"","UF","region","region_name","microregion","microregion_name","pop","gdp","week","nconcep","nconcep_educ_low","nconcep_educ_high","nconcep_age_young","nconcep_age_old","nfetal","nfetal_educ_low","nfetal_educ_high","nfetal_age_young","nfetal_age_old","totalconcep","totalconcep_educ_low","totalconcep_educ_high","totalconcep_age_young","totalconcep_age_old","deaths","lgdp","lpop","isolated","s_date","year","month"
"1","AC",1,"Norte",12001,"Cruzeiro do Sul",159274,13597.6753611387,5,54,26,28,35,19,2,1,1,0,2,56,27,29,35,21,18,9.51765412778602,11.9783812685158,0.323569655475821,2020-02-03,2020,2
"2","AC",1,"Norte",12001,"Cruzeiro do Sul",159274,13597.6753611387,6,58,22,36,27,31,0,0,0,0,0,58,22,36,27,31,10,9.51765412778602,11.9783812685158,0.301824599718657,2020-02-10,2020,2
"3","AC",1,"Norte",12001,"Cruzeiro do Sul",159274,13597.6753611387,7,68,29,39,38,30,0,0,0,0,0,68,29,39,38,30,13,9.51765412778602,11.9783812685158,0.314457419292732,2020-02-17,2020,2
"4","AC",1,"Norte",12001,"Cruzeiro do Sul",159274,13597.6753611387,8,71,29,42,35,36,2,2,0,0,2,73,31,42,35,38,7,9.51765412778602,11.9783812685158,0.348216647119355,2020-02-24,2020,2
"5","AC",1,"Norte",12001,"Cruzeiro do Sul",159274,13597.6753611387,9,62,25,37,27,35,1,1,0,0,1,63,26,37,27,36,14,9.51765412778602,11.9783812685158,0.330607749955718,2020-03-02,2020,3
"6","AC",1,"Norte",12001,"Cruzeiro do Sul",159274,13597.6753611387,10,62,21,41,36,26,0,0,0,0,0,62,21,41,36,26,6,9.51765412778602,11.9783812685158,0.341206928112389,2020-03-09,2020,3
"7","AC",1,"Norte",12001,"Cruzeiro do Sul",159274,13597.6753611387,11,40,24,16,19,21,0,0,0,0,0,40,24,16,19,21,9,9.51765412778602,11.9783812685158,0.404247306648029,2020-03-16,2020,3
"8","AC",1,"Norte",12001,"Cruzeiro do Sul",159274,13597.6753611387,12,38,23,15,21,17,0,0,0,0,0,38,23,15,21,17,6,9.51765412778602,11.9783812685158,0.50646298957826,2020-03-23,2020,3
"9","AC",1,"Norte",12001,"Cruzeiro do Sul",159274,13597.6753611387,13,31,15,16,17,14,2,0,2,2,0,33,15,18,19,14,13,9.51765412778602,11.9783812685158,0.478538616485944,2020-03-30,2020,3
"10","AC",1,"Norte",12001,"Cruzeiro do Sul",159274,13597.6753611387,14,15,8,7,10,5,0,0,0,0,0,15,8,7,10,5,12,9.51765412778602,11.9783812685158,0.475734035507001,2020-04-06,2020,4
"11","AC",1,"Norte",12001,"Cruzeiro do Sul",159274,13597.6753611387,15,29,15,14,10,19,0,0,0,0,0,29,15,14,10,19,13,9.51765412778602,11.9783812685158,0.474960447769591,2020-04-13,2020,4
"12","AC",1,"Norte",12001,"Cruzeiro do Sul",159274,13597.6753611387,16,25,8,17,13,12,1,1,0,1,0,26,9,17,14,12,10,9.51765412778602,11.9783812685158,0.496026562879652,2020-04-20,2020,4
"13","AC",1,"Norte",12001,"Cruzeiro do Sul",159274,13597.6753611387,17,28,12,16,15,13,1,1,0,1,0,29,13,16,16,13,11,9.51765412778602,11.9783812685158,0.476730027298026,2020-04-27,2020,4
"14","AC",1,"Norte",12001,"Cruzeiro do Sul",159274,13597.6753611387,18,32,13,19,22,10,0,0,0,0,0,32,13,19,22,10,9,9.51765412778602,11.9783812685158,0.520087749737868,2020-05-04,2020,5
"15","AC",1,"Norte",12001,"Cruzeiro do Sul",159274,13597.6753611387,19,32,15,17,22,10,0,0,0,0,0,32,15,17,22,10,6,9.51765412778602,11.9783812685158,0.523794505858201,2020-05-11,2020,5
"16","AC",1,"Norte",12001,"Cruzeiro do Sul",159274,13597.6753611387,20,36,19,17,19,17,2,2,0,2,0,38,21,17,21,17,23,9.51765412778602,11.9783812685158,0.532777711003798,2020-05-18,2020,5
"17","AC",1,"Norte",12001,"Cruzeiro do Sul",159274,13597.6753611387,21,43,23,20,20,23,0,0,0,0,0,43,23,20,20,23,14,9.51765412778602,11.9783812685158,0.506308414346718,2020-05-25,2020,5
"18","AC",1,"Norte",12002,"Tarauacá",86508,10966.6734802562,5,39,22,17,21,18,0,0,0,0,0,39,22,17,21,18,4,9.30261626938511,11.3679921741926,0.30549447076347,2020-02-03,2020,2
"19","AC",1,"Norte",12002,"Tarauacá",86508,10966.6734802562,6,25,14,11,12,13,0,0,0,0,0,25,14,11,12,13,7,9.30261626938511,11.3679921741926,0.304090031528308,2020-02-10,2020,2
"20","AC",1,"Norte",12002,"Tarauacá",86508,10966.6734802562,7,32,20,12,21,11,1,0,1,1,0,33,20,13,22,11,6,9.30261626938511,11.3679921741926,0.290580803460242,2020-02-17,2020,2
"21","AC",1,"Norte",12002,"Tarauacá",86508,10966.6734802562,8,35,16,19,19,16,2,2,0,1,1,37,18,19,20,17,7,9.30261626938511,11.3679921741926,0.331815142447531,2020-02-24,2020,2
"22","AC",1,"Norte",12002,"Tarauacá",86508,10966.6734802562,9,26,17,9,13,13,0,0,0,0,0,26,17,9,13,13,13,9.30261626938511,11.3679921741926,0.30926669615218,2020-03-02,2020,3
"23","AC",1,"Norte",12002,"Tarauacá",86508,10966.6734802562,10,33,21,12,21,12,1,0,1,0,1,34,21,13,21,13,16,9.30261626938511,11.3679921741926,0.330398816676425,2020-03-09,2020,3
"24","AC",1,"Norte",12002,"Tarauacá",86508,10966.6734802562,11,34,20,14,23,11,1,1,0,0,1,35,21,14,23,12,10,9.30261626938511,11.3679921741926,0.392793613933668,2020-03-16,2020,3
"25","AC",1,"Norte",12002,"Tarauacá",86508,10966.6734802562,12,23,12,11,16,7,2,0,2,1,1,25,12,13,17,8,7,9.30261626938511,11.3679921741926,0.472298172841029,2020-03-23,2020,3
"26","AC",1,"Norte",12002,"Tarauacá",86508,10966.6734802562,13,30,16,14,22,8,0,0,0,0,0,30,16,14,22,8,2,9.30261626938511,11.3679921741926,0.440171362393392,2020-03-30,2020,3
"27","AC",1,"Norte",12002,"Tarauacá",86508,10966.6734802562,14,39,23,16,26,13,0,0,0,0,0,39,23,16,26,13,6,9.30261626938511,11.3679921741926,0.451025681654595,2020-04-06,2020,4
"28","AC",1,"Norte",12002,"Tarauacá",86508,10966.6734802562,15,31,17,14,17,14,0,0,0,0,0,31,17,14,17,14,7,9.30261626938511,11.3679921741926,0.429440376480333,2020-04-13,2020,4
"29","AC",1,"Norte",12002,"Tarauacá",86508,10966.6734802562,16,31,16,15,17,14,0,0,0,0,0,31,16,15,17,14,2,9.30261626938511,11.3679921741926,0.435323530713047,2020-04-20,2020,4
"30","AC",1,"Norte",12002,"Tarauacá",86508,10966.6734802562,17,41,19,22,23,18,0,0,0,0,0,41,19,22,23,18,9,9.30261626938511,11.3679921741926,0.401937305497384,2020-04-27,2020,4
"31","AC",1,"Norte",12002,"Tarauacá",86508,10966.6734802562,18,27,20,7,18,9,1,1,0,1,0,28,21,7,19,9,3,9.30261626938511,11.3679921741926,0.436865483898468,2020-05-04,2020,5
"32","AC",1,"Norte",12002,"Tarauacá",86508,10966.6734802562,19,45,23,22,31,14,1,1,0,0,1,46,24,22,31,15,2,9.30261626938511,11.3679921741926,0.461204250526703,2020-05-11,2020,5
"33","AC",1,"Norte",12002,"Tarauacá",86508,10966.6734802562,20,20,12,8,11,9,1,1,0,1,0,21,13,8,12,9,6,9.30261626938511,11.3679921741926,0.445918843206714,2020-05-18,2020,5
"34","AC",1,"Norte",12002,"Tarauacá",86508,10966.6734802562,21,46,28,18,28,18,0,0,0,0,0,46,28,18,28,18,6,9.30261626938511,11.3679921741926,0.455674874428415,2020-05-25,2020,5
"35","AC",1,"Norte",12003,"Sena Madureira",62809,11741.4419761499,5,22,11,11,17,5,0,0,0,0,0,22,11,11,17,5,3,9.37087991174675,11.04785365429,0.312925862667068,2020-02-03,2020,2
"36","AC",1,"Norte",12003,"Sena Madureira",62809,11741.4419761499,6,15,8,7,11,4,0,0,0,0,0,15,8,7,11,4,6,9.37087991174675,11.04785365429,0.292469101914364,2020-02-10,2020,2
"37","AC",1,"Norte",12003,"Sena Madureira",62809,11741.4419761499,7,9,6,3,6,3,0,0,0,0,0,9,6,3,6,3,7,9.37087991174675,11.04785365429,0.318550241769317,2020-02-17,2020,2
"38","AC",1,"Norte",12003,"Sena Madureira",62809,11741.4419761499,8,17,9,8,12,5,0,0,0,0,0,17,9,8,12,5,4,9.37087991174675,11.04785365429,0.360720348281976,2020-02-24,2020,2
"39","AC",1,"Norte",12003,"Sena Madureira",62809,11741.4419761499,9,14,10,4,7,7,0,0,0,0,0,14,10,4,7,7,5,9.37087991174675,11.04785365429,0.347931957907424,2020-03-02,2020,3
"40","AC",1,"Norte",12003,"Sena Madureira",62809,11741.4419761499,10,15,9,6,4,11,0,0,0,0,0,15,9,6,4,11,4,9.37087991174675,11.04785365429,0.344073404719068,2020-03-09,2020,3
"41","AC",1,"Norte",12003,"Sena Madureira",62809,11741.4419761499,11,10,6,4,4,6,0,0,0,0,0,10,6,4,4,6,6,9.37087991174675,11.04785365429,0.422573559646442,2020-03-16,2020,3
"42","AC",1,"Norte",12003,"Sena Madureira",62809,11741.4419761499,12,16,9,7,7,9,0,0,0,0,0,16,9,7,7,9,2,9.37087991174675,11.04785365429,0.492272895878136,2020-03-23,2020,3
"43","AC",1,"Norte",12003,"Sena Madureira",62809,11741.4419761499,13,26,14,12,17,9,0,0,0,0,0,26,14,12,17,9,5,9.37087991174675,11.04785365429,0.451420388369838,2020-03-30,2020,3
"44","AC",1,"Norte",12003,"Sena Madureira",62809,11741.4419761499,14,14,6,8,10,4,0,0,0,0,0,14,6,8,10,4,6,9.37087991174675,11.04785365429,0.455941309690738,2020-04-06,2020,4
"45","AC",1,"Norte",12003,"Sena Madureira",62809,11741.4419761499,15,19,12,7,12,7,0,0,0,0,0,19,12,7,12,7,13,9.37087991174675,11.04785365429,0.440074469609375,2020-04-13,2020,4
"46","AC",1,"Norte",12003,"Sena Madureira",62809,11741.4419761499,16,20,13,7,9,11,0,0,0,0,0,20,13,7,9,11,6,9.37087991174675,11.04785365429,0.435627337797919,2020-04-20,2020,4
"47","AC",1,"Norte",12003,"Sena Madureira",62809,11741.4419761499,17,21,12,9,10,11,0,0,0,0,0,21,12,9,10,11,6,9.37087991174675,11.04785365429,0.417311092761655,2020-04-27,2020,4
"48","AC",1,"Norte",12003,"Sena Madureira",62809,11741.4419761499,18,11,7,4,5,6,0,0,0,0,0,11,7,4,5,6,4,9.37087991174675,11.04785365429,0.422284015983469,2020-05-04,2020,5
"49","AC",1,"Norte",12003,"Sena Madureira",62809,11741.4419761499,19,7,4,3,3,4,0,0,0,0,0,7,4,3,3,4,5,9.37087991174675,11.04785365429,0.458765131128357,2020-05-11,2020,5
"50","AC",1,"Norte",12003,"Sena Madureira",62809,11741.4419761499,20,12,6,6,6,6,0,0,0,0,0,12,6,6,6,6,8,9.37087991174675,11.04785365429,0.475723530331863,2020-05-18,2020,5
"51","AC",1,"Norte",12003,"Sena Madureira",62809,11741.4419761499,21,11,7,4,5,6,0,0,0,0,0,11,7,4,5,6,6,9.37087991174675,11.04785365429,0.441063183575312,2020-05-25,2020,5
"52","AC",1,"Norte",12004,"Rio Branco",513351,20803.0031419633,5,131,43,88,56,75,3,1,2,1,2,134,44,90,57,77,58,9.94285263709252,13.1487151007139,0.316309339446334,2020-02-03,2020,2
"53","AC",1,"Norte",12004,"Rio Branco",513351,20803.0031419633,6,118,47,71,53,65,0,0,0,0,0,118,47,71,53,65,54,9.94285263709252,13.1487151007139,0.316413126958464,2020-02-10,2020,2
"54","AC",1,"Norte",12004,"Rio Branco",513351,20803.0031419633,7,134,53,81,59,75,1,0,1,0,1,135,53,82,59,76,46,9.94285263709252,13.1487151007139,0.325876331813104,2020-02-17,2020,2
"55","AC",1,"Norte",12004,"Rio Branco",513351,20803.0031419633,8,150,48,102,76,74,1,0,1,1,0,151,48,103,77,74,49,9.94285263709252,13.1487151007139,0.373405469358638,2020-02-24,2020,2
"56","AC",1,"Norte",12004,"Rio Branco",513351,20803.0031419633,9,143,43,100,67,76,2,1,1,0,2,145,44,101,67,78,54,9.94285263709252,13.1487151007139,0.349940114995716,2020-03-02,2020,3
"57","AC",1,"Norte",12004,"Rio Branco",513351,20803.0031419633,10,122,32,90,49,73,1,0,1,1,0,123,32,91,50,73,51,9.94285263709252,13.1487151007139,0.368417748714875,2020-03-09,2020,3
"58","AC",1,"Norte",12004,"Rio Branco",513351,20803.0031419633,11,160,39,121,60,100,1,0,1,1,0,161,39,122,61,100,52,9.94285263709252,13.1487151007139,0.451602809980846,2020-03-16,2020,3
"59","AC",1,"Norte",12004,"Rio Branco",513351,20803.0031419633,12,121,37,84,54,67,2,1,1,1,1,123,38,85,55,68,45,9.94285263709252,13.1487151007139,0.544536019857919,2020-03-23,2020,3
"60","AC",1,"Norte",12004,"Rio Branco",513351,20803.0031419633,13,115,37,78,52,63,0,0,0,0,0,115,37,78,52,63,42,9.94285263709252,13.1487151007139,0.503771306965611,2020-03-30,2020,3
"61","AC",1,"Norte",12004,"Rio Branco",513351,20803.0031419633,14,130,42,88,69,61,2,1,1,1,1,132,43,89,70,62,45,9.94285263709252,13.1487151007139,0.491718980322219,2020-04-06,2020,4
"62","AC",1,"Norte",12004,"Rio Branco",513351,20803.0031419633,15,132,52,80,54,78,3,0,3,1,2,135,52,83,55,80,52,9.94285263709252,13.1487151007139,0.486199186278477,2020-04-13,2020,4
"63","AC",1,"Norte",12004,"Rio Branco",513351,20803.0031419633,16,120,39,81,55,65,2,2,0,0,2,122,41,81,55,67,56,9.94285263709252,13.1487151007139,0.488834896373285,2020-04-20,2020,4
"64","AC",1,"Norte",12004,"Rio Branco",513351,20803.0031419633,17,130,43,87,63,67,2,0,2,1,1,132,43,89,64,68,65,9.94285263709252,13.1487151007139,0.471234118160884,2020-04-27,2020,4
"65","AC",1,"Norte",12004,"Rio Branco",513351,20803.0031419633,18,111,34,77,47,64,1,1,0,0,1,112,35,77,47,65,67,9.94285263709252,13.1487151007139,0.470889712977498,2020-05-04,2020,5
"66","AC",1,"Norte",12004,"Rio Branco",513351,20803.0031419633,19,116,40,76,58,58,0,0,0,0,0,116,40,76,58,58,86,9.94285263709252,13.1487151007139,0.494177928417933,2020-05-11,2020,5
"67","AC",1,"Norte",12004,"Rio Branco",513351,20803.0031419633,20,115,31,84,52,63,0,0,0,0,0,115,31,84,52,63,109,9.94285263709252,13.1487151007139,0.506497692244246,2020-05-18,2020,5
"68","AC",1,"Norte",12004,"Rio Branco",513351,20803.0031419633,21,141,43,98,59,82,2,0,2,1,1,143,43,100,60,83,113,9.94285263709252,13.1487151007139,0.480254236755553,2020-05-25,2020,5
"69","AC",1,"Norte",12005,"Brasiléia",72528,17179.4969970218,5,18,8,10,10,8,0,0,0,0,0,18,8,10,10,8,3,9.75147191670577,11.1917279731806,0.282078934081766,2020-02-03,2020,2
"70","AC",1,"Norte",12005,"Brasiléia",72528,17179.4969970218,6,30,14,16,18,12,0,0,0,0,0,30,14,16,18,12,9,9.75147191670577,11.1917279731806,0.289977483856816,2020-02-10,2020,2
"71","AC",1,"Norte",12005,"Brasiléia",72528,17179.4969970218,7,11,3,8,8,3,0,0,0,0,0,11,3,8,8,3,0,9.75147191670577,11.1917279731806,0.303453242751508,2020-02-17,2020,2
"72","AC",1,"Norte",12005,"Brasiléia",72528,17179.4969970218,8,14,5,9,7,7,0,0,0,0,0,14,5,9,7,7,6,9.75147191670577,11.1917279731806,0.331716598720745,2020-02-24,2020,2
"73","AC",1,"Norte",12005,"Brasiléia",72528,17179.4969970218,9,27,10,17,10,17,0,0,0,0,0,27,10,17,10,17,2,9.75147191670577,11.1917279731806,0.336214408801698,2020-03-02,2020,3
"74","AC",1,"Norte",12005,"Brasiléia",72528,17179.4969970218,10,13,7,6,8,5,0,0,0,0,0,13,7,6,8,5,4,9.75147191670577,11.1917279731806,0.36521651980226,2020-03-09,2020,3
"75","AC",1,"Norte",12005,"Brasiléia",72528,17179.4969970218,11,12,4,8,6,6,0,0,0,0,0,12,4,8,6,6,6,9.75147191670577,11.1917279731806,0.420907969469387,2020-03-16,2020,3
"76","AC",1,"Norte",12005,"Brasiléia",72528,17179.4969970218,12,23,9,14,12,11,0,0,0,0,0,23,9,14,12,11,11,9.75147191670577,11.1917279731806,0.508324692426197,2020-03-23,2020,3
"77","AC",1,"Norte",12005,"Brasiléia",72528,17179.4969970218,13,13,6,7,7,6,1,0,1,1,0,14,6,8,8,6,5,9.75147191670577,11.1917279731806,0.466574044510012,2020-03-30,2020,3
"78","AC",1,"Norte",12005,"Brasiléia",72528,17179.4969970218,14,22,8,14,12,10,0,0,0,0,0,22,8,14,12,10,7,9.75147191670577,11.1917279731806,0.451477507353728,2020-04-06,2020,4
"79","AC",1,"Norte",12005,"Brasiléia",72528,17179.4969970218,15,24,10,14,11,13,0,0,0,0,0,24,10,14,11,13,9,9.75147191670577,11.1917279731806,0.444213400258724,2020-04-13,2020,4
"80","AC",1,"Norte",12005,"Brasiléia",72528,17179.4969970218,16,16,5,11,10,6,0,0,0,0,0,16,5,11,10,6,5,9.75147191670577,11.1917279731806,0.439141196524544,2020-04-20,2020,4
"81","AC",1,"Norte",12005,"Brasiléia",72528,17179.4969970218,17,23,11,12,12,11,0,0,0,0,0,23,11,12,12,11,9,9.75147191670577,11.1917279731806,0.440076533918741,2020-04-27,2020,4
"82","AC",1,"Norte",12005,"Brasiléia",72528,17179.4969970218,18,17,7,10,9,8,1,0,1,0,1,18,7,11,9,9,10,9.75147191670577,11.1917279731806,0.427160621603638,2020-05-04,2020,5
"83","AC",1,"Norte",12005,"Brasiléia",72528,17179.4969970218,19,21,10,11,9,12,0,0,0,0,0,21,10,11,9,12,6,9.75147191670577,11.1917279731806,0.446809810610481,2020-05-11,2020,5
"84","AC",1,"Norte",12005,"Brasiléia",72528,17179.4969970218,20,25,15,10,14,11,0,0,0,0,0,25,15,10,14,11,11,9.75147191670577,11.1917279731806,0.46189490616068,2020-05-18,2020,5
"85","AC",1,"Norte",12005,"Brasiléia",72528,17179.4969970218,21,25,9,16,11,14,0,0,0,0,0,25,9,16,11,14,14,9.75147191670577,11.1917279731806,0.465777508343318,2020-05-25,2020,5
"86","AL",2,"Nordeste",27001,"Serrana do Sertão Alagoano",92087,7319.36980160066,5,21,12,9,12,9,0,0,0,0,0,21,12,9,12,9,15,8.89827951057167,11.4304890613578,0.29616290582132,2020-02-03,2020,2
"87","AL",2,"Nordeste",27001,"Serrana do Sertão Alagoano",92087,7319.36980160066,6,19,13,6,9,10,0,0,0,0,0,19,13,6,9,10,13,8.89827951057167,11.4304890613578,0.279485744768159,2020-02-10,2020,2
"88","AL",2,"Nordeste",27001,"Serrana do Sertão Alagoano",92087,7319.36980160066,7,15,7,8,7,8,1,0,1,1,0,16,7,9,8,8,12,8.89827951057167,11.4304890613578,0.290962988600823,2020-02-17,2020,2
"89","AL",2,"Nordeste",27001,"Serrana do Sertão Alagoano",92087,7319.36980160066,8,37,24,13,17,20,1,0,1,0,1,38,24,14,17,21,15,8.89827951057167,11.4304890613578,0.336120236278782,2020-02-24,2020,2
"90","AL",2,"Nordeste",27001,"Serrana do Sertão Alagoano",92087,7319.36980160066,9,40,23,17,21,19,1,0,1,0,1,41,23,18,21,20,11,8.89827951057167,11.4304890613578,0.312059386592931,2020-03-02,2020,3
"91","AL",2,"Nordeste",27001,"Serrana do Sertão Alagoano",92087,7319.36980160066,10,21,15,6,6,15,0,0,0,0,0,21,15,6,6,15,12,8.89827951057167,11.4304890613578,0.341647270507597,2020-03-09,2020,3
"92","AL",2,"Nordeste",27001,"Serrana do Sertão Alagoano",92087,7319.36980160066,11,18,11,7,8,10,0,0,0,0,0,18,11,7,8,10,7,8.89827951057167,11.4304890613578,0.390754380032524,2020-03-16,2020,3
"93","AL",2,"Nordeste",27001,"Serrana do Sertão Alagoano",92087,7319.36980160066,12,19,11,8,10,9,0,0,0,0,0,19,11,8,10,9,13,8.89827951057167,11.4304890613578,0.500352890350599,2020-03-23,2020,3
"94","AL",2,"Nordeste",27001,"Serrana do Sertão Alagoano",92087,7319.36980160066,13,18,14,4,13,5,0,0,0,0,0,18,14,4,13,5,12,8.89827951057167,11.4304890613578,0.440896834048709,2020-03-30,2020,3
"95","AL",2,"Nordeste",27001,"Serrana do Sertão Alagoano",92087,7319.36980160066,14,18,15,3,10,8,0,0,0,0,0,18,15,3,10,8,11,8.89827951057167,11.4304890613578,0.442752031216814,2020-04-06,2020,4
"96","AL",2,"Nordeste",27001,"Serrana do Sertão Alagoano",92087,7319.36980160066,15,34,20,14,22,12,1,1,0,0,1,35,21,14,22,13,15,8.89827951057167,11.4304890613578,0.410235846198342,2020-04-13,2020,4
"97","AL",2,"Nordeste",27001,"Serrana do Sertão Alagoano",92087,7319.36980160066,16,24,13,11,12,12,0,0,0,0,0,24,13,11,12,12,14,8.89827951057167,11.4304890613578,0.407790266144106,2020-04-20,2020,4
"98","AL",2,"Nordeste",27001,"Serrana do Sertão Alagoano",92087,7319.36980160066,17,23,13,10,11,12,0,0,0,0,0,23,13,10,11,12,6,8.89827951057167,11.4304890613578,0.413008254903082,2020-04-27,2020,4
"99","AL",2,"Nordeste",27001,"Serrana do Sertão Alagoano",92087,7319.36980160066,18,27,17,10,13,14,0,0,0,0,0,27,17,10,13,14,13,8.89827951057167,11.4304890613578,0.43245818691825,2020-05-04,2020,5
"100","AL",2,"Nordeste",27001,"Serrana do Sertão Alagoano",92087,7319.36980160066,19,24,9,15,13,11,1,1,0,1,0,25,10,15,14,11,9,8.89827951057167,11.4304890613578,0.454643665354495,2020-05-11,2020,5
"101","AL",2,"Nordeste",27001,"Serrana do Sertão Alagoano",92087,7319.36980160066,20,23,13,10,17,6,0,0,0,0,0,23,13,10,17,6,12,8.89827951057167,11.4304890613578,0.448640905948298,2020-05-18,2020,5
"102","AL",2,"Nordeste",27001,"Serrana do Sertão Alagoano",92087,7319.36980160066,21,32,19,13,15,17,0,0,0,0,0,32,19,13,15,17,7,8.89827951057167,11.4304890613578,0.437010886425846,2020-05-25,2020,5
"103","AL",2,"Nordeste",27002,"Alagoana do Sertão do São Francisco",86886,9731.03677002049,5,33,19,14,14,19,1,0,1,0,1,34,19,15,14,20,5,9.18307572346252,11.3723521935567,0.281906353472136,2020-02-03,2020,2
"104","AL",2,"Nordeste",27002,"Alagoana do Sertão do São Francisco",86886,9731.03677002049,6,29,10,19,11,18,0,0,0,0,0,29,10,19,11,18,11,9.18307572346252,11.3723521935567,0.27612315471131,2020-02-10,2020,2
"105","AL",2,"Nordeste",27002,"Alagoana do Sertão do São Francisco",86886,9731.03677002049,7,29,22,7,16,13,1,1,0,1,0,30,23,7,17,13,12,9.18307572346252,11.3723521935567,0.29166841088933,2020-02-17,2020,2
"106","AL",2,"Nordeste",27002,"Alagoana do Sertão do São Francisco",86886,9731.03677002049,8,20,8,12,8,12,1,0,1,1,0,21,8,13,9,12,18,9.18307572346252,11.3723521935567,0.32956128130957,2020-02-24,2020,2
"107","AL",2,"Nordeste",27002,"Alagoana do Sertão do São Francisco",86886,9731.03677002049,9,21,7,14,13,8,1,0,1,0,1,22,7,15,13,9,7,9.18307572346252,11.3723521935567,0.305491935164914,2020-03-02,2020,3
"108","AL",2,"Nordeste",27002,"Alagoana do Sertão do São Francisco",86886,9731.03677002049,10,12,3,9,8,4,0,0,0,0,0,12,3,9,8,4,6,9.18307572346252,11.3723521935567,0.335746792437846,2020-03-09,2020,3
"109","AL",2,"Nordeste",27002,"Alagoana do Sertão do São Francisco",86886,9731.03677002049,11,14,7,7,6,8,0,0,0,0,0,14,7,7,6,8,6,9.18307572346252,11.3723521935567,0.389420364292227,2020-03-16,2020,3
"110","AL",2,"Nordeste",27002,"Alagoana do Sertão do São Francisco",86886,9731.03677002049,12,18,10,8,8,10,0,0,0,0,0,18,10,8,8,10,16,9.18307572346252,11.3723521935567,0.504369287148481,2020-03-23,2020,3
"111","AL",2,"Nordeste",27002,"Alagoana do Sertão do São Francisco",86886,9731.03677002049,13,9,3,6,5,4,1,1,0,1,0,10,4,6,6,4,15,9.18307572346252,11.3723521935567,0.44932689909631,2020-03-30,2020,3
"112","AL",2,"Nordeste",27002,"Alagoana do Sertão do São Francisco",86886,9731.03677002049,14,24,12,12,13,11,1,0,1,1,0,25,12,13,14,11,14,9.18307572346252,11.3723521935567,0.421989515370815,2020-04-06,2020,4
"113","AL",2,"Nordeste",27002,"Alagoana do Sertão do São Francisco",86886,9731.03677002049,15,23,18,5,14,9,1,0,1,0,1,24,18,6,14,10,11,9.18307572346252,11.3723521935567,0.413864826363045,2020-04-13,2020,4
"114","AL",2,"Nordeste",27002,"Alagoana do Sertão do São Francisco",86886,9731.03677002049,16,24,13,11,12,12,0,0,0,0,0,24,13,11,12,12,14,9.18307572346252,11.3723521935567,0.407553265276662,2020-04-20,2020,4
"115","AL",2,"Nordeste",27002,"Alagoana do Sertão do São Francisco",86886,9731.03677002049,17,32,15,17,17,15,0,0,0,0,0,32,15,17,17,15,7,9.18307572346252,11.3723521935567,0.388582916601565,2020-04-27,2020,4
"116","AL",2,"Nordeste",27002,"Alagoana do Sertão do São Francisco",86886,9731.03677002049,18,31,13,18,12,19,0,0,0,0,0,31,13,18,12,19,10,9.18307572346252,11.3723521935567,0.399720217272316,2020-05-04,2020,5
"117","AL",2,"Nordeste",27002,"Alagoana do Sertão do São Francisco",86886,9731.03677002049,19,30,12,18,15,15,0,0,0,0,0,30,12,18,15,15,11,9.18307572346252,11.3723521935567,0.424256528729124,2020-05-11,2020,5
"118","AL",2,"Nordeste",27002,"Alagoana do Sertão do São Francisco",86886,9731.03677002049,20,15,8,7,8,7,1,0,1,1,0,16,8,8,9,7,16,9.18307572346252,11.3723521935567,0.44071107917409,2020-05-18,2020,5
"119","AL",2,"Nordeste",27002,"Alagoana do Sertão do São Francisco",86886,9731.03677002049,21,23,12,11,12,11,0,0,0,0,0,23,12,11,12,11,10,9.18307572346252,11.3723521935567,0.426225298012862,2020-05-25,2020,5
"120","AL",2,"Nordeste",27003,"Santana do Ipanema",178716,8134.68760060655,5,49,21,28,22,27,1,1,0,1,0,50,22,28,23,27,17,9.00389261702352,12.0935532326739,0.279694846888318,2020-02-03,2020,2
"121","AL",2,"Nordeste",27003,"Santana do Ipanema",178716,8134.68760060655,6,47,20,27,27,20,0,0,0,0,0,47,20,27,27,20,19,9.00389261702352,12.0935532326739,0.266774787001534,2020-02-10,2020,2
"122","AL",2,"Nordeste",27003,"Santana do Ipanema",178716,8134.68760060655,7,50,21,29,25,25,0,0,0,0,0,50,21,29,25,25,21,9.00389261702352,12.0935532326739,0.282926138923839,2020-02-17,2020,2
"123","AL",2,"Nordeste",27003,"Santana do Ipanema",178716,8134.68760060655,8,51,23,28,27,24,0,0,0,0,0,51,23,28,27,24,32,9.00389261702352,12.0935532326739,0.330088357641784,2020-02-24,2020,2
"124","AL",2,"Nordeste",27003,"Santana do Ipanema",178716,8134.68760060655,9,48,26,22,24,24,1,1,0,0,1,49,27,22,24,25,18,9.00389261702352,12.0935532326739,0.289743841932449,2020-03-02,2020,3
"125","AL",2,"Nordeste",27003,"Santana do Ipanema",178716,8134.68760060655,10,46,30,16,24,22,1,1,0,1,0,47,31,16,25,22,19,9.00389261702352,12.0935532326739,0.321853257176697,2020-03-09,2020,3
"126","AL",2,"Nordeste",27003,"Santana do Ipanema",178716,8134.68760060655,11,35,20,15,19,16,2,0,2,1,1,37,20,17,20,17,21,9.00389261702352,12.0935532326739,0.362240574462289,2020-03-16,2020,3
"127","AL",2,"Nordeste",27003,"Santana do Ipanema",178716,8134.68760060655,12,43,18,25,20,23,0,0,0,0,0,43,18,25,20,23,26,9.00389261702352,12.0935532326739,0.445388621479198,2020-03-23,2020,3
"128","AL",2,"Nordeste",27003,"Santana do Ipanema",178716,8134.68760060655,13,55,26,29,27,28,0,0,0,0,0,55,26,29,27,28,32,9.00389261702352,12.0935532326739,0.394752489949997,2020-03-30,2020,3
"129","AL",2,"Nordeste",27003,"Santana do Ipanema",178716,8134.68760060655,14,50,18,32,25,25,0,0,0,0,0,50,18,32,25,25,23,9.00389261702352,12.0935532326739,0.39427361383952,2020-04-06,2020,4
"130","AL",2,"Nordeste",27003,"Santana do Ipanema",178716,8134.68760060655,15,53,27,26,27,26,1,1,0,0,1,54,28,26,27,27,19,9.00389261702352,12.0935532326739,0.370937492770364,2020-04-13,2020,4
"131","AL",2,"Nordeste",27003,"Santana do Ipanema",178716,8134.68760060655,16,52,21,31,25,27,0,0,0,0,0,52,21,31,25,27,18,9.00389261702352,12.0935532326739,0.373267998254013,2020-04-20,2020,4
"132","AL",2,"Nordeste",27003,"Santana do Ipanema",178716,8134.68760060655,17,66,34,32,30,36,2,2,0,1,1,68,36,32,31,37,25,9.00389261702352,12.0935532326739,0.373170192489706,2020-04-27,2020,4
"133","AL",2,"Nordeste",27003,"Santana do Ipanema",178716,8134.68760060655,18,47,21,26,25,22,1,1,0,0,1,48,22,26,25,23,20,9.00389261702352,12.0935532326739,0.381771862909282,2020-05-04,2020,5
"134","AL",2,"Nordeste",27003,"Santana do Ipanema",178716,8134.68760060655,19,44,23,21,24,20,0,0,0,0,0,44,23,21,24,20,29,9.00389261702352,12.0935532326739,0.421139749509678,2020-05-11,2020,5
"135","AL",2,"Nordeste",27003,"Santana do Ipanema",178716,8134.68760060655,20,58,31,27,34,24,2,0,2,1,1,60,31,29,35,25,31,9.00389261702352,12.0935532326739,0.427148952126313,2020-05-18,2020,5
"136","AL",2,"Nordeste",27003,"Santana do Ipanema",178716,8134.68760060655,21,70,29,41,36,34,0,0,0,0,0,70,29,41,36,34,28,9.00389261702352,12.0935532326739,0.412606279871535,2020-05-25,2020,5
"137","AL",2,"Nordeste",27004,"Batalha",96452,8916.73812704765,5,18,9,9,10,8,0,0,0,0,0,18,9,9,10,8,7,9.09568547787226,11.4768007542516,0.270890214346881,2020-02-03,2020,2
"138","AL",2,"Nordeste",27004,"Batalha",96452,8916.73812704765,6,26,16,10,15,11,0,0,0,0,0,26,16,10,15,11,10,9.09568547787226,11.4768007542516,0.264810145860157,2020-02-10,2020,2
"139","AL",2,"Nordeste",27004,"Batalha",96452,8916.73812704765,7,19,9,10,9,10,0,0,0,0,0,19,9,10,9,10,11,9.09568547787226,11.4768007542516,0.268960723655021,2020-02-17,2020,2
"140","AL",2,"Nordeste",27004,"Batalha",96452,8916.73812704765,8,31,16,15,17,14,0,0,0,0,0,31,16,15,17,14,11,9.09568547787226,11.4768007542516,0.330838216068934,2020-02-24,2020,2
"141","AL",2,"Nordeste",27004,"Batalha",96452,8916.73812704765,9,43,26,17,19,24,0,0,0,0,0,43,26,17,19,24,12,9.09568547787226,11.4768007542516,0.30279618060991,2020-03-02,2020,3
"142","AL",2,"Nordeste",27004,"Batalha",96452,8916.73812704765,10,25,13,12,9,16,0,0,0,0,0,25,13,12,9,16,13,9.09568547787226,11.4768007542516,0.327818114519944,2020-03-09,2020,3
"143","AL",2,"Nordeste",27004,"Batalha",96452,8916.73812704765,11,22,12,10,11,11,1,1,0,0,1,23,13,10,11,12,11,9.09568547787226,11.4768007542516,0.352548533626525,2020-03-16,2020,3
"144","AL",2,"Nordeste",27004,"Batalha",96452,8916.73812704765,12,29,13,16,13,16,0,0,0,0,0,29,13,16,13,16,5,9.09568547787226,11.4768007542516,0.436500643773947,2020-03-23,2020,3
"145","AL",2,"Nordeste",27004,"Batalha",96452,8916.73812704765,13,21,12,9,7,14,0,0,0,0,0,21,12,9,7,14,11,9.09568547787226,11.4768007542516,0.38639565603448,2020-03-30,2020,3
"146","AL",2,"Nordeste",27004,"Batalha",96452,8916.73812704765,14,28,13,15,11,17,1,0,1,0,1,29,13,16,11,18,11,9.09568547787226,11.4768007542516,0.390906166090953,2020-04-06,2020,4
"147","AL",2,"Nordeste",27004,"Batalha",96452,8916.73812704765,15,20,8,12,8,12,0,0,0,0,0,20,8,12,8,12,7,9.09568547787226,11.4768007542516,0.373484325331348,2020-04-13,2020,4
"148","AL",2,"Nordeste",27004,"Batalha",96452,8916.73812704765,16,21,9,12,14,7,0,0,0,0,0,21,9,12,14,7,5,9.09568547787226,11.4768007542516,0.374958048508716,2020-04-20,2020,4
"149","AL",2,"Nordeste",27004,"Batalha",96452,8916.73812704765,17,31,20,11,17,14,0,0,0,0,0,31,20,11,17,14,13,9.09568547787226,11.4768007542516,0.371278624221836,2020-04-27,2020,4
"150","AL",2,"Nordeste",27004,"Batalha",96452,8916.73812704765,18,32,17,15,12,20,0,0,0,0,0,32,17,15,12,20,14,9.09568547787226,11.4768007542516,0.377034910242073,2020-05-04,2020,5
"151","AL",2,"Nordeste",27004,"Batalha",96452,8916.73812704765,19,29,17,12,16,13,0,0,0,0,0,29,17,12,16,13,12,9.09568547787226,11.4768007542516,0.409097216831784,2020-05-11,2020,5
"152","AL",2,"Nordeste",27004,"Batalha",96452,8916.73812704765,20,29,20,9,16,13,1,1,0,0,1,30,21,9,16,14,10,9.09568547787226,11.4768007542516,0.396770072805712,2020-05-18,2020,5
"153","AL",2,"Nordeste",27004,"Batalha",96452,8916.73812704765,21,24,13,11,13,11,0,0,0,0,0,24,13,11,13,11,20,9.09568547787226,11.4768007542516,0.406629869884078,2020-05-25,2020,5
"154","AL",2,"Nordeste",27005,"Palmeira dos Índios",179333,10066.4435036496,5,60,28,32,31,29,0,0,0,0,0,60,28,32,31,29,21,9.2169627459375,12.096999691738,0.270609649374381,2020-02-03,2020,2
"155","AL",2,"Nordeste",27005,"Palmeira dos Índios",179333,10066.4435036496,6,45,13,32,17,28,0,0,0,0,0,45,13,32,17,28,29,9.2169627459375,12.096999691738,0.265305629446543,2020-02-10,2020,2
"156","AL",2,"Nordeste",27005,"Palmeira dos Índios",179333,10066.4435036496,7,41,14,27,22,19,0,0,0,0,0,41,14,27,22,19,18,9.2169627459375,12.096999691738,0.279402245266177,2020-02-17,2020,2
"157","AL",2,"Nordeste",27005,"Palmeira dos Índios",179333,10066.4435036496,8,49,18,31,20,29,0,0,0,0,0,49,18,31,20,29,27,9.2169627459375,12.096999691738,0.323213474201559,2020-02-24,2020,2
"158","AL",2,"Nordeste",27005,"Palmeira dos Índios",179333,10066.4435036496,9,39,18,21,26,13,0,0,0,0,0,39,18,21,26,13,26,9.2169627459375,12.096999691738,0.297189225867694,2020-03-02,2020,3
"159","AL",2,"Nordeste",27005,"Palmeira dos Índios",179333,10066.4435036496,10,37,14,23,20,17,0,0,0,0,0,37,14,23,20,17,25,9.2169627459375,12.096999691738,0.327603799851527,2020-03-09,2020,3
"160","AL",2,"Nordeste",27005,"Palmeira dos Índios",179333,10066.4435036496,11,50,18,32,28,22,0,0,0,0,0,50,18,32,28,22,22,9.2169627459375,12.096999691738,0.381283735655891,2020-03-16,2020,3
"161","AL",2,"Nordeste",27005,"Palmeira dos Índios",179333,10066.4435036496,12,40,17,23,16,24,1,1,0,1,0,41,18,23,17,24,26,9.2169627459375,12.096999691738,0.480937281895947,2020-03-23,2020,3
"162","AL",2,"Nordeste",27005,"Palmeira dos Índios",179333,10066.4435036496,13,35,20,15,21,14,0,0,0,0,0,35,20,15,21,14,24,9.2169627459375,12.096999691738,0.422706468125757,2020-03-30,2020,3
"163","AL",2,"Nordeste",27005,"Palmeira dos Índios",179333,10066.4435036496,14,40,12,28,18,22,0,0,0,0,0,40,12,28,18,22,20,9.2169627459375,12.096999691738,0.411588229210404,2020-04-06,2020,4
"164","AL",2,"Nordeste",27005,"Palmeira dos Índios",179333,10066.4435036496,15,45,17,28,20,25,0,0,0,0,0,45,17,28,20,25,26,9.2169627459375,12.096999691738,0.389567684029685,2020-04-13,2020,4
"165","AL",2,"Nordeste",27005,"Palmeira dos Índios",179333,10066.4435036496,16,59,20,39,24,35,0,0,0,0,0,59,20,39,24,35,23,9.2169627459375,12.096999691738,0.389783019900571,2020-04-20,2020,4
"166","AL",2,"Nordeste",27005,"Palmeira dos Índios",179333,10066.4435036496,17,41,19,22,22,19,1,0,1,0,1,42,19,23,22,20,23,9.2169627459375,12.096999691738,0.390126009248935,2020-04-27,2020,4
"167","AL",2,"Nordeste",27005,"Palmeira dos Índios",179333,10066.4435036496,18,43,19,24,19,24,0,0,0,0,0,43,19,24,19,24,25,9.2169627459375,12.096999691738,0.397147468697187,2020-05-04,2020,5
"168","AL",2,"Nordeste",27005,"Palmeira dos Índios",179333,10066.4435036496,19,42,17,25,14,28,1,0,1,0,1,43,17,26,14,29,37,9.2169627459375,12.096999691738,0.423921224778856,2020-05-11,2020,5
"169","AL",2,"Nordeste",27005,"Palmeira dos Índios",179333,10066.4435036496,20,49,14,35,21,28,0,0,0,0,0,49,14,35,21,28,32,9.2169627459375,12.096999691738,0.42978086013393,2020-05-18,2020,5
"170","AL",2,"Nordeste",27005,"Palmeira dos Índios",179333,10066.4435036496,21,33,13,20,14,19,1,1,0,0,1,34,14,20,14,20,40,9.2169627459375,12.096999691738,0.431827889509682,2020-05-25,2020,5
"171","AL",2,"Nordeste",27006,"Arapiraca",441885,15636.3566348484,5,111,52,59,48,63,0,0,0,0,0,111,52,59,48,63,56,9.6573540352258,12.9988049462114,0.274493564762638,2020-02-03,2020,2
"172","AL",2,"Nordeste",27006,"Arapiraca",441885,15636.3566348484,6,116,45,71,47,69,1,1,0,1,0,117,46,71,48,69,48,9.6573540352258,12.9988049462114,0.268055857551107,2020-02-10,2020,2
"173","AL",2,"Nordeste",27006,"Arapiraca",441885,15636.3566348484,7,115,59,56,52,63,1,1,0,0,1,116,60,56,52,64,58,9.6573540352258,12.9988049462114,0.283327895616615,2020-02-17,2020,2
"174","AL",2,"Nordeste",27006,"Arapiraca",441885,15636.3566348484,8,145,58,87,64,81,0,0,0,0,0,145,58,87,64,81,62,9.6573540352258,12.9988049462114,0.327421170883259,2020-02-24,2020,2
"175","AL",2,"Nordeste",27006,"Arapiraca",441885,15636.3566348484,9,131,56,75,64,67,0,0,0,0,0,131,56,75,64,67,58,9.6573540352258,12.9988049462114,0.298663256169895,2020-03-02,2020,3
"176","AL",2,"Nordeste",27006,"Arapiraca",441885,15636.3566348484,10,111,41,70,44,67,0,0,0,0,0,111,41,70,44,67,50,9.6573540352258,12.9988049462114,0.324344317459217,2020-03-09,2020,3
"177","AL",2,"Nordeste",27006,"Arapiraca",441885,15636.3566348484,11,115,50,65,51,64,0,0,0,0,0,115,50,65,51,64,59,9.6573540352258,12.9988049462114,0.374609992164612,2020-03-16,2020,3
"178","AL",2,"Nordeste",27006,"Arapiraca",441885,15636.3566348484,12,113,51,62,51,62,0,0,0,0,0,113,51,62,51,62,58,9.6573540352258,12.9988049462114,0.483910615240191,2020-03-23,2020,3
"179","AL",2,"Nordeste",27006,"Arapiraca",441885,15636.3566348484,13,100,44,56,54,46,0,0,0,0,0,100,44,56,54,46,52,9.6573540352258,12.9988049462114,0.427956168042681,2020-03-30,2020,3
"180","AL",2,"Nordeste",27006,"Arapiraca",441885,15636.3566348484,14,117,42,75,43,74,0,0,0,0,0,117,42,75,43,74,61,9.6573540352258,12.9988049462114,0.400466350060022,2020-04-06,2020,4
"181","AL",2,"Nordeste",27006,"Arapiraca",441885,15636.3566348484,15,138,62,76,60,78,0,0,0,0,0,138,62,76,60,78,58,9.6573540352258,12.9988049462114,0.389160312435767,2020-04-13,2020,4
"182","AL",2,"Nordeste",27006,"Arapiraca",441885,15636.3566348484,16,125,53,72,59,66,0,0,0,0,0,125,53,72,59,66,47,9.6573540352258,12.9988049462114,0.394284437605361,2020-04-20,2020,4
"183","AL",2,"Nordeste",27006,"Arapiraca",441885,15636.3566348484,17,130,66,64,46,84,0,0,0,0,0,130,66,64,46,84,51,9.6573540352258,12.9988049462114,0.380458793052609,2020-04-27,2020,4
"184","AL",2,"Nordeste",27006,"Arapiraca",441885,15636.3566348484,18,128,65,63,44,84,0,0,0,0,0,128,65,63,44,84,69,9.6573540352258,12.9988049462114,0.391101842589814,2020-05-04,2020,5
"185","AL",2,"Nordeste",27006,"Arapiraca",441885,15636.3566348484,19,130,54,76,54,76,0,0,0,0,0,130,54,76,54,76,65,9.6573540352258,12.9988049462114,0.412665216621271,2020-05-11,2020,5
"186","AL",2,"Nordeste",27006,"Arapiraca",441885,15636.3566348484,20,150,67,83,64,86,0,0,0,0,0,150,67,83,64,86,68,9.6573540352258,12.9988049462114,0.413300514572622,2020-05-18,2020,5
"187","AL",2,"Nordeste",27006,"Arapiraca",441885,15636.3566348484,21,129,58,71,66,63,0,0,0,0,0,129,58,71,66,63,96,9.6573540352258,12.9988049462114,0.414418172912839,2020-05-25,2020,5
"188","AL",2,"Nordeste",27008,"Serrana dos Quilombos",152009,19491.6495033847,5,36,16,20,17,19,2,1,1,1,1,38,17,21,18,20,20,9.87774142223927,11.9316950086019,0.271409239277508,2020-02-03,2020,2
"189","AL",2,"Nordeste",27008,"Serrana dos Quilombos",152009,19491.6495033847,6,47,21,26,25,22,0,0,0,0,0,47,21,26,25,22,13,9.87774142223927,11.9316950086019,0.269392061147859,2020-02-10,2020,2
"190","AL",2,"Nordeste",27008,"Serrana dos Quilombos",152009,19491.6495033847,7,56,22,34,35,21,0,0,0,0,0,56,22,34,35,21,18,9.87774142223927,11.9316950086019,0.284488986815048,2020-02-17,2020,2
"191","AL",2,"Nordeste",27008,"Serrana dos Quilombos",152009,19491.6495033847,8,41,19,22,25,16,0,0,0,0,0,41,19,22,25,16,22,9.87774142223927,11.9316950086019,0.340275349550344,2020-02-24,2020,2
"192","AL",2,"Nordeste",27008,"Serrana dos Quilombos",152009,19491.6495033847,9,43,19,24,18,25,0,0,0,0,0,43,19,24,18,25,18,9.87774142223927,11.9316950086019,0.303598448319982,2020-03-02,2020,3
"193","AL",2,"Nordeste",27008,"Serrana dos Quilombos",152009,19491.6495033847,10,46,17,29,22,24,0,0,0,0,0,46,17,29,22,24,19,9.87774142223927,11.9316950086019,0.322031225443305,2020-03-09,2020,3
"194","AL",2,"Nordeste",27008,"Serrana dos Quilombos",152009,19491.6495033847,11,42,16,26,18,24,0,0,0,0,0,42,16,26,18,24,24,9.87774142223927,11.9316950086019,0.368584815381581,2020-03-16,2020,3
"195","AL",2,"Nordeste",27008,"Serrana dos Quilombos",152009,19491.6495033847,12,46,26,20,23,23,0,0,0,0,0,46,26,20,23,23,18,9.87774142223927,11.9316950086019,0.47125032427213,2020-03-23,2020,3
"196","AL",2,"Nordeste",27008,"Serrana dos Quilombos",152009,19491.6495033847,13,34,11,23,14,20,0,0,0,0,0,34,11,23,14,20,17,9.87774142223927,11.9316950086019,0.423780449857879,2020-03-30,2020,3
"197","AL",2,"Nordeste",27008,"Serrana dos Quilombos",152009,19491.6495033847,14,39,20,19,21,18,0,0,0,0,0,39,20,19,21,18,27,9.87774142223927,11.9316950086019,0.406602815226981,2020-04-06,2020,4
"198","AL",2,"Nordeste",27008,"Serrana dos Quilombos",152009,19491.6495033847,15,38,18,20,23,15,0,0,0,0,0,38,18,20,23,15,23,9.87774142223927,11.9316950086019,0.397456238490313,2020-04-13,2020,4
"199","AL",2,"Nordeste",27008,"Serrana dos Quilombos",152009,19491.6495033847,16,36,16,20,19,17,0,0,0,0,0,36,16,20,19,17,19,9.87774142223927,11.9316950086019,0.392258213599673,2020-04-20,2020,4
"200","AL",2,"Nordeste",27008,"Serrana dos Quilombos",152009,19491.6495033847,17,49,21,28,34,15,1,0,1,1,0,50,21,29,35,15,23,9.87774142223927,11.9316950086019,0.383927675145018,2020-04-27,2020,4
"201","AL",2,"Nordeste",27008,"Serrana dos Quilombos",152009,19491.6495033847,18,51,23,28,25,26,0,0,0,0,0,51,23,28,25,26,31,9.87774142223927,11.9316950086019,0.398935604165704,2020-05-04,2020,5
"202","AL",2,"Nordeste",27008,"Serrana dos Quilombos",152009,19491.6495033847,19,38,18,20,26,12,1,1,0,0,1,39,19,20,26,13,33,9.87774142223927,11.9316950086019,0.435898443710758,2020-05-11,2020,5
"203","AL",2,"Nordeste",27008,"Serrana dos Quilombos",152009,19491.6495033847,20,37,22,15,20,17,2,0,2,1,1,39,22,17,21,18,29,9.87774142223927,11.9316950086019,0.430868468654781,2020-05-18,2020,5
"204","AL",2,"Nordeste",27008,"Serrana dos Quilombos",152009,19491.6495033847,21,52,26,26,33,19,0,0,0,0,0,52,26,26,33,19,30,9.87774142223927,11.9316950086019,0.424831983194198,2020-05-25,2020,5
"205","AL",2,"Nordeste",27009,"Mata Alagoana",318641,13734.4879831221,5,86,41,45,48,38,0,0,0,0,0,86,41,45,48,38,31,9.52766531957621,12.6718203561885,0.282572452364825,2020-02-03,2020,2
"206","AL",2,"Nordeste",27009,"Mata Alagoana",318641,13734.4879831221,6,99,41,58,62,37,1,1,0,1,0,100,42,58,63,37,27,9.52766531957621,12.6718203561885,0.275991500863209,2020-02-10,2020,2
"207","AL",2,"Nordeste",27009,"Mata Alagoana",318641,13734.4879831221,7,86,35,51,53,33,1,0,1,0,1,87,35,52,53,34,33,9.52766531957621,12.6718203561885,0.29363368383909,2020-02-17,2020,2
"208","AL",2,"Nordeste",27009,"Mata Alagoana",318641,13734.4879831221,8,75,35,40,43,32,2,2,0,2,0,77,37,40,45,32,40,9.52766531957621,12.6718203561885,0.339836258755698,2020-02-24,2020,2
"209","AL",2,"Nordeste",27009,"Mata Alagoana",318641,13734.4879831221,9,76,43,33,42,34,1,0,1,0,1,77,43,34,42,35,40,9.52766531957621,12.6718203561885,0.31101445212112,2020-03-02,2020,3
"210","AL",2,"Nordeste",27009,"Mata Alagoana",318641,13734.4879831221,10,51,25,26,30,21,1,0,1,0,1,52,25,27,30,22,46,9.52766531957621,12.6718203561885,0.335083249923041,2020-03-09,2020,3
"211","AL",2,"Nordeste",27009,"Mata Alagoana",318641,13734.4879831221,11,70,39,31,42,28,0,0,0,0,0,70,39,31,42,28,31,9.52766531957621,12.6718203561885,0.379695028335323,2020-03-16,2020,3
"212","AL",2,"Nordeste",27009,"Mata Alagoana",318641,13734.4879831221,12,51,30,21,26,25,1,1,0,0,1,52,31,21,26,26,35,9.52766531957621,12.6718203561885,0.479187482038911,2020-03-23,2020,3
"213","AL",2,"Nordeste",27009,"Mata Alagoana",318641,13734.4879831221,13,52,20,32,28,24,0,0,0,0,0,52,20,32,28,24,51,9.52766531957621,12.6718203561885,0.42522947499304,2020-03-30,2020,3
"214","AL",2,"Nordeste",27009,"Mata Alagoana",318641,13734.4879831221,14,66,38,28,37,29,0,0,0,0,0,66,38,28,37,29,30,9.52766531957621,12.6718203561885,0.409745449722137,2020-04-06,2020,4
"215","AL",2,"Nordeste",27009,"Mata Alagoana",318641,13734.4879831221,15,70,32,38,38,32,0,0,0,0,0,70,32,38,38,32,29,9.52766531957621,12.6718203561885,0.402778274947482,2020-04-13,2020,4
"216","AL",2,"Nordeste",27009,"Mata Alagoana",318641,13734.4879831221,16,64,35,29,38,26,2,2,0,1,1,66,37,29,39,27,39,9.52766531957621,12.6718203561885,0.406852695330155,2020-04-20,2020,4
"217","AL",2,"Nordeste",27009,"Mata Alagoana",318641,13734.4879831221,17,83,44,39,46,37,1,0,1,1,0,84,44,40,47,37,42,9.52766531957621,12.6718203561885,0.396130382004131,2020-04-27,2020,4
"218","AL",2,"Nordeste",27009,"Mata Alagoana",318641,13734.4879831221,18,78,44,34,48,30,0,0,0,0,0,78,44,34,48,30,43,9.52766531957621,12.6718203561885,0.407533035021136,2020-05-04,2020,5
"219","AL",2,"Nordeste",27009,"Mata Alagoana",318641,13734.4879831221,19,75,32,43,40,35,1,1,0,0,1,76,33,43,40,36,57,9.52766531957621,12.6718203561885,0.434159401267505,2020-05-11,2020,5
"220","AL",2,"Nordeste",27009,"Mata Alagoana",318641,13734.4879831221,20,89,46,43,56,33,0,0,0,0,0,89,46,43,56,33,72,9.52766531957621,12.6718203561885,0.44241029674081,2020-05-18,2020,5
"221","AL",2,"Nordeste",27009,"Mata Alagoana",318641,13734.4879831221,21,84,38,46,48,36,2,2,0,0,2,86,40,46,48,38,91,9.52766531957621,12.6718203561885,0.437320200998631,2020-05-25,2020,5
"222","AL",2,"Nordeste",27010,"Litoral Norte Alagoano",72407,19252.8932880799,5,20,8,12,7,13,0,0,0,0,0,20,8,12,7,13,7,9.86541662910139,11.190058258783,0.263356881969926,2020-02-03,2020,2
"223","AL",2,"Nordeste",27010,"Litoral Norte Alagoano",72407,19252.8932880799,6,14,6,8,10,4,0,0,0,0,0,14,6,8,10,4,11,9.86541662910139,11.190058258783,0.263456000881014,2020-02-10,2020,2
"224","AL",2,"Nordeste",27010,"Litoral Norte Alagoano",72407,19252.8932880799,7,21,11,10,14,7,0,0,0,0,0,21,11,10,14,7,8,9.86541662910139,11.190058258783,0.277108720694568,2020-02-17,2020,2
"225","AL",2,"Nordeste",27010,"Litoral Norte Alagoano",72407,19252.8932880799,8,22,10,12,13,9,0,0,0,0,0,22,10,12,13,9,10,9.86541662910139,11.190058258783,0.305844543759987,2020-02-24,2020,2
"226","AL",2,"Nordeste",27010,"Litoral Norte Alagoano",72407,19252.8932880799,9,20,12,8,11,9,2,2,0,1,1,22,14,8,12,10,5,9.86541662910139,11.190058258783,0.293033955170172,2020-03-02,2020,3
"227","AL",2,"Nordeste",27010,"Litoral Norte Alagoano",72407,19252.8932880799,10,19,7,12,13,6,0,0,0,0,0,19,7,12,13,6,10,9.86541662910139,11.190058258783,0.327514679080823,2020-03-09,2020,3
"228","AL",2,"Nordeste",27010,"Litoral Norte Alagoano",72407,19252.8932880799,11,19,9,10,15,4,0,0,0,0,0,19,9,10,15,4,8,9.86541662910139,11.190058258783,0.377589661115549,2020-03-16,2020,3
"229","AL",2,"Nordeste",27010,"Litoral Norte Alagoano",72407,19252.8932880799,12,19,10,9,8,11,0,0,0,0,0,19,10,9,8,11,11,9.86541662910139,11.190058258783,0.484012844687409,2020-03-23,2020,3
"230","AL",2,"Nordeste",27010,"Litoral Norte Alagoano",72407,19252.8932880799,13,17,11,6,12,5,0,0,0,0,0,17,11,6,12,5,6,9.86541662910139,11.190058258783,0.456044287431441,2020-03-30,2020,3
"231","AL",2,"Nordeste",27010,"Litoral Norte Alagoano",72407,19252.8932880799,14,13,5,8,9,4,0,0,0,0,0,13,5,8,9,4,5,9.86541662910139,11.190058258783,0.429453946821439,2020-04-06,2020,4
"232","AL",2,"Nordeste",27010,"Litoral Norte Alagoano",72407,19252.8932880799,15,18,5,13,10,8,0,0,0,0,0,18,5,13,10,8,10,9.86541662910139,11.190058258783,0.429228988493078,2020-04-13,2020,4
"233","AL",2,"Nordeste",27010,"Litoral Norte Alagoano",72407,19252.8932880799,16,22,12,10,13,9,0,0,0,0,0,22,12,10,13,9,8,9.86541662910139,11.190058258783,0.430685380620405,2020-04-20,2020,4
"234","AL",2,"Nordeste",27010,"Litoral Norte Alagoano",72407,19252.8932880799,17,19,11,8,11,8,0,0,0,0,0,19,11,8,11,8,5,9.86541662910139,11.190058258783,0.417027870516792,2020-04-27,2020,4
"235","AL",2,"Nordeste",27010,"Litoral Norte Alagoano",72407,19252.8932880799,18,23,14,9,16,7,0,0,0,0,0,23,14,9,16,7,9,9.86541662910139,11.190058258783,0.441490972239463,2020-05-04,2020,5
"236","AL",2,"Nordeste",27010,"Litoral Norte Alagoano",72407,19252.8932880799,19,21,3,18,9,12,0,0,0,0,0,21,3,18,9,12,15,9.86541662910139,11.190058258783,0.469917535619712,2020-05-11,2020,5
"237","AL",2,"Nordeste",27010,"Litoral Norte Alagoano",72407,19252.8932880799,20,30,10,20,13,17,0,0,0,0,0,30,10,20,13,17,14,9.86541662910139,11.190058258783,0.471345598096524,2020-05-18,2020,5
"238","AL",2,"Nordeste",27010,"Litoral Norte Alagoano",72407,19252.8932880799,21,26,13,13,15,11,0,0,0,0,0,26,13,13,15,11,13,9.86541662910139,11.190058258783,0.450423035343949,2020-05-25,2020,5
"239","AL",2,"Nordeste",27011,"Maceió",1253244,21638.4805318837,5,348,115,233,161,187,2,0,2,1,1,350,115,235,162,188,163,9.98222851477816,14.0412459475619,0.258210210386811,2020-02-03,2020,2
"240","AL",2,"Nordeste",27011,"Maceió",1253244,21638.4805318837,6,313,80,233,129,184,1,0,1,1,0,314,80,234,130,184,171,9.98222851477816,14.0412459475619,0.260674634127927,2020-02-10,2020,2
"241","AL",2,"Nordeste",27011,"Maceió",1253244,21638.4805318837,7,338,120,218,166,172,3,0,3,3,0,341,120,221,169,172,144,9.98222851477816,14.0412459475619,0.281541862833867,2020-02-17,2020,2
"242","AL",2,"Nordeste",27011,"Maceió",1253244,21638.4805318837,8,314,93,221,155,159,3,2,1,0,3,317,95,222,155,162,159,9.98222851477816,14.0412459475619,0.343578279848042,2020-02-24,2020,2
"243","AL",2,"Nordeste",27011,"Maceió",1253244,21638.4805318837,9,285,80,205,129,156,0,0,0,0,0,285,80,205,129,156,167,9.98222851477816,14.0412459475619,0.299951388801049,2020-03-02,2020,3
"244","AL",2,"Nordeste",27011,"Maceió",1253244,21638.4805318837,10,313,108,205,149,164,3,1,2,3,0,316,109,207,152,164,160,9.98222851477816,14.0412459475619,0.312813107821658,2020-03-09,2020,3
"245","AL",2,"Nordeste",27011,"Maceió",1253244,21638.4805318837,11,301,105,196,131,170,2,1,1,1,1,303,106,197,132,171,146,9.98222851477816,14.0412459475619,0.401091538568094,2020-03-16,2020,3
"246","AL",2,"Nordeste",27011,"Maceió",1253244,21638.4805318837,12,280,95,185,138,142,3,2,1,2,1,283,97,186,140,143,126,9.98222851477816,14.0412459475619,0.548307199879887,2020-03-23,2020,3
"247","AL",2,"Nordeste",27011,"Maceió",1253244,21638.4805318837,13,259,91,168,132,127,3,2,1,1,2,262,93,169,133,129,161,9.98222851477816,14.0412459475619,0.489264149706929,2020-03-30,2020,3
"248","AL",2,"Nordeste",27011,"Maceió",1253244,21638.4805318837,14,317,105,212,157,160,1,1,0,0,1,318,106,212,157,161,172,9.98222851477816,14.0412459475619,0.471602071606016,2020-04-06,2020,4
"249","AL",2,"Nordeste",27011,"Maceió",1253244,21638.4805318837,15,286,103,183,141,145,0,0,0,0,0,286,103,183,141,145,161,9.98222851477816,14.0412459475619,0.455063386161155,2020-04-13,2020,4
"250","AL",2,"Nordeste",27011,"Maceió",1253244,21638.4805318837,16,271,84,187,135,136,1,1,0,0,1,272,85,187,135,137,166,9.98222851477816,14.0412459475619,0.470632239315319,2020-04-20,2020,4
"251","AL",2,"Nordeste",27011,"Maceió",1253244,21638.4805318837,17,281,107,174,138,143,5,3,2,2,3,286,110,176,140,146,210,9.98222851477816,14.0412459475619,0.458963213584475,2020-04-27,2020,4
"252","AL",2,"Nordeste",27011,"Maceió",1253244,21638.4805318837,18,301,86,215,151,150,4,1,3,2,2,305,87,218,153,152,318,9.98222851477816,14.0412459475619,0.447665318189323,2020-05-04,2020,5
"253","AL",2,"Nordeste",27011,"Maceió",1253244,21638.4805318837,19,299,99,200,137,162,1,1,0,0,1,300,100,200,137,163,320,9.98222851477816,14.0412459475619,0.474416695531969,2020-05-11,2020,5
"254","AL",2,"Nordeste",27011,"Maceió",1253244,21638.4805318837,20,310,104,206,139,171,4,2,2,2,2,314,106,208,141,173,374,9.98222851477816,14.0412459475619,0.476276795177717,2020-05-18,2020,5
"255","AL",2,"Nordeste",27011,"Maceió",1253244,21638.4805318837,21,323,101,222,150,173,2,0,2,1,1,325,101,224,151,174,374,9.98222851477816,14.0412459475619,0.464735729810324,2020-05-25,2020,5
"256","AL",2,"Nordeste",27012,"São Miguel dos Campos",308789,14469.5863651879,5,69,20,49,37,32,2,2,0,1,1,71,22,49,38,33,24,9.57980423353539,12.6404134747366,0.270028199517831,2020-02-03,2020,2
"257","AL",2,"Nordeste",27012,"São Miguel dos Campos",308789,14469.5863651879,6,72,26,46,41,31,1,1,0,0,1,73,27,46,41,32,35,9.57980423353539,12.6404134747366,0.262204784428159,2020-02-10,2020,2
"258","AL",2,"Nordeste",27012,"São Miguel dos Campos",308789,14469.5863651879,7,61,20,41,29,32,0,0,0,0,0,61,20,41,29,32,35,9.57980423353539,12.6404134747366,0.277784181764519,2020-02-17,2020,2
"259","AL",2,"Nordeste",27012,"São Miguel dos Campos",308789,14469.5863651879,8,69,22,47,40,29,2,1,1,0,2,71,23,48,40,31,36,9.57980423353539,12.6404134747366,0.323014932166411,2020-02-24,2020,2
"260","AL",2,"Nordeste",27012,"São Miguel dos Campos",308789,14469.5863651879,9,70,26,44,32,38,1,1,0,0,1,71,27,44,32,39,28,9.57980423353539,12.6404134747366,0.300245941398157,2020-03-02,2020,3
"261","AL",2,"Nordeste",27012,"São Miguel dos Campos",308789,14469.5863651879,10,53,18,35,28,25,1,1,0,0,1,54,19,35,28,26,34,9.57980423353539,12.6404134747366,0.3269178576817,2020-03-09,2020,3
"262","AL",2,"Nordeste",27012,"São Miguel dos Campos",308789,14469.5863651879,11,49,11,38,23,26,0,0,0,0,0,49,11,38,23,26,34,9.57980423353539,12.6404134747366,0.380992952129277,2020-03-16,2020,3
"263","AL",2,"Nordeste",27012,"São Miguel dos Campos",308789,14469.5863651879,12,60,20,40,32,28,1,1,0,0,1,61,21,40,32,29,35,9.57980423353539,12.6404134747366,0.469922127444587,2020-03-23,2020,3
"264","AL",2,"Nordeste",27012,"São Miguel dos Campos",308789,14469.5863651879,13,60,23,37,32,28,0,0,0,0,0,60,23,37,32,28,41,9.57980423353539,12.6404134747366,0.420854387295379,2020-03-30,2020,3
"265","AL",2,"Nordeste",27012,"São Miguel dos Campos",308789,14469.5863651879,14,77,33,44,30,47,1,0,1,0,1,78,33,45,30,48,29,9.57980423353539,12.6404134747366,0.39221602522619,2020-04-06,2020,4
"266","AL",2,"Nordeste",27012,"São Miguel dos Campos",308789,14469.5863651879,15,65,20,45,40,25,0,0,0,0,0,65,20,45,40,25,32,9.57980423353539,12.6404134747366,0.385257244989692,2020-04-13,2020,4
"267","AL",2,"Nordeste",27012,"São Miguel dos Campos",308789,14469.5863651879,16,69,24,45,31,38,0,0,0,0,0,69,24,45,31,38,34,9.57980423353539,12.6404134747366,0.392709681057691,2020-04-20,2020,4
"268","AL",2,"Nordeste",27012,"São Miguel dos Campos",308789,14469.5863651879,17,61,25,36,35,26,0,0,0,0,0,61,25,36,35,26,35,9.57980423353539,12.6404134747366,0.377520059380834,2020-04-27,2020,4
"269","AL",2,"Nordeste",27012,"São Miguel dos Campos",308789,14469.5863651879,18,72,34,38,39,33,1,0,1,0,1,73,34,39,39,34,48,9.57980423353539,12.6404134747366,0.391364847887675,2020-05-04,2020,5
"270","AL",2,"Nordeste",27012,"São Miguel dos Campos",308789,14469.5863651879,19,66,30,36,35,31,1,0,1,0,1,67,30,37,35,32,45,9.57980423353539,12.6404134747366,0.417748041554745,2020-05-11,2020,5
"271","AL",2,"Nordeste",27012,"São Miguel dos Campos",308789,14469.5863651879,20,81,27,54,45,36,0,0,0,0,0,81,27,54,45,36,43,9.57980423353539,12.6404134747366,0.425213825899363,2020-05-18,2020,5
"272","AL",2,"Nordeste",27012,"São Miguel dos Campos",308789,14469.5863651879,21,64,29,35,30,34,0,0,0,0,0,64,29,35,30,34,54,9.57980423353539,12.6404134747366,0.416268787854557,2020-05-25,2020,5
"273","AL",2,"Nordeste",27013,"Penedo",131171,13187.4847863476,5,35,14,21,14,21,1,0,1,0,1,36,14,22,14,22,11,9.48702353657587,11.7842570944746,0.28437470587731,2020-02-03,2020,2
"274","AL",2,"Nordeste",27013,"Penedo",131171,13187.4847863476,6,34,19,15,11,23,0,0,0,0,0,34,19,15,11,23,20,9.48702353657587,11.7842570944746,0.283728940339241,2020-02-10,2020,2
"275","AL",2,"Nordeste",27013,"Penedo",131171,13187.4847863476,7,32,13,19,16,16,0,0,0,0,0,32,13,19,16,16,20,9.48702353657587,11.7842570944746,0.293828827261657,2020-02-17,2020,2
"276","AL",2,"Nordeste",27013,"Penedo",131171,13187.4847863476,8,37,13,24,14,23,0,0,0,0,0,37,13,24,14,23,25,9.48702353657587,11.7842570944746,0.347538700867875,2020-02-24,2020,2
"277","AL",2,"Nordeste",27013,"Penedo",131171,13187.4847863476,9,29,14,15,13,16,1,0,1,0,1,30,14,16,13,17,14,9.48702353657587,11.7842570944746,0.314145648394481,2020-03-02,2020,3
"278","AL",2,"Nordeste",27013,"Penedo",131171,13187.4847863476,10,29,7,22,12,17,0,0,0,0,0,29,7,22,12,17,16,9.48702353657587,11.7842570944746,0.339336590712363,2020-03-09,2020,3
"279","AL",2,"Nordeste",27013,"Penedo",131171,13187.4847863476,11,33,10,23,19,14,0,0,0,0,0,33,10,23,19,14,8,9.48702353657587,11.7842570944746,0.402434712057634,2020-03-16,2020,3
"280","AL",2,"Nordeste",27013,"Penedo",131171,13187.4847863476,12,34,11,23,17,17,1,1,0,0,1,35,12,23,17,18,11,9.48702353657587,11.7842570944746,0.520080872008073,2020-03-23,2020,3
"281","AL",2,"Nordeste",27013,"Penedo",131171,13187.4847863476,13,34,15,19,14,20,0,0,0,0,0,34,15,19,14,20,15,9.48702353657587,11.7842570944746,0.451801017867626,2020-03-30,2020,3
"282","AL",2,"Nordeste",27013,"Penedo",131171,13187.4847863476,14,35,13,22,23,12,0,0,0,0,0,35,13,22,23,12,19,9.48702353657587,11.7842570944746,0.432487990900109,2020-04-06,2020,4
"283","AL",2,"Nordeste",27013,"Penedo",131171,13187.4847863476,15,43,17,26,25,18,0,0,0,0,0,43,17,26,25,18,14,9.48702353657587,11.7842570944746,0.425995687107435,2020-04-13,2020,4
"284","AL",2,"Nordeste",27013,"Penedo",131171,13187.4847863476,16,29,15,14,21,8,1,0,1,1,0,30,15,15,22,8,16,9.48702353657587,11.7842570944746,0.427762275555502,2020-04-20,2020,4
"285","AL",2,"Nordeste",27013,"Penedo",131171,13187.4847863476,17,36,17,19,19,17,0,0,0,0,0,36,17,19,19,17,19,9.48702353657587,11.7842570944746,0.414593415064259,2020-04-27,2020,4
"286","AL",2,"Nordeste",27013,"Penedo",131171,13187.4847863476,18,38,23,15,18,20,0,0,0,0,0,38,23,15,18,20,16,9.48702353657587,11.7842570944746,0.421759209240982,2020-05-04,2020,5
"287","AL",2,"Nordeste",27013,"Penedo",131171,13187.4847863476,19,37,23,14,13,24,0,0,0,0,0,37,23,14,13,24,17,9.48702353657587,11.7842570944746,0.441845022840955,2020-05-11,2020,5
"288","AL",2,"Nordeste",27013,"Penedo",131171,13187.4847863476,20,30,14,16,15,15,0,0,0,0,0,30,14,16,15,15,19,9.48702353657587,11.7842570944746,0.445225771188642,2020-05-18,2020,5
"289","AL",2,"Nordeste",27013,"Penedo",131171,13187.4847863476,21,29,16,13,16,13,1,1,0,1,0,30,17,13,17,13,28,9.48702353657587,11.7842570944746,0.439373262544849,2020-05-25,2020,5
"290","AM",1,"Norte",13001,"Rio Negro",119734,6667.95950774216,5,38,26,12,18,20,0,0,0,0,0,38,26,12,18,20,12,8.80506917122809,11.6930278946553,0.289917740487896,2020-02-03,2020,2
"291","AM",1,"Norte",13001,"Rio Negro",119734,6667.95950774216,6,41,19,22,22,19,0,0,0,0,0,41,19,22,22,19,13,8.80506917122809,11.6930278946553,0.299484118258624,2020-02-10,2020,2
"292","AM",1,"Norte",13001,"Rio Negro",119734,6667.95950774216,7,35,19,16,20,15,0,0,0,0,0,35,19,16,20,15,10,8.80506917122809,11.6930278946553,0.296495058394628,2020-02-17,2020,2
"293","AM",1,"Norte",13001,"Rio Negro",119734,6667.95950774216,8,56,28,28,30,26,1,0,1,1,0,57,28,29,31,26,10,8.80506917122809,11.6930278946553,0.346371230616126,2020-02-24,2020,2
"294","AM",1,"Norte",13001,"Rio Negro",119734,6667.95950774216,9,50,27,23,21,29,0,0,0,0,0,50,27,23,21,29,9,8.80506917122809,11.6930278946553,0.318465383409632,2020-03-02,2020,3
"295","AM",1,"Norte",13001,"Rio Negro",119734,6667.95950774216,10,39,23,16,19,20,2,2,0,2,0,41,25,16,21,20,13,8.80506917122809,11.6930278946553,0.333217142262035,2020-03-09,2020,3
"296","AM",1,"Norte",13001,"Rio Negro",119734,6667.95950774216,11,38,15,23,25,13,0,0,0,0,0,38,15,23,25,13,6,8.80506917122809,11.6930278946553,0.368865173670367,2020-03-16,2020,3
"297","AM",1,"Norte",13001,"Rio Negro",119734,6667.95950774216,12,34,21,13,18,16,0,0,0,0,0,34,21,13,18,16,8,8.80506917122809,11.6930278946553,0.444473671857305,2020-03-23,2020,3
"298","AM",1,"Norte",13001,"Rio Negro",119734,6667.95950774216,13,37,19,18,20,17,1,1,0,1,0,38,20,18,21,17,6,8.80506917122809,11.6930278946553,0.413466269431735,2020-03-30,2020,3
"299","AM",1,"Norte",13001,"Rio Negro",119734,6667.95950774216,14,30,17,13,15,15,0,0,0,0,0,30,17,13,15,15,8,8.80506917122809,11.6930278946553,0.42317117487384,2020-04-06,2020,4
"300","AM",1,"Norte",13001,"Rio Negro",119734,6667.95950774216,15,27,10,17,14,13,0,0,0,0,0,27,10,17,14,13,13,8.80506917122809,11.6930278946553,0.407120540125824,2020-04-13,2020,4
"301","AM",1,"Norte",13001,"Rio Negro",119734,6667.95950774216,16,39,18,21,17,22,2,1,1,2,0,41,19,22,19,22,9,8.80506917122809,11.6930278946553,0.444438624752838,2020-04-20,2020,4
"302","AM",1,"Norte",13001,"Rio Negro",119734,6667.95950774216,17,39,21,18,19,20,0,0,0,0,0,39,21,18,19,20,17,8.80506917122809,11.6930278946553,0.48702349178386,2020-04-27,2020,4
"303","AM",1,"Norte",13001,"Rio Negro",119734,6667.95950774216,18,35,13,22,20,15,0,0,0,0,0,35,13,22,20,15,27,8.80506917122809,11.6930278946553,0.475741798429062,2020-05-04,2020,5
"304","AM",1,"Norte",13001,"Rio Negro",119734,6667.95950774216,19,16,8,8,8,8,0,0,0,0,0,16,8,8,8,8,21,8.80506917122809,11.6930278946553,0.501776861138067,2020-05-11,2020,5
"305","AM",1,"Norte",13001,"Rio Negro",119734,6667.95950774216,20,39,22,17,18,21,0,0,0,0,0,39,22,17,18,21,25,8.80506917122809,11.6930278946553,0.457445388117379,2020-05-18,2020,5
"306","AM",1,"Norte",13001,"Rio Negro",119734,6667.95950774216,21,36,11,25,25,11,1,1,0,0,1,37,12,25,25,12,16,8.80506917122809,11.6930278946553,0.456582817906204,2020-05-25,2020,5
"307","AM",1,"Norte",13003,"Alto Solimões",254355,8124.70532106701,5,121,55,66,63,58,3,3,0,3,0,124,58,66,66,58,21,9.00266473836386,12.4464862080093,0.338878594743115,2020-02-03,2020,2
"308","AM",1,"Norte",13003,"Alto Solimões",254355,8124.70532106701,6,122,58,64,69,53,2,0,2,0,2,124,58,66,69,55,21,9.00266473836386,12.4464862080093,0.299881458201053,2020-02-10,2020,2
"309","AM",1,"Norte",13003,"Alto Solimões",254355,8124.70532106701,7,114,46,68,68,46,1,1,0,1,0,115,47,68,69,46,18,9.00266473836386,12.4464862080093,0.311830227673436,2020-02-17,2020,2
"310","AM",1,"Norte",13003,"Alto Solimões",254355,8124.70532106701,8,119,53,66,66,53,1,0,1,0,1,120,53,67,66,54,28,9.00266473836386,12.4464862080093,0.351810381432394,2020-02-24,2020,2
"311","AM",1,"Norte",13003,"Alto Solimões",254355,8124.70532106701,9,122,49,73,59,63,4,2,2,1,3,126,51,75,60,66,13,9.00266473836386,12.4464862080093,0.32955092385101,2020-03-02,2020,3
"312","AM",1,"Norte",13003,"Alto Solimões",254355,8124.70532106701,10,103,53,50,55,48,2,1,1,0,2,105,54,51,55,50,8,9.00266473836386,12.4464862080093,0.349586310470863,2020-03-09,2020,3
"313","AM",1,"Norte",13003,"Alto Solimões",254355,8124.70532106701,11,97,44,53,62,35,1,0,1,1,0,98,44,54,63,35,20,9.00266473836386,12.4464862080093,0.412462056955449,2020-03-16,2020,3
"314","AM",1,"Norte",13003,"Alto Solimões",254355,8124.70532106701,12,94,42,52,56,38,2,0,2,1,1,96,42,54,57,39,16,9.00266473836386,12.4464862080093,0.507883878489122,2020-03-23,2020,3
"315","AM",1,"Norte",13003,"Alto Solimões",254355,8124.70532106701,13,79,47,32,45,34,2,2,0,0,2,81,49,32,45,36,16,9.00266473836386,12.4464862080093,0.468395091035147,2020-03-30,2020,3
"316","AM",1,"Norte",13003,"Alto Solimões",254355,8124.70532106701,14,96,44,52,43,53,1,0,1,1,0,97,44,53,44,53,17,9.00266473836386,12.4464862080093,0.461411616183823,2020-04-06,2020,4
"317","AM",1,"Norte",13003,"Alto Solimões",254355,8124.70532106701,15,91,47,44,47,44,0,0,0,0,0,91,47,44,47,44,19,9.00266473836386,12.4464862080093,0.481892562263101,2020-04-13,2020,4
"318","AM",1,"Norte",13003,"Alto Solimões",254355,8124.70532106701,16,77,35,42,45,32,0,0,0,0,0,77,35,42,45,32,32,9.00266473836386,12.4464862080093,0.520613167621019,2020-04-20,2020,4
"319","AM",1,"Norte",13003,"Alto Solimões",254355,8124.70532106701,17,123,52,71,80,43,0,0,0,0,0,123,52,71,80,43,63,9.00266473836386,12.4464862080093,0.538953591670264,2020-04-27,2020,4
"320","AM",1,"Norte",13003,"Alto Solimões",254355,8124.70532106701,18,128,61,67,69,59,2,2,0,1,1,130,63,67,70,60,71,9.00266473836386,12.4464862080093,0.517703400332391,2020-05-04,2020,5
"321","AM",1,"Norte",13003,"Alto Solimões",254355,8124.70532106701,19,119,59,60,56,63,3,0,3,1,2,122,59,63,57,65,66,9.00266473836386,12.4464862080093,0.521470491311867,2020-05-11,2020,5
"322","AM",1,"Norte",13003,"Alto Solimões",254355,8124.70532106701,20,120,52,68,78,42,0,0,0,0,0,120,52,68,78,42,55,9.00266473836386,12.4464862080093,0.4849265463286,2020-05-18,2020,5
"323","AM",1,"Norte",13003,"Alto Solimões",254355,8124.70532106701,21,120,48,72,62,58,4,3,1,1,3,124,51,73,63,61,46,9.00266473836386,12.4464862080093,0.475080539177281,2020-05-25,2020,5
"324","AM",1,"Norte",13005,"Tefé",89457,14425.5955547358,5,60,25,35,35,25,0,0,0,0,0,60,25,35,35,25,8,9.57675937681422,11.401513341884,0.314149653233963,2020-02-03,2020,2
"325","AM",1,"Norte",13005,"Tefé",89457,14425.5955547358,6,56,32,24,36,20,0,0,0,0,0,56,32,24,36,20,4,9.57675937681422,11.401513341884,0.291514597350474,2020-02-10,2020,2
"326","AM",1,"Norte",13005,"Tefé",89457,14425.5955547358,7,46,17,29,28,18,0,0,0,0,0,46,17,29,28,18,2,9.57675937681422,11.401513341884,0.324474640206138,2020-02-17,2020,2
"327","AM",1,"Norte",13005,"Tefé",89457,14425.5955547358,8,41,19,22,24,17,1,0,1,0,1,42,19,23,24,18,7,9.57675937681422,11.401513341884,0.337467268162884,2020-02-24,2020,2
"328","AM",1,"Norte",13005,"Tefé",89457,14425.5955547358,9,55,25,30,31,24,2,0,2,2,0,57,25,32,33,24,3,9.57675937681422,11.401513341884,0.313257462175413,2020-03-02,2020,3
"329","AM",1,"Norte",13005,"Tefé",89457,14425.5955547358,10,41,15,26,28,13,0,0,0,0,0,41,15,26,28,13,4,9.57675937681422,11.401513341884,0.328166645277148,2020-03-09,2020,3
"330","AM",1,"Norte",13005,"Tefé",89457,14425.5955547358,11,58,29,29,41,17,0,0,0,0,0,58,29,29,41,17,8,9.57675937681422,11.401513341884,0.395611268619238,2020-03-16,2020,3
"331","AM",1,"Norte",13005,"Tefé",89457,14425.5955547358,12,49,27,22,35,14,0,0,0,0,0,49,27,22,35,14,3,9.57675937681422,11.401513341884,0.490753891619416,2020-03-23,2020,3
"332","AM",1,"Norte",13005,"Tefé",89457,14425.5955547358,13,37,20,17,21,16,1,0,1,0,1,38,20,18,21,17,10,9.57675937681422,11.401513341884,0.466801420738346,2020-03-30,2020,3
"333","AM",1,"Norte",13005,"Tefé",89457,14425.5955547358,14,46,26,20,28,18,0,0,0,0,0,46,26,20,28,18,11,9.57675937681422,11.401513341884,0.49946469843119,2020-04-06,2020,4
"334","AM",1,"Norte",13005,"Tefé",89457,14425.5955547358,15,34,18,16,25,9,0,0,0,0,0,34,18,16,25,9,7,9.57675937681422,11.401513341884,0.509412167364333,2020-04-13,2020,4
"335","AM",1,"Norte",13005,"Tefé",89457,14425.5955547358,16,45,20,25,28,17,0,0,0,0,0,45,20,25,28,17,12,9.57675937681422,11.401513341884,0.491830595791619,2020-04-20,2020,4
"336","AM",1,"Norte",13005,"Tefé",89457,14425.5955547358,17,39,22,17,28,11,3,3,0,2,1,42,25,17,30,12,21,9.57675937681422,11.401513341884,0.513977371404532,2020-04-27,2020,4
"337","AM",1,"Norte",13005,"Tefé",89457,14425.5955547358,18,49,21,28,31,18,1,1,0,1,0,50,22,28,32,18,25,9.57675937681422,11.401513341884,0.495327930822381,2020-05-04,2020,5
"338","AM",1,"Norte",13005,"Tefé",89457,14425.5955547358,19,63,26,37,39,24,0,0,0,0,0,63,26,37,39,24,33,9.57675937681422,11.401513341884,0.520773645925721,2020-05-11,2020,5
"339","AM",1,"Norte",13005,"Tefé",89457,14425.5955547358,20,52,23,29,31,21,1,1,0,1,0,53,24,29,32,21,23,9.57675937681422,11.401513341884,0.478184985693483,2020-05-18,2020,5
"340","AM",1,"Norte",13005,"Tefé",89457,14425.5955547358,21,48,22,26,37,11,1,0,1,0,1,49,22,27,37,12,17,9.57675937681422,11.401513341884,0.462716036809313,2020-05-25,2020,5
"341","AM",1,"Norte",13006,"Coari",183887,17645.4382085737,5,57,27,30,35,22,0,0,0,0,0,57,27,30,35,22,12,9.77823257051756,12.122076717501,0.319875536369535,2020-02-03,2020,2
"342","AM",1,"Norte",13006,"Coari",183887,17645.4382085737,6,55,32,23,31,24,0,0,0,0,0,55,32,23,31,24,13,9.77823257051756,12.122076717501,0.310799913154874,2020-02-10,2020,2
"343","AM",1,"Norte",13006,"Coari",183887,17645.4382085737,7,59,26,33,34,25,0,0,0,0,0,59,26,33,34,25,11,9.77823257051756,12.122076717501,0.317375631146649,2020-02-17,2020,2
"344","AM",1,"Norte",13006,"Coari",183887,17645.4382085737,8,65,34,31,41,24,0,0,0,0,0,65,34,31,41,24,6,9.77823257051756,12.122076717501,0.371468647223137,2020-02-24,2020,2
"345","AM",1,"Norte",13006,"Coari",183887,17645.4382085737,9,61,28,33,33,28,2,1,1,1,1,63,29,34,34,29,9,9.77823257051756,12.122076717501,0.339031705492193,2020-03-02,2020,3
"346","AM",1,"Norte",13006,"Coari",183887,17645.4382085737,10,46,23,23,29,17,0,0,0,0,0,46,23,23,29,17,16,9.77823257051756,12.122076717501,0.352484070785971,2020-03-09,2020,3
"347","AM",1,"Norte",13006,"Coari",183887,17645.4382085737,11,53,22,31,33,20,1,1,0,1,0,54,23,31,34,20,8,9.77823257051756,12.122076717501,0.399471677042951,2020-03-16,2020,3
"348","AM",1,"Norte",13006,"Coari",183887,17645.4382085737,12,58,25,33,31,27,1,0,1,0,1,59,25,34,31,28,7,9.77823257051756,12.122076717501,0.490853670728505,2020-03-23,2020,3
"349","AM",1,"Norte",13006,"Coari",183887,17645.4382085737,13,48,25,23,30,18,1,0,1,1,0,49,25,24,31,18,12,9.77823257051756,12.122076717501,0.458825998068707,2020-03-30,2020,3
"350","AM",1,"Norte",13006,"Coari",183887,17645.4382085737,14,47,20,27,28,19,0,0,0,0,0,47,20,27,28,19,16,9.77823257051756,12.122076717501,0.46730293385917,2020-04-06,2020,4
"351","AM",1,"Norte",13006,"Coari",183887,17645.4382085737,15,71,32,39,46,25,0,0,0,0,0,71,32,39,46,25,11,9.77823257051756,12.122076717501,0.470432260474949,2020-04-13,2020,4
"352","AM",1,"Norte",13006,"Coari",183887,17645.4382085737,16,57,32,25,36,21,3,2,1,3,0,60,34,26,39,21,24,9.77823257051756,12.122076717501,0.478759981721663,2020-04-20,2020,4
"353","AM",1,"Norte",13006,"Coari",183887,17645.4382085737,17,59,28,31,37,22,1,1,0,1,0,60,29,31,38,22,29,9.77823257051756,12.122076717501,0.483072107104292,2020-04-27,2020,4
"354","AM",1,"Norte",13006,"Coari",183887,17645.4382085737,18,44,16,28,26,18,0,0,0,0,0,44,16,28,26,18,50,9.77823257051756,12.122076717501,0.49444905599583,2020-05-04,2020,5
"355","AM",1,"Norte",13006,"Coari",183887,17645.4382085737,19,65,25,40,43,22,1,1,0,1,0,66,26,40,44,22,29,9.77823257051756,12.122076717501,0.511518385141721,2020-05-11,2020,5
"356","AM",1,"Norte",13006,"Coari",183887,17645.4382085737,20,78,43,35,49,29,1,0,1,0,1,79,43,36,49,30,35,9.77823257051756,12.122076717501,0.493259054341866,2020-05-18,2020,5
"357","AM",1,"Norte",13006,"Coari",183887,17645.4382085737,21,46,22,24,30,16,0,0,0,0,0,46,22,24,30,16,21,9.77823257051756,12.122076717501,0.452593594495884,2020-05-25,2020,5
"358","AM",1,"Norte",13007,"Manaus",2509626,33627.4858461221,5,833,226,607,363,470,6,0,6,3,3,839,226,613,366,473,251,10.4230990426808,14.7356442960217,0.310640910244477,2020-02-03,2020,2
"359","AM",1,"Norte",13007,"Manaus",2509626,33627.4858461221,6,767,184,583,365,402,7,2,5,1,6,774,186,588,366,408,273,10.4230990426808,14.7356442960217,0.308322326443744,2020-02-10,2020,2
"360","AM",1,"Norte",13007,"Manaus",2509626,33627.4858461221,7,797,185,612,361,436,6,3,3,4,2,803,188,615,365,438,219,10.4230990426808,14.7356442960217,0.323388208207684,2020-02-17,2020,2
"361","AM",1,"Norte",13007,"Manaus",2509626,33627.4858461221,8,819,212,607,377,442,10,5,5,6,4,829,217,612,383,446,227,10.4230990426808,14.7356442960217,0.373161743687169,2020-02-24,2020,2
"362","AM",1,"Norte",13007,"Manaus",2509626,33627.4858461221,9,756,186,570,349,407,15,4,11,4,11,771,190,581,353,418,235,10.4230990426808,14.7356442960217,0.34967313998835,2020-03-02,2020,3
"363","AM",1,"Norte",13007,"Manaus",2509626,33627.4858461221,10,768,164,604,349,419,3,2,1,1,2,771,166,605,350,421,255,10.4230990426808,14.7356442960217,0.368985555150016,2020-03-09,2020,3
"364","AM",1,"Norte",13007,"Manaus",2509626,33627.4858461221,11,816,208,608,353,463,10,6,4,1,9,826,214,612,354,472,235,10.4230990426808,14.7356442960217,0.423515724234126,2020-03-16,2020,3
"365","AM",1,"Norte",13007,"Manaus",2509626,33627.4858461221,12,700,161,539,345,355,8,5,3,2,6,708,166,542,347,361,240,10.4230990426808,14.7356442960217,0.531891851138087,2020-03-23,2020,3
"366","AM",1,"Norte",13007,"Manaus",2509626,33627.4858461221,13,659,142,517,289,370,6,5,1,3,3,665,147,518,292,373,294,10.4230990426808,14.7356442960217,0.515444414840887,2020-03-30,2020,3
"367","AM",1,"Norte",13007,"Manaus",2509626,33627.4858461221,14,686,170,516,329,357,5,2,3,5,0,691,172,519,334,357,428,10.4230990426808,14.7356442960217,0.544534593729627,2020-04-06,2020,4
"368","AM",1,"Norte",13007,"Manaus",2509626,33627.4858461221,15,696,178,518,301,395,7,2,5,1,6,703,180,523,302,401,813,10.4230990426808,14.7356442960217,0.528801769785691,2020-04-13,2020,4
"369","AM",1,"Norte",13007,"Manaus",2509626,33627.4858461221,16,768,193,575,339,429,13,4,9,1,12,781,197,584,340,441,1067,10.4230990426808,14.7356442960217,0.535381990692626,2020-04-20,2020,4
"370","AM",1,"Norte",13007,"Manaus",2509626,33627.4858461221,17,820,206,614,363,457,11,4,7,5,6,831,210,621,368,463,1000,10.4230990426808,14.7356442960217,0.507080433759016,2020-04-27,2020,4
"371","AM",1,"Norte",13007,"Manaus",2509626,33627.4858461221,18,803,199,604,375,428,7,3,4,3,4,810,202,608,378,432,736,10.4230990426808,14.7356442960217,0.483576432483094,2020-05-04,2020,5
"372","AM",1,"Norte",13007,"Manaus",2509626,33627.4858461221,19,716,151,565,330,386,8,4,4,2,6,724,155,569,332,392,549,10.4230990426808,14.7356442960217,0.493338851669114,2020-05-11,2020,5
"373","AM",1,"Norte",13007,"Manaus",2509626,33627.4858461221,20,780,173,607,348,432,11,3,8,2,9,791,176,615,350,441,420,10.4230990426808,14.7356442960217,0.472937723157335,2020-05-18,2020,5
"374","AM",1,"Norte",13007,"Manaus",2509626,33627.4858461221,21,814,209,605,353,461,14,1,13,4,10,828,210,618,357,471,350,10.4230990426808,14.7356442960217,0.448978496800958,2020-05-25,2020,5
"375","AM",1,"Norte",13008,"Rio Preto da Eva",71299,17765.7295445939,5,16,9,7,12,4,1,1,0,1,0,17,10,7,13,4,4,9.78502657401181,11.1746375810586,0.286187803599186,2020-02-03,2020,2
"376","AM",1,"Norte",13008,"Rio Preto da Eva",71299,17765.7295445939,6,16,6,10,7,9,0,0,0,0,0,16,6,10,7,9,6,9.78502657401181,11.1746375810586,0.28970979823156,2020-02-10,2020,2
"377","AM",1,"Norte",13008,"Rio Preto da Eva",71299,17765.7295445939,7,23,6,17,8,15,1,0,1,0,1,24,6,18,8,16,6,9.78502657401181,11.1746375810586,0.292492844844857,2020-02-17,2020,2
"378","AM",1,"Norte",13008,"Rio Preto da Eva",71299,17765.7295445939,8,14,7,7,8,6,1,1,0,1,0,15,8,7,9,6,3,9.78502657401181,11.1746375810586,0.345902989740584,2020-02-24,2020,2
"379","AM",1,"Norte",13008,"Rio Preto da Eva",71299,17765.7295445939,9,21,7,14,10,11,0,0,0,0,0,21,7,14,10,11,3,9.78502657401181,11.1746375810586,0.314840485056883,2020-03-02,2020,3
"380","AM",1,"Norte",13008,"Rio Preto da Eva",71299,17765.7295445939,10,18,7,11,11,7,0,0,0,0,0,18,7,11,11,7,1,9.78502657401181,11.1746375810586,0.331854933607938,2020-03-09,2020,3
"381","AM",1,"Norte",13008,"Rio Preto da Eva",71299,17765.7295445939,11,11,8,3,6,5,0,0,0,0,0,11,8,3,6,5,1,9.78502657401181,11.1746375810586,0.388183517540379,2020-03-16,2020,3
"382","AM",1,"Norte",13008,"Rio Preto da Eva",71299,17765.7295445939,12,16,5,11,8,8,0,0,0,0,0,16,5,11,8,8,4,9.78502657401181,11.1746375810586,0.493109470760495,2020-03-23,2020,3
"383","AM",1,"Norte",13008,"Rio Preto da Eva",71299,17765.7295445939,13,16,5,11,8,8,0,0,0,0,0,16,5,11,8,8,8,9.78502657401181,11.1746375810586,0.457254762623589,2020-03-30,2020,3
"384","AM",1,"Norte",13008,"Rio Preto da Eva",71299,17765.7295445939,14,24,10,14,10,14,0,0,0,0,0,24,10,14,10,14,8,9.78502657401181,11.1746375810586,0.482971519012433,2020-04-06,2020,4
"385","AM",1,"Norte",13008,"Rio Preto da Eva",71299,17765.7295445939,15,22,6,16,13,9,0,0,0,0,0,22,6,16,13,9,5,9.78502657401181,11.1746375810586,0.449891664365852,2020-04-13,2020,4
"386","AM",1,"Norte",13008,"Rio Preto da Eva",71299,17765.7295445939,16,15,7,8,10,5,0,0,0,0,0,15,7,8,10,5,13,9.78502657401181,11.1746375810586,0.464190791724672,2020-04-20,2020,4
"387","AM",1,"Norte",13008,"Rio Preto da Eva",71299,17765.7295445939,17,16,4,12,10,6,0,0,0,0,0,16,4,12,10,6,8,9.78502657401181,11.1746375810586,0.462234163336389,2020-04-27,2020,4
"388","AM",1,"Norte",13008,"Rio Preto da Eva",71299,17765.7295445939,18,18,4,14,8,10,0,0,0,0,0,18,4,14,8,10,14,9.78502657401181,11.1746375810586,0.478797604076665,2020-05-04,2020,5
"389","AM",1,"Norte",13008,"Rio Preto da Eva",71299,17765.7295445939,19,16,6,10,10,6,1,0,1,0,1,17,6,11,10,7,8,9.78502657401181,11.1746375810586,0.479730302535713,2020-05-11,2020,5
"390","AM",1,"Norte",13008,"Rio Preto da Eva",71299,17765.7295445939,20,22,7,15,14,8,0,0,0,0,0,22,7,15,14,8,7,9.78502657401181,11.1746375810586,0.460584692470388,2020-05-18,2020,5
"391","AM",1,"Norte",13008,"Rio Preto da Eva",71299,17765.7295445939,21,20,8,12,10,10,1,1,0,0,1,21,9,12,10,11,5,9.78502657401181,11.1746375810586,0.443044414289777,2020-05-25,2020,5
"392","AM",1,"Norte",13009,"Itacoatiara",182772,14099.0384033112,5,60,19,41,31,29,0,0,0,0,0,60,19,41,31,29,12,9.55386187569393,12.1159947534035,0.272832971474392,2020-02-03,2020,2
"393","AM",1,"Norte",13009,"Itacoatiara",182772,14099.0384033112,6,70,23,47,34,36,0,0,0,0,0,70,23,47,34,36,18,9.55386187569393,12.1159947534035,0.2763079954379,2020-02-10,2020,2
"394","AM",1,"Norte",13009,"Itacoatiara",182772,14099.0384033112,7,60,15,45,32,28,2,1,1,0,2,62,16,46,32,30,11,9.55386187569393,12.1159947534035,0.28293035317458,2020-02-17,2020,2
"395","AM",1,"Norte",13009,"Itacoatiara",182772,14099.0384033112,8,56,26,30,26,30,0,0,0,0,0,56,26,30,26,30,17,9.55386187569393,12.1159947534035,0.329915644545722,2020-02-24,2020,2
"396","AM",1,"Norte",13009,"Itacoatiara",182772,14099.0384033112,9,79,22,57,41,38,1,1,0,0,1,80,23,57,41,39,11,9.55386187569393,12.1159947534035,0.307441042472172,2020-03-02,2020,3
"397","AM",1,"Norte",13009,"Itacoatiara",182772,14099.0384033112,10,53,14,39,20,33,1,1,0,0,1,54,15,39,20,34,17,9.55386187569393,12.1159947534035,0.331617486981772,2020-03-09,2020,3
"398","AM",1,"Norte",13009,"Itacoatiara",182772,14099.0384033112,11,63,21,42,31,32,1,1,0,1,0,64,22,42,32,32,13,9.55386187569393,12.1159947534035,0.385994711559483,2020-03-16,2020,3
"399","AM",1,"Norte",13009,"Itacoatiara",182772,14099.0384033112,12,60,26,34,34,26,0,0,0,0,0,60,26,34,34,26,9,9.55386187569393,12.1159947534035,0.4774960838089,2020-03-23,2020,3
"400","AM",1,"Norte",13009,"Itacoatiara",182772,14099.0384033112,13,34,15,19,19,15,0,0,0,0,0,34,15,19,19,15,13,9.55386187569393,12.1159947534035,0.451321382335996,2020-03-30,2020,3
"401","AM",1,"Norte",13009,"Itacoatiara",182772,14099.0384033112,14,51,20,31,33,18,1,1,0,0,1,52,21,31,33,19,13,9.55386187569393,12.1159947534035,0.476465801720875,2020-04-06,2020,4
"402","AM",1,"Norte",13009,"Itacoatiara",182772,14099.0384033112,15,50,13,37,25,25,0,0,0,0,0,50,13,37,25,25,19,9.55386187569393,12.1159947534035,0.450153073014889,2020-04-13,2020,4
"403","AM",1,"Norte",13009,"Itacoatiara",182772,14099.0384033112,16,59,21,38,32,27,1,0,1,0,1,60,21,39,32,28,25,9.55386187569393,12.1159947534035,0.461472480161409,2020-04-20,2020,4
"404","AM",1,"Norte",13009,"Itacoatiara",182772,14099.0384033112,17,62,15,47,32,30,1,0,1,1,0,63,15,48,33,30,26,9.55386187569393,12.1159947534035,0.454003135649589,2020-04-27,2020,4
"405","AM",1,"Norte",13009,"Itacoatiara",182772,14099.0384033112,18,46,16,30,29,17,1,0,1,1,0,47,16,31,30,17,34,9.55386187569393,12.1159947534035,0.457612210541247,2020-05-04,2020,5
"406","AM",1,"Norte",13009,"Itacoatiara",182772,14099.0384033112,19,51,17,34,28,23,0,0,0,0,0,51,17,34,28,23,42,9.55386187569393,12.1159947534035,0.471494323389127,2020-05-11,2020,5
"407","AM",1,"Norte",13009,"Itacoatiara",182772,14099.0384033112,20,60,26,34,34,26,4,2,2,3,1,64,28,36,37,27,38,9.55386187569393,12.1159947534035,0.450124015290364,2020-05-18,2020,5
"408","AM",1,"Norte",13009,"Itacoatiara",182772,14099.0384033112,21,62,27,35,36,26,0,0,0,0,0,62,27,35,36,26,28,9.55386187569393,12.1159947534035,0.429442869704377,2020-05-25,2020,5
"409","AM",1,"Norte",13010,"Parintins",284437,9409.5772083449,5,108,34,74,64,44,1,0,1,0,1,109,34,75,64,45,19,9.1494833015323,12.558267066902,0.253987129062151,2020-02-03,2020,2
"410","AM",1,"Norte",13010,"Parintins",284437,9409.5772083449,6,80,30,50,44,36,0,0,0,0,0,80,30,50,44,36,20,9.1494833015323,12.558267066902,0.236766265069077,2020-02-10,2020,2
"411","AM",1,"Norte",13010,"Parintins",284437,9409.5772083449,7,112,44,68,73,39,2,1,1,1,1,114,45,69,74,40,19,9.1494833015323,12.558267066902,0.256288250766058,2020-02-17,2020,2
"412","AM",1,"Norte",13010,"Parintins",284437,9409.5772083449,8,108,40,68,61,47,1,1,0,0,1,109,41,68,61,48,23,9.1494833015323,12.558267066902,0.290060724302219,2020-02-24,2020,2
"413","AM",1,"Norte",13010,"Parintins",284437,9409.5772083449,9,97,32,65,49,48,2,1,1,1,1,99,33,66,50,49,20,9.1494833015323,12.558267066902,0.261615253741211,2020-03-02,2020,3
"414","AM",1,"Norte",13010,"Parintins",284437,9409.5772083449,10,80,25,55,34,46,0,0,0,0,0,80,25,55,34,46,11,9.1494833015323,12.558267066902,0.295094085476152,2020-03-09,2020,3
"415","AM",1,"Norte",13010,"Parintins",284437,9409.5772083449,11,85,27,58,54,31,2,2,0,2,0,87,29,58,56,31,19,9.1494833015323,12.558267066902,0.355095643161852,2020-03-16,2020,3
"416","AM",1,"Norte",13010,"Parintins",284437,9409.5772083449,12,94,40,54,50,44,1,0,1,0,1,95,40,55,50,45,21,9.1494833015323,12.558267066902,0.454113911270004,2020-03-23,2020,3
"417","AM",1,"Norte",13010,"Parintins",284437,9409.5772083449,13,77,29,48,44,33,1,0,1,0,1,78,29,49,44,34,11,9.1494833015323,12.558267066902,0.416477588782123,2020-03-30,2020,3
"418","AM",1,"Norte",13010,"Parintins",284437,9409.5772083449,14,77,30,47,43,34,0,0,0,0,0,77,30,47,43,34,22,9.1494833015323,12.558267066902,0.447859888663755,2020-04-06,2020,4
"419","AM",1,"Norte",13010,"Parintins",284437,9409.5772083449,15,81,32,49,48,33,2,0,2,0,2,83,32,51,48,35,14,9.1494833015323,12.558267066902,0.43529370183775,2020-04-13,2020,4
"420","AM",1,"Norte",13010,"Parintins",284437,9409.5772083449,16,102,40,62,53,49,1,0,1,0,1,103,40,63,53,50,31,9.1494833015323,12.558267066902,0.440750778149446,2020-04-20,2020,4
"421","AM",1,"Norte",13010,"Parintins",284437,9409.5772083449,17,96,39,57,60,36,3,2,1,1,2,99,41,58,61,38,58,9.1494833015323,12.558267066902,0.444138939122363,2020-04-27,2020,4
"422","AM",1,"Norte",13010,"Parintins",284437,9409.5772083449,18,83,27,56,44,39,3,2,1,1,2,86,29,57,45,41,34,9.1494833015323,12.558267066902,0.448269276624272,2020-05-04,2020,5
"423","AM",1,"Norte",13010,"Parintins",284437,9409.5772083449,19,68,19,49,38,30,0,0,0,0,0,68,19,49,38,30,30,9.1494833015323,12.558267066902,0.457588443792574,2020-05-11,2020,5
"424","AM",1,"Norte",13010,"Parintins",284437,9409.5772083449,20,98,28,70,60,38,1,0,1,0,1,99,28,71,60,39,29,9.1494833015323,12.558267066902,0.415291405090904,2020-05-18,2020,5
"425","AM",1,"Norte",13010,"Parintins",284437,9409.5772083449,21,115,45,70,60,55,2,1,1,1,1,117,46,71,61,56,26,9.1494833015323,12.558267066902,0.412035848900432,2020-05-25,2020,5
"426","AM",1,"Norte",13011,"Boca do Acre",54157,10759.8857434865,5,23,18,5,15,8,0,0,0,0,0,23,18,5,15,8,2,9.28358021502432,10.8996425146192,0.325102652766521,2020-02-03,2020,2
"427","AM",1,"Norte",13011,"Boca do Acre",54157,10759.8857434865,6,19,11,8,16,3,0,0,0,0,0,19,11,8,16,3,5,9.28358021502432,10.8996425146192,0.339776335287983,2020-02-10,2020,2
"428","AM",1,"Norte",13011,"Boca do Acre",54157,10759.8857434865,7,23,17,6,14,9,0,0,0,0,0,23,17,6,14,9,3,9.28358021502432,10.8996425146192,0.353719466325191,2020-02-17,2020,2
"429","AM",1,"Norte",13011,"Boca do Acre",54157,10759.8857434865,8,25,16,9,16,9,0,0,0,0,0,25,16,9,16,9,1,9.28358021502432,10.8996425146192,0.397181203734703,2020-02-24,2020,2
"430","AM",1,"Norte",13011,"Boca do Acre",54157,10759.8857434865,9,17,11,6,12,5,1,1,0,1,0,18,12,6,13,5,6,9.28358021502432,10.8996425146192,0.354547433309421,2020-03-02,2020,3
"431","AM",1,"Norte",13011,"Boca do Acre",54157,10759.8857434865,10,14,6,8,7,7,1,0,1,0,1,15,6,9,7,8,6,9.28358021502432,10.8996425146192,0.376069366344598,2020-03-09,2020,3
"432","AM",1,"Norte",13011,"Boca do Acre",54157,10759.8857434865,11,15,8,7,7,8,0,0,0,0,0,15,8,7,7,8,4,9.28358021502432,10.8996425146192,0.439415230933816,2020-03-16,2020,3
"433","AM",1,"Norte",13011,"Boca do Acre",54157,10759.8857434865,12,12,10,2,5,7,0,0,0,0,0,12,10,2,5,7,9,9.28358021502432,10.8996425146192,0.523869654222206,2020-03-23,2020,3
"434","AM",1,"Norte",13011,"Boca do Acre",54157,10759.8857434865,13,20,12,8,16,4,0,0,0,0,0,20,12,8,16,4,3,9.28358021502432,10.8996425146192,0.487837240924239,2020-03-30,2020,3
"435","AM",1,"Norte",13011,"Boca do Acre",54157,10759.8857434865,14,22,12,10,16,6,0,0,0,0,0,22,12,10,16,6,6,9.28358021502432,10.8996425146192,0.514019597460606,2020-04-06,2020,4
"436","AM",1,"Norte",13011,"Boca do Acre",54157,10759.8857434865,15,23,14,9,14,9,1,1,0,1,0,24,15,9,15,9,6,9.28358021502432,10.8996425146192,0.488977930790991,2020-04-13,2020,4
"437","AM",1,"Norte",13011,"Boca do Acre",54157,10759.8857434865,16,13,5,8,8,5,0,0,0,0,0,13,5,8,8,5,2,9.28358021502432,10.8996425146192,0.463862103847848,2020-04-20,2020,4
"438","AM",1,"Norte",13011,"Boca do Acre",54157,10759.8857434865,17,15,7,8,9,6,0,0,0,0,0,15,7,8,9,6,6,9.28358021502432,10.8996425146192,0.525268287408439,2020-04-27,2020,4
"439","AM",1,"Norte",13011,"Boca do Acre",54157,10759.8857434865,18,16,6,10,11,5,0,0,0,0,0,16,6,10,11,5,0,9.28358021502432,10.8996425146192,0.512972285848737,2020-05-04,2020,5
"440","AM",1,"Norte",13011,"Boca do Acre",54157,10759.8857434865,19,17,7,10,7,10,2,2,0,2,0,19,9,10,9,10,6,9.28358021502432,10.8996425146192,0.512334752438652,2020-05-11,2020,5
"441","AM",1,"Norte",13011,"Boca do Acre",54157,10759.8857434865,20,19,10,9,8,11,1,1,0,1,0,20,11,9,9,11,8,9.28358021502432,10.8996425146192,0.49828552183934,2020-05-18,2020,5
"442","AM",1,"Norte",13011,"Boca do Acre",54157,10759.8857434865,21,35,22,13,22,13,0,0,0,0,0,35,22,13,22,13,9,9.28358021502432,10.8996425146192,0.477920595890828,2020-05-25,2020,5
"443","AM",1,"Norte",13012,"Purus",79704,10871.8448153167,5,35,18,17,24,11,0,0,0,0,0,35,18,17,24,11,8,9.29393168193557,11.2860750517247,0.295694017567029,2020-02-03,2020,2
"444","AM",1,"Norte",13012,"Purus",79704,10871.8448153167,6,21,10,11,15,6,0,0,0,0,0,21,10,11,15,6,7,9.29393168193557,11.2860750517247,0.31587364873367,2020-02-10,2020,2
"445","AM",1,"Norte",13012,"Purus",79704,10871.8448153167,7,28,15,13,22,6,0,0,0,0,0,28,15,13,22,6,3,9.29393168193557,11.2860750517247,0.306112143027951,2020-02-17,2020,2
"446","AM",1,"Norte",13012,"Purus",79704,10871.8448153167,8,33,20,13,16,17,0,0,0,0,0,33,20,13,16,17,3,9.29393168193557,11.2860750517247,0.387843668719958,2020-02-24,2020,2
"447","AM",1,"Norte",13012,"Purus",79704,10871.8448153167,9,16,12,4,11,5,1,1,0,0,1,17,13,4,11,6,5,9.29393168193557,11.2860750517247,0.377430366474776,2020-03-02,2020,3
"448","AM",1,"Norte",13012,"Purus",79704,10871.8448153167,10,17,11,6,10,7,0,0,0,0,0,17,11,6,10,7,9,9.29393168193557,11.2860750517247,0.36327656431266,2020-03-09,2020,3
"449","AM",1,"Norte",13012,"Purus",79704,10871.8448153167,11,25,12,13,15,10,0,0,0,0,0,25,12,13,15,10,8,9.29393168193557,11.2860750517247,0.421488975789419,2020-03-16,2020,3
"450","AM",1,"Norte",13012,"Purus",79704,10871.8448153167,12,29,9,20,19,10,0,0,0,0,0,29,9,20,19,10,4,9.29393168193557,11.2860750517247,0.456870798902405,2020-03-23,2020,3
"451","AM",1,"Norte",13012,"Purus",79704,10871.8448153167,13,13,9,4,10,3,0,0,0,0,0,13,9,4,10,3,3,9.29393168193557,11.2860750517247,0.45585937284624,2020-03-30,2020,3
"452","AM",1,"Norte",13012,"Purus",79704,10871.8448153167,14,23,12,11,9,14,0,0,0,0,0,23,12,11,9,14,3,9.29393168193557,11.2860750517247,0.476109578655334,2020-04-06,2020,4
"453","AM",1,"Norte",13012,"Purus",79704,10871.8448153167,15,24,14,10,17,7,0,0,0,0,0,24,14,10,17,7,6,9.29393168193557,11.2860750517247,0.502721746892404,2020-04-13,2020,4
"454","AM",1,"Norte",13012,"Purus",79704,10871.8448153167,16,19,8,11,11,8,0,0,0,0,0,19,8,11,11,8,6,9.29393168193557,11.2860750517247,0.483715549997596,2020-04-20,2020,4
"455","AM",1,"Norte",13012,"Purus",79704,10871.8448153167,17,26,12,14,19,7,1,0,1,1,0,27,12,15,20,7,8,9.29393168193557,11.2860750517247,0.45545731610222,2020-04-27,2020,4
"456","AM",1,"Norte",13012,"Purus",79704,10871.8448153167,18,27,16,11,17,10,1,1,0,1,0,28,17,11,18,10,10,9.29393168193557,11.2860750517247,0.462686195489535,2020-05-04,2020,5
"457","AM",1,"Norte",13012,"Purus",79704,10871.8448153167,19,21,9,12,17,4,0,0,0,0,0,21,9,12,17,4,5,9.29393168193557,11.2860750517247,0.470155198779421,2020-05-11,2020,5
"458","AM",1,"Norte",13012,"Purus",79704,10871.8448153167,20,28,12,16,17,11,0,0,0,0,0,28,12,16,17,11,6,9.29393168193557,11.2860750517247,0.477405307838103,2020-05-18,2020,5
"459","AM",1,"Norte",13012,"Purus",79704,10871.8448153167,21,27,13,14,19,8,0,0,0,0,0,27,13,14,19,8,8,9.29393168193557,11.2860750517247,0.462023354209044,2020-05-25,2020,5
"460","AM",1,"Norte",13013,"Madeira",202880,9502.379246944,5,66,28,38,36,30,0,0,0,0,0,66,28,38,36,30,13,9.15929749327874,12.220369950231,0.298530384306294,2020-02-03,2020,2
"461","AM",1,"Norte",13013,"Madeira",202880,9502.379246944,6,60,28,32,31,29,1,1,0,0,1,61,29,32,31,30,12,9.15929749327874,12.220369950231,0.288912651973315,2020-02-10,2020,2
"462","AM",1,"Norte",13013,"Madeira",202880,9502.379246944,7,66,30,36,32,34,1,0,1,1,0,67,30,37,33,34,9,9.15929749327874,12.220369950231,0.302269277761914,2020-02-17,2020,2
"463","AM",1,"Norte",13013,"Madeira",202880,9502.379246944,8,62,23,39,40,22,0,0,0,0,0,62,23,39,40,22,12,9.15929749327874,12.220369950231,0.348379423265556,2020-02-24,2020,2
"464","AM",1,"Norte",13013,"Madeira",202880,9502.379246944,9,69,32,37,37,32,0,0,0,0,0,69,32,37,37,32,16,9.15929749327874,12.220369950231,0.353648597219574,2020-03-02,2020,3
"465","AM",1,"Norte",13013,"Madeira",202880,9502.379246944,10,61,25,36,39,22,1,1,0,1,0,62,26,36,40,22,7,9.15929749327874,12.220369950231,0.341584407232647,2020-03-09,2020,3
"466","AM",1,"Norte",13013,"Madeira",202880,9502.379246944,11,64,34,30,33,31,3,2,1,1,2,67,36,31,34,33,16,9.15929749327874,12.220369950231,0.38855505440146,2020-03-16,2020,3
"467","AM",1,"Norte",13013,"Madeira",202880,9502.379246944,12,67,28,39,38,29,0,0,0,0,0,67,28,39,38,29,11,9.15929749327874,12.220369950231,0.475734436492283,2020-03-23,2020,3
"468","AM",1,"Norte",13013,"Madeira",202880,9502.379246944,13,49,22,27,32,17,0,0,0,0,0,49,22,27,32,17,7,9.15929749327874,12.220369950231,0.44087162218601,2020-03-30,2020,3
"469","AM",1,"Norte",13013,"Madeira",202880,9502.379246944,14,61,32,29,39,22,0,0,0,0,0,61,32,29,39,22,9,9.15929749327874,12.220369950231,0.458196992222917,2020-04-06,2020,4
"470","AM",1,"Norte",13013,"Madeira",202880,9502.379246944,15,45,20,25,27,18,1,1,0,1,0,46,21,25,28,18,14,9.15929749327874,12.220369950231,0.438255436456713,2020-04-13,2020,4
"471","AM",1,"Norte",13013,"Madeira",202880,9502.379246944,16,67,27,40,39,28,1,0,1,0,1,68,27,41,39,29,11,9.15929749327874,12.220369950231,0.446381998423353,2020-04-20,2020,4
"472","AM",1,"Norte",13013,"Madeira",202880,9502.379246944,17,73,32,41,45,28,0,0,0,0,0,73,32,41,45,28,19,9.15929749327874,12.220369950231,0.467958197671605,2020-04-27,2020,4
"473","AM",1,"Norte",13013,"Madeira",202880,9502.379246944,18,63,27,36,38,25,2,2,0,2,0,65,29,36,40,25,16,9.15929749327874,12.220369950231,0.451965822861633,2020-05-04,2020,5
"474","AM",1,"Norte",13013,"Madeira",202880,9502.379246944,19,71,33,38,38,33,2,1,1,2,0,73,34,39,40,33,17,9.15929749327874,12.220369950231,0.469308829060118,2020-05-11,2020,5
"475","AM",1,"Norte",13013,"Madeira",202880,9502.379246944,20,64,30,34,35,29,3,2,1,1,2,67,32,35,36,31,18,9.15929749327874,12.220369950231,0.471350665244045,2020-05-18,2020,5
"476","AM",1,"Norte",13013,"Madeira",202880,9502.379246944,21,69,28,41,44,25,1,1,0,1,0,70,29,41,45,25,20,9.15929749327874,12.220369950231,0.445939067462773,2020-05-25,2020,5
"477","AP",1,"Norte",16003,"Macapá",700690,21386.4680602121,5,197,69,128,84,113,2,2,0,1,1,199,71,128,85,114,49,9.97051366736776,13.4598208428139,0.300640696762255,2020-02-03,2020,2
"478","AP",1,"Norte",16003,"Macapá",700690,21386.4680602121,6,234,73,161,98,136,0,0,0,0,0,234,73,161,98,136,67,9.97051366736776,13.4598208428139,0.28717760010566,2020-02-10,2020,2
"479","AP",1,"Norte",16003,"Macapá",700690,21386.4680602121,7,210,56,154,109,101,2,2,0,0,2,212,58,154,109,103,45,9.97051366736776,13.4598208428139,0.30025518591497,2020-02-17,2020,2
"480","AP",1,"Norte",16003,"Macapá",700690,21386.4680602121,8,196,61,135,95,101,3,1,2,1,2,199,62,137,96,103,84,9.97051366736776,13.4598208428139,0.355930636151027,2020-02-24,2020,2
"481","AP",1,"Norte",16003,"Macapá",700690,21386.4680602121,9,218,69,149,106,112,3,1,2,1,2,221,70,151,107,114,65,9.97051366736776,13.4598208428139,0.325867266122831,2020-03-02,2020,3
"482","AP",1,"Norte",16003,"Macapá",700690,21386.4680602121,10,213,63,150,102,111,3,2,1,2,1,216,65,151,104,112,50,9.97051366736776,13.4598208428139,0.335774327007588,2020-03-09,2020,3
"483","AP",1,"Norte",16003,"Macapá",700690,21386.4680602121,11,187,60,127,82,105,1,0,1,0,1,188,60,128,82,106,53,9.97051366736776,13.4598208428139,0.449171288310685,2020-03-16,2020,3
"484","AP",1,"Norte",16003,"Macapá",700690,21386.4680602121,12,184,68,116,81,103,1,0,1,0,1,185,68,117,81,104,49,9.97051366736776,13.4598208428139,0.545052600775409,2020-03-23,2020,3
"485","AP",1,"Norte",16003,"Macapá",700690,21386.4680602121,13,179,62,117,97,82,2,1,1,0,2,181,63,118,97,84,68,9.97051366736776,13.4598208428139,0.499352874915744,2020-03-30,2020,3
"486","AP",1,"Norte",16003,"Macapá",700690,21386.4680602121,14,221,75,146,100,121,1,1,0,1,0,222,76,146,101,121,72,9.97051366736776,13.4598208428139,0.497703155383365,2020-04-06,2020,4
"487","AP",1,"Norte",16003,"Macapá",700690,21386.4680602121,15,203,66,137,99,104,0,0,0,0,0,203,66,137,99,104,80,9.97051366736776,13.4598208428139,0.481972046058043,2020-04-13,2020,4
"488","AP",1,"Norte",16003,"Macapá",700690,21386.4680602121,16,200,58,142,83,117,3,2,1,2,1,203,60,143,85,118,75,9.97051366736776,13.4598208428139,0.480097798924058,2020-04-20,2020,4
"489","AP",1,"Norte",16003,"Macapá",700690,21386.4680602121,17,195,52,143,101,94,7,2,5,4,3,202,54,148,105,97,91,9.97051366736776,13.4598208428139,0.487031443102114,2020-04-27,2020,4
"490","AP",1,"Norte",16003,"Macapá",700690,21386.4680602121,18,178,62,116,86,92,0,0,0,0,0,178,62,116,86,92,135,9.97051366736776,13.4598208428139,0.491083100133297,2020-05-04,2020,5
"491","AP",1,"Norte",16003,"Macapá",700690,21386.4680602121,19,210,58,152,93,117,1,1,0,0,1,211,59,152,93,118,185,9.97051366736776,13.4598208428139,0.523134258565008,2020-05-11,2020,5
"492","AP",1,"Norte",16003,"Macapá",700690,21386.4680602121,20,191,56,135,87,104,4,3,1,2,2,195,59,136,89,106,197,9.97051366736776,13.4598208428139,0.551421679718763,2020-05-18,2020,5
"493","AP",1,"Norte",16003,"Macapá",700690,21386.4680602121,21,205,43,162,97,108,1,0,1,0,1,206,43,163,97,109,160,9.97051366736776,13.4598208428139,0.517576499836846,2020-05-25,2020,5
"494","AP",1,"Norte",16004,"Mazagão",89669,15648.698856461,5,25,15,10,15,10,0,0,0,0,0,25,15,10,15,10,6,9.65814305234973,11.4038803918821,0.297122775027495,2020-02-03,2020,2
"495","AP",1,"Norte",16004,"Mazagão",89669,15648.698856461,6,31,11,20,22,9,0,0,0,0,0,31,11,20,22,9,7,9.65814305234973,11.4038803918821,0.292989365884496,2020-02-10,2020,2
"496","AP",1,"Norte",16004,"Mazagão",89669,15648.698856461,7,33,22,11,20,13,0,0,0,0,0,33,22,11,20,13,7,9.65814305234973,11.4038803918821,0.323583942934186,2020-02-17,2020,2
"497","AP",1,"Norte",16004,"Mazagão",89669,15648.698856461,8,32,15,17,18,14,0,0,0,0,0,32,15,17,18,14,6,9.65814305234973,11.4038803918821,0.340892060696514,2020-02-24,2020,2
"498","AP",1,"Norte",16004,"Mazagão",89669,15648.698856461,9,25,15,10,15,10,0,0,0,0,0,25,15,10,15,10,5,9.65814305234973,11.4038803918821,0.337749928856948,2020-03-02,2020,3
"499","AP",1,"Norte",16004,"Mazagão",89669,15648.698856461,10,27,13,14,16,11,0,0,0,0,0,27,13,14,16,11,3,9.65814305234973,11.4038803918821,0.3558110855186,2020-03-09,2020,3
"500","AP",1,"Norte",16004,"Mazagão",89669,15648.698856461,11,29,19,10,19,10,0,0,0,0,0,29,19,10,19,10,1,9.65814305234973,11.4038803918821,0.453836248906491,2020-03-16,2020,3
"501","AP",1,"Norte",16004,"Mazagão",89669,15648.698856461,12,24,12,12,11,13,0,0,0,0,0,24,12,12,11,13,5,9.65814305234973,11.4038803918821,0.516537048289587,2020-03-23,2020,3
"502","AP",1,"Norte",16004,"Mazagão",89669,15648.698856461,13,26,13,13,16,10,0,0,0,0,0,26,13,13,16,10,9,9.65814305234973,11.4038803918821,0.464935566687672,2020-03-30,2020,3
"503","AP",1,"Norte",16004,"Mazagão",89669,15648.698856461,14,28,14,14,19,9,1,1,0,0,1,29,15,14,19,10,5,9.65814305234973,11.4038803918821,0.474193190309502,2020-04-06,2020,4
"504","AP",1,"Norte",16004,"Mazagão",89669,15648.698856461,15,29,11,18,14,15,0,0,0,0,0,29,11,18,14,15,12,9.65814305234973,11.4038803918821,0.479334975546927,2020-04-13,2020,4
"505","AP",1,"Norte",16004,"Mazagão",89669,15648.698856461,16,23,9,14,10,13,0,0,0,0,0,23,9,14,10,13,9,9.65814305234973,11.4038803918821,0.490049667933181,2020-04-20,2020,4
"506","AP",1,"Norte",16004,"Mazagão",89669,15648.698856461,17,21,7,14,10,11,0,0,0,0,0,21,7,14,10,11,16,9.65814305234973,11.4038803918821,0.494889338358457,2020-04-27,2020,4
"507","AP",1,"Norte",16004,"Mazagão",89669,15648.698856461,18,24,11,13,11,13,1,1,0,0,1,25,12,13,11,14,21,9.65814305234973,11.4038803918821,0.482950903995365,2020-05-04,2020,5
"508","AP",1,"Norte",16004,"Mazagão",89669,15648.698856461,19,29,15,14,17,12,0,0,0,0,0,29,15,14,17,12,19,9.65814305234973,11.4038803918821,0.503447929249645,2020-05-11,2020,5
"509","AP",1,"Norte",16004,"Mazagão",89669,15648.698856461,20,28,16,12,17,11,0,0,0,0,0,28,16,12,17,11,15,9.65814305234973,11.4038803918821,0.518010956373547,2020-05-18,2020,5
"510","AP",1,"Norte",16004,"Mazagão",89669,15648.698856461,21,28,13,15,18,10,0,0,0,0,0,28,13,15,18,10,11,9.65814305234973,11.4038803918821,0.500257844768608,2020-05-25,2020,5
"511","BA",2,"Nordeste",29001,"Barreiras",347122,55239.4210031343,5,81,22,59,27,54,0,0,0,0,0,81,22,59,27,54,22,10.9194321259899,12.7574315821519,0.269760604807554,2020-02-03,2020,2
"512","BA",2,"Nordeste",29001,"Barreiras",347122,55239.4210031343,6,132,30,102,46,86,2,0,2,1,1,134,30,104,47,87,30,10.9194321259899,12.7574315821519,0.259076968933801,2020-02-10,2020,2
"513","BA",2,"Nordeste",29001,"Barreiras",347122,55239.4210031343,7,109,23,86,51,58,1,1,0,0,1,110,24,86,51,59,41,10.9194321259899,12.7574315821519,0.267304228019111,2020-02-17,2020,2
"514","BA",2,"Nordeste",29001,"Barreiras",347122,55239.4210031343,8,126,20,106,47,79,1,0,1,0,1,127,20,107,47,80,24,10.9194321259899,12.7574315821519,0.301937456729805,2020-02-24,2020,2
"515","BA",2,"Nordeste",29001,"Barreiras",347122,55239.4210031343,9,120,29,91,54,66,1,1,0,0,1,121,30,91,54,67,30,10.9194321259899,12.7574315821519,0.279076683183285,2020-03-02,2020,3
"516","BA",2,"Nordeste",29001,"Barreiras",347122,55239.4210031343,10,98,25,73,32,66,3,1,2,2,1,101,26,75,34,67,32,10.9194321259899,12.7574315821519,0.298873195841312,2020-03-09,2020,3
"517","BA",2,"Nordeste",29001,"Barreiras",347122,55239.4210031343,11,85,15,70,29,56,1,0,1,0,1,86,15,71,29,57,23,10.9194321259899,12.7574315821519,0.354137783442619,2020-03-16,2020,3
"518","BA",2,"Nordeste",29001,"Barreiras",347122,55239.4210031343,12,76,14,62,26,50,0,0,0,0,0,76,14,62,26,50,41,10.9194321259899,12.7574315821519,0.453683867705025,2020-03-23,2020,3
"519","BA",2,"Nordeste",29001,"Barreiras",347122,55239.4210031343,13,95,27,68,40,55,0,0,0,0,0,95,27,68,40,55,38,10.9194321259899,12.7574315821519,0.400742503744303,2020-03-30,2020,3
"520","BA",2,"Nordeste",29001,"Barreiras",347122,55239.4210031343,14,92,25,67,40,52,0,0,0,0,0,92,25,67,40,52,35,10.9194321259899,12.7574315821519,0.372410930915568,2020-04-06,2020,4
"521","BA",2,"Nordeste",29001,"Barreiras",347122,55239.4210031343,15,106,27,79,33,73,2,1,1,0,2,108,28,80,33,75,26,10.9194321259899,12.7574315821519,0.354364467062077,2020-04-13,2020,4
"522","BA",2,"Nordeste",29001,"Barreiras",347122,55239.4210031343,16,105,30,75,46,59,1,1,0,0,1,106,31,75,46,60,29,10.9194321259899,12.7574315821519,0.358953057604412,2020-04-20,2020,4
"523","BA",2,"Nordeste",29001,"Barreiras",347122,55239.4210031343,17,106,35,71,45,61,2,1,1,0,2,108,36,72,45,63,37,10.9194321259899,12.7574315821519,0.348529445208524,2020-04-27,2020,4
"524","BA",2,"Nordeste",29001,"Barreiras",347122,55239.4210031343,18,109,28,81,44,65,1,0,1,1,0,110,28,82,45,65,23,10.9194321259899,12.7574315821519,0.346147059221906,2020-05-04,2020,5
"525","BA",2,"Nordeste",29001,"Barreiras",347122,55239.4210031343,19,111,27,84,46,65,1,0,1,0,1,112,27,85,46,66,31,10.9194321259899,12.7574315821519,0.369068953378318,2020-05-11,2020,5
"526","BA",2,"Nordeste",29001,"Barreiras",347122,55239.4210031343,20,121,37,84,65,56,2,1,1,0,2,123,38,85,65,58,36,10.9194321259899,12.7574315821519,0.366591323451158,2020-05-18,2020,5
"527","BA",2,"Nordeste",29001,"Barreiras",347122,55239.4210031343,21,125,32,93,55,70,0,0,0,0,0,125,32,93,55,70,23,10.9194321259899,12.7574315821519,0.375424661485104,2020-05-25,2020,5
"528","BA",2,"Nordeste",29002,"Cotegipe",119183,8731.27373769749,5,28,12,16,13,15,0,0,0,0,0,28,12,16,13,15,11,9.07466654170709,11.6884154059929,0.283176611295988,2020-02-03,2020,2
"529","BA",2,"Nordeste",29002,"Cotegipe",119183,8731.27373769749,6,21,5,16,9,12,0,0,0,0,0,21,5,16,9,12,13,9.07466654170709,11.6884154059929,0.264279135430035,2020-02-10,2020,2
"530","BA",2,"Nordeste",29002,"Cotegipe",119183,8731.27373769749,7,22,7,15,13,9,0,0,0,0,0,22,7,15,13,9,9,9.07466654170709,11.6884154059929,0.273118804663762,2020-02-17,2020,2
"531","BA",2,"Nordeste",29002,"Cotegipe",119183,8731.27373769749,8,26,7,19,7,19,0,0,0,0,0,26,7,19,7,19,6,9.07466654170709,11.6884154059929,0.30269555195715,2020-02-24,2020,2
"532","BA",2,"Nordeste",29002,"Cotegipe",119183,8731.27373769749,9,25,8,17,15,10,1,1,0,0,1,26,9,17,15,11,7,9.07466654170709,11.6884154059929,0.287401009507191,2020-03-02,2020,3
"533","BA",2,"Nordeste",29002,"Cotegipe",119183,8731.27373769749,10,24,5,19,12,12,0,0,0,0,0,24,5,19,12,12,15,9.07466654170709,11.6884154059929,0.300431788520487,2020-03-09,2020,3
"534","BA",2,"Nordeste",29002,"Cotegipe",119183,8731.27373769749,11,18,7,11,9,9,0,0,0,0,0,18,7,11,9,9,13,9.07466654170709,11.6884154059929,0.371016038253663,2020-03-16,2020,3
"535","BA",2,"Nordeste",29002,"Cotegipe",119183,8731.27373769749,12,24,9,15,8,16,1,0,1,1,0,25,9,16,9,16,10,9.07466654170709,11.6884154059929,0.46745590259147,2020-03-23,2020,3
"536","BA",2,"Nordeste",29002,"Cotegipe",119183,8731.27373769749,13,13,1,12,7,6,0,0,0,0,0,13,1,12,7,6,6,9.07466654170709,11.6884154059929,0.39310171769792,2020-03-30,2020,3
"537","BA",2,"Nordeste",29002,"Cotegipe",119183,8731.27373769749,14,25,11,14,8,17,0,0,0,0,0,25,11,14,8,17,10,9.07466654170709,11.6884154059929,0.376202982367021,2020-04-06,2020,4
"538","BA",2,"Nordeste",29002,"Cotegipe",119183,8731.27373769749,15,25,8,17,11,14,2,0,2,1,1,27,8,19,12,15,6,9.07466654170709,11.6884154059929,0.345455287004652,2020-04-13,2020,4
"539","BA",2,"Nordeste",29002,"Cotegipe",119183,8731.27373769749,16,20,3,17,11,9,0,0,0,0,0,20,3,17,11,9,14,9.07466654170709,11.6884154059929,0.340528705967818,2020-04-20,2020,4
"540","BA",2,"Nordeste",29002,"Cotegipe",119183,8731.27373769749,17,18,6,12,9,9,0,0,0,0,0,18,6,12,9,9,7,9.07466654170709,11.6884154059929,0.355554793482605,2020-04-27,2020,4
"541","BA",2,"Nordeste",29002,"Cotegipe",119183,8731.27373769749,18,16,3,13,5,11,0,0,0,0,0,16,3,13,5,11,10,9.07466654170709,11.6884154059929,0.362568596318888,2020-05-04,2020,5
"542","BA",2,"Nordeste",29002,"Cotegipe",119183,8731.27373769749,19,25,6,19,11,14,0,0,0,0,0,25,6,19,11,14,9,9.07466654170709,11.6884154059929,0.389362142084638,2020-05-11,2020,5
"543","BA",2,"Nordeste",29002,"Cotegipe",119183,8731.27373769749,20,23,7,16,10,13,0,0,0,0,0,23,7,16,10,13,15,9.07466654170709,11.6884154059929,0.38954021092663,2020-05-18,2020,5
"544","BA",2,"Nordeste",29002,"Cotegipe",119183,8731.27373769749,21,28,9,19,13,15,1,0,1,1,0,29,9,20,14,15,10,9.07466654170709,11.6884154059929,0.378403904837836,2020-05-25,2020,5
"545","BA",2,"Nordeste",29003,"Santa Maria da Vitória",182396,22938.7488002478,5,32,7,25,15,17,0,0,0,0,0,32,7,25,15,17,19,10.0405828469225,12.1139354265573,0.281284526585828,2020-02-03,2020,2
"546","BA",2,"Nordeste",29003,"Santa Maria da Vitória",182396,22938.7488002478,6,26,7,19,13,13,0,0,0,0,0,26,7,19,13,13,17,10.0405828469225,12.1139354265573,0.269209867652688,2020-02-10,2020,2
"547","BA",2,"Nordeste",29003,"Santa Maria da Vitória",182396,22938.7488002478,7,22,9,13,8,14,1,0,1,1,0,23,9,14,9,14,14,10.0405828469225,12.1139354265573,0.278305399061151,2020-02-17,2020,2
"548","BA",2,"Nordeste",29003,"Santa Maria da Vitória",182396,22938.7488002478,8,30,7,23,15,15,0,0,0,0,0,30,7,23,15,15,21,10.0405828469225,12.1139354265573,0.312631286669307,2020-02-24,2020,2
"549","BA",2,"Nordeste",29003,"Santa Maria da Vitória",182396,22938.7488002478,9,18,6,12,7,11,0,0,0,0,0,18,6,12,7,11,23,10.0405828469225,12.1139354265573,0.306264203821659,2020-03-02,2020,3
"550","BA",2,"Nordeste",29003,"Santa Maria da Vitória",182396,22938.7488002478,10,19,10,9,7,12,1,1,0,0,1,20,11,9,7,13,20,10.0405828469225,12.1139354265573,0.317637597419269,2020-03-09,2020,3
"551","BA",2,"Nordeste",29003,"Santa Maria da Vitória",182396,22938.7488002478,11,16,6,10,5,11,1,0,1,1,0,17,6,11,6,11,26,10.0405828469225,12.1139354265573,0.367549247117038,2020-03-16,2020,3
"552","BA",2,"Nordeste",29003,"Santa Maria da Vitória",182396,22938.7488002478,12,14,4,10,3,11,0,0,0,0,0,14,4,10,3,11,19,10.0405828469225,12.1139354265573,0.470863385989869,2020-03-23,2020,3
"553","BA",2,"Nordeste",29003,"Santa Maria da Vitória",182396,22938.7488002478,13,22,5,17,8,14,0,0,0,0,0,22,5,17,8,14,18,10.0405828469225,12.1139354265573,0.416682436192773,2020-03-30,2020,3
"554","BA",2,"Nordeste",29003,"Santa Maria da Vitória",182396,22938.7488002478,14,18,5,13,6,12,1,1,0,0,1,19,6,13,6,13,19,10.0405828469225,12.1139354265573,0.415315067548235,2020-04-06,2020,4
"555","BA",2,"Nordeste",29003,"Santa Maria da Vitória",182396,22938.7488002478,15,27,9,18,12,15,1,0,1,1,0,28,9,19,13,15,22,10.0405828469225,12.1139354265573,0.378770979687641,2020-04-13,2020,4
"556","BA",2,"Nordeste",29003,"Santa Maria da Vitória",182396,22938.7488002478,16,20,5,15,7,13,1,0,1,1,0,21,5,16,8,13,13,10.0405828469225,12.1139354265573,0.367206927260988,2020-04-20,2020,4
"557","BA",2,"Nordeste",29003,"Santa Maria da Vitória",182396,22938.7488002478,17,34,12,22,21,13,0,0,0,0,0,34,12,22,21,13,18,10.0405828469225,12.1139354265573,0.371084261475766,2020-04-27,2020,4
"558","BA",2,"Nordeste",29003,"Santa Maria da Vitória",182396,22938.7488002478,18,30,8,22,16,14,0,0,0,0,0,30,8,22,16,14,13,10.0405828469225,12.1139354265573,0.360236296401011,2020-05-04,2020,5
"559","BA",2,"Nordeste",29003,"Santa Maria da Vitória",182396,22938.7488002478,19,30,8,22,10,20,0,0,0,0,0,30,8,22,10,20,17,10.0405828469225,12.1139354265573,0.391606745401821,2020-05-11,2020,5
"560","BA",2,"Nordeste",29003,"Santa Maria da Vitória",182396,22938.7488002478,20,24,6,18,13,11,0,0,0,0,0,24,6,18,13,11,19,10.0405828469225,12.1139354265573,0.382918843545811,2020-05-18,2020,5
"561","BA",2,"Nordeste",29003,"Santa Maria da Vitória",182396,22938.7488002478,21,34,11,23,18,16,1,1,0,0,1,35,12,23,18,17,12,10.0405828469225,12.1139354265573,0.386560986911227,2020-05-25,2020,5
"562","BA",2,"Nordeste",29004,"Juazeiro",494980,15408.4189687664,5,137,55,82,64,73,2,0,2,2,0,139,55,84,66,73,53,9.64266932530675,13.1122726366942,0.267285300359557,2020-02-03,2020,2
"563","BA",2,"Nordeste",29004,"Juazeiro",494980,15408.4189687664,6,138,57,81,67,71,1,0,1,0,1,139,57,82,67,72,60,9.64266932530675,13.1122726366942,0.26472158531489,2020-02-10,2020,2
"564","BA",2,"Nordeste",29004,"Juazeiro",494980,15408.4189687664,7,154,61,93,77,77,2,0,2,0,2,156,61,95,77,79,58,9.64266932530675,13.1122726366942,0.284217747373855,2020-02-17,2020,2
"565","BA",2,"Nordeste",29004,"Juazeiro",494980,15408.4189687664,8,153,64,89,71,82,2,1,1,0,2,155,65,90,71,84,64,9.64266932530675,13.1122726366942,0.318099725299967,2020-02-24,2020,2
"566","BA",2,"Nordeste",29004,"Juazeiro",494980,15408.4189687664,9,156,52,104,77,79,2,1,1,1,1,158,53,105,78,80,64,9.64266932530675,13.1122726366942,0.301776619416209,2020-03-02,2020,3
"567","BA",2,"Nordeste",29004,"Juazeiro",494980,15408.4189687664,10,134,46,88,63,71,2,0,2,0,2,136,46,90,63,73,58,9.64266932530675,13.1122726366942,0.3196005280909,2020-03-09,2020,3
"568","BA",2,"Nordeste",29004,"Juazeiro",494980,15408.4189687664,11,119,49,70,52,67,4,1,3,2,2,123,50,73,54,69,46,9.64266932530675,13.1122726366942,0.379411139874431,2020-03-16,2020,3
"569","BA",2,"Nordeste",29004,"Juazeiro",494980,15408.4189687664,12,157,58,99,74,83,2,2,0,0,2,159,60,99,74,85,74,9.64266932530675,13.1122726366942,0.467591600159474,2020-03-23,2020,3
"570","BA",2,"Nordeste",29004,"Juazeiro",494980,15408.4189687664,13,134,55,79,56,78,5,3,2,5,0,139,58,81,61,78,76,9.64266932530675,13.1122726366942,0.42186754462256,2020-03-30,2020,3
"571","BA",2,"Nordeste",29004,"Juazeiro",494980,15408.4189687664,14,149,56,93,79,70,1,1,0,0,1,150,57,93,79,71,53,9.64266932530675,13.1122726366942,0.404320909181706,2020-04-06,2020,4
"572","BA",2,"Nordeste",29004,"Juazeiro",494980,15408.4189687664,15,130,46,84,60,70,1,0,1,1,0,131,46,85,61,70,54,9.64266932530675,13.1122726366942,0.391994473657932,2020-04-13,2020,4
"573","BA",2,"Nordeste",29004,"Juazeiro",494980,15408.4189687664,16,138,64,74,60,78,3,1,2,1,2,141,65,76,61,80,46,9.64266932530675,13.1122726366942,0.386447344781905,2020-04-20,2020,4
"574","BA",2,"Nordeste",29004,"Juazeiro",494980,15408.4189687664,17,159,64,95,80,79,4,1,3,1,3,163,65,98,81,82,57,9.64266932530675,13.1122726366942,0.376666185068309,2020-04-27,2020,4
"575","BA",2,"Nordeste",29004,"Juazeiro",494980,15408.4189687664,18,148,50,98,76,72,3,2,1,2,1,151,52,99,78,73,59,9.64266932530675,13.1122726366942,0.386722020087607,2020-05-04,2020,5
"576","BA",2,"Nordeste",29004,"Juazeiro",494980,15408.4189687664,19,140,61,79,65,75,2,2,0,1,1,142,63,79,66,76,47,9.64266932530675,13.1122726366942,0.408570664559308,2020-05-11,2020,5
"577","BA",2,"Nordeste",29004,"Juazeiro",494980,15408.4189687664,20,141,59,82,55,86,3,2,1,1,2,144,61,83,56,88,67,9.64266932530675,13.1122726366942,0.400539774775137,2020-05-18,2020,5
"578","BA",2,"Nordeste",29004,"Juazeiro",494980,15408.4189687664,21,164,66,98,84,80,2,1,1,1,1,166,67,99,85,81,59,9.64266932530675,13.1122726366942,0.404458348800211,2020-05-25,2020,5
"579","BA",2,"Nordeste",29005,"Paulo Afonso",182526,22174.7689210304,5,46,15,31,19,27,0,0,0,0,0,46,15,31,19,27,18,10.0067103864259,12.1146479076108,0.280934202641983,2020-02-03,2020,2
"580","BA",2,"Nordeste",29005,"Paulo Afonso",182526,22174.7689210304,6,59,21,38,29,30,0,0,0,0,0,59,21,38,29,30,15,10.0067103864259,12.1146479076108,0.279344586961496,2020-02-10,2020,2
"581","BA",2,"Nordeste",29005,"Paulo Afonso",182526,22174.7689210304,7,49,18,31,24,25,0,0,0,0,0,49,18,31,24,25,12,10.0067103864259,12.1146479076108,0.290455351233438,2020-02-17,2020,2
"582","BA",2,"Nordeste",29005,"Paulo Afonso",182526,22174.7689210304,8,50,18,32,16,34,0,0,0,0,0,50,18,32,16,34,20,10.0067103864259,12.1146479076108,0.324937625900316,2020-02-24,2020,2
"583","BA",2,"Nordeste",29005,"Paulo Afonso",182526,22174.7689210304,9,42,22,20,16,26,0,0,0,0,0,42,22,20,16,26,16,10.0067103864259,12.1146479076108,0.301962732133085,2020-03-02,2020,3
"584","BA",2,"Nordeste",29005,"Paulo Afonso",182526,22174.7689210304,10,43,19,24,17,26,2,0,2,1,1,45,19,26,18,27,27,10.0067103864259,12.1146479076108,0.335912287080138,2020-03-09,2020,3
"585","BA",2,"Nordeste",29005,"Paulo Afonso",182526,22174.7689210304,11,58,20,38,27,31,0,0,0,0,0,58,20,38,27,31,24,10.0067103864259,12.1146479076108,0.397940151146668,2020-03-16,2020,3
"586","BA",2,"Nordeste",29005,"Paulo Afonso",182526,22174.7689210304,12,27,7,20,10,17,0,0,0,0,0,27,7,20,10,17,22,10.0067103864259,12.1146479076108,0.484672395421158,2020-03-23,2020,3
"587","BA",2,"Nordeste",29005,"Paulo Afonso",182526,22174.7689210304,13,45,17,28,25,20,1,0,1,0,1,46,17,29,25,21,24,10.0067103864259,12.1146479076108,0.43834503773509,2020-03-30,2020,3
"588","BA",2,"Nordeste",29005,"Paulo Afonso",182526,22174.7689210304,14,38,11,27,23,15,2,1,1,1,1,40,12,28,24,16,26,10.0067103864259,12.1146479076108,0.425508849859028,2020-04-06,2020,4
"589","BA",2,"Nordeste",29005,"Paulo Afonso",182526,22174.7689210304,15,56,19,37,28,28,0,0,0,0,0,56,19,37,28,28,21,10.0067103864259,12.1146479076108,0.41417083802363,2020-04-13,2020,4
"590","BA",2,"Nordeste",29005,"Paulo Afonso",182526,22174.7689210304,16,51,15,36,18,33,0,0,0,0,0,51,15,36,18,33,22,10.0067103864259,12.1146479076108,0.42501189379305,2020-04-20,2020,4
"591","BA",2,"Nordeste",29005,"Paulo Afonso",182526,22174.7689210304,17,45,14,31,17,28,1,0,1,1,0,46,14,32,18,28,19,10.0067103864259,12.1146479076108,0.416040599075488,2020-04-27,2020,4
"592","BA",2,"Nordeste",29005,"Paulo Afonso",182526,22174.7689210304,18,41,15,26,21,20,1,0,1,0,1,42,15,27,21,21,10,10.0067103864259,12.1146479076108,0.408135814313292,2020-05-04,2020,5
"593","BA",2,"Nordeste",29005,"Paulo Afonso",182526,22174.7689210304,19,47,17,30,18,29,1,0,1,1,0,48,17,31,19,29,24,10.0067103864259,12.1146479076108,0.435666359601102,2020-05-11,2020,5
"594","BA",2,"Nordeste",29005,"Paulo Afonso",182526,22174.7689210304,20,47,16,31,21,26,1,1,0,1,0,48,17,31,22,26,17,10.0067103864259,12.1146479076108,0.428145240947812,2020-05-18,2020,5
"595","BA",2,"Nordeste",29005,"Paulo Afonso",182526,22174.7689210304,21,41,10,31,13,28,1,0,1,1,0,42,10,32,14,28,28,10.0067103864259,12.1146479076108,0.432472344351715,2020-05-25,2020,5
"596","BA",2,"Nordeste",29006,"Barra",183168,8489.54721605302,5,44,17,27,23,21,2,0,2,1,1,46,17,29,24,22,12,9.0465909464407,12.1181590434761,0.261273830305725,2020-02-03,2020,2
"597","BA",2,"Nordeste",29006,"Barra",183168,8489.54721605302,6,56,19,37,31,25,0,0,0,0,0,56,19,37,31,25,15,9.0465909464407,12.1181590434761,0.253190226142189,2020-02-10,2020,2
"598","BA",2,"Nordeste",29006,"Barra",183168,8489.54721605302,7,44,18,26,19,25,0,0,0,0,0,44,18,26,19,25,9,9.0465909464407,12.1181590434761,0.264429915629641,2020-02-17,2020,2
"599","BA",2,"Nordeste",29006,"Barra",183168,8489.54721605302,8,58,24,34,28,30,0,0,0,0,0,58,24,34,28,30,18,9.0465909464407,12.1181590434761,0.293756743341664,2020-02-24,2020,2
"600","BA",2,"Nordeste",29006,"Barra",183168,8489.54721605302,9,55,18,37,18,37,0,0,0,0,0,55,18,37,18,37,19,9.0465909464407,12.1181590434761,0.280086209131697,2020-03-02,2020,3
"601","BA",2,"Nordeste",29006,"Barra",183168,8489.54721605302,10,60,29,31,27,33,0,0,0,0,0,60,29,31,27,33,27,9.0465909464407,12.1181590434761,0.301475040604888,2020-03-09,2020,3
"602","BA",2,"Nordeste",29006,"Barra",183168,8489.54721605302,11,44,12,32,16,28,0,0,0,0,0,44,12,32,16,28,23,9.0465909464407,12.1181590434761,0.365048776437826,2020-03-16,2020,3
"603","BA",2,"Nordeste",29006,"Barra",183168,8489.54721605302,12,43,14,29,19,24,2,1,1,1,1,45,15,30,20,25,19,9.0465909464407,12.1181590434761,0.439587159144904,2020-03-23,2020,3
"604","BA",2,"Nordeste",29006,"Barra",183168,8489.54721605302,13,44,19,25,24,20,1,1,0,1,0,45,20,25,25,20,19,9.0465909464407,12.1181590434761,0.403216510873223,2020-03-30,2020,3
"605","BA",2,"Nordeste",29006,"Barra",183168,8489.54721605302,14,44,11,33,21,23,1,1,0,1,0,45,12,33,22,23,26,9.0465909464407,12.1181590434761,0.401488908988735,2020-04-06,2020,4
"606","BA",2,"Nordeste",29006,"Barra",183168,8489.54721605302,15,48,19,29,18,30,0,0,0,0,0,48,19,29,18,30,15,9.0465909464407,12.1181590434761,0.374384597662618,2020-04-13,2020,4
"607","BA",2,"Nordeste",29006,"Barra",183168,8489.54721605302,16,47,15,32,14,33,0,0,0,0,0,47,15,32,14,33,16,9.0465909464407,12.1181590434761,0.352234001101558,2020-04-20,2020,4
"608","BA",2,"Nordeste",29006,"Barra",183168,8489.54721605302,17,55,11,44,32,23,1,0,1,1,0,56,11,45,33,23,18,9.0465909464407,12.1181590434761,0.355404532079992,2020-04-27,2020,4
"609","BA",2,"Nordeste",29006,"Barra",183168,8489.54721605302,18,54,22,32,33,21,3,1,2,2,1,57,23,34,35,22,29,9.0465909464407,12.1181590434761,0.35251745763768,2020-05-04,2020,5
"610","BA",2,"Nordeste",29006,"Barra",183168,8489.54721605302,19,54,16,38,29,25,1,0,1,1,0,55,16,39,30,25,25,9.0465909464407,12.1181590434761,0.375313741813523,2020-05-11,2020,5
"611","BA",2,"Nordeste",29006,"Barra",183168,8489.54721605302,20,57,23,34,32,25,0,0,0,0,0,57,23,34,32,25,21,9.0465909464407,12.1181590434761,0.379841609234249,2020-05-18,2020,5
"612","BA",2,"Nordeste",29006,"Barra",183168,8489.54721605302,21,65,19,46,29,36,1,0,1,1,0,66,19,47,30,36,15,9.0465909464407,12.1181590434761,0.404403926869118,2020-05-25,2020,5
"613","BA",2,"Nordeste",29007,"Bom Jesus da Lapa",181009,10383.8023523692,5,41,11,30,17,24,0,0,0,0,0,41,11,30,17,24,25,9.24800240489998,12.1063020327687,0.291450612557936,2020-02-03,2020,2
"614","BA",2,"Nordeste",29007,"Bom Jesus da Lapa",181009,10383.8023523692,6,45,8,37,19,26,1,1,0,1,0,46,9,37,20,26,14,9.24800240489998,12.1063020327687,0.272672805506507,2020-02-10,2020,2
"615","BA",2,"Nordeste",29007,"Bom Jesus da Lapa",181009,10383.8023523692,7,41,12,29,18,23,0,0,0,0,0,41,12,29,18,23,17,9.24800240489998,12.1063020327687,0.280538661286313,2020-02-17,2020,2
"616","BA",2,"Nordeste",29007,"Bom Jesus da Lapa",181009,10383.8023523692,8,44,9,35,24,20,0,0,0,0,0,44,9,35,24,20,18,9.24800240489998,12.1063020327687,0.316973223806743,2020-02-24,2020,2
"617","BA",2,"Nordeste",29007,"Bom Jesus da Lapa",181009,10383.8023523692,9,39,10,29,18,21,1,0,1,0,1,40,10,30,18,22,18,9.24800240489998,12.1063020327687,0.311386465205801,2020-03-02,2020,3
"618","BA",2,"Nordeste",29007,"Bom Jesus da Lapa",181009,10383.8023523692,10,41,9,32,15,26,0,0,0,0,0,41,9,32,15,26,25,9.24800240489998,12.1063020327687,0.328517925487702,2020-03-09,2020,3
"619","BA",2,"Nordeste",29007,"Bom Jesus da Lapa",181009,10383.8023523692,11,37,9,28,22,15,2,1,1,0,2,39,10,29,22,17,16,9.24800240489998,12.1063020327687,0.367138726695715,2020-03-16,2020,3
"620","BA",2,"Nordeste",29007,"Bom Jesus da Lapa",181009,10383.8023523692,12,33,11,22,16,17,2,1,1,0,2,35,12,23,16,19,22,9.24800240489998,12.1063020327687,0.473135293368512,2020-03-23,2020,3
"621","BA",2,"Nordeste",29007,"Bom Jesus da Lapa",181009,10383.8023523692,13,27,6,21,13,14,0,0,0,0,0,27,6,21,13,14,15,9.24800240489998,12.1063020327687,0.412263836880625,2020-03-30,2020,3
"622","BA",2,"Nordeste",29007,"Bom Jesus da Lapa",181009,10383.8023523692,14,38,10,28,18,20,1,0,1,0,1,39,10,29,18,21,26,9.24800240489998,12.1063020327687,0.405661645039467,2020-04-06,2020,4
"623","BA",2,"Nordeste",29007,"Bom Jesus da Lapa",181009,10383.8023523692,15,36,10,26,19,17,0,0,0,0,0,36,10,26,19,17,12,9.24800240489998,12.1063020327687,0.383840784265562,2020-04-13,2020,4
"624","BA",2,"Nordeste",29007,"Bom Jesus da Lapa",181009,10383.8023523692,16,41,15,26,12,29,0,0,0,0,0,41,15,26,12,29,18,9.24800240489998,12.1063020327687,0.373817489803645,2020-04-20,2020,4
"625","BA",2,"Nordeste",29007,"Bom Jesus da Lapa",181009,10383.8023523692,17,47,14,33,26,21,1,0,1,0,1,48,14,34,26,22,21,9.24800240489998,12.1063020327687,0.362297486729622,2020-04-27,2020,4
"626","BA",2,"Nordeste",29007,"Bom Jesus da Lapa",181009,10383.8023523692,18,50,16,34,14,36,1,0,1,1,0,51,16,35,15,36,23,9.24800240489998,12.1063020327687,0.372133545189815,2020-05-04,2020,5
"627","BA",2,"Nordeste",29007,"Bom Jesus da Lapa",181009,10383.8023523692,19,35,13,22,19,16,1,1,0,0,1,36,14,22,19,17,22,9.24800240489998,12.1063020327687,0.385776707265237,2020-05-11,2020,5
"628","BA",2,"Nordeste",29007,"Bom Jesus da Lapa",181009,10383.8023523692,20,38,12,26,13,25,1,1,0,0,1,39,13,26,13,26,17,9.24800240489998,12.1063020327687,0.397332896604892,2020-05-18,2020,5
"629","BA",2,"Nordeste",29007,"Bom Jesus da Lapa",181009,10383.8023523692,21,47,9,38,17,30,0,0,0,0,0,47,9,38,17,30,19,9.24800240489998,12.1063020327687,0.40705045085843,2020-05-25,2020,5
"630","BA",2,"Nordeste",29008,"Senhor do Bonfim",302999,11861.7717789498,5,68,24,44,27,41,1,1,0,0,1,69,25,44,27,42,31,9.38107605253645,12.621484784156,0.275027761230423,2020-02-03,2020,2
"631","BA",2,"Nordeste",29008,"Senhor do Bonfim",302999,11861.7717789498,6,92,22,70,37,55,0,0,0,0,0,92,22,70,37,55,41,9.38107605253645,12.621484784156,0.274079532479807,2020-02-10,2020,2
"632","BA",2,"Nordeste",29008,"Senhor do Bonfim",302999,11861.7717789498,7,68,20,48,27,41,0,0,0,0,0,68,20,48,27,41,33,9.38107605253645,12.621484784156,0.283848249318343,2020-02-17,2020,2
"633","BA",2,"Nordeste",29008,"Senhor do Bonfim",302999,11861.7717789498,8,70,15,55,30,40,0,0,0,0,0,70,15,55,30,40,53,9.38107605253645,12.621484784156,0.317387182026579,2020-02-24,2020,2
"634","BA",2,"Nordeste",29008,"Senhor do Bonfim",302999,11861.7717789498,9,77,23,54,36,41,2,0,2,1,1,79,23,56,37,42,36,9.38107605253645,12.621484784156,0.29717689297505,2020-03-02,2020,3
"635","BA",2,"Nordeste",29008,"Senhor do Bonfim",302999,11861.7717789498,10,71,22,49,34,37,0,0,0,0,0,71,22,49,34,37,47,9.38107605253645,12.621484784156,0.319640763288713,2020-03-09,2020,3
"636","BA",2,"Nordeste",29008,"Senhor do Bonfim",302999,11861.7717789498,11,62,26,36,28,34,1,0,1,0,1,63,26,37,28,35,36,9.38107605253645,12.621484784156,0.370556915308032,2020-03-16,2020,3
"637","BA",2,"Nordeste",29008,"Senhor do Bonfim",302999,11861.7717789498,12,66,23,43,27,39,0,0,0,0,0,66,23,43,27,39,43,9.38107605253645,12.621484784156,0.482974053089971,2020-03-23,2020,3
"638","BA",2,"Nordeste",29008,"Senhor do Bonfim",302999,11861.7717789498,13,56,14,42,23,33,1,1,0,0,1,57,15,42,23,34,44,9.38107605253645,12.621484784156,0.442849413288319,2020-03-30,2020,3
"639","BA",2,"Nordeste",29008,"Senhor do Bonfim",302999,11861.7717789498,14,64,16,48,32,32,2,1,1,1,1,66,17,49,33,33,35,9.38107605253645,12.621484784156,0.419953790335328,2020-04-06,2020,4
"640","BA",2,"Nordeste",29008,"Senhor do Bonfim",302999,11861.7717789498,15,63,23,40,36,27,2,0,2,1,1,65,23,42,37,28,32,9.38107605253645,12.621484784156,0.392914503297588,2020-04-13,2020,4
"641","BA",2,"Nordeste",29008,"Senhor do Bonfim",302999,11861.7717789498,16,67,30,37,31,36,1,0,1,1,0,68,30,38,32,36,36,9.38107605253645,12.621484784156,0.394342419718659,2020-04-20,2020,4
"642","BA",2,"Nordeste",29008,"Senhor do Bonfim",302999,11861.7717789498,17,69,22,47,31,38,1,1,0,1,0,70,23,47,32,38,33,9.38107605253645,12.621484784156,0.376578619954116,2020-04-27,2020,4
"643","BA",2,"Nordeste",29008,"Senhor do Bonfim",302999,11861.7717789498,18,71,27,44,29,42,2,0,2,0,2,73,27,46,29,44,41,9.38107605253645,12.621484784156,0.384193882240875,2020-05-04,2020,5
"644","BA",2,"Nordeste",29008,"Senhor do Bonfim",302999,11861.7717789498,19,73,22,51,35,38,1,0,1,1,0,74,22,52,36,38,39,9.38107605253645,12.621484784156,0.408811914368271,2020-05-11,2020,5
"645","BA",2,"Nordeste",29008,"Senhor do Bonfim",302999,11861.7717789498,20,80,39,41,44,36,0,0,0,0,0,80,39,41,44,36,39,9.38107605253645,12.621484784156,0.41844153913378,2020-05-18,2020,5
"646","BA",2,"Nordeste",29008,"Senhor do Bonfim",302999,11861.7717789498,21,75,19,56,28,47,1,1,0,0,1,76,20,56,28,48,35,9.38107605253645,12.621484784156,0.416858217717427,2020-05-25,2020,5
"647","BA",2,"Nordeste",29009,"Irecê",396256,10555.4974973754,5,100,25,75,36,64,0,0,0,0,0,100,25,75,36,64,50,9.26440209298269,12.8898157460148,0.28173579142088,2020-02-03,2020,2
"648","BA",2,"Nordeste",29009,"Irecê",396256,10555.4974973754,6,78,25,53,33,45,1,0,1,0,1,79,25,54,33,46,55,9.26440209298269,12.8898157460148,0.276733179657586,2020-02-10,2020,2
"649","BA",2,"Nordeste",29009,"Irecê",396256,10555.4974973754,7,96,25,71,40,56,0,0,0,0,0,96,25,71,40,56,60,9.26440209298269,12.8898157460148,0.298557808664513,2020-02-17,2020,2
"650","BA",2,"Nordeste",29009,"Irecê",396256,10555.4974973754,8,76,24,52,39,37,1,0,1,1,0,77,24,53,40,37,44,9.26440209298269,12.8898157460148,0.327552757464609,2020-02-24,2020,2
"651","BA",2,"Nordeste",29009,"Irecê",396256,10555.4974973754,9,83,23,60,38,45,0,0,0,0,0,83,23,60,38,45,49,9.26440209298269,12.8898157460148,0.309152663730736,2020-03-02,2020,3
"652","BA",2,"Nordeste",29009,"Irecê",396256,10555.4974973754,10,74,25,49,33,41,1,0,1,0,1,75,25,50,33,42,37,9.26440209298269,12.8898157460148,0.33424073855141,2020-03-09,2020,3
"653","BA",2,"Nordeste",29009,"Irecê",396256,10555.4974973754,11,70,20,50,26,44,1,1,0,0,1,71,21,50,26,45,51,9.26440209298269,12.8898157460148,0.389381785339032,2020-03-16,2020,3
"654","BA",2,"Nordeste",29009,"Irecê",396256,10555.4974973754,12,80,21,59,36,44,1,0,1,1,0,81,21,60,37,44,41,9.26440209298269,12.8898157460148,0.498461347961917,2020-03-23,2020,3
"655","BA",2,"Nordeste",29009,"Irecê",396256,10555.4974973754,13,70,18,52,32,38,3,1,2,3,0,73,19,54,35,38,39,9.26440209298269,12.8898157460148,0.447986024235835,2020-03-30,2020,3
"656","BA",2,"Nordeste",29009,"Irecê",396256,10555.4974973754,14,84,33,51,40,44,3,1,2,3,0,87,34,53,43,44,40,9.26440209298269,12.8898157460148,0.427818441414856,2020-04-06,2020,4
"657","BA",2,"Nordeste",29009,"Irecê",396256,10555.4974973754,15,82,24,58,30,52,3,0,3,3,0,85,24,61,33,52,51,9.26440209298269,12.8898157460148,0.414885018362114,2020-04-13,2020,4
"658","BA",2,"Nordeste",29009,"Irecê",396256,10555.4974973754,16,79,23,56,28,51,1,1,0,1,0,80,24,56,29,51,50,9.26440209298269,12.8898157460148,0.397864165266356,2020-04-20,2020,4
"659","BA",2,"Nordeste",29009,"Irecê",396256,10555.4974973754,17,91,38,53,41,50,0,0,0,0,0,91,38,53,41,50,69,9.26440209298269,12.8898157460148,0.378019993454718,2020-04-27,2020,4
"660","BA",2,"Nordeste",29009,"Irecê",396256,10555.4974973754,18,81,31,50,39,42,0,0,0,0,0,81,31,50,39,42,47,9.26440209298269,12.8898157460148,0.387043676390827,2020-05-04,2020,5
"661","BA",2,"Nordeste",29009,"Irecê",396256,10555.4974973754,19,100,25,75,44,56,2,1,1,0,2,102,26,76,44,58,70,9.26440209298269,12.8898157460148,0.410310539163748,2020-05-11,2020,5
"662","BA",2,"Nordeste",29009,"Irecê",396256,10555.4974973754,20,97,27,70,45,52,0,0,0,0,0,97,27,70,45,52,49,9.26440209298269,12.8898157460148,0.402528833780362,2020-05-18,2020,5
"663","BA",2,"Nordeste",29009,"Irecê",396256,10555.4974973754,21,119,33,86,43,76,3,2,1,1,2,122,35,87,44,78,40,9.26440209298269,12.8898157460148,0.407498273760131,2020-05-25,2020,5
"664","BA",2,"Nordeste",29010,"Jacobina",338733,10736.749558797,5,71,16,55,26,45,0,0,0,0,0,71,16,55,26,45,38,9.28142767409896,12.7329674654149,0.265547763869258,2020-02-03,2020,2
"665","BA",2,"Nordeste",29010,"Jacobina",338733,10736.749558797,6,79,27,52,32,47,0,0,0,0,0,79,27,52,32,47,47,9.28142767409896,12.7329674654149,0.261553685312273,2020-02-10,2020,2
"666","BA",2,"Nordeste",29010,"Jacobina",338733,10736.749558797,7,79,26,53,37,42,0,0,0,0,0,79,26,53,37,42,42,9.28142767409896,12.7329674654149,0.282108643440482,2020-02-17,2020,2
"667","BA",2,"Nordeste",29010,"Jacobina",338733,10736.749558797,8,62,25,37,26,36,0,0,0,0,0,62,25,37,26,36,47,9.28142767409896,12.7329674654149,0.310650997591176,2020-02-24,2020,2
"668","BA",2,"Nordeste",29010,"Jacobina",338733,10736.749558797,9,66,26,40,33,33,1,0,1,1,0,67,26,41,34,33,43,9.28142767409896,12.7329674654149,0.291787123490762,2020-03-02,2020,3
"669","BA",2,"Nordeste",29010,"Jacobina",338733,10736.749558797,10,74,32,42,27,47,0,0,0,0,0,74,32,42,27,47,46,9.28142767409896,12.7329674654149,0.314733941810375,2020-03-09,2020,3
"670","BA",2,"Nordeste",29010,"Jacobina",338733,10736.749558797,11,51,20,31,29,22,1,0,1,1,0,52,20,32,30,22,48,9.28142767409896,12.7329674654149,0.370794357292852,2020-03-16,2020,3
"671","BA",2,"Nordeste",29010,"Jacobina",338733,10736.749558797,12,68,24,44,35,33,2,1,1,2,0,70,25,45,37,33,42,9.28142767409896,12.7329674654149,0.466951191361533,2020-03-23,2020,3
"672","BA",2,"Nordeste",29010,"Jacobina",338733,10736.749558797,13,51,14,37,14,37,0,0,0,0,0,51,14,37,14,37,40,9.28142767409896,12.7329674654149,0.425301763135626,2020-03-30,2020,3
"673","BA",2,"Nordeste",29010,"Jacobina",338733,10736.749558797,14,80,27,53,31,49,0,0,0,0,0,80,27,53,31,49,35,9.28142767409896,12.7329674654149,0.406725458546642,2020-04-06,2020,4
"674","BA",2,"Nordeste",29010,"Jacobina",338733,10736.749558797,15,53,25,28,22,31,0,0,0,0,0,53,25,28,22,31,44,9.28142767409896,12.7329674654149,0.385067582712123,2020-04-13,2020,4
"675","BA",2,"Nordeste",29010,"Jacobina",338733,10736.749558797,16,62,29,33,25,37,1,0,1,1,0,63,29,34,26,37,51,9.28142767409896,12.7329674654149,0.376314280895369,2020-04-20,2020,4
"676","BA",2,"Nordeste",29010,"Jacobina",338733,10736.749558797,17,78,21,57,26,52,0,0,0,0,0,78,21,57,26,52,43,9.28142767409896,12.7329674654149,0.367407114415797,2020-04-27,2020,4
"677","BA",2,"Nordeste",29010,"Jacobina",338733,10736.749558797,18,62,22,40,25,37,0,0,0,0,0,62,22,40,25,37,43,9.28142767409896,12.7329674654149,0.379924027289158,2020-05-04,2020,5
"678","BA",2,"Nordeste",29010,"Jacobina",338733,10736.749558797,19,72,25,47,35,37,0,0,0,0,0,72,25,47,35,37,56,9.28142767409896,12.7329674654149,0.410401235452028,2020-05-11,2020,5
"679","BA",2,"Nordeste",29010,"Jacobina",338733,10736.749558797,20,77,24,53,36,41,0,0,0,0,0,77,24,53,36,41,47,9.28142767409896,12.7329674654149,0.407867512887122,2020-05-18,2020,5
"680","BA",2,"Nordeste",29010,"Jacobina",338733,10736.749558797,21,66,28,38,30,36,0,0,0,0,0,66,28,38,30,36,45,9.28142767409896,12.7329674654149,0.400219216769505,2020-05-25,2020,5
"681","BA",2,"Nordeste",29011,"Itaberaba",254407,9217.02920304866,5,45,15,30,20,25,1,0,1,1,0,46,15,31,21,25,29,9.12880805237843,12.4466906257928,0.265441272663372,2020-02-03,2020,2
"682","BA",2,"Nordeste",29011,"Itaberaba",254407,9217.02920304866,6,39,13,26,20,19,0,0,0,0,0,39,13,26,20,19,27,9.12880805237843,12.4466906257928,0.262539489510451,2020-02-10,2020,2
"683","BA",2,"Nordeste",29011,"Itaberaba",254407,9217.02920304866,7,58,18,40,22,36,1,1,0,1,0,59,19,40,23,36,32,9.12880805237843,12.4466906257928,0.272655832794178,2020-02-17,2020,2
"684","BA",2,"Nordeste",29011,"Itaberaba",254407,9217.02920304866,8,53,16,37,29,24,0,0,0,0,0,53,16,37,29,24,35,9.12880805237843,12.4466906257928,0.305410558718724,2020-02-24,2020,2
"685","BA",2,"Nordeste",29011,"Itaberaba",254407,9217.02920304866,9,45,20,25,19,26,0,0,0,0,0,45,20,25,19,26,44,9.12880805237843,12.4466906257928,0.281418701540315,2020-03-02,2020,3
"686","BA",2,"Nordeste",29011,"Itaberaba",254407,9217.02920304866,10,41,8,33,23,18,2,1,1,1,1,43,9,34,24,19,27,9.12880805237843,12.4466906257928,0.306976432761337,2020-03-09,2020,3
"687","BA",2,"Nordeste",29011,"Itaberaba",254407,9217.02920304866,11,43,23,20,22,21,1,1,0,1,0,44,24,20,23,21,34,9.12880805237843,12.4466906257928,0.363293711287349,2020-03-16,2020,3
"688","BA",2,"Nordeste",29011,"Itaberaba",254407,9217.02920304866,12,40,12,28,15,25,0,0,0,0,0,40,12,28,15,25,32,9.12880805237843,12.4466906257928,0.446957594407689,2020-03-23,2020,3
"689","BA",2,"Nordeste",29011,"Itaberaba",254407,9217.02920304866,13,43,12,31,21,22,0,0,0,0,0,43,12,31,21,22,38,9.12880805237843,12.4466906257928,0.400881471831919,2020-03-30,2020,3
"690","BA",2,"Nordeste",29011,"Itaberaba",254407,9217.02920304866,14,47,19,28,19,28,1,0,1,0,1,48,19,29,19,29,34,9.12880805237843,12.4466906257928,0.384080030929968,2020-04-06,2020,4
"691","BA",2,"Nordeste",29011,"Itaberaba",254407,9217.02920304866,15,40,16,24,20,20,0,0,0,0,0,40,16,24,20,20,36,9.12880805237843,12.4466906257928,0.370358158587408,2020-04-13,2020,4
"692","BA",2,"Nordeste",29011,"Itaberaba",254407,9217.02920304866,16,34,11,23,15,19,0,0,0,0,0,34,11,23,15,19,26,9.12880805237843,12.4466906257928,0.374107125495855,2020-04-20,2020,4
"693","BA",2,"Nordeste",29011,"Itaberaba",254407,9217.02920304866,17,54,23,31,23,31,0,0,0,0,0,54,23,31,23,31,32,9.12880805237843,12.4466906257928,0.353138408760229,2020-04-27,2020,4
"694","BA",2,"Nordeste",29011,"Itaberaba",254407,9217.02920304866,18,42,13,29,17,25,1,0,1,0,1,43,13,30,17,26,41,9.12880805237843,12.4466906257928,0.359003836143479,2020-05-04,2020,5
"695","BA",2,"Nordeste",29011,"Itaberaba",254407,9217.02920304866,19,51,16,35,20,31,2,1,1,2,0,53,17,36,22,31,36,9.12880805237843,12.4466906257928,0.389084502215856,2020-05-11,2020,5
"696","BA",2,"Nordeste",29011,"Itaberaba",254407,9217.02920304866,20,40,14,26,19,21,0,0,0,0,0,40,14,26,19,21,36,9.12880805237843,12.4466906257928,0.397765867591089,2020-05-18,2020,5
"697","BA",2,"Nordeste",29011,"Itaberaba",254407,9217.02920304866,21,33,12,21,14,19,0,0,0,0,0,33,12,21,14,19,35,9.12880805237843,12.4466906257928,0.389074854593133,2020-05-25,2020,5
"698","BA",2,"Nordeste",29012,"Feira de Santana",1074399,20598.3030721268,5,226,63,163,77,149,1,1,0,0,1,227,64,163,77,150,130,9.93296397624518,13.8872719934387,0.256200837678845,2020-02-03,2020,2
"699","BA",2,"Nordeste",29012,"Feira de Santana",1074399,20598.3030721268,6,202,64,138,79,123,3,0,3,0,3,205,64,141,79,126,127,9.93296397624518,13.8872719934387,0.252185257126057,2020-02-10,2020,2
"700","BA",2,"Nordeste",29012,"Feira de Santana",1074399,20598.3030721268,7,197,65,132,79,118,2,1,1,0,2,199,66,133,79,120,124,9.93296397624518,13.8872719934387,0.272662081540647,2020-02-17,2020,2
"701","BA",2,"Nordeste",29012,"Feira de Santana",1074399,20598.3030721268,8,223,64,159,72,151,2,1,1,0,2,225,65,160,72,153,144,9.93296397624518,13.8872719934387,0.31138488747203,2020-02-24,2020,2
"702","BA",2,"Nordeste",29012,"Feira de Santana",1074399,20598.3030721268,9,229,69,160,77,152,1,1,0,1,0,230,70,160,78,152,133,9.93296397624518,13.8872719934387,0.285980047359649,2020-03-02,2020,3
"703","BA",2,"Nordeste",29012,"Feira de Santana",1074399,20598.3030721268,10,207,50,157,65,142,1,1,0,1,0,208,51,157,66,142,146,9.93296397624518,13.8872719934387,0.307571488584294,2020-03-09,2020,3
"704","BA",2,"Nordeste",29012,"Feira de Santana",1074399,20598.3030721268,11,210,65,145,78,132,1,0,1,1,0,211,65,146,79,132,156,9.93296397624518,13.8872719934387,0.37687798086221,2020-03-16,2020,3
"705","BA",2,"Nordeste",29012,"Feira de Santana",1074399,20598.3030721268,12,197,54,143,73,124,4,2,2,2,2,201,56,145,75,126,149,9.93296397624518,13.8872719934387,0.482308545008787,2020-03-23,2020,3
"706","BA",2,"Nordeste",29012,"Feira de Santana",1074399,20598.3030721268,13,181,46,135,68,113,2,1,1,0,2,183,47,136,68,115,149,9.93296397624518,13.8872719934387,0.429151628178048,2020-03-30,2020,3
"707","BA",2,"Nordeste",29012,"Feira de Santana",1074399,20598.3030721268,14,199,56,143,61,138,1,0,1,0,1,200,56,144,61,139,151,9.93296397624518,13.8872719934387,0.421011348791236,2020-04-06,2020,4
"708","BA",2,"Nordeste",29012,"Feira de Santana",1074399,20598.3030721268,15,194,47,147,67,127,3,1,2,1,2,197,48,149,68,129,120,9.93296397624518,13.8872719934387,0.399862465682148,2020-04-13,2020,4
"709","BA",2,"Nordeste",29012,"Feira de Santana",1074399,20598.3030721268,16,200,52,148,64,136,2,1,1,1,1,202,53,149,65,137,158,9.93296397624518,13.8872719934387,0.410475049087012,2020-04-20,2020,4
"710","BA",2,"Nordeste",29012,"Feira de Santana",1074399,20598.3030721268,17,197,63,134,79,118,2,0,2,1,1,199,63,136,80,119,133,9.93296397624518,13.8872719934387,0.38079708025698,2020-04-27,2020,4
"711","BA",2,"Nordeste",29012,"Feira de Santana",1074399,20598.3030721268,18,207,54,153,70,137,3,2,1,1,2,210,56,154,71,139,127,9.93296397624518,13.8872719934387,0.37895687338796,2020-05-04,2020,5
"712","BA",2,"Nordeste",29012,"Feira de Santana",1074399,20598.3030721268,19,208,51,157,66,142,1,0,1,0,1,209,51,158,66,143,145,9.93296397624518,13.8872719934387,0.391136997429104,2020-05-11,2020,5
"713","BA",2,"Nordeste",29012,"Feira de Santana",1074399,20598.3030721268,20,185,47,138,72,113,3,1,2,2,1,188,48,140,74,114,154,9.93296397624518,13.8872719934387,0.394969891904516,2020-05-18,2020,5
"714","BA",2,"Nordeste",29012,"Feira de Santana",1074399,20598.3030721268,21,214,56,158,70,144,3,0,3,0,3,217,56,161,70,147,156,9.93296397624518,13.8872719934387,0.404247278946652,2020-05-25,2020,5
"715","BA",2,"Nordeste",29013,"Jeremoabo",96814,7472.34199919433,5,25,10,15,10,15,0,0,0,0,0,25,10,15,10,15,8,8.91896374963135,11.4805468909062,0.275676466242816,2020-02-03,2020,2
"716","BA",2,"Nordeste",29013,"Jeremoabo",96814,7472.34199919433,6,15,6,9,5,10,0,0,0,0,0,15,6,9,5,10,3,8.91896374963135,11.4805468909062,0.27540574867214,2020-02-10,2020,2
"717","BA",2,"Nordeste",29013,"Jeremoabo",96814,7472.34199919433,7,13,7,6,7,6,0,0,0,0,0,13,7,6,7,6,12,8.91896374963135,11.4805468909062,0.28384212038931,2020-02-17,2020,2
"718","BA",2,"Nordeste",29013,"Jeremoabo",96814,7472.34199919433,8,19,8,11,6,13,0,0,0,0,0,19,8,11,6,13,14,8.91896374963135,11.4805468909062,0.321883393020921,2020-02-24,2020,2
"719","BA",2,"Nordeste",29013,"Jeremoabo",96814,7472.34199919433,9,24,14,10,13,11,0,0,0,0,0,24,14,10,13,11,12,8.91896374963135,11.4805468909062,0.295242735693623,2020-03-02,2020,3
"720","BA",2,"Nordeste",29013,"Jeremoabo",96814,7472.34199919433,10,19,10,9,10,9,0,0,0,0,0,19,10,9,10,9,12,8.91896374963135,11.4805468909062,0.333425674813725,2020-03-09,2020,3
"721","BA",2,"Nordeste",29013,"Jeremoabo",96814,7472.34199919433,11,23,12,11,9,14,0,0,0,0,0,23,12,11,9,14,12,8.91896374963135,11.4805468909062,0.378302255394209,2020-03-16,2020,3
"722","BA",2,"Nordeste",29013,"Jeremoabo",96814,7472.34199919433,12,12,6,6,4,8,0,0,0,0,0,12,6,6,4,8,5,8.91896374963135,11.4805468909062,0.464638557633884,2020-03-23,2020,3
"723","BA",2,"Nordeste",29013,"Jeremoabo",96814,7472.34199919433,13,18,9,9,14,4,0,0,0,0,0,18,9,9,14,4,18,8.91896374963135,11.4805468909062,0.40784093601824,2020-03-30,2020,3
"724","BA",2,"Nordeste",29013,"Jeremoabo",96814,7472.34199919433,14,21,12,9,13,8,0,0,0,0,0,21,12,9,13,8,12,8.91896374963135,11.4805468909062,0.402445587935162,2020-04-06,2020,4
"725","BA",2,"Nordeste",29013,"Jeremoabo",96814,7472.34199919433,15,10,2,8,2,8,0,0,0,0,0,10,2,8,2,8,9,8.91896374963135,11.4805468909062,0.376345824982891,2020-04-13,2020,4
"726","BA",2,"Nordeste",29013,"Jeremoabo",96814,7472.34199919433,16,20,12,8,12,8,0,0,0,0,0,20,12,8,12,8,11,8.91896374963135,11.4805468909062,0.388667506651861,2020-04-20,2020,4
"727","BA",2,"Nordeste",29013,"Jeremoabo",96814,7472.34199919433,17,20,9,11,10,10,1,1,0,0,1,21,10,11,10,11,16,8.91896374963135,11.4805468909062,0.381769020356851,2020-04-27,2020,4
"728","BA",2,"Nordeste",29013,"Jeremoabo",96814,7472.34199919433,18,13,4,9,7,6,0,0,0,0,0,13,4,9,7,6,9,8.91896374963135,11.4805468909062,0.399685199788823,2020-05-04,2020,5
"729","BA",2,"Nordeste",29013,"Jeremoabo",96814,7472.34199919433,19,17,7,10,9,8,0,0,0,0,0,17,7,10,9,8,10,8.91896374963135,11.4805468909062,0.416481272270631,2020-05-11,2020,5
"730","BA",2,"Nordeste",29013,"Jeremoabo",96814,7472.34199919433,20,24,15,9,8,16,0,0,0,0,0,24,15,9,8,16,10,8.91896374963135,11.4805468909062,0.412948635596799,2020-05-18,2020,5
"731","BA",2,"Nordeste",29013,"Jeremoabo",96814,7472.34199919433,21,24,14,10,7,17,0,0,0,0,0,24,14,10,7,17,9,8.91896374963135,11.4805468909062,0.408439787940916,2020-05-25,2020,5
"732","BA",2,"Nordeste",29014,"Euclides da Cunha",302905,8131.23719149568,5,60,25,35,30,30,0,0,0,0,0,60,25,35,30,30,38,9.00346836703998,12.6211745039771,0.278502324566193,2020-02-03,2020,2
"733","BA",2,"Nordeste",29014,"Euclides da Cunha",302905,8131.23719149568,6,48,22,26,18,30,1,1,0,0,1,49,23,26,18,31,36,9.00346836703998,12.6211745039771,0.266522766395772,2020-02-10,2020,2
"734","BA",2,"Nordeste",29014,"Euclides da Cunha",302905,8131.23719149568,7,67,27,40,30,37,0,0,0,0,0,67,27,40,30,37,44,9.00346836703998,12.6211745039771,0.280782822420355,2020-02-17,2020,2
"735","BA",2,"Nordeste",29014,"Euclides da Cunha",302905,8131.23719149568,8,70,23,47,31,39,0,0,0,0,0,70,23,47,31,39,41,9.00346836703998,12.6211745039771,0.311457976067896,2020-02-24,2020,2
"736","BA",2,"Nordeste",29014,"Euclides da Cunha",302905,8131.23719149568,9,60,16,44,24,36,1,0,1,0,1,61,16,45,24,37,34,9.00346836703998,12.6211745039771,0.296006260000623,2020-03-02,2020,3
"737","BA",2,"Nordeste",29014,"Euclides da Cunha",302905,8131.23719149568,10,50,17,33,23,27,0,0,0,0,0,50,17,33,23,27,25,9.00346836703998,12.6211745039771,0.322164449494003,2020-03-09,2020,3
"738","BA",2,"Nordeste",29014,"Euclides da Cunha",302905,8131.23719149568,11,55,24,31,32,23,2,1,1,1,1,57,25,32,33,24,33,9.00346836703998,12.6211745039771,0.37367710366669,2020-03-16,2020,3
"739","BA",2,"Nordeste",29014,"Euclides da Cunha",302905,8131.23719149568,12,46,23,23,19,27,1,1,0,0,1,47,24,23,19,28,31,9.00346836703998,12.6211745039771,0.464920506665739,2020-03-23,2020,3
"740","BA",2,"Nordeste",29014,"Euclides da Cunha",302905,8131.23719149568,13,56,19,37,31,25,0,0,0,0,0,56,19,37,31,25,31,9.00346836703998,12.6211745039771,0.421512766858692,2020-03-30,2020,3
"741","BA",2,"Nordeste",29014,"Euclides da Cunha",302905,8131.23719149568,14,55,26,29,28,27,3,1,2,1,2,58,27,31,29,29,37,9.00346836703998,12.6211745039771,0.410113529353013,2020-04-06,2020,4
"742","BA",2,"Nordeste",29014,"Euclides da Cunha",302905,8131.23719149568,15,61,19,42,24,37,1,1,0,0,1,62,20,42,24,38,40,9.00346836703998,12.6211745039771,0.396268872319404,2020-04-13,2020,4
"743","BA",2,"Nordeste",29014,"Euclides da Cunha",302905,8131.23719149568,16,58,36,22,34,24,0,0,0,0,0,58,36,22,34,24,27,9.00346836703998,12.6211745039771,0.39281122395941,2020-04-20,2020,4
"744","BA",2,"Nordeste",29014,"Euclides da Cunha",302905,8131.23719149568,17,87,33,54,38,49,3,2,1,2,1,90,35,55,40,50,27,9.00346836703998,12.6211745039771,0.374884860726565,2020-04-27,2020,4
"745","BA",2,"Nordeste",29014,"Euclides da Cunha",302905,8131.23719149568,18,66,30,36,36,30,2,2,0,1,1,68,32,36,37,31,38,9.00346836703998,12.6211745039771,0.398452992071871,2020-05-04,2020,5
"746","BA",2,"Nordeste",29014,"Euclides da Cunha",302905,8131.23719149568,19,77,27,50,39,38,0,0,0,0,0,77,27,50,39,38,46,9.00346836703998,12.6211745039771,0.420640032102934,2020-05-11,2020,5
"747","BA",2,"Nordeste",29014,"Euclides da Cunha",302905,8131.23719149568,20,62,26,36,23,39,0,0,0,0,0,62,26,36,23,39,33,9.00346836703998,12.6211745039771,0.42708285672049,2020-05-18,2020,5
"748","BA",2,"Nordeste",29014,"Euclides da Cunha",302905,8131.23719149568,21,76,36,40,36,40,0,0,0,0,0,76,36,40,36,40,29,9.00346836703998,12.6211745039771,0.411267548124878,2020-05-25,2020,5
"749","BA",2,"Nordeste",29015,"Ribeira do Pombal",334859,8238.86776720948,5,52,19,33,22,30,0,0,0,0,0,52,19,33,22,30,39,9.01661820657027,12.7214648266834,0.266953693370573,2020-02-03,2020,2
"750","BA",2,"Nordeste",29015,"Ribeira do Pombal",334859,8238.86776720948,6,57,21,36,25,32,0,0,0,0,0,57,21,36,25,32,27,9.01661820657027,12.7214648266834,0.260599029189948,2020-02-10,2020,2
"751","BA",2,"Nordeste",29015,"Ribeira do Pombal",334859,8238.86776720948,7,75,28,47,32,43,0,0,0,0,0,75,28,47,32,43,26,9.01661820657027,12.7214648266834,0.277933532483517,2020-02-17,2020,2
"752","BA",2,"Nordeste",29015,"Ribeira do Pombal",334859,8238.86776720948,8,65,27,38,34,31,0,0,0,0,0,65,27,38,34,31,38,9.01661820657027,12.7214648266834,0.314743847710497,2020-02-24,2020,2
"753","BA",2,"Nordeste",29015,"Ribeira do Pombal",334859,8238.86776720948,9,62,23,39,29,33,0,0,0,0,0,62,23,39,29,33,28,9.01661820657027,12.7214648266834,0.292890647877383,2020-03-02,2020,3
"754","BA",2,"Nordeste",29015,"Ribeira do Pombal",334859,8238.86776720948,10,43,20,23,17,26,2,2,0,0,2,45,22,23,17,28,40,9.01661820657027,12.7214648266834,0.312098908923563,2020-03-09,2020,3
"755","BA",2,"Nordeste",29015,"Ribeira do Pombal",334859,8238.86776720948,11,49,26,23,25,24,1,0,1,0,1,50,26,24,25,25,34,9.01661820657027,12.7214648266834,0.37196928100859,2020-03-16,2020,3
"756","BA",2,"Nordeste",29015,"Ribeira do Pombal",334859,8238.86776720948,12,39,15,24,15,24,0,0,0,0,0,39,15,24,15,24,37,9.01661820657027,12.7214648266834,0.473623233480342,2020-03-23,2020,3
"757","BA",2,"Nordeste",29015,"Ribeira do Pombal",334859,8238.86776720948,13,60,20,40,31,29,0,0,0,0,0,60,20,40,31,29,39,9.01661820657027,12.7214648266834,0.423720887006719,2020-03-30,2020,3
"758","BA",2,"Nordeste",29015,"Ribeira do Pombal",334859,8238.86776720948,14,43,18,25,15,28,0,0,0,0,0,43,18,25,15,28,34,9.01661820657027,12.7214648266834,0.409017791158271,2020-04-06,2020,4
"759","BA",2,"Nordeste",29015,"Ribeira do Pombal",334859,8238.86776720948,15,55,25,30,24,31,0,0,0,0,0,55,25,30,24,31,30,9.01661820657027,12.7214648266834,0.396222737680929,2020-04-13,2020,4
"760","BA",2,"Nordeste",29015,"Ribeira do Pombal",334859,8238.86776720948,16,59,26,33,32,27,1,1,0,0,1,60,27,33,32,28,33,9.01661820657027,12.7214648266834,0.393846469256811,2020-04-20,2020,4
"761","BA",2,"Nordeste",29015,"Ribeira do Pombal",334859,8238.86776720948,17,66,37,29,28,38,2,2,0,0,2,68,39,29,28,40,47,9.01661820657027,12.7214648266834,0.367948587594403,2020-04-27,2020,4
"762","BA",2,"Nordeste",29015,"Ribeira do Pombal",334859,8238.86776720948,18,60,30,30,18,42,0,0,0,0,0,60,30,30,18,42,26,9.01661820657027,12.7214648266834,0.388204133472966,2020-05-04,2020,5
"763","BA",2,"Nordeste",29015,"Ribeira do Pombal",334859,8238.86776720948,19,57,19,38,27,30,0,0,0,0,0,57,19,38,27,30,40,9.01661820657027,12.7214648266834,0.398078328374774,2020-05-11,2020,5
"764","BA",2,"Nordeste",29015,"Ribeira do Pombal",334859,8238.86776720948,20,71,26,45,31,40,1,1,0,1,0,72,27,45,32,40,39,9.01661820657027,12.7214648266834,0.410341785843346,2020-05-18,2020,5
"765","BA",2,"Nordeste",29015,"Ribeira do Pombal",334859,8238.86776720948,21,71,31,40,25,46,0,0,0,0,0,71,31,40,25,46,40,9.01661820657027,12.7214648266834,0.394549863398925,2020-05-25,2020,5
"766","BA",2,"Nordeste",29016,"Serrinha",440982,9477.76515841916,5,80,30,50,33,47,0,0,0,0,0,80,30,50,33,47,61,9.15670382467458,12.9967593372694,0.257190265939187,2020-02-03,2020,2
"767","BA",2,"Nordeste",29016,"Serrinha",440982,9477.76515841916,6,91,28,63,42,49,0,0,0,0,0,91,28,63,42,49,54,9.15670382467458,12.9967593372694,0.24995253246744,2020-02-10,2020,2
"768","BA",2,"Nordeste",29016,"Serrinha",440982,9477.76515841916,7,62,21,41,23,39,3,0,3,1,2,65,21,44,24,41,42,9.15670382467458,12.9967593372694,0.264266768979272,2020-02-17,2020,2
"769","BA",2,"Nordeste",29016,"Serrinha",440982,9477.76515841916,8,92,29,63,35,57,0,0,0,0,0,92,29,63,35,57,57,9.15670382467458,12.9967593372694,0.29549110263829,2020-02-24,2020,2
"770","BA",2,"Nordeste",29016,"Serrinha",440982,9477.76515841916,9,76,24,52,31,45,2,1,1,0,2,78,25,53,31,47,58,9.15670382467458,12.9967593372694,0.276875060973046,2020-03-02,2020,3
"771","BA",2,"Nordeste",29016,"Serrinha",440982,9477.76515841916,10,86,41,45,34,52,4,2,2,1,3,90,43,47,35,55,52,9.15670382467458,12.9967593372694,0.302032740142452,2020-03-09,2020,3
"772","BA",2,"Nordeste",29016,"Serrinha",440982,9477.76515841916,11,75,31,44,30,45,0,0,0,0,0,75,31,44,30,45,50,9.15670382467458,12.9967593372694,0.361249755180001,2020-03-16,2020,3
"773","BA",2,"Nordeste",29016,"Serrinha",440982,9477.76515841916,12,88,27,61,29,59,1,1,0,1,0,89,28,61,30,59,49,9.15670382467458,12.9967593372694,0.463493029253628,2020-03-23,2020,3
"774","BA",2,"Nordeste",29016,"Serrinha",440982,9477.76515841916,13,66,18,48,26,40,1,1,0,0,1,67,19,48,26,41,46,9.15670382467458,12.9967593372694,0.408194629091997,2020-03-30,2020,3
"775","BA",2,"Nordeste",29016,"Serrinha",440982,9477.76515841916,14,65,27,38,32,33,0,0,0,0,0,65,27,38,32,33,71,9.15670382467458,12.9967593372694,0.398743767777768,2020-04-06,2020,4
"776","BA",2,"Nordeste",29016,"Serrinha",440982,9477.76515841916,15,72,34,38,37,35,2,1,1,0,2,74,35,39,37,37,60,9.15670382467458,12.9967593372694,0.389494671976795,2020-04-13,2020,4
"777","BA",2,"Nordeste",29016,"Serrinha",440982,9477.76515841916,16,98,41,57,40,58,2,2,0,1,1,100,43,57,41,59,46,9.15670382467458,12.9967593372694,0.378331645232781,2020-04-20,2020,4
"778","BA",2,"Nordeste",29016,"Serrinha",440982,9477.76515841916,17,84,27,57,39,45,1,1,0,1,0,85,28,57,40,45,53,9.15670382467458,12.9967593372694,0.35440893947335,2020-04-27,2020,4
"779","BA",2,"Nordeste",29016,"Serrinha",440982,9477.76515841916,18,90,30,60,37,53,2,1,1,0,2,92,31,61,37,55,65,9.15670382467458,12.9967593372694,0.363429793838185,2020-05-04,2020,5
"780","BA",2,"Nordeste",29016,"Serrinha",440982,9477.76515841916,19,86,23,63,32,54,1,1,0,1,0,87,24,63,33,54,73,9.15670382467458,12.9967593372694,0.384043953001782,2020-05-11,2020,5
"781","BA",2,"Nordeste",29016,"Serrinha",440982,9477.76515841916,20,73,30,43,29,44,0,0,0,0,0,73,30,43,29,44,67,9.15670382467458,12.9967593372694,0.396528412080998,2020-05-18,2020,5
"782","BA",2,"Nordeste",29016,"Serrinha",440982,9477.76515841916,21,97,30,67,48,49,2,0,2,1,1,99,30,69,49,50,58,9.15670382467458,12.9967593372694,0.395717105426385,2020-05-25,2020,5
"783","BA",2,"Nordeste",29017,"Alagoinhas",328745,19614.2631586792,5,57,24,33,28,29,0,0,0,0,0,57,24,33,28,29,35,9.884012292742,12.703037653233,0.266377204843586,2020-02-03,2020,2
"784","BA",2,"Nordeste",29017,"Alagoinhas",328745,19614.2631586792,6,72,30,42,36,36,0,0,0,0,0,72,30,42,36,36,38,9.884012292742,12.703037653233,0.263842770007657,2020-02-10,2020,2
"785","BA",2,"Nordeste",29017,"Alagoinhas",328745,19614.2631586792,7,61,16,45,21,40,0,0,0,0,0,61,16,45,21,40,40,9.884012292742,12.703037653233,0.281335848077995,2020-02-17,2020,2
"786","BA",2,"Nordeste",29017,"Alagoinhas",328745,19614.2631586792,8,57,18,39,23,34,1,1,0,0,1,58,19,39,23,35,49,9.884012292742,12.703037653233,0.320185707518747,2020-02-24,2020,2
"787","BA",2,"Nordeste",29017,"Alagoinhas",328745,19614.2631586792,9,58,24,34,26,32,0,0,0,0,0,58,24,34,26,32,46,9.884012292742,12.703037653233,0.290836975187677,2020-03-02,2020,3
"788","BA",2,"Nordeste",29017,"Alagoinhas",328745,19614.2631586792,10,57,26,31,27,30,2,2,0,0,2,59,28,31,27,32,45,9.884012292742,12.703037653233,0.314081138131209,2020-03-09,2020,3
"789","BA",2,"Nordeste",29017,"Alagoinhas",328745,19614.2631586792,11,57,24,33,24,33,0,0,0,0,0,57,24,33,24,33,45,9.884012292742,12.703037653233,0.373615628848745,2020-03-16,2020,3
"790","BA",2,"Nordeste",29017,"Alagoinhas",328745,19614.2631586792,12,61,19,42,24,37,1,0,1,0,1,62,19,43,24,38,49,9.884012292742,12.703037653233,0.481885152279776,2020-03-23,2020,3
"791","BA",2,"Nordeste",29017,"Alagoinhas",328745,19614.2631586792,13,56,15,41,21,35,0,0,0,0,0,56,15,41,21,35,44,9.884012292742,12.703037653233,0.436738136312185,2020-03-30,2020,3
"792","BA",2,"Nordeste",29017,"Alagoinhas",328745,19614.2631586792,14,65,26,39,25,40,0,0,0,0,0,65,26,39,25,40,49,9.884012292742,12.703037653233,0.41706369715658,2020-04-06,2020,4
"793","BA",2,"Nordeste",29017,"Alagoinhas",328745,19614.2631586792,15,74,28,46,29,45,0,0,0,0,0,74,28,46,29,45,48,9.884012292742,12.703037653233,0.397047073967213,2020-04-13,2020,4
"794","BA",2,"Nordeste",29017,"Alagoinhas",328745,19614.2631586792,16,65,25,40,24,41,0,0,0,0,0,65,25,40,24,41,31,9.884012292742,12.703037653233,0.404519142578285,2020-04-20,2020,4
"795","BA",2,"Nordeste",29017,"Alagoinhas",328745,19614.2631586792,17,67,25,42,28,39,2,2,0,0,2,69,27,42,28,41,45,9.884012292742,12.703037653233,0.382256321363271,2020-04-27,2020,4
"796","BA",2,"Nordeste",29017,"Alagoinhas",328745,19614.2631586792,18,68,25,43,21,47,1,0,1,0,1,69,25,44,21,48,38,9.884012292742,12.703037653233,0.395118543637672,2020-05-04,2020,5
"797","BA",2,"Nordeste",29017,"Alagoinhas",328745,19614.2631586792,19,58,25,33,25,33,1,1,0,0,1,59,26,33,25,34,43,9.884012292742,12.703037653233,0.410666531049652,2020-05-11,2020,5
"798","BA",2,"Nordeste",29017,"Alagoinhas",328745,19614.2631586792,20,61,19,42,22,39,2,0,2,1,1,63,19,44,23,40,62,9.884012292742,12.703037653233,0.418962013279546,2020-05-18,2020,5
"799","BA",2,"Nordeste",29017,"Alagoinhas",328745,19614.2631586792,21,68,22,46,24,44,2,2,0,1,1,70,24,46,25,45,46,9.884012292742,12.703037653233,0.40469509762884,2020-05-25,2020,5
"800","BA",2,"Nordeste",29018,"Entre Rios",125586,13565.3670782571,5,32,11,21,12,20,0,0,0,0,0,32,11,21,12,20,10,9.5152752854167,11.7407460618354,0.263624250780333,2020-02-03,2020,2
"801","BA",2,"Nordeste",29018,"Entre Rios",125586,13565.3670782571,6,30,13,17,16,14,1,0,1,0,1,31,13,18,16,15,20,9.5152752854167,11.7407460618354,0.254884376881263,2020-02-10,2020,2
"802","BA",2,"Nordeste",29018,"Entre Rios",125586,13565.3670782571,7,22,12,10,9,13,1,0,1,0,1,23,12,11,9,14,8,9.5152752854167,11.7407460618354,0.272792831220714,2020-02-17,2020,2
"803","BA",2,"Nordeste",29018,"Entre Rios",125586,13565.3670782571,8,18,4,14,6,12,0,0,0,0,0,18,4,14,6,12,16,9.5152752854167,11.7407460618354,0.309676885723744,2020-02-24,2020,2
"804","BA",2,"Nordeste",29018,"Entre Rios",125586,13565.3670782571,9,20,6,14,9,11,1,0,1,1,0,21,6,15,10,11,11,9.5152752854167,11.7407460618354,0.288498910599885,2020-03-02,2020,3
"805","BA",2,"Nordeste",29018,"Entre Rios",125586,13565.3670782571,10,25,11,14,11,14,0,0,0,0,0,25,11,14,11,14,14,9.5152752854167,11.7407460618354,0.313381884515503,2020-03-09,2020,3
"806","BA",2,"Nordeste",29018,"Entre Rios",125586,13565.3670782571,11,24,9,15,11,13,0,0,0,0,0,24,9,15,11,13,13,9.5152752854167,11.7407460618354,0.371059768333962,2020-03-16,2020,3
"807","BA",2,"Nordeste",29018,"Entre Rios",125586,13565.3670782571,12,18,10,8,3,15,0,0,0,0,0,18,10,8,3,15,10,9.5152752854167,11.7407460618354,0.504454957630527,2020-03-23,2020,3
"808","BA",2,"Nordeste",29018,"Entre Rios",125586,13565.3670782571,13,19,6,13,10,9,1,1,0,0,1,20,7,13,10,10,9,9.5152752854167,11.7407460618354,0.42230281656438,2020-03-30,2020,3
"809","BA",2,"Nordeste",29018,"Entre Rios",125586,13565.3670782571,14,21,8,13,11,10,1,0,1,0,1,22,8,14,11,11,8,9.5152752854167,11.7407460618354,0.405251794587862,2020-04-06,2020,4
"810","BA",2,"Nordeste",29018,"Entre Rios",125586,13565.3670782571,15,16,7,9,6,10,0,0,0,0,0,16,7,9,6,10,12,9.5152752854167,11.7407460618354,0.397546105358228,2020-04-13,2020,4
"811","BA",2,"Nordeste",29018,"Entre Rios",125586,13565.3670782571,16,26,11,15,16,10,0,0,0,0,0,26,11,15,16,10,6,9.5152752854167,11.7407460618354,0.398997509560429,2020-04-20,2020,4
"812","BA",2,"Nordeste",29018,"Entre Rios",125586,13565.3670782571,17,21,9,12,9,12,1,1,0,0,1,22,10,12,9,13,10,9.5152752854167,11.7407460618354,0.379144977655325,2020-04-27,2020,4
"813","BA",2,"Nordeste",29018,"Entre Rios",125586,13565.3670782571,18,18,7,11,7,11,0,0,0,0,0,18,7,11,7,11,12,9.5152752854167,11.7407460618354,0.387902539115829,2020-05-04,2020,5
"814","BA",2,"Nordeste",29018,"Entre Rios",125586,13565.3670782571,19,26,15,11,16,10,0,0,0,0,0,26,15,11,16,10,13,9.5152752854167,11.7407460618354,0.398191716635756,2020-05-11,2020,5
"815","BA",2,"Nordeste",29018,"Entre Rios",125586,13565.3670782571,20,28,12,16,21,7,2,2,0,1,1,30,14,16,22,8,17,9.5152752854167,11.7407460618354,0.423004453932244,2020-05-18,2020,5
"816","BA",2,"Nordeste",29018,"Entre Rios",125586,13565.3670782571,21,29,9,20,14,15,0,0,0,0,0,29,9,20,14,15,15,9.5152752854167,11.7407460618354,0.404464904490217,2020-05-25,2020,5
"817","BA",2,"Nordeste",29019,"Catu",231007,17164.5458881333,5,41,17,24,17,24,1,0,1,1,0,42,17,25,18,24,17,9.75060124985487,12.3502032920751,0.26406654638548,2020-02-03,2020,2
"818","BA",2,"Nordeste",29019,"Catu",231007,17164.5458881333,6,48,18,30,20,28,0,0,0,0,0,48,18,30,20,28,33,9.75060124985487,12.3502032920751,0.249235866775844,2020-02-10,2020,2
"819","BA",2,"Nordeste",29019,"Catu",231007,17164.5458881333,7,35,8,27,15,20,1,0,1,1,0,36,8,28,16,20,23,9.75060124985487,12.3502032920751,0.281451270979914,2020-02-17,2020,2
"820","BA",2,"Nordeste",29019,"Catu",231007,17164.5458881333,8,49,20,29,25,24,1,0,1,0,1,50,20,30,25,25,31,9.75060124985487,12.3502032920751,0.312462668370669,2020-02-24,2020,2
"821","BA",2,"Nordeste",29019,"Catu",231007,17164.5458881333,9,38,4,34,11,27,1,0,1,0,1,39,4,35,11,28,26,9.75060124985487,12.3502032920751,0.280877256305063,2020-03-02,2020,3
"822","BA",2,"Nordeste",29019,"Catu",231007,17164.5458881333,10,39,14,25,8,31,1,1,0,0,1,40,15,25,8,32,18,9.75060124985487,12.3502032920751,0.302972037817405,2020-03-09,2020,3
"823","BA",2,"Nordeste",29019,"Catu",231007,17164.5458881333,11,47,18,29,19,28,0,0,0,0,0,47,18,29,19,28,33,9.75060124985487,12.3502032920751,0.37704015554379,2020-03-16,2020,3
"824","BA",2,"Nordeste",29019,"Catu",231007,17164.5458881333,12,41,16,25,16,25,4,1,3,1,3,45,17,28,17,28,26,9.75060124985487,12.3502032920751,0.478854625668607,2020-03-23,2020,3
"825","BA",2,"Nordeste",29019,"Catu",231007,17164.5458881333,13,38,12,26,15,23,1,1,0,1,0,39,13,26,16,23,25,9.75060124985487,12.3502032920751,0.432350371946306,2020-03-30,2020,3
"826","BA",2,"Nordeste",29019,"Catu",231007,17164.5458881333,14,48,19,29,14,34,0,0,0,0,0,48,19,29,14,34,22,9.75060124985487,12.3502032920751,0.416003850784979,2020-04-06,2020,4
"827","BA",2,"Nordeste",29019,"Catu",231007,17164.5458881333,15,37,14,23,12,25,1,0,1,0,1,38,14,24,12,26,25,9.75060124985487,12.3502032920751,0.403100282032716,2020-04-13,2020,4
"828","BA",2,"Nordeste",29019,"Catu",231007,17164.5458881333,16,48,13,35,20,28,1,0,1,0,1,49,13,36,20,29,21,9.75060124985487,12.3502032920751,0.412230879464824,2020-04-20,2020,4
"829","BA",2,"Nordeste",29019,"Catu",231007,17164.5458881333,17,36,11,25,13,23,2,2,0,2,0,38,13,25,15,23,23,9.75060124985487,12.3502032920751,0.387723021459423,2020-04-27,2020,4
"830","BA",2,"Nordeste",29019,"Catu",231007,17164.5458881333,18,42,11,31,11,31,1,0,1,0,1,43,11,32,11,32,26,9.75060124985487,12.3502032920751,0.403797336325235,2020-05-04,2020,5
"831","BA",2,"Nordeste",29019,"Catu",231007,17164.5458881333,19,39,5,34,18,21,0,0,0,0,0,39,5,34,18,21,29,9.75060124985487,12.3502032920751,0.41114827840045,2020-05-11,2020,5
"832","BA",2,"Nordeste",29019,"Catu",231007,17164.5458881333,20,43,8,35,16,27,0,0,0,0,0,43,8,35,16,27,26,9.75060124985487,12.3502032920751,0.42382808160538,2020-05-18,2020,5
"833","BA",2,"Nordeste",29019,"Catu",231007,17164.5458881333,21,51,15,36,22,29,0,0,0,0,0,51,15,36,22,29,39,9.75060124985487,12.3502032920751,0.414156813856437,2020-05-25,2020,5
"834","BA",2,"Nordeste",29020,"Santo Antônio de Jesus",574951,12813.4508244529,5,111,32,79,47,64,8,1,7,2,6,119,33,86,49,70,64,9.45825074381629,13.262040098757,0.268203558971208,2020-02-03,2020,2
"835","BA",2,"Nordeste",29020,"Santo Antônio de Jesus",574951,12813.4508244529,6,96,26,70,38,58,2,1,1,1,1,98,27,71,39,59,73,9.45825074381629,13.262040098757,0.264886165424096,2020-02-10,2020,2
"836","BA",2,"Nordeste",29020,"Santo Antônio de Jesus",574951,12813.4508244529,7,101,22,79,40,61,2,1,1,1,1,103,23,80,41,62,80,9.45825074381629,13.262040098757,0.287347750699052,2020-02-17,2020,2
"837","BA",2,"Nordeste",29020,"Santo Antônio de Jesus",574951,12813.4508244529,8,92,25,67,28,64,2,1,1,0,2,94,26,68,28,66,82,9.45825074381629,13.262040098757,0.323873898025241,2020-02-24,2020,2
"838","BA",2,"Nordeste",29020,"Santo Antônio de Jesus",574951,12813.4508244529,9,108,25,83,40,68,2,1,1,1,1,110,26,84,41,69,67,9.45825074381629,13.262040098757,0.293571845087252,2020-03-02,2020,3
"839","BA",2,"Nordeste",29020,"Santo Antônio de Jesus",574951,12813.4508244529,10,101,26,75,35,66,4,2,2,0,4,105,28,77,35,70,85,9.45825074381629,13.262040098757,0.322355882514935,2020-03-09,2020,3
"840","BA",2,"Nordeste",29020,"Santo Antônio de Jesus",574951,12813.4508244529,11,98,22,76,40,58,0,0,0,0,0,98,22,76,40,58,67,9.45825074381629,13.262040098757,0.39050416458179,2020-03-16,2020,3
"841","BA",2,"Nordeste",29020,"Santo Antônio de Jesus",574951,12813.4508244529,12,92,22,70,35,57,2,0,2,0,2,94,22,72,35,59,83,9.45825074381629,13.262040098757,0.505227174085213,2020-03-23,2020,3
"842","BA",2,"Nordeste",29020,"Santo Antônio de Jesus",574951,12813.4508244529,13,98,25,73,37,61,3,0,3,0,3,101,25,76,37,64,79,9.45825074381629,13.262040098757,0.45247034300757,2020-03-30,2020,3
"843","BA",2,"Nordeste",29020,"Santo Antônio de Jesus",574951,12813.4508244529,14,101,21,80,35,66,2,1,1,0,2,103,22,81,35,68,76,9.45825074381629,13.262040098757,0.444299000697358,2020-04-06,2020,4
"844","BA",2,"Nordeste",29020,"Santo Antônio de Jesus",574951,12813.4508244529,15,111,28,83,40,71,4,2,2,1,3,115,30,85,41,74,73,9.45825074381629,13.262040098757,0.418517323832057,2020-04-13,2020,4
"845","BA",2,"Nordeste",29020,"Santo Antônio de Jesus",574951,12813.4508244529,16,110,19,91,37,73,1,0,1,1,0,111,19,92,38,73,63,9.45825074381629,13.262040098757,0.437399897936671,2020-04-20,2020,4
"846","BA",2,"Nordeste",29020,"Santo Antônio de Jesus",574951,12813.4508244529,17,111,32,79,41,70,1,1,0,1,0,112,33,79,42,70,79,9.45825074381629,13.262040098757,0.40827190386794,2020-04-27,2020,4
"847","BA",2,"Nordeste",29020,"Santo Antônio de Jesus",574951,12813.4508244529,18,117,29,88,39,78,2,0,2,0,2,119,29,90,39,80,73,9.45825074381629,13.262040098757,0.411346191092518,2020-05-04,2020,5
"848","BA",2,"Nordeste",29020,"Santo Antônio de Jesus",574951,12813.4508244529,19,122,30,92,50,72,1,0,1,0,1,123,30,93,50,73,76,9.45825074381629,13.262040098757,0.424430705681033,2020-05-11,2020,5
"849","BA",2,"Nordeste",29020,"Santo Antônio de Jesus",574951,12813.4508244529,20,111,35,76,45,66,3,2,1,1,2,114,37,77,46,68,80,9.45825074381629,13.262040098757,0.430949137710276,2020-05-18,2020,5
"850","BA",2,"Nordeste",29020,"Santo Antônio de Jesus",574951,12813.4508244529,21,140,29,111,50,90,1,0,1,1,0,141,29,112,51,90,77,9.45825074381629,13.262040098757,0.431698526178352,2020-05-25,2020,5
"851","BA",2,"Nordeste",29021,"Salvador",3826038,31161.6871200939,5,734,164,570,243,491,10,4,6,5,5,744,168,576,248,496,426,10.346944642296,15.1573403609769,0.264121578402834,2020-02-03,2020,2
"852","BA",2,"Nordeste",29021,"Salvador",3826038,31161.6871200939,6,720,175,545,228,492,20,2,18,9,11,740,177,563,237,503,454,10.346944642296,15.1573403609769,0.264137072325412,2020-02-10,2020,2
"853","BA",2,"Nordeste",29021,"Salvador",3826038,31161.6871200939,7,714,156,558,242,472,7,3,4,2,5,721,159,562,244,477,452,10.346944642296,15.1573403609769,0.287688204071055,2020-02-17,2020,2
"854","BA",2,"Nordeste",29021,"Salvador",3826038,31161.6871200939,8,700,151,549,237,463,2,0,2,0,2,702,151,551,237,465,428,10.346944642296,15.1573403609769,0.340178868470988,2020-02-24,2020,2
"855","BA",2,"Nordeste",29021,"Salvador",3826038,31161.6871200939,9,711,155,556,235,476,5,1,4,2,3,716,156,560,237,479,444,10.346944642296,15.1573403609769,0.306467327832749,2020-03-02,2020,3
"856","BA",2,"Nordeste",29021,"Salvador",3826038,31161.6871200939,10,618,145,473,200,418,11,4,7,4,7,629,149,480,204,425,433,10.346944642296,15.1573403609769,0.316145465557148,2020-03-09,2020,3
"857","BA",2,"Nordeste",29021,"Salvador",3826038,31161.6871200939,11,602,129,473,193,409,7,3,4,3,4,609,132,477,196,413,446,10.346944642296,15.1573403609769,0.415753969265788,2020-03-16,2020,3
"858","BA",2,"Nordeste",29021,"Salvador",3826038,31161.6871200939,12,605,129,476,187,418,14,6,8,3,11,619,135,484,190,429,460,10.346944642296,15.1573403609769,0.551484139787375,2020-03-23,2020,3
"859","BA",2,"Nordeste",29021,"Salvador",3826038,31161.6871200939,13,600,135,465,175,425,6,2,4,3,3,606,137,469,178,428,467,10.346944642296,15.1573403609769,0.502128726427669,2020-03-30,2020,3
"860","BA",2,"Nordeste",29021,"Salvador",3826038,31161.6871200939,14,697,172,525,259,438,9,4,5,1,8,706,176,530,260,446,519,10.346944642296,15.1573403609769,0.501993166694267,2020-04-06,2020,4
"861","BA",2,"Nordeste",29021,"Salvador",3826038,31161.6871200939,15,633,124,509,206,427,5,0,5,1,4,638,124,514,207,431,475,10.346944642296,15.1573403609769,0.480725947114658,2020-04-13,2020,4
"862","BA",2,"Nordeste",29021,"Salvador",3826038,31161.6871200939,16,621,149,472,218,403,17,5,12,2,15,638,154,484,220,418,488,10.346944642296,15.1573403609769,0.5026346255093,2020-04-20,2020,4
"863","BA",2,"Nordeste",29021,"Salvador",3826038,31161.6871200939,17,678,165,513,186,492,8,4,4,1,7,686,169,517,187,499,550,10.346944642296,15.1573403609769,0.471446304980051,2020-04-27,2020,4
"864","BA",2,"Nordeste",29021,"Salvador",3826038,31161.6871200939,18,633,151,482,203,430,16,4,12,6,10,649,155,494,209,440,615,10.346944642296,15.1573403609769,0.459135511757972,2020-05-04,2020,5
"865","BA",2,"Nordeste",29021,"Salvador",3826038,31161.6871200939,19,680,143,537,213,467,14,4,10,5,9,694,147,547,218,476,635,10.346944642296,15.1573403609769,0.469954785109663,2020-05-11,2020,5
"866","BA",2,"Nordeste",29021,"Salvador",3826038,31161.6871200939,20,731,165,566,233,498,7,4,3,3,4,738,169,569,236,502,705,10.346944642296,15.1573403609769,0.473616989898025,2020-05-18,2020,5
"867","BA",2,"Nordeste",29021,"Salvador",3826038,31161.6871200939,21,665,166,499,209,456,11,5,6,2,9,676,171,505,211,465,776,10.346944642296,15.1573403609769,0.477426740112833,2020-05-25,2020,5
"868","BA",2,"Nordeste",29022,"Boquira",194269,7467.01143970474,5,39,13,26,19,20,1,0,1,0,1,40,13,27,19,21,21,8.91825012306945,12.1769990755444,0.258716108822376,2020-02-03,2020,2
"869","BA",2,"Nordeste",29022,"Boquira",194269,7467.01143970474,6,27,8,19,15,12,0,0,0,0,0,27,8,19,15,12,25,8.91825012306945,12.1769990755444,0.244284737860821,2020-02-10,2020,2
"870","BA",2,"Nordeste",29022,"Boquira",194269,7467.01143970474,7,35,16,19,12,23,1,1,0,0,1,36,17,19,12,24,23,8.91825012306945,12.1769990755444,0.269472287353645,2020-02-17,2020,2
"871","BA",2,"Nordeste",29022,"Boquira",194269,7467.01143970474,8,38,9,29,13,25,0,0,0,0,0,38,9,29,13,25,22,8.91825012306945,12.1769990755444,0.290595593703648,2020-02-24,2020,2
"872","BA",2,"Nordeste",29022,"Boquira",194269,7467.01143970474,9,32,4,28,12,20,0,0,0,0,0,32,4,28,12,20,19,8.91825012306945,12.1769990755444,0.269594338847235,2020-03-02,2020,3
"873","BA",2,"Nordeste",29022,"Boquira",194269,7467.01143970474,10,41,12,29,15,26,0,0,0,0,0,41,12,29,15,26,21,8.91825012306945,12.1769990755444,0.298859676788968,2020-03-09,2020,3
"874","BA",2,"Nordeste",29022,"Boquira",194269,7467.01143970474,11,26,6,20,8,18,0,0,0,0,0,26,6,20,8,18,31,8.91825012306945,12.1769990755444,0.328954239447978,2020-03-16,2020,3
"875","BA",2,"Nordeste",29022,"Boquira",194269,7467.01143970474,12,28,11,17,9,19,0,0,0,0,0,28,11,17,9,19,28,8.91825012306945,12.1769990755444,0.452558335169817,2020-03-23,2020,3
"876","BA",2,"Nordeste",29022,"Boquira",194269,7467.01143970474,13,25,6,19,7,18,1,0,1,0,1,26,6,20,7,19,31,8.91825012306945,12.1769990755444,0.39323540525981,2020-03-30,2020,3
"877","BA",2,"Nordeste",29022,"Boquira",194269,7467.01143970474,14,32,10,22,14,18,0,0,0,0,0,32,10,22,14,18,23,8.91825012306945,12.1769990755444,0.395980656293374,2020-04-06,2020,4
"878","BA",2,"Nordeste",29022,"Boquira",194269,7467.01143970474,15,42,8,34,17,25,0,0,0,0,0,42,8,34,17,25,17,8.91825012306945,12.1769990755444,0.368328606983776,2020-04-13,2020,4
"879","BA",2,"Nordeste",29022,"Boquira",194269,7467.01143970474,16,32,11,21,13,19,2,1,1,0,2,34,12,22,13,21,24,8.91825012306945,12.1769990755444,0.344324456331984,2020-04-20,2020,4
"880","BA",2,"Nordeste",29022,"Boquira",194269,7467.01143970474,17,29,7,22,12,17,0,0,0,0,0,29,7,22,12,17,27,8.91825012306945,12.1769990755444,0.365666940281,2020-04-27,2020,4
"881","BA",2,"Nordeste",29022,"Boquira",194269,7467.01143970474,18,32,10,22,14,18,0,0,0,0,0,32,10,22,14,18,24,8.91825012306945,12.1769990755444,0.382675003618471,2020-05-04,2020,5
"882","BA",2,"Nordeste",29022,"Boquira",194269,7467.01143970474,19,32,11,21,8,24,0,0,0,0,0,32,11,21,8,24,23,8.91825012306945,12.1769990755444,0.405420524555195,2020-05-11,2020,5
"883","BA",2,"Nordeste",29022,"Boquira",194269,7467.01143970474,20,42,5,37,15,27,0,0,0,0,0,42,5,37,15,27,26,8.91825012306945,12.1769990755444,0.39009666906801,2020-05-18,2020,5
"884","BA",2,"Nordeste",29022,"Boquira",194269,7467.01143970474,21,41,9,32,18,23,0,0,0,0,0,41,9,32,18,23,16,8.91825012306945,12.1769990755444,0.389524164595134,2020-05-25,2020,5
"885","BA",2,"Nordeste",29023,"Seabra",260813,10600.1141977585,5,64,16,48,22,42,0,0,0,0,0,64,16,48,22,42,38,9.26862005341557,12.4715589544181,0.269332370993184,2020-02-03,2020,2
"886","BA",2,"Nordeste",29023,"Seabra",260813,10600.1141977585,6,77,24,53,37,40,0,0,0,0,0,77,24,53,37,40,26,9.26862005341557,12.4715589544181,0.266693922375366,2020-02-10,2020,2
"887","BA",2,"Nordeste",29023,"Seabra",260813,10600.1141977585,7,66,24,42,35,31,0,0,0,0,0,66,24,42,35,31,31,9.26862005341557,12.4715589544181,0.282600021410886,2020-02-17,2020,2
"888","BA",2,"Nordeste",29023,"Seabra",260813,10600.1141977585,8,64,22,42,30,34,1,1,0,1,0,65,23,42,31,34,26,9.26862005341557,12.4715589544181,0.3166626532247,2020-02-24,2020,2
"889","BA",2,"Nordeste",29023,"Seabra",260813,10600.1141977585,9,47,12,35,23,24,3,2,1,2,1,50,14,36,25,25,28,9.26862005341557,12.4715589544181,0.299818588917769,2020-03-02,2020,3
"890","BA",2,"Nordeste",29023,"Seabra",260813,10600.1141977585,10,63,17,46,32,31,0,0,0,0,0,63,17,46,32,31,25,9.26862005341557,12.4715589544181,0.321801455246114,2020-03-09,2020,3
"891","BA",2,"Nordeste",29023,"Seabra",260813,10600.1141977585,11,52,15,37,22,30,0,0,0,0,0,52,15,37,22,30,32,9.26862005341557,12.4715589544181,0.369136623616519,2020-03-16,2020,3
"892","BA",2,"Nordeste",29023,"Seabra",260813,10600.1141977585,12,43,16,27,20,23,0,0,0,0,0,43,16,27,20,23,34,9.26862005341557,12.4715589544181,0.465737950313685,2020-03-23,2020,3
"893","BA",2,"Nordeste",29023,"Seabra",260813,10600.1141977585,13,36,11,25,14,22,2,1,1,0,2,38,12,26,14,24,28,9.26862005341557,12.4715589544181,0.429391806618046,2020-03-30,2020,3
"894","BA",2,"Nordeste",29023,"Seabra",260813,10600.1141977585,14,31,8,23,18,13,0,0,0,0,0,31,8,23,18,13,25,9.26862005341557,12.4715589544181,0.404860721011631,2020-04-06,2020,4
"895","BA",2,"Nordeste",29023,"Seabra",260813,10600.1141977585,15,51,18,33,22,29,0,0,0,0,0,51,18,33,22,29,22,9.26862005341557,12.4715589544181,0.391454279375215,2020-04-13,2020,4
"896","BA",2,"Nordeste",29023,"Seabra",260813,10600.1141977585,16,42,10,32,16,26,0,0,0,0,0,42,10,32,16,26,26,9.26862005341557,12.4715589544181,0.383338360246544,2020-04-20,2020,4
"897","BA",2,"Nordeste",29023,"Seabra",260813,10600.1141977585,17,26,8,18,12,14,1,0,1,1,0,27,8,19,13,14,30,9.26862005341557,12.4715589544181,0.37942110597996,2020-04-27,2020,4
"898","BA",2,"Nordeste",29023,"Seabra",260813,10600.1141977585,18,41,13,28,18,23,1,0,1,1,0,42,13,29,19,23,34,9.26862005341557,12.4715589544181,0.389353453599399,2020-05-04,2020,5
"899","BA",2,"Nordeste",29023,"Seabra",260813,10600.1141977585,19,43,12,31,21,22,1,1,0,1,0,44,13,31,22,22,29,9.26862005341557,12.4715589544181,0.400403076327072,2020-05-11,2020,5
"900","BA",2,"Nordeste",29023,"Seabra",260813,10600.1141977585,20,46,13,33,16,30,0,0,0,0,0,46,13,33,16,30,23,9.26862005341557,12.4715589544181,0.397393098330564,2020-05-18,2020,5
"901","BA",2,"Nordeste",29023,"Seabra",260813,10600.1141977585,21,54,16,38,18,36,0,0,0,0,0,54,16,38,18,36,29,9.26862005341557,12.4715589544181,0.402825859895013,2020-05-25,2020,5
"902","BA",2,"Nordeste",29024,"Jequié",513575,12710.1055946843,5,105,34,71,53,52,0,0,0,0,0,105,34,71,53,52,94,9.45015267214933,13.1491513541607,0.265523008815624,2020-02-03,2020,2
"903","BA",2,"Nordeste",29024,"Jequié",513575,12710.1055946843,6,96,23,73,28,68,1,1,0,0,1,97,24,73,28,69,63,9.45015267214933,13.1491513541607,0.262432757387146,2020-02-10,2020,2
"904","BA",2,"Nordeste",29024,"Jequié",513575,12710.1055946843,7,92,32,60,48,44,1,1,0,1,0,93,33,60,49,44,70,9.45015267214933,13.1491513541607,0.278818728597311,2020-02-17,2020,2
"905","BA",2,"Nordeste",29024,"Jequié",513575,12710.1055946843,8,115,43,72,48,67,0,0,0,0,0,115,43,72,48,67,72,9.45015267214933,13.1491513541607,0.318257870392897,2020-02-24,2020,2
"906","BA",2,"Nordeste",29024,"Jequié",513575,12710.1055946843,9,117,40,77,54,63,0,0,0,0,0,117,40,77,54,63,69,9.45015267214933,13.1491513541607,0.290271478931246,2020-03-02,2020,3
"907","BA",2,"Nordeste",29024,"Jequié",513575,12710.1055946843,10,89,21,68,33,56,2,0,2,0,2,91,21,70,33,58,64,9.45015267214933,13.1491513541607,0.31483107798374,2020-03-09,2020,3
"908","BA",2,"Nordeste",29024,"Jequié",513575,12710.1055946843,11,109,41,68,41,68,1,1,0,1,0,110,42,68,42,68,62,9.45015267214933,13.1491513541607,0.370848348897992,2020-03-16,2020,3
"909","BA",2,"Nordeste",29024,"Jequié",513575,12710.1055946843,12,101,34,67,44,57,4,3,1,2,2,105,37,68,46,59,64,9.45015267214933,13.1491513541607,0.488985117299589,2020-03-23,2020,3
"910","BA",2,"Nordeste",29024,"Jequié",513575,12710.1055946843,13,97,37,60,47,50,1,0,1,1,0,98,37,61,48,50,78,9.45015267214933,13.1491513541607,0.429755381580114,2020-03-30,2020,3
"911","BA",2,"Nordeste",29024,"Jequié",513575,12710.1055946843,14,87,22,65,35,52,0,0,0,0,0,87,22,65,35,52,74,9.45015267214933,13.1491513541607,0.411027304186489,2020-04-06,2020,4
"912","BA",2,"Nordeste",29024,"Jequié",513575,12710.1055946843,15,102,34,68,52,50,1,0,1,1,0,103,34,69,53,50,73,9.45015267214933,13.1491513541607,0.394480828075693,2020-04-13,2020,4
"913","BA",2,"Nordeste",29024,"Jequié",513575,12710.1055946843,16,101,25,76,42,59,1,0,1,1,0,102,25,77,43,59,67,9.45015267214933,13.1491513541607,0.399429138547497,2020-04-20,2020,4
"914","BA",2,"Nordeste",29024,"Jequié",513575,12710.1055946843,17,108,38,70,48,60,1,0,1,1,0,109,38,71,49,60,66,9.45015267214933,13.1491513541607,0.37952634216826,2020-04-27,2020,4
"915","BA",2,"Nordeste",29024,"Jequié",513575,12710.1055946843,18,94,26,68,36,58,4,2,2,2,2,98,28,70,38,60,72,9.45015267214933,13.1491513541607,0.385102841225498,2020-05-04,2020,5
"916","BA",2,"Nordeste",29024,"Jequié",513575,12710.1055946843,19,89,25,64,38,51,1,0,1,1,0,90,25,65,39,51,85,9.45015267214933,13.1491513541607,0.412223836149782,2020-05-11,2020,5
"917","BA",2,"Nordeste",29024,"Jequié",513575,12710.1055946843,20,127,38,89,47,80,2,2,0,0,2,129,40,89,47,82,78,9.45015267214933,13.1491513541607,0.415445377116387,2020-05-18,2020,5
"918","BA",2,"Nordeste",29024,"Jequié",513575,12710.1055946843,21,132,41,91,53,79,0,0,0,0,0,132,41,91,53,79,109,9.45015267214933,13.1491513541607,0.409811456134869,2020-05-25,2020,5
"919","BA",2,"Nordeste",29025,"Livramento do Brumado",102220,9039.44955634905,5,15,3,12,3,12,0,0,0,0,0,15,3,12,3,12,12,9.10935356174797,11.5348826323223,0.256085850599077,2020-02-03,2020,2
"920","BA",2,"Nordeste",29025,"Livramento do Brumado",102220,9039.44955634905,6,28,9,19,11,17,0,0,0,0,0,28,9,19,11,17,11,9.10935356174797,11.5348826323223,0.245699829012803,2020-02-10,2020,2
"921","BA",2,"Nordeste",29025,"Livramento do Brumado",102220,9039.44955634905,7,16,3,13,5,11,1,0,1,1,0,17,3,14,6,11,7,9.10935356174797,11.5348826323223,0.268120150407188,2020-02-17,2020,2
"922","BA",2,"Nordeste",29025,"Livramento do Brumado",102220,9039.44955634905,8,18,7,11,7,11,0,0,0,0,0,18,7,11,7,11,13,9.10935356174797,11.5348826323223,0.297744338600279,2020-02-24,2020,2
"923","BA",2,"Nordeste",29025,"Livramento do Brumado",102220,9039.44955634905,9,15,7,8,5,10,0,0,0,0,0,15,7,8,5,10,9,9.10935356174797,11.5348826323223,0.288235046953883,2020-03-02,2020,3
"924","BA",2,"Nordeste",29025,"Livramento do Brumado",102220,9039.44955634905,10,17,4,13,9,8,2,2,0,2,0,19,6,13,11,8,11,9.10935356174797,11.5348826323223,0.305715261133836,2020-03-09,2020,3
"925","BA",2,"Nordeste",29025,"Livramento do Brumado",102220,9039.44955634905,11,16,3,13,3,13,0,0,0,0,0,16,3,13,3,13,16,9.10935356174797,11.5348826323223,0.351099382469567,2020-03-16,2020,3
"926","BA",2,"Nordeste",29025,"Livramento do Brumado",102220,9039.44955634905,12,24,5,19,7,17,0,0,0,0,0,24,5,19,7,17,13,9.10935356174797,11.5348826323223,0.464051786366709,2020-03-23,2020,3
"927","BA",2,"Nordeste",29025,"Livramento do Brumado",102220,9039.44955634905,13,12,2,10,3,9,0,0,0,0,0,12,2,10,3,9,5,9.10935356174797,11.5348826323223,0.414252944031142,2020-03-30,2020,3
"928","BA",2,"Nordeste",29025,"Livramento do Brumado",102220,9039.44955634905,14,23,6,17,12,11,0,0,0,0,0,23,6,17,12,11,13,9.10935356174797,11.5348826323223,0.399910128139588,2020-04-06,2020,4
"929","BA",2,"Nordeste",29025,"Livramento do Brumado",102220,9039.44955634905,15,14,3,11,6,8,0,0,0,0,0,14,3,11,6,8,16,9.10935356174797,11.5348826323223,0.390758713534951,2020-04-13,2020,4
"930","BA",2,"Nordeste",29025,"Livramento do Brumado",102220,9039.44955634905,16,7,2,5,2,5,0,0,0,0,0,7,2,5,2,5,13,9.10935356174797,11.5348826323223,0.352198507579746,2020-04-20,2020,4
"931","BA",2,"Nordeste",29025,"Livramento do Brumado",102220,9039.44955634905,17,12,4,8,4,8,0,0,0,0,0,12,4,8,4,8,8,9.10935356174797,11.5348826323223,0.364940276520966,2020-04-27,2020,4
"932","BA",2,"Nordeste",29025,"Livramento do Brumado",102220,9039.44955634905,18,17,2,15,6,11,1,0,1,0,1,18,2,16,6,12,12,9.10935356174797,11.5348826323223,0.38141357413543,2020-05-04,2020,5
"933","BA",2,"Nordeste",29025,"Livramento do Brumado",102220,9039.44955634905,19,16,7,9,4,12,0,0,0,0,0,16,7,9,4,12,16,9.10935356174797,11.5348826323223,0.388873504046994,2020-05-11,2020,5
"934","BA",2,"Nordeste",29025,"Livramento do Brumado",102220,9039.44955634905,20,22,5,17,11,11,0,0,0,0,0,22,5,17,11,11,6,9.10935356174797,11.5348826323223,0.375251231181135,2020-05-18,2020,5
"935","BA",2,"Nordeste",29025,"Livramento do Brumado",102220,9039.44955634905,21,24,7,17,5,19,0,0,0,0,0,24,7,17,5,19,11,9.10935356174797,11.5348826323223,0.354606082574267,2020-05-25,2020,5
"936","BA",2,"Nordeste",29026,"Guanambi",395405,11164.2679674258,5,68,11,57,22,46,1,1,0,0,1,69,12,57,22,47,46,9.32047359718307,12.8876658350611,0.27020003960968,2020-02-03,2020,2
"937","BA",2,"Nordeste",29026,"Guanambi",395405,11164.2679674258,6,84,22,62,26,58,1,1,0,0,1,85,23,62,26,59,43,9.32047359718307,12.8876658350611,0.259600377359004,2020-02-10,2020,2
"938","BA",2,"Nordeste",29026,"Guanambi",395405,11164.2679674258,7,74,22,52,26,48,0,0,0,0,0,74,22,52,26,48,38,9.32047359718307,12.8876658350611,0.275872818827496,2020-02-17,2020,2
"939","BA",2,"Nordeste",29026,"Guanambi",395405,11164.2679674258,8,73,18,55,25,48,0,0,0,0,0,73,18,55,25,48,42,9.32047359718307,12.8876658350611,0.311951490780325,2020-02-24,2020,2
"940","BA",2,"Nordeste",29026,"Guanambi",395405,11164.2679674258,9,93,21,72,25,68,1,0,1,0,1,94,21,73,25,69,57,9.32047359718307,12.8876658350611,0.295558141067149,2020-03-02,2020,3
"941","BA",2,"Nordeste",29026,"Guanambi",395405,11164.2679674258,10,69,19,50,28,41,1,1,0,0,1,70,20,50,28,42,51,9.32047359718307,12.8876658350611,0.311205084431365,2020-03-09,2020,3
"942","BA",2,"Nordeste",29026,"Guanambi",395405,11164.2679674258,11,57,16,41,15,42,1,0,1,0,1,58,16,42,15,43,46,9.32047359718307,12.8876658350611,0.360118799871909,2020-03-16,2020,3
"943","BA",2,"Nordeste",29026,"Guanambi",395405,11164.2679674258,12,81,29,52,30,51,0,0,0,0,0,81,29,52,30,51,44,9.32047359718307,12.8876658350611,0.467559788507436,2020-03-23,2020,3
"944","BA",2,"Nordeste",29026,"Guanambi",395405,11164.2679674258,13,58,22,36,19,39,0,0,0,0,0,58,22,36,19,39,30,9.32047359718307,12.8876658350611,0.423967869981877,2020-03-30,2020,3
"945","BA",2,"Nordeste",29026,"Guanambi",395405,11164.2679674258,14,62,15,47,24,38,1,1,0,0,1,63,16,47,24,39,44,9.32047359718307,12.8876658350611,0.39749227775127,2020-04-06,2020,4
"946","BA",2,"Nordeste",29026,"Guanambi",395405,11164.2679674258,15,67,17,50,28,39,1,0,1,0,1,68,17,51,28,40,52,9.32047359718307,12.8876658350611,0.381877824469046,2020-04-13,2020,4
"947","BA",2,"Nordeste",29026,"Guanambi",395405,11164.2679674258,16,67,17,50,18,49,0,0,0,0,0,67,17,50,18,49,41,9.32047359718307,12.8876658350611,0.369167156768054,2020-04-20,2020,4
"948","BA",2,"Nordeste",29026,"Guanambi",395405,11164.2679674258,17,80,13,67,33,47,0,0,0,0,0,80,13,67,33,47,46,9.32047359718307,12.8876658350611,0.363418159289031,2020-04-27,2020,4
"949","BA",2,"Nordeste",29026,"Guanambi",395405,11164.2679674258,18,74,23,51,25,49,3,2,1,0,3,77,25,52,25,52,43,9.32047359718307,12.8876658350611,0.366823301242719,2020-05-04,2020,5
"950","BA",2,"Nordeste",29026,"Guanambi",395405,11164.2679674258,19,77,16,61,30,47,0,0,0,0,0,77,16,61,30,47,49,9.32047359718307,12.8876658350611,0.387533256797222,2020-05-11,2020,5
"951","BA",2,"Nordeste",29026,"Guanambi",395405,11164.2679674258,20,72,25,47,30,42,0,0,0,0,0,72,25,47,30,42,45,9.32047359718307,12.8876658350611,0.399767100879653,2020-05-18,2020,5
"952","BA",2,"Nordeste",29026,"Guanambi",395405,11164.2679674258,21,79,20,59,27,52,1,0,1,0,1,80,20,60,27,53,44,9.32047359718307,12.8876658350611,0.397611217554852,2020-05-25,2020,5
"953","BA",2,"Nordeste",29027,"Brumado",226484,13245.7894827891,5,44,15,29,20,24,0,0,0,0,0,44,15,29,20,24,19,9.49143500602939,12.3304295812335,0.276926603324701,2020-02-03,2020,2
"954","BA",2,"Nordeste",29027,"Brumado",226484,13245.7894827891,6,38,11,27,6,32,1,0,1,0,1,39,11,28,6,33,31,9.49143500602939,12.3304295812335,0.274272947201684,2020-02-10,2020,2
"955","BA",2,"Nordeste",29027,"Brumado",226484,13245.7894827891,7,39,11,28,18,21,1,1,0,0,1,40,12,28,18,22,31,9.49143500602939,12.3304295812335,0.279772877610558,2020-02-17,2020,2
"956","BA",2,"Nordeste",29027,"Brumado",226484,13245.7894827891,8,52,13,39,24,28,1,0,1,0,1,53,13,40,24,29,30,9.49143500602939,12.3304295812335,0.31419572407446,2020-02-24,2020,2
"957","BA",2,"Nordeste",29027,"Brumado",226484,13245.7894827891,9,58,15,43,19,39,1,1,0,0,1,59,16,43,19,40,32,9.49143500602939,12.3304295812335,0.288890980801706,2020-03-02,2020,3
"958","BA",2,"Nordeste",29027,"Brumado",226484,13245.7894827891,10,36,18,18,8,28,0,0,0,0,0,36,18,18,8,28,32,9.49143500602939,12.3304295812335,0.308160168923639,2020-03-09,2020,3
"959","BA",2,"Nordeste",29027,"Brumado",226484,13245.7894827891,11,40,15,25,17,23,0,0,0,0,0,40,15,25,17,23,34,9.49143500602939,12.3304295812335,0.368047387697432,2020-03-16,2020,3
"960","BA",2,"Nordeste",29027,"Brumado",226484,13245.7894827891,12,38,12,26,15,23,1,0,1,0,1,39,12,27,15,24,35,9.49143500602939,12.3304295812335,0.475750179259204,2020-03-23,2020,3
"961","BA",2,"Nordeste",29027,"Brumado",226484,13245.7894827891,13,32,4,28,9,23,2,0,2,1,1,34,4,30,10,24,27,9.49143500602939,12.3304295812335,0.436443351602915,2020-03-30,2020,3
"962","BA",2,"Nordeste",29027,"Brumado",226484,13245.7894827891,14,37,8,29,12,25,2,0,2,2,0,39,8,31,14,25,21,9.49143500602939,12.3304295812335,0.409271570262992,2020-04-06,2020,4
"963","BA",2,"Nordeste",29027,"Brumado",226484,13245.7894827891,15,43,9,34,15,28,0,0,0,0,0,43,9,34,15,28,35,9.49143500602939,12.3304295812335,0.387774238093947,2020-04-13,2020,4
"964","BA",2,"Nordeste",29027,"Brumado",226484,13245.7894827891,16,37,8,29,12,25,0,0,0,0,0,37,8,29,12,25,35,9.49143500602939,12.3304295812335,0.377195222669315,2020-04-20,2020,4
"965","BA",2,"Nordeste",29027,"Brumado",226484,13245.7894827891,17,46,16,30,20,26,0,0,0,0,0,46,16,30,20,26,43,9.49143500602939,12.3304295812335,0.373751595321128,2020-04-27,2020,4
"966","BA",2,"Nordeste",29027,"Brumado",226484,13245.7894827891,18,46,17,29,14,32,3,1,2,2,1,49,18,31,16,33,31,9.49143500602939,12.3304295812335,0.380695013666068,2020-05-04,2020,5
"967","BA",2,"Nordeste",29027,"Brumado",226484,13245.7894827891,19,65,15,50,26,39,1,0,1,1,0,66,15,51,27,39,29,9.49143500602939,12.3304295812335,0.393552760111244,2020-05-11,2020,5
"968","BA",2,"Nordeste",29027,"Brumado",226484,13245.7894827891,20,41,11,30,9,32,0,0,0,0,0,41,11,30,9,32,30,9.49143500602939,12.3304295812335,0.384536903345042,2020-05-18,2020,5
"969","BA",2,"Nordeste",29027,"Brumado",226484,13245.7894827891,21,45,14,31,17,28,0,0,0,0,0,45,14,31,17,28,41,9.49143500602939,12.3304295812335,0.390588788476881,2020-05-25,2020,5
"970","BA",2,"Nordeste",29028,"Vitória da Conquista",644383,15145.9906913901,5,140,50,90,49,91,2,0,2,0,2,142,50,92,49,93,88,9.62549113508161,13.3760485488072,0.267215942229233,2020-02-03,2020,2
"971","BA",2,"Nordeste",29028,"Vitória da Conquista",644383,15145.9906913901,6,128,30,98,45,83,4,4,0,0,4,132,34,98,45,87,75,9.62549113508161,13.3760485488072,0.26150838323657,2020-02-10,2020,2
"972","BA",2,"Nordeste",29028,"Vitória da Conquista",644383,15145.9906913901,7,139,44,95,51,88,2,1,1,1,1,141,45,96,52,89,63,9.62549113508161,13.3760485488072,0.283771729926326,2020-02-17,2020,2
"973","BA",2,"Nordeste",29028,"Vitória da Conquista",644383,15145.9906913901,8,149,53,96,50,99,2,1,1,1,1,151,54,97,51,100,78,9.62549113508161,13.3760485488072,0.322561772051511,2020-02-24,2020,2
"974","BA",2,"Nordeste",29028,"Vitória da Conquista",644383,15145.9906913901,9,153,56,97,55,98,2,1,1,1,1,155,57,98,56,99,93,9.62549113508161,13.3760485488072,0.298161433491224,2020-03-02,2020,3
"975","BA",2,"Nordeste",29028,"Vitória da Conquista",644383,15145.9906913901,10,142,37,105,51,91,0,0,0,0,0,142,37,105,51,91,78,9.62549113508161,13.3760485488072,0.315011348641937,2020-03-09,2020,3
"976","BA",2,"Nordeste",29028,"Vitória da Conquista",644383,15145.9906913901,11,140,57,83,53,87,3,1,2,2,1,143,58,85,55,88,73,9.62549113508161,13.3760485488072,0.369390613704924,2020-03-16,2020,3
"977","BA",2,"Nordeste",29028,"Vitória da Conquista",644383,15145.9906913901,12,130,48,82,47,83,1,1,0,1,0,131,49,82,48,83,95,9.62549113508161,13.3760485488072,0.476042546275641,2020-03-23,2020,3
"978","BA",2,"Nordeste",29028,"Vitória da Conquista",644383,15145.9906913901,13,133,47,86,64,69,1,0,1,0,1,134,47,87,64,70,94,9.62549113508161,13.3760485488072,0.430644916671207,2020-03-30,2020,3
"979","BA",2,"Nordeste",29028,"Vitória da Conquista",644383,15145.9906913901,14,157,58,99,50,107,4,2,2,1,3,161,60,101,51,110,77,9.62549113508161,13.3760485488072,0.426183173892936,2020-04-06,2020,4
"980","BA",2,"Nordeste",29028,"Vitória da Conquista",644383,15145.9906913901,15,126,39,87,37,89,1,0,1,0,1,127,39,88,37,90,64,9.62549113508161,13.3760485488072,0.401650151582606,2020-04-13,2020,4
"981","BA",2,"Nordeste",29028,"Vitória da Conquista",644383,15145.9906913901,16,108,34,74,38,70,1,0,1,0,1,109,34,75,38,71,77,9.62549113508161,13.3760485488072,0.400219711957519,2020-04-20,2020,4
"982","BA",2,"Nordeste",29028,"Vitória da Conquista",644383,15145.9906913901,17,116,39,77,34,82,2,0,2,1,1,118,39,79,35,83,96,9.62549113508161,13.3760485488072,0.385997674702809,2020-04-27,2020,4
"983","BA",2,"Nordeste",29028,"Vitória da Conquista",644383,15145.9906913901,18,121,46,75,47,74,3,2,1,1,2,124,48,76,48,76,81,9.62549113508161,13.3760485488072,0.391186355939601,2020-05-04,2020,5
"984","BA",2,"Nordeste",29028,"Vitória da Conquista",644383,15145.9906913901,19,134,44,90,56,78,2,1,1,1,1,136,45,91,57,79,89,9.62549113508161,13.3760485488072,0.411289542754254,2020-05-11,2020,5
"985","BA",2,"Nordeste",29028,"Vitória da Conquista",644383,15145.9906913901,20,166,52,114,65,101,0,0,0,0,0,166,52,114,65,101,87,9.62549113508161,13.3760485488072,0.39287594097603,2020-05-18,2020,5
"986","BA",2,"Nordeste",29028,"Vitória da Conquista",644383,15145.9906913901,21,166,62,104,64,102,1,1,0,0,1,167,63,104,64,103,72,9.62549113508161,13.3760485488072,0.395129852823902,2020-05-25,2020,5
"987","BA",2,"Nordeste",29029,"Itapetinga",197600,12217.0712233806,5,43,20,23,21,22,0,0,0,0,0,43,20,23,21,22,32,9.41058953324551,12.1940000642959,0.275574713342845,2020-02-03,2020,2
"988","BA",2,"Nordeste",29029,"Itapetinga",197600,12217.0712233806,6,48,25,23,26,22,1,0,1,0,1,49,25,24,26,23,29,9.41058953324551,12.1940000642959,0.26762518204812,2020-02-10,2020,2
"989","BA",2,"Nordeste",29029,"Itapetinga",197600,12217.0712233806,7,41,17,24,18,23,1,1,0,1,0,42,18,24,19,23,20,9.41058953324551,12.1940000642959,0.290014119239701,2020-02-17,2020,2
"990","BA",2,"Nordeste",29029,"Itapetinga",197600,12217.0712233806,8,58,23,35,23,35,1,0,1,0,1,59,23,36,23,36,24,9.41058953324551,12.1940000642959,0.322163028599934,2020-02-24,2020,2
"991","BA",2,"Nordeste",29029,"Itapetinga",197600,12217.0712233806,9,39,13,26,14,25,0,0,0,0,0,39,13,26,14,25,29,9.41058953324551,12.1940000642959,0.296699952894307,2020-03-02,2020,3
"992","BA",2,"Nordeste",29029,"Itapetinga",197600,12217.0712233806,10,42,18,24,16,26,0,0,0,0,0,42,18,24,16,26,30,9.41058953324551,12.1940000642959,0.318818929283369,2020-03-09,2020,3
"993","BA",2,"Nordeste",29029,"Itapetinga",197600,12217.0712233806,11,31,15,16,11,20,0,0,0,0,0,31,15,16,11,20,23,9.41058953324551,12.1940000642959,0.371640778362416,2020-03-16,2020,3
"994","BA",2,"Nordeste",29029,"Itapetinga",197600,12217.0712233806,12,32,15,17,19,13,0,0,0,0,0,32,15,17,19,13,24,9.41058953324551,12.1940000642959,0.464862724680451,2020-03-23,2020,3
"995","BA",2,"Nordeste",29029,"Itapetinga",197600,12217.0712233806,13,25,9,16,13,12,0,0,0,0,0,25,9,16,13,12,27,9.41058953324551,12.1940000642959,0.420882443080855,2020-03-30,2020,3
"996","BA",2,"Nordeste",29029,"Itapetinga",197600,12217.0712233806,14,31,14,17,17,14,0,0,0,0,0,31,14,17,17,14,27,9.41058953324551,12.1940000642959,0.404121587552609,2020-04-06,2020,4
"997","BA",2,"Nordeste",29029,"Itapetinga",197600,12217.0712233806,15,31,9,22,17,14,0,0,0,0,0,31,9,22,17,14,25,9.41058953324551,12.1940000642959,0.378169204071848,2020-04-13,2020,4
"998","BA",2,"Nordeste",29029,"Itapetinga",197600,12217.0712233806,16,31,12,19,12,19,1,0,1,0,1,32,12,20,12,20,25,9.41058953324551,12.1940000642959,0.36256271309428,2020-04-20,2020,4
"999","BA",2,"Nordeste",29029,"Itapetinga",197600,12217.0712233806,17,43,15,28,21,22,0,0,0,0,0,43,15,28,21,22,34,9.41058953324551,12.1940000642959,0.351654345407725,2020-04-27,2020,4
"1000","BA",2,"Nordeste",29029,"Itapetinga",197600,12217.0712233806,18,25,12,13,11,14,0,0,0,0,0,25,12,13,11,14,27,9.41058953324551,12.1940000642959,0.358655133599895,2020-05-04,2020,5
"1001","BA",2,"Nordeste",29029,"Itapetinga",197600,12217.0712233806,19,43,17,26,20,23,1,1,0,1,0,44,18,26,21,23,29,9.41058953324551,12.1940000642959,0.389025962421974,2020-05-11,2020,5
"1002","BA",2,"Nordeste",29029,"Itapetinga",197600,12217.0712233806,20,52,24,28,25,27,1,0,1,1,0,53,24,29,26,27,19,9.41058953324551,12.1940000642959,0.373312359235104,2020-05-18,2020,5
"1003","BA",2,"Nordeste",29029,"Itapetinga",197600,12217.0712233806,21,43,19,24,18,25,0,0,0,0,0,43,19,24,18,25,29,9.41058953324551,12.1940000642959,0.361872783109798,2020-05-25,2020,5
"1004","BA",2,"Nordeste",29030,"Valença",286862,15022.1726685305,5,57,27,30,31,26,1,0,1,1,0,58,27,31,32,26,18,9.61728256655685,12.566756542866,0.276480775115713,2020-02-03,2020,2
"1005","BA",2,"Nordeste",29030,"Valença",286862,15022.1726685305,6,63,23,40,23,40,0,0,0,0,0,63,23,40,23,40,34,9.61728256655685,12.566756542866,0.260623093376914,2020-02-10,2020,2
"1006","BA",2,"Nordeste",29030,"Valença",286862,15022.1726685305,7,69,36,33,33,36,1,1,0,1,0,70,37,33,34,36,39,9.61728256655685,12.566756542866,0.28083797587877,2020-02-17,2020,2
"1007","BA",2,"Nordeste",29030,"Valença",286862,15022.1726685305,8,61,23,38,24,37,2,1,1,1,1,63,24,39,25,38,22,9.61728256655685,12.566756542866,0.315964082084829,2020-02-24,2020,2
"1008","BA",2,"Nordeste",29030,"Valença",286862,15022.1726685305,9,53,19,34,27,26,1,0,1,0,1,54,19,35,27,27,24,9.61728256655685,12.566756542866,0.296655005963537,2020-03-02,2020,3
"1009","BA",2,"Nordeste",29030,"Valença",286862,15022.1726685305,10,60,22,38,31,29,3,0,3,0,3,63,22,41,31,32,37,9.61728256655685,12.566756542866,0.321503980013144,2020-03-09,2020,3
"1010","BA",2,"Nordeste",29030,"Valença",286862,15022.1726685305,11,49,19,30,22,27,0,0,0,0,0,49,19,30,22,27,24,9.61728256655685,12.566756542866,0.38540439667326,2020-03-16,2020,3
"1011","BA",2,"Nordeste",29030,"Valença",286862,15022.1726685305,12,52,33,19,27,25,0,0,0,0,0,52,33,19,27,25,29,9.61728256655685,12.566756542866,0.508658120543746,2020-03-23,2020,3
"1012","BA",2,"Nordeste",29030,"Valença",286862,15022.1726685305,13,37,16,21,14,23,2,0,2,1,1,39,16,23,15,24,31,9.61728256655685,12.566756542866,0.458382361220836,2020-03-30,2020,3
"1013","BA",2,"Nordeste",29030,"Valença",286862,15022.1726685305,14,44,12,32,22,22,0,0,0,0,0,44,12,32,22,22,28,9.61728256655685,12.566756542866,0.443537563621561,2020-04-06,2020,4
"1014","BA",2,"Nordeste",29030,"Valença",286862,15022.1726685305,15,54,27,27,31,23,0,0,0,0,0,54,27,27,31,23,34,9.61728256655685,12.566756542866,0.428379436683907,2020-04-13,2020,4
"1015","BA",2,"Nordeste",29030,"Valença",286862,15022.1726685305,16,57,26,31,23,34,0,0,0,0,0,57,26,31,23,34,33,9.61728256655685,12.566756542866,0.447312716323206,2020-04-20,2020,4
"1016","BA",2,"Nordeste",29030,"Valença",286862,15022.1726685305,17,54,19,35,22,32,0,0,0,0,0,54,19,35,22,32,28,9.61728256655685,12.566756542866,0.407180080271889,2020-04-27,2020,4
"1017","BA",2,"Nordeste",29030,"Valença",286862,15022.1726685305,18,49,20,29,27,22,1,1,0,1,0,50,21,29,28,22,27,9.61728256655685,12.566756542866,0.409516493655217,2020-05-04,2020,5
"1018","BA",2,"Nordeste",29030,"Valença",286862,15022.1726685305,19,70,29,41,30,40,2,1,1,1,1,72,30,42,31,41,36,9.61728256655685,12.566756542866,0.441401455781173,2020-05-11,2020,5
"1019","BA",2,"Nordeste",29030,"Valença",286862,15022.1726685305,20,72,27,45,29,43,0,0,0,0,0,72,27,45,29,43,36,9.61728256655685,12.566756542866,0.440821614987114,2020-05-18,2020,5
"1020","BA",2,"Nordeste",29030,"Valença",286862,15022.1726685305,21,71,23,48,26,45,4,2,2,4,0,75,25,50,30,45,30,9.61728256655685,12.566756542866,0.431641729660733,2020-05-25,2020,5
"1021","BA",2,"Nordeste",29031,"Ilhéus-Itabuna",983168,14657.878565708,5,213,75,138,103,110,5,2,3,1,4,218,77,141,104,114,150,9.59273325594527,13.7985352899183,0.273280473369996,2020-02-03,2020,2
"1022","BA",2,"Nordeste",29031,"Ilhéus-Itabuna",983168,14657.878565708,6,189,67,122,89,100,3,1,2,2,1,192,68,124,91,101,116,9.59273325594527,13.7985352899183,0.270636297770832,2020-02-10,2020,2
"1023","BA",2,"Nordeste",29031,"Ilhéus-Itabuna",983168,14657.878565708,7,215,80,135,86,129,2,1,1,1,1,217,81,136,87,130,119,9.59273325594527,13.7985352899183,0.289193816501571,2020-02-17,2020,2
"1024","BA",2,"Nordeste",29031,"Ilhéus-Itabuna",983168,14657.878565708,8,206,79,127,98,108,0,0,0,0,0,206,79,127,98,108,144,9.59273325594527,13.7985352899183,0.329869117950469,2020-02-24,2020,2
"1025","BA",2,"Nordeste",29031,"Ilhéus-Itabuna",983168,14657.878565708,9,218,85,133,102,116,2,0,2,1,1,220,85,135,103,117,151,9.59273325594527,13.7985352899183,0.300989690741055,2020-03-02,2020,3
"1026","BA",2,"Nordeste",29031,"Ilhéus-Itabuna",983168,14657.878565708,10,196,76,120,83,113,1,1,0,0,1,197,77,120,83,114,145,9.59273325594527,13.7985352899183,0.326110961941517,2020-03-09,2020,3
"1027","BA",2,"Nordeste",29031,"Ilhéus-Itabuna",983168,14657.878565708,11,194,82,112,97,97,2,1,1,2,0,196,83,113,99,97,173,9.59273325594527,13.7985352899183,0.394741021017252,2020-03-16,2020,3
"1028","BA",2,"Nordeste",29031,"Ilhéus-Itabuna",983168,14657.878565708,12,183,82,101,80,103,3,1,2,2,1,186,83,103,82,104,149,9.59273325594527,13.7985352899183,0.503037389240299,2020-03-23,2020,3
"1029","BA",2,"Nordeste",29031,"Ilhéus-Itabuna",983168,14657.878565708,13,185,61,124,89,96,4,1,3,1,3,189,62,127,90,99,181,9.59273325594527,13.7985352899183,0.462149425258265,2020-03-30,2020,3
"1030","BA",2,"Nordeste",29031,"Ilhéus-Itabuna",983168,14657.878565708,14,197,82,115,103,94,3,2,1,1,2,200,84,116,104,96,152,9.59273325594527,13.7985352899183,0.452155751275024,2020-04-06,2020,4
"1031","BA",2,"Nordeste",29031,"Ilhéus-Itabuna",983168,14657.878565708,15,167,57,110,81,86,0,0,0,0,0,167,57,110,81,86,164,9.59273325594527,13.7985352899183,0.436553725969351,2020-04-13,2020,4
"1032","BA",2,"Nordeste",29031,"Ilhéus-Itabuna",983168,14657.878565708,16,204,72,132,86,118,4,3,1,3,1,208,75,133,89,119,173,9.59273325594527,13.7985352899183,0.435644863287917,2020-04-20,2020,4
"1033","BA",2,"Nordeste",29031,"Ilhéus-Itabuna",983168,14657.878565708,17,201,77,124,106,95,5,0,5,2,3,206,77,129,108,98,175,9.59273325594527,13.7985352899183,0.420698453997284,2020-04-27,2020,4
"1034","BA",2,"Nordeste",29031,"Ilhéus-Itabuna",983168,14657.878565708,18,229,79,150,116,113,5,1,4,2,3,234,80,154,118,116,171,9.59273325594527,13.7985352899183,0.412511125237598,2020-05-04,2020,5
"1035","BA",2,"Nordeste",29031,"Ilhéus-Itabuna",983168,14657.878565708,19,222,64,158,107,115,3,1,2,1,2,225,65,160,108,117,174,9.59273325594527,13.7985352899183,0.441343910019829,2020-05-11,2020,5
"1036","BA",2,"Nordeste",29031,"Ilhéus-Itabuna",983168,14657.878565708,20,236,95,141,113,123,5,5,0,3,2,241,100,141,116,125,154,9.59273325594527,13.7985352899183,0.429976597273295,2020-05-18,2020,5
"1037","BA",2,"Nordeste",29031,"Ilhéus-Itabuna",983168,14657.878565708,21,239,83,156,104,135,0,0,0,0,0,239,83,156,104,135,177,9.59273325594527,13.7985352899183,0.422765078195466,2020-05-25,2020,5
"1038","BA",2,"Nordeste",29032,"Porto Seguro",806790,19737.343856146,5,227,66,161,99,128,7,4,3,3,4,234,70,164,102,132,98,9.8902677475077,13.6008186903399,0.267472602698369,2020-02-03,2020,2
"1039","BA",2,"Nordeste",29032,"Porto Seguro",806790,19737.343856146,6,203,72,131,85,118,4,1,3,1,3,207,73,134,86,121,93,9.8902677475077,13.6008186903399,0.267237060986326,2020-02-10,2020,2
"1040","BA",2,"Nordeste",29032,"Porto Seguro",806790,19737.343856146,7,205,75,130,90,115,2,2,0,1,1,207,77,130,91,116,92,9.8902677475077,13.6008186903399,0.283278275528994,2020-02-17,2020,2
"1041","BA",2,"Nordeste",29032,"Porto Seguro",806790,19737.343856146,8,213,75,138,102,111,3,1,2,0,3,216,76,140,102,114,109,9.8902677475077,13.6008186903399,0.320732117107912,2020-02-24,2020,2
"1042","BA",2,"Nordeste",29032,"Porto Seguro",806790,19737.343856146,9,211,72,139,101,110,1,0,1,0,1,212,72,140,101,111,100,9.8902677475077,13.6008186903399,0.306959400464104,2020-03-02,2020,3
"1043","BA",2,"Nordeste",29032,"Porto Seguro",806790,19737.343856146,10,183,46,137,79,104,1,1,0,0,1,184,47,137,79,105,87,9.8902677475077,13.6008186903399,0.319085795792425,2020-03-09,2020,3
"1044","BA",2,"Nordeste",29032,"Porto Seguro",806790,19737.343856146,11,178,58,120,84,94,2,1,1,1,1,180,59,121,85,95,93,9.8902677475077,13.6008186903399,0.383248842833374,2020-03-16,2020,3
"1045","BA",2,"Nordeste",29032,"Porto Seguro",806790,19737.343856146,12,209,66,143,102,107,4,2,2,3,1,213,68,145,105,108,94,9.8902677475077,13.6008186903399,0.481825843768533,2020-03-23,2020,3
"1046","BA",2,"Nordeste",29032,"Porto Seguro",806790,19737.343856146,13,160,63,97,75,85,1,1,0,1,0,161,64,97,76,85,100,9.8902677475077,13.6008186903399,0.434975435895858,2020-03-30,2020,3
"1047","BA",2,"Nordeste",29032,"Porto Seguro",806790,19737.343856146,14,198,67,131,97,101,3,2,1,1,2,201,69,132,98,103,97,9.8902677475077,13.6008186903399,0.415319150008161,2020-04-06,2020,4
"1048","BA",2,"Nordeste",29032,"Porto Seguro",806790,19737.343856146,15,197,69,128,87,110,2,1,1,1,1,199,70,129,88,111,98,9.8902677475077,13.6008186903399,0.397818444298046,2020-04-13,2020,4
"1049","BA",2,"Nordeste",29032,"Porto Seguro",806790,19737.343856146,16,246,86,160,114,132,1,0,1,0,1,247,86,161,114,133,83,9.8902677475077,13.6008186903399,0.387735750359275,2020-04-20,2020,4
"1050","BA",2,"Nordeste",29032,"Porto Seguro",806790,19737.343856146,17,235,96,139,94,141,1,1,0,0,1,236,97,139,94,142,95,9.8902677475077,13.6008186903399,0.375748073508713,2020-04-27,2020,4
"1051","BA",2,"Nordeste",29032,"Porto Seguro",806790,19737.343856146,18,217,86,131,107,110,4,3,1,2,2,221,89,132,109,112,86,9.8902677475077,13.6008186903399,0.380397070223773,2020-05-04,2020,5
"1052","BA",2,"Nordeste",29032,"Porto Seguro",806790,19737.343856146,19,245,111,134,126,119,0,0,0,0,0,245,111,134,126,119,106,9.8902677475077,13.6008186903399,0.406387993011686,2020-05-11,2020,5
"1053","BA",2,"Nordeste",29032,"Porto Seguro",806790,19737.343856146,20,229,73,156,108,121,1,1,0,0,1,230,74,156,108,122,115,9.8902677475077,13.6008186903399,0.394687140819422,2020-05-18,2020,5
"1054","BA",2,"Nordeste",29032,"Porto Seguro",806790,19737.343856146,21,214,74,140,96,118,1,1,0,1,0,215,75,140,97,118,108,9.8902677475077,13.6008186903399,0.396439817167502,2020-05-25,2020,5
"1055","CE",2,"Nordeste",23001,"Litoral de Camocim e Acaraú",391710,9714.37656743509,5,115,30,85,51,64,0,0,0,0,0,115,30,85,51,64,56,9.18136218758928,12.8782770490702,0.292480595510034,2020-02-03,2020,2
"1056","CE",2,"Nordeste",23001,"Litoral de Camocim e Acaraú",391710,9714.37656743509,6,117,35,82,45,72,0,0,0,0,0,117,35,82,45,72,45,9.18136218758928,12.8782770490702,0.28978362703856,2020-02-10,2020,2
"1057","CE",2,"Nordeste",23001,"Litoral de Camocim e Acaraú",391710,9714.37656743509,7,141,51,90,58,83,3,1,2,3,0,144,52,92,61,83,54,9.18136218758928,12.8782770490702,0.302828411049082,2020-02-17,2020,2
"1058","CE",2,"Nordeste",23001,"Litoral de Camocim e Acaraú",391710,9714.37656743509,8,120,42,78,56,64,2,2,0,1,1,122,44,78,57,65,55,9.18136218758928,12.8782770490702,0.341843572018729,2020-02-24,2020,2
"1059","CE",2,"Nordeste",23001,"Litoral de Camocim e Acaraú",391710,9714.37656743509,9,116,32,84,47,69,0,0,0,0,0,116,32,84,47,69,44,9.18136218758928,12.8782770490702,0.333343538702379,2020-03-02,2020,3
"1060","CE",2,"Nordeste",23001,"Litoral de Camocim e Acaraú",391710,9714.37656743509,10,105,36,69,46,59,1,1,0,0,1,106,37,69,46,60,49,9.18136218758928,12.8782770490702,0.361334842096372,2020-03-09,2020,3
"1061","CE",2,"Nordeste",23001,"Litoral de Camocim e Acaraú",391710,9714.37656743509,11,101,32,69,41,60,2,0,2,0,2,103,32,71,41,62,53,9.18136218758928,12.8782770490702,0.439049933185581,2020-03-16,2020,3
"1062","CE",2,"Nordeste",23001,"Litoral de Camocim e Acaraú",391710,9714.37656743509,12,85,33,52,34,51,3,1,2,1,2,88,34,54,35,53,56,9.18136218758928,12.8782770490702,0.53986808022431,2020-03-23,2020,3
"1063","CE",2,"Nordeste",23001,"Litoral de Camocim e Acaraú",391710,9714.37656743509,13,83,33,50,34,49,1,1,0,1,0,84,34,50,35,49,53,9.18136218758928,12.8782770490702,0.487985568313676,2020-03-30,2020,3
"1064","CE",2,"Nordeste",23001,"Litoral de Camocim e Acaraú",391710,9714.37656743509,14,97,40,57,34,63,3,1,2,2,1,100,41,59,36,64,57,9.18136218758928,12.8782770490702,0.468067074737956,2020-04-06,2020,4
"1065","CE",2,"Nordeste",23001,"Litoral de Camocim e Acaraú",391710,9714.37656743509,15,104,37,67,50,54,1,0,1,1,0,105,37,68,51,54,44,9.18136218758928,12.8782770490702,0.453466343793343,2020-04-13,2020,4
"1066","CE",2,"Nordeste",23001,"Litoral de Camocim e Acaraú",391710,9714.37656743509,16,116,35,81,47,69,2,1,1,0,2,118,36,82,47,71,28,9.18136218758928,12.8782770490702,0.444617248208767,2020-04-20,2020,4
"1067","CE",2,"Nordeste",23001,"Litoral de Camocim e Acaraú",391710,9714.37656743509,17,111,30,81,52,59,1,1,0,0,1,112,31,81,52,60,44,9.18136218758928,12.8782770490702,0.438937427332383,2020-04-27,2020,4
"1068","CE",2,"Nordeste",23001,"Litoral de Camocim e Acaraú",391710,9714.37656743509,18,92,26,66,42,50,0,0,0,0,0,92,26,66,42,50,65,9.18136218758928,12.8782770490702,0.468880206529754,2020-05-04,2020,5
"1069","CE",2,"Nordeste",23001,"Litoral de Camocim e Acaraú",391710,9714.37656743509,19,114,42,72,54,60,2,1,1,0,2,116,43,73,54,62,81,9.18136218758928,12.8782770490702,0.499576421594873,2020-05-11,2020,5
"1070","CE",2,"Nordeste",23001,"Litoral de Camocim e Acaraú",391710,9714.37656743509,20,104,35,69,45,59,1,0,1,0,1,105,35,70,45,60,92,9.18136218758928,12.8782770490702,0.488618760919372,2020-05-18,2020,5
"1071","CE",2,"Nordeste",23001,"Litoral de Camocim e Acaraú",391710,9714.37656743509,21,120,43,77,46,74,2,1,1,1,1,122,44,78,47,75,86,9.18136218758928,12.8782770490702,0.476847514949269,2020-05-25,2020,5
"1072","CE",2,"Nordeste",23002,"Ibiapaba",322809,12119.7502263568,5,88,27,61,32,56,0,0,0,0,0,88,27,61,32,56,44,9.40259165102454,12.6848160960302,0.278817711718054,2020-02-03,2020,2
"1073","CE",2,"Nordeste",23002,"Ibiapaba",322809,12119.7502263568,6,91,27,64,31,60,0,0,0,0,0,91,27,64,31,60,33,9.40259165102454,12.6848160960302,0.271066070238201,2020-02-10,2020,2
"1074","CE",2,"Nordeste",23002,"Ibiapaba",322809,12119.7502263568,7,85,20,65,32,53,0,0,0,0,0,85,20,65,32,53,37,9.40259165102454,12.6848160960302,0.283903743135352,2020-02-17,2020,2
"1075","CE",2,"Nordeste",23002,"Ibiapaba",322809,12119.7502263568,8,118,40,78,54,64,0,0,0,0,0,118,40,78,54,64,53,9.40259165102454,12.6848160960302,0.328367168863012,2020-02-24,2020,2
"1076","CE",2,"Nordeste",23002,"Ibiapaba",322809,12119.7502263568,9,84,28,56,39,45,0,0,0,0,0,84,28,56,39,45,31,9.40259165102454,12.6848160960302,0.312005628464642,2020-03-02,2020,3
"1077","CE",2,"Nordeste",23002,"Ibiapaba",322809,12119.7502263568,10,79,33,46,33,46,1,0,1,0,1,80,33,47,33,47,51,9.40259165102454,12.6848160960302,0.340329799303676,2020-03-09,2020,3
"1078","CE",2,"Nordeste",23002,"Ibiapaba",322809,12119.7502263568,11,83,30,53,30,53,1,0,1,0,1,84,30,54,30,54,51,9.40259165102454,12.6848160960302,0.436379120438867,2020-03-16,2020,3
"1079","CE",2,"Nordeste",23002,"Ibiapaba",322809,12119.7502263568,12,75,19,56,26,49,0,0,0,0,0,75,19,56,26,49,40,9.40259165102454,12.6848160960302,0.533664242194735,2020-03-23,2020,3
"1080","CE",2,"Nordeste",23002,"Ibiapaba",322809,12119.7502263568,13,72,27,45,23,49,5,2,3,3,2,77,29,48,26,51,38,9.40259165102454,12.6848160960302,0.478854900374266,2020-03-30,2020,3
"1081","CE",2,"Nordeste",23002,"Ibiapaba",322809,12119.7502263568,14,68,22,46,25,43,1,0,1,0,1,69,22,47,25,44,40,9.40259165102454,12.6848160960302,0.46863397108662,2020-04-06,2020,4
"1082","CE",2,"Nordeste",23002,"Ibiapaba",322809,12119.7502263568,15,89,40,49,39,50,0,0,0,0,0,89,40,49,39,50,41,9.40259165102454,12.6848160960302,0.437650720296522,2020-04-13,2020,4
"1083","CE",2,"Nordeste",23002,"Ibiapaba",322809,12119.7502263568,16,79,26,53,40,39,3,0,3,2,1,82,26,56,42,40,29,9.40259165102454,12.6848160960302,0.435223164308615,2020-04-20,2020,4
"1084","CE",2,"Nordeste",23002,"Ibiapaba",322809,12119.7502263568,17,78,22,56,32,46,0,0,0,0,0,78,22,56,32,46,33,9.40259165102454,12.6848160960302,0.43514545247527,2020-04-27,2020,4
"1085","CE",2,"Nordeste",23002,"Ibiapaba",322809,12119.7502263568,18,66,19,47,32,34,1,1,0,1,0,67,20,47,33,34,46,9.40259165102454,12.6848160960302,0.446190452316435,2020-05-04,2020,5
"1086","CE",2,"Nordeste",23002,"Ibiapaba",322809,12119.7502263568,19,89,32,57,37,52,1,1,0,1,0,90,33,57,38,52,41,9.40259165102454,12.6848160960302,0.475586717626879,2020-05-11,2020,5
"1087","CE",2,"Nordeste",23002,"Ibiapaba",322809,12119.7502263568,20,80,35,45,31,49,0,0,0,0,0,80,35,45,31,49,56,9.40259165102454,12.6848160960302,0.46286569676948,2020-05-18,2020,5
"1088","CE",2,"Nordeste",23002,"Ibiapaba",322809,12119.7502263568,21,90,30,60,42,48,1,0,1,0,1,91,30,61,42,49,49,9.40259165102454,12.6848160960302,0.447182422695124,2020-05-25,2020,5
"1089","CE",2,"Nordeste",23003,"Coreaú",60067,10630.6434166847,5,13,1,12,5,8,0,0,0,0,0,13,1,12,5,8,4,9.27149599788472,11.0032158848624,0.294389400850916,2020-02-03,2020,2
"1090","CE",2,"Nordeste",23003,"Coreaú",60067,10630.6434166847,6,22,8,14,5,17,0,0,0,0,0,22,8,14,5,17,6,9.27149599788472,11.0032158848624,0.280901945037701,2020-02-10,2020,2
"1091","CE",2,"Nordeste",23003,"Coreaú",60067,10630.6434166847,7,14,3,11,8,6,0,0,0,0,0,14,3,11,8,6,5,9.27149599788472,11.0032158848624,0.289083269837758,2020-02-17,2020,2
"1092","CE",2,"Nordeste",23003,"Coreaú",60067,10630.6434166847,8,19,7,12,7,12,0,0,0,0,0,19,7,12,7,12,8,9.27149599788472,11.0032158848624,0.329001802966828,2020-02-24,2020,2
"1093","CE",2,"Nordeste",23003,"Coreaú",60067,10630.6434166847,9,14,3,11,5,9,0,0,0,0,0,14,3,11,5,9,8,9.27149599788472,11.0032158848624,0.318483338322447,2020-03-02,2020,3
"1094","CE",2,"Nordeste",23003,"Coreaú",60067,10630.6434166847,10,12,2,10,4,8,0,0,0,0,0,12,2,10,4,8,2,9.27149599788472,11.0032158848624,0.336715603961518,2020-03-09,2020,3
"1095","CE",2,"Nordeste",23003,"Coreaú",60067,10630.6434166847,11,14,8,6,7,7,0,0,0,0,0,14,8,6,7,7,6,9.27149599788472,11.0032158848624,0.439450641975643,2020-03-16,2020,3
"1096","CE",2,"Nordeste",23003,"Coreaú",60067,10630.6434166847,12,8,4,4,3,5,0,0,0,0,0,8,4,4,3,5,7,9.27149599788472,11.0032158848624,0.563552099221529,2020-03-23,2020,3
"1097","CE",2,"Nordeste",23003,"Coreaú",60067,10630.6434166847,13,20,8,12,7,13,0,0,0,0,0,20,8,12,7,13,9,9.27149599788472,11.0032158848624,0.48533471326937,2020-03-30,2020,3
"1098","CE",2,"Nordeste",23003,"Coreaú",60067,10630.6434166847,14,15,5,10,5,10,0,0,0,0,0,15,5,10,5,10,11,9.27149599788472,11.0032158848624,0.458142352074675,2020-04-06,2020,4
"1099","CE",2,"Nordeste",23003,"Coreaú",60067,10630.6434166847,15,11,4,7,7,4,0,0,0,0,0,11,4,7,7,4,9,9.27149599788472,11.0032158848624,0.462645858340307,2020-04-13,2020,4
"1100","CE",2,"Nordeste",23003,"Coreaú",60067,10630.6434166847,16,8,5,3,2,6,0,0,0,0,0,8,5,3,2,6,6,9.27149599788472,11.0032158848624,0.471741272765092,2020-04-20,2020,4
"1101","CE",2,"Nordeste",23003,"Coreaú",60067,10630.6434166847,17,15,8,7,7,8,0,0,0,0,0,15,8,7,7,8,5,9.27149599788472,11.0032158848624,0.474950973287156,2020-04-27,2020,4
"1102","CE",2,"Nordeste",23003,"Coreaú",60067,10630.6434166847,18,15,5,10,3,12,1,0,1,1,0,16,5,11,4,12,6,9.27149599788472,11.0032158848624,0.478892548653416,2020-05-04,2020,5
"1103","CE",2,"Nordeste",23003,"Coreaú",60067,10630.6434166847,19,12,4,8,2,10,0,0,0,0,0,12,4,8,2,10,7,9.27149599788472,11.0032158848624,0.490222852687154,2020-05-11,2020,5
"1104","CE",2,"Nordeste",23003,"Coreaú",60067,10630.6434166847,20,14,1,13,6,8,0,0,0,0,0,14,1,13,6,8,11,9.27149599788472,11.0032158848624,0.479612490048924,2020-05-18,2020,5
"1105","CE",2,"Nordeste",23003,"Coreaú",60067,10630.6434166847,21,20,6,14,5,15,2,1,1,2,0,22,7,15,7,15,12,9.27149599788472,11.0032158848624,0.472268288549673,2020-05-25,2020,5
"1106","CE",2,"Nordeste",23004,"Meruoca",26966,6605.30801379515,5,3,0,3,2,1,0,0,0,0,0,3,0,3,2,1,5,8.79562884929761,10.202332092194,0.294090089400959,2020-02-03,2020,2
"1107","CE",2,"Nordeste",23004,"Meruoca",26966,6605.30801379515,6,8,2,6,2,6,1,0,1,1,0,9,2,7,3,6,4,8.79562884929761,10.202332092194,0.261501503061969,2020-02-10,2020,2
"1108","CE",2,"Nordeste",23004,"Meruoca",26966,6605.30801379515,7,6,2,4,1,5,0,0,0,0,0,6,2,4,1,5,2,8.79562884929761,10.202332092194,0.290133134986001,2020-02-17,2020,2
"1109","CE",2,"Nordeste",23004,"Meruoca",26966,6605.30801379515,8,14,3,11,4,10,0,0,0,0,0,14,3,11,4,10,4,8.79562884929761,10.202332092194,0.346711824919873,2020-02-24,2020,2
"1110","CE",2,"Nordeste",23004,"Meruoca",26966,6605.30801379515,9,1,0,1,0,1,0,0,0,0,0,1,0,1,0,1,4,8.79562884929761,10.202332092194,0.307826966534799,2020-03-02,2020,3
"1111","CE",2,"Nordeste",23004,"Meruoca",26966,6605.30801379515,10,3,0,3,0,3,0,0,0,0,0,3,0,3,0,3,2,8.79562884929761,10.202332092194,0.354424823887957,2020-03-09,2020,3
"1112","CE",2,"Nordeste",23004,"Meruoca",26966,6605.30801379515,11,5,0,5,0,5,0,0,0,0,0,5,0,5,0,5,4,8.79562884929761,10.202332092194,0.44514880547062,2020-03-16,2020,3
"1113","CE",2,"Nordeste",23004,"Meruoca",26966,6605.30801379515,12,4,1,3,1,3,0,0,0,0,0,4,1,3,1,3,3,8.79562884929761,10.202332092194,0.546906855228939,2020-03-23,2020,3
"1114","CE",2,"Nordeste",23004,"Meruoca",26966,6605.30801379515,13,6,3,3,2,4,0,0,0,0,0,6,3,3,2,4,5,8.79562884929761,10.202332092194,0.483839987279607,2020-03-30,2020,3
"1115","CE",2,"Nordeste",23004,"Meruoca",26966,6605.30801379515,14,4,1,3,3,1,0,0,0,0,0,4,1,3,3,1,0,8.79562884929761,10.202332092194,0.476613457084848,2020-04-06,2020,4
"1116","CE",2,"Nordeste",23004,"Meruoca",26966,6605.30801379515,15,6,3,3,2,4,0,0,0,0,0,6,3,3,2,4,1,8.79562884929761,10.202332092194,0.465902169970161,2020-04-13,2020,4
"1117","CE",2,"Nordeste",23004,"Meruoca",26966,6605.30801379515,16,7,4,3,1,6,0,0,0,0,0,7,4,3,1,6,5,8.79562884929761,10.202332092194,0.485504762212896,2020-04-20,2020,4
"1118","CE",2,"Nordeste",23004,"Meruoca",26966,6605.30801379515,17,3,0,3,3,0,0,0,0,0,0,3,0,3,3,0,3,8.79562884929761,10.202332092194,0.456016688063339,2020-04-27,2020,4
"1119","CE",2,"Nordeste",23004,"Meruoca",26966,6605.30801379515,18,3,2,1,0,3,0,0,0,0,0,3,2,1,0,3,4,8.79562884929761,10.202332092194,0.478556436154112,2020-05-04,2020,5
"1120","CE",2,"Nordeste",23004,"Meruoca",26966,6605.30801379515,19,3,1,2,1,2,0,0,0,0,0,3,1,2,1,2,4,8.79562884929761,10.202332092194,0.508526252463749,2020-05-11,2020,5
"1121","CE",2,"Nordeste",23004,"Meruoca",26966,6605.30801379515,20,8,2,6,3,5,0,0,0,0,0,8,2,6,3,5,6,8.79562884929761,10.202332092194,0.495459305040596,2020-05-18,2020,5
"1122","CE",2,"Nordeste",23004,"Meruoca",26966,6605.30801379515,21,11,2,9,5,6,0,0,0,0,0,11,2,9,5,6,2,8.79562884929761,10.202332092194,0.500966686176024,2020-05-25,2020,5
"1123","CE",2,"Nordeste",23005,"Sobral",417859,15140.1240881015,5,103,20,83,34,69,1,0,1,0,1,104,20,84,34,70,51,9.62510372300154,12.9428993340273,0.291447265532892,2020-02-03,2020,2
"1124","CE",2,"Nordeste",23005,"Sobral",417859,15140.1240881015,6,118,15,103,41,77,2,0,2,1,1,120,15,105,42,78,56,9.62510372300154,12.9428993340273,0.28601815684608,2020-02-10,2020,2
"1125","CE",2,"Nordeste",23005,"Sobral",417859,15140.1240881015,7,130,35,95,46,84,1,0,1,1,0,131,35,96,47,84,53,9.62510372300154,12.9428993340273,0.293567990007395,2020-02-17,2020,2
"1126","CE",2,"Nordeste",23005,"Sobral",417859,15140.1240881015,8,120,26,94,43,77,0,0,0,0,0,120,26,94,43,77,51,9.62510372300154,12.9428993340273,0.349494424252503,2020-02-24,2020,2
"1127","CE",2,"Nordeste",23005,"Sobral",417859,15140.1240881015,9,104,26,78,46,58,0,0,0,0,0,104,26,78,46,58,60,9.62510372300154,12.9428993340273,0.319353069369957,2020-03-02,2020,3
"1128","CE",2,"Nordeste",23005,"Sobral",417859,15140.1240881015,10,102,21,81,39,63,1,1,0,0,1,103,22,81,39,64,54,9.62510372300154,12.9428993340273,0.348228064323542,2020-03-09,2020,3
"1129","CE",2,"Nordeste",23005,"Sobral",417859,15140.1240881015,11,107,21,86,53,54,0,0,0,0,0,107,21,86,53,54,64,9.62510372300154,12.9428993340273,0.443976244656726,2020-03-16,2020,3
"1130","CE",2,"Nordeste",23005,"Sobral",417859,15140.1240881015,12,103,21,82,41,62,0,0,0,0,0,103,21,82,41,62,49,9.62510372300154,12.9428993340273,0.551127418397862,2020-03-23,2020,3
"1131","CE",2,"Nordeste",23005,"Sobral",417859,15140.1240881015,13,99,21,78,28,71,1,1,0,0,1,100,22,78,28,72,53,9.62510372300154,12.9428993340273,0.492455685571951,2020-03-30,2020,3
"1132","CE",2,"Nordeste",23005,"Sobral",417859,15140.1240881015,14,93,18,75,39,54,0,0,0,0,0,93,18,75,39,54,49,9.62510372300154,12.9428993340273,0.477294634525288,2020-04-06,2020,4
"1133","CE",2,"Nordeste",23005,"Sobral",417859,15140.1240881015,15,97,21,76,43,54,0,0,0,0,0,97,21,76,43,54,58,9.62510372300154,12.9428993340273,0.458438434580566,2020-04-13,2020,4
"1134","CE",2,"Nordeste",23005,"Sobral",417859,15140.1240881015,16,94,17,77,41,53,1,0,1,0,1,95,17,78,41,54,50,9.62510372300154,12.9428993340273,0.458465259808975,2020-04-20,2020,4
"1135","CE",2,"Nordeste",23005,"Sobral",417859,15140.1240881015,17,100,19,81,42,58,1,1,0,0,1,101,20,81,42,59,75,9.62510372300154,12.9428993340273,0.445597588848746,2020-04-27,2020,4
"1136","CE",2,"Nordeste",23005,"Sobral",417859,15140.1240881015,18,116,24,92,40,76,1,1,0,0,1,117,25,92,40,77,64,9.62510372300154,12.9428993340273,0.48234600693406,2020-05-04,2020,5
"1137","CE",2,"Nordeste",23005,"Sobral",417859,15140.1240881015,19,99,27,72,34,65,2,0,2,2,0,101,27,74,36,65,96,9.62510372300154,12.9428993340273,0.525515011647085,2020-05-11,2020,5
"1138","CE",2,"Nordeste",23005,"Sobral",417859,15140.1240881015,20,98,18,80,45,53,1,0,1,0,1,99,18,81,45,54,83,9.62510372300154,12.9428993340273,0.508567366396739,2020-05-18,2020,5
"1139","CE",2,"Nordeste",23005,"Sobral",417859,15140.1240881015,21,93,29,64,37,56,1,0,1,1,0,94,29,65,38,56,116,9.62510372300154,12.9428993340273,0.490058806481559,2020-05-25,2020,5
"1140","CE",2,"Nordeste",23006,"Ipu",140376,8666.71946002166,5,31,12,19,11,20,0,0,0,0,0,31,12,19,11,20,27,9.06724561985792,11.852079815791,0.282709348563963,2020-02-03,2020,2
"1141","CE",2,"Nordeste",23006,"Ipu",140376,8666.71946002166,6,28,14,14,11,17,1,0,1,1,0,29,14,15,12,17,20,9.06724561985792,11.852079815791,0.279265784697991,2020-02-10,2020,2
"1142","CE",2,"Nordeste",23006,"Ipu",140376,8666.71946002166,7,34,13,21,13,21,0,0,0,0,0,34,13,21,13,21,24,9.06724561985792,11.852079815791,0.281085188545392,2020-02-17,2020,2
"1143","CE",2,"Nordeste",23006,"Ipu",140376,8666.71946002166,8,23,9,14,8,15,0,0,0,0,0,23,9,14,8,15,30,9.06724561985792,11.852079815791,0.327885721784025,2020-02-24,2020,2
"1144","CE",2,"Nordeste",23006,"Ipu",140376,8666.71946002166,9,22,9,13,8,14,0,0,0,0,0,22,9,13,8,14,20,9.06724561985792,11.852079815791,0.315334761346246,2020-03-02,2020,3
"1145","CE",2,"Nordeste",23006,"Ipu",140376,8666.71946002166,10,30,5,25,13,17,0,0,0,0,0,30,5,25,13,17,22,9.06724561985792,11.852079815791,0.341643884926097,2020-03-09,2020,3
"1146","CE",2,"Nordeste",23006,"Ipu",140376,8666.71946002166,11,32,13,19,12,20,1,1,0,1,0,33,14,19,13,20,17,9.06724561985792,11.852079815791,0.430530196795495,2020-03-16,2020,3
"1147","CE",2,"Nordeste",23006,"Ipu",140376,8666.71946002166,12,13,6,7,9,4,0,0,0,0,0,13,6,7,9,4,26,9.06724561985792,11.852079815791,0.522196346894574,2020-03-23,2020,3
"1148","CE",2,"Nordeste",23006,"Ipu",140376,8666.71946002166,13,15,9,6,9,6,1,0,1,0,1,16,9,7,9,7,19,9.06724561985792,11.852079815791,0.463986292920213,2020-03-30,2020,3
"1149","CE",2,"Nordeste",23006,"Ipu",140376,8666.71946002166,14,14,5,9,4,10,1,1,0,1,0,15,6,9,5,10,29,9.06724561985792,11.852079815791,0.466006941882505,2020-04-06,2020,4
"1150","CE",2,"Nordeste",23006,"Ipu",140376,8666.71946002166,15,7,2,5,2,5,3,0,3,2,1,10,2,8,4,6,19,9.06724561985792,11.852079815791,0.423474854002443,2020-04-13,2020,4
"1151","CE",2,"Nordeste",23006,"Ipu",140376,8666.71946002166,16,12,5,7,5,7,0,0,0,0,0,12,5,7,5,7,17,9.06724561985792,11.852079815791,0.415329811419747,2020-04-20,2020,4
"1152","CE",2,"Nordeste",23006,"Ipu",140376,8666.71946002166,17,9,2,7,6,3,0,0,0,0,0,9,2,7,6,3,23,9.06724561985792,11.852079815791,0.428334558620559,2020-04-27,2020,4
"1153","CE",2,"Nordeste",23006,"Ipu",140376,8666.71946002166,18,11,4,7,1,10,1,1,0,0,1,12,5,7,1,11,20,9.06724561985792,11.852079815791,0.436454578265249,2020-05-04,2020,5
"1154","CE",2,"Nordeste",23006,"Ipu",140376,8666.71946002166,19,9,3,6,3,6,0,0,0,0,0,9,3,6,3,6,18,9.06724561985792,11.852079815791,0.485488115164555,2020-05-11,2020,5
"1155","CE",2,"Nordeste",23006,"Ipu",140376,8666.71946002166,20,15,3,12,4,11,0,0,0,0,0,15,3,12,4,11,22,9.06724561985792,11.852079815791,0.447373499485943,2020-05-18,2020,5
"1156","CE",2,"Nordeste",23006,"Ipu",140376,8666.71946002166,21,13,3,10,6,7,0,0,0,0,0,13,3,10,6,7,26,9.06724561985792,11.852079815791,0.430950312618948,2020-05-25,2020,5
"1157","CE",2,"Nordeste",23007,"Santa Quitéria",74140,8936.2602611276,5,20,4,16,10,10,0,0,0,0,0,20,4,16,10,10,10,9.09787246533919,11.2137104767047,0.262009444775242,2020-02-03,2020,2
"1158","CE",2,"Nordeste",23007,"Santa Quitéria",74140,8936.2602611276,6,18,6,12,9,9,0,0,0,0,0,18,6,12,9,9,11,9.09787246533919,11.2137104767047,0.264824484326496,2020-02-10,2020,2
"1159","CE",2,"Nordeste",23007,"Santa Quitéria",74140,8936.2602611276,7,21,6,15,13,8,0,0,0,0,0,21,6,15,13,8,7,9.09787246533919,11.2137104767047,0.277735738963217,2020-02-17,2020,2
"1160","CE",2,"Nordeste",23007,"Santa Quitéria",74140,8936.2602611276,8,19,5,14,8,11,1,0,1,0,1,20,5,15,8,12,11,9.09787246533919,11.2137104767047,0.310391271287244,2020-02-24,2020,2
"1161","CE",2,"Nordeste",23007,"Santa Quitéria",74140,8936.2602611276,9,15,7,8,7,8,0,0,0,0,0,15,7,8,7,8,12,9.09787246533919,11.2137104767047,0.299668563957521,2020-03-02,2020,3
"1162","CE",2,"Nordeste",23007,"Santa Quitéria",74140,8936.2602611276,10,20,6,14,8,12,0,0,0,0,0,20,6,14,8,12,11,9.09787246533919,11.2137104767047,0.337202072707337,2020-03-09,2020,3
"1163","CE",2,"Nordeste",23007,"Santa Quitéria",74140,8936.2602611276,11,16,5,11,9,7,0,0,0,0,0,16,5,11,9,7,14,9.09787246533919,11.2137104767047,0.416436379046143,2020-03-16,2020,3
"1164","CE",2,"Nordeste",23007,"Santa Quitéria",74140,8936.2602611276,12,16,5,11,8,8,0,0,0,0,0,16,5,11,8,8,21,9.09787246533919,11.2137104767047,0.521905583629211,2020-03-23,2020,3
"1165","CE",2,"Nordeste",23007,"Santa Quitéria",74140,8936.2602611276,13,11,2,9,3,8,0,0,0,0,0,11,2,9,3,8,12,9.09787246533919,11.2137104767047,0.470850051088871,2020-03-30,2020,3
"1166","CE",2,"Nordeste",23007,"Santa Quitéria",74140,8936.2602611276,14,12,4,8,4,8,0,0,0,0,0,12,4,8,4,8,13,9.09787246533919,11.2137104767047,0.445020211230746,2020-04-06,2020,4
"1167","CE",2,"Nordeste",23007,"Santa Quitéria",74140,8936.2602611276,15,10,6,4,3,7,0,0,0,0,0,10,6,4,3,7,11,9.09787246533919,11.2137104767047,0.420414087424028,2020-04-13,2020,4
"1168","CE",2,"Nordeste",23007,"Santa Quitéria",74140,8936.2602611276,16,6,2,4,2,4,0,0,0,0,0,6,2,4,2,4,12,9.09787246533919,11.2137104767047,0.413114265534653,2020-04-20,2020,4
"1169","CE",2,"Nordeste",23007,"Santa Quitéria",74140,8936.2602611276,17,22,9,13,7,15,0,0,0,0,0,22,9,13,7,15,10,9.09787246533919,11.2137104767047,0.413165652718938,2020-04-27,2020,4
"1170","CE",2,"Nordeste",23007,"Santa Quitéria",74140,8936.2602611276,18,7,5,2,1,6,0,0,0,0,0,7,5,2,1,6,11,9.09787246533919,11.2137104767047,0.452258332880641,2020-05-04,2020,5
"1171","CE",2,"Nordeste",23007,"Santa Quitéria",74140,8936.2602611276,19,10,5,5,6,4,0,0,0,0,0,10,5,5,6,4,17,9.09787246533919,11.2137104767047,0.467087296383928,2020-05-11,2020,5
"1172","CE",2,"Nordeste",23007,"Santa Quitéria",74140,8936.2602611276,20,12,1,11,6,6,0,0,0,0,0,12,1,11,6,6,9,9.09787246533919,11.2137104767047,0.46796744112381,2020-05-18,2020,5
"1173","CE",2,"Nordeste",23007,"Santa Quitéria",74140,8936.2602611276,21,19,4,15,9,10,0,0,0,0,0,19,4,15,9,10,12,9.09787246533919,11.2137104767047,0.452226158623475,2020-05-25,2020,5
"1174","CE",2,"Nordeste",23008,"Itapipoca",230659,12822.7295793791,5,61,18,43,26,35,3,2,1,2,1,64,20,44,28,36,25,9.45897462351953,12.3486957083851,0.283316572285001,2020-02-03,2020,2
"1175","CE",2,"Nordeste",23008,"Itapipoca",230659,12822.7295793791,6,63,14,49,24,39,2,1,1,1,1,65,15,50,25,40,19,9.45897462351953,12.3486957083851,0.284173627428971,2020-02-10,2020,2
"1176","CE",2,"Nordeste",23008,"Itapipoca",230659,12822.7295793791,7,60,21,39,29,31,3,3,0,2,1,63,24,39,31,32,21,9.45897462351953,12.3486957083851,0.291251808152509,2020-02-17,2020,2
"1177","CE",2,"Nordeste",23008,"Itapipoca",230659,12822.7295793791,8,61,18,43,28,33,0,0,0,0,0,61,18,43,28,33,23,9.45897462351953,12.3486957083851,0.34404379690676,2020-02-24,2020,2
"1178","CE",2,"Nordeste",23008,"Itapipoca",230659,12822.7295793791,9,68,23,45,33,35,1,1,0,0,1,69,24,45,33,36,33,9.45897462351953,12.3486957083851,0.317570803762905,2020-03-02,2020,3
"1179","CE",2,"Nordeste",23008,"Itapipoca",230659,12822.7295793791,10,67,19,48,33,34,0,0,0,0,0,67,19,48,33,34,27,9.45897462351953,12.3486957083851,0.351411128895763,2020-03-09,2020,3
"1180","CE",2,"Nordeste",23008,"Itapipoca",230659,12822.7295793791,11,57,14,43,23,34,0,0,0,0,0,57,14,43,23,34,21,9.45897462351953,12.3486957083851,0.435301347022361,2020-03-16,2020,3
"1181","CE",2,"Nordeste",23008,"Itapipoca",230659,12822.7295793791,12,55,15,40,27,28,1,1,0,0,1,56,16,40,27,29,22,9.45897462351953,12.3486957083851,0.536049050386695,2020-03-23,2020,3
"1182","CE",2,"Nordeste",23008,"Itapipoca",230659,12822.7295793791,13,60,18,42,27,33,0,0,0,0,0,60,18,42,27,33,25,9.45897462351953,12.3486957083851,0.47566909068476,2020-03-30,2020,3
"1183","CE",2,"Nordeste",23008,"Itapipoca",230659,12822.7295793791,14,55,17,38,24,31,2,1,1,0,2,57,18,39,24,33,20,9.45897462351953,12.3486957083851,0.45558332411366,2020-04-06,2020,4
"1184","CE",2,"Nordeste",23008,"Itapipoca",230659,12822.7295793791,15,62,23,39,26,36,1,0,1,1,0,63,23,40,27,36,20,9.45897462351953,12.3486957083851,0.441047619862955,2020-04-13,2020,4
"1185","CE",2,"Nordeste",23008,"Itapipoca",230659,12822.7295793791,16,56,15,41,17,39,0,0,0,0,0,56,15,41,17,39,30,9.45897462351953,12.3486957083851,0.460982881771166,2020-04-20,2020,4
"1186","CE",2,"Nordeste",23008,"Itapipoca",230659,12822.7295793791,17,70,18,52,35,35,0,0,0,0,0,70,18,52,35,35,40,9.45897462351953,12.3486957083851,0.450710366809206,2020-04-27,2020,4
"1187","CE",2,"Nordeste",23008,"Itapipoca",230659,12822.7295793791,18,41,5,36,16,25,1,0,1,0,1,42,5,37,16,26,63,9.45897462351953,12.3486957083851,0.480182783155654,2020-05-04,2020,5
"1188","CE",2,"Nordeste",23008,"Itapipoca",230659,12822.7295793791,19,34,13,21,11,23,0,0,0,0,0,34,13,21,11,23,50,9.45897462351953,12.3486957083851,0.521412902273214,2020-05-11,2020,5
"1189","CE",2,"Nordeste",23008,"Itapipoca",230659,12822.7295793791,20,23,5,18,11,12,1,0,1,0,1,24,5,19,11,13,58,9.45897462351953,12.3486957083851,0.52082168454552,2020-05-18,2020,5
"1190","CE",2,"Nordeste",23008,"Itapipoca",230659,12822.7295793791,21,26,9,17,13,13,0,0,0,0,0,26,9,17,13,13,39,9.45897462351953,12.3486957083851,0.492306889627704,2020-05-25,2020,5
"1191","CE",2,"Nordeste",23009,"Baixo Curu",117165,43999.7775760679,5,40,8,32,23,17,0,0,0,0,0,40,8,32,23,17,13,10.6919398577983,11.6713384767125,0.268728580917139,2020-02-03,2020,2
"1192","CE",2,"Nordeste",23009,"Baixo Curu",117165,43999.7775760679,6,35,11,24,16,19,0,0,0,0,0,35,11,24,16,19,13,10.6919398577983,11.6713384767125,0.274300210244363,2020-02-10,2020,2
"1193","CE",2,"Nordeste",23009,"Baixo Curu",117165,43999.7775760679,7,32,7,25,13,19,0,0,0,0,0,32,7,25,13,19,14,10.6919398577983,11.6713384767125,0.282224923578946,2020-02-17,2020,2
"1194","CE",2,"Nordeste",23009,"Baixo Curu",117165,43999.7775760679,8,35,3,32,11,24,0,0,0,0,0,35,3,32,11,24,20,10.6919398577983,11.6713384767125,0.33181390238606,2020-02-24,2020,2
"1195","CE",2,"Nordeste",23009,"Baixo Curu",117165,43999.7775760679,9,37,11,26,13,24,0,0,0,0,0,37,11,26,13,24,12,10.6919398577983,11.6713384767125,0.302361808555682,2020-03-02,2020,3
"1196","CE",2,"Nordeste",23009,"Baixo Curu",117165,43999.7775760679,10,43,13,30,10,33,0,0,0,0,0,43,13,30,10,33,20,10.6919398577983,11.6713384767125,0.332455862581399,2020-03-09,2020,3
"1197","CE",2,"Nordeste",23009,"Baixo Curu",117165,43999.7775760679,11,33,8,25,14,19,1,0,1,0,1,34,8,26,14,20,15,10.6919398577983,11.6713384767125,0.401662594117839,2020-03-16,2020,3
"1198","CE",2,"Nordeste",23009,"Baixo Curu",117165,43999.7775760679,12,22,9,13,11,11,0,0,0,0,0,22,9,13,11,11,14,10.6919398577983,11.6713384767125,0.500011579192971,2020-03-23,2020,3
"1199","CE",2,"Nordeste",23009,"Baixo Curu",117165,43999.7775760679,13,31,5,26,10,21,0,0,0,0,0,31,5,26,10,21,19,10.6919398577983,11.6713384767125,0.459297385866301,2020-03-30,2020,3
"1200","CE",2,"Nordeste",23009,"Baixo Curu",117165,43999.7775760679,14,33,5,28,16,17,0,0,0,0,0,33,5,28,16,17,15,10.6919398577983,11.6713384767125,0.451003059296203,2020-04-06,2020,4
"1201","CE",2,"Nordeste",23009,"Baixo Curu",117165,43999.7775760679,15,24,4,20,9,15,0,0,0,0,0,24,4,20,9,15,18,10.6919398577983,11.6713384767125,0.440448596774675,2020-04-13,2020,4
"1202","CE",2,"Nordeste",23009,"Baixo Curu",117165,43999.7775760679,16,30,7,23,12,18,0,0,0,0,0,30,7,23,12,18,13,10.6919398577983,11.6713384767125,0.454309812815808,2020-04-20,2020,4
"1203","CE",2,"Nordeste",23009,"Baixo Curu",117165,43999.7775760679,17,26,7,19,12,14,1,1,0,0,1,27,8,19,12,15,16,10.6919398577983,11.6713384767125,0.421952223787927,2020-04-27,2020,4
"1204","CE",2,"Nordeste",23009,"Baixo Curu",117165,43999.7775760679,18,34,11,23,13,21,2,1,1,0,2,36,12,24,13,23,22,10.6919398577983,11.6713384767125,0.450619272985802,2020-05-04,2020,5
"1205","CE",2,"Nordeste",23009,"Baixo Curu",117165,43999.7775760679,19,24,5,19,12,12,0,0,0,0,0,24,5,19,12,12,32,10.6919398577983,11.6713384767125,0.477092250800267,2020-05-11,2020,5
"1206","CE",2,"Nordeste",23009,"Baixo Curu",117165,43999.7775760679,20,23,5,18,8,15,0,0,0,0,0,23,5,18,8,15,27,10.6919398577983,11.6713384767125,0.462741707786429,2020-05-18,2020,5
"1207","CE",2,"Nordeste",23009,"Baixo Curu",117165,43999.7775760679,21,26,6,20,8,18,0,0,0,0,0,26,6,20,8,18,28,10.6919398577983,11.6713384767125,0.43992630827104,2020-05-25,2020,5
"1208","CE",2,"Nordeste",23010,"Uruburetama",111441,10662.4538391615,5,38,18,20,20,18,1,1,0,0,1,39,19,20,20,19,12,9.27448386252084,11.621250581852,0.281538482930516,2020-02-03,2020,2
"1209","CE",2,"Nordeste",23010,"Uruburetama",111441,10662.4538391615,6,29,7,22,11,18,0,0,0,0,0,29,7,22,11,18,15,9.27448386252084,11.621250581852,0.280226941266807,2020-02-10,2020,2
"1210","CE",2,"Nordeste",23010,"Uruburetama",111441,10662.4538391615,7,28,9,19,12,16,0,0,0,0,0,28,9,19,12,16,14,9.27448386252084,11.621250581852,0.287887196475021,2020-02-17,2020,2
"1211","CE",2,"Nordeste",23010,"Uruburetama",111441,10662.4538391615,8,30,10,20,12,18,1,1,0,0,1,31,11,20,12,19,12,9.27448386252084,11.621250581852,0.335757419077598,2020-02-24,2020,2
"1212","CE",2,"Nordeste",23010,"Uruburetama",111441,10662.4538391615,9,34,11,23,15,19,1,0,1,1,0,35,11,24,16,19,22,9.27448386252084,11.621250581852,0.325939494732407,2020-03-02,2020,3
"1213","CE",2,"Nordeste",23010,"Uruburetama",111441,10662.4538391615,10,11,3,8,6,5,0,0,0,0,0,11,3,8,6,5,13,9.27448386252084,11.621250581852,0.341871364881195,2020-03-09,2020,3
"1214","CE",2,"Nordeste",23010,"Uruburetama",111441,10662.4538391615,11,17,6,11,3,14,2,0,2,1,1,19,6,13,4,15,13,9.27448386252084,11.621250581852,0.423466318880898,2020-03-16,2020,3
"1215","CE",2,"Nordeste",23010,"Uruburetama",111441,10662.4538391615,12,14,5,9,3,11,0,0,0,0,0,14,5,9,3,11,14,9.27448386252084,11.621250581852,0.515488890322008,2020-03-23,2020,3
"1216","CE",2,"Nordeste",23010,"Uruburetama",111441,10662.4538391615,13,26,3,23,12,14,0,0,0,0,0,26,3,23,12,14,20,9.27448386252084,11.621250581852,0.45710340807811,2020-03-30,2020,3
"1217","CE",2,"Nordeste",23010,"Uruburetama",111441,10662.4538391615,14,21,11,10,7,14,0,0,0,0,0,21,11,10,7,14,7,9.27448386252084,11.621250581852,0.451895176454854,2020-04-06,2020,4
"1218","CE",2,"Nordeste",23010,"Uruburetama",111441,10662.4538391615,15,23,8,15,16,7,0,0,0,0,0,23,8,15,16,7,14,9.27448386252084,11.621250581852,0.423711046088935,2020-04-13,2020,4
"1219","CE",2,"Nordeste",23010,"Uruburetama",111441,10662.4538391615,16,21,6,15,10,11,1,0,1,0,1,22,6,16,10,12,18,9.27448386252084,11.621250581852,0.444766967788945,2020-04-20,2020,4
"1220","CE",2,"Nordeste",23010,"Uruburetama",111441,10662.4538391615,17,19,4,15,9,10,0,0,0,0,0,19,4,15,9,10,19,9.27448386252084,11.621250581852,0.430139764293574,2020-04-27,2020,4
"1221","CE",2,"Nordeste",23010,"Uruburetama",111441,10662.4538391615,18,22,7,15,9,13,0,0,0,0,0,22,7,15,9,13,29,9.27448386252084,11.621250581852,0.487044992525444,2020-05-04,2020,5
"1222","CE",2,"Nordeste",23010,"Uruburetama",111441,10662.4538391615,19,22,9,13,9,13,0,0,0,0,0,22,9,13,9,13,34,9.27448386252084,11.621250581852,0.516880546306997,2020-05-11,2020,5
"1223","CE",2,"Nordeste",23010,"Uruburetama",111441,10662.4538391615,20,14,5,9,1,13,0,0,0,0,0,14,5,9,1,13,55,9.27448386252084,11.621250581852,0.499255873773572,2020-05-18,2020,5
"1224","CE",2,"Nordeste",23010,"Uruburetama",111441,10662.4538391615,21,14,7,7,6,8,0,0,0,0,0,14,7,7,6,8,28,9.27448386252084,11.621250581852,0.483195271120228,2020-05-25,2020,5
"1225","CE",2,"Nordeste",23011,"Médio Curu",92681,8530.01953464033,5,14,5,9,5,9,0,0,0,0,0,14,5,9,5,9,16,9.05134693059334,11.4369187683025,0.272396727938094,2020-02-03,2020,2
"1226","CE",2,"Nordeste",23011,"Médio Curu",92681,8530.01953464033,6,22,6,16,13,9,0,0,0,0,0,22,6,16,13,9,13,9.05134693059334,11.4369187683025,0.279707797608247,2020-02-10,2020,2
"1227","CE",2,"Nordeste",23011,"Médio Curu",92681,8530.01953464033,7,22,6,16,7,15,0,0,0,0,0,22,6,16,7,15,10,9.05134693059334,11.4369187683025,0.29892054522862,2020-02-17,2020,2
"1228","CE",2,"Nordeste",23011,"Médio Curu",92681,8530.01953464033,8,25,11,14,14,11,0,0,0,0,0,25,11,14,14,11,20,9.05134693059334,11.4369187683025,0.33597393179522,2020-02-24,2020,2
"1229","CE",2,"Nordeste",23011,"Médio Curu",92681,8530.01953464033,9,19,5,14,7,12,0,0,0,0,0,19,5,14,7,12,13,9.05134693059334,11.4369187683025,0.316746918383438,2020-03-02,2020,3
"1230","CE",2,"Nordeste",23011,"Médio Curu",92681,8530.01953464033,10,15,4,11,9,6,0,0,0,0,0,15,4,11,9,6,16,9.05134693059334,11.4369187683025,0.358127050076063,2020-03-09,2020,3
"1231","CE",2,"Nordeste",23011,"Médio Curu",92681,8530.01953464033,11,20,7,13,5,15,0,0,0,0,0,20,7,13,5,15,15,9.05134693059334,11.4369187683025,0.420458901363862,2020-03-16,2020,3
"1232","CE",2,"Nordeste",23011,"Médio Curu",92681,8530.01953464033,12,20,7,13,9,11,0,0,0,0,0,20,7,13,9,11,13,9.05134693059334,11.4369187683025,0.506021498265229,2020-03-23,2020,3
"1233","CE",2,"Nordeste",23011,"Médio Curu",92681,8530.01953464033,13,23,8,15,13,10,0,0,0,0,0,23,8,15,13,10,12,9.05134693059334,11.4369187683025,0.45928497033417,2020-03-30,2020,3
"1234","CE",2,"Nordeste",23011,"Médio Curu",92681,8530.01953464033,14,12,4,8,4,8,0,0,0,0,0,12,4,8,4,8,13,9.05134693059334,11.4369187683025,0.446289594075754,2020-04-06,2020,4
"1235","CE",2,"Nordeste",23011,"Médio Curu",92681,8530.01953464033,15,13,3,10,7,6,1,1,0,1,0,14,4,10,8,6,9,9.05134693059334,11.4369187683025,0.44266538175442,2020-04-13,2020,4
"1236","CE",2,"Nordeste",23011,"Médio Curu",92681,8530.01953464033,16,23,4,19,15,8,0,0,0,0,0,23,4,19,15,8,11,9.05134693059334,11.4369187683025,0.439401306939196,2020-04-20,2020,4
"1237","CE",2,"Nordeste",23011,"Médio Curu",92681,8530.01953464033,17,18,7,11,10,8,0,0,0,0,0,18,7,11,10,8,11,9.05134693059334,11.4369187683025,0.444501768325474,2020-04-27,2020,4
"1238","CE",2,"Nordeste",23011,"Médio Curu",92681,8530.01953464033,18,15,8,7,10,5,1,1,0,0,1,16,9,7,10,6,17,9.05134693059334,11.4369187683025,0.469459504233549,2020-05-04,2020,5
"1239","CE",2,"Nordeste",23011,"Médio Curu",92681,8530.01953464033,19,22,10,12,14,8,0,0,0,0,0,22,10,12,14,8,15,9.05134693059334,11.4369187683025,0.509863741616375,2020-05-11,2020,5
"1240","CE",2,"Nordeste",23011,"Médio Curu",92681,8530.01953464033,20,11,3,8,5,6,0,0,0,0,0,11,3,8,5,6,27,9.05134693059334,11.4369187683025,0.508396881685018,2020-05-18,2020,5
"1241","CE",2,"Nordeste",23011,"Médio Curu",92681,8530.01953464033,21,23,10,13,14,9,0,0,0,0,0,23,10,13,14,9,19,9.05134693059334,11.4369187683025,0.47167280448796,2020-05-25,2020,5
"1242","CE",2,"Nordeste",23012,"Canindé",134114,7315.1327163458,5,30,10,20,15,15,0,0,0,0,0,30,10,20,15,15,14,8.89770045633076,11.8064454635222,0.28135294881958,2020-02-03,2020,2
"1243","CE",2,"Nordeste",23012,"Canindé",134114,7315.1327163458,6,26,9,17,12,14,0,0,0,0,0,26,9,17,12,14,13,8.89770045633076,11.8064454635222,0.295473598780611,2020-02-10,2020,2
"1244","CE",2,"Nordeste",23012,"Canindé",134114,7315.1327163458,7,39,16,23,21,18,2,2,0,0,2,41,18,23,21,20,23,8.89770045633076,11.8064454635222,0.30068918267818,2020-02-17,2020,2
"1245","CE",2,"Nordeste",23012,"Canindé",134114,7315.1327163458,8,26,10,16,13,13,0,0,0,0,0,26,10,16,13,13,19,8.89770045633076,11.8064454635222,0.343392646766222,2020-02-24,2020,2
"1246","CE",2,"Nordeste",23012,"Canindé",134114,7315.1327163458,9,27,11,16,10,17,0,0,0,0,0,27,11,16,10,17,19,8.89770045633076,11.8064454635222,0.338090386096247,2020-03-02,2020,3
"1247","CE",2,"Nordeste",23012,"Canindé",134114,7315.1327163458,10,28,11,17,10,18,0,0,0,0,0,28,11,17,10,18,23,8.89770045633076,11.8064454635222,0.355416338099911,2020-03-09,2020,3
"1248","CE",2,"Nordeste",23012,"Canindé",134114,7315.1327163458,11,25,9,16,13,12,0,0,0,0,0,25,9,16,13,12,18,8.89770045633076,11.8064454635222,0.426562416227904,2020-03-16,2020,3
"1249","CE",2,"Nordeste",23012,"Canindé",134114,7315.1327163458,12,29,11,18,16,13,0,0,0,0,0,29,11,18,16,13,25,8.89770045633076,11.8064454635222,0.509522874544333,2020-03-23,2020,3
"1250","CE",2,"Nordeste",23012,"Canindé",134114,7315.1327163458,13,18,9,9,10,8,0,0,0,0,0,18,9,9,10,8,20,8.89770045633076,11.8064454635222,0.477497761655307,2020-03-30,2020,3
"1251","CE",2,"Nordeste",23012,"Canindé",134114,7315.1327163458,14,26,13,13,12,14,0,0,0,0,0,26,13,13,12,14,13,8.89770045633076,11.8064454635222,0.455599265553301,2020-04-06,2020,4
"1252","CE",2,"Nordeste",23012,"Canindé",134114,7315.1327163458,15,39,13,26,19,20,0,0,0,0,0,39,13,26,19,20,17,8.89770045633076,11.8064454635222,0.44073421944552,2020-04-13,2020,4
"1253","CE",2,"Nordeste",23012,"Canindé",134114,7315.1327163458,16,28,9,19,18,10,1,0,1,0,1,29,9,20,18,11,22,8.89770045633076,11.8064454635222,0.424988686874602,2020-04-20,2020,4
"1254","CE",2,"Nordeste",23012,"Canindé",134114,7315.1327163458,17,33,8,25,17,16,0,0,0,0,0,33,8,25,17,16,20,8.89770045633076,11.8064454635222,0.417773782231793,2020-04-27,2020,4
"1255","CE",2,"Nordeste",23012,"Canindé",134114,7315.1327163458,18,34,13,21,15,19,0,0,0,0,0,34,13,21,15,19,17,8.89770045633076,11.8064454635222,0.443772439173265,2020-05-04,2020,5
"1256","CE",2,"Nordeste",23012,"Canindé",134114,7315.1327163458,19,23,10,13,10,13,0,0,0,0,0,23,10,13,10,13,27,8.89770045633076,11.8064454635222,0.477361043771036,2020-05-11,2020,5
"1257","CE",2,"Nordeste",23012,"Canindé",134114,7315.1327163458,20,30,9,21,6,24,0,0,0,0,0,30,9,21,6,24,25,8.89770045633076,11.8064454635222,0.480832947694141,2020-05-18,2020,5
"1258","CE",2,"Nordeste",23012,"Canindé",134114,7315.1327163458,21,21,6,15,11,10,0,0,0,0,0,21,6,15,11,10,30,8.89770045633076,11.8064454635222,0.463583797994027,2020-05-25,2020,5
"1259","CE",2,"Nordeste",23013,"Baturité",198566,9842.68935421976,5,39,17,22,13,26,1,1,0,1,0,40,18,22,14,26,25,9.19448426106004,12.1988768175484,0.285984474464153,2020-02-03,2020,2
"1260","CE",2,"Nordeste",23013,"Baturité",198566,9842.68935421976,6,40,16,24,16,24,1,0,1,0,1,41,16,25,16,25,28,9.19448426106004,12.1988768175484,0.290286996985089,2020-02-10,2020,2
"1261","CE",2,"Nordeste",23013,"Baturité",198566,9842.68935421976,7,53,16,37,19,34,0,0,0,0,0,53,16,37,19,34,23,9.19448426106004,12.1988768175484,0.303167614306283,2020-02-17,2020,2
"1262","CE",2,"Nordeste",23013,"Baturité",198566,9842.68935421976,8,40,14,26,12,28,0,0,0,0,0,40,14,26,12,28,28,9.19448426106004,12.1988768175484,0.345263044360705,2020-02-24,2020,2
"1263","CE",2,"Nordeste",23013,"Baturité",198566,9842.68935421976,9,37,7,30,12,25,1,0,1,0,1,38,7,31,12,26,33,9.19448426106004,12.1988768175484,0.320207780109076,2020-03-02,2020,3
"1264","CE",2,"Nordeste",23013,"Baturité",198566,9842.68935421976,10,26,9,17,14,12,2,2,0,0,2,28,11,17,14,14,25,9.19448426106004,12.1988768175484,0.347134688229674,2020-03-09,2020,3
"1265","CE",2,"Nordeste",23013,"Baturité",198566,9842.68935421976,11,21,6,15,12,9,0,0,0,0,0,21,6,15,12,9,34,9.19448426106004,12.1988768175484,0.444561068352961,2020-03-16,2020,3
"1266","CE",2,"Nordeste",23013,"Baturité",198566,9842.68935421976,12,29,7,22,9,20,0,0,0,0,0,29,7,22,9,20,40,9.19448426106004,12.1988768175484,0.5347540861671,2020-03-23,2020,3
"1267","CE",2,"Nordeste",23013,"Baturité",198566,9842.68935421976,13,44,10,34,19,25,1,1,0,0,1,45,11,34,19,26,26,9.19448426106004,12.1988768175484,0.479534962215212,2020-03-30,2020,3
"1268","CE",2,"Nordeste",23013,"Baturité",198566,9842.68935421976,14,35,17,18,15,20,0,0,0,0,0,35,17,18,15,20,22,9.19448426106004,12.1988768175484,0.475248615951988,2020-04-06,2020,4
"1269","CE",2,"Nordeste",23013,"Baturité",198566,9842.68935421976,15,35,13,22,18,17,0,0,0,0,0,35,13,22,18,17,23,9.19448426106004,12.1988768175484,0.461203634127989,2020-04-13,2020,4
"1270","CE",2,"Nordeste",23013,"Baturité",198566,9842.68935421976,16,39,10,29,16,23,2,1,1,1,1,41,11,30,17,24,29,9.19448426106004,12.1988768175484,0.466480081540163,2020-04-20,2020,4
"1271","CE",2,"Nordeste",23013,"Baturité",198566,9842.68935421976,17,37,14,23,16,21,0,0,0,0,0,37,14,23,16,21,34,9.19448426106004,12.1988768175484,0.449112541264222,2020-04-27,2020,4
"1272","CE",2,"Nordeste",23013,"Baturité",198566,9842.68935421976,18,40,14,26,19,21,0,0,0,0,0,40,14,26,19,21,45,9.19448426106004,12.1988768175484,0.486860476387818,2020-05-04,2020,5
"1273","CE",2,"Nordeste",23013,"Baturité",198566,9842.68935421976,19,49,14,35,19,30,0,0,0,0,0,49,14,35,19,30,39,9.19448426106004,12.1988768175484,0.521520584906053,2020-05-11,2020,5
"1274","CE",2,"Nordeste",23013,"Baturité",198566,9842.68935421976,20,43,17,26,17,26,1,1,0,1,0,44,18,26,18,26,45,9.19448426106004,12.1988768175484,0.510400620209615,2020-05-18,2020,5
"1275","CE",2,"Nordeste",23013,"Baturité",198566,9842.68935421976,21,42,16,26,17,25,1,0,1,0,1,43,16,27,17,26,53,9.19448426106004,12.1988768175484,0.47685732853656,2020-05-25,2020,5
"1276","CE",2,"Nordeste",23014,"Chorozinho",68680,10273.1157574257,5,13,6,7,6,7,0,0,0,0,0,13,6,7,6,7,6,9.2372856412756,11.1372133150114,0.277788337012961,2020-02-03,2020,2
"1277","CE",2,"Nordeste",23014,"Chorozinho",68680,10273.1157574257,6,7,3,4,3,4,0,0,0,0,0,7,3,4,3,4,11,9.2372856412756,11.1372133150114,0.27561463154635,2020-02-10,2020,2
"1278","CE",2,"Nordeste",23014,"Chorozinho",68680,10273.1157574257,7,11,6,5,5,6,0,0,0,0,0,11,6,5,5,6,8,9.2372856412756,11.1372133150114,0.295509997693459,2020-02-17,2020,2
"1279","CE",2,"Nordeste",23014,"Chorozinho",68680,10273.1157574257,8,13,7,6,7,6,0,0,0,0,0,13,7,6,7,6,10,9.2372856412756,11.1372133150114,0.351453452297225,2020-02-24,2020,2
"1280","CE",2,"Nordeste",23014,"Chorozinho",68680,10273.1157574257,9,11,6,5,6,5,0,0,0,0,0,11,6,5,6,5,13,9.2372856412756,11.1372133150114,0.323535442350361,2020-03-02,2020,3
"1281","CE",2,"Nordeste",23014,"Chorozinho",68680,10273.1157574257,10,16,8,8,8,8,0,0,0,0,0,16,8,8,8,8,11,9.2372856412756,11.1372133150114,0.358800441902167,2020-03-09,2020,3
"1282","CE",2,"Nordeste",23014,"Chorozinho",68680,10273.1157574257,11,16,7,9,8,8,0,0,0,0,0,16,7,9,8,8,8,9.2372856412756,11.1372133150114,0.433531677787709,2020-03-16,2020,3
"1283","CE",2,"Nordeste",23014,"Chorozinho",68680,10273.1157574257,12,23,7,16,9,14,0,0,0,0,0,23,7,16,9,14,7,9.2372856412756,11.1372133150114,0.518807115603866,2020-03-23,2020,3
"1284","CE",2,"Nordeste",23014,"Chorozinho",68680,10273.1157574257,13,5,2,3,2,3,1,0,1,0,1,6,2,4,2,4,18,9.2372856412756,11.1372133150114,0.466609413832451,2020-03-30,2020,3
"1285","CE",2,"Nordeste",23014,"Chorozinho",68680,10273.1157574257,14,12,7,5,6,6,0,0,0,0,0,12,7,5,6,6,12,9.2372856412756,11.1372133150114,0.462656765982937,2020-04-06,2020,4
"1286","CE",2,"Nordeste",23014,"Chorozinho",68680,10273.1157574257,15,9,1,8,2,7,0,0,0,0,0,9,1,8,2,7,12,9.2372856412756,11.1372133150114,0.4576985822632,2020-04-13,2020,4
"1287","CE",2,"Nordeste",23014,"Chorozinho",68680,10273.1157574257,16,12,4,8,4,8,1,0,1,0,1,13,4,9,4,9,8,9.2372856412756,11.1372133150114,0.459981437739466,2020-04-20,2020,4
"1288","CE",2,"Nordeste",23014,"Chorozinho",68680,10273.1157574257,17,13,3,10,4,9,0,0,0,0,0,13,3,10,4,9,19,9.2372856412756,11.1372133150114,0.440380950754276,2020-04-27,2020,4
"1289","CE",2,"Nordeste",23014,"Chorozinho",68680,10273.1157574257,18,14,5,9,5,9,0,0,0,0,0,14,5,9,5,9,17,9.2372856412756,11.1372133150114,0.481935738308784,2020-05-04,2020,5
"1290","CE",2,"Nordeste",23014,"Chorozinho",68680,10273.1157574257,19,10,2,8,6,4,0,0,0,0,0,10,2,8,6,4,18,9.2372856412756,11.1372133150114,0.514595007129345,2020-05-11,2020,5
"1291","CE",2,"Nordeste",23014,"Chorozinho",68680,10273.1157574257,20,16,6,10,7,9,0,0,0,0,0,16,6,10,7,9,27,9.2372856412756,11.1372133150114,0.480221803804729,2020-05-18,2020,5
"1292","CE",2,"Nordeste",23014,"Chorozinho",68680,10273.1157574257,21,21,4,17,9,12,0,0,0,0,0,21,4,17,9,12,16,9.2372856412756,11.1372133150114,0.463714364167693,2020-05-25,2020,5
"1293","CE",2,"Nordeste",23015,"Cascavel",146950,11777.7388182375,5,30,9,21,16,14,0,0,0,0,0,30,9,21,16,14,26,9.37396648786702,11.8978476718471,0.278357715757232,2020-02-03,2020,2
"1294","CE",2,"Nordeste",23015,"Cascavel",146950,11777.7388182375,6,19,9,10,7,12,0,0,0,0,0,19,9,10,7,12,15,9.37396648786702,11.8978476718471,0.27966708181962,2020-02-10,2020,2
"1295","CE",2,"Nordeste",23015,"Cascavel",146950,11777.7388182375,7,26,11,15,12,14,0,0,0,0,0,26,11,15,12,14,12,9.37396648786702,11.8978476718471,0.294011528432434,2020-02-17,2020,2
"1296","CE",2,"Nordeste",23015,"Cascavel",146950,11777.7388182375,8,31,13,18,14,17,0,0,0,0,0,31,13,18,14,17,30,9.37396648786702,11.8978476718471,0.34601828248255,2020-02-24,2020,2
"1297","CE",2,"Nordeste",23015,"Cascavel",146950,11777.7388182375,9,24,8,16,8,16,0,0,0,0,0,24,8,16,8,16,25,9.37396648786702,11.8978476718471,0.31583760003843,2020-03-02,2020,3
"1298","CE",2,"Nordeste",23015,"Cascavel",146950,11777.7388182375,10,17,5,12,9,8,0,0,0,0,0,17,5,12,9,8,18,9.37396648786702,11.8978476718471,0.342640391204108,2020-03-09,2020,3
"1299","CE",2,"Nordeste",23015,"Cascavel",146950,11777.7388182375,11,17,6,11,8,9,1,0,1,1,0,18,6,12,9,9,18,9.37396648786702,11.8978476718471,0.424445395399863,2020-03-16,2020,3
"1300","CE",2,"Nordeste",23015,"Cascavel",146950,11777.7388182375,12,21,6,15,10,11,0,0,0,0,0,21,6,15,10,11,19,9.37396648786702,11.8978476718471,0.526149142060664,2020-03-23,2020,3
"1301","CE",2,"Nordeste",23015,"Cascavel",146950,11777.7388182375,13,28,11,17,13,15,0,0,0,0,0,28,11,17,13,15,18,9.37396648786702,11.8978476718471,0.477253631380911,2020-03-30,2020,3
"1302","CE",2,"Nordeste",23015,"Cascavel",146950,11777.7388182375,14,26,11,15,13,13,2,2,0,0,2,28,13,15,13,15,23,9.37396648786702,11.8978476718471,0.467206852706715,2020-04-06,2020,4
"1303","CE",2,"Nordeste",23015,"Cascavel",146950,11777.7388182375,15,22,8,14,10,12,0,0,0,0,0,22,8,14,10,12,11,9.37396648786702,11.8978476718471,0.457698104035637,2020-04-13,2020,4
"1304","CE",2,"Nordeste",23015,"Cascavel",146950,11777.7388182375,16,24,9,15,12,12,0,0,0,0,0,24,9,15,12,12,37,9.37396648786702,11.8978476718471,0.444606013097151,2020-04-20,2020,4
"1305","CE",2,"Nordeste",23015,"Cascavel",146950,11777.7388182375,17,36,9,27,20,16,1,0,1,0,1,37,9,28,20,17,25,9.37396648786702,11.8978476718471,0.436426061616555,2020-04-27,2020,4
"1306","CE",2,"Nordeste",23015,"Cascavel",146950,11777.7388182375,18,27,9,18,11,16,0,0,0,0,0,27,9,18,11,16,48,9.37396648786702,11.8978476718471,0.472573200644573,2020-05-04,2020,5
"1307","CE",2,"Nordeste",23015,"Cascavel",146950,11777.7388182375,19,18,1,17,5,13,0,0,0,0,0,18,1,17,5,13,43,9.37396648786702,11.8978476718471,0.516420053401076,2020-05-11,2020,5
"1308","CE",2,"Nordeste",23015,"Cascavel",146950,11777.7388182375,20,32,8,24,13,19,0,0,0,0,0,32,8,24,13,19,55,9.37396648786702,11.8978476718471,0.469622002348716,2020-05-18,2020,5
"1309","CE",2,"Nordeste",23015,"Cascavel",146950,11777.7388182375,21,41,11,30,18,23,1,0,1,0,1,42,11,31,18,24,42,9.37396648786702,11.8978476718471,0.451432043444722,2020-05-25,2020,5
"1310","CE",2,"Nordeste",23016,"Fortaleza",3696069,24883.3681333682,5,778,187,591,273,505,15,6,9,8,7,793,193,600,281,512,404,10.1219549128261,15.1227803804006,0.286984833489945,2020-02-03,2020,2
"1311","CE",2,"Nordeste",23016,"Fortaleza",3696069,24883.3681333682,6,735,161,574,266,469,7,3,4,4,3,742,164,578,270,472,448,10.1219549128261,15.1227803804006,0.285053303870689,2020-02-10,2020,2
"1312","CE",2,"Nordeste",23016,"Fortaleza",3696069,24883.3681333682,7,774,193,581,258,516,3,3,0,1,2,777,196,581,259,518,486,10.1219549128261,15.1227803804006,0.312078590396152,2020-02-17,2020,2
"1313","CE",2,"Nordeste",23016,"Fortaleza",3696069,24883.3681333682,8,781,191,590,280,501,4,1,3,1,3,785,192,593,281,504,517,10.1219549128261,15.1227803804006,0.373850463748565,2020-02-24,2020,2
"1314","CE",2,"Nordeste",23016,"Fortaleza",3696069,24883.3681333682,9,754,192,562,271,483,8,2,6,1,7,762,194,568,272,490,418,10.1219549128261,15.1227803804006,0.333472514364931,2020-03-02,2020,3
"1315","CE",2,"Nordeste",23016,"Fortaleza",3696069,24883.3681333682,10,722,156,566,271,451,6,0,6,3,3,728,156,572,274,454,485,10.1219549128261,15.1227803804006,0.353766599285767,2020-03-09,2020,3
"1316","CE",2,"Nordeste",23016,"Fortaleza",3696069,24883.3681333682,11,720,160,560,282,438,4,2,2,3,1,724,162,562,285,439,518,10.1219549128261,15.1227803804006,0.461552986606687,2020-03-16,2020,3
"1317","CE",2,"Nordeste",23016,"Fortaleza",3696069,24883.3681333682,12,729,189,540,279,450,5,2,3,1,4,734,191,543,280,454,510,10.1219549128261,15.1227803804006,0.58175229124528,2020-03-23,2020,3
"1318","CE",2,"Nordeste",23016,"Fortaleza",3696069,24883.3681333682,13,665,151,514,238,427,5,2,3,2,3,670,153,517,240,430,505,10.1219549128261,15.1227803804006,0.529990181856985,2020-03-30,2020,3
"1319","CE",2,"Nordeste",23016,"Fortaleza",3696069,24883.3681333682,14,656,160,496,222,434,9,1,8,4,5,665,161,504,226,439,601,10.1219549128261,15.1227803804006,0.522319972532655,2020-04-06,2020,4
"1320","CE",2,"Nordeste",23016,"Fortaleza",3696069,24883.3681333682,15,708,159,549,233,475,9,4,5,4,5,717,163,554,237,480,613,10.1219549128261,15.1227803804006,0.507210425605356,2020-04-13,2020,4
"1321","CE",2,"Nordeste",23016,"Fortaleza",3696069,24883.3681333682,16,659,175,484,240,419,8,5,3,4,4,667,180,487,244,423,809,10.1219549128261,15.1227803804006,0.517319582112685,2020-04-20,2020,4
"1322","CE",2,"Nordeste",23016,"Fortaleza",3696069,24883.3681333682,17,664,172,492,264,400,9,3,6,3,6,673,175,498,267,406,1207,10.1219549128261,15.1227803804006,0.497336318997784,2020-04-27,2020,4
"1323","CE",2,"Nordeste",23016,"Fortaleza",3696069,24883.3681333682,18,739,160,579,268,471,7,4,3,3,4,746,164,582,271,475,1575,10.1219549128261,15.1227803804006,0.511649113350681,2020-05-04,2020,5
"1324","CE",2,"Nordeste",23016,"Fortaleza",3696069,24883.3681333682,19,734,173,561,274,460,6,4,2,2,4,740,177,563,276,464,1567,10.1219549128261,15.1227803804006,0.53623898420847,2020-05-11,2020,5
"1325","CE",2,"Nordeste",23016,"Fortaleza",3696069,24883.3681333682,20,798,196,602,313,485,8,3,5,0,8,806,199,607,313,493,1314,10.1219549128261,15.1227803804006,0.506104766886502,2020-05-18,2020,5
"1326","CE",2,"Nordeste",23016,"Fortaleza",3696069,24883.3681333682,21,837,217,620,309,528,6,3,3,4,2,843,220,623,313,530,944,10.1219549128261,15.1227803804006,0.488014823761842,2020-05-25,2020,5
"1327","CE",2,"Nordeste",23017,"Pacajus",141717,20754.7362202841,5,31,8,23,10,21,0,0,0,0,0,31,8,23,10,21,13,9.94052975119337,11.8615873902541,0.28153534281285,2020-02-03,2020,2
"1328","CE",2,"Nordeste",23017,"Pacajus",141717,20754.7362202841,6,34,11,23,14,20,0,0,0,0,0,34,11,23,14,20,21,9.94052975119337,11.8615873902541,0.280196047355824,2020-02-10,2020,2
"1329","CE",2,"Nordeste",23017,"Pacajus",141717,20754.7362202841,7,34,9,25,20,14,0,0,0,0,0,34,9,25,20,14,18,9.94052975119337,11.8615873902541,0.304013449153459,2020-02-17,2020,2
"1330","CE",2,"Nordeste",23017,"Pacajus",141717,20754.7362202841,8,23,10,13,12,11,1,0,1,0,1,24,10,14,12,12,22,9.94052975119337,11.8615873902541,0.353318378735051,2020-02-24,2020,2
"1331","CE",2,"Nordeste",23017,"Pacajus",141717,20754.7362202841,9,35,7,28,9,26,0,0,0,0,0,35,7,28,9,26,20,9.94052975119337,11.8615873902541,0.334401783883305,2020-03-02,2020,3
"1332","CE",2,"Nordeste",23017,"Pacajus",141717,20754.7362202841,10,33,7,26,13,20,1,0,1,1,0,34,7,27,14,20,18,9.94052975119337,11.8615873902541,0.352461198571921,2020-03-09,2020,3
"1333","CE",2,"Nordeste",23017,"Pacajus",141717,20754.7362202841,11,32,8,24,13,19,1,0,1,0,1,33,8,25,13,20,21,9.94052975119337,11.8615873902541,0.430504088895696,2020-03-16,2020,3
"1334","CE",2,"Nordeste",23017,"Pacajus",141717,20754.7362202841,12,26,6,20,7,19,0,0,0,0,0,26,6,20,7,19,19,9.94052975119337,11.8615873902541,0.545788903074582,2020-03-23,2020,3
"1335","CE",2,"Nordeste",23017,"Pacajus",141717,20754.7362202841,13,20,5,15,7,13,0,0,0,0,0,20,5,15,7,13,22,9.94052975119337,11.8615873902541,0.492371149681372,2020-03-30,2020,3
"1336","CE",2,"Nordeste",23017,"Pacajus",141717,20754.7362202841,14,29,12,17,9,20,0,0,0,0,0,29,12,17,9,20,17,9.94052975119337,11.8615873902541,0.483136105449939,2020-04-06,2020,4
"1337","CE",2,"Nordeste",23017,"Pacajus",141717,20754.7362202841,15,39,8,31,16,23,0,0,0,0,0,39,8,31,16,23,24,9.94052975119337,11.8615873902541,0.470967760866236,2020-04-13,2020,4
"1338","CE",2,"Nordeste",23017,"Pacajus",141717,20754.7362202841,16,37,12,25,16,21,0,0,0,0,0,37,12,25,16,21,18,9.94052975119337,11.8615873902541,0.471907325206716,2020-04-20,2020,4
"1339","CE",2,"Nordeste",23017,"Pacajus",141717,20754.7362202841,17,29,8,21,13,16,0,0,0,0,0,29,8,21,13,16,29,9.94052975119337,11.8615873902541,0.448829276226803,2020-04-27,2020,4
"1340","CE",2,"Nordeste",23017,"Pacajus",141717,20754.7362202841,18,37,15,22,14,23,0,0,0,0,0,37,15,22,14,23,29,9.94052975119337,11.8615873902541,0.475994518695428,2020-05-04,2020,5
"1341","CE",2,"Nordeste",23017,"Pacajus",141717,20754.7362202841,19,26,13,13,10,16,1,0,1,0,1,27,13,14,10,17,36,9.94052975119337,11.8615873902541,0.514398020102845,2020-05-11,2020,5
"1342","CE",2,"Nordeste",23017,"Pacajus",141717,20754.7362202841,20,43,19,24,16,27,0,0,0,0,0,43,19,24,16,27,29,9.94052975119337,11.8615873902541,0.48832989257711,2020-05-18,2020,5
"1343","CE",2,"Nordeste",23017,"Pacajus",141717,20754.7362202841,21,28,7,21,9,19,1,0,1,0,1,29,7,22,9,20,27,9.94052975119337,11.8615873902541,0.45929618792981,2020-05-25,2020,5
"1344","CE",2,"Nordeste",23018,"Sertão de Cratéus",249622,8115.62354896604,5,13,5,8,6,7,0,0,0,0,0,13,5,8,6,7,33,9.001546316056,12.4277030526189,0.276274391176957,2020-02-03,2020,2
"1345","CE",2,"Nordeste",23018,"Sertão de Cratéus",249622,8115.62354896604,6,13,4,9,3,10,0,0,0,0,0,13,4,9,3,10,39,9.001546316056,12.4277030526189,0.274265766208647,2020-02-10,2020,2
"1346","CE",2,"Nordeste",23018,"Sertão de Cratéus",249622,8115.62354896604,7,12,5,7,4,8,0,0,0,0,0,12,5,7,4,8,45,9.001546316056,12.4277030526189,0.279705980300535,2020-02-17,2020,2
"1347","CE",2,"Nordeste",23018,"Sertão de Cratéus",249622,8115.62354896604,8,15,5,10,5,10,0,0,0,0,0,15,5,10,5,10,31,9.001546316056,12.4277030526189,0.326047823098076,2020-02-24,2020,2
"1348","CE",2,"Nordeste",23018,"Sertão de Cratéus",249622,8115.62354896604,9,10,6,4,3,7,0,0,0,0,0,10,6,4,3,7,35,9.001546316056,12.4277030526189,0.312382440685725,2020-03-02,2020,3
"1349","CE",2,"Nordeste",23018,"Sertão de Cratéus",249622,8115.62354896604,10,15,4,11,5,10,2,2,0,1,1,17,6,11,6,11,42,9.001546316056,12.4277030526189,0.336502113962019,2020-03-09,2020,3
"1350","CE",2,"Nordeste",23018,"Sertão de Cratéus",249622,8115.62354896604,11,11,4,7,5,6,0,0,0,0,0,11,4,7,5,6,38,9.001546316056,12.4277030526189,0.411747734611184,2020-03-16,2020,3
"1351","CE",2,"Nordeste",23018,"Sertão de Cratéus",249622,8115.62354896604,12,12,6,6,1,11,2,1,1,1,1,14,7,7,2,12,45,9.001546316056,12.4277030526189,0.492263016119933,2020-03-23,2020,3
"1352","CE",2,"Nordeste",23018,"Sertão de Cratéus",249622,8115.62354896604,13,10,4,6,3,7,1,0,1,0,1,11,4,7,3,8,44,9.001546316056,12.4277030526189,0.444444579288644,2020-03-30,2020,3
"1353","CE",2,"Nordeste",23018,"Sertão de Cratéus",249622,8115.62354896604,14,6,2,4,2,4,0,0,0,0,0,6,2,4,2,4,44,9.001546316056,12.4277030526189,0.443918743297237,2020-04-06,2020,4
"1354","CE",2,"Nordeste",23018,"Sertão de Cratéus",249622,8115.62354896604,15,15,5,10,4,11,1,1,0,0,1,16,6,10,4,12,35,9.001546316056,12.4277030526189,0.424055678947284,2020-04-13,2020,4
"1355","CE",2,"Nordeste",23018,"Sertão de Cratéus",249622,8115.62354896604,16,12,6,6,4,8,1,1,0,0,1,13,7,6,4,9,36,9.001546316056,12.4277030526189,0.409288645519587,2020-04-20,2020,4
"1356","CE",2,"Nordeste",23018,"Sertão de Cratéus",249622,8115.62354896604,17,13,3,10,4,9,0,0,0,0,0,13,3,10,4,9,43,9.001546316056,12.4277030526189,0.40201543991011,2020-04-27,2020,4
"1357","CE",2,"Nordeste",23018,"Sertão de Cratéus",249622,8115.62354896604,18,15,4,11,7,8,0,0,0,0,0,15,4,11,7,8,42,9.001546316056,12.4277030526189,0.431362517508888,2020-05-04,2020,5
"1358","CE",2,"Nordeste",23018,"Sertão de Cratéus",249622,8115.62354896604,19,12,8,4,4,8,0,0,0,0,0,12,8,4,4,8,50,9.001546316056,12.4277030526189,0.459632238102261,2020-05-11,2020,5
"1359","CE",2,"Nordeste",23018,"Sertão de Cratéus",249622,8115.62354896604,20,13,5,8,3,10,2,2,0,0,2,15,7,8,3,12,45,9.001546316056,12.4277030526189,0.446512718979328,2020-05-18,2020,5
"1360","CE",2,"Nordeste",23018,"Sertão de Cratéus",249622,8115.62354896604,21,16,7,9,8,8,0,0,0,0,0,16,7,9,8,8,31,9.001546316056,12.4277030526189,0.428947610201899,2020-05-25,2020,5
"1361","CE",2,"Nordeste",23019,"Sertão de Quixeramobim",289730,10352.9883678942,5,41,15,26,15,26,0,0,0,0,0,41,15,26,15,26,34,9.2450304882162,12.5767047337981,0.277614369156874,2020-02-03,2020,2
"1362","CE",2,"Nordeste",23019,"Sertão de Quixeramobim",289730,10352.9883678942,6,40,15,25,14,26,0,0,0,0,0,40,15,25,14,26,27,9.2450304882162,12.5767047337981,0.27541479778206,2020-02-10,2020,2
"1363","CE",2,"Nordeste",23019,"Sertão de Quixeramobim",289730,10352.9883678942,7,47,18,29,15,32,0,0,0,0,0,47,18,29,15,32,26,9.2450304882162,12.5767047337981,0.290884452643158,2020-02-17,2020,2
"1364","CE",2,"Nordeste",23019,"Sertão de Quixeramobim",289730,10352.9883678942,8,33,11,22,13,20,0,0,0,0,0,33,11,22,13,20,47,9.2450304882162,12.5767047337981,0.331383639266749,2020-02-24,2020,2
"1365","CE",2,"Nordeste",23019,"Sertão de Quixeramobim",289730,10352.9883678942,9,46,13,33,22,24,0,0,0,0,0,46,13,33,22,24,35,9.2450304882162,12.5767047337981,0.305342058379652,2020-03-02,2020,3
"1366","CE",2,"Nordeste",23019,"Sertão de Quixeramobim",289730,10352.9883678942,10,38,16,22,12,26,1,0,1,0,1,39,16,23,12,27,40,9.2450304882162,12.5767047337981,0.337784235598179,2020-03-09,2020,3
"1367","CE",2,"Nordeste",23019,"Sertão de Quixeramobim",289730,10352.9883678942,11,26,9,17,8,18,0,0,0,0,0,26,9,17,8,18,41,9.2450304882162,12.5767047337981,0.417005072219135,2020-03-16,2020,3
"1368","CE",2,"Nordeste",23019,"Sertão de Quixeramobim",289730,10352.9883678942,12,27,7,20,12,15,0,0,0,0,0,27,7,20,12,15,38,9.2450304882162,12.5767047337981,0.507800679865093,2020-03-23,2020,3
"1369","CE",2,"Nordeste",23019,"Sertão de Quixeramobim",289730,10352.9883678942,13,31,7,24,11,20,0,0,0,0,0,31,7,24,11,20,37,9.2450304882162,12.5767047337981,0.462574524114648,2020-03-30,2020,3
"1370","CE",2,"Nordeste",23019,"Sertão de Quixeramobim",289730,10352.9883678942,14,37,11,26,13,24,2,0,2,2,0,39,11,28,15,24,41,9.2450304882162,12.5767047337981,0.447167342644364,2020-04-06,2020,4
"1371","CE",2,"Nordeste",23019,"Sertão de Quixeramobim",289730,10352.9883678942,15,30,11,19,12,18,0,0,0,0,0,30,11,19,12,18,38,9.2450304882162,12.5767047337981,0.434287050275372,2020-04-13,2020,4
"1372","CE",2,"Nordeste",23019,"Sertão de Quixeramobim",289730,10352.9883678942,16,34,11,23,17,17,2,0,2,0,2,36,11,25,17,19,56,9.2450304882162,12.5767047337981,0.429267694767686,2020-04-20,2020,4
"1373","CE",2,"Nordeste",23019,"Sertão de Quixeramobim",289730,10352.9883678942,17,40,11,29,21,19,1,0,1,0,1,41,11,30,21,20,43,9.2450304882162,12.5767047337981,0.423568779661381,2020-04-27,2020,4
"1374","CE",2,"Nordeste",23019,"Sertão de Quixeramobim",289730,10352.9883678942,18,34,11,23,18,16,1,1,0,0,1,35,12,23,18,17,35,9.2450304882162,12.5767047337981,0.443696728206915,2020-05-04,2020,5
"1375","CE",2,"Nordeste",23019,"Sertão de Quixeramobim",289730,10352.9883678942,19,33,14,19,14,19,2,2,0,1,1,35,16,19,15,20,59,9.2450304882162,12.5767047337981,0.481568705475472,2020-05-11,2020,5
"1376","CE",2,"Nordeste",23019,"Sertão de Quixeramobim",289730,10352.9883678942,20,31,15,16,14,17,1,0,1,1,0,32,15,17,15,17,51,9.2450304882162,12.5767047337981,0.459802864357251,2020-05-18,2020,5
"1377","CE",2,"Nordeste",23019,"Sertão de Quixeramobim",289730,10352.9883678942,21,37,12,25,12,25,1,0,1,0,1,38,12,26,12,26,45,9.2450304882162,12.5767047337981,0.451335183283983,2020-05-25,2020,5
"1378","CE",2,"Nordeste",23020,"Sertão de Inhamuns",152513,8071.97277759929,5,28,7,21,13,15,1,1,0,1,0,29,8,21,14,15,15,8.9961531895797,11.935005117298,0.264385329495595,2020-02-03,2020,2
"1379","CE",2,"Nordeste",23020,"Sertão de Inhamuns",152513,8071.97277759929,6,37,12,25,14,23,0,0,0,0,0,37,12,25,14,23,14,8.9961531895797,11.935005117298,0.270498404952119,2020-02-10,2020,2
"1380","CE",2,"Nordeste",23020,"Sertão de Inhamuns",152513,8071.97277759929,7,39,8,31,19,20,0,0,0,0,0,39,8,31,19,20,18,8.9961531895797,11.935005117298,0.274405652285002,2020-02-17,2020,2
"1381","CE",2,"Nordeste",23020,"Sertão de Inhamuns",152513,8071.97277759929,8,29,8,21,10,19,0,0,0,0,0,29,8,21,10,19,19,8.9961531895797,11.935005117298,0.300513681068088,2020-02-24,2020,2
"1382","CE",2,"Nordeste",23020,"Sertão de Inhamuns",152513,8071.97277759929,9,33,14,19,9,24,0,0,0,0,0,33,14,19,9,24,17,8.9961531895797,11.935005117298,0.283714578851285,2020-03-02,2020,3
"1383","CE",2,"Nordeste",23020,"Sertão de Inhamuns",152513,8071.97277759929,10,29,12,17,11,18,0,0,0,0,0,29,12,17,11,18,24,8.9961531895797,11.935005117298,0.314483586856506,2020-03-09,2020,3
"1384","CE",2,"Nordeste",23020,"Sertão de Inhamuns",152513,8071.97277759929,11,25,9,16,11,14,1,0,1,1,0,26,9,17,12,14,27,8.9961531895797,11.935005117298,0.369725924265351,2020-03-16,2020,3
"1385","CE",2,"Nordeste",23020,"Sertão de Inhamuns",152513,8071.97277759929,12,33,12,21,21,12,0,0,0,0,0,33,12,21,21,12,21,8.9961531895797,11.935005117298,0.455578767279737,2020-03-23,2020,3
"1386","CE",2,"Nordeste",23020,"Sertão de Inhamuns",152513,8071.97277759929,13,29,10,19,10,19,0,0,0,0,0,29,10,19,10,19,19,8.9961531895797,11.935005117298,0.410295574724533,2020-03-30,2020,3
"1387","CE",2,"Nordeste",23020,"Sertão de Inhamuns",152513,8071.97277759929,14,38,15,23,13,25,0,0,0,0,0,38,15,23,13,25,23,8.9961531895797,11.935005117298,0.407065787566846,2020-04-06,2020,4
"1388","CE",2,"Nordeste",23020,"Sertão de Inhamuns",152513,8071.97277759929,15,27,5,22,11,16,1,0,1,1,0,28,5,23,12,16,22,8.9961531895797,11.935005117298,0.383241681838425,2020-04-13,2020,4
"1389","CE",2,"Nordeste",23020,"Sertão de Inhamuns",152513,8071.97277759929,16,34,12,22,14,20,0,0,0,0,0,34,12,22,14,20,21,8.9961531895797,11.935005117298,0.382633358957236,2020-04-20,2020,4
"1390","CE",2,"Nordeste",23020,"Sertão de Inhamuns",152513,8071.97277759929,17,33,11,22,16,17,0,0,0,0,0,33,11,22,16,17,22,8.9961531895797,11.935005117298,0.381974676020452,2020-04-27,2020,4
"1391","CE",2,"Nordeste",23020,"Sertão de Inhamuns",152513,8071.97277759929,18,29,15,14,11,18,0,0,0,0,0,29,15,14,11,18,15,8.9961531895797,11.935005117298,0.40555780877718,2020-05-04,2020,5
"1392","CE",2,"Nordeste",23020,"Sertão de Inhamuns",152513,8071.97277759929,19,32,10,22,12,20,2,2,0,0,2,34,12,22,12,22,23,8.9961531895797,11.935005117298,0.430388229068305,2020-05-11,2020,5
"1393","CE",2,"Nordeste",23020,"Sertão de Inhamuns",152513,8071.97277759929,20,26,6,20,9,17,1,0,1,0,1,27,6,21,9,18,17,8.9961531895797,11.935005117298,0.418007037746223,2020-05-18,2020,5
"1394","CE",2,"Nordeste",23020,"Sertão de Inhamuns",152513,8071.97277759929,21,37,8,29,20,17,0,0,0,0,0,37,8,29,20,17,31,8.9961531895797,11.935005117298,0.410417353183698,2020-05-25,2020,5
"1395","CE",2,"Nordeste",23021,"Sertão de Senador Pompeu",225351,7966.90005573528,5,41,16,25,18,23,0,0,0,0,0,41,16,25,18,23,24,8.98305074452137,12.3254144656505,0.262634918639703,2020-02-03,2020,2
"1396","CE",2,"Nordeste",23021,"Sertão de Senador Pompeu",225351,7966.90005573528,6,35,14,21,12,23,0,0,0,0,0,35,14,21,12,23,27,8.98305074452137,12.3254144656505,0.260807471455655,2020-02-10,2020,2
"1397","CE",2,"Nordeste",23021,"Sertão de Senador Pompeu",225351,7966.90005573528,7,23,9,14,10,13,2,1,1,1,1,25,10,15,11,14,26,8.98305074452137,12.3254144656505,0.270097829628647,2020-02-17,2020,2
"1398","CE",2,"Nordeste",23021,"Sertão de Senador Pompeu",225351,7966.90005573528,8,27,9,18,16,11,1,1,0,0,1,28,10,18,16,12,23,8.98305074452137,12.3254144656505,0.312453811508691,2020-02-24,2020,2
"1399","CE",2,"Nordeste",23021,"Sertão de Senador Pompeu",225351,7966.90005573528,9,31,10,21,16,15,0,0,0,0,0,31,10,21,16,15,30,8.98305074452137,12.3254144656505,0.296275958653917,2020-03-02,2020,3
"1400","CE",2,"Nordeste",23021,"Sertão de Senador Pompeu",225351,7966.90005573528,10,21,8,13,10,11,0,0,0,0,0,21,8,13,10,11,44,8.98305074452137,12.3254144656505,0.32226959957785,2020-03-09,2020,3
"1401","CE",2,"Nordeste",23021,"Sertão de Senador Pompeu",225351,7966.90005573528,11,34,10,24,14,20,0,0,0,0,0,34,10,24,14,20,31,8.98305074452137,12.3254144656505,0.397984653966925,2020-03-16,2020,3
"1402","CE",2,"Nordeste",23021,"Sertão de Senador Pompeu",225351,7966.90005573528,12,27,9,18,13,14,2,1,1,1,1,29,10,19,14,15,30,8.98305074452137,12.3254144656505,0.481676927809595,2020-03-23,2020,3
"1403","CE",2,"Nordeste",23021,"Sertão de Senador Pompeu",225351,7966.90005573528,13,17,5,12,6,11,0,0,0,0,0,17,5,12,6,11,40,8.98305074452137,12.3254144656505,0.42636354655826,2020-03-30,2020,3
"1404","CE",2,"Nordeste",23021,"Sertão de Senador Pompeu",225351,7966.90005573528,14,32,16,16,8,24,0,0,0,0,0,32,16,16,8,24,38,8.98305074452137,12.3254144656505,0.434791432533464,2020-04-06,2020,4
"1405","CE",2,"Nordeste",23021,"Sertão de Senador Pompeu",225351,7966.90005573528,15,27,12,15,13,14,2,1,1,0,2,29,13,16,13,16,27,8.98305074452137,12.3254144656505,0.419275360395041,2020-04-13,2020,4
"1406","CE",2,"Nordeste",23021,"Sertão de Senador Pompeu",225351,7966.90005573528,16,33,8,25,12,21,0,0,0,0,0,33,8,25,12,21,38,8.98305074452137,12.3254144656505,0.409045412931796,2020-04-20,2020,4
"1407","CE",2,"Nordeste",23021,"Sertão de Senador Pompeu",225351,7966.90005573528,17,42,14,28,22,20,1,0,1,0,1,43,14,29,22,21,31,8.98305074452137,12.3254144656505,0.400680544140124,2020-04-27,2020,4
"1408","CE",2,"Nordeste",23021,"Sertão de Senador Pompeu",225351,7966.90005573528,18,35,7,28,16,19,1,1,0,0,1,36,8,28,16,20,31,8.98305074452137,12.3254144656505,0.418804030933747,2020-05-04,2020,5
"1409","CE",2,"Nordeste",23021,"Sertão de Senador Pompeu",225351,7966.90005573528,19,35,12,23,15,20,1,0,1,1,0,36,12,24,16,20,37,8.98305074452137,12.3254144656505,0.450188734453526,2020-05-11,2020,5
"1410","CE",2,"Nordeste",23021,"Sertão de Senador Pompeu",225351,7966.90005573528,20,41,17,24,20,21,0,0,0,0,0,41,17,24,20,21,32,8.98305074452137,12.3254144656505,0.428524706004864,2020-05-18,2020,5
"1411","CE",2,"Nordeste",23021,"Sertão de Senador Pompeu",225351,7966.90005573528,21,43,19,24,12,31,1,0,1,0,1,44,19,25,12,32,37,8.98305074452137,12.3254144656505,0.422764720889883,2020-05-25,2020,5
"1412","CE",2,"Nordeste",23022,"Litoral de Aracati",119532,14310.8845137704,5,26,9,17,15,11,0,0,0,0,0,26,9,17,15,11,11,9.5687756815257,11.6913393969332,0.273490357387546,2020-02-03,2020,2
"1413","CE",2,"Nordeste",23022,"Litoral de Aracati",119532,14310.8845137704,6,30,4,26,13,17,1,0,1,1,0,31,4,27,14,17,15,9.5687756815257,11.6913393969332,0.277642164690024,2020-02-10,2020,2
"1414","CE",2,"Nordeste",23022,"Litoral de Aracati",119532,14310.8845137704,7,20,8,12,7,13,0,0,0,0,0,20,8,12,7,13,19,9.5687756815257,11.6913393969332,0.292103594349455,2020-02-17,2020,2
"1415","CE",2,"Nordeste",23022,"Litoral de Aracati",119532,14310.8845137704,8,28,5,23,12,16,0,0,0,0,0,28,5,23,12,16,9,9.5687756815257,11.6913393969332,0.344332309360146,2020-02-24,2020,2
"1416","CE",2,"Nordeste",23022,"Litoral de Aracati",119532,14310.8845137704,9,30,6,24,13,17,1,0,1,1,0,31,6,25,14,17,9,9.5687756815257,11.6913393969332,0.323125943883201,2020-03-02,2020,3
"1417","CE",2,"Nordeste",23022,"Litoral de Aracati",119532,14310.8845137704,10,17,2,15,7,10,0,0,0,0,0,17,2,15,7,10,19,9.5687756815257,11.6913393969332,0.347655309744028,2020-03-09,2020,3
"1418","CE",2,"Nordeste",23022,"Litoral de Aracati",119532,14310.8845137704,11,33,8,25,13,20,0,0,0,0,0,33,8,25,13,20,25,9.5687756815257,11.6913393969332,0.435580161865565,2020-03-16,2020,3
"1419","CE",2,"Nordeste",23022,"Litoral de Aracati",119532,14310.8845137704,12,26,8,18,12,14,0,0,0,0,0,26,8,18,12,14,14,9.5687756815257,11.6913393969332,0.542623615689148,2020-03-23,2020,3
"1420","CE",2,"Nordeste",23022,"Litoral de Aracati",119532,14310.8845137704,13,21,6,15,10,11,0,0,0,0,0,21,6,15,10,11,7,9.5687756815257,11.6913393969332,0.487091338510857,2020-03-30,2020,3
"1421","CE",2,"Nordeste",23022,"Litoral de Aracati",119532,14310.8845137704,14,12,2,10,3,9,0,0,0,0,0,12,2,10,3,9,11,9.5687756815257,11.6913393969332,0.472880521723678,2020-04-06,2020,4
"1422","CE",2,"Nordeste",23022,"Litoral de Aracati",119532,14310.8845137704,15,35,13,22,9,26,0,0,0,0,0,35,13,22,9,26,17,9.5687756815257,11.6913393969332,0.441612474126178,2020-04-13,2020,4
"1423","CE",2,"Nordeste",23022,"Litoral de Aracati",119532,14310.8845137704,16,17,8,9,9,8,0,0,0,0,0,17,8,9,9,8,15,9.5687756815257,11.6913393969332,0.443188283409783,2020-04-20,2020,4
"1424","CE",2,"Nordeste",23022,"Litoral de Aracati",119532,14310.8845137704,17,28,7,21,14,14,0,0,0,0,0,28,7,21,14,14,17,9.5687756815257,11.6913393969332,0.423037742606626,2020-04-27,2020,4
"1425","CE",2,"Nordeste",23022,"Litoral de Aracati",119532,14310.8845137704,18,21,5,16,7,14,0,0,0,0,0,21,5,16,7,14,17,9.5687756815257,11.6913393969332,0.452056230643413,2020-05-04,2020,5
"1426","CE",2,"Nordeste",23022,"Litoral de Aracati",119532,14310.8845137704,19,27,10,17,12,15,0,0,0,0,0,27,10,17,12,15,21,9.5687756815257,11.6913393969332,0.487378994938229,2020-05-11,2020,5
"1427","CE",2,"Nordeste",23022,"Litoral de Aracati",119532,14310.8845137704,20,10,4,6,6,4,0,0,0,0,0,10,4,6,6,4,24,9.5687756815257,11.6913393969332,0.473490850898076,2020-05-18,2020,5
"1428","CE",2,"Nordeste",23022,"Litoral de Aracati",119532,14310.8845137704,21,15,5,10,3,12,0,0,0,0,0,15,5,10,3,12,25,9.5687756815257,11.6913393969332,0.457092463911494,2020-05-25,2020,5
"1429","CE",2,"Nordeste",23023,"Baixo Jaguaribe",334292,13715.9173785792,5,62,24,38,20,42,0,0,0,0,0,62,24,38,20,42,40,9.52631228983903,12.7197701415206,0.277784259861251,2020-02-03,2020,2
"1430","CE",2,"Nordeste",23023,"Baixo Jaguaribe",334292,13715.9173785792,6,72,15,57,22,50,1,0,1,0,1,73,15,58,22,51,38,9.52631228983903,12.7197701415206,0.279381263263937,2020-02-10,2020,2
"1431","CE",2,"Nordeste",23023,"Baixo Jaguaribe",334292,13715.9173785792,7,59,23,36,23,36,0,0,0,0,0,59,23,36,23,36,30,9.52631228983903,12.7197701415206,0.295943796947969,2020-02-17,2020,2
"1432","CE",2,"Nordeste",23023,"Baixo Jaguaribe",334292,13715.9173785792,8,56,15,41,20,36,2,2,0,0,2,58,17,41,20,38,51,9.52631228983903,12.7197701415206,0.334248496905872,2020-02-24,2020,2
"1433","CE",2,"Nordeste",23023,"Baixo Jaguaribe",334292,13715.9173785792,9,69,22,47,30,39,0,0,0,0,0,69,22,47,30,39,38,9.52631228983903,12.7197701415206,0.321448304169641,2020-03-02,2020,3
"1434","CE",2,"Nordeste",23023,"Baixo Jaguaribe",334292,13715.9173785792,10,81,19,62,31,50,0,0,0,0,0,81,19,62,31,50,45,9.52631228983903,12.7197701415206,0.346652135708622,2020-03-09,2020,3
"1435","CE",2,"Nordeste",23023,"Baixo Jaguaribe",334292,13715.9173785792,11,59,15,44,24,35,0,0,0,0,0,59,15,44,24,35,42,9.52631228983903,12.7197701415206,0.412687999741571,2020-03-16,2020,3
"1436","CE",2,"Nordeste",23023,"Baixo Jaguaribe",334292,13715.9173785792,12,53,21,32,24,29,1,0,1,0,1,54,21,33,24,30,46,9.52631228983903,12.7197701415206,0.509625031307176,2020-03-23,2020,3
"1437","CE",2,"Nordeste",23023,"Baixo Jaguaribe",334292,13715.9173785792,13,41,12,29,17,24,2,0,2,2,0,43,12,31,19,24,51,9.52631228983903,12.7197701415206,0.460594823783735,2020-03-30,2020,3
"1438","CE",2,"Nordeste",23023,"Baixo Jaguaribe",334292,13715.9173785792,14,59,15,44,20,39,0,0,0,0,0,59,15,44,20,39,60,9.52631228983903,12.7197701415206,0.446772776387773,2020-04-06,2020,4
"1439","CE",2,"Nordeste",23023,"Baixo Jaguaribe",334292,13715.9173785792,15,61,16,45,18,43,0,0,0,0,0,61,16,45,18,43,45,9.52631228983903,12.7197701415206,0.422389479298133,2020-04-13,2020,4
"1440","CE",2,"Nordeste",23023,"Baixo Jaguaribe",334292,13715.9173785792,16,54,15,39,21,33,1,0,1,0,1,55,15,40,21,34,55,9.52631228983903,12.7197701415206,0.417102854248644,2020-04-20,2020,4
"1441","CE",2,"Nordeste",23023,"Baixo Jaguaribe",334292,13715.9173785792,17,57,24,33,25,32,2,1,1,0,2,59,25,34,25,34,55,9.52631228983903,12.7197701415206,0.402783038953193,2020-04-27,2020,4
"1442","CE",2,"Nordeste",23023,"Baixo Jaguaribe",334292,13715.9173785792,18,60,19,41,24,36,0,0,0,0,0,60,19,41,24,36,45,9.52631228983903,12.7197701415206,0.429889927335047,2020-05-04,2020,5
"1443","CE",2,"Nordeste",23023,"Baixo Jaguaribe",334292,13715.9173785792,19,70,20,50,26,44,0,0,0,0,0,70,20,50,26,44,43,9.52631228983903,12.7197701415206,0.455315760125006,2020-05-11,2020,5
"1444","CE",2,"Nordeste",23023,"Baixo Jaguaribe",334292,13715.9173785792,20,70,23,47,28,42,0,0,0,0,0,70,23,47,28,42,57,9.52631228983903,12.7197701415206,0.444023108859971,2020-05-18,2020,5
"1445","CE",2,"Nordeste",23023,"Baixo Jaguaribe",334292,13715.9173785792,21,77,26,51,30,47,2,1,1,1,1,79,27,52,31,48,51,9.52631228983903,12.7197701415206,0.426534680434815,2020-05-25,2020,5
"1446","CE",2,"Nordeste",23024,"Médio Jaguaribe",64275,13475.0672903928,5,16,5,11,8,8,0,0,0,0,0,16,5,11,8,8,8,9.50859638948591,11.0709260321341,0.247289308608263,2020-02-03,2020,2
"1447","CE",2,"Nordeste",23024,"Médio Jaguaribe",64275,13475.0672903928,6,12,2,10,4,8,0,0,0,0,0,12,2,10,4,8,5,9.50859638948591,11.0709260321341,0.255485530952539,2020-02-10,2020,2
"1448","CE",2,"Nordeste",23024,"Médio Jaguaribe",64275,13475.0672903928,7,14,6,8,7,7,0,0,0,0,0,14,6,8,7,7,4,9.50859638948591,11.0709260321341,0.25477748351817,2020-02-17,2020,2
"1449","CE",2,"Nordeste",23024,"Médio Jaguaribe",64275,13475.0672903928,8,15,5,10,12,3,0,0,0,0,0,15,5,10,12,3,10,9.50859638948591,11.0709260321341,0.304915379594169,2020-02-24,2020,2
"1450","CE",2,"Nordeste",23024,"Médio Jaguaribe",64275,13475.0672903928,9,15,5,10,6,9,0,0,0,0,0,15,5,10,6,9,11,9.50859638948591,11.0709260321341,0.263293261978975,2020-03-02,2020,3
"1451","CE",2,"Nordeste",23024,"Médio Jaguaribe",64275,13475.0672903928,10,12,8,4,2,10,0,0,0,0,0,12,8,4,2,10,5,9.50859638948591,11.0709260321341,0.304500621230917,2020-03-09,2020,3
"1452","CE",2,"Nordeste",23024,"Médio Jaguaribe",64275,13475.0672903928,11,12,2,10,3,9,0,0,0,0,0,12,2,10,3,9,13,9.50859638948591,11.0709260321341,0.373961683361302,2020-03-16,2020,3
"1453","CE",2,"Nordeste",23024,"Médio Jaguaribe",64275,13475.0672903928,12,6,0,6,3,3,0,0,0,0,0,6,0,6,3,3,12,9.50859638948591,11.0709260321341,0.453914575274804,2020-03-23,2020,3
"1454","CE",2,"Nordeste",23024,"Médio Jaguaribe",64275,13475.0672903928,13,15,9,6,3,12,0,0,0,0,0,15,9,6,3,12,7,9.50859638948591,11.0709260321341,0.406227728096974,2020-03-30,2020,3
"1455","CE",2,"Nordeste",23024,"Médio Jaguaribe",64275,13475.0672903928,14,10,2,8,6,4,0,0,0,0,0,10,2,8,6,4,7,9.50859638948591,11.0709260321341,0.400904723520583,2020-04-06,2020,4
"1456","CE",2,"Nordeste",23024,"Médio Jaguaribe",64275,13475.0672903928,15,15,4,11,4,11,0,0,0,0,0,15,4,11,4,11,5,9.50859638948591,11.0709260321341,0.381394160448534,2020-04-13,2020,4
"1457","CE",2,"Nordeste",23024,"Médio Jaguaribe",64275,13475.0672903928,16,10,4,6,3,7,0,0,0,0,0,10,4,6,3,7,12,9.50859638948591,11.0709260321341,0.381734951890797,2020-04-20,2020,4
"1458","CE",2,"Nordeste",23024,"Médio Jaguaribe",64275,13475.0672903928,17,9,2,7,3,6,0,0,0,0,0,9,2,7,3,6,11,9.50859638948591,11.0709260321341,0.368374379393696,2020-04-27,2020,4
"1459","CE",2,"Nordeste",23024,"Médio Jaguaribe",64275,13475.0672903928,18,10,3,7,2,8,0,0,0,0,0,10,3,7,2,8,15,9.50859638948591,11.0709260321341,0.401786482408816,2020-05-04,2020,5
"1460","CE",2,"Nordeste",23024,"Médio Jaguaribe",64275,13475.0672903928,19,14,4,10,9,5,0,0,0,0,0,14,4,10,9,5,17,9.50859638948591,11.0709260321341,0.42714307504772,2020-05-11,2020,5
"1461","CE",2,"Nordeste",23024,"Médio Jaguaribe",64275,13475.0672903928,20,17,4,13,9,8,0,0,0,0,0,17,4,13,9,8,8,9.50859638948591,11.0709260321341,0.417868179392306,2020-05-18,2020,5
"1462","CE",2,"Nordeste",23024,"Médio Jaguaribe",64275,13475.0672903928,21,16,4,12,6,10,0,0,0,0,0,16,4,12,6,10,10,9.50859638948591,11.0709260321341,0.414901616393741,2020-05-25,2020,5
"1463","CE",2,"Nordeste",23025,"Serra do Pereiro",44319,12547.3834542747,5,6,0,6,2,4,0,0,0,0,0,6,0,6,2,4,6,9.4372674331237,10.6991687579897,0.2655453395794,2020-02-03,2020,2
"1464","CE",2,"Nordeste",23025,"Serra do Pereiro",44319,12547.3834542747,6,8,2,6,4,4,0,0,0,0,0,8,2,6,4,4,3,9.4372674331237,10.6991687579897,0.258930446234607,2020-02-10,2020,2
"1465","CE",2,"Nordeste",23025,"Serra do Pereiro",44319,12547.3834542747,7,9,0,9,7,2,0,0,0,0,0,9,0,9,7,2,9,9.4372674331237,10.6991687579897,0.27110609805353,2020-02-17,2020,2
"1466","CE",2,"Nordeste",23025,"Serra do Pereiro",44319,12547.3834542747,8,5,1,4,0,5,0,0,0,0,0,5,1,4,0,5,3,9.4372674331237,10.6991687579897,0.306783730503454,2020-02-24,2020,2
"1467","CE",2,"Nordeste",23025,"Serra do Pereiro",44319,12547.3834542747,9,5,1,4,2,3,0,0,0,0,0,5,1,4,2,3,5,9.4372674331237,10.6991687579897,0.292166906385388,2020-03-02,2020,3
"1468","CE",2,"Nordeste",23025,"Serra do Pereiro",44319,12547.3834542747,10,6,3,3,1,5,0,0,0,0,0,6,3,3,1,5,8,9.4372674331237,10.6991687579897,0.3254852396774,2020-03-09,2020,3
"1469","CE",2,"Nordeste",23025,"Serra do Pereiro",44319,12547.3834542747,11,9,3,6,1,8,0,0,0,0,0,9,3,6,1,8,4,9.4372674331237,10.6991687579897,0.389792544437638,2020-03-16,2020,3
"1470","CE",2,"Nordeste",23025,"Serra do Pereiro",44319,12547.3834542747,12,7,4,3,3,4,0,0,0,0,0,7,4,3,3,4,3,9.4372674331237,10.6991687579897,0.471929124422472,2020-03-23,2020,3
"1471","CE",2,"Nordeste",23025,"Serra do Pereiro",44319,12547.3834542747,13,6,1,5,2,4,1,1,0,0,1,7,2,5,2,5,9,9.4372674331237,10.6991687579897,0.438476767667559,2020-03-30,2020,3
"1472","CE",2,"Nordeste",23025,"Serra do Pereiro",44319,12547.3834542747,14,10,3,7,5,5,0,0,0,0,0,10,3,7,5,5,6,9.4372674331237,10.6991687579897,0.417880205024689,2020-04-06,2020,4
"1473","CE",2,"Nordeste",23025,"Serra do Pereiro",44319,12547.3834542747,15,6,2,4,4,2,0,0,0,0,0,6,2,4,4,2,5,9.4372674331237,10.6991687579897,0.394665432531221,2020-04-13,2020,4
"1474","CE",2,"Nordeste",23025,"Serra do Pereiro",44319,12547.3834542747,16,7,3,4,3,4,0,0,0,0,0,7,3,4,3,4,2,9.4372674331237,10.6991687579897,0.406044859694184,2020-04-20,2020,4
"1475","CE",2,"Nordeste",23025,"Serra do Pereiro",44319,12547.3834542747,17,11,1,10,4,7,0,0,0,0,0,11,1,10,4,7,5,9.4372674331237,10.6991687579897,0.389297613346198,2020-04-27,2020,4
"1476","CE",2,"Nordeste",23025,"Serra do Pereiro",44319,12547.3834542747,18,7,2,5,2,5,0,0,0,0,0,7,2,5,2,5,6,9.4372674331237,10.6991687579897,0.415752984906735,2020-05-04,2020,5
"1477","CE",2,"Nordeste",23025,"Serra do Pereiro",44319,12547.3834542747,19,9,3,6,2,7,0,0,0,0,0,9,3,6,2,7,4,9.4372674331237,10.6991687579897,0.452456873406725,2020-05-11,2020,5
"1478","CE",2,"Nordeste",23025,"Serra do Pereiro",44319,12547.3834542747,20,12,3,9,5,7,0,0,0,0,0,12,3,9,5,7,9,9.4372674331237,10.6991687579897,0.439759760715975,2020-05-18,2020,5
"1479","CE",2,"Nordeste",23025,"Serra do Pereiro",44319,12547.3834542747,21,7,1,6,1,6,0,0,0,0,0,7,1,6,1,6,2,9.4372674331237,10.6991687579897,0.438656146620748,2020-05-25,2020,5
"1480","CE",2,"Nordeste",23026,"Iguatu",234352,11288.7940684099,5,56,18,38,24,32,1,1,0,0,1,57,19,38,24,33,46,9.33156583730315,12.3645795375581,0.27845981829948,2020-02-03,2020,2
"1481","CE",2,"Nordeste",23026,"Iguatu",234352,11288.7940684099,6,43,15,28,19,24,0,0,0,0,0,43,15,28,19,24,34,9.33156583730315,12.3645795375581,0.268360833251221,2020-02-10,2020,2
"1482","CE",2,"Nordeste",23026,"Iguatu",234352,11288.7940684099,7,48,16,32,26,22,1,1,0,1,0,49,17,32,27,22,35,9.33156583730315,12.3645795375581,0.276207262315782,2020-02-17,2020,2
"1483","CE",2,"Nordeste",23026,"Iguatu",234352,11288.7940684099,8,55,13,42,21,34,0,0,0,0,0,55,13,42,21,34,40,9.33156583730315,12.3645795375581,0.32070517877119,2020-02-24,2020,2
"1484","CE",2,"Nordeste",23026,"Iguatu",234352,11288.7940684099,9,55,16,39,20,35,0,0,0,0,0,55,16,39,20,35,28,9.33156583730315,12.3645795375581,0.295197705562448,2020-03-02,2020,3
"1485","CE",2,"Nordeste",23026,"Iguatu",234352,11288.7940684099,10,36,12,24,21,15,1,0,1,0,1,37,12,25,21,16,34,9.33156583730315,12.3645795375581,0.322070760524111,2020-03-09,2020,3
"1486","CE",2,"Nordeste",23026,"Iguatu",234352,11288.7940684099,11,54,18,36,21,33,0,0,0,0,0,54,18,36,21,33,42,9.33156583730315,12.3645795375581,0.409611341783065,2020-03-16,2020,3
"1487","CE",2,"Nordeste",23026,"Iguatu",234352,11288.7940684099,12,41,9,32,16,25,0,0,0,0,0,41,9,32,16,25,30,9.33156583730315,12.3645795375581,0.503802545497892,2020-03-23,2020,3
"1488","CE",2,"Nordeste",23026,"Iguatu",234352,11288.7940684099,13,50,16,34,15,35,1,0,1,0,1,51,16,35,15,36,32,9.33156583730315,12.3645795375581,0.457478576603059,2020-03-30,2020,3
"1489","CE",2,"Nordeste",23026,"Iguatu",234352,11288.7940684099,14,39,10,29,16,23,0,0,0,0,0,39,10,29,16,23,29,9.33156583730315,12.3645795375581,0.455544329023575,2020-04-06,2020,4
"1490","CE",2,"Nordeste",23026,"Iguatu",234352,11288.7940684099,15,43,18,25,21,22,1,1,0,0,1,44,19,25,21,23,21,9.33156583730315,12.3645795375581,0.430342251518935,2020-04-13,2020,4
"1491","CE",2,"Nordeste",23026,"Iguatu",234352,11288.7940684099,16,61,24,37,25,36,0,0,0,0,0,61,24,37,25,36,29,9.33156583730315,12.3645795375581,0.418485361817282,2020-04-20,2020,4
"1492","CE",2,"Nordeste",23026,"Iguatu",234352,11288.7940684099,17,60,18,42,25,35,0,0,0,0,0,60,18,42,25,35,37,9.33156583730315,12.3645795375581,0.397832887691826,2020-04-27,2020,4
"1493","CE",2,"Nordeste",23026,"Iguatu",234352,11288.7940684099,18,66,25,41,31,35,0,0,0,0,0,66,25,41,31,35,38,9.33156583730315,12.3645795375581,0.423748970166901,2020-05-04,2020,5
"1494","CE",2,"Nordeste",23026,"Iguatu",234352,11288.7940684099,19,50,14,36,18,32,1,0,1,0,1,51,14,37,18,33,33,9.33156583730315,12.3645795375581,0.450376843337942,2020-05-11,2020,5
"1495","CE",2,"Nordeste",23026,"Iguatu",234352,11288.7940684099,20,44,15,29,24,20,0,0,0,0,0,44,15,29,24,20,35,9.33156583730315,12.3645795375581,0.424976338777696,2020-05-18,2020,5
"1496","CE",2,"Nordeste",23026,"Iguatu",234352,11288.7940684099,21,44,16,28,12,32,0,0,0,0,0,44,16,28,12,32,29,9.33156583730315,12.3645795375581,0.415489081496683,2020-05-25,2020,5
"1497","CE",2,"Nordeste",23027,"Várzea Alegre",100445,8270.08914749365,5,17,6,11,6,11,0,0,0,0,0,17,6,11,6,11,12,9.02040056758402,11.5173655929962,0.273460827726987,2020-02-03,2020,2
"1498","CE",2,"Nordeste",23027,"Várzea Alegre",100445,8270.08914749365,6,29,13,16,14,15,0,0,0,0,0,29,13,16,14,15,15,9.02040056758402,11.5173655929962,0.264148801978942,2020-02-10,2020,2
"1499","CE",2,"Nordeste",23027,"Várzea Alegre",100445,8270.08914749365,7,24,4,20,6,18,1,0,1,1,0,25,4,21,7,18,14,9.02040056758402,11.5173655929962,0.283760230236178,2020-02-17,2020,2
"1500","CE",2,"Nordeste",23027,"Várzea Alegre",100445,8270.08914749365,8,25,10,15,10,15,0,0,0,0,0,25,10,15,10,15,12,9.02040056758402,11.5173655929962,0.324233535150259,2020-02-24,2020,2
"1501","CE",2,"Nordeste",23027,"Várzea Alegre",100445,8270.08914749365,9,34,14,20,18,16,2,0,2,0,2,36,14,22,18,18,17,9.02040056758402,11.5173655929962,0.306516910493364,2020-03-02,2020,3
"1502","CE",2,"Nordeste",23027,"Várzea Alegre",100445,8270.08914749365,10,19,1,18,7,12,0,0,0,0,0,19,1,18,7,12,18,9.02040056758402,11.5173655929962,0.344672644790069,2020-03-09,2020,3
"1503","CE",2,"Nordeste",23027,"Várzea Alegre",100445,8270.08914749365,11,19,9,10,9,10,1,1,0,1,0,20,10,10,10,10,15,9.02040056758402,11.5173655929962,0.404737391966181,2020-03-16,2020,3
"1504","CE",2,"Nordeste",23027,"Várzea Alegre",100445,8270.08914749365,12,27,6,21,11,16,0,0,0,0,0,27,6,21,11,16,15,9.02040056758402,11.5173655929962,0.507719099397367,2020-03-23,2020,3
"1505","CE",2,"Nordeste",23027,"Várzea Alegre",100445,8270.08914749365,13,16,5,11,2,14,1,0,1,0,1,17,5,12,2,15,15,9.02040056758402,11.5173655929962,0.448892758548184,2020-03-30,2020,3
"1506","CE",2,"Nordeste",23027,"Várzea Alegre",100445,8270.08914749365,14,19,5,14,7,12,0,0,0,0,0,19,5,14,7,12,13,9.02040056758402,11.5173655929962,0.450213044901942,2020-04-06,2020,4
"1507","CE",2,"Nordeste",23027,"Várzea Alegre",100445,8270.08914749365,15,11,7,4,5,6,0,0,0,0,0,11,7,4,5,6,15,9.02040056758402,11.5173655929962,0.42591669631338,2020-04-13,2020,4
"1508","CE",2,"Nordeste",23027,"Várzea Alegre",100445,8270.08914749365,16,24,9,15,9,15,0,0,0,0,0,24,9,15,9,15,12,9.02040056758402,11.5173655929962,0.41071675108257,2020-04-20,2020,4
"1509","CE",2,"Nordeste",23027,"Várzea Alegre",100445,8270.08914749365,17,20,7,13,9,11,0,0,0,0,0,20,7,13,9,11,14,9.02040056758402,11.5173655929962,0.390124107623851,2020-04-27,2020,4
"1510","CE",2,"Nordeste",23027,"Várzea Alegre",100445,8270.08914749365,18,21,9,12,11,10,1,1,0,0,1,22,10,12,11,11,13,9.02040056758402,11.5173655929962,0.417707282035958,2020-05-04,2020,5
"1511","CE",2,"Nordeste",23027,"Várzea Alegre",100445,8270.08914749365,19,14,5,9,7,7,0,0,0,0,0,14,5,9,7,7,14,9.02040056758402,11.5173655929962,0.427654239049595,2020-05-11,2020,5
"1512","CE",2,"Nordeste",23027,"Várzea Alegre",100445,8270.08914749365,20,20,3,17,10,10,0,0,0,0,0,20,3,17,10,10,9,9.02040056758402,11.5173655929962,0.416661399613833,2020-05-18,2020,5
"1513","CE",2,"Nordeste",23027,"Várzea Alegre",100445,8270.08914749365,21,19,4,15,7,12,0,0,0,0,0,19,4,15,7,12,12,9.02040056758402,11.5173655929962,0.40646577559297,2020-05-25,2020,5
"1514","CE",2,"Nordeste",23028,"Lavras da Mangabeira",58016,8289.62951634032,5,5,3,2,2,3,0,0,0,0,0,5,3,2,2,3,6,9.0227605567013,10.9684741135546,0.262096214839431,2020-02-03,2020,2
"1515","CE",2,"Nordeste",23028,"Lavras da Mangabeira",58016,8289.62951634032,6,15,7,8,7,8,0,0,0,0,0,15,7,8,7,8,8,9.0227605567013,10.9684741135546,0.249958747183086,2020-02-10,2020,2
"1516","CE",2,"Nordeste",23028,"Lavras da Mangabeira",58016,8289.62951634032,7,13,3,10,6,7,0,0,0,0,0,13,3,10,6,7,5,9.0227605567013,10.9684741135546,0.27272225181611,2020-02-17,2020,2
"1517","CE",2,"Nordeste",23028,"Lavras da Mangabeira",58016,8289.62951634032,8,13,5,8,6,7,0,0,0,0,0,13,5,8,6,7,6,9.0227605567013,10.9684741135546,0.311922215790048,2020-02-24,2020,2
"1518","CE",2,"Nordeste",23028,"Lavras da Mangabeira",58016,8289.62951634032,9,7,1,6,4,3,0,0,0,0,0,7,1,6,4,3,8,9.0227605567013,10.9684741135546,0.300612758377914,2020-03-02,2020,3
"1519","CE",2,"Nordeste",23028,"Lavras da Mangabeira",58016,8289.62951634032,10,10,5,5,5,5,0,0,0,0,0,10,5,5,5,5,7,9.0227605567013,10.9684741135546,0.324909560465824,2020-03-09,2020,3
"1520","CE",2,"Nordeste",23028,"Lavras da Mangabeira",58016,8289.62951634032,11,11,3,8,7,4,0,0,0,0,0,11,3,8,7,4,3,9.0227605567013,10.9684741135546,0.428833284125514,2020-03-16,2020,3
"1521","CE",2,"Nordeste",23028,"Lavras da Mangabeira",58016,8289.62951634032,12,10,4,6,4,6,0,0,0,0,0,10,4,6,4,6,6,9.0227605567013,10.9684741135546,0.508201950280674,2020-03-23,2020,3
"1522","CE",2,"Nordeste",23028,"Lavras da Mangabeira",58016,8289.62951634032,13,10,3,7,4,6,1,1,0,1,0,11,4,7,5,6,2,9.0227605567013,10.9684741135546,0.466375858055435,2020-03-30,2020,3
"1523","CE",2,"Nordeste",23028,"Lavras da Mangabeira",58016,8289.62951634032,14,10,3,7,5,5,0,0,0,0,0,10,3,7,5,5,11,9.0227605567013,10.9684741135546,0.442584849925401,2020-04-06,2020,4
"1524","CE",2,"Nordeste",23028,"Lavras da Mangabeira",58016,8289.62951634032,15,6,3,3,2,4,0,0,0,0,0,6,3,3,2,4,10,9.0227605567013,10.9684741135546,0.412630151917587,2020-04-13,2020,4
"1525","CE",2,"Nordeste",23028,"Lavras da Mangabeira",58016,8289.62951634032,16,11,4,7,6,5,0,0,0,0,0,11,4,7,6,5,4,9.0227605567013,10.9684741135546,0.391413774179621,2020-04-20,2020,4
"1526","CE",2,"Nordeste",23028,"Lavras da Mangabeira",58016,8289.62951634032,17,6,2,4,1,5,0,0,0,0,0,6,2,4,1,5,6,9.0227605567013,10.9684741135546,0.400396724755927,2020-04-27,2020,4
"1527","CE",2,"Nordeste",23028,"Lavras da Mangabeira",58016,8289.62951634032,18,11,3,8,8,3,0,0,0,0,0,11,3,8,8,3,8,9.0227605567013,10.9684741135546,0.435487670988843,2020-05-04,2020,5
"1528","CE",2,"Nordeste",23028,"Lavras da Mangabeira",58016,8289.62951634032,19,8,3,5,4,4,0,0,0,0,0,8,3,5,4,4,7,9.0227605567013,10.9684741135546,0.455638650361984,2020-05-11,2020,5
"1529","CE",2,"Nordeste",23028,"Lavras da Mangabeira",58016,8289.62951634032,20,10,2,8,5,5,0,0,0,0,0,10,2,8,5,5,15,9.0227605567013,10.9684741135546,0.446344660010102,2020-05-18,2020,5
"1530","CE",2,"Nordeste",23028,"Lavras da Mangabeira",58016,8289.62951634032,21,7,2,5,3,4,0,0,0,0,0,7,2,5,3,4,11,9.0227605567013,10.9684741135546,0.438208171482062,2020-05-25,2020,5
"1531","CE",2,"Nordeste",23029,"Chapada do Araripe",100343,6939.77772211315,5,25,8,17,12,13,1,1,0,0,1,26,9,17,12,14,13,8.84502502447397,11.5163495959369,0.252058671876406,2020-02-03,2020,2
"1532","CE",2,"Nordeste",23029,"Chapada do Araripe",100343,6939.77772211315,6,18,11,7,6,12,1,1,0,0,1,19,12,7,6,13,14,8.84502502447397,11.5163495959369,0.238005760244256,2020-02-10,2020,2
"1533","CE",2,"Nordeste",23029,"Chapada do Araripe",100343,6939.77772211315,7,28,8,20,9,19,1,1,0,0,1,29,9,20,9,20,24,8.84502502447397,11.5163495959369,0.270889299631885,2020-02-17,2020,2
"1534","CE",2,"Nordeste",23029,"Chapada do Araripe",100343,6939.77772211315,8,29,11,18,13,16,2,0,2,1,1,31,11,20,14,17,16,8.84502502447397,11.5163495959369,0.306560354086908,2020-02-24,2020,2
"1535","CE",2,"Nordeste",23029,"Chapada do Araripe",100343,6939.77772211315,9,30,14,16,12,18,0,0,0,0,0,30,14,16,12,18,8,8.84502502447397,11.5163495959369,0.279365453547057,2020-03-02,2020,3
"1536","CE",2,"Nordeste",23029,"Chapada do Araripe",100343,6939.77772211315,10,16,5,11,2,14,0,0,0,0,0,16,5,11,2,14,12,8.84502502447397,11.5163495959369,0.30131683226726,2020-03-09,2020,3
"1537","CE",2,"Nordeste",23029,"Chapada do Araripe",100343,6939.77772211315,11,20,8,12,13,7,1,1,0,0,1,21,9,12,13,8,15,8.84502502447397,11.5163495959369,0.373010489511018,2020-03-16,2020,3
"1538","CE",2,"Nordeste",23029,"Chapada do Araripe",100343,6939.77772211315,12,24,10,14,14,10,0,0,0,0,0,24,10,14,14,10,17,8.84502502447397,11.5163495959369,0.462250219263754,2020-03-23,2020,3
"1539","CE",2,"Nordeste",23029,"Chapada do Araripe",100343,6939.77772211315,13,24,8,16,13,11,0,0,0,0,0,24,8,16,13,11,25,8.84502502447397,11.5163495959369,0.409407665642771,2020-03-30,2020,3
"1540","CE",2,"Nordeste",23029,"Chapada do Araripe",100343,6939.77772211315,14,21,3,18,11,10,0,0,0,0,0,21,3,18,11,10,15,8.84502502447397,11.5163495959369,0.381006910791912,2020-04-06,2020,4
"1541","CE",2,"Nordeste",23029,"Chapada do Araripe",100343,6939.77772211315,15,23,9,14,12,11,1,1,0,0,1,24,10,14,12,12,14,8.84502502447397,11.5163495959369,0.373098493384819,2020-04-13,2020,4
"1542","CE",2,"Nordeste",23029,"Chapada do Araripe",100343,6939.77772211315,16,22,10,12,6,16,0,0,0,0,0,22,10,12,6,16,14,8.84502502447397,11.5163495959369,0.365264607940192,2020-04-20,2020,4
"1543","CE",2,"Nordeste",23029,"Chapada do Araripe",100343,6939.77772211315,17,27,15,12,13,14,0,0,0,0,0,27,15,12,13,14,9,8.84502502447397,11.5163495959369,0.36571044175859,2020-04-27,2020,4
"1544","CE",2,"Nordeste",23029,"Chapada do Araripe",100343,6939.77772211315,18,25,10,15,8,17,0,0,0,0,0,25,10,15,8,17,12,8.84502502447397,11.5163495959369,0.385585585990513,2020-05-04,2020,5
"1545","CE",2,"Nordeste",23029,"Chapada do Araripe",100343,6939.77772211315,19,31,11,20,21,10,0,0,0,0,0,31,11,20,21,10,13,8.84502502447397,11.5163495959369,0.42109310497094,2020-05-11,2020,5
"1546","CE",2,"Nordeste",23029,"Chapada do Araripe",100343,6939.77772211315,20,22,9,13,8,14,0,0,0,0,0,22,9,13,8,14,11,8.84502502447397,11.5163495959369,0.398245130618784,2020-05-18,2020,5
"1547","CE",2,"Nordeste",23029,"Chapada do Araripe",100343,6939.77772211315,21,32,10,22,18,14,0,0,0,0,0,32,10,22,18,14,14,8.84502502447397,11.5163495959369,0.390229949435156,2020-05-25,2020,5
"1548","CE",2,"Nordeste",23030,"Caririaçu",58840,7765.83331033311,5,19,8,11,12,7,0,0,0,0,0,19,8,11,12,7,5,8.95748904602998,10.9825771747154,0.252402595664432,2020-02-03,2020,2
"1549","CE",2,"Nordeste",23030,"Caririaçu",58840,7765.83331033311,6,15,8,7,5,10,1,0,1,0,1,16,8,8,5,11,13,8.95748904602998,10.9825771747154,0.260130558978529,2020-02-10,2020,2
"1550","CE",2,"Nordeste",23030,"Caririaçu",58840,7765.83331033311,7,11,2,9,6,5,0,0,0,0,0,11,2,9,6,5,6,8.95748904602998,10.9825771747154,0.269496246100476,2020-02-17,2020,2
"1551","CE",2,"Nordeste",23030,"Caririaçu",58840,7765.83331033311,8,19,5,14,11,8,0,0,0,0,0,19,5,14,11,8,11,8.95748904602998,10.9825771747154,0.310184765879184,2020-02-24,2020,2
"1552","CE",2,"Nordeste",23030,"Caririaçu",58840,7765.83331033311,9,15,6,9,7,8,0,0,0,0,0,15,6,9,7,8,8,8.95748904602998,10.9825771747154,0.293619066252139,2020-03-02,2020,3
"1553","CE",2,"Nordeste",23030,"Caririaçu",58840,7765.83331033311,10,10,4,6,2,8,1,0,1,1,0,11,4,7,3,8,9,8.95748904602998,10.9825771747154,0.30024063942903,2020-03-09,2020,3
"1554","CE",2,"Nordeste",23030,"Caririaçu",58840,7765.83331033311,11,14,4,10,5,9,0,0,0,0,0,14,4,10,5,9,16,8.95748904602998,10.9825771747154,0.38051236961879,2020-03-16,2020,3
"1555","CE",2,"Nordeste",23030,"Caririaçu",58840,7765.83331033311,12,11,4,7,5,6,0,0,0,0,0,11,4,7,5,6,14,8.95748904602998,10.9825771747154,0.487380287996643,2020-03-23,2020,3
"1556","CE",2,"Nordeste",23030,"Caririaçu",58840,7765.83331033311,13,16,5,11,7,9,0,0,0,0,0,16,5,11,7,9,8,8.95748904602998,10.9825771747154,0.443694279331218,2020-03-30,2020,3
"1557","CE",2,"Nordeste",23030,"Caririaçu",58840,7765.83331033311,14,11,5,6,7,4,0,0,0,0,0,11,5,6,7,4,11,8.95748904602998,10.9825771747154,0.416790578174846,2020-04-06,2020,4
"1558","CE",2,"Nordeste",23030,"Caririaçu",58840,7765.83331033311,15,10,3,7,5,5,0,0,0,0,0,10,3,7,5,5,13,8.95748904602998,10.9825771747154,0.404198310560268,2020-04-13,2020,4
"1559","CE",2,"Nordeste",23030,"Caririaçu",58840,7765.83331033311,16,14,5,9,7,7,0,0,0,0,0,14,5,9,7,7,11,8.95748904602998,10.9825771747154,0.409095046258864,2020-04-20,2020,4
"1560","CE",2,"Nordeste",23030,"Caririaçu",58840,7765.83331033311,17,11,5,6,8,3,0,0,0,0,0,11,5,6,8,3,11,8.95748904602998,10.9825771747154,0.392208099008311,2020-04-27,2020,4
"1561","CE",2,"Nordeste",23030,"Caririaçu",58840,7765.83331033311,18,15,4,11,5,10,0,0,0,0,0,15,4,11,5,10,12,8.95748904602998,10.9825771747154,0.416800047205329,2020-05-04,2020,5
"1562","CE",2,"Nordeste",23030,"Caririaçu",58840,7765.83331033311,19,11,3,8,5,6,0,0,0,0,0,11,3,8,5,6,6,8.95748904602998,10.9825771747154,0.455217009911895,2020-05-11,2020,5
"1563","CE",2,"Nordeste",23030,"Caririaçu",58840,7765.83331033311,20,16,2,14,6,10,0,0,0,0,0,16,2,14,6,10,4,8.95748904602998,10.9825771747154,0.419492661099035,2020-05-18,2020,5
"1564","CE",2,"Nordeste",23030,"Caririaçu",58840,7765.83331033311,21,11,3,8,3,8,0,0,0,0,0,11,3,8,3,8,7,8.95748904602998,10.9825771747154,0.413337873972593,2020-05-25,2020,5
"1565","CE",2,"Nordeste",23031,"Barro",95536,8111.27226616145,5,18,7,11,7,11,0,0,0,0,0,18,7,11,7,11,13,9.0010100110278,11.4672584187868,0.244805057346732,2020-02-03,2020,2
"1566","CE",2,"Nordeste",23031,"Barro",95536,8111.27226616145,6,17,6,11,7,10,0,0,0,0,0,17,6,11,7,10,10,9.0010100110278,11.4672584187868,0.235034678388507,2020-02-10,2020,2
"1567","CE",2,"Nordeste",23031,"Barro",95536,8111.27226616145,7,15,6,9,6,9,0,0,0,0,0,15,6,9,6,9,6,9.0010100110278,11.4672584187868,0.248085105561595,2020-02-17,2020,2
"1568","CE",2,"Nordeste",23031,"Barro",95536,8111.27226616145,8,19,4,15,7,12,0,0,0,0,0,19,4,15,7,12,8,9.0010100110278,11.4672584187868,0.296020985339678,2020-02-24,2020,2
"1569","CE",2,"Nordeste",23031,"Barro",95536,8111.27226616145,9,11,5,6,4,7,0,0,0,0,0,11,5,6,4,7,8,9.0010100110278,11.4672584187868,0.29863369644305,2020-03-02,2020,3
"1570","CE",2,"Nordeste",23031,"Barro",95536,8111.27226616145,10,30,9,21,12,18,1,0,1,0,1,31,9,22,12,19,11,9.0010100110278,11.4672584187868,0.322511901554202,2020-03-09,2020,3
"1571","CE",2,"Nordeste",23031,"Barro",95536,8111.27226616145,11,38,19,19,18,20,1,1,0,1,0,39,20,19,19,20,13,9.0010100110278,11.4672584187868,0.390634779538401,2020-03-16,2020,3
"1572","CE",2,"Nordeste",23031,"Barro",95536,8111.27226616145,12,13,8,5,6,7,0,0,0,0,0,13,8,5,6,7,7,9.0010100110278,11.4672584187868,0.485885009540891,2020-03-23,2020,3
"1573","CE",2,"Nordeste",23031,"Barro",95536,8111.27226616145,13,19,7,12,9,10,0,0,0,0,0,19,7,12,9,10,12,9.0010100110278,11.4672584187868,0.424277074900187,2020-03-30,2020,3
"1574","CE",2,"Nordeste",23031,"Barro",95536,8111.27226616145,14,16,5,11,5,11,0,0,0,0,0,16,5,11,5,11,16,9.0010100110278,11.4672584187868,0.39938280874153,2020-04-06,2020,4
"1575","CE",2,"Nordeste",23031,"Barro",95536,8111.27226616145,15,20,7,13,9,11,0,0,0,0,0,20,7,13,9,11,7,9.0010100110278,11.4672584187868,0.385866731693379,2020-04-13,2020,4
"1576","CE",2,"Nordeste",23031,"Barro",95536,8111.27226616145,16,20,9,11,8,12,1,1,0,0,1,21,10,11,8,13,8,9.0010100110278,11.4672584187868,0.373254372069646,2020-04-20,2020,4
"1577","CE",2,"Nordeste",23031,"Barro",95536,8111.27226616145,17,34,11,23,18,16,0,0,0,0,0,34,11,23,18,16,16,9.0010100110278,11.4672584187868,0.377936134434597,2020-04-27,2020,4
"1578","CE",2,"Nordeste",23031,"Barro",95536,8111.27226616145,18,22,4,18,9,13,0,0,0,0,0,22,4,18,9,13,8,9.0010100110278,11.4672584187868,0.408226742835643,2020-05-04,2020,5
"1579","CE",2,"Nordeste",23031,"Barro",95536,8111.27226616145,19,16,5,11,3,13,0,0,0,0,0,16,5,11,3,13,10,9.0010100110278,11.4672584187868,0.434028157130361,2020-05-11,2020,5
"1580","CE",2,"Nordeste",23031,"Barro",95536,8111.27226616145,20,20,8,12,10,10,0,0,0,0,0,20,8,12,10,10,16,9.0010100110278,11.4672584187868,0.428959831462101,2020-05-18,2020,5
"1581","CE",2,"Nordeste",23031,"Barro",95536,8111.27226616145,21,26,7,19,11,15,0,0,0,0,0,26,7,19,11,15,10,9.0010100110278,11.4672584187868,0.408739632835644,2020-05-25,2020,5
"1582","CE",2,"Nordeste",23032,"Cariri",581538,14144.995371618,5,144,34,110,61,83,0,0,0,0,0,144,34,110,61,83,72,9.55711615652586,13.2734315970431,0.268195020064017,2020-02-03,2020,2
"1583","CE",2,"Nordeste",23032,"Cariri",581538,14144.995371618,6,154,44,110,55,99,0,0,0,0,0,154,44,110,55,99,90,9.55711615652586,13.2734315970431,0.265703556489077,2020-02-10,2020,2
"1584","CE",2,"Nordeste",23032,"Cariri",581538,14144.995371618,7,168,41,127,62,106,2,1,1,0,2,170,42,128,62,108,90,9.55711615652586,13.2734315970431,0.282020669461133,2020-02-17,2020,2
"1585","CE",2,"Nordeste",23032,"Cariri",581538,14144.995371618,8,172,48,124,69,103,3,0,3,1,2,175,48,127,70,105,92,9.55711615652586,13.2734315970431,0.329563527631594,2020-02-24,2020,2
"1586","CE",2,"Nordeste",23032,"Cariri",581538,14144.995371618,9,184,33,151,67,117,1,0,1,0,1,185,33,152,67,118,84,9.55711615652586,13.2734315970431,0.302139834437344,2020-03-02,2020,3
"1587","CE",2,"Nordeste",23032,"Cariri",581538,14144.995371618,10,134,39,95,58,76,3,0,3,1,2,137,39,98,59,78,87,9.55711615652586,13.2734315970431,0.323131233890808,2020-03-09,2020,3
"1588","CE",2,"Nordeste",23032,"Cariri",581538,14144.995371618,11,181,48,133,66,115,1,0,1,0,1,182,48,134,66,116,85,9.55711615652586,13.2734315970431,0.420458438639329,2020-03-16,2020,3
"1589","CE",2,"Nordeste",23032,"Cariri",581538,14144.995371618,12,155,52,103,61,94,3,0,3,2,1,158,52,106,63,95,96,9.55711615652586,13.2734315970431,0.541968206381414,2020-03-23,2020,3
"1590","CE",2,"Nordeste",23032,"Cariri",581538,14144.995371618,13,159,44,115,55,104,4,4,0,3,1,163,48,115,58,105,78,9.55711615652586,13.2734315970431,0.474699477167944,2020-03-30,2020,3
"1591","CE",2,"Nordeste",23032,"Cariri",581538,14144.995371618,14,170,38,132,72,98,1,0,1,1,0,171,38,133,73,98,81,9.55711615652586,13.2734315970431,0.465894400188098,2020-04-06,2020,4
"1592","CE",2,"Nordeste",23032,"Cariri",581538,14144.995371618,15,150,36,114,65,85,1,0,1,0,1,151,36,115,65,86,68,9.55711615652586,13.2734315970431,0.440837252826973,2020-04-13,2020,4
"1593","CE",2,"Nordeste",23032,"Cariri",581538,14144.995371618,16,167,47,120,72,95,2,1,1,2,0,169,48,121,74,95,87,9.55711615652586,13.2734315970431,0.440781688363165,2020-04-20,2020,4
"1594","CE",2,"Nordeste",23032,"Cariri",581538,14144.995371618,17,163,40,123,56,107,1,0,1,0,1,164,40,124,56,108,91,9.55711615652586,13.2734315970431,0.415459537269331,2020-04-27,2020,4
"1595","CE",2,"Nordeste",23032,"Cariri",581538,14144.995371618,18,159,47,112,58,101,4,1,3,2,2,163,48,115,60,103,82,9.55711615652586,13.2734315970431,0.422410625205884,2020-05-04,2020,5
"1596","CE",2,"Nordeste",23032,"Cariri",581538,14144.995371618,19,161,51,110,62,99,6,3,3,3,3,167,54,113,65,102,84,9.55711615652586,13.2734315970431,0.452515005461914,2020-05-11,2020,5
"1597","CE",2,"Nordeste",23032,"Cariri",581538,14144.995371618,20,161,51,110,61,100,2,1,1,1,1,163,52,111,62,101,76,9.55711615652586,13.2734315970431,0.436593741378064,2020-05-18,2020,5
"1598","CE",2,"Nordeste",23032,"Cariri",581538,14144.995371618,21,163,46,117,69,94,1,0,1,1,0,164,46,118,70,94,79,9.55711615652586,13.2734315970431,0.423095334967477,2020-05-25,2020,5
"1599","CE",2,"Nordeste",23033,"Brejo Santo",106430,10621.9126110119,5,25,7,18,9,16,0,0,0,0,0,25,7,18,9,16,11,9.2706743737796,11.5752427710351,0.252443114065277,2020-02-03,2020,2
"1600","CE",2,"Nordeste",23033,"Brejo Santo",106430,10621.9126110119,6,25,6,19,12,13,0,0,0,0,0,25,6,19,12,13,11,9.2706743737796,11.5752427710351,0.259751599820353,2020-02-10,2020,2
"1601","CE",2,"Nordeste",23033,"Brejo Santo",106430,10621.9126110119,7,28,7,21,9,19,0,0,0,0,0,28,7,21,9,19,13,9.2706743737796,11.5752427710351,0.265411667145315,2020-02-17,2020,2
"1602","CE",2,"Nordeste",23033,"Brejo Santo",106430,10621.9126110119,8,25,8,17,10,15,1,0,1,1,0,26,8,18,11,15,24,9.2706743737796,11.5752427710351,0.309669140598286,2020-02-24,2020,2
"1603","CE",2,"Nordeste",23033,"Brejo Santo",106430,10621.9126110119,9,28,9,19,14,14,0,0,0,0,0,28,9,19,14,14,7,9.2706743737796,11.5752427710351,0.295616660093064,2020-03-02,2020,3
"1604","CE",2,"Nordeste",23033,"Brejo Santo",106430,10621.9126110119,10,32,10,22,13,19,0,0,0,0,0,32,10,22,13,19,12,9.2706743737796,11.5752427710351,0.31372296782087,2020-03-09,2020,3
"1605","CE",2,"Nordeste",23033,"Brejo Santo",106430,10621.9126110119,11,22,4,18,9,13,1,0,1,0,1,23,4,19,9,14,18,9.2706743737796,11.5752427710351,0.407630121000487,2020-03-16,2020,3
"1606","CE",2,"Nordeste",23033,"Brejo Santo",106430,10621.9126110119,12,26,12,14,13,13,1,0,1,0,1,27,12,15,13,14,6,9.2706743737796,11.5752427710351,0.523524392563293,2020-03-23,2020,3
"1607","CE",2,"Nordeste",23033,"Brejo Santo",106430,10621.9126110119,13,25,6,19,11,14,0,0,0,0,0,25,6,19,11,14,13,9.2706743737796,11.5752427710351,0.448363353295425,2020-03-30,2020,3
"1608","CE",2,"Nordeste",23033,"Brejo Santo",106430,10621.9126110119,14,32,10,22,16,16,0,0,0,0,0,32,10,22,16,16,18,9.2706743737796,11.5752427710351,0.430529614603987,2020-04-06,2020,4
"1609","CE",2,"Nordeste",23033,"Brejo Santo",106430,10621.9126110119,15,29,10,19,12,17,0,0,0,0,0,29,10,19,12,17,17,9.2706743737796,11.5752427710351,0.401999646553359,2020-04-13,2020,4
"1610","CE",2,"Nordeste",23033,"Brejo Santo",106430,10621.9126110119,16,29,5,24,15,14,0,0,0,0,0,29,5,24,15,14,14,9.2706743737796,11.5752427710351,0.400501967236259,2020-04-20,2020,4
"1611","CE",2,"Nordeste",23033,"Brejo Santo",106430,10621.9126110119,17,19,3,16,11,8,1,0,1,0,1,20,3,17,11,9,14,9.2706743737796,11.5752427710351,0.384090378519084,2020-04-27,2020,4
"1612","CE",2,"Nordeste",23033,"Brejo Santo",106430,10621.9126110119,18,29,9,20,13,16,0,0,0,0,0,29,9,20,13,16,13,9.2706743737796,11.5752427710351,0.391534587487336,2020-05-04,2020,5
"1613","CE",2,"Nordeste",23033,"Brejo Santo",106430,10621.9126110119,19,25,9,16,8,17,0,0,0,0,0,25,9,16,8,17,10,9.2706743737796,11.5752427710351,0.431666988056093,2020-05-11,2020,5
"1614","CE",2,"Nordeste",23033,"Brejo Santo",106430,10621.9126110119,20,18,4,14,4,14,0,0,0,0,0,18,4,14,4,14,15,9.2706743737796,11.5752427710351,0.423273021501618,2020-05-18,2020,5
"1615","CE",2,"Nordeste",23033,"Brejo Santo",106430,10621.9126110119,21,32,12,20,15,17,0,0,0,0,0,32,12,20,15,17,14,9.2706743737796,11.5752427710351,0.410874899679808,2020-05-25,2020,5
"1616","DF",5,"Centro-oeste",53001,"Brasília",3055149,85661.39,5,735,131,604,233,502,2,1,1,1,1,737,132,605,234,503,235,11.3581574779814,14.9323389219026,0.279846322826282,2020-02-03,2020,2
"1617","DF",5,"Centro-oeste",53001,"Brasília",3055149,85661.39,6,750,105,645,195,555,6,1,5,3,3,756,106,650,198,558,234,11.3581574779814,14.9323389219026,0.269451852678484,2020-02-10,2020,2
"1618","DF",5,"Centro-oeste",53001,"Brasília",3055149,85661.39,7,681,105,576,205,476,2,0,2,0,2,683,105,578,205,478,219,11.3581574779814,14.9323389219026,0.286012226865458,2020-02-17,2020,2
"1619","DF",5,"Centro-oeste",53001,"Brasília",3055149,85661.39,8,739,112,627,227,512,4,0,4,0,4,743,112,631,227,516,232,11.3581574779814,14.9323389219026,0.347837778256708,2020-02-24,2020,2
"1620","DF",5,"Centro-oeste",53001,"Brasília",3055149,85661.39,9,685,109,576,192,493,7,0,7,0,7,692,109,583,192,500,235,11.3581574779814,14.9323389219026,0.307165222704111,2020-03-02,2020,3
"1621","DF",5,"Centro-oeste",53001,"Brasília",3055149,85661.39,10,651,105,546,198,453,6,0,6,3,3,657,105,552,201,456,272,11.3581574779814,14.9323389219026,0.326482700182253,2020-03-09,2020,3
"1622","DF",5,"Centro-oeste",53001,"Brasília",3055149,85661.39,11,623,83,540,186,437,6,1,5,2,4,629,84,545,188,441,268,11.3581574779814,14.9323389219026,0.445364715060973,2020-03-16,2020,3
"1623","DF",5,"Centro-oeste",53001,"Brasília",3055149,85661.39,12,575,86,489,169,406,9,1,8,4,5,584,87,497,173,411,255,11.3581574779814,14.9323389219026,0.565743023569479,2020-03-23,2020,3
"1624","DF",5,"Centro-oeste",53001,"Brasília",3055149,85661.39,13,560,78,482,161,399,4,1,3,1,3,564,79,485,162,402,247,11.3581574779814,14.9323389219026,0.506954437980085,2020-03-30,2020,3
"1625","DF",5,"Centro-oeste",53001,"Brasília",3055149,85661.39,14,577,93,484,185,392,6,1,5,1,5,583,94,489,186,397,270,11.3581574779814,14.9323389219026,0.490274136597215,2020-04-06,2020,4
"1626","DF",5,"Centro-oeste",53001,"Brasília",3055149,85661.39,15,661,92,569,204,457,4,0,4,2,2,665,92,573,206,459,210,11.3581574779814,14.9323389219026,0.474934845489021,2020-04-13,2020,4
"1627","DF",5,"Centro-oeste",53001,"Brasília",3055149,85661.39,16,677,117,560,202,475,10,3,7,5,5,687,120,567,207,480,227,11.3581574779814,14.9323389219026,0.475505925985453,2020-04-20,2020,4
"1628","DF",5,"Centro-oeste",53001,"Brasília",3055149,85661.39,17,666,117,549,180,486,7,0,7,4,3,673,117,556,184,489,227,11.3581574779814,14.9323389219026,0.453058541911849,2020-04-27,2020,4
"1629","DF",5,"Centro-oeste",53001,"Brasília",3055149,85661.39,18,641,123,518,179,462,9,2,7,1,8,650,125,525,180,470,240,11.3581574779814,14.9323389219026,0.427403154843524,2020-05-04,2020,5
"1630","DF",5,"Centro-oeste",53001,"Brasília",3055149,85661.39,19,720,120,600,211,509,8,1,7,4,4,728,121,607,215,513,257,11.3581574779814,14.9323389219026,0.439239055743983,2020-05-11,2020,5
"1631","DF",5,"Centro-oeste",53001,"Brasília",3055149,85661.39,20,726,101,625,238,488,3,0,3,1,2,729,101,628,239,490,255,11.3581574779814,14.9323389219026,0.430709666554938,2020-05-18,2020,5
"1632","DF",5,"Centro-oeste",53001,"Brasília",3055149,85661.39,21,719,120,599,225,494,4,2,2,3,1,723,122,601,228,495,299,11.3581574779814,14.9323389219026,0.422331114077378,2020-05-25,2020,5
"1633","ES",3,"Sudeste",32001,"Barra de São Francisco",94226,15821.9177356568,5,20,7,13,7,13,0,0,0,0,0,20,7,13,7,13,15,9.66915145620345,11.4534514309737,0.29722237742939,2020-02-03,2020,2
"1634","ES",3,"Sudeste",32001,"Barra de São Francisco",94226,15821.9177356568,6,29,6,23,9,20,0,0,0,0,0,29,6,23,9,20,9,9.66915145620345,11.4534514309737,0.284211658889847,2020-02-10,2020,2
"1635","ES",3,"Sudeste",32001,"Barra de São Francisco",94226,15821.9177356568,7,14,8,6,6,8,0,0,0,0,0,14,8,6,6,8,9,9.66915145620345,11.4534514309737,0.307695954755298,2020-02-17,2020,2
"1636","ES",3,"Sudeste",32001,"Barra de São Francisco",94226,15821.9177356568,8,18,6,12,7,11,0,0,0,0,0,18,6,12,7,11,16,9.66915145620345,11.4534514309737,0.34575014500048,2020-02-24,2020,2
"1637","ES",3,"Sudeste",32001,"Barra de São Francisco",94226,15821.9177356568,9,36,13,23,17,19,0,0,0,0,0,36,13,23,17,19,8,9.66915145620345,11.4534514309737,0.339367928016448,2020-03-02,2020,3
"1638","ES",3,"Sudeste",32001,"Barra de São Francisco",94226,15821.9177356568,10,24,8,16,10,14,0,0,0,0,0,24,8,16,10,14,13,9.66915145620345,11.4534514309737,0.330027525285795,2020-03-09,2020,3
"1639","ES",3,"Sudeste",32001,"Barra de São Francisco",94226,15821.9177356568,11,20,3,17,4,16,0,0,0,0,0,20,3,17,4,16,9,9.66915145620345,11.4534514309737,0.382081327567256,2020-03-16,2020,3
"1640","ES",3,"Sudeste",32001,"Barra de São Francisco",94226,15821.9177356568,12,18,9,9,11,7,1,0,1,0,1,19,9,10,11,8,18,9.66915145620345,11.4534514309737,0.482115623276309,2020-03-23,2020,3
"1641","ES",3,"Sudeste",32001,"Barra de São Francisco",94226,15821.9177356568,13,17,6,11,7,10,0,0,0,0,0,17,6,11,7,10,13,9.66915145620345,11.4534514309737,0.441890856021945,2020-03-30,2020,3
"1642","ES",3,"Sudeste",32001,"Barra de São Francisco",94226,15821.9177356568,14,33,7,26,14,19,1,0,1,0,1,34,7,27,14,20,13,9.66915145620345,11.4534514309737,0.433484791343688,2020-04-06,2020,4
"1643","ES",3,"Sudeste",32001,"Barra de São Francisco",94226,15821.9177356568,15,33,4,29,13,20,0,0,0,0,0,33,4,29,13,20,13,9.66915145620345,11.4534514309737,0.400663002459634,2020-04-13,2020,4
"1644","ES",3,"Sudeste",32001,"Barra de São Francisco",94226,15821.9177356568,16,19,7,12,7,12,0,0,0,0,0,19,7,12,7,12,9,9.66915145620345,11.4534514309737,0.410502041257737,2020-04-20,2020,4
"1645","ES",3,"Sudeste",32001,"Barra de São Francisco",94226,15821.9177356568,17,21,6,15,7,14,0,0,0,0,0,21,6,15,7,14,13,9.66915145620345,11.4534514309737,0.420265821090608,2020-04-27,2020,4
"1646","ES",3,"Sudeste",32001,"Barra de São Francisco",94226,15821.9177356568,18,34,13,21,12,22,0,0,0,0,0,34,13,21,12,22,16,9.66915145620345,11.4534514309737,0.414454714495715,2020-05-04,2020,5
"1647","ES",3,"Sudeste",32001,"Barra de São Francisco",94226,15821.9177356568,19,34,16,18,15,19,1,0,1,1,0,35,16,19,16,19,19,9.66915145620345,11.4534514309737,0.433561823585124,2020-05-11,2020,5
"1648","ES",3,"Sudeste",32001,"Barra de São Francisco",94226,15821.9177356568,20,18,6,12,6,12,0,0,0,0,0,18,6,12,6,12,19,9.66915145620345,11.4534514309737,0.437950673144517,2020-05-18,2020,5
"1649","ES",3,"Sudeste",32001,"Barra de São Francisco",94226,15821.9177356568,21,21,5,16,8,13,0,0,0,0,0,21,5,16,8,13,12,9.66915145620345,11.4534514309737,0.419364531387354,2020-05-25,2020,5
"1650","ES",3,"Sudeste",32002,"Nova Venécia",136996,17968.7450348185,5,40,9,31,15,25,0,0,0,0,0,40,9,31,15,25,14,9.79638914065658,11.8277070073037,0.273378243576261,2020-02-03,2020,2
"1651","ES",3,"Sudeste",32002,"Nova Venécia",136996,17968.7450348185,6,33,11,22,17,16,0,0,0,0,0,33,11,22,17,16,19,9.79638914065658,11.8277070073037,0.273882181515686,2020-02-10,2020,2
"1652","ES",3,"Sudeste",32002,"Nova Venécia",136996,17968.7450348185,7,23,6,17,11,12,0,0,0,0,0,23,6,17,11,12,20,9.79638914065658,11.8277070073037,0.284097755210579,2020-02-17,2020,2
"1653","ES",3,"Sudeste",32002,"Nova Venécia",136996,17968.7450348185,8,45,12,33,19,26,0,0,0,0,0,45,12,33,19,26,16,9.79638914065658,11.8277070073037,0.32546114404022,2020-02-24,2020,2
"1654","ES",3,"Sudeste",32002,"Nova Venécia",136996,17968.7450348185,9,24,6,18,9,15,0,0,0,0,0,24,6,18,9,15,12,9.79638914065658,11.8277070073037,0.302054049665735,2020-03-02,2020,3
"1655","ES",3,"Sudeste",32002,"Nova Venécia",136996,17968.7450348185,10,28,4,24,10,18,0,0,0,0,0,28,4,24,10,18,15,9.79638914065658,11.8277070073037,0.299261789754961,2020-03-09,2020,3
"1656","ES",3,"Sudeste",32002,"Nova Venécia",136996,17968.7450348185,11,27,11,16,13,14,2,0,2,1,1,29,11,18,14,15,17,9.79638914065658,11.8277070073037,0.36141029139587,2020-03-16,2020,3
"1657","ES",3,"Sudeste",32002,"Nova Venécia",136996,17968.7450348185,12,26,8,18,8,18,0,0,0,0,0,26,8,18,8,18,19,9.79638914065658,11.8277070073037,0.443932812364112,2020-03-23,2020,3
"1658","ES",3,"Sudeste",32002,"Nova Venécia",136996,17968.7450348185,13,33,10,23,11,22,1,0,1,0,1,34,10,24,11,23,12,9.79638914065658,11.8277070073037,0.406899688593518,2020-03-30,2020,3
"1659","ES",3,"Sudeste",32002,"Nova Venécia",136996,17968.7450348185,14,35,14,21,17,18,1,1,0,1,0,36,15,21,18,18,9,9.79638914065658,11.8277070073037,0.411760364606025,2020-04-06,2020,4
"1660","ES",3,"Sudeste",32002,"Nova Venécia",136996,17968.7450348185,15,25,9,16,10,15,0,0,0,0,0,25,9,16,10,15,12,9.79638914065658,11.8277070073037,0.370096345908977,2020-04-13,2020,4
"1661","ES",3,"Sudeste",32002,"Nova Venécia",136996,17968.7450348185,16,40,12,28,12,28,0,0,0,0,0,40,12,28,12,28,11,9.79638914065658,11.8277070073037,0.389117954805909,2020-04-20,2020,4
"1662","ES",3,"Sudeste",32002,"Nova Venécia",136996,17968.7450348185,17,26,8,18,12,14,0,0,0,0,0,26,8,18,12,14,11,9.79638914065658,11.8277070073037,0.379955900250375,2020-04-27,2020,4
"1663","ES",3,"Sudeste",32002,"Nova Venécia",136996,17968.7450348185,18,39,9,30,13,26,0,0,0,0,0,39,9,30,13,26,10,9.79638914065658,11.8277070073037,0.365466461363136,2020-05-04,2020,5
"1664","ES",3,"Sudeste",32002,"Nova Venécia",136996,17968.7450348185,19,30,11,19,9,21,0,0,0,0,0,30,11,19,9,21,13,9.79638914065658,11.8277070073037,0.383759977319192,2020-05-11,2020,5
"1665","ES",3,"Sudeste",32002,"Nova Venécia",136996,17968.7450348185,20,30,12,18,13,17,0,0,0,0,0,30,12,18,13,17,20,9.79638914065658,11.8277070073037,0.373669270705133,2020-05-18,2020,5
"1666","ES",3,"Sudeste",32002,"Nova Venécia",136996,17968.7450348185,21,27,10,17,13,14,0,0,0,0,0,27,10,17,13,14,17,9.79638914065658,11.8277070073037,0.371983477385449,2020-05-25,2020,5
"1667","ES",3,"Sudeste",32003,"Colatina",220242,24391.7459638943,5,53,11,42,16,37,0,0,0,0,0,53,11,42,16,37,26,10.1020000738834,12.3024822207778,0.2837563812322,2020-02-03,2020,2
"1668","ES",3,"Sudeste",32003,"Colatina",220242,24391.7459638943,6,51,15,36,20,31,0,0,0,0,0,51,15,36,20,31,32,10.1020000738834,12.3024822207778,0.287955083573475,2020-02-10,2020,2
"1669","ES",3,"Sudeste",32003,"Colatina",220242,24391.7459638943,7,50,14,36,18,32,0,0,0,0,0,50,14,36,18,32,20,10.1020000738834,12.3024822207778,0.30263300926603,2020-02-17,2020,2
"1670","ES",3,"Sudeste",32003,"Colatina",220242,24391.7459638943,8,56,16,40,19,37,0,0,0,0,0,56,16,40,19,37,21,10.1020000738834,12.3024822207778,0.360971526660209,2020-02-24,2020,2
"1671","ES",3,"Sudeste",32003,"Colatina",220242,24391.7459638943,9,41,11,30,13,28,1,0,1,0,1,42,11,31,13,29,25,10.1020000738834,12.3024822207778,0.321113044157293,2020-03-02,2020,3
"1672","ES",3,"Sudeste",32003,"Colatina",220242,24391.7459638943,10,56,15,41,22,34,0,0,0,0,0,56,15,41,22,34,24,10.1020000738834,12.3024822207778,0.3251246407709,2020-03-09,2020,3
"1673","ES",3,"Sudeste",32003,"Colatina",220242,24391.7459638943,11,48,14,34,15,33,0,0,0,0,0,48,14,34,15,33,25,10.1020000738834,12.3024822207778,0.412062545013881,2020-03-16,2020,3
"1674","ES",3,"Sudeste",32003,"Colatina",220242,24391.7459638943,12,47,12,35,7,40,0,0,0,0,0,47,12,35,7,40,29,10.1020000738834,12.3024822207778,0.510264094485055,2020-03-23,2020,3
"1675","ES",3,"Sudeste",32003,"Colatina",220242,24391.7459638943,13,39,9,30,11,28,0,0,0,0,0,39,9,30,11,28,19,10.1020000738834,12.3024822207778,0.465870160810917,2020-03-30,2020,3
"1676","ES",3,"Sudeste",32003,"Colatina",220242,24391.7459638943,14,45,7,38,14,31,0,0,0,0,0,45,7,38,14,31,27,10.1020000738834,12.3024822207778,0.46834874220508,2020-04-06,2020,4
"1677","ES",3,"Sudeste",32003,"Colatina",220242,24391.7459638943,15,37,9,28,19,18,1,1,0,0,1,38,10,28,19,19,20,10.1020000738834,12.3024822207778,0.427566579052636,2020-04-13,2020,4
"1678","ES",3,"Sudeste",32003,"Colatina",220242,24391.7459638943,16,50,13,37,13,37,2,2,0,0,2,52,15,37,13,39,30,10.1020000738834,12.3024822207778,0.440835023852013,2020-04-20,2020,4
"1679","ES",3,"Sudeste",32003,"Colatina",220242,24391.7459638943,17,57,15,42,22,35,0,0,0,0,0,57,15,42,22,35,22,10.1020000738834,12.3024822207778,0.419461133826047,2020-04-27,2020,4
"1680","ES",3,"Sudeste",32003,"Colatina",220242,24391.7459638943,18,42,11,31,16,26,3,0,3,1,2,45,11,34,17,28,25,10.1020000738834,12.3024822207778,0.410005176236539,2020-05-04,2020,5
"1681","ES",3,"Sudeste",32003,"Colatina",220242,24391.7459638943,19,49,10,39,16,33,0,0,0,0,0,49,10,39,16,33,20,10.1020000738834,12.3024822207778,0.434228135181184,2020-05-11,2020,5
"1682","ES",3,"Sudeste",32003,"Colatina",220242,24391.7459638943,20,51,10,41,16,35,0,0,0,0,0,51,10,41,16,35,33,10.1020000738834,12.3024822207778,0.42139261725268,2020-05-18,2020,5
"1683","ES",3,"Sudeste",32003,"Colatina",220242,24391.7459638943,21,49,11,38,14,35,0,0,0,0,0,49,11,38,14,35,32,10.1020000738834,12.3024822207778,0.418335206886463,2020-05-25,2020,5
"1684","ES",3,"Sudeste",32004,"Montanha",59657,16674.9510617363,5,16,4,12,8,8,0,0,0,0,0,16,4,12,8,8,8,9.72166293595111,10.9963667718564,0.251706843418912,2020-02-03,2020,2
"1685","ES",3,"Sudeste",32004,"Montanha",59657,16674.9510617363,6,15,12,3,7,8,0,0,0,0,0,15,12,3,7,8,4,9.72166293595111,10.9963667718564,0.24676719892055,2020-02-10,2020,2
"1686","ES",3,"Sudeste",32004,"Montanha",59657,16674.9510617363,7,13,6,7,10,3,0,0,0,0,0,13,6,7,10,3,11,9.72166293595111,10.9963667718564,0.264383432340946,2020-02-17,2020,2
"1687","ES",3,"Sudeste",32004,"Montanha",59657,16674.9510617363,8,19,8,11,8,11,0,0,0,0,0,19,8,11,8,11,10,9.72166293595111,10.9963667718564,0.318408049523795,2020-02-24,2020,2
"1688","ES",3,"Sudeste",32004,"Montanha",59657,16674.9510617363,9,12,3,9,5,7,0,0,0,0,0,12,3,9,5,7,3,9.72166293595111,10.9963667718564,0.293846097037889,2020-03-02,2020,3
"1689","ES",3,"Sudeste",32004,"Montanha",59657,16674.9510617363,10,8,4,4,3,5,0,0,0,0,0,8,4,4,3,5,17,9.72166293595111,10.9963667718564,0.300881923586279,2020-03-09,2020,3
"1690","ES",3,"Sudeste",32004,"Montanha",59657,16674.9510617363,11,15,6,9,7,8,0,0,0,0,0,15,6,9,7,8,5,9.72166293595111,10.9963667718564,0.356651180164037,2020-03-16,2020,3
"1691","ES",3,"Sudeste",32004,"Montanha",59657,16674.9510617363,12,12,5,7,9,3,1,0,1,0,1,13,5,8,9,4,8,9.72166293595111,10.9963667718564,0.456598275891527,2020-03-23,2020,3
"1692","ES",3,"Sudeste",32004,"Montanha",59657,16674.9510617363,13,13,3,10,7,6,0,0,0,0,0,13,3,10,7,6,5,9.72166293595111,10.9963667718564,0.409187406730201,2020-03-30,2020,3
"1693","ES",3,"Sudeste",32004,"Montanha",59657,16674.9510617363,14,9,1,8,3,6,0,0,0,0,0,9,1,8,3,6,7,9.72166293595111,10.9963667718564,0.391426093498508,2020-04-06,2020,4
"1694","ES",3,"Sudeste",32004,"Montanha",59657,16674.9510617363,15,12,6,6,8,4,0,0,0,0,0,12,6,6,8,4,5,9.72166293595111,10.9963667718564,0.364170576689924,2020-04-13,2020,4
"1695","ES",3,"Sudeste",32004,"Montanha",59657,16674.9510617363,16,11,3,8,3,8,0,0,0,0,0,11,3,8,3,8,12,9.72166293595111,10.9963667718564,0.379299119408468,2020-04-20,2020,4
"1696","ES",3,"Sudeste",32004,"Montanha",59657,16674.9510617363,17,11,6,5,6,5,0,0,0,0,0,11,6,5,6,5,7,9.72166293595111,10.9963667718564,0.368883613271627,2020-04-27,2020,4
"1697","ES",3,"Sudeste",32004,"Montanha",59657,16674.9510617363,18,15,1,14,9,6,0,0,0,0,0,15,1,14,9,6,4,9.72166293595111,10.9963667718564,0.359881742953059,2020-05-04,2020,5
"1698","ES",3,"Sudeste",32004,"Montanha",59657,16674.9510617363,19,12,5,7,4,8,0,0,0,0,0,12,5,7,4,8,10,9.72166293595111,10.9963667718564,0.369478447858687,2020-05-11,2020,5
"1699","ES",3,"Sudeste",32004,"Montanha",59657,16674.9510617363,20,18,6,12,9,9,1,0,1,0,1,19,6,13,9,10,8,9.72166293595111,10.9963667718564,0.366816464402026,2020-05-18,2020,5
"1700","ES",3,"Sudeste",32004,"Montanha",59657,16674.9510617363,21,8,4,4,1,7,1,0,1,0,1,9,4,5,1,8,10,9.72166293595111,10.9963667718564,0.360715210432253,2020-05-25,2020,5
"1701","ES",3,"Sudeste",32005,"São Mateus",221335,17644.5943101633,5,72,15,57,25,47,0,0,0,0,0,72,15,57,25,47,23,9.77818474407194,12.3074326698826,0.28639641659797,2020-02-03,2020,2
"1702","ES",3,"Sudeste",32005,"São Mateus",221335,17644.5943101633,6,49,24,25,26,23,0,0,0,0,0,49,24,25,26,23,19,9.77818474407194,12.3074326698826,0.28546234122512,2020-02-10,2020,2
"1703","ES",3,"Sudeste",32005,"São Mateus",221335,17644.5943101633,7,56,15,41,11,45,0,0,0,0,0,56,15,41,11,45,26,9.77818474407194,12.3074326698826,0.286627466093723,2020-02-17,2020,2
"1704","ES",3,"Sudeste",32005,"São Mateus",221335,17644.5943101633,8,53,11,42,19,34,1,0,1,0,1,54,11,43,19,35,21,9.77818474407194,12.3074326698826,0.341615701793024,2020-02-24,2020,2
"1705","ES",3,"Sudeste",32005,"São Mateus",221335,17644.5943101633,9,52,9,43,21,31,0,0,0,0,0,52,9,43,21,31,26,9.77818474407194,12.3074326698826,0.325274391192065,2020-03-02,2020,3
"1706","ES",3,"Sudeste",32005,"São Mateus",221335,17644.5943101633,10,62,15,47,19,43,1,0,1,0,1,63,15,48,19,44,20,9.77818474407194,12.3074326698826,0.33554563104616,2020-03-09,2020,3
"1707","ES",3,"Sudeste",32005,"São Mateus",221335,17644.5943101633,11,41,10,31,16,25,1,1,0,1,0,42,11,31,17,25,26,9.77818474407194,12.3074326698826,0.401669306457116,2020-03-16,2020,3
"1708","ES",3,"Sudeste",32005,"São Mateus",221335,17644.5943101633,12,45,12,33,12,33,1,0,1,0,1,46,12,34,12,34,22,9.77818474407194,12.3074326698826,0.492525118029131,2020-03-23,2020,3
"1709","ES",3,"Sudeste",32005,"São Mateus",221335,17644.5943101633,13,55,18,37,23,32,1,1,0,0,1,56,19,37,23,33,29,9.77818474407194,12.3074326698826,0.470290462654617,2020-03-30,2020,3
"1710","ES",3,"Sudeste",32005,"São Mateus",221335,17644.5943101633,14,63,17,46,29,34,0,0,0,0,0,63,17,46,29,34,23,9.77818474407194,12.3074326698826,0.450920487706803,2020-04-06,2020,4
"1711","ES",3,"Sudeste",32005,"São Mateus",221335,17644.5943101633,15,60,14,46,27,33,1,0,1,1,0,61,14,47,28,33,21,9.77818474407194,12.3074326698826,0.417631821660756,2020-04-13,2020,4
"1712","ES",3,"Sudeste",32005,"São Mateus",221335,17644.5943101633,16,67,16,51,24,43,2,1,1,1,1,69,17,52,25,44,18,9.77818474407194,12.3074326698826,0.425396211130086,2020-04-20,2020,4
"1713","ES",3,"Sudeste",32005,"São Mateus",221335,17644.5943101633,17,67,20,47,31,36,1,0,1,0,1,68,20,48,31,37,16,9.77818474407194,12.3074326698826,0.399590779691658,2020-04-27,2020,4
"1714","ES",3,"Sudeste",32005,"São Mateus",221335,17644.5943101633,18,66,17,49,23,43,0,0,0,0,0,66,17,49,23,43,22,9.77818474407194,12.3074326698826,0.394243027738565,2020-05-04,2020,5
"1715","ES",3,"Sudeste",32005,"São Mateus",221335,17644.5943101633,19,61,18,43,25,36,2,0,2,1,1,63,18,45,26,37,25,9.77818474407194,12.3074326698826,0.41508463461274,2020-05-11,2020,5
"1716","ES",3,"Sudeste",32005,"São Mateus",221335,17644.5943101633,20,68,20,48,35,33,1,1,0,1,0,69,21,48,36,33,21,9.77818474407194,12.3074326698826,0.398347331389754,2020-05-18,2020,5
"1717","ES",3,"Sudeste",32005,"São Mateus",221335,17644.5943101633,21,65,22,43,28,37,1,1,0,1,0,66,23,43,29,37,18,9.77818474407194,12.3074326698826,0.388948985036417,2020-05-25,2020,5
"1718","ES",3,"Sudeste",32006,"Linhares",381001,36720.4282588235,5,96,30,66,36,60,1,0,1,0,1,97,30,67,36,61,25,10.5110885074884,12.8505572787773,0.272221978914303,2020-02-03,2020,2
"1719","ES",3,"Sudeste",32006,"Linhares",381001,36720.4282588235,6,96,21,75,30,66,0,0,0,0,0,96,21,75,30,66,36,10.5110885074884,12.8505572787773,0.278885569301934,2020-02-10,2020,2
"1720","ES",3,"Sudeste",32006,"Linhares",381001,36720.4282588235,7,90,22,68,33,57,0,0,0,0,0,90,22,68,33,57,34,10.5110885074884,12.8505572787773,0.290311778077966,2020-02-17,2020,2
"1721","ES",3,"Sudeste",32006,"Linhares",381001,36720.4282588235,8,89,31,58,37,52,0,0,0,0,0,89,31,58,37,52,35,10.5110885074884,12.8505572787773,0.349575449824598,2020-02-24,2020,2
"1722","ES",3,"Sudeste",32006,"Linhares",381001,36720.4282588235,9,87,19,68,23,64,0,0,0,0,0,87,19,68,23,64,31,10.5110885074884,12.8505572787773,0.312802680507162,2020-03-02,2020,3
"1723","ES",3,"Sudeste",32006,"Linhares",381001,36720.4282588235,10,93,25,68,36,57,2,1,1,1,1,95,26,69,37,58,50,10.5110885074884,12.8505572787773,0.314566143366119,2020-03-09,2020,3
"1724","ES",3,"Sudeste",32006,"Linhares",381001,36720.4282588235,11,74,23,51,28,46,0,0,0,0,0,74,23,51,28,46,43,10.5110885074884,12.8505572787773,0.411137487188328,2020-03-16,2020,3
"1725","ES",3,"Sudeste",32006,"Linhares",381001,36720.4282588235,12,94,27,67,32,62,0,0,0,0,0,94,27,67,32,62,38,10.5110885074884,12.8505572787773,0.503772774235672,2020-03-23,2020,3
"1726","ES",3,"Sudeste",32006,"Linhares",381001,36720.4282588235,13,72,20,52,28,44,0,0,0,0,0,72,20,52,28,44,47,10.5110885074884,12.8505572787773,0.474357863454608,2020-03-30,2020,3
"1727","ES",3,"Sudeste",32006,"Linhares",381001,36720.4282588235,14,100,18,82,40,60,2,0,2,2,0,102,18,84,42,60,39,10.5110885074884,12.8505572787773,0.455183757694094,2020-04-06,2020,4
"1728","ES",3,"Sudeste",32006,"Linhares",381001,36720.4282588235,15,99,28,71,34,65,2,2,0,2,0,101,30,71,36,65,43,10.5110885074884,12.8505572787773,0.427799721897631,2020-04-13,2020,4
"1729","ES",3,"Sudeste",32006,"Linhares",381001,36720.4282588235,16,111,28,83,40,71,1,1,0,1,0,112,29,83,41,71,23,10.5110885074884,12.8505572787773,0.440089234304247,2020-04-20,2020,4
"1730","ES",3,"Sudeste",32006,"Linhares",381001,36720.4282588235,17,117,32,85,40,77,1,0,1,0,1,118,32,86,40,78,38,10.5110885074884,12.8505572787773,0.419802767745663,2020-04-27,2020,4
"1731","ES",3,"Sudeste",32006,"Linhares",381001,36720.4282588235,18,100,32,68,39,61,2,1,1,0,2,102,33,69,39,63,39,10.5110885074884,12.8505572787773,0.391102476423246,2020-05-04,2020,5
"1732","ES",3,"Sudeste",32006,"Linhares",381001,36720.4282588235,19,106,22,84,46,60,1,1,0,0,1,107,23,84,46,61,33,10.5110885074884,12.8505572787773,0.40759729501136,2020-05-11,2020,5
"1733","ES",3,"Sudeste",32006,"Linhares",381001,36720.4282588235,20,108,32,76,39,69,0,0,0,0,0,108,32,76,39,69,49,10.5110885074884,12.8505572787773,0.394198359835216,2020-05-18,2020,5
"1734","ES",3,"Sudeste",32006,"Linhares",381001,36720.4282588235,21,106,21,85,41,65,1,1,0,1,0,107,22,85,42,65,41,10.5110885074884,12.8505572787773,0.395948769009001,2020-05-25,2020,5
"1735","ES",3,"Sudeste",32007,"Afonso Cláudio",143272,20117.4018022363,5,44,14,30,19,25,1,1,0,0,1,45,15,30,19,26,22,9.9093404807973,11.8725002004466,0.275639947362149,2020-02-03,2020,2
"1736","ES",3,"Sudeste",32007,"Afonso Cláudio",143272,20117.4018022363,6,48,14,34,19,29,1,1,0,0,1,49,15,34,19,30,26,9.9093404807973,11.8725002004466,0.278891652520972,2020-02-10,2020,2
"1737","ES",3,"Sudeste",32007,"Afonso Cláudio",143272,20117.4018022363,7,28,9,19,8,20,0,0,0,0,0,28,9,19,8,20,19,9.9093404807973,11.8725002004466,0.293418477977015,2020-02-17,2020,2
"1738","ES",3,"Sudeste",32007,"Afonso Cláudio",143272,20117.4018022363,8,27,12,15,9,18,0,0,0,0,0,27,12,15,9,18,13,9.9093404807973,11.8725002004466,0.347611558140357,2020-02-24,2020,2
"1739","ES",3,"Sudeste",32007,"Afonso Cláudio",143272,20117.4018022363,9,43,12,31,18,25,1,1,0,0,1,44,13,31,18,26,19,9.9093404807973,11.8725002004466,0.320096340965143,2020-03-02,2020,3
"1740","ES",3,"Sudeste",32007,"Afonso Cláudio",143272,20117.4018022363,10,32,11,21,11,21,1,0,1,0,1,33,11,22,11,22,15,9.9093404807973,11.8725002004466,0.321567164956516,2020-03-09,2020,3
"1741","ES",3,"Sudeste",32007,"Afonso Cláudio",143272,20117.4018022363,11,38,15,23,10,28,0,0,0,0,0,38,15,23,10,28,11,9.9093404807973,11.8725002004466,0.392041817452012,2020-03-16,2020,3
"1742","ES",3,"Sudeste",32007,"Afonso Cláudio",143272,20117.4018022363,12,30,16,14,14,16,0,0,0,0,0,30,16,14,14,16,26,9.9093404807973,11.8725002004466,0.487637371531219,2020-03-23,2020,3
"1743","ES",3,"Sudeste",32007,"Afonso Cláudio",143272,20117.4018022363,13,29,7,22,12,17,0,0,0,0,0,29,7,22,12,17,14,9.9093404807973,11.8725002004466,0.450429864821711,2020-03-30,2020,3
"1744","ES",3,"Sudeste",32007,"Afonso Cláudio",143272,20117.4018022363,14,37,7,30,14,23,0,0,0,0,0,37,7,30,14,23,17,9.9093404807973,11.8725002004466,0.450058979681425,2020-04-06,2020,4
"1745","ES",3,"Sudeste",32007,"Afonso Cláudio",143272,20117.4018022363,15,32,11,21,12,20,0,0,0,0,0,32,11,21,12,20,13,9.9093404807973,11.8725002004466,0.414909237707873,2020-04-13,2020,4
"1746","ES",3,"Sudeste",32007,"Afonso Cláudio",143272,20117.4018022363,16,31,8,23,5,26,0,0,0,0,0,31,8,23,5,26,14,9.9093404807973,11.8725002004466,0.430394352590498,2020-04-20,2020,4
"1747","ES",3,"Sudeste",32007,"Afonso Cláudio",143272,20117.4018022363,17,32,12,20,11,21,0,0,0,0,0,32,12,20,11,21,25,9.9093404807973,11.8725002004466,0.42691214639665,2020-04-27,2020,4
"1748","ES",3,"Sudeste",32007,"Afonso Cláudio",143272,20117.4018022363,18,37,13,24,12,25,0,0,0,0,0,37,13,24,12,25,13,9.9093404807973,11.8725002004466,0.415168460376478,2020-05-04,2020,5
"1749","ES",3,"Sudeste",32007,"Afonso Cláudio",143272,20117.4018022363,19,40,17,23,17,23,1,0,1,0,1,41,17,24,17,24,20,9.9093404807973,11.8725002004466,0.416978604261342,2020-05-11,2020,5
"1750","ES",3,"Sudeste",32007,"Afonso Cláudio",143272,20117.4018022363,20,31,6,25,8,23,1,0,1,1,0,32,6,26,9,23,19,9.9093404807973,11.8725002004466,0.402636773494391,2020-05-18,2020,5
"1751","ES",3,"Sudeste",32007,"Afonso Cláudio",143272,20117.4018022363,21,35,13,22,14,21,1,1,0,1,0,36,14,22,15,21,25,9.9093404807973,11.8725002004466,0.404332123299416,2020-05-25,2020,5
"1752","ES",3,"Sudeste",32008,"Santa Teresa",113963,24297.5523238244,5,22,8,14,9,13,0,0,0,0,0,22,8,14,9,13,4,10.0981308968407,11.6436291132917,0.280483177102733,2020-02-03,2020,2
"1753","ES",3,"Sudeste",32008,"Santa Teresa",113963,24297.5523238244,6,17,8,9,6,11,0,0,0,0,0,17,8,9,6,11,13,10.0981308968407,11.6436291132917,0.281879597326222,2020-02-10,2020,2
"1754","ES",3,"Sudeste",32008,"Santa Teresa",113963,24297.5523238244,7,31,8,23,9,22,0,0,0,0,0,31,8,23,9,22,19,10.0981308968407,11.6436291132917,0.306017531288583,2020-02-17,2020,2
"1755","ES",3,"Sudeste",32008,"Santa Teresa",113963,24297.5523238244,8,20,10,10,7,13,0,0,0,0,0,20,10,10,7,13,9,10.0981308968407,11.6436291132917,0.345723138325779,2020-02-24,2020,2
"1756","ES",3,"Sudeste",32008,"Santa Teresa",113963,24297.5523238244,9,30,10,20,9,21,0,0,0,0,0,30,10,20,9,21,15,10.0981308968407,11.6436291132917,0.323342985853933,2020-03-02,2020,3
"1757","ES",3,"Sudeste",32008,"Santa Teresa",113963,24297.5523238244,10,16,5,11,4,12,0,0,0,0,0,16,5,11,4,12,14,10.0981308968407,11.6436291132917,0.324942835009447,2020-03-09,2020,3
"1758","ES",3,"Sudeste",32008,"Santa Teresa",113963,24297.5523238244,11,29,11,18,11,18,0,0,0,0,0,29,11,18,11,18,18,10.0981308968407,11.6436291132917,0.393011475033198,2020-03-16,2020,3
"1759","ES",3,"Sudeste",32008,"Santa Teresa",113963,24297.5523238244,12,16,5,11,6,10,0,0,0,0,0,16,5,11,6,10,13,10.0981308968407,11.6436291132917,0.492265398717869,2020-03-23,2020,3
"1760","ES",3,"Sudeste",32008,"Santa Teresa",113963,24297.5523238244,13,18,8,10,8,10,0,0,0,0,0,18,8,10,8,10,20,10.0981308968407,11.6436291132917,0.453695632271165,2020-03-30,2020,3
"1761","ES",3,"Sudeste",32008,"Santa Teresa",113963,24297.5523238244,14,25,9,16,10,15,1,1,0,1,0,26,10,16,11,15,11,10.0981308968407,11.6436291132917,0.452823671104358,2020-04-06,2020,4
"1762","ES",3,"Sudeste",32008,"Santa Teresa",113963,24297.5523238244,15,25,7,18,10,15,0,0,0,0,0,25,7,18,10,15,12,10.0981308968407,11.6436291132917,0.413785980710114,2020-04-13,2020,4
"1763","ES",3,"Sudeste",32008,"Santa Teresa",113963,24297.5523238244,16,21,8,13,7,14,0,0,0,0,0,21,8,13,7,14,16,10.0981308968407,11.6436291132917,0.432283130402629,2020-04-20,2020,4
"1764","ES",3,"Sudeste",32008,"Santa Teresa",113963,24297.5523238244,17,29,11,18,9,20,0,0,0,0,0,29,11,18,9,20,15,10.0981308968407,11.6436291132917,0.427252384529284,2020-04-27,2020,4
"1765","ES",3,"Sudeste",32008,"Santa Teresa",113963,24297.5523238244,18,26,12,14,7,19,0,0,0,0,0,26,12,14,7,19,17,10.0981308968407,11.6436291132917,0.427817387556653,2020-05-04,2020,5
"1766","ES",3,"Sudeste",32008,"Santa Teresa",113963,24297.5523238244,19,34,13,21,12,22,0,0,0,0,0,34,13,21,12,22,12,10.0981308968407,11.6436291132917,0.437918077151695,2020-05-11,2020,5
"1767","ES",3,"Sudeste",32008,"Santa Teresa",113963,24297.5523238244,20,36,14,22,18,18,2,1,1,1,1,38,15,23,19,19,27,10.0981308968407,11.6436291132917,0.434060566873567,2020-05-18,2020,5
"1768","ES",3,"Sudeste",32008,"Santa Teresa",113963,24297.5523238244,21,24,11,13,6,18,0,0,0,0,0,24,11,13,6,18,15,10.0981308968407,11.6436291132917,0.428080759325245,2020-05-25,2020,5
"1769","ES",3,"Sudeste",32009,"Vitória",1857837,40867.8144563759,5,461,102,359,148,313,4,1,3,2,2,465,103,362,150,315,194,10.6180980996299,14.4349234657669,0.27550720356163,2020-02-03,2020,2
"1770","ES",3,"Sudeste",32009,"Vitória",1857837,40867.8144563759,6,484,87,397,155,329,2,2,0,1,1,486,89,397,156,330,192,10.6180980996299,14.4349234657669,0.277261469284803,2020-02-10,2020,2
"1771","ES",3,"Sudeste",32009,"Vitória",1857837,40867.8144563759,7,420,85,335,134,286,3,2,1,2,1,423,87,336,136,287,212,10.6180980996299,14.4349234657669,0.293571082296533,2020-02-17,2020,2
"1772","ES",3,"Sudeste",32009,"Vitória",1857837,40867.8144563759,8,422,76,346,125,297,6,2,4,2,4,428,78,350,127,301,200,10.6180980996299,14.4349234657669,0.354512691218006,2020-02-24,2020,2
"1773","ES",3,"Sudeste",32009,"Vitória",1857837,40867.8144563759,9,436,104,332,151,285,3,2,1,1,2,439,106,333,152,287,194,10.6180980996299,14.4349234657669,0.319281490237626,2020-03-02,2020,3
"1774","ES",3,"Sudeste",32009,"Vitória",1857837,40867.8144563759,10,422,109,313,147,275,2,0,2,0,2,424,109,315,147,277,240,10.6180980996299,14.4349234657669,0.322845903320252,2020-03-09,2020,3
"1775","ES",3,"Sudeste",32009,"Vitória",1857837,40867.8144563759,11,384,102,282,134,250,2,2,0,2,0,386,104,282,136,250,229,10.6180980996299,14.4349234657669,0.423133032642706,2020-03-16,2020,3
"1776","ES",3,"Sudeste",32009,"Vitória",1857837,40867.8144563759,12,391,77,314,132,259,5,2,3,2,3,396,79,317,134,262,228,10.6180980996299,14.4349234657669,0.538254902265865,2020-03-23,2020,3
"1777","ES",3,"Sudeste",32009,"Vitória",1857837,40867.8144563759,13,424,81,343,138,286,5,2,3,1,4,429,83,346,139,290,234,10.6180980996299,14.4349234657669,0.494047218380339,2020-03-30,2020,3
"1778","ES",3,"Sudeste",32009,"Vitória",1857837,40867.8144563759,14,392,81,311,127,265,2,1,1,1,1,394,82,312,128,266,225,10.6180980996299,14.4349234657669,0.476717942720146,2020-04-06,2020,4
"1779","ES",3,"Sudeste",32009,"Vitória",1857837,40867.8144563759,15,490,97,393,172,318,3,2,1,1,2,493,99,394,173,320,221,10.6180980996299,14.4349234657669,0.456165789269991,2020-04-13,2020,4
"1780","ES",3,"Sudeste",32009,"Vitória",1857837,40867.8144563759,16,474,113,361,165,309,2,1,1,1,1,476,114,362,166,310,225,10.6180980996299,14.4349234657669,0.472380397075783,2020-04-20,2020,4
"1781","ES",3,"Sudeste",32009,"Vitória",1857837,40867.8144563759,17,450,115,335,154,296,3,0,3,0,3,453,115,338,154,299,265,10.6180980996299,14.4349234657669,0.449895618661217,2020-04-27,2020,4
"1782","ES",3,"Sudeste",32009,"Vitória",1857837,40867.8144563759,18,441,84,357,139,302,4,1,3,3,1,445,85,360,142,303,244,10.6180980996299,14.4349234657669,0.425804308143289,2020-05-04,2020,5
"1783","ES",3,"Sudeste",32009,"Vitória",1857837,40867.8144563759,19,461,95,366,164,297,4,1,3,3,1,465,96,369,167,298,343,10.6180980996299,14.4349234657669,0.438845976984444,2020-05-11,2020,5
"1784","ES",3,"Sudeste",32009,"Vitória",1857837,40867.8144563759,20,429,102,327,143,286,5,1,4,1,4,434,103,331,144,290,334,10.6180980996299,14.4349234657669,0.425358310600957,2020-05-18,2020,5
"1785","ES",3,"Sudeste",32009,"Vitória",1857837,40867.8144563759,21,494,122,372,179,315,8,6,2,3,5,502,128,374,182,320,377,10.6180980996299,14.4349234657669,0.423553082709683,2020-05-25,2020,5
"1786","ES",3,"Sudeste",32010,"Guarapari",218768,22300.0289937742,5,48,13,35,22,26,0,0,0,0,0,48,13,35,22,26,18,10.0123432576166,12.2957670865489,0.279682990841574,2020-02-03,2020,2
"1787","ES",3,"Sudeste",32010,"Guarapari",218768,22300.0289937742,6,63,22,41,24,39,0,0,0,0,0,63,22,41,24,39,21,10.0123432576166,12.2957670865489,0.279862677729173,2020-02-10,2020,2
"1788","ES",3,"Sudeste",32010,"Guarapari",218768,22300.0289937742,7,58,20,38,15,43,1,1,0,1,0,59,21,38,16,43,25,10.0123432576166,12.2957670865489,0.283448898507832,2020-02-17,2020,2
"1789","ES",3,"Sudeste",32010,"Guarapari",218768,22300.0289937742,8,53,22,31,17,36,1,1,0,1,0,54,23,31,18,36,19,10.0123432576166,12.2957670865489,0.336373325564473,2020-02-24,2020,2
"1790","ES",3,"Sudeste",32010,"Guarapari",218768,22300.0289937742,9,44,9,35,11,33,0,0,0,0,0,44,9,35,11,33,18,10.0123432576166,12.2957670865489,0.322214876732706,2020-03-02,2020,3
"1791","ES",3,"Sudeste",32010,"Guarapari",218768,22300.0289937742,10,41,14,27,20,21,0,0,0,0,0,41,14,27,20,21,27,10.0123432576166,12.2957670865489,0.326187536188071,2020-03-09,2020,3
"1792","ES",3,"Sudeste",32010,"Guarapari",218768,22300.0289937742,11,52,16,36,25,27,0,0,0,0,0,52,16,36,25,27,21,10.0123432576166,12.2957670865489,0.412915609012222,2020-03-16,2020,3
"1793","ES",3,"Sudeste",32010,"Guarapari",218768,22300.0289937742,12,58,13,45,24,34,0,0,0,0,0,58,13,45,24,34,29,10.0123432576166,12.2957670865489,0.511409216605555,2020-03-23,2020,3
"1794","ES",3,"Sudeste",32010,"Guarapari",218768,22300.0289937742,13,56,10,46,22,34,0,0,0,0,0,56,10,46,22,34,24,10.0123432576166,12.2957670865489,0.4694130176052,2020-03-30,2020,3
"1795","ES",3,"Sudeste",32010,"Guarapari",218768,22300.0289937742,14,39,11,28,10,29,2,1,1,0,2,41,12,29,10,31,33,10.0123432576166,12.2957670865489,0.462936538904711,2020-04-06,2020,4
"1796","ES",3,"Sudeste",32010,"Guarapari",218768,22300.0289937742,15,74,14,60,36,38,1,1,0,0,1,75,15,60,36,39,24,10.0123432576166,12.2957670865489,0.437553792280894,2020-04-13,2020,4
"1797","ES",3,"Sudeste",32010,"Guarapari",218768,22300.0289937742,16,71,20,51,19,52,0,0,0,0,0,71,20,51,19,52,25,10.0123432576166,12.2957670865489,0.448562351422412,2020-04-20,2020,4
"1798","ES",3,"Sudeste",32010,"Guarapari",218768,22300.0289937742,17,46,16,30,16,30,1,1,0,1,0,47,17,30,17,30,17,10.0123432576166,12.2957670865489,0.427439092169084,2020-04-27,2020,4
"1799","ES",3,"Sudeste",32010,"Guarapari",218768,22300.0289937742,18,50,17,33,22,28,1,0,1,0,1,51,17,34,22,29,29,10.0123432576166,12.2957670865489,0.408875793775093,2020-05-04,2020,5
"1800","ES",3,"Sudeste",32010,"Guarapari",218768,22300.0289937742,19,53,16,37,18,35,0,0,0,0,0,53,16,37,18,35,20,10.0123432576166,12.2957670865489,0.425510235598979,2020-05-11,2020,5
"1801","ES",3,"Sudeste",32010,"Guarapari",218768,22300.0289937742,20,67,20,47,25,42,0,0,0,0,0,67,20,47,25,42,32,10.0123432576166,12.2957670865489,0.408710552896663,2020-05-18,2020,5
"1802","ES",3,"Sudeste",32010,"Guarapari",218768,22300.0289937742,21,46,10,36,19,27,1,0,1,0,1,47,10,37,19,28,34,10.0123432576166,12.2957670865489,0.40724503050041,2020-05-25,2020,5
"1803","ES",3,"Sudeste",32011,"Alegre",167558,15914.4316392533,5,42,20,22,11,31,0,0,0,0,0,42,20,22,11,31,25,9.6749816268104,12.0290848389668,0.296727286813733,2020-02-03,2020,2
"1804","ES",3,"Sudeste",32011,"Alegre",167558,15914.4316392533,6,31,15,16,12,19,1,1,0,1,0,32,16,16,13,19,22,9.6749816268104,12.0290848389668,0.301619934529044,2020-02-10,2020,2
"1805","ES",3,"Sudeste",32011,"Alegre",167558,15914.4316392533,7,41,12,29,11,30,0,0,0,0,0,41,12,29,11,30,16,9.6749816268104,12.0290848389668,0.301819084178297,2020-02-17,2020,2
"1806","ES",3,"Sudeste",32011,"Alegre",167558,15914.4316392533,8,37,9,28,13,24,0,0,0,0,0,37,9,28,13,24,28,9.6749816268104,12.0290848389668,0.348568793678043,2020-02-24,2020,2
"1807","ES",3,"Sudeste",32011,"Alegre",167558,15914.4316392533,9,32,9,23,11,21,0,0,0,0,0,32,9,23,11,21,10,9.6749816268104,12.0290848389668,0.322391666001749,2020-03-02,2020,3
"1808","ES",3,"Sudeste",32011,"Alegre",167558,15914.4316392533,10,39,11,28,9,30,1,0,1,0,1,40,11,29,9,31,37,9.6749816268104,12.0290848389668,0.321328788449737,2020-03-09,2020,3
"1809","ES",3,"Sudeste",32011,"Alegre",167558,15914.4316392533,11,36,13,23,13,23,0,0,0,0,0,36,13,23,13,23,22,9.6749816268104,12.0290848389668,0.414591959090273,2020-03-16,2020,3
"1810","ES",3,"Sudeste",32011,"Alegre",167558,15914.4316392533,12,33,17,16,17,16,0,0,0,0,0,33,17,16,17,16,27,9.6749816268104,12.0290848389668,0.519102289448771,2020-03-23,2020,3
"1811","ES",3,"Sudeste",32011,"Alegre",167558,15914.4316392533,13,31,13,18,13,18,1,1,0,0,1,32,14,18,13,19,18,9.6749816268104,12.0290848389668,0.466754168292261,2020-03-30,2020,3
"1812","ES",3,"Sudeste",32011,"Alegre",167558,15914.4316392533,14,34,11,23,15,19,0,0,0,0,0,34,11,23,15,19,14,9.6749816268104,12.0290848389668,0.453163372918647,2020-04-06,2020,4
"1813","ES",3,"Sudeste",32011,"Alegre",167558,15914.4316392533,15,35,14,21,11,24,0,0,0,0,0,35,14,21,11,24,18,9.6749816268104,12.0290848389668,0.410299435220744,2020-04-13,2020,4
"1814","ES",3,"Sudeste",32011,"Alegre",167558,15914.4316392533,16,44,18,26,18,26,0,0,0,0,0,44,18,26,18,26,32,9.6749816268104,12.0290848389668,0.430637079895572,2020-04-20,2020,4
"1815","ES",3,"Sudeste",32011,"Alegre",167558,15914.4316392533,17,39,14,25,14,25,0,0,0,0,0,39,14,25,14,25,23,9.6749816268104,12.0290848389668,0.420547730420132,2020-04-27,2020,4
"1816","ES",3,"Sudeste",32011,"Alegre",167558,15914.4316392533,18,35,12,23,16,19,0,0,0,0,0,35,12,23,16,19,21,9.6749816268104,12.0290848389668,0.404582025885932,2020-05-04,2020,5
"1817","ES",3,"Sudeste",32011,"Alegre",167558,15914.4316392533,19,29,13,16,13,16,0,0,0,0,0,29,13,16,13,16,22,9.6749816268104,12.0290848389668,0.422727814901655,2020-05-11,2020,5
"1818","ES",3,"Sudeste",32011,"Alegre",167558,15914.4316392533,20,42,17,25,17,25,0,0,0,0,0,42,17,25,17,25,28,9.6749816268104,12.0290848389668,0.405773320522738,2020-05-18,2020,5
"1819","ES",3,"Sudeste",32011,"Alegre",167558,15914.4316392533,21,42,19,23,16,26,1,1,0,0,1,43,20,23,16,27,30,9.6749816268104,12.0290848389668,0.405339257673695,2020-05-25,2020,5
"1820","ES",3,"Sudeste",32012,"Cachoeiro de Itapemirim",364000,21578.5494701923,5,63,14,49,19,44,0,0,0,0,0,63,14,49,19,44,42,9.97945502015784,12.8049091466189,0.294762285997376,2020-02-03,2020,2
"1821","ES",3,"Sudeste",32012,"Cachoeiro de Itapemirim",364000,21578.5494701923,6,71,15,56,28,43,0,0,0,0,0,71,15,56,28,43,32,9.97945502015784,12.8049091466189,0.288138325581274,2020-02-10,2020,2
"1822","ES",3,"Sudeste",32012,"Cachoeiro de Itapemirim",364000,21578.5494701923,7,70,19,51,22,48,0,0,0,0,0,70,19,51,22,48,45,9.97945502015784,12.8049091466189,0.301792396669828,2020-02-17,2020,2
"1823","ES",3,"Sudeste",32012,"Cachoeiro de Itapemirim",364000,21578.5494701923,8,76,22,54,19,57,1,0,1,1,0,77,22,55,20,57,55,9.97945502015784,12.8049091466189,0.361763506541295,2020-02-24,2020,2
"1824","ES",3,"Sudeste",32012,"Cachoeiro de Itapemirim",364000,21578.5494701923,9,70,20,50,23,47,0,0,0,0,0,70,20,50,23,47,43,9.97945502015784,12.8049091466189,0.323717099855852,2020-03-02,2020,3
"1825","ES",3,"Sudeste",32012,"Cachoeiro de Itapemirim",364000,21578.5494701923,10,84,24,60,32,52,1,0,1,0,1,85,24,61,32,53,42,9.97945502015784,12.8049091466189,0.320863767076697,2020-03-09,2020,3
"1826","ES",3,"Sudeste",32012,"Cachoeiro de Itapemirim",364000,21578.5494701923,11,72,16,56,22,50,0,0,0,0,0,72,16,56,22,50,45,9.97945502015784,12.8049091466189,0.416389385643636,2020-03-16,2020,3
"1827","ES",3,"Sudeste",32012,"Cachoeiro de Itapemirim",364000,21578.5494701923,12,73,16,57,21,52,1,1,0,1,0,74,17,57,22,52,50,9.97945502015784,12.8049091466189,0.512904151281,2020-03-23,2020,3
"1828","ES",3,"Sudeste",32012,"Cachoeiro de Itapemirim",364000,21578.5494701923,13,65,8,57,24,41,0,0,0,0,0,65,8,57,24,41,45,9.97945502015784,12.8049091466189,0.463125969218297,2020-03-30,2020,3
"1829","ES",3,"Sudeste",32012,"Cachoeiro de Itapemirim",364000,21578.5494701923,14,72,16,56,28,44,0,0,0,0,0,72,16,56,28,44,46,9.97945502015784,12.8049091466189,0.456232857727489,2020-04-06,2020,4
"1830","ES",3,"Sudeste",32012,"Cachoeiro de Itapemirim",364000,21578.5494701923,15,105,20,85,39,66,1,0,1,1,0,106,20,86,40,66,47,9.97945502015784,12.8049091466189,0.42089025518291,2020-04-13,2020,4
"1831","ES",3,"Sudeste",32012,"Cachoeiro de Itapemirim",364000,21578.5494701923,16,79,19,60,25,54,1,1,0,0,1,80,20,60,25,55,47,9.97945502015784,12.8049091466189,0.438993642789396,2020-04-20,2020,4
"1832","ES",3,"Sudeste",32012,"Cachoeiro de Itapemirim",364000,21578.5494701923,17,81,15,66,29,52,0,0,0,0,0,81,15,66,29,52,35,9.97945502015784,12.8049091466189,0.420611251037821,2020-04-27,2020,4
"1833","ES",3,"Sudeste",32012,"Cachoeiro de Itapemirim",364000,21578.5494701923,18,85,26,59,26,59,1,0,1,1,0,86,26,60,27,59,48,9.97945502015784,12.8049091466189,0.399846344069931,2020-05-04,2020,5
"1834","ES",3,"Sudeste",32012,"Cachoeiro de Itapemirim",364000,21578.5494701923,19,71,23,48,27,44,1,0,1,0,1,72,23,49,27,45,47,9.97945502015784,12.8049091466189,0.41653223166487,2020-05-11,2020,5
"1835","ES",3,"Sudeste",32012,"Cachoeiro de Itapemirim",364000,21578.5494701923,20,87,18,69,31,56,0,0,0,0,0,87,18,69,31,56,51,9.97945502015784,12.8049091466189,0.404063975910539,2020-05-18,2020,5
"1836","ES",3,"Sudeste",32012,"Cachoeiro de Itapemirim",364000,21578.5494701923,21,81,27,54,35,46,0,0,0,0,0,81,27,54,35,46,58,9.97945502015784,12.8049091466189,0.4020357744903,2020-05-25,2020,5
"1837","ES",3,"Sudeste",32013,"Itapemirim",85197,178417.389445403,5,31,13,18,13,18,0,0,0,0,0,31,13,18,13,18,10,12.0918809688475,11.3527215009299,0.317321317084518,2020-02-03,2020,2
"1838","ES",3,"Sudeste",32013,"Itapemirim",85197,178417.389445403,6,27,5,22,13,14,0,0,0,0,0,27,5,22,13,14,9,12.0918809688475,11.3527215009299,0.294906824307822,2020-02-10,2020,2
"1839","ES",3,"Sudeste",32013,"Itapemirim",85197,178417.389445403,7,26,8,18,14,12,0,0,0,0,0,26,8,18,14,12,13,12.0918809688475,11.3527215009299,0.320312293529613,2020-02-17,2020,2
"1840","ES",3,"Sudeste",32013,"Itapemirim",85197,178417.389445403,8,23,7,16,6,17,0,0,0,0,0,23,7,16,6,17,12,12.0918809688475,11.3527215009299,0.370048480492744,2020-02-24,2020,2
"1841","ES",3,"Sudeste",32013,"Itapemirim",85197,178417.389445403,9,19,5,14,5,14,0,0,0,0,0,19,5,14,5,14,9,12.0918809688475,11.3527215009299,0.341644501878833,2020-03-02,2020,3
"1842","ES",3,"Sudeste",32013,"Itapemirim",85197,178417.389445403,10,24,12,12,11,13,0,0,0,0,0,24,12,12,11,13,6,12.0918809688475,11.3527215009299,0.352112539802454,2020-03-09,2020,3
"1843","ES",3,"Sudeste",32013,"Itapemirim",85197,178417.389445403,11,28,7,21,13,15,0,0,0,0,0,28,7,21,13,15,12,12.0918809688475,11.3527215009299,0.416647641232513,2020-03-16,2020,3
"1844","ES",3,"Sudeste",32013,"Itapemirim",85197,178417.389445403,12,23,7,16,6,17,0,0,0,0,0,23,7,16,6,17,7,12.0918809688475,11.3527215009299,0.509267727693925,2020-03-23,2020,3
"1845","ES",3,"Sudeste",32013,"Itapemirim",85197,178417.389445403,13,15,5,10,3,12,0,0,0,0,0,15,5,10,3,12,8,12.0918809688475,11.3527215009299,0.472703195781045,2020-03-30,2020,3
"1846","ES",3,"Sudeste",32013,"Itapemirim",85197,178417.389445403,14,34,14,20,16,18,0,0,0,0,0,34,14,20,16,18,6,12.0918809688475,11.3527215009299,0.461978212420035,2020-04-06,2020,4
"1847","ES",3,"Sudeste",32013,"Itapemirim",85197,178417.389445403,15,26,5,21,11,15,0,0,0,0,0,26,5,21,11,15,12,12.0918809688475,11.3527215009299,0.43708273337208,2020-04-13,2020,4
"1848","ES",3,"Sudeste",32013,"Itapemirim",85197,178417.389445403,16,27,2,25,10,17,1,0,1,0,1,28,2,26,10,18,16,12.0918809688475,11.3527215009299,0.448934837208256,2020-04-20,2020,4
"1849","ES",3,"Sudeste",32013,"Itapemirim",85197,178417.389445403,17,21,4,17,7,14,0,0,0,0,0,21,4,17,7,14,14,12.0918809688475,11.3527215009299,0.432875745433019,2020-04-27,2020,4
"1850","ES",3,"Sudeste",32013,"Itapemirim",85197,178417.389445403,18,32,8,24,8,24,1,1,0,1,0,33,9,24,9,24,15,12.0918809688475,11.3527215009299,0.430480429111324,2020-05-04,2020,5
"1851","ES",3,"Sudeste",32013,"Itapemirim",85197,178417.389445403,19,26,5,21,9,17,0,0,0,0,0,26,5,21,9,17,16,12.0918809688475,11.3527215009299,0.459653486913539,2020-05-11,2020,5
"1852","ES",3,"Sudeste",32013,"Itapemirim",85197,178417.389445403,20,27,6,21,13,14,1,1,0,0,1,28,7,21,13,15,22,12.0918809688475,11.3527215009299,0.462670772101967,2020-05-18,2020,5
"1853","ES",3,"Sudeste",32013,"Itapemirim",85197,178417.389445403,21,20,4,16,11,9,0,0,0,0,0,20,4,16,11,9,23,12.0918809688475,11.3527215009299,0.443099076746601,2020-05-25,2020,5
"1854","GO",5,"Centro-oeste",52001,"São Miguel do Araguaia",79876,26953.2661020832,5,14,2,12,3,11,0,0,0,0,0,14,2,12,3,11,10,10.201859760166,11.2882307111633,0.326158193184515,2020-02-03,2020,2
"1855","GO",5,"Centro-oeste",52001,"São Miguel do Araguaia",79876,26953.2661020832,6,19,5,14,5,14,0,0,0,0,0,19,5,14,5,14,12,10.201859760166,11.2882307111633,0.310121964163399,2020-02-10,2020,2
"1856","GO",5,"Centro-oeste",52001,"São Miguel do Araguaia",79876,26953.2661020832,7,30,5,25,11,19,0,0,0,0,0,30,5,25,11,19,10,10.201859760166,11.2882307111633,0.310606229164917,2020-02-17,2020,2
"1857","GO",5,"Centro-oeste",52001,"São Miguel do Araguaia",79876,26953.2661020832,8,16,2,14,5,11,0,0,0,0,0,16,2,14,5,11,8,10.201859760166,11.2882307111633,0.348479616705732,2020-02-24,2020,2
"1858","GO",5,"Centro-oeste",52001,"São Miguel do Araguaia",79876,26953.2661020832,9,20,6,14,9,11,0,0,0,0,0,20,6,14,9,11,15,10.201859760166,11.2882307111633,0.338170504330657,2020-03-02,2020,3
"1859","GO",5,"Centro-oeste",52001,"São Miguel do Araguaia",79876,26953.2661020832,10,20,10,10,10,10,0,0,0,0,0,20,10,10,10,10,9,10.201859760166,11.2882307111633,0.351220067072625,2020-03-09,2020,3
"1860","GO",5,"Centro-oeste",52001,"São Miguel do Araguaia",79876,26953.2661020832,11,25,4,21,13,12,0,0,0,0,0,25,4,21,13,12,3,10.201859760166,11.2882307111633,0.412999952184673,2020-03-16,2020,3
"1861","GO",5,"Centro-oeste",52001,"São Miguel do Araguaia",79876,26953.2661020832,12,19,3,16,10,9,0,0,0,0,0,19,3,16,10,9,8,10.201859760166,11.2882307111633,0.480240938657937,2020-03-23,2020,3
"1862","GO",5,"Centro-oeste",52001,"São Miguel do Araguaia",79876,26953.2661020832,13,11,2,9,6,5,0,0,0,0,0,11,2,9,6,5,11,10.201859760166,11.2882307111633,0.435067171224686,2020-03-30,2020,3
"1863","GO",5,"Centro-oeste",52001,"São Miguel do Araguaia",79876,26953.2661020832,14,21,1,20,13,8,0,0,0,0,0,21,1,20,13,8,15,10.201859760166,11.2882307111633,0.419736997136139,2020-04-06,2020,4
"1864","GO",5,"Centro-oeste",52001,"São Miguel do Araguaia",79876,26953.2661020832,15,19,4,15,9,10,0,0,0,0,0,19,4,15,9,10,6,10.201859760166,11.2882307111633,0.405468651277462,2020-04-13,2020,4
"1865","GO",5,"Centro-oeste",52001,"São Miguel do Araguaia",79876,26953.2661020832,16,23,7,16,9,14,0,0,0,0,0,23,7,16,9,14,7,10.201859760166,11.2882307111633,0.409512810733641,2020-04-20,2020,4
"1866","GO",5,"Centro-oeste",52001,"São Miguel do Araguaia",79876,26953.2661020832,17,19,2,17,6,13,0,0,0,0,0,19,2,17,6,13,11,10.201859760166,11.2882307111633,0.400423732095611,2020-04-27,2020,4
"1867","GO",5,"Centro-oeste",52001,"São Miguel do Araguaia",79876,26953.2661020832,18,26,9,17,16,10,0,0,0,0,0,26,9,17,16,10,4,10.201859760166,11.2882307111633,0.383130913581564,2020-05-04,2020,5
"1868","GO",5,"Centro-oeste",52001,"São Miguel do Araguaia",79876,26953.2661020832,19,15,3,12,8,7,0,0,0,0,0,15,3,12,8,7,12,10.201859760166,11.2882307111633,0.401425315795885,2020-05-11,2020,5
"1869","GO",5,"Centro-oeste",52001,"São Miguel do Araguaia",79876,26953.2661020832,20,26,5,21,16,10,0,0,0,0,0,26,5,21,16,10,8,10.201859760166,11.2882307111633,0.386390608292043,2020-05-18,2020,5
"1870","GO",5,"Centro-oeste",52001,"São Miguel do Araguaia",79876,26953.2661020832,21,23,4,19,10,13,0,0,0,0,0,23,4,19,10,13,7,10.201859760166,11.2882307111633,0.402234146349948,2020-05-25,2020,5
"1871","GO",5,"Centro-oeste",52002,"Rio Vermelho",85562,23240.3530130198,5,29,2,27,14,15,0,0,0,0,0,29,2,27,14,15,9,10.0536454007395,11.3569965383322,0.270015154646162,2020-02-03,2020,2
"1872","GO",5,"Centro-oeste",52002,"Rio Vermelho",85562,23240.3530130198,6,14,7,7,9,5,0,0,0,0,0,14,7,7,9,5,14,10.0536454007395,11.3569965383322,0.27157380116888,2020-02-10,2020,2
"1873","GO",5,"Centro-oeste",52002,"Rio Vermelho",85562,23240.3530130198,7,20,4,16,8,12,0,0,0,0,0,20,4,16,8,12,7,10.0536454007395,11.3569965383322,0.283299112346791,2020-02-17,2020,2
"1874","GO",5,"Centro-oeste",52002,"Rio Vermelho",85562,23240.3530130198,8,15,5,10,6,9,0,0,0,0,0,15,5,10,6,9,11,10.0536454007395,11.3569965383322,0.333111568137483,2020-02-24,2020,2
"1875","GO",5,"Centro-oeste",52002,"Rio Vermelho",85562,23240.3530130198,9,15,3,12,6,9,0,0,0,0,0,15,3,12,6,9,16,10.0536454007395,11.3569965383322,0.311309083427569,2020-03-02,2020,3
"1876","GO",5,"Centro-oeste",52002,"Rio Vermelho",85562,23240.3530130198,10,19,2,17,10,9,1,0,1,1,0,20,2,18,11,9,13,10.0536454007395,11.3569965383322,0.326324334965723,2020-03-09,2020,3
"1877","GO",5,"Centro-oeste",52002,"Rio Vermelho",85562,23240.3530130198,11,17,1,16,7,10,0,0,0,0,0,17,1,16,7,10,14,10.0536454007395,11.3569965383322,0.396392823115498,2020-03-16,2020,3
"1878","GO",5,"Centro-oeste",52002,"Rio Vermelho",85562,23240.3530130198,12,15,1,14,6,9,0,0,0,0,0,15,1,14,6,9,12,10.0536454007395,11.3569965383322,0.490775856207844,2020-03-23,2020,3
"1879","GO",5,"Centro-oeste",52002,"Rio Vermelho",85562,23240.3530130198,13,17,4,13,4,13,0,0,0,0,0,17,4,13,4,13,12,10.0536454007395,11.3569965383322,0.436838021715675,2020-03-30,2020,3
"1880","GO",5,"Centro-oeste",52002,"Rio Vermelho",85562,23240.3530130198,14,26,6,20,14,12,0,0,0,0,0,26,6,20,14,12,12,10.0536454007395,11.3569965383322,0.434368065933994,2020-04-06,2020,4
"1881","GO",5,"Centro-oeste",52002,"Rio Vermelho",85562,23240.3530130198,15,17,4,13,9,8,0,0,0,0,0,17,4,13,9,8,8,10.0536454007395,11.3569965383322,0.408120849158049,2020-04-13,2020,4
"1882","GO",5,"Centro-oeste",52002,"Rio Vermelho",85562,23240.3530130198,16,14,1,13,7,7,1,1,0,0,1,15,2,13,7,8,10,10.0536454007395,11.3569965383322,0.401269968292972,2020-04-20,2020,4
"1883","GO",5,"Centro-oeste",52002,"Rio Vermelho",85562,23240.3530130198,17,14,6,8,7,7,0,0,0,0,0,14,6,8,7,7,12,10.0536454007395,11.3569965383322,0.405176091112319,2020-04-27,2020,4
"1884","GO",5,"Centro-oeste",52002,"Rio Vermelho",85562,23240.3530130198,18,17,6,11,7,10,0,0,0,0,0,17,6,11,7,10,14,10.0536454007395,11.3569965383322,0.383714777680702,2020-05-04,2020,5
"1885","GO",5,"Centro-oeste",52002,"Rio Vermelho",85562,23240.3530130198,19,13,1,12,8,5,0,0,0,0,0,13,1,12,8,5,14,10.0536454007395,11.3569965383322,0.393342407264032,2020-05-11,2020,5
"1886","GO",5,"Centro-oeste",52002,"Rio Vermelho",85562,23240.3530130198,20,12,2,10,2,10,0,0,0,0,0,12,2,10,2,10,17,10.0536454007395,11.3569965383322,0.389563220984818,2020-05-18,2020,5
"1887","GO",5,"Centro-oeste",52002,"Rio Vermelho",85562,23240.3530130198,21,18,4,14,6,12,0,0,0,0,0,18,4,14,6,12,12,10.0536454007395,11.3569965383322,0.38442411094909,2020-05-25,2020,5
"1888","GO",5,"Centro-oeste",52003,"Aragarças",57756,23419.4107495325,5,9,1,8,2,7,0,0,0,0,0,9,1,8,2,7,7,10.0613204766957,10.9639825190911,0.288306374007293,2020-02-03,2020,2
"1889","GO",5,"Centro-oeste",52003,"Aragarças",57756,23419.4107495325,6,11,1,10,6,5,0,0,0,0,0,11,1,10,6,5,4,10.0613204766957,10.9639825190911,0.290101413489276,2020-02-10,2020,2
"1890","GO",5,"Centro-oeste",52003,"Aragarças",57756,23419.4107495325,7,12,3,9,4,8,0,0,0,0,0,12,3,9,4,8,4,10.0613204766957,10.9639825190911,0.293853992237854,2020-02-17,2020,2
"1891","GO",5,"Centro-oeste",52003,"Aragarças",57756,23419.4107495325,8,17,3,14,12,5,0,0,0,0,0,17,3,14,12,5,7,10.0613204766957,10.9639825190911,0.340569840223697,2020-02-24,2020,2
"1892","GO",5,"Centro-oeste",52003,"Aragarças",57756,23419.4107495325,9,7,1,6,1,6,0,0,0,0,0,7,1,6,1,6,3,10.0613204766957,10.9639825190911,0.321085493490346,2020-03-02,2020,3
"1893","GO",5,"Centro-oeste",52003,"Aragarças",57756,23419.4107495325,10,9,2,7,3,6,0,0,0,0,0,9,2,7,3,6,7,10.0613204766957,10.9639825190911,0.339910702934669,2020-03-09,2020,3
"1894","GO",5,"Centro-oeste",52003,"Aragarças",57756,23419.4107495325,11,8,3,5,2,6,0,0,0,0,0,8,3,5,2,6,12,10.0613204766957,10.9639825190911,0.405698561842819,2020-03-16,2020,3
"1895","GO",5,"Centro-oeste",52003,"Aragarças",57756,23419.4107495325,12,5,2,3,3,2,1,1,0,0,1,6,3,3,3,3,6,10.0613204766957,10.9639825190911,0.465225918757394,2020-03-23,2020,3
"1896","GO",5,"Centro-oeste",52003,"Aragarças",57756,23419.4107495325,13,9,1,8,4,5,0,0,0,0,0,9,1,8,4,5,7,10.0613204766957,10.9639825190911,0.427011409765356,2020-03-30,2020,3
"1897","GO",5,"Centro-oeste",52003,"Aragarças",57756,23419.4107495325,14,10,3,7,6,4,0,0,0,0,0,10,3,7,6,4,10,10.0613204766957,10.9639825190911,0.412607723309775,2020-04-06,2020,4
"1898","GO",5,"Centro-oeste",52003,"Aragarças",57756,23419.4107495325,15,10,0,10,4,6,0,0,0,0,0,10,0,10,4,6,7,10.0613204766957,10.9639825190911,0.393594059478679,2020-04-13,2020,4
"1899","GO",5,"Centro-oeste",52003,"Aragarças",57756,23419.4107495325,16,9,1,8,4,5,0,0,0,0,0,9,1,8,4,5,6,10.0613204766957,10.9639825190911,0.410805818493758,2020-04-20,2020,4
"1900","GO",5,"Centro-oeste",52003,"Aragarças",57756,23419.4107495325,17,9,2,7,5,4,0,0,0,0,0,9,2,7,5,4,6,10.0613204766957,10.9639825190911,0.401881513861072,2020-04-27,2020,4
"1901","GO",5,"Centro-oeste",52003,"Aragarças",57756,23419.4107495325,18,8,3,5,3,5,0,0,0,0,0,8,3,5,3,5,11,10.0613204766957,10.9639825190911,0.385355894315271,2020-05-04,2020,5
"1902","GO",5,"Centro-oeste",52003,"Aragarças",57756,23419.4107495325,19,17,2,15,4,13,0,0,0,0,0,17,2,15,4,13,8,10.0613204766957,10.9639825190911,0.413662410668161,2020-05-11,2020,5
"1903","GO",5,"Centro-oeste",52003,"Aragarças",57756,23419.4107495325,20,11,2,9,8,3,0,0,0,0,0,11,2,9,8,3,4,10.0613204766957,10.9639825190911,0.40552652515506,2020-05-18,2020,5
"1904","GO",5,"Centro-oeste",52003,"Aragarças",57756,23419.4107495325,21,14,4,10,9,5,0,0,0,0,0,14,4,10,9,5,10,10.0613204766957,10.9639825190911,0.398791107227921,2020-05-25,2020,5
"1905","GO",5,"Centro-oeste",52004,"Porangatu",238511,25626.3679325901,5,53,17,36,24,29,1,0,1,1,0,54,17,37,25,29,20,10.1513770977511,12.3821707098403,0.296932895717529,2020-02-03,2020,2
"1906","GO",5,"Centro-oeste",52004,"Porangatu",238511,25626.3679325901,6,47,5,42,23,24,1,0,1,1,0,48,5,43,24,24,39,10.1513770977511,12.3821707098403,0.277770387229149,2020-02-10,2020,2
"1907","GO",5,"Centro-oeste",52004,"Porangatu",238511,25626.3679325901,7,54,7,47,20,34,1,1,0,1,0,55,8,47,21,34,33,10.1513770977511,12.3821707098403,0.287385396115012,2020-02-17,2020,2
"1908","GO",5,"Centro-oeste",52004,"Porangatu",238511,25626.3679325901,8,38,5,33,19,19,1,1,0,0,1,39,6,33,19,20,28,10.1513770977511,12.3821707098403,0.332821206909774,2020-02-24,2020,2
"1909","GO",5,"Centro-oeste",52004,"Porangatu",238511,25626.3679325901,9,31,2,29,17,14,1,0,1,0,1,32,2,30,17,15,26,10.1513770977511,12.3821707098403,0.311545484891117,2020-03-02,2020,3
"1910","GO",5,"Centro-oeste",52004,"Porangatu",238511,25626.3679325901,10,29,8,21,12,17,0,0,0,0,0,29,8,21,12,17,31,10.1513770977511,12.3821707098403,0.320102425329103,2020-03-09,2020,3
"1911","GO",5,"Centro-oeste",52004,"Porangatu",238511,25626.3679325901,11,48,9,39,18,30,1,0,1,1,0,49,9,40,19,30,39,10.1513770977511,12.3821707098403,0.402438317228997,2020-03-16,2020,3
"1912","GO",5,"Centro-oeste",52004,"Porangatu",238511,25626.3679325901,12,41,8,33,21,20,0,0,0,0,0,41,8,33,21,20,24,10.1513770977511,12.3821707098403,0.473681209926459,2020-03-23,2020,3
"1913","GO",5,"Centro-oeste",52004,"Porangatu",238511,25626.3679325901,13,40,10,30,18,22,1,0,1,0,1,41,10,31,18,23,38,10.1513770977511,12.3821707098403,0.423524045212159,2020-03-30,2020,3
"1914","GO",5,"Centro-oeste",52004,"Porangatu",238511,25626.3679325901,14,49,11,38,32,17,0,0,0,0,0,49,11,38,32,17,29,10.1513770977511,12.3821707098403,0.432422769436597,2020-04-06,2020,4
"1915","GO",5,"Centro-oeste",52004,"Porangatu",238511,25626.3679325901,15,61,10,51,28,33,2,1,1,0,2,63,11,52,28,35,24,10.1513770977511,12.3821707098403,0.398467171267486,2020-04-13,2020,4
"1916","GO",5,"Centro-oeste",52004,"Porangatu",238511,25626.3679325901,16,50,10,40,26,24,0,0,0,0,0,50,10,40,26,24,26,10.1513770977511,12.3821707098403,0.395906417928154,2020-04-20,2020,4
"1917","GO",5,"Centro-oeste",52004,"Porangatu",238511,25626.3679325901,17,57,10,47,30,27,0,0,0,0,0,57,10,47,30,27,20,10.1513770977511,12.3821707098403,0.389714467020829,2020-04-27,2020,4
"1918","GO",5,"Centro-oeste",52004,"Porangatu",238511,25626.3679325901,18,52,8,44,21,31,0,0,0,0,0,52,8,44,21,31,25,10.1513770977511,12.3821707098403,0.375920290839321,2020-05-04,2020,5
"1919","GO",5,"Centro-oeste",52004,"Porangatu",238511,25626.3679325901,19,54,9,45,27,27,0,0,0,0,0,54,9,45,27,27,36,10.1513770977511,12.3821707098403,0.389199975421387,2020-05-11,2020,5
"1920","GO",5,"Centro-oeste",52004,"Porangatu",238511,25626.3679325901,20,51,12,39,20,31,0,0,0,0,0,51,12,39,20,31,24,10.1513770977511,12.3821707098403,0.395266769820645,2020-05-18,2020,5
"1921","GO",5,"Centro-oeste",52004,"Porangatu",238511,25626.3679325901,21,58,9,49,23,35,0,0,0,0,0,58,9,49,23,35,29,10.1513770977511,12.3821707098403,0.387378993166385,2020-05-25,2020,5
"1922","GO",5,"Centro-oeste",52005,"Chapada dos Veadeiros",70283,17227.2224920678,5,20,9,11,9,11,0,0,0,0,0,20,9,11,9,11,9,9.75424611467427,11.1602852277873,0.28982920794306,2020-02-03,2020,2
"1923","GO",5,"Centro-oeste",52005,"Chapada dos Veadeiros",70283,17227.2224920678,6,20,5,15,11,9,0,0,0,0,0,20,5,15,11,9,9,9.75424611467427,11.1602852277873,0.267217195870521,2020-02-10,2020,2
"1924","GO",5,"Centro-oeste",52005,"Chapada dos Veadeiros",70283,17227.2224920678,7,16,7,9,10,6,1,0,1,0,1,17,7,10,10,7,7,9.75424611467427,11.1602852277873,0.284832674601671,2020-02-17,2020,2
"1925","GO",5,"Centro-oeste",52005,"Chapada dos Veadeiros",70283,17227.2224920678,8,22,7,15,5,17,0,0,0,0,0,22,7,15,5,17,9,9.75424611467427,11.1602852277873,0.311707394966323,2020-02-24,2020,2
"1926","GO",5,"Centro-oeste",52005,"Chapada dos Veadeiros",70283,17227.2224920678,9,23,4,19,10,13,0,0,0,0,0,23,4,19,10,13,6,9.75424611467427,11.1602852277873,0.313171060109056,2020-03-02,2020,3
"1927","GO",5,"Centro-oeste",52005,"Chapada dos Veadeiros",70283,17227.2224920678,10,18,5,13,7,11,0,0,0,0,0,18,5,13,7,11,8,9.75424611467427,11.1602852277873,0.312925003097852,2020-03-09,2020,3
"1928","GO",5,"Centro-oeste",52005,"Chapada dos Veadeiros",70283,17227.2224920678,11,15,1,14,6,9,0,0,0,0,0,15,1,14,6,9,3,9.75424611467427,11.1602852277873,0.390709450642522,2020-03-16,2020,3
"1929","GO",5,"Centro-oeste",52005,"Chapada dos Veadeiros",70283,17227.2224920678,12,15,2,13,7,8,0,0,0,0,0,15,2,13,7,8,6,9.75424611467427,11.1602852277873,0.47702310098539,2020-03-23,2020,3
"1930","GO",5,"Centro-oeste",52005,"Chapada dos Veadeiros",70283,17227.2224920678,13,16,5,11,10,6,0,0,0,0,0,16,5,11,10,6,5,9.75424611467427,11.1602852277873,0.411230357502716,2020-03-30,2020,3
"1931","GO",5,"Centro-oeste",52005,"Chapada dos Veadeiros",70283,17227.2224920678,14,20,2,18,8,12,0,0,0,0,0,20,2,18,8,12,6,9.75424611467427,11.1602852277873,0.416345310487565,2020-04-06,2020,4
"1932","GO",5,"Centro-oeste",52005,"Chapada dos Veadeiros",70283,17227.2224920678,15,14,2,12,3,11,1,0,1,1,0,15,2,13,4,11,5,9.75424611467427,11.1602852277873,0.388978737864249,2020-04-13,2020,4
"1933","GO",5,"Centro-oeste",52005,"Chapada dos Veadeiros",70283,17227.2224920678,16,10,1,9,3,7,0,0,0,0,0,10,1,9,3,7,9,9.75424611467427,11.1602852277873,0.393263745176338,2020-04-20,2020,4
"1934","GO",5,"Centro-oeste",52005,"Chapada dos Veadeiros",70283,17227.2224920678,17,13,6,7,2,11,0,0,0,0,0,13,6,7,2,11,8,9.75424611467427,11.1602852277873,0.386595917217927,2020-04-27,2020,4
"1935","GO",5,"Centro-oeste",52005,"Chapada dos Veadeiros",70283,17227.2224920678,18,18,5,13,9,9,0,0,0,0,0,18,5,13,9,9,4,9.75424611467427,11.1602852277873,0.398523108007773,2020-05-04,2020,5
"1936","GO",5,"Centro-oeste",52005,"Chapada dos Veadeiros",70283,17227.2224920678,19,14,7,7,6,8,0,0,0,0,0,14,7,7,6,8,5,9.75424611467427,11.1602852277873,0.403409138927993,2020-05-11,2020,5
"1937","GO",5,"Centro-oeste",52005,"Chapada dos Veadeiros",70283,17227.2224920678,20,21,7,14,13,8,0,0,0,0,0,21,7,14,13,8,7,9.75424611467427,11.1602852277873,0.396261260163827,2020-05-18,2020,5
"1938","GO",5,"Centro-oeste",52005,"Chapada dos Veadeiros",70283,17227.2224920678,21,21,9,12,11,10,0,0,0,0,0,21,9,12,11,10,10,9.75424611467427,11.1602852277873,0.388864594690295,2020-05-25,2020,5
"1939","GO",5,"Centro-oeste",52006,"Ceres",253005,23051.9189190727,5,66,7,59,23,43,0,0,0,0,0,66,7,59,23,43,36,10.0455042952448,12.4411645303602,0.306550491936535,2020-02-03,2020,2
"1940","GO",5,"Centro-oeste",52006,"Ceres",253005,23051.9189190727,6,51,7,44,22,29,0,0,0,0,0,51,7,44,22,29,42,10.0455042952448,12.4411645303602,0.292965597844796,2020-02-10,2020,2
"1941","GO",5,"Centro-oeste",52006,"Ceres",253005,23051.9189190727,7,52,7,45,21,31,0,0,0,0,0,52,7,45,21,31,24,10.0455042952448,12.4411645303602,0.293549367609152,2020-02-17,2020,2
"1942","GO",5,"Centro-oeste",52006,"Ceres",253005,23051.9189190727,8,48,4,44,19,29,2,0,2,0,2,50,4,46,19,31,36,10.0455042952448,12.4411645303602,0.336284103382258,2020-02-24,2020,2
"1943","GO",5,"Centro-oeste",52006,"Ceres",253005,23051.9189190727,9,57,10,47,15,42,1,0,1,0,1,58,10,48,15,43,28,10.0455042952448,12.4411645303602,0.323606389000024,2020-03-02,2020,3
"1944","GO",5,"Centro-oeste",52006,"Ceres",253005,23051.9189190727,10,43,7,36,16,27,1,0,1,1,0,44,7,37,17,27,40,10.0455042952448,12.4411645303602,0.32849819936069,2020-03-09,2020,3
"1945","GO",5,"Centro-oeste",52006,"Ceres",253005,23051.9189190727,11,50,8,42,30,20,2,0,2,1,1,52,8,44,31,21,38,10.0455042952448,12.4411645303602,0.410145466658291,2020-03-16,2020,3
"1946","GO",5,"Centro-oeste",52006,"Ceres",253005,23051.9189190727,12,47,5,42,21,26,0,0,0,0,0,47,5,42,21,26,36,10.0455042952448,12.4411645303602,0.495474521685752,2020-03-23,2020,3
"1947","GO",5,"Centro-oeste",52006,"Ceres",253005,23051.9189190727,13,33,4,29,13,20,0,0,0,0,0,33,4,29,13,20,24,10.0455042952448,12.4411645303602,0.444959080458118,2020-03-30,2020,3
"1948","GO",5,"Centro-oeste",52006,"Ceres",253005,23051.9189190727,14,53,16,37,19,34,0,0,0,0,0,53,16,37,19,34,34,10.0455042952448,12.4411645303602,0.435257439114642,2020-04-06,2020,4
"1949","GO",5,"Centro-oeste",52006,"Ceres",253005,23051.9189190727,15,38,8,30,15,23,0,0,0,0,0,38,8,30,15,23,27,10.0455042952448,12.4411645303602,0.418576199954841,2020-04-13,2020,4
"1950","GO",5,"Centro-oeste",52006,"Ceres",253005,23051.9189190727,16,54,9,45,24,30,0,0,0,0,0,54,9,45,24,30,33,10.0455042952448,12.4411645303602,0.418170458666936,2020-04-20,2020,4
"1951","GO",5,"Centro-oeste",52006,"Ceres",253005,23051.9189190727,17,45,3,42,14,31,2,1,1,0,2,47,4,43,14,33,35,10.0455042952448,12.4411645303602,0.396437963338456,2020-04-27,2020,4
"1952","GO",5,"Centro-oeste",52006,"Ceres",253005,23051.9189190727,18,48,10,38,20,28,1,0,1,0,1,49,10,39,20,29,32,10.0455042952448,12.4411645303602,0.376162829041994,2020-05-04,2020,5
"1953","GO",5,"Centro-oeste",52006,"Ceres",253005,23051.9189190727,19,60,10,50,22,38,2,0,2,2,0,62,10,52,24,38,32,10.0455042952448,12.4411645303602,0.386455890901431,2020-05-11,2020,5
"1954","GO",5,"Centro-oeste",52006,"Ceres",253005,23051.9189190727,20,80,11,69,26,54,0,0,0,0,0,80,11,69,26,54,26,10.0455042952448,12.4411645303602,0.38747578708475,2020-05-18,2020,5
"1955","GO",5,"Centro-oeste",52006,"Ceres",253005,23051.9189190727,21,63,16,47,27,36,2,2,0,1,1,65,18,47,28,37,33,10.0455042952448,12.4411645303602,0.374974223592196,2020-05-25,2020,5
"1956","GO",5,"Centro-oeste",52007,"Anápolis",624349,30789.8985494331,5,171,27,144,75,96,1,0,1,1,0,172,27,145,76,96,69,10.3349419459938,13.3444647858763,0.287627969788398,2020-02-03,2020,2
"1957","GO",5,"Centro-oeste",52007,"Anápolis",624349,30789.8985494331,6,153,16,137,48,105,3,1,2,2,1,156,17,139,50,106,65,10.3349419459938,13.3444647858763,0.279967220216502,2020-02-10,2020,2
"1958","GO",5,"Centro-oeste",52007,"Anápolis",624349,30789.8985494331,7,149,18,131,48,101,1,0,1,0,1,150,18,132,48,102,79,10.3349419459938,13.3444647858763,0.293542001921637,2020-02-17,2020,2
"1959","GO",5,"Centro-oeste",52007,"Anápolis",624349,30789.8985494331,8,120,21,99,44,76,2,1,1,0,2,122,22,100,44,78,74,10.3349419459938,13.3444647858763,0.337108620658443,2020-02-24,2020,2
"1960","GO",5,"Centro-oeste",52007,"Anápolis",624349,30789.8985494331,9,124,23,101,42,82,0,0,0,0,0,124,23,101,42,82,91,10.3349419459938,13.3444647858763,0.307829755927877,2020-03-02,2020,3
"1961","GO",5,"Centro-oeste",52007,"Anápolis",624349,30789.8985494331,10,134,24,110,49,85,0,0,0,0,0,134,24,110,49,85,93,10.3349419459938,13.3444647858763,0.31810475999067,2020-03-09,2020,3
"1962","GO",5,"Centro-oeste",52007,"Anápolis",624349,30789.8985494331,11,126,30,96,38,88,0,0,0,0,0,126,30,96,38,88,85,10.3349419459938,13.3444647858763,0.412256209500315,2020-03-16,2020,3
"1963","GO",5,"Centro-oeste",52007,"Anápolis",624349,30789.8985494331,12,111,19,92,40,71,1,0,1,0,1,112,19,93,40,72,78,10.3349419459938,13.3444647858763,0.497324621362049,2020-03-23,2020,3
"1964","GO",5,"Centro-oeste",52007,"Anápolis",624349,30789.8985494331,13,121,16,105,35,86,1,0,1,0,1,122,16,106,35,87,85,10.3349419459938,13.3444647858763,0.443567830818404,2020-03-30,2020,3
"1965","GO",5,"Centro-oeste",52007,"Anápolis",624349,30789.8985494331,14,139,24,115,57,82,3,2,1,2,1,142,26,116,59,83,69,10.3349419459938,13.3444647858763,0.43193739782626,2020-04-06,2020,4
"1966","GO",5,"Centro-oeste",52007,"Anápolis",624349,30789.8985494331,15,150,26,124,56,94,2,2,0,1,1,152,28,124,57,95,70,10.3349419459938,13.3444647858763,0.41405479091145,2020-04-13,2020,4
"1967","GO",5,"Centro-oeste",52007,"Anápolis",624349,30789.8985494331,16,189,43,146,73,116,0,0,0,0,0,189,43,146,73,116,77,10.3349419459938,13.3444647858763,0.410405725109069,2020-04-20,2020,4
"1968","GO",5,"Centro-oeste",52007,"Anápolis",624349,30789.8985494331,17,158,16,142,59,99,3,2,1,3,0,161,18,143,62,99,59,10.3349419459938,13.3444647858763,0.390968078212486,2020-04-27,2020,4
"1969","GO",5,"Centro-oeste",52007,"Anápolis",624349,30789.8985494331,18,172,22,150,60,112,1,0,1,1,0,173,22,151,61,112,97,10.3349419459938,13.3444647858763,0.367239685780803,2020-05-04,2020,5
"1970","GO",5,"Centro-oeste",52007,"Anápolis",624349,30789.8985494331,19,158,19,139,57,101,0,0,0,0,0,158,19,139,57,101,89,10.3349419459938,13.3444647858763,0.37511225505991,2020-05-11,2020,5
"1971","GO",5,"Centro-oeste",52007,"Anápolis",624349,30789.8985494331,20,165,28,137,63,102,0,0,0,0,0,165,28,137,63,102,71,10.3349419459938,13.3444647858763,0.372099841370631,2020-05-18,2020,5
"1972","GO",5,"Centro-oeste",52007,"Anápolis",624349,30789.8985494331,21,160,24,136,73,87,1,0,1,0,1,161,24,137,73,88,68,10.3349419459938,13.3444647858763,0.365232738378077,2020-05-25,2020,5
"1973","GO",5,"Centro-oeste",52008,"Iporá",56077,20533.9594086702,5,18,2,16,5,13,1,0,1,0,1,19,2,17,5,14,7,9.92983535107066,10.9344810252704,0.281673456742966,2020-02-03,2020,2
"1974","GO",5,"Centro-oeste",52008,"Iporá",56077,20533.9594086702,6,10,2,8,3,7,0,0,0,0,0,10,2,8,3,7,7,9.92983535107066,10.9344810252704,0.266114792032644,2020-02-10,2020,2
"1975","GO",5,"Centro-oeste",52008,"Iporá",56077,20533.9594086702,7,10,0,10,9,1,0,0,0,0,0,10,0,10,9,1,3,9.92983535107066,10.9344810252704,0.286993510949893,2020-02-17,2020,2
"1976","GO",5,"Centro-oeste",52008,"Iporá",56077,20533.9594086702,8,15,0,15,4,11,1,1,0,0,1,16,1,15,4,12,11,9.92983535107066,10.9344810252704,0.325854996148398,2020-02-24,2020,2
"1977","GO",5,"Centro-oeste",52008,"Iporá",56077,20533.9594086702,9,6,0,6,3,3,0,0,0,0,0,6,0,6,3,3,9,9.92983535107066,10.9344810252704,0.29369240000227,2020-03-02,2020,3
"1978","GO",5,"Centro-oeste",52008,"Iporá",56077,20533.9594086702,10,7,2,5,2,5,0,0,0,0,0,7,2,5,2,5,8,9.92983535107066,10.9344810252704,0.301609936768473,2020-03-09,2020,3
"1979","GO",5,"Centro-oeste",52008,"Iporá",56077,20533.9594086702,11,5,0,5,2,3,0,0,0,0,0,5,0,5,2,3,8,9.92983535107066,10.9344810252704,0.374517376584016,2020-03-16,2020,3
"1980","GO",5,"Centro-oeste",52008,"Iporá",56077,20533.9594086702,12,11,0,11,1,10,0,0,0,0,0,11,0,11,1,10,4,9.92983535107066,10.9344810252704,0.456091747213924,2020-03-23,2020,3
"1981","GO",5,"Centro-oeste",52008,"Iporá",56077,20533.9594086702,13,10,0,10,3,7,0,0,0,0,0,10,0,10,3,7,8,9.92983535107066,10.9344810252704,0.393783714221193,2020-03-30,2020,3
"1982","GO",5,"Centro-oeste",52008,"Iporá",56077,20533.9594086702,14,14,1,13,2,12,0,0,0,0,0,14,1,13,2,12,7,9.92983535107066,10.9344810252704,0.380556000003533,2020-04-06,2020,4
"1983","GO",5,"Centro-oeste",52008,"Iporá",56077,20533.9594086702,15,14,1,13,5,9,0,0,0,0,0,14,1,13,5,9,6,9.92983535107066,10.9344810252704,0.368971158168699,2020-04-13,2020,4
"1984","GO",5,"Centro-oeste",52008,"Iporá",56077,20533.9594086702,16,11,1,10,4,7,0,0,0,0,0,11,1,10,4,7,7,9.92983535107066,10.9344810252704,0.371129937845578,2020-04-20,2020,4
"1985","GO",5,"Centro-oeste",52008,"Iporá",56077,20533.9594086702,17,11,0,11,5,6,0,0,0,0,0,11,0,11,5,6,12,9.92983535107066,10.9344810252704,0.357531354816505,2020-04-27,2020,4
"1986","GO",5,"Centro-oeste",52008,"Iporá",56077,20533.9594086702,18,9,0,9,5,4,0,0,0,0,0,9,0,9,5,4,8,9.92983535107066,10.9344810252704,0.350427663237911,2020-05-04,2020,5
"1987","GO",5,"Centro-oeste",52008,"Iporá",56077,20533.9594086702,19,11,0,11,6,5,0,0,0,0,0,11,0,11,6,5,12,9.92983535107066,10.9344810252704,0.335327659818317,2020-05-11,2020,5
"1988","GO",5,"Centro-oeste",52008,"Iporá",56077,20533.9594086702,20,15,4,11,5,10,0,0,0,0,0,15,4,11,5,10,9,9.92983535107066,10.9344810252704,0.347456562973082,2020-05-18,2020,5
"1989","GO",5,"Centro-oeste",52008,"Iporá",56077,20533.9594086702,21,12,3,9,6,6,0,0,0,0,0,12,3,9,6,6,11,9.92983535107066,10.9344810252704,0.354669509681593,2020-05-25,2020,5
"1990","GO",5,"Centro-oeste",52009,"Anicuns",118506,18972.7094585084,5,33,4,29,12,21,0,0,0,0,0,33,4,29,12,21,19,9.85075688132826,11.6827188711869,0.294511000493825,2020-02-03,2020,2
"1991","GO",5,"Centro-oeste",52009,"Anicuns",118506,18972.7094585084,6,17,3,14,6,11,0,0,0,0,0,17,3,14,6,11,23,9.85075688132826,11.6827188711869,0.281683989874143,2020-02-10,2020,2
"1992","GO",5,"Centro-oeste",52009,"Anicuns",118506,18972.7094585084,7,26,3,23,15,11,0,0,0,0,0,26,3,23,15,11,15,9.85075688132826,11.6827188711869,0.29555091260365,2020-02-17,2020,2
"1993","GO",5,"Centro-oeste",52009,"Anicuns",118506,18972.7094585084,8,23,5,18,14,9,0,0,0,0,0,23,5,18,14,9,18,9.85075688132826,11.6827188711869,0.334167509958534,2020-02-24,2020,2
"1994","GO",5,"Centro-oeste",52009,"Anicuns",118506,18972.7094585084,9,18,3,15,5,13,0,0,0,0,0,18,3,15,5,13,8,9.85075688132826,11.6827188711869,0.314612406667454,2020-03-02,2020,3
"1995","GO",5,"Centro-oeste",52009,"Anicuns",118506,18972.7094585084,10,12,2,10,5,7,0,0,0,0,0,12,2,10,5,7,14,9.85075688132826,11.6827188711869,0.331269771025176,2020-03-09,2020,3
"1996","GO",5,"Centro-oeste",52009,"Anicuns",118506,18972.7094585084,11,17,5,12,5,12,0,0,0,0,0,17,5,12,5,12,17,9.85075688132826,11.6827188711869,0.415287026790244,2020-03-16,2020,3
"1997","GO",5,"Centro-oeste",52009,"Anicuns",118506,18972.7094585084,12,15,2,13,7,8,0,0,0,0,0,15,2,13,7,8,11,9.85075688132826,11.6827188711869,0.49223305059069,2020-03-23,2020,3
"1998","GO",5,"Centro-oeste",52009,"Anicuns",118506,18972.7094585084,13,18,2,16,6,12,1,0,1,0,1,19,2,17,6,13,14,9.85075688132826,11.6827188711869,0.43272370520967,2020-03-30,2020,3
"1999","GO",5,"Centro-oeste",52009,"Anicuns",118506,18972.7094585084,14,24,4,20,11,13,1,0,1,1,0,25,4,21,12,13,16,9.85075688132826,11.6827188711869,0.422208141506552,2020-04-06,2020,4
"2000","GO",5,"Centro-oeste",52009,"Anicuns",118506,18972.7094585084,15,19,2,17,7,12,0,0,0,0,0,19,2,17,7,12,10,9.85075688132826,11.6827188711869,0.412243326847251,2020-04-13,2020,4
"2001","GO",5,"Centro-oeste",52009,"Anicuns",118506,18972.7094585084,16,25,6,19,11,14,0,0,0,0,0,25,6,19,11,14,13,9.85075688132826,11.6827188711869,0.398349006683287,2020-04-20,2020,4
"2002","GO",5,"Centro-oeste",52009,"Anicuns",118506,18972.7094585084,17,28,2,26,10,18,0,0,0,0,0,28,2,26,10,18,16,9.85075688132826,11.6827188711869,0.386435758591902,2020-04-27,2020,4
"2003","GO",5,"Centro-oeste",52009,"Anicuns",118506,18972.7094585084,18,14,4,10,3,11,1,1,0,0,1,15,5,10,3,12,13,9.85075688132826,11.6827188711869,0.367352102027448,2020-05-04,2020,5
"2004","GO",5,"Centro-oeste",52009,"Anicuns",118506,18972.7094585084,19,18,1,17,5,13,0,0,0,0,0,18,1,17,5,13,16,9.85075688132826,11.6827188711869,0.367654450375768,2020-05-11,2020,5
"2005","GO",5,"Centro-oeste",52009,"Anicuns",118506,18972.7094585084,20,23,1,22,5,18,1,1,0,1,0,24,2,22,6,18,17,9.85075688132826,11.6827188711869,0.3614777075311,2020-05-18,2020,5
"2006","GO",5,"Centro-oeste",52009,"Anicuns",118506,18972.7094585084,21,24,4,20,9,15,0,0,0,0,0,24,4,20,9,15,23,9.85075688132826,11.6827188711869,0.368642718837531,2020-05-25,2020,5
"2007","GO",5,"Centro-oeste",52010,"Goiânia",2583753,29461.4870868887,5,616,89,527,207,409,4,1,3,1,3,620,90,530,208,412,277,10.2908391669127,14.7647535510805,0.267713908518357,2020-02-03,2020,2
"2008","GO",5,"Centro-oeste",52010,"Goiânia",2583753,29461.4870868887,6,585,99,486,189,396,3,1,2,1,2,588,100,488,190,398,272,10.2908391669127,14.7647535510805,0.263188672198417,2020-02-10,2020,2
"2009","GO",5,"Centro-oeste",52010,"Goiânia",2583753,29461.4870868887,7,600,101,499,207,393,3,1,2,0,3,603,102,501,207,396,270,10.2908391669127,14.7647535510805,0.278569715782545,2020-02-17,2020,2
"2010","GO",5,"Centro-oeste",52010,"Goiânia",2583753,29461.4870868887,8,506,83,423,174,332,6,3,3,3,3,512,86,426,177,335,270,10.2908391669127,14.7647535510805,0.330403632091647,2020-02-24,2020,2
"2011","GO",5,"Centro-oeste",52010,"Goiânia",2583753,29461.4870868887,9,559,87,472,217,342,6,2,4,1,5,565,89,476,218,347,263,10.2908391669127,14.7647535510805,0.296157579852456,2020-03-02,2020,3
"2012","GO",5,"Centro-oeste",52010,"Goiânia",2583753,29461.4870868887,10,546,108,438,190,356,8,3,5,0,8,554,111,443,190,364,281,10.2908391669127,14.7647535510805,0.305613086274785,2020-03-09,2020,3
"2013","GO",5,"Centro-oeste",52010,"Goiânia",2583753,29461.4870868887,11,629,99,530,236,393,5,0,5,3,2,634,99,535,239,395,282,10.2908391669127,14.7647535510805,0.413558179347375,2020-03-16,2020,3
"2014","GO",5,"Centro-oeste",52010,"Goiânia",2583753,29461.4870868887,12,554,89,465,199,355,5,0,5,2,3,559,89,470,201,358,272,10.2908391669127,14.7647535510805,0.525602299396998,2020-03-23,2020,3
"2015","GO",5,"Centro-oeste",52010,"Goiânia",2583753,29461.4870868887,13,541,92,449,188,353,8,1,7,2,6,549,93,456,190,359,280,10.2908391669127,14.7647535510805,0.470119026189295,2020-03-30,2020,3
"2016","GO",5,"Centro-oeste",52010,"Goiânia",2583753,29461.4870868887,14,575,94,481,201,374,5,1,4,2,3,580,95,485,203,377,278,10.2908391669127,14.7647535510805,0.451832698527617,2020-04-06,2020,4
"2017","GO",5,"Centro-oeste",52010,"Goiânia",2583753,29461.4870868887,15,563,88,475,206,357,5,3,2,4,1,568,91,477,210,358,270,10.2908391669127,14.7647535510805,0.4382836655505,2020-04-13,2020,4
"2018","GO",5,"Centro-oeste",52010,"Goiânia",2583753,29461.4870868887,16,610,103,507,222,388,2,0,2,1,1,612,103,509,223,389,252,10.2908391669127,14.7647535510805,0.423460889863201,2020-04-20,2020,4
"2019","GO",5,"Centro-oeste",52010,"Goiânia",2583753,29461.4870868887,17,546,86,460,189,357,2,0,2,1,1,548,86,462,190,358,263,10.2908391669127,14.7647535510805,0.404678324262708,2020-04-27,2020,4
"2020","GO",5,"Centro-oeste",52010,"Goiânia",2583753,29461.4870868887,18,636,109,527,198,438,5,1,4,1,4,641,110,531,199,442,289,10.2908391669127,14.7647535510805,0.376409979114888,2020-05-04,2020,5
"2021","GO",5,"Centro-oeste",52010,"Goiânia",2583753,29461.4870868887,19,603,98,505,203,400,4,2,2,3,1,607,100,507,206,401,275,10.2908391669127,14.7647535510805,0.385346609958745,2020-05-11,2020,5
"2022","GO",5,"Centro-oeste",52010,"Goiânia",2583753,29461.4870868887,20,597,107,490,222,375,6,2,4,3,3,603,109,494,225,378,274,10.2908391669127,14.7647535510805,0.38152961437462,2020-05-18,2020,5
"2023","GO",5,"Centro-oeste",52010,"Goiânia",2583753,29461.4870868887,21,638,104,534,199,439,7,3,4,2,5,645,107,538,201,444,288,10.2908391669127,14.7647535510805,0.374888061175994,2020-05-25,2020,5
"2024","GO",5,"Centro-oeste",52011,"Vão do Paranã",124483,12811.3651725135,5,33,7,26,16,17,2,0,2,2,0,35,7,28,18,17,8,9.45808796005666,11.7319244393789,0.266183711578058,2020-02-03,2020,2
"2025","GO",5,"Centro-oeste",52011,"Vão do Paranã",124483,12811.3651725135,6,36,5,31,10,26,0,0,0,0,0,36,5,31,10,26,7,9.45808796005666,11.7319244393789,0.264305779205909,2020-02-10,2020,2
"2026","GO",5,"Centro-oeste",52011,"Vão do Paranã",124483,12811.3651725135,7,20,8,12,7,13,0,0,0,0,0,20,8,12,7,13,10,9.45808796005666,11.7319244393789,0.279809711500094,2020-02-17,2020,2
"2027","GO",5,"Centro-oeste",52011,"Vão do Paranã",124483,12811.3651725135,8,23,8,15,13,10,0,0,0,0,0,23,8,15,13,10,10,9.45808796005666,11.7319244393789,0.303967772824052,2020-02-24,2020,2
"2028","GO",5,"Centro-oeste",52011,"Vão do Paranã",124483,12811.3651725135,9,25,9,16,14,11,0,0,0,0,0,25,9,16,14,11,13,9.45808796005666,11.7319244393789,0.281390237924302,2020-03-02,2020,3
"2029","GO",5,"Centro-oeste",52011,"Vão do Paranã",124483,12811.3651725135,10,22,8,14,13,9,0,0,0,0,0,22,8,14,13,9,13,9.45808796005666,11.7319244393789,0.284238558856856,2020-03-09,2020,3
"2030","GO",5,"Centro-oeste",52011,"Vão do Paranã",124483,12811.3651725135,11,32,6,26,12,20,0,0,0,0,0,32,6,26,12,20,16,9.45808796005666,11.7319244393789,0.358727719275757,2020-03-16,2020,3
"2031","GO",5,"Centro-oeste",52011,"Vão do Paranã",124483,12811.3651725135,12,28,12,16,11,17,0,0,0,0,0,28,12,16,11,17,10,9.45808796005666,11.7319244393789,0.463485187128131,2020-03-23,2020,3
"2032","GO",5,"Centro-oeste",52011,"Vão do Paranã",124483,12811.3651725135,13,26,3,23,13,13,0,0,0,0,0,26,3,23,13,13,11,9.45808796005666,11.7319244393789,0.40716175278777,2020-03-30,2020,3
"2033","GO",5,"Centro-oeste",52011,"Vão do Paranã",124483,12811.3651725135,14,16,5,11,7,9,0,0,0,0,0,16,5,11,7,9,12,9.45808796005666,11.7319244393789,0.403643881646402,2020-04-06,2020,4
"2034","GO",5,"Centro-oeste",52011,"Vão do Paranã",124483,12811.3651725135,15,22,6,16,7,15,0,0,0,0,0,22,6,16,7,15,15,9.45808796005666,11.7319244393789,0.389722103532413,2020-04-13,2020,4
"2035","GO",5,"Centro-oeste",52011,"Vão do Paranã",124483,12811.3651725135,16,22,7,15,7,15,1,1,0,0,1,23,8,15,7,16,16,9.45808796005666,11.7319244393789,0.375076781657167,2020-04-20,2020,4
"2036","GO",5,"Centro-oeste",52011,"Vão do Paranã",124483,12811.3651725135,17,33,7,26,20,13,1,0,1,0,1,34,7,27,20,14,14,9.45808796005666,11.7319244393789,0.378992602493544,2020-04-27,2020,4
"2037","GO",5,"Centro-oeste",52011,"Vão do Paranã",124483,12811.3651725135,18,30,5,25,8,22,0,0,0,0,0,30,5,25,8,22,14,9.45808796005666,11.7319244393789,0.352606134613326,2020-05-04,2020,5
"2038","GO",5,"Centro-oeste",52011,"Vão do Paranã",124483,12811.3651725135,19,29,10,19,13,16,0,0,0,0,0,29,10,19,13,16,11,9.45808796005666,11.7319244393789,0.351767283768761,2020-05-11,2020,5
"2039","GO",5,"Centro-oeste",52011,"Vão do Paranã",124483,12811.3651725135,20,30,3,27,14,16,1,0,1,1,0,31,3,28,15,16,10,9.45808796005666,11.7319244393789,0.368257539555701,2020-05-18,2020,5
"2040","GO",5,"Centro-oeste",52011,"Vão do Paranã",124483,12811.3651725135,21,29,4,25,16,13,0,0,0,0,0,29,4,25,16,13,11,9.45808796005666,11.7319244393789,0.343353990397281,2020-05-25,2020,5
"2041","GO",5,"Centro-oeste",52012,"Entorno de Brasília",1310551,15468.7519384671,5,314,79,235,110,204,7,0,7,3,4,321,79,242,113,208,110,9.64657726406614,14.0859582174325,0.283332629241889,2020-02-03,2020,2
"2042","GO",5,"Centro-oeste",52012,"Entorno de Brasília",1310551,15468.7519384671,6,331,91,240,117,214,6,3,3,2,4,337,94,243,119,218,95,9.64657726406614,14.0859582174325,0.273914388003343,2020-02-10,2020,2
"2043","GO",5,"Centro-oeste",52012,"Entorno de Brasília",1310551,15468.7519384671,7,298,81,217,127,171,3,1,2,0,3,301,82,219,127,174,95,9.64657726406614,14.0859582174325,0.289043993218124,2020-02-17,2020,2
"2044","GO",5,"Centro-oeste",52012,"Entorno de Brasília",1310551,15468.7519384671,8,327,87,240,137,190,2,1,1,1,1,329,88,241,138,191,121,9.64657726406614,14.0859582174325,0.340859175498835,2020-02-24,2020,2
"2045","GO",5,"Centro-oeste",52012,"Entorno de Brasília",1310551,15468.7519384671,9,300,76,224,132,168,2,0,2,1,1,302,76,226,133,169,104,9.64657726406614,14.0859582174325,0.310904647948949,2020-03-02,2020,3
"2046","GO",5,"Centro-oeste",52012,"Entorno de Brasília",1310551,15468.7519384671,10,312,96,216,119,193,3,1,2,3,0,315,97,218,122,193,139,9.64657726406614,14.0859582174325,0.317819056004499,2020-03-09,2020,3
"2047","GO",5,"Centro-oeste",52012,"Entorno de Brasília",1310551,15468.7519384671,11,306,69,237,132,174,1,0,1,1,0,307,69,238,133,174,101,9.64657726406614,14.0859582174325,0.40880690322737,2020-03-16,2020,3
"2048","GO",5,"Centro-oeste",52012,"Entorno de Brasília",1310551,15468.7519384671,12,320,80,240,117,203,1,0,1,0,1,321,80,241,117,204,113,9.64657726406614,14.0859582174325,0.5113986603069,2020-03-23,2020,3
"2049","GO",5,"Centro-oeste",52012,"Entorno de Brasília",1310551,15468.7519384671,13,283,61,222,117,166,4,0,4,1,3,287,61,226,118,169,100,9.64657726406614,14.0859582174325,0.454842409747651,2020-03-30,2020,3
"2050","GO",5,"Centro-oeste",52012,"Entorno de Brasília",1310551,15468.7519384671,14,297,83,214,129,168,4,1,3,3,1,301,84,217,132,169,115,9.64657726406614,14.0859582174325,0.438422945458684,2020-04-06,2020,4
"2051","GO",5,"Centro-oeste",52012,"Entorno de Brasília",1310551,15468.7519384671,15,310,79,231,142,168,4,1,3,1,3,314,80,234,143,171,95,9.64657726406614,14.0859582174325,0.424405574673422,2020-04-13,2020,4
"2052","GO",5,"Centro-oeste",52012,"Entorno de Brasília",1310551,15468.7519384671,16,348,87,261,146,202,4,2,2,0,4,352,89,263,146,206,93,9.64657726406614,14.0859582174325,0.415741495174207,2020-04-20,2020,4
"2053","GO",5,"Centro-oeste",52012,"Entorno de Brasília",1310551,15468.7519384671,17,338,84,254,147,191,1,0,1,1,0,339,84,255,148,191,115,9.64657726406614,14.0859582174325,0.401516722892758,2020-04-27,2020,4
"2054","GO",5,"Centro-oeste",52012,"Entorno de Brasília",1310551,15468.7519384671,18,318,85,233,126,192,3,0,3,2,1,321,85,236,128,193,112,9.64657726406614,14.0859582174325,0.38236394559049,2020-05-04,2020,5
"2055","GO",5,"Centro-oeste",52012,"Entorno de Brasília",1310551,15468.7519384671,19,342,105,237,138,204,5,3,2,1,4,347,108,239,139,208,132,9.64657726406614,14.0859582174325,0.392899809213469,2020-05-11,2020,5
"2056","GO",5,"Centro-oeste",52012,"Entorno de Brasília",1310551,15468.7519384671,20,310,84,226,132,178,1,0,1,0,1,311,84,227,132,179,112,9.64657726406614,14.0859582174325,0.38961413033537,2020-05-18,2020,5
"2057","GO",5,"Centro-oeste",52012,"Entorno de Brasília",1310551,15468.7519384671,21,327,87,240,145,182,8,4,4,3,5,335,91,244,148,187,136,9.64657726406614,14.0859582174325,0.382529053886857,2020-05-25,2020,5
"2058","GO",5,"Centro-oeste",52013,"Sudoeste de Goiás",558560,42364.6450934725,5,143,28,115,53,90,0,0,0,0,0,143,28,115,53,90,64,10.6540694512452,13.2331173223389,0.280042333653993,2020-02-03,2020,2
"2059","GO",5,"Centro-oeste",52013,"Sudoeste de Goiás",558560,42364.6450934725,6,139,31,108,55,84,1,1,0,0,1,140,32,108,55,85,51,10.6540694512452,13.2331173223389,0.275279836469861,2020-02-10,2020,2
"2060","GO",5,"Centro-oeste",52013,"Sudoeste de Goiás",558560,42364.6450934725,7,140,28,112,66,74,0,0,0,0,0,140,28,112,66,74,55,10.6540694512452,13.2331173223389,0.289475123061394,2020-02-17,2020,2
"2061","GO",5,"Centro-oeste",52013,"Sudoeste de Goiás",558560,42364.6450934725,8,150,30,120,68,82,1,0,1,0,1,151,30,121,68,83,48,10.6540694512452,13.2331173223389,0.335623357064381,2020-02-24,2020,2
"2062","GO",5,"Centro-oeste",52013,"Sudoeste de Goiás",558560,42364.6450934725,9,124,25,99,44,80,1,0,1,0,1,125,25,100,44,81,52,10.6540694512452,13.2331173223389,0.299895737956009,2020-03-02,2020,3
"2063","GO",5,"Centro-oeste",52013,"Sudoeste de Goiás",558560,42364.6450934725,10,138,18,120,60,78,2,1,1,1,1,140,19,121,61,79,67,10.6540694512452,13.2331173223389,0.311449593244486,2020-03-09,2020,3
"2064","GO",5,"Centro-oeste",52013,"Sudoeste de Goiás",558560,42364.6450934725,11,124,29,95,62,62,1,0,1,0,1,125,29,96,62,63,68,10.6540694512452,13.2331173223389,0.403446628305359,2020-03-16,2020,3
"2065","GO",5,"Centro-oeste",52013,"Sudoeste de Goiás",558560,42364.6450934725,12,140,31,109,65,75,1,0,1,1,0,141,31,110,66,75,55,10.6540694512452,13.2331173223389,0.480601741691576,2020-03-23,2020,3
"2066","GO",5,"Centro-oeste",52013,"Sudoeste de Goiás",558560,42364.6450934725,13,125,25,100,48,77,1,0,1,1,0,126,25,101,49,77,44,10.6540694512452,13.2331173223389,0.433472205477927,2020-03-30,2020,3
"2067","GO",5,"Centro-oeste",52013,"Sudoeste de Goiás",558560,42364.6450934725,14,123,20,103,49,74,0,0,0,0,0,123,20,103,49,74,47,10.6540694512452,13.2331173223389,0.422056325730058,2020-04-06,2020,4
"2068","GO",5,"Centro-oeste",52013,"Sudoeste de Goiás",558560,42364.6450934725,15,140,31,109,59,81,2,0,2,0,2,142,31,111,59,83,44,10.6540694512452,13.2331173223389,0.397194411342318,2020-04-13,2020,4
"2069","GO",5,"Centro-oeste",52013,"Sudoeste de Goiás",558560,42364.6450934725,16,164,38,126,72,92,0,0,0,0,0,164,38,126,72,92,43,10.6540694512452,13.2331173223389,0.398453152994714,2020-04-20,2020,4
"2070","GO",5,"Centro-oeste",52013,"Sudoeste de Goiás",558560,42364.6450934725,17,140,31,109,52,88,2,0,2,0,2,142,31,111,52,90,59,10.6540694512452,13.2331173223389,0.386003383193139,2020-04-27,2020,4
"2071","GO",5,"Centro-oeste",52013,"Sudoeste de Goiás",558560,42364.6450934725,18,155,34,121,55,100,1,1,0,0,1,156,35,121,55,101,41,10.6540694512452,13.2331173223389,0.366854429562436,2020-05-04,2020,5
"2072","GO",5,"Centro-oeste",52013,"Sudoeste de Goiás",558560,42364.6450934725,19,134,25,109,62,72,0,0,0,0,0,134,25,109,62,72,54,10.6540694512452,13.2331173223389,0.376184447121476,2020-05-11,2020,5
"2073","GO",5,"Centro-oeste",52013,"Sudoeste de Goiás",558560,42364.6450934725,20,152,25,127,53,99,1,0,1,0,1,153,25,128,53,100,48,10.6540694512452,13.2331173223389,0.38226175493224,2020-05-18,2020,5
"2074","GO",5,"Centro-oeste",52013,"Sudoeste de Goiás",558560,42364.6450934725,21,149,28,121,57,92,0,0,0,0,0,149,28,121,57,92,64,10.6540694512452,13.2331173223389,0.374778344602678,2020-05-25,2020,5
"2075","GO",5,"Centro-oeste",52014,"Vale do Rio dos Bois",127367,41381.7026994433,5,22,3,19,8,14,0,0,0,0,0,22,3,19,8,14,24,10.6305940983371,11.7548279618794,0.291232036100611,2020-02-03,2020,2
"2076","GO",5,"Centro-oeste",52014,"Vale do Rio dos Bois",127367,41381.7026994433,6,25,2,23,11,14,0,0,0,0,0,25,2,23,11,14,8,10.6305940983371,11.7548279618794,0.277764064596066,2020-02-10,2020,2
"2077","GO",5,"Centro-oeste",52014,"Vale do Rio dos Bois",127367,41381.7026994433,7,21,5,16,12,9,0,0,0,0,0,21,5,16,12,9,16,10.6305940983371,11.7548279618794,0.289017741939357,2020-02-17,2020,2
"2078","GO",5,"Centro-oeste",52014,"Vale do Rio dos Bois",127367,41381.7026994433,8,35,9,26,10,25,0,0,0,0,0,35,9,26,10,25,14,10.6305940983371,11.7548279618794,0.321082574997023,2020-02-24,2020,2
"2079","GO",5,"Centro-oeste",52014,"Vale do Rio dos Bois",127367,41381.7026994433,9,25,4,21,9,16,0,0,0,0,0,25,4,21,9,16,20,10.6305940983371,11.7548279618794,0.304182407448009,2020-03-02,2020,3
"2080","GO",5,"Centro-oeste",52014,"Vale do Rio dos Bois",127367,41381.7026994433,10,17,7,10,9,8,0,0,0,0,0,17,7,10,9,8,14,10.6305940983371,11.7548279618794,0.318893414251883,2020-03-09,2020,3
"2081","GO",5,"Centro-oeste",52014,"Vale do Rio dos Bois",127367,41381.7026994433,11,23,5,18,10,13,0,0,0,0,0,23,5,18,10,13,12,10.6305940983371,11.7548279618794,0.384600671645053,2020-03-16,2020,3
"2082","GO",5,"Centro-oeste",52014,"Vale do Rio dos Bois",127367,41381.7026994433,12,31,7,24,14,17,0,0,0,0,0,31,7,24,14,17,14,10.6305940983371,11.7548279618794,0.45752176447037,2020-03-23,2020,3
"2083","GO",5,"Centro-oeste",52014,"Vale do Rio dos Bois",127367,41381.7026994433,13,21,6,15,10,11,0,0,0,0,0,21,6,15,10,11,16,10.6305940983371,11.7548279618794,0.414979916314044,2020-03-30,2020,3
"2084","GO",5,"Centro-oeste",52014,"Vale do Rio dos Bois",127367,41381.7026994433,14,32,8,24,14,18,0,0,0,0,0,32,8,24,14,18,14,10.6305940983371,11.7548279618794,0.410897666286598,2020-04-06,2020,4
"2085","GO",5,"Centro-oeste",52014,"Vale do Rio dos Bois",127367,41381.7026994433,15,18,3,15,8,10,1,0,1,0,1,19,3,16,8,11,15,10.6305940983371,11.7548279618794,0.397135167429184,2020-04-13,2020,4
"2086","GO",5,"Centro-oeste",52014,"Vale do Rio dos Bois",127367,41381.7026994433,16,29,5,24,9,20,0,0,0,0,0,29,5,24,9,20,15,10.6305940983371,11.7548279618794,0.381344562942823,2020-04-20,2020,4
"2087","GO",5,"Centro-oeste",52014,"Vale do Rio dos Bois",127367,41381.7026994433,17,34,8,26,16,18,1,0,1,1,0,35,8,27,17,18,12,10.6305940983371,11.7548279618794,0.389831980033586,2020-04-27,2020,4
"2088","GO",5,"Centro-oeste",52014,"Vale do Rio dos Bois",127367,41381.7026994433,18,29,8,21,14,15,0,0,0,0,0,29,8,21,14,15,25,10.6305940983371,11.7548279618794,0.365473231420526,2020-05-04,2020,5
"2089","GO",5,"Centro-oeste",52014,"Vale do Rio dos Bois",127367,41381.7026994433,19,39,5,34,23,16,0,0,0,0,0,39,5,34,23,16,17,10.6305940983371,11.7548279618794,0.376166715446691,2020-05-11,2020,5
"2090","GO",5,"Centro-oeste",52014,"Vale do Rio dos Bois",127367,41381.7026994433,20,24,4,20,10,14,0,0,0,0,0,24,4,20,10,14,18,10.6305940983371,11.7548279618794,0.387771821322228,2020-05-18,2020,5
"2091","GO",5,"Centro-oeste",52014,"Vale do Rio dos Bois",127367,41381.7026994433,21,40,5,35,18,22,0,0,0,0,0,40,5,35,18,22,15,10.6305940983371,11.7548279618794,0.373442705576477,2020-05-25,2020,5
"2092","GO",5,"Centro-oeste",52015,"Meia Ponte",414086,35848.4591213419,5,113,23,90,55,58,2,2,0,0,2,115,25,90,55,60,61,10.4870558638305,12.9338289607033,0.291156125046697,2020-02-03,2020,2
"2093","GO",5,"Centro-oeste",52015,"Meia Ponte",414086,35848.4591213419,6,76,21,55,32,44,1,1,0,0,1,77,22,55,32,45,51,10.4870558638305,12.9338289607033,0.290820635194471,2020-02-10,2020,2
"2094","GO",5,"Centro-oeste",52015,"Meia Ponte",414086,35848.4591213419,7,89,16,73,31,58,0,0,0,0,0,89,16,73,31,58,64,10.4870558638305,12.9338289607033,0.299186472551468,2020-02-17,2020,2
"2095","GO",5,"Centro-oeste",52015,"Meia Ponte",414086,35848.4591213419,8,73,11,62,28,45,1,1,0,0,1,74,12,62,28,46,45,10.4870558638305,12.9338289607033,0.335356696481927,2020-02-24,2020,2
"2096","GO",5,"Centro-oeste",52015,"Meia Ponte",414086,35848.4591213419,9,100,23,77,47,53,2,1,1,2,0,102,24,78,49,53,61,10.4870558638305,12.9338289607033,0.316413032043701,2020-03-02,2020,3
"2097","GO",5,"Centro-oeste",52015,"Meia Ponte",414086,35848.4591213419,10,74,17,57,33,41,0,0,0,0,0,74,17,57,33,41,56,10.4870558638305,12.9338289607033,0.327698034038843,2020-03-09,2020,3
"2098","GO",5,"Centro-oeste",52015,"Meia Ponte",414086,35848.4591213419,11,94,24,70,32,62,2,1,1,1,1,96,25,71,33,63,59,10.4870558638305,12.9338289607033,0.40276425641954,2020-03-16,2020,3
"2099","GO",5,"Centro-oeste",52015,"Meia Ponte",414086,35848.4591213419,12,90,22,68,35,55,1,1,0,0,1,91,23,68,35,56,43,10.4870558638305,12.9338289607033,0.504270976665398,2020-03-23,2020,3
"2100","GO",5,"Centro-oeste",52015,"Meia Ponte",414086,35848.4591213419,13,85,21,64,35,50,1,0,1,0,1,86,21,65,35,51,38,10.4870558638305,12.9338289607033,0.4627901087214,2020-03-30,2020,3
"2101","GO",5,"Centro-oeste",52015,"Meia Ponte",414086,35848.4591213419,14,95,26,69,41,54,0,0,0,0,0,95,26,69,41,54,62,10.4870558638305,12.9338289607033,0.445084371586476,2020-04-06,2020,4
"2102","GO",5,"Centro-oeste",52015,"Meia Ponte",414086,35848.4591213419,15,84,15,69,31,53,0,0,0,0,0,84,15,69,31,53,66,10.4870558638305,12.9338289607033,0.425103472428865,2020-04-13,2020,4
"2103","GO",5,"Centro-oeste",52015,"Meia Ponte",414086,35848.4591213419,16,93,15,78,35,58,0,0,0,0,0,93,15,78,35,58,46,10.4870558638305,12.9338289607033,0.415176299477132,2020-04-20,2020,4
"2104","GO",5,"Centro-oeste",52015,"Meia Ponte",414086,35848.4591213419,17,92,24,68,50,42,0,0,0,0,0,92,24,68,50,42,65,10.4870558638305,12.9338289607033,0.403155255052699,2020-04-27,2020,4
"2105","GO",5,"Centro-oeste",52015,"Meia Ponte",414086,35848.4591213419,18,95,22,73,32,63,0,0,0,0,0,95,22,73,32,63,78,10.4870558638305,12.9338289607033,0.381981238744403,2020-05-04,2020,5
"2106","GO",5,"Centro-oeste",52015,"Meia Ponte",414086,35848.4591213419,19,109,27,82,49,60,1,1,0,1,0,110,28,82,50,60,57,10.4870558638305,12.9338289607033,0.392690595184865,2020-05-11,2020,5
"2107","GO",5,"Centro-oeste",52015,"Meia Ponte",414086,35848.4591213419,20,101,23,78,34,67,1,0,1,0,1,102,23,79,34,68,52,10.4870558638305,12.9338289607033,0.398203315265577,2020-05-18,2020,5
"2108","GO",5,"Centro-oeste",52015,"Meia Ponte",414086,35848.4591213419,21,108,20,88,44,64,1,1,0,1,0,109,21,88,45,64,63,10.4870558638305,12.9338289607033,0.37993572473713,2020-05-25,2020,5
"2109","GO",5,"Centro-oeste",52016,"Pires do Rio",101396,32181.7704471577,5,18,7,11,9,9,0,0,0,0,0,18,7,11,9,9,14,10.379155436036,11.5267889216294,0.272053173612275,2020-02-03,2020,2
"2110","GO",5,"Centro-oeste",52016,"Pires do Rio",101396,32181.7704471577,6,13,3,10,6,7,0,0,0,0,0,13,3,10,6,7,19,10.379155436036,11.5267889216294,0.269083676984023,2020-02-10,2020,2
"2111","GO",5,"Centro-oeste",52016,"Pires do Rio",101396,32181.7704471577,7,20,2,18,7,13,0,0,0,0,0,20,2,18,7,13,16,10.379155436036,11.5267889216294,0.292861453744902,2020-02-17,2020,2
"2112","GO",5,"Centro-oeste",52016,"Pires do Rio",101396,32181.7704471577,8,16,4,12,7,9,0,0,0,0,0,16,4,12,7,9,10,10.379155436036,11.5267889216294,0.323926561368717,2020-02-24,2020,2
"2113","GO",5,"Centro-oeste",52016,"Pires do Rio",101396,32181.7704471577,9,8,1,7,6,2,0,0,0,0,0,8,1,7,6,2,16,10.379155436036,11.5267889216294,0.300834933815713,2020-03-02,2020,3
"2114","GO",5,"Centro-oeste",52016,"Pires do Rio",101396,32181.7704471577,10,21,4,17,12,9,0,0,0,0,0,21,4,17,12,9,15,10.379155436036,11.5267889216294,0.310782381970268,2020-03-09,2020,3
"2115","GO",5,"Centro-oeste",52016,"Pires do Rio",101396,32181.7704471577,11,11,4,7,4,7,0,0,0,0,0,11,4,7,4,7,12,10.379155436036,11.5267889216294,0.393523687373397,2020-03-16,2020,3
"2116","GO",5,"Centro-oeste",52016,"Pires do Rio",101396,32181.7704471577,12,20,4,16,6,14,0,0,0,0,0,20,4,16,6,14,13,10.379155436036,11.5267889216294,0.469631155328662,2020-03-23,2020,3
"2117","GO",5,"Centro-oeste",52016,"Pires do Rio",101396,32181.7704471577,13,13,1,12,8,5,0,0,0,0,0,13,1,12,8,5,13,10.379155436036,11.5267889216294,0.425812672120485,2020-03-30,2020,3
"2118","GO",5,"Centro-oeste",52016,"Pires do Rio",101396,32181.7704471577,14,16,4,12,9,7,0,0,0,0,0,16,4,12,9,7,10,10.379155436036,11.5267889216294,0.424659468480031,2020-04-06,2020,4
"2119","GO",5,"Centro-oeste",52016,"Pires do Rio",101396,32181.7704471577,15,22,5,17,6,16,1,0,1,1,0,23,5,18,7,16,10,10.379155436036,11.5267889216294,0.394867357968573,2020-04-13,2020,4
"2120","GO",5,"Centro-oeste",52016,"Pires do Rio",101396,32181.7704471577,16,22,4,18,11,11,0,0,0,0,0,22,4,18,11,11,25,10.379155436036,11.5267889216294,0.392809192322014,2020-04-20,2020,4
"2121","GO",5,"Centro-oeste",52016,"Pires do Rio",101396,32181.7704471577,17,21,5,16,9,12,0,0,0,0,0,21,5,16,9,12,18,10.379155436036,11.5267889216294,0.389422261157188,2020-04-27,2020,4
"2122","GO",5,"Centro-oeste",52016,"Pires do Rio",101396,32181.7704471577,18,22,2,20,9,13,0,0,0,0,0,22,2,20,9,13,20,10.379155436036,11.5267889216294,0.371043967385772,2020-05-04,2020,5
"2123","GO",5,"Centro-oeste",52016,"Pires do Rio",101396,32181.7704471577,19,23,2,21,9,14,1,1,0,1,0,24,3,21,10,14,11,10.379155436036,11.5267889216294,0.379982719143781,2020-05-11,2020,5
"2124","GO",5,"Centro-oeste",52016,"Pires do Rio",101396,32181.7704471577,20,20,7,13,6,14,0,0,0,0,0,20,7,13,6,14,14,10.379155436036,11.5267889216294,0.369399347676369,2020-05-18,2020,5
"2125","GO",5,"Centro-oeste",52016,"Pires do Rio",101396,32181.7704471577,21,32,4,28,13,19,0,0,0,0,0,32,4,28,13,19,13,10.379155436036,11.5267889216294,0.379113382998841,2020-05-25,2020,5
"2126","GO",5,"Centro-oeste",52017,"Catalão",179314,57933.2896768239,5,38,8,30,15,23,0,0,0,0,0,38,8,30,15,23,23,10.9670474495804,12.0968937379728,0.286975386031441,2020-02-03,2020,2
"2127","GO",5,"Centro-oeste",52017,"Catalão",179314,57933.2896768239,6,27,2,25,8,19,0,0,0,0,0,27,2,25,8,19,24,10.9670474495804,12.0968937379728,0.271196639000938,2020-02-10,2020,2
"2128","GO",5,"Centro-oeste",52017,"Catalão",179314,57933.2896768239,7,52,7,45,21,31,1,0,1,0,1,53,7,46,21,32,14,10.9670474495804,12.0968937379728,0.289451490369531,2020-02-17,2020,2
"2129","GO",5,"Centro-oeste",52017,"Catalão",179314,57933.2896768239,8,45,6,39,11,34,0,0,0,0,0,45,6,39,11,34,23,10.9670474495804,12.0968937379728,0.335981281835601,2020-02-24,2020,2
"2130","GO",5,"Centro-oeste",52017,"Catalão",179314,57933.2896768239,9,36,4,32,13,23,1,0,1,0,1,37,4,33,13,24,21,10.9670474495804,12.0968937379728,0.301355246260264,2020-03-02,2020,3
"2131","GO",5,"Centro-oeste",52017,"Catalão",179314,57933.2896768239,10,42,5,37,18,24,0,0,0,0,0,42,5,37,18,24,17,10.9670474495804,12.0968937379728,0.313497778714625,2020-03-09,2020,3
"2132","GO",5,"Centro-oeste",52017,"Catalão",179314,57933.2896768239,11,36,3,33,12,24,0,0,0,0,0,36,3,33,12,24,25,10.9670474495804,12.0968937379728,0.405830768201207,2020-03-16,2020,3
"2133","GO",5,"Centro-oeste",52017,"Catalão",179314,57933.2896768239,12,28,8,20,13,15,1,0,1,1,0,29,8,21,14,15,22,10.9670474495804,12.0968937379728,0.495968497794647,2020-03-23,2020,3
"2134","GO",5,"Centro-oeste",52017,"Catalão",179314,57933.2896768239,13,45,12,33,20,25,1,1,0,0,1,46,13,33,20,26,13,10.9670474495804,12.0968937379728,0.456204947268828,2020-03-30,2020,3
"2135","GO",5,"Centro-oeste",52017,"Catalão",179314,57933.2896768239,14,38,8,30,15,23,0,0,0,0,0,38,8,30,15,23,13,10.9670474495804,12.0968937379728,0.435778696454611,2020-04-06,2020,4
"2136","GO",5,"Centro-oeste",52017,"Catalão",179314,57933.2896768239,15,26,3,23,11,15,0,0,0,0,0,26,3,23,11,15,16,10.9670474495804,12.0968937379728,0.42112716826511,2020-04-13,2020,4
"2137","GO",5,"Centro-oeste",52017,"Catalão",179314,57933.2896768239,16,49,12,37,19,30,0,0,0,0,0,49,12,37,19,30,18,10.9670474495804,12.0968937379728,0.408643539856444,2020-04-20,2020,4
"2138","GO",5,"Centro-oeste",52017,"Catalão",179314,57933.2896768239,17,37,10,27,14,23,0,0,0,0,0,37,10,27,14,23,18,10.9670474495804,12.0968937379728,0.398129427495804,2020-04-27,2020,4
"2139","GO",5,"Centro-oeste",52017,"Catalão",179314,57933.2896768239,18,35,5,30,14,21,0,0,0,0,0,35,5,30,14,21,20,10.9670474495804,12.0968937379728,0.375256248262646,2020-05-04,2020,5
"2140","GO",5,"Centro-oeste",52017,"Catalão",179314,57933.2896768239,19,42,11,31,15,27,0,0,0,0,0,42,11,31,15,27,21,10.9670474495804,12.0968937379728,0.387420036379713,2020-05-11,2020,5
"2141","GO",5,"Centro-oeste",52017,"Catalão",179314,57933.2896768239,20,37,9,28,12,25,0,0,0,0,0,37,9,28,12,25,20,10.9670474495804,12.0968937379728,0.388844494993933,2020-05-18,2020,5
"2142","GO",5,"Centro-oeste",52017,"Catalão",179314,57933.2896768239,21,29,5,24,10,19,0,0,0,0,0,29,5,24,10,19,21,10.9670474495804,12.0968937379728,0.388565152703407,2020-05-25,2020,5
"2143","GO",5,"Centro-oeste",52018,"Quirinópolis",130105,34383.6517256062,5,18,1,17,7,11,0,0,0,0,0,18,1,17,7,11,17,10.4453364898642,11.7760970957375,0.282244936802831,2020-02-03,2020,2
"2144","GO",5,"Centro-oeste",52018,"Quirinópolis",130105,34383.6517256062,6,37,7,30,14,23,0,0,0,0,0,37,7,30,14,23,19,10.4453364898642,11.7760970957375,0.286925892965225,2020-02-10,2020,2
"2145","GO",5,"Centro-oeste",52018,"Quirinópolis",130105,34383.6517256062,7,23,5,18,10,13,0,0,0,0,0,23,5,18,10,13,20,10.4453364898642,11.7760970957375,0.303265168725104,2020-02-17,2020,2
"2146","GO",5,"Centro-oeste",52018,"Quirinópolis",130105,34383.6517256062,8,21,2,19,12,9,0,0,0,0,0,21,2,19,12,9,13,10.4453364898642,11.7760970957375,0.333907952721361,2020-02-24,2020,2
"2147","GO",5,"Centro-oeste",52018,"Quirinópolis",130105,34383.6517256062,9,22,3,19,12,10,0,0,0,0,0,22,3,19,12,10,12,10.4453364898642,11.7760970957375,0.323380808792085,2020-03-02,2020,3
"2148","GO",5,"Centro-oeste",52018,"Quirinópolis",130105,34383.6517256062,10,25,7,18,11,14,0,0,0,0,0,25,7,18,11,14,19,10.4453364898642,11.7760970957375,0.328715291597954,2020-03-09,2020,3
"2149","GO",5,"Centro-oeste",52018,"Quirinópolis",130105,34383.6517256062,11,15,4,11,5,10,0,0,0,0,0,15,4,11,5,10,15,10.4453364898642,11.7760970957375,0.393779953403299,2020-03-16,2020,3
"2150","GO",5,"Centro-oeste",52018,"Quirinópolis",130105,34383.6517256062,12,20,1,19,9,11,0,0,0,0,0,20,1,19,9,11,22,10.4453364898642,11.7760970957375,0.473412410832306,2020-03-23,2020,3
"2151","GO",5,"Centro-oeste",52018,"Quirinópolis",130105,34383.6517256062,13,19,4,15,7,12,1,0,1,0,1,20,4,16,7,13,10,10.4453364898642,11.7760970957375,0.431634714970757,2020-03-30,2020,3
"2152","GO",5,"Centro-oeste",52018,"Quirinópolis",130105,34383.6517256062,14,26,10,16,10,16,1,0,1,1,0,27,10,17,11,16,14,10.4453364898642,11.7760970957375,0.404245962437295,2020-04-06,2020,4
"2153","GO",5,"Centro-oeste",52018,"Quirinópolis",130105,34383.6517256062,15,38,5,33,19,19,0,0,0,0,0,38,5,33,19,19,8,10.4453364898642,11.7760970957375,0.386972280250322,2020-04-13,2020,4
"2154","GO",5,"Centro-oeste",52018,"Quirinópolis",130105,34383.6517256062,16,17,3,14,9,8,1,0,1,0,1,18,3,15,9,9,13,10.4453364898642,11.7760970957375,0.390504932250464,2020-04-20,2020,4
"2155","GO",5,"Centro-oeste",52018,"Quirinópolis",130105,34383.6517256062,17,29,8,21,14,15,0,0,0,0,0,29,8,21,14,15,10,10.4453364898642,11.7760970957375,0.391309864785111,2020-04-27,2020,4
"2156","GO",5,"Centro-oeste",52018,"Quirinópolis",130105,34383.6517256062,18,30,9,21,16,14,1,1,0,1,0,31,10,21,17,14,18,10.4453364898642,11.7760970957375,0.370095987959867,2020-05-04,2020,5
"2157","GO",5,"Centro-oeste",52018,"Quirinópolis",130105,34383.6517256062,19,20,2,18,8,12,0,0,0,0,0,20,2,18,8,12,13,10.4453364898642,11.7760970957375,0.390197856416202,2020-05-11,2020,5
"2158","GO",5,"Centro-oeste",52018,"Quirinópolis",130105,34383.6517256062,20,42,4,38,15,27,0,0,0,0,0,42,4,38,15,27,21,10.4453364898642,11.7760970957375,0.393367747378304,2020-05-18,2020,5
"2159","GO",5,"Centro-oeste",52018,"Quirinópolis",130105,34383.6517256062,21,40,10,30,14,26,0,0,0,0,0,40,10,30,14,26,12,10.4453364898642,11.7760970957375,0.392028513859476,2020-05-25,2020,5
"2160","MA",2,"Nordeste",21001,"Litoral Ocidental Maranhense",191685,6300.01745008738,5,45,10,35,21,24,1,1,0,0,1,46,11,35,21,25,15,8.74830768223093,12.1636086787109,0.272480437555589,2020-02-03,2020,2
"2161","MA",2,"Nordeste",21001,"Litoral Ocidental Maranhense",191685,6300.01745008738,6,48,9,39,23,25,0,0,0,0,0,48,9,39,23,25,15,8.74830768223093,12.1636086787109,0.276546603040758,2020-02-10,2020,2
"2162","MA",2,"Nordeste",21001,"Litoral Ocidental Maranhense",191685,6300.01745008738,7,50,18,32,32,18,0,0,0,0,0,50,18,32,32,18,23,8.74830768223093,12.1636086787109,0.274419995445342,2020-02-17,2020,2
"2163","MA",2,"Nordeste",21001,"Litoral Ocidental Maranhense",191685,6300.01745008738,8,42,13,29,23,19,0,0,0,0,0,42,13,29,23,19,13,8.74830768223093,12.1636086787109,0.333124157303291,2020-02-24,2020,2
"2164","MA",2,"Nordeste",21001,"Litoral Ocidental Maranhense",191685,6300.01745008738,9,33,10,23,20,13,0,0,0,0,0,33,10,23,20,13,19,8.74830768223093,12.1636086787109,0.307599409393235,2020-03-02,2020,3
"2165","MA",2,"Nordeste",21001,"Litoral Ocidental Maranhense",191685,6300.01745008738,10,29,10,19,14,15,0,0,0,0,0,29,10,19,14,15,18,8.74830768223093,12.1636086787109,0.34000085547627,2020-03-09,2020,3
"2166","MA",2,"Nordeste",21001,"Litoral Ocidental Maranhense",191685,6300.01745008738,11,35,8,27,20,15,0,0,0,0,0,35,8,27,20,15,17,8.74830768223093,12.1636086787109,0.365509983113665,2020-03-16,2020,3
"2167","MA",2,"Nordeste",21001,"Litoral Ocidental Maranhense",191685,6300.01745008738,12,34,11,23,16,18,3,1,2,2,1,37,12,25,18,19,15,8.74830768223093,12.1636086787109,0.44788509886582,2020-03-23,2020,3
"2168","MA",2,"Nordeste",21001,"Litoral Ocidental Maranhense",191685,6300.01745008738,13,22,11,11,11,11,2,0,2,2,0,24,11,13,13,11,23,8.74830768223093,12.1636086787109,0.436377414533751,2020-03-30,2020,3
"2169","MA",2,"Nordeste",21001,"Litoral Ocidental Maranhense",191685,6300.01745008738,14,36,11,25,23,13,1,0,1,0,1,37,11,26,23,14,14,8.74830768223093,12.1636086787109,0.426413105157574,2020-04-06,2020,4
"2170","MA",2,"Nordeste",21001,"Litoral Ocidental Maranhense",191685,6300.01745008738,15,41,17,24,27,14,2,0,2,1,1,43,17,26,28,15,16,8.74830768223093,12.1636086787109,0.404385327536188,2020-04-13,2020,4
"2171","MA",2,"Nordeste",21001,"Litoral Ocidental Maranhense",191685,6300.01745008738,16,35,13,22,24,11,0,0,0,0,0,35,13,22,24,11,13,8.74830768223093,12.1636086787109,0.418451252383567,2020-04-20,2020,4
"2172","MA",2,"Nordeste",21001,"Litoral Ocidental Maranhense",191685,6300.01745008738,17,39,12,27,22,17,0,0,0,0,0,39,12,27,22,17,22,8.74830768223093,12.1636086787109,0.43028583177719,2020-04-27,2020,4
"2173","MA",2,"Nordeste",21001,"Litoral Ocidental Maranhense",191685,6300.01745008738,18,45,18,27,32,13,0,0,0,0,0,45,18,27,32,13,28,8.74830768223093,12.1636086787109,0.45506936194733,2020-05-04,2020,5
"2174","MA",2,"Nordeste",21001,"Litoral Ocidental Maranhense",191685,6300.01745008738,19,40,16,24,19,21,0,0,0,0,0,40,16,24,19,21,27,8.74830768223093,12.1636086787109,0.479516175325528,2020-05-11,2020,5
"2175","MA",2,"Nordeste",21001,"Litoral Ocidental Maranhense",191685,6300.01745008738,20,37,17,20,21,16,1,1,0,1,0,38,18,20,22,16,31,8.74830768223093,12.1636086787109,0.468211628512852,2020-05-18,2020,5
"2176","MA",2,"Nordeste",21001,"Litoral Ocidental Maranhense",191685,6300.01745008738,21,46,12,34,22,24,0,0,0,0,0,46,12,34,22,24,34,8.74830768223093,12.1636086787109,0.443914434489949,2020-05-25,2020,5
"2177","MA",2,"Nordeste",21002,"Aglomeração Urbana de São Luís",1442927,25961.4162950517,5,379,66,313,144,235,3,0,3,1,2,382,66,316,145,237,153,10.16436672615,14.1821842474258,0.279747269687902,2020-02-03,2020,2
"2178","MA",2,"Nordeste",21002,"Aglomeração Urbana de São Luís",1442927,25961.4162950517,6,403,65,338,151,252,2,1,1,1,1,405,66,339,152,253,159,10.16436672615,14.1821842474258,0.276965117108452,2020-02-10,2020,2
"2179","MA",2,"Nordeste",21002,"Aglomeração Urbana de São Luís",1442927,25961.4162950517,7,379,72,307,148,231,4,2,2,3,1,383,74,309,151,232,133,10.16436672615,14.1821842474258,0.293125717305804,2020-02-17,2020,2
"2180","MA",2,"Nordeste",21002,"Aglomeração Urbana de São Luís",1442927,25961.4162950517,8,375,69,306,155,220,3,0,3,0,3,378,69,309,155,223,153,10.16436672615,14.1821842474258,0.349804576470072,2020-02-24,2020,2
"2181","MA",2,"Nordeste",21002,"Aglomeração Urbana de São Luís",1442927,25961.4162950517,9,355,61,294,150,205,4,2,2,2,2,359,63,296,152,207,151,10.16436672615,14.1821842474258,0.318444764208368,2020-03-02,2020,3
"2182","MA",2,"Nordeste",21002,"Aglomeração Urbana de São Luís",1442927,25961.4162950517,10,356,62,294,129,227,3,1,2,0,3,359,63,296,129,230,159,10.16436672615,14.1821842474258,0.337440088508862,2020-03-09,2020,3
"2183","MA",2,"Nordeste",21002,"Aglomeração Urbana de São Luís",1442927,25961.4162950517,11,306,57,249,122,184,1,0,1,0,1,307,57,250,122,185,156,10.16436672615,14.1821842474258,0.399337792752538,2020-03-16,2020,3
"2184","MA",2,"Nordeste",21002,"Aglomeração Urbana de São Luís",1442927,25961.4162950517,12,314,61,253,126,188,2,1,1,2,0,316,62,254,128,188,202,10.16436672615,14.1821842474258,0.518996411940748,2020-03-23,2020,3
"2185","MA",2,"Nordeste",21002,"Aglomeração Urbana de São Luís",1442927,25961.4162950517,13,288,61,227,108,180,2,1,1,2,0,290,62,228,110,180,153,10.16436672615,14.1821842474258,0.48246052902692,2020-03-30,2020,3
"2186","MA",2,"Nordeste",21002,"Aglomeração Urbana de São Luís",1442927,25961.4162950517,14,314,53,261,133,181,4,0,4,1,3,318,53,265,134,184,218,10.16436672615,14.1821842474258,0.486296835045058,2020-04-06,2020,4
"2187","MA",2,"Nordeste",21002,"Aglomeração Urbana de São Luís",1442927,25961.4162950517,15,325,57,268,129,196,2,1,1,1,1,327,58,269,130,197,274,10.16436672615,14.1821842474258,0.479579595934433,2020-04-13,2020,4
"2188","MA",2,"Nordeste",21002,"Aglomeração Urbana de São Luís",1442927,25961.4162950517,16,290,46,244,122,168,2,0,2,0,2,292,46,246,122,170,468,10.16436672615,14.1821842474258,0.500299603393805,2020-04-20,2020,4
"2189","MA",2,"Nordeste",21002,"Aglomeração Urbana de São Luís",1442927,25961.4162950517,17,326,62,264,141,185,2,0,2,1,1,328,62,266,142,186,639,10.16436672615,14.1821842474258,0.484364688771661,2020-04-27,2020,4
"2190","MA",2,"Nordeste",21002,"Aglomeração Urbana de São Luís",1442927,25961.4162950517,18,307,56,251,118,189,2,1,1,0,2,309,57,252,118,191,511,10.16436672615,14.1821842474258,0.516981791295742,2020-05-04,2020,5
"2191","MA",2,"Nordeste",21002,"Aglomeração Urbana de São Luís",1442927,25961.4162950517,19,368,71,297,121,247,2,2,0,1,1,370,73,297,122,248,426,10.16436672615,14.1821842474258,0.522810779474323,2020-05-11,2020,5
"2192","MA",2,"Nordeste",21002,"Aglomeração Urbana de São Luís",1442927,25961.4162950517,20,366,54,312,139,227,4,2,2,0,4,370,56,314,139,231,303,10.16436672615,14.1821842474258,0.449386044185702,2020-05-18,2020,5
"2193","MA",2,"Nordeste",21002,"Aglomeração Urbana de São Luís",1442927,25961.4162950517,21,370,78,292,141,229,3,1,2,1,2,373,79,294,142,231,241,10.16436672615,14.1821842474258,0.427191341842423,2020-05-25,2020,5
"2194","MA",2,"Nordeste",21003,"Rosário",179884,8098.3421388228,5,48,14,34,35,13,0,0,0,0,0,48,14,34,35,13,13,8.9994146454925,12.1000674776843,0.263312593775675,2020-02-03,2020,2
"2195","MA",2,"Nordeste",21003,"Rosário",179884,8098.3421388228,6,37,13,24,19,18,1,1,0,0,1,38,14,24,19,19,15,8.9994146454925,12.1000674776843,0.268780836762648,2020-02-10,2020,2
"2196","MA",2,"Nordeste",21003,"Rosário",179884,8098.3421388228,7,49,11,38,28,21,0,0,0,0,0,49,11,38,28,21,18,8.9994146454925,12.1000674776843,0.280214941617906,2020-02-17,2020,2
"2197","MA",2,"Nordeste",21003,"Rosário",179884,8098.3421388228,8,42,14,28,24,18,2,0,2,0,2,44,14,30,24,20,27,8.9994146454925,12.1000674776843,0.32190452125722,2020-02-24,2020,2
"2198","MA",2,"Nordeste",21003,"Rosário",179884,8098.3421388228,9,55,17,38,32,23,2,2,0,0,2,57,19,38,32,25,15,8.9994146454925,12.1000674776843,0.304967342136497,2020-03-02,2020,3
"2199","MA",2,"Nordeste",21003,"Rosário",179884,8098.3421388228,10,42,13,29,22,20,1,0,1,1,0,43,13,30,23,20,15,8.9994146454925,12.1000674776843,0.33255160750638,2020-03-09,2020,3
"2200","MA",2,"Nordeste",21003,"Rosário",179884,8098.3421388228,11,41,10,31,24,17,1,1,0,0,1,42,11,31,24,18,13,8.9994146454925,12.1000674776843,0.359880336096401,2020-03-16,2020,3
"2201","MA",2,"Nordeste",21003,"Rosário",179884,8098.3421388228,12,26,7,19,13,13,1,0,1,1,0,27,7,20,14,13,19,8.9994146454925,12.1000674776843,0.429818873093416,2020-03-23,2020,3
"2202","MA",2,"Nordeste",21003,"Rosário",179884,8098.3421388228,13,37,18,19,19,18,0,0,0,0,0,37,18,19,19,18,16,8.9994146454925,12.1000674776843,0.397897488403325,2020-03-30,2020,3
"2203","MA",2,"Nordeste",21003,"Rosário",179884,8098.3421388228,14,43,12,31,21,22,0,0,0,0,0,43,12,31,21,22,16,8.9994146454925,12.1000674776843,0.395823605773988,2020-04-06,2020,4
"2204","MA",2,"Nordeste",21003,"Rosário",179884,8098.3421388228,15,29,14,15,18,11,0,0,0,0,0,29,14,15,18,11,18,8.9994146454925,12.1000674776843,0.386717988619647,2020-04-13,2020,4
"2205","MA",2,"Nordeste",21003,"Rosário",179884,8098.3421388228,16,42,12,30,24,18,0,0,0,0,0,42,12,30,24,18,19,8.9994146454925,12.1000674776843,0.408682861033236,2020-04-20,2020,4
"2206","MA",2,"Nordeste",21003,"Rosário",179884,8098.3421388228,17,46,13,33,29,17,0,0,0,0,0,46,13,33,29,17,24,8.9994146454925,12.1000674776843,0.403413023330762,2020-04-27,2020,4
"2207","MA",2,"Nordeste",21003,"Rosário",179884,8098.3421388228,18,30,11,19,17,13,2,0,2,0,2,32,11,21,17,15,39,8.9994146454925,12.1000674776843,0.409628953681497,2020-05-04,2020,5
"2208","MA",2,"Nordeste",21003,"Rosário",179884,8098.3421388228,19,33,11,22,22,11,0,0,0,0,0,33,11,22,22,11,43,8.9994146454925,12.1000674776843,0.417905765655137,2020-05-11,2020,5
"2209","MA",2,"Nordeste",21003,"Rosário",179884,8098.3421388228,20,37,11,26,18,19,2,1,1,1,1,39,12,27,19,20,32,8.9994146454925,12.1000674776843,0.395174546283818,2020-05-18,2020,5
"2210","MA",2,"Nordeste",21003,"Rosário",179884,8098.3421388228,21,42,12,30,23,19,0,0,0,0,0,42,12,30,23,19,31,8.9994146454925,12.1000674776843,0.364748032143522,2020-05-25,2020,5
"2211","MA",2,"Nordeste",21004,"Lençóis Maranhenses",199178,6719.86770039864,5,67,24,43,40,27,1,1,0,1,0,68,25,43,41,27,12,8.81282374588272,12.2019541762664,0.261256494101368,2020-02-03,2020,2
"2212","MA",2,"Nordeste",21004,"Lençóis Maranhenses",199178,6719.86770039864,6,80,30,50,42,38,0,0,0,0,0,80,30,50,42,38,12,8.81282374588272,12.2019541762664,0.27139477845346,2020-02-10,2020,2
"2213","MA",2,"Nordeste",21004,"Lençóis Maranhenses",199178,6719.86770039864,7,67,32,35,37,30,0,0,0,0,0,67,32,35,37,30,14,8.81282374588272,12.2019541762664,0.276861272525458,2020-02-17,2020,2
"2214","MA",2,"Nordeste",21004,"Lençóis Maranhenses",199178,6719.86770039864,8,68,30,38,39,29,0,0,0,0,0,68,30,38,39,29,12,8.81282374588272,12.2019541762664,0.307333208844039,2020-02-24,2020,2
"2215","MA",2,"Nordeste",21004,"Lençóis Maranhenses",199178,6719.86770039864,9,62,23,39,32,30,3,3,0,2,1,65,26,39,34,31,15,8.81282374588272,12.2019541762664,0.292214432385547,2020-03-02,2020,3
"2216","MA",2,"Nordeste",21004,"Lençóis Maranhenses",199178,6719.86770039864,10,44,17,27,24,20,0,0,0,0,0,44,17,27,24,20,14,8.81282374588272,12.2019541762664,0.306030765168775,2020-03-09,2020,3
"2217","MA",2,"Nordeste",21004,"Lençóis Maranhenses",199178,6719.86770039864,11,52,23,29,28,24,0,0,0,0,0,52,23,29,28,24,29,8.81282374588272,12.2019541762664,0.369820840924911,2020-03-16,2020,3
"2218","MA",2,"Nordeste",21004,"Lençóis Maranhenses",199178,6719.86770039864,12,68,26,42,37,31,1,1,0,1,0,69,27,42,38,31,15,8.81282374588272,12.2019541762664,0.432109606493465,2020-03-23,2020,3
"2219","MA",2,"Nordeste",21004,"Lençóis Maranhenses",199178,6719.86770039864,13,46,28,18,28,18,1,0,1,0,1,47,28,19,28,19,15,8.81282374588272,12.2019541762664,0.414443524928043,2020-03-30,2020,3
"2220","MA",2,"Nordeste",21004,"Lençóis Maranhenses",199178,6719.86770039864,14,49,19,30,28,21,1,0,1,0,1,50,19,31,28,22,17,8.81282374588272,12.2019541762664,0.406780451378112,2020-04-06,2020,4
"2221","MA",2,"Nordeste",21004,"Lençóis Maranhenses",199178,6719.86770039864,15,55,22,33,22,33,0,0,0,0,0,55,22,33,22,33,16,8.81282374588272,12.2019541762664,0.373967874687489,2020-04-13,2020,4
"2222","MA",2,"Nordeste",21004,"Lençóis Maranhenses",199178,6719.86770039864,16,65,27,38,33,32,1,1,0,1,0,66,28,38,34,32,15,8.81282374588272,12.2019541762664,0.381642060302531,2020-04-20,2020,4
"2223","MA",2,"Nordeste",21004,"Lençóis Maranhenses",199178,6719.86770039864,17,58,18,40,27,31,3,2,1,1,2,61,20,41,28,33,25,8.81282374588272,12.2019541762664,0.412971290592188,2020-04-27,2020,4
"2224","MA",2,"Nordeste",21004,"Lençóis Maranhenses",199178,6719.86770039864,18,47,20,27,26,21,1,0,1,1,0,48,20,28,27,21,29,8.81282374588272,12.2019541762664,0.449896899355027,2020-05-04,2020,5
"2225","MA",2,"Nordeste",21004,"Lençóis Maranhenses",199178,6719.86770039864,19,56,23,33,28,28,0,0,0,0,0,56,23,33,28,28,46,8.81282374588272,12.2019541762664,0.469994603053376,2020-05-11,2020,5
"2226","MA",2,"Nordeste",21004,"Lençóis Maranhenses",199178,6719.86770039864,20,62,23,39,28,34,1,1,0,1,0,63,24,39,29,34,48,8.81282374588272,12.2019541762664,0.430480737938723,2020-05-18,2020,5
"2227","MA",2,"Nordeste",21004,"Lençóis Maranhenses",199178,6719.86770039864,21,64,19,45,37,27,0,0,0,0,0,64,19,45,37,27,34,8.81282374588272,12.2019541762664,0.401105260638566,2020-05-25,2020,5
"2228","MA",2,"Nordeste",21005,"Baixada Maranhense",608061,7301.79371903477,5,138,46,92,85,53,3,1,2,3,0,141,47,94,88,53,64,8.89587531188978,13.3180304848631,0.273382888176337,2020-02-03,2020,2
"2229","MA",2,"Nordeste",21005,"Baixada Maranhense",608061,7301.79371903477,6,151,53,98,83,68,0,0,0,0,0,151,53,98,83,68,67,8.89587531188978,13.3180304848631,0.269738797766368,2020-02-10,2020,2
"2230","MA",2,"Nordeste",21005,"Baixada Maranhense",608061,7301.79371903477,7,142,41,101,79,63,1,0,1,0,1,143,41,102,79,64,58,8.89587531188978,13.3180304848631,0.287382981761637,2020-02-17,2020,2
"2231","MA",2,"Nordeste",21005,"Baixada Maranhense",608061,7301.79371903477,8,161,63,98,86,75,4,1,3,1,3,165,64,101,87,78,55,8.89587531188978,13.3180304848631,0.335695729733786,2020-02-24,2020,2
"2232","MA",2,"Nordeste",21005,"Baixada Maranhense",608061,7301.79371903477,9,140,49,91,78,62,3,0,3,3,0,143,49,94,81,62,58,8.89587531188978,13.3180304848631,0.30379691039143,2020-03-02,2020,3
"2233","MA",2,"Nordeste",21005,"Baixada Maranhense",608061,7301.79371903477,10,127,34,93,80,47,1,1,0,0,1,128,35,93,80,48,66,8.89587531188978,13.3180304848631,0.327754964176111,2020-03-09,2020,3
"2234","MA",2,"Nordeste",21005,"Baixada Maranhense",608061,7301.79371903477,11,127,33,94,73,54,2,2,0,0,2,129,35,94,73,56,58,8.89587531188978,13.3180304848631,0.365235952713252,2020-03-16,2020,3
"2235","MA",2,"Nordeste",21005,"Baixada Maranhense",608061,7301.79371903477,12,119,41,78,49,70,2,0,2,1,1,121,41,80,50,71,57,8.89587531188978,13.3180304848631,0.45257520281935,2020-03-23,2020,3
"2236","MA",2,"Nordeste",21005,"Baixada Maranhense",608061,7301.79371903477,13,107,31,76,59,48,2,1,1,0,2,109,32,77,59,50,59,8.89587531188978,13.3180304848631,0.418639238424325,2020-03-30,2020,3
"2237","MA",2,"Nordeste",21005,"Baixada Maranhense",608061,7301.79371903477,14,147,52,95,90,57,2,0,2,1,1,149,52,97,91,58,62,8.89587531188978,13.3180304848631,0.407784786298017,2020-04-06,2020,4
"2238","MA",2,"Nordeste",21005,"Baixada Maranhense",608061,7301.79371903477,15,112,37,75,60,52,1,1,0,1,0,113,38,75,61,52,44,8.89587531188978,13.3180304848631,0.39471456217769,2020-04-13,2020,4
"2239","MA",2,"Nordeste",21005,"Baixada Maranhense",608061,7301.79371903477,16,142,55,87,76,66,2,1,1,2,0,144,56,88,78,66,65,8.89587531188978,13.3180304848631,0.401853054755907,2020-04-20,2020,4
"2240","MA",2,"Nordeste",21005,"Baixada Maranhense",608061,7301.79371903477,17,123,57,66,70,53,2,1,1,1,1,125,58,67,71,54,97,8.89587531188978,13.3180304848631,0.411050050722761,2020-04-27,2020,4
"2241","MA",2,"Nordeste",21005,"Baixada Maranhense",608061,7301.79371903477,18,117,36,81,66,51,1,0,1,0,1,118,36,82,66,52,131,8.89587531188978,13.3180304848631,0.448274219244365,2020-05-04,2020,5
"2242","MA",2,"Nordeste",21005,"Baixada Maranhense",608061,7301.79371903477,19,128,42,86,71,57,2,0,2,1,1,130,42,88,72,58,108,8.89587531188978,13.3180304848631,0.465172421347188,2020-05-11,2020,5
"2243","MA",2,"Nordeste",21005,"Baixada Maranhense",608061,7301.79371903477,20,146,53,93,82,64,0,0,0,0,0,146,53,93,82,64,120,8.89587531188978,13.3180304848631,0.44689935202321,2020-05-18,2020,5
"2244","MA",2,"Nordeste",21005,"Baixada Maranhense",608061,7301.79371903477,21,130,47,83,72,58,5,2,3,1,4,135,49,86,73,62,101,8.89587531188978,13.3180304848631,0.423491371695989,2020-05-25,2020,5
"2245","MA",2,"Nordeste",21006,"Itapecuru Mirim",238418,8164.85092031642,5,73,29,44,39,34,1,0,1,0,1,74,29,45,39,35,35,9.00759374685655,12.3817807146788,0.257414584854608,2020-02-03,2020,2
"2246","MA",2,"Nordeste",21006,"Itapecuru Mirim",238418,8164.85092031642,6,58,23,35,32,26,0,0,0,0,0,58,23,35,32,26,22,9.00759374685655,12.3817807146788,0.255418319360421,2020-02-10,2020,2
"2247","MA",2,"Nordeste",21006,"Itapecuru Mirim",238418,8164.85092031642,7,65,21,44,34,31,0,0,0,0,0,65,21,44,34,31,22,9.00759374685655,12.3817807146788,0.257412173823312,2020-02-17,2020,2
"2248","MA",2,"Nordeste",21006,"Itapecuru Mirim",238418,8164.85092031642,8,75,30,45,41,34,2,2,0,1,1,77,32,45,42,35,17,9.00759374685655,12.3817807146788,0.303927338168176,2020-02-24,2020,2
"2249","MA",2,"Nordeste",21006,"Itapecuru Mirim",238418,8164.85092031642,9,58,19,39,41,17,0,0,0,0,0,58,19,39,41,17,20,9.00759374685655,12.3817807146788,0.297347259393399,2020-03-02,2020,3
"2250","MA",2,"Nordeste",21006,"Itapecuru Mirim",238418,8164.85092031642,10,62,24,38,36,26,1,1,0,1,0,63,25,38,37,26,30,9.00759374685655,12.3817807146788,0.311581733222153,2020-03-09,2020,3
"2251","MA",2,"Nordeste",21006,"Itapecuru Mirim",238418,8164.85092031642,11,39,14,25,19,20,0,0,0,0,0,39,14,25,19,20,28,9.00759374685655,12.3817807146788,0.336328589059485,2020-03-16,2020,3
"2252","MA",2,"Nordeste",21006,"Itapecuru Mirim",238418,8164.85092031642,12,46,17,29,22,24,0,0,0,0,0,46,17,29,22,24,10,9.00759374685655,12.3817807146788,0.423133584978943,2020-03-23,2020,3
"2253","MA",2,"Nordeste",21006,"Itapecuru Mirim",238418,8164.85092031642,13,44,18,26,25,19,1,1,0,0,1,45,19,26,25,20,19,9.00759374685655,12.3817807146788,0.382879218600771,2020-03-30,2020,3
"2254","MA",2,"Nordeste",21006,"Itapecuru Mirim",238418,8164.85092031642,14,62,22,40,34,28,0,0,0,0,0,62,22,40,34,28,17,9.00759374685655,12.3817807146788,0.385994091510681,2020-04-06,2020,4
"2255","MA",2,"Nordeste",21006,"Itapecuru Mirim",238418,8164.85092031642,15,67,27,40,36,31,1,0,1,1,0,68,27,41,37,31,13,9.00759374685655,12.3817807146788,0.370473355419408,2020-04-13,2020,4
"2256","MA",2,"Nordeste",21006,"Itapecuru Mirim",238418,8164.85092031642,16,49,12,37,28,21,1,0,1,1,0,50,12,38,29,21,21,9.00759374685655,12.3817807146788,0.375431916868569,2020-04-20,2020,4
"2257","MA",2,"Nordeste",21006,"Itapecuru Mirim",238418,8164.85092031642,17,46,23,23,24,22,1,0,1,1,0,47,23,24,25,22,18,9.00759374685655,12.3817807146788,0.38310601147243,2020-04-27,2020,4
"2258","MA",2,"Nordeste",21006,"Itapecuru Mirim",238418,8164.85092031642,18,53,19,34,25,28,0,0,0,0,0,53,19,34,25,28,27,9.00759374685655,12.3817807146788,0.391362094694984,2020-05-04,2020,5
"2259","MA",2,"Nordeste",21006,"Itapecuru Mirim",238418,8164.85092031642,19,58,26,32,29,29,1,1,0,0,1,59,27,32,29,30,39,9.00759374685655,12.3817807146788,0.422333703281763,2020-05-11,2020,5
"2260","MA",2,"Nordeste",21006,"Itapecuru Mirim",238418,8164.85092031642,20,61,15,46,32,29,0,0,0,0,0,61,15,46,32,29,34,9.00759374685655,12.3817807146788,0.388747911839084,2020-05-18,2020,5
"2261","MA",2,"Nordeste",21006,"Itapecuru Mirim",238418,8164.85092031642,21,65,18,47,40,25,0,0,0,0,0,65,18,47,40,25,34,9.00759374685655,12.3817807146788,0.382275823068341,2020-05-25,2020,5
"2262","MA",2,"Nordeste",21007,"Gurupi",243679,7322.4424563873,5,57,18,39,33,24,1,0,1,1,0,58,18,40,34,24,15,8.89869922020564,12.403607064378,0.286989283017173,2020-02-03,2020,2
"2263","MA",2,"Nordeste",21007,"Gurupi",243679,7322.4424563873,6,56,16,40,30,26,0,0,0,0,0,56,16,40,30,26,11,8.89869922020564,12.403607064378,0.276488753067769,2020-02-10,2020,2
"2264","MA",2,"Nordeste",21007,"Gurupi",243679,7322.4424563873,7,49,23,26,32,17,0,0,0,0,0,49,23,26,32,17,8,8.89869922020564,12.403607064378,0.300141796329599,2020-02-17,2020,2
"2265","MA",2,"Nordeste",21007,"Gurupi",243679,7322.4424563873,8,51,25,26,36,15,1,0,1,1,0,52,25,27,37,15,21,8.89869922020564,12.403607064378,0.337283972217001,2020-02-24,2020,2
"2266","MA",2,"Nordeste",21007,"Gurupi",243679,7322.4424563873,9,46,22,24,22,24,1,1,0,1,0,47,23,24,23,24,15,8.89869922020564,12.403607064378,0.316401142190936,2020-03-02,2020,3
"2267","MA",2,"Nordeste",21007,"Gurupi",243679,7322.4424563873,10,44,19,25,20,24,1,0,1,1,0,45,19,26,21,24,16,8.89869922020564,12.403607064378,0.360821112977581,2020-03-09,2020,3
"2268","MA",2,"Nordeste",21007,"Gurupi",243679,7322.4424563873,11,29,12,17,13,16,0,0,0,0,0,29,12,17,13,16,14,8.89869922020564,12.403607064378,0.387513995446178,2020-03-16,2020,3
"2269","MA",2,"Nordeste",21007,"Gurupi",243679,7322.4424563873,12,33,10,23,19,14,0,0,0,0,0,33,10,23,19,14,12,8.89869922020564,12.403607064378,0.471224442348288,2020-03-23,2020,3
"2270","MA",2,"Nordeste",21007,"Gurupi",243679,7322.4424563873,13,26,12,14,15,11,0,0,0,0,0,26,12,14,15,11,25,8.89869922020564,12.403607064378,0.432423646525771,2020-03-30,2020,3
"2271","MA",2,"Nordeste",21007,"Gurupi",243679,7322.4424563873,14,38,16,22,22,16,2,1,1,2,0,40,17,23,24,16,12,8.89869922020564,12.403607064378,0.423400332695576,2020-04-06,2020,4
"2272","MA",2,"Nordeste",21007,"Gurupi",243679,7322.4424563873,15,37,13,24,17,20,0,0,0,0,0,37,13,24,17,20,17,8.89869922020564,12.403607064378,0.408232928847951,2020-04-13,2020,4
"2273","MA",2,"Nordeste",21007,"Gurupi",243679,7322.4424563873,16,48,18,30,24,24,0,0,0,0,0,48,18,30,24,24,17,8.89869922020564,12.403607064378,0.408108153952116,2020-04-20,2020,4
"2274","MA",2,"Nordeste",21007,"Gurupi",243679,7322.4424563873,17,35,13,22,18,17,0,0,0,0,0,35,13,22,18,17,16,8.89869922020564,12.403607064378,0.423518123721681,2020-04-27,2020,4
"2275","MA",2,"Nordeste",21007,"Gurupi",243679,7322.4424563873,18,31,12,19,17,14,0,0,0,0,0,31,12,19,17,14,22,8.89869922020564,12.403607064378,0.472572421452341,2020-05-04,2020,5
"2276","MA",2,"Nordeste",21007,"Gurupi",243679,7322.4424563873,19,33,16,17,16,17,0,0,0,0,0,33,16,17,16,17,34,8.89869922020564,12.403607064378,0.498465262843331,2020-05-11,2020,5
"2277","MA",2,"Nordeste",21007,"Gurupi",243679,7322.4424563873,20,38,16,22,23,15,3,1,2,2,1,41,17,24,25,16,36,8.89869922020564,12.403607064378,0.467298967244533,2020-05-18,2020,5
"2278","MA",2,"Nordeste",21007,"Gurupi",243679,7322.4424563873,21,39,14,25,28,11,0,0,0,0,0,39,14,25,28,11,27,8.89869922020564,12.403607064378,0.44254429451334,2020-05-25,2020,5
"2279","MA",2,"Nordeste",21008,"Pindaré",669222,8530.96601978118,5,184,66,118,101,83,1,1,0,0,1,185,67,118,101,84,61,9.05145788375473,13.4138711226291,0.286815247334273,2020-02-03,2020,2
"2280","MA",2,"Nordeste",21008,"Pindaré",669222,8530.96601978118,6,174,77,97,105,69,2,0,2,1,1,176,77,99,106,70,63,9.05145788375473,13.4138711226291,0.281543445049828,2020-02-10,2020,2
"2281","MA",2,"Nordeste",21008,"Pindaré",669222,8530.96601978118,7,183,77,106,99,84,0,0,0,0,0,183,77,106,99,84,48,9.05145788375473,13.4138711226291,0.294906833929285,2020-02-17,2020,2
"2282","MA",2,"Nordeste",21008,"Pindaré",669222,8530.96601978118,8,179,82,97,100,79,3,1,2,3,0,182,83,99,103,79,62,9.05145788375473,13.4138711226291,0.335863445359761,2020-02-24,2020,2
"2283","MA",2,"Nordeste",21008,"Pindaré",669222,8530.96601978118,9,179,61,118,102,77,2,1,1,2,0,181,62,119,104,77,65,9.05145788375473,13.4138711226291,0.319792767733783,2020-03-02,2020,3
"2284","MA",2,"Nordeste",21008,"Pindaré",669222,8530.96601978118,10,166,61,105,98,68,3,3,0,2,1,169,64,105,100,69,57,9.05145788375473,13.4138711226291,0.342393082885443,2020-03-09,2020,3
"2285","MA",2,"Nordeste",21008,"Pindaré",669222,8530.96601978118,11,160,66,94,90,70,2,1,1,1,1,162,67,95,91,71,78,9.05145788375473,13.4138711226291,0.386187034351516,2020-03-16,2020,3
"2286","MA",2,"Nordeste",21008,"Pindaré",669222,8530.96601978118,12,124,46,78,65,59,4,1,3,2,2,128,47,81,67,61,59,9.05145788375473,13.4138711226291,0.477014169644873,2020-03-23,2020,3
"2287","MA",2,"Nordeste",21008,"Pindaré",669222,8530.96601978118,13,125,43,82,66,59,1,0,1,0,1,126,43,83,66,60,67,9.05145788375473,13.4138711226291,0.4308557851067,2020-03-30,2020,3
"2288","MA",2,"Nordeste",21008,"Pindaré",669222,8530.96601978118,14,138,48,90,81,57,4,2,2,3,1,142,50,92,84,58,74,9.05145788375473,13.4138711226291,0.423914055962723,2020-04-06,2020,4
"2289","MA",2,"Nordeste",21008,"Pindaré",669222,8530.96601978118,15,162,70,92,99,63,6,3,3,1,5,168,73,95,100,68,50,9.05145788375473,13.4138711226291,0.393349305460533,2020-04-13,2020,4
"2290","MA",2,"Nordeste",21008,"Pindaré",669222,8530.96601978118,16,160,62,98,90,70,2,0,2,1,1,162,62,100,91,71,73,9.05145788375473,13.4138711226291,0.393648410583549,2020-04-20,2020,4
"2291","MA",2,"Nordeste",21008,"Pindaré",669222,8530.96601978118,17,157,54,103,88,69,3,2,1,2,1,160,56,104,90,70,61,9.05145788375473,13.4138711226291,0.403192700624586,2020-04-27,2020,4
"2292","MA",2,"Nordeste",21008,"Pindaré",669222,8530.96601978118,18,155,55,100,92,63,1,1,0,1,0,156,56,100,93,63,106,9.05145788375473,13.4138711226291,0.42950124585925,2020-05-04,2020,5
"2293","MA",2,"Nordeste",21008,"Pindaré",669222,8530.96601978118,19,148,62,86,88,60,2,2,0,1,1,150,64,86,89,61,108,9.05145788375473,13.4138711226291,0.470684682657562,2020-05-11,2020,5
"2294","MA",2,"Nordeste",21008,"Pindaré",669222,8530.96601978118,20,148,70,78,89,59,1,1,0,1,0,149,71,78,90,59,138,9.05145788375473,13.4138711226291,0.459556782847655,2020-05-18,2020,5
"2295","MA",2,"Nordeste",21008,"Pindaré",669222,8530.96601978118,21,161,61,100,100,61,2,1,1,1,1,163,62,101,101,62,131,9.05145788375473,13.4138711226291,0.441192516516953,2020-05-25,2020,5
"2296","MA",2,"Nordeste",21009,"Imperatriz",602537,20451.6003666829,5,74,16,58,32,42,1,1,0,1,0,75,17,58,33,42,77,9.92581641594849,13.3089043532498,0.290041935336054,2020-02-03,2020,2
"2297","MA",2,"Nordeste",21009,"Imperatriz",602537,20451.6003666829,6,56,20,36,21,35,1,1,0,1,0,57,21,36,22,35,75,9.92581641594849,13.3089043532498,0.279051239780639,2020-02-10,2020,2
"2298","MA",2,"Nordeste",21009,"Imperatriz",602537,20451.6003666829,7,95,26,69,41,54,1,0,1,0,1,96,26,70,41,55,81,9.92581641594849,13.3089043532498,0.299894687416052,2020-02-17,2020,2
"2299","MA",2,"Nordeste",21009,"Imperatriz",602537,20451.6003666829,8,64,16,48,31,33,3,3,0,0,3,67,19,48,31,36,75,9.92581641594849,13.3089043532498,0.342057602955697,2020-02-24,2020,2
"2300","MA",2,"Nordeste",21009,"Imperatriz",602537,20451.6003666829,9,75,22,53,27,48,3,3,0,2,1,78,25,53,29,49,62,9.92581641594849,13.3089043532498,0.315303758316773,2020-03-02,2020,3
"2301","MA",2,"Nordeste",21009,"Imperatriz",602537,20451.6003666829,10,71,22,49,31,40,1,0,1,0,1,72,22,50,31,41,83,9.92581641594849,13.3089043532498,0.33829789550285,2020-03-09,2020,3
"2302","MA",2,"Nordeste",21009,"Imperatriz",602537,20451.6003666829,11,70,20,50,29,41,0,0,0,0,0,70,20,50,29,41,81,9.92581641594849,13.3089043532498,0.396498131683996,2020-03-16,2020,3
"2303","MA",2,"Nordeste",21009,"Imperatriz",602537,20451.6003666829,12,87,22,65,41,46,0,0,0,0,0,87,22,65,41,46,49,9.92581641594849,13.3089043532498,0.502222403022204,2020-03-23,2020,3
"2304","MA",2,"Nordeste",21009,"Imperatriz",602537,20451.6003666829,13,54,11,43,20,34,1,1,0,1,0,55,12,43,21,34,82,9.92581641594849,13.3089043532498,0.456744616745206,2020-03-30,2020,3
"2305","MA",2,"Nordeste",21009,"Imperatriz",602537,20451.6003666829,14,84,30,54,38,46,0,0,0,0,0,84,30,54,38,46,59,9.92581641594849,13.3089043532498,0.442422605497549,2020-04-06,2020,4
"2306","MA",2,"Nordeste",21009,"Imperatriz",602537,20451.6003666829,15,74,21,53,31,43,1,1,0,0,1,75,22,53,31,44,71,9.92581641594849,13.3089043532498,0.420398757852767,2020-04-13,2020,4
"2307","MA",2,"Nordeste",21009,"Imperatriz",602537,20451.6003666829,16,97,29,68,37,60,1,1,0,0,1,98,30,68,37,61,68,9.92581641594849,13.3089043532498,0.432712740646308,2020-04-20,2020,4
"2308","MA",2,"Nordeste",21009,"Imperatriz",602537,20451.6003666829,17,71,19,52,28,43,1,1,0,1,0,72,20,52,29,43,108,9.92581641594849,13.3089043532498,0.423664976828336,2020-04-27,2020,4
"2309","MA",2,"Nordeste",21009,"Imperatriz",602537,20451.6003666829,18,70,21,49,26,44,2,1,1,2,0,72,22,50,28,44,133,9.92581641594849,13.3089043532498,0.432512507904658,2020-05-04,2020,5
"2310","MA",2,"Nordeste",21009,"Imperatriz",602537,20451.6003666829,19,71,26,45,29,42,2,1,1,2,0,73,27,46,31,42,163,9.92581641594849,13.3089043532498,0.465632178114333,2020-05-11,2020,5
"2311","MA",2,"Nordeste",21009,"Imperatriz",602537,20451.6003666829,20,85,31,54,37,48,4,3,1,3,1,89,34,55,40,49,193,9.92581641594849,13.3089043532498,0.457400296243235,2020-05-18,2020,5
"2312","MA",2,"Nordeste",21009,"Imperatriz",602537,20451.6003666829,21,104,31,73,42,62,3,2,1,1,2,107,33,74,43,64,164,9.92581641594849,13.3089043532498,0.43146552450734,2020-05-25,2020,5
"2313","MA",2,"Nordeste",21010,"Médio Mearim",424432,13723.5915067431,5,112,50,62,59,53,1,0,1,1,0,113,50,63,60,53,42,9.52687163865217,12.958507083445,0.270291143933132,2020-02-03,2020,2
"2314","MA",2,"Nordeste",21010,"Médio Mearim",424432,13723.5915067431,6,110,37,73,61,49,1,0,1,0,1,111,37,74,61,50,44,9.52687163865217,12.958507083445,0.256361806769942,2020-02-10,2020,2
"2315","MA",2,"Nordeste",21010,"Médio Mearim",424432,13723.5915067431,7,120,41,79,66,54,1,1,0,0,1,121,42,79,66,55,44,9.52687163865217,12.958507083445,0.265050587804341,2020-02-17,2020,2
"2316","MA",2,"Nordeste",21010,"Médio Mearim",424432,13723.5915067431,8,118,37,81,65,53,1,1,0,0,1,119,38,81,65,54,42,9.52687163865217,12.958507083445,0.322370877541356,2020-02-24,2020,2
"2317","MA",2,"Nordeste",21010,"Médio Mearim",424432,13723.5915067431,9,126,33,93,55,71,0,0,0,0,0,126,33,93,55,71,47,9.52687163865217,12.958507083445,0.300283707375602,2020-03-02,2020,3
"2318","MA",2,"Nordeste",21010,"Médio Mearim",424432,13723.5915067431,10,97,37,60,49,48,2,2,0,1,1,99,39,60,50,49,59,9.52687163865217,12.958507083445,0.324519949150293,2020-03-09,2020,3
"2319","MA",2,"Nordeste",21010,"Médio Mearim",424432,13723.5915067431,11,104,33,71,59,45,2,0,2,0,2,106,33,73,59,47,43,9.52687163865217,12.958507083445,0.375481232532286,2020-03-16,2020,3
"2320","MA",2,"Nordeste",21010,"Médio Mearim",424432,13723.5915067431,12,103,35,68,54,49,0,0,0,0,0,103,35,68,54,49,64,9.52687163865217,12.958507083445,0.482997019474482,2020-03-23,2020,3
"2321","MA",2,"Nordeste",21010,"Médio Mearim",424432,13723.5915067431,13,71,24,47,42,29,0,0,0,0,0,71,24,47,42,29,45,9.52687163865217,12.958507083445,0.42111676021376,2020-03-30,2020,3
"2322","MA",2,"Nordeste",21010,"Médio Mearim",424432,13723.5915067431,14,105,27,78,62,43,0,0,0,0,0,105,27,78,62,43,35,9.52687163865217,12.958507083445,0.413397326720123,2020-04-06,2020,4
"2323","MA",2,"Nordeste",21010,"Médio Mearim",424432,13723.5915067431,15,100,33,67,56,44,0,0,0,0,0,100,33,67,56,44,40,9.52687163865217,12.958507083445,0.398575691221891,2020-04-13,2020,4
"2324","MA",2,"Nordeste",21010,"Médio Mearim",424432,13723.5915067431,16,111,31,80,60,51,3,1,2,3,0,114,32,82,63,51,39,9.52687163865217,12.958507083445,0.394688857865842,2020-04-20,2020,4
"2325","MA",2,"Nordeste",21010,"Médio Mearim",424432,13723.5915067431,17,92,34,58,48,44,1,0,1,0,1,93,34,59,48,45,62,9.52687163865217,12.958507083445,0.396388129069119,2020-04-27,2020,4
"2326","MA",2,"Nordeste",21010,"Médio Mearim",424432,13723.5915067431,18,76,29,47,45,31,0,0,0,0,0,76,29,47,45,31,77,9.52687163865217,12.958507083445,0.423116153132546,2020-05-04,2020,5
"2327","MA",2,"Nordeste",21010,"Médio Mearim",424432,13723.5915067431,19,89,31,58,43,46,2,0,2,1,1,91,31,60,44,47,93,9.52687163865217,12.958507083445,0.467896252514005,2020-05-11,2020,5
"2328","MA",2,"Nordeste",21010,"Médio Mearim",424432,13723.5915067431,20,97,35,62,51,46,0,0,0,0,0,97,35,62,51,46,119,9.52687163865217,12.958507083445,0.456030897754156,2020-05-18,2020,5
"2329","MA",2,"Nordeste",21010,"Médio Mearim",424432,13723.5915067431,21,105,27,78,58,47,2,0,2,1,1,107,27,80,59,48,119,9.52687163865217,12.958507083445,0.451124577405637,2020-05-25,2020,5
"2330","MA",2,"Nordeste",21011,"Alto Mearim e Grajaú",338308,8119.02497975218,5,102,44,58,52,50,2,1,1,0,2,104,45,59,52,52,35,9.00196534956078,12.7317120021392,0.275606160273423,2020-02-03,2020,2
"2331","MA",2,"Nordeste",21011,"Alto Mearim e Grajaú",338308,8119.02497975218,6,94,46,48,46,48,2,2,0,0,2,96,48,48,46,50,30,9.00196534956078,12.7317120021392,0.272169809941789,2020-02-10,2020,2
"2332","MA",2,"Nordeste",21011,"Alto Mearim e Grajaú",338308,8119.02497975218,7,82,47,35,56,26,0,0,0,0,0,82,47,35,56,26,33,9.00196534956078,12.7317120021392,0.277370324081158,2020-02-17,2020,2
"2333","MA",2,"Nordeste",21011,"Alto Mearim e Grajaú",338308,8119.02497975218,8,81,41,40,49,32,1,0,1,0,1,82,41,41,49,33,35,9.00196534956078,12.7317120021392,0.32690816192959,2020-02-24,2020,2
"2334","MA",2,"Nordeste",21011,"Alto Mearim e Grajaú",338308,8119.02497975218,9,89,49,40,48,41,1,0,1,0,1,90,49,41,48,42,36,9.00196534956078,12.7317120021392,0.305207487540878,2020-03-02,2020,3
"2335","MA",2,"Nordeste",21011,"Alto Mearim e Grajaú",338308,8119.02497975218,10,70,35,35,36,34,1,0,1,0,1,71,35,36,36,35,37,9.00196534956078,12.7317120021392,0.322203352189129,2020-03-09,2020,3
"2336","MA",2,"Nordeste",21011,"Alto Mearim e Grajaú",338308,8119.02497975218,11,79,35,44,44,35,0,0,0,0,0,79,35,44,44,35,43,9.00196534956078,12.7317120021392,0.378126188106774,2020-03-16,2020,3
"2337","MA",2,"Nordeste",21011,"Alto Mearim e Grajaú",338308,8119.02497975218,12,81,49,32,43,38,1,1,0,0,1,82,50,32,43,39,33,9.00196534956078,12.7317120021392,0.459259237446151,2020-03-23,2020,3
"2338","MA",2,"Nordeste",21011,"Alto Mearim e Grajaú",338308,8119.02497975218,13,50,27,23,24,26,0,0,0,0,0,50,27,23,24,26,38,9.00196534956078,12.7317120021392,0.414403526206514,2020-03-30,2020,3
"2339","MA",2,"Nordeste",21011,"Alto Mearim e Grajaú",338308,8119.02497975218,14,79,33,46,40,39,3,3,0,2,1,82,36,46,42,40,21,9.00196534956078,12.7317120021392,0.406214191080695,2020-04-06,2020,4
"2340","MA",2,"Nordeste",21011,"Alto Mearim e Grajaú",338308,8119.02497975218,15,88,38,50,46,42,2,2,0,1,1,90,40,50,47,43,26,9.00196534956078,12.7317120021392,0.376806496569381,2020-04-13,2020,4
"2341","MA",2,"Nordeste",21011,"Alto Mearim e Grajaú",338308,8119.02497975218,16,73,37,36,42,31,3,2,1,3,0,76,39,37,45,31,24,9.00196534956078,12.7317120021392,0.366142193333544,2020-04-20,2020,4
"2342","MA",2,"Nordeste",21011,"Alto Mearim e Grajaú",338308,8119.02497975218,17,92,39,53,47,45,1,0,1,1,0,93,39,54,48,45,23,9.00196534956078,12.7317120021392,0.375089553790711,2020-04-27,2020,4
"2343","MA",2,"Nordeste",21011,"Alto Mearim e Grajaú",338308,8119.02497975218,18,83,45,38,40,43,1,1,0,1,0,84,46,38,41,43,39,9.00196534956078,12.7317120021392,0.427118149508901,2020-05-04,2020,5
"2344","MA",2,"Nordeste",21011,"Alto Mearim e Grajaú",338308,8119.02497975218,19,61,29,32,36,25,2,1,1,0,2,63,30,33,36,27,39,9.00196534956078,12.7317120021392,0.471214027049156,2020-05-11,2020,5
"2345","MA",2,"Nordeste",21011,"Alto Mearim e Grajaú",338308,8119.02497975218,20,106,54,52,54,52,1,1,0,1,0,107,55,52,55,52,42,9.00196534956078,12.7317120021392,0.445453734049407,2020-05-18,2020,5
"2346","MA",2,"Nordeste",21011,"Alto Mearim e Grajaú",338308,8119.02497975218,21,109,57,52,55,54,1,0,1,1,0,110,57,53,56,54,26,9.00196534956078,12.7317120021392,0.413010619921012,2020-05-25,2020,5
"2347","MA",2,"Nordeste",21012,"Presidente Dutra",200027,8772.30029561009,5,54,21,33,31,23,0,0,0,0,0,54,21,33,31,23,21,9.07935434237751,12.2062076364185,0.281979228258353,2020-02-03,2020,2
"2348","MA",2,"Nordeste",21012,"Presidente Dutra",200027,8772.30029561009,6,55,23,32,28,27,0,0,0,0,0,55,23,32,28,27,19,9.07935434237751,12.2062076364185,0.278054413444836,2020-02-10,2020,2
"2349","MA",2,"Nordeste",21012,"Presidente Dutra",200027,8772.30029561009,7,56,17,39,28,28,1,1,0,0,1,57,18,39,28,29,21,9.07935434237751,12.2062076364185,0.287210895904142,2020-02-17,2020,2
"2350","MA",2,"Nordeste",21012,"Presidente Dutra",200027,8772.30029561009,8,55,18,37,26,29,1,0,1,0,1,56,18,38,26,30,22,9.07935434237751,12.2062076364185,0.328845853021004,2020-02-24,2020,2
"2351","MA",2,"Nordeste",21012,"Presidente Dutra",200027,8772.30029561009,9,56,13,43,28,28,0,0,0,0,0,56,13,43,28,28,23,9.07935434237751,12.2062076364185,0.317128461771913,2020-03-02,2020,3
"2352","MA",2,"Nordeste",21012,"Presidente Dutra",200027,8772.30029561009,10,42,15,27,22,20,0,0,0,0,0,42,15,27,22,20,25,9.07935434237751,12.2062076364185,0.343881774255701,2020-03-09,2020,3
"2353","MA",2,"Nordeste",21012,"Presidente Dutra",200027,8772.30029561009,11,44,15,29,22,22,2,2,0,1,1,46,17,29,23,23,30,9.07935434237751,12.2062076364185,0.376782234152449,2020-03-16,2020,3
"2354","MA",2,"Nordeste",21012,"Presidente Dutra",200027,8772.30029561009,12,35,12,23,13,22,0,0,0,0,0,35,12,23,13,22,26,9.07935434237751,12.2062076364185,0.495957453537362,2020-03-23,2020,3
"2355","MA",2,"Nordeste",21012,"Presidente Dutra",200027,8772.30029561009,13,48,12,36,25,23,0,0,0,0,0,48,12,36,25,23,17,9.07935434237751,12.2062076364185,0.436027582358009,2020-03-30,2020,3
"2356","MA",2,"Nordeste",21012,"Presidente Dutra",200027,8772.30029561009,14,52,18,34,24,28,0,0,0,0,0,52,18,34,24,28,28,9.07935434237751,12.2062076364185,0.414826006413681,2020-04-06,2020,4
"2357","MA",2,"Nordeste",21012,"Presidente Dutra",200027,8772.30029561009,15,56,18,38,31,25,0,0,0,0,0,56,18,38,31,25,19,9.07935434237751,12.2062076364185,0.388149579226776,2020-04-13,2020,4
"2358","MA",2,"Nordeste",21012,"Presidente Dutra",200027,8772.30029561009,16,44,16,28,29,15,0,0,0,0,0,44,16,28,29,15,22,9.07935434237751,12.2062076364185,0.381609720893974,2020-04-20,2020,4
"2359","MA",2,"Nordeste",21012,"Presidente Dutra",200027,8772.30029561009,17,40,14,26,20,20,1,1,0,1,0,41,15,26,21,20,20,9.07935434237751,12.2062076364185,0.390572496654284,2020-04-27,2020,4
"2360","MA",2,"Nordeste",21012,"Presidente Dutra",200027,8772.30029561009,18,42,15,27,22,20,0,0,0,0,0,42,15,27,22,20,37,9.07935434237751,12.2062076364185,0.430529435831377,2020-05-04,2020,5
"2361","MA",2,"Nordeste",21012,"Presidente Dutra",200027,8772.30029561009,19,53,18,35,30,23,0,0,0,0,0,53,18,35,30,23,29,9.07935434237751,12.2062076364185,0.459136967817353,2020-05-11,2020,5
"2362","MA",2,"Nordeste",21012,"Presidente Dutra",200027,8772.30029561009,20,56,22,34,27,29,0,0,0,0,0,56,22,34,27,29,34,9.07935434237751,12.2062076364185,0.440755062379593,2020-05-18,2020,5
"2363","MA",2,"Nordeste",21012,"Presidente Dutra",200027,8772.30029561009,21,58,18,40,31,27,0,0,0,0,0,58,18,40,31,27,32,9.07935434237751,12.2062076364185,0.417499863214572,2020-05-25,2020,5
"2364","MA",2,"Nordeste",21013,"Baixo Parnaíba Maranhense",147430,6765.65990646408,5,31,13,18,21,10,0,0,0,0,0,31,13,18,21,10,14,8.81961508299664,11.9011087658439,0.305737667719788,2020-02-03,2020,2
"2365","MA",2,"Nordeste",21013,"Baixo Parnaíba Maranhense",147430,6765.65990646408,6,26,12,14,15,11,2,0,2,2,0,28,12,16,17,11,11,8.81961508299664,11.9011087658439,0.280912418115869,2020-02-10,2020,2
"2366","MA",2,"Nordeste",21013,"Baixo Parnaíba Maranhense",147430,6765.65990646408,7,31,10,21,15,16,0,0,0,0,0,31,10,21,15,16,7,8.81961508299664,11.9011087658439,0.312358868807886,2020-02-17,2020,2
"2367","MA",2,"Nordeste",21013,"Baixo Parnaíba Maranhense",147430,6765.65990646408,8,36,20,16,18,18,0,0,0,0,0,36,20,16,18,18,8,8.81961508299664,11.9011087658439,0.343798582284332,2020-02-24,2020,2
"2368","MA",2,"Nordeste",21013,"Baixo Parnaíba Maranhense",147430,6765.65990646408,9,34,10,24,19,15,0,0,0,0,0,34,10,24,19,15,12,8.81961508299664,11.9011087658439,0.328694759244921,2020-03-02,2020,3
"2369","MA",2,"Nordeste",21013,"Baixo Parnaíba Maranhense",147430,6765.65990646408,10,26,10,16,14,12,0,0,0,0,0,26,10,16,14,12,14,8.81961508299664,11.9011087658439,0.357390013209951,2020-03-09,2020,3
"2370","MA",2,"Nordeste",21013,"Baixo Parnaíba Maranhense",147430,6765.65990646408,11,35,13,22,24,11,0,0,0,0,0,35,13,22,24,11,12,8.81961508299664,11.9011087658439,0.427153709925248,2020-03-16,2020,3
"2371","MA",2,"Nordeste",21013,"Baixo Parnaíba Maranhense",147430,6765.65990646408,12,24,9,15,17,7,2,2,0,2,0,26,11,15,19,7,13,8.81961508299664,11.9011087658439,0.523028781947563,2020-03-23,2020,3
"2372","MA",2,"Nordeste",21013,"Baixo Parnaíba Maranhense",147430,6765.65990646408,13,21,10,11,13,8,0,0,0,0,0,21,10,11,13,8,9,8.81961508299664,11.9011087658439,0.463951177820691,2020-03-30,2020,3
"2373","MA",2,"Nordeste",21013,"Baixo Parnaíba Maranhense",147430,6765.65990646408,14,31,14,17,16,15,1,0,1,0,1,32,14,18,16,16,17,8.81961508299664,11.9011087658439,0.435228532447759,2020-04-06,2020,4
"2374","MA",2,"Nordeste",21013,"Baixo Parnaíba Maranhense",147430,6765.65990646408,15,28,13,15,18,10,0,0,0,0,0,28,13,15,18,10,18,8.81961508299664,11.9011087658439,0.42326982136211,2020-04-13,2020,4
"2375","MA",2,"Nordeste",21013,"Baixo Parnaíba Maranhense",147430,6765.65990646408,16,24,14,10,14,10,0,0,0,0,0,24,14,10,14,10,10,8.81961508299664,11.9011087658439,0.429444915968667,2020-04-20,2020,4
"2376","MA",2,"Nordeste",21013,"Baixo Parnaíba Maranhense",147430,6765.65990646408,17,41,16,25,21,20,0,0,0,0,0,41,16,25,21,20,14,8.81961508299664,11.9011087658439,0.461844465586724,2020-04-27,2020,4
"2377","MA",2,"Nordeste",21013,"Baixo Parnaíba Maranhense",147430,6765.65990646408,18,27,7,20,17,10,2,1,1,1,1,29,8,21,18,11,11,8.81961508299664,11.9011087658439,0.496281442781024,2020-05-04,2020,5
"2378","MA",2,"Nordeste",21013,"Baixo Parnaíba Maranhense",147430,6765.65990646408,19,26,13,13,14,12,0,0,0,0,0,26,13,13,14,12,9,8.81961508299664,11.9011087658439,0.535251726727811,2020-05-11,2020,5
"2379","MA",2,"Nordeste",21013,"Baixo Parnaíba Maranhense",147430,6765.65990646408,20,29,8,21,13,16,0,0,0,0,0,29,8,21,13,16,21,8.81961508299664,11.9011087658439,0.508010040980716,2020-05-18,2020,5
"2380","MA",2,"Nordeste",21013,"Baixo Parnaíba Maranhense",147430,6765.65990646408,21,27,15,12,15,12,0,0,0,0,0,27,15,12,15,12,23,8.81961508299664,11.9011087658439,0.496151917559264,2020-05-25,2020,5
"2381","MA",2,"Nordeste",21014,"Chapadinha",246702,7786.55126330553,5,74,36,38,41,33,0,0,0,0,0,74,36,38,41,33,17,8.96015332752709,12.4159364094972,0.269006107559611,2020-02-03,2020,2
"2382","MA",2,"Nordeste",21014,"Chapadinha",246702,7786.55126330553,6,73,20,53,35,38,0,0,0,0,0,73,20,53,35,38,19,8.96015332752709,12.4159364094972,0.25905566897453,2020-02-10,2020,2
"2383","MA",2,"Nordeste",21014,"Chapadinha",246702,7786.55126330553,7,82,28,54,49,33,2,1,1,0,2,84,29,55,49,35,24,8.96015332752709,12.4159364094972,0.268121636017483,2020-02-17,2020,2
"2384","MA",2,"Nordeste",21014,"Chapadinha",246702,7786.55126330553,8,79,29,50,44,35,0,0,0,0,0,79,29,50,44,35,24,8.96015332752709,12.4159364094972,0.316313820067003,2020-02-24,2020,2
"2385","MA",2,"Nordeste",21014,"Chapadinha",246702,7786.55126330553,9,67,33,34,45,22,1,1,0,0,1,68,34,34,45,23,20,8.96015332752709,12.4159364094972,0.29874727124776,2020-03-02,2020,3
"2386","MA",2,"Nordeste",21014,"Chapadinha",246702,7786.55126330553,10,66,24,42,35,31,1,1,0,1,0,67,25,42,36,31,24,8.96015332752709,12.4159364094972,0.327313152448933,2020-03-09,2020,3
"2387","MA",2,"Nordeste",21014,"Chapadinha",246702,7786.55126330553,11,49,27,22,27,22,0,0,0,0,0,49,27,22,27,22,19,8.96015332752709,12.4159364094972,0.383401388930786,2020-03-16,2020,3
"2388","MA",2,"Nordeste",21014,"Chapadinha",246702,7786.55126330553,12,53,22,31,31,22,1,0,1,1,0,54,22,32,32,22,29,8.96015332752709,12.4159364094972,0.460028733070458,2020-03-23,2020,3
"2389","MA",2,"Nordeste",21014,"Chapadinha",246702,7786.55126330553,13,51,20,31,32,19,0,0,0,0,0,51,20,31,32,19,28,8.96015332752709,12.4159364094972,0.410471096980459,2020-03-30,2020,3
"2390","MA",2,"Nordeste",21014,"Chapadinha",246702,7786.55126330553,14,69,25,44,33,36,0,0,0,0,0,69,25,44,33,36,20,8.96015332752709,12.4159364094972,0.416340607567889,2020-04-06,2020,4
"2391","MA",2,"Nordeste",21014,"Chapadinha",246702,7786.55126330553,15,70,30,40,41,29,2,2,0,1,1,72,32,40,42,30,25,8.96015332752709,12.4159364094972,0.387236570645596,2020-04-13,2020,4
"2392","MA",2,"Nordeste",21014,"Chapadinha",246702,7786.55126330553,16,68,31,37,34,34,1,1,0,0,1,69,32,37,34,35,27,8.96015332752709,12.4159364094972,0.385977920097558,2020-04-20,2020,4
"2393","MA",2,"Nordeste",21014,"Chapadinha",246702,7786.55126330553,17,64,32,32,36,28,1,1,0,0,1,65,33,32,36,29,18,8.96015332752709,12.4159364094972,0.387390614402575,2020-04-27,2020,4
"2394","MA",2,"Nordeste",21014,"Chapadinha",246702,7786.55126330553,18,65,29,36,46,19,3,2,1,2,1,68,31,37,48,20,29,8.96015332752709,12.4159364094972,0.426510074238438,2020-05-04,2020,5
"2395","MA",2,"Nordeste",21014,"Chapadinha",246702,7786.55126330553,19,65,36,29,40,25,1,1,0,0,1,66,37,29,40,26,40,8.96015332752709,12.4159364094972,0.457662745276421,2020-05-11,2020,5
"2396","MA",2,"Nordeste",21014,"Chapadinha",246702,7786.55126330553,20,65,21,44,29,36,0,0,0,0,0,65,21,44,29,36,48,8.96015332752709,12.4159364094972,0.433772629639621,2020-05-18,2020,5
"2397","MA",2,"Nordeste",21014,"Chapadinha",246702,7786.55126330553,21,61,25,36,37,24,0,0,0,0,0,61,25,36,37,24,46,8.96015332752709,12.4159364094972,0.417417142169093,2020-05-25,2020,5
"2398","MA",2,"Nordeste",21015,"Codó",280000,8002.86739585714,5,73,31,42,42,31,2,1,1,0,2,75,32,43,42,33,18,8.98755518092541,12.5425448821514,0.287787842489319,2020-02-03,2020,2
"2399","MA",2,"Nordeste",21015,"Codó",280000,8002.86739585714,6,86,36,50,44,42,2,1,1,1,1,88,37,51,45,43,26,8.98755518092541,12.5425448821514,0.278527511037543,2020-02-10,2020,2
"2400","MA",2,"Nordeste",21015,"Codó",280000,8002.86739585714,7,97,41,56,43,54,0,0,0,0,0,97,41,56,43,54,24,8.98755518092541,12.5425448821514,0.291219527876783,2020-02-17,2020,2
"2401","MA",2,"Nordeste",21015,"Codó",280000,8002.86739585714,8,75,30,45,34,41,0,0,0,0,0,75,30,45,34,41,44,8.98755518092541,12.5425448821514,0.338904523437352,2020-02-24,2020,2
"2402","MA",2,"Nordeste",21015,"Codó",280000,8002.86739585714,9,76,32,44,45,31,1,1,0,1,0,77,33,44,46,31,34,8.98755518092541,12.5425448821514,0.315634822893606,2020-03-02,2020,3
"2403","MA",2,"Nordeste",21015,"Codó",280000,8002.86739585714,10,72,24,48,31,41,2,1,1,1,1,74,25,49,32,42,36,8.98755518092541,12.5425448821514,0.348312843327841,2020-03-09,2020,3
"2404","MA",2,"Nordeste",21015,"Codó",280000,8002.86739585714,11,71,31,40,36,35,1,1,0,1,0,72,32,40,37,35,42,8.98755518092541,12.5425448821514,0.400681059491045,2020-03-16,2020,3
"2405","MA",2,"Nordeste",21015,"Codó",280000,8002.86739585714,12,58,22,36,27,31,1,1,0,1,0,59,23,36,28,31,26,8.98755518092541,12.5425448821514,0.495188441756808,2020-03-23,2020,3
"2406","MA",2,"Nordeste",21015,"Codó",280000,8002.86739585714,13,66,33,33,40,26,2,1,1,1,1,68,34,34,41,27,28,8.98755518092541,12.5425448821514,0.442566487048836,2020-03-30,2020,3
"2407","MA",2,"Nordeste",21015,"Codó",280000,8002.86739585714,14,58,24,34,36,22,0,0,0,0,0,58,24,34,36,22,23,8.98755518092541,12.5425448821514,0.422923851362177,2020-04-06,2020,4
"2408","MA",2,"Nordeste",21015,"Codó",280000,8002.86739585714,15,74,22,52,40,34,0,0,0,0,0,74,22,52,40,34,23,8.98755518092541,12.5425448821514,0.401614634114842,2020-04-13,2020,4
"2409","MA",2,"Nordeste",21015,"Codó",280000,8002.86739585714,16,73,31,42,37,36,0,0,0,0,0,73,31,42,37,36,32,8.98755518092541,12.5425448821514,0.401630722225044,2020-04-20,2020,4
"2410","MA",2,"Nordeste",21015,"Codó",280000,8002.86739585714,17,73,28,45,47,26,0,0,0,0,0,73,28,45,47,26,37,8.98755518092541,12.5425448821514,0.405605071077046,2020-04-27,2020,4
"2411","MA",2,"Nordeste",21015,"Codó",280000,8002.86739585714,18,53,24,29,36,17,3,2,1,2,1,56,26,30,38,18,42,8.98755518092541,12.5425448821514,0.438605145048012,2020-05-04,2020,5
"2412","MA",2,"Nordeste",21015,"Codó",280000,8002.86739585714,19,77,37,40,45,32,0,0,0,0,0,77,37,40,45,32,80,8.98755518092541,12.5425448821514,0.481299128951992,2020-05-11,2020,5
"2413","MA",2,"Nordeste",21015,"Codó",280000,8002.86739585714,20,63,20,43,38,25,1,1,0,1,0,64,21,43,39,25,59,8.98755518092541,12.5425448821514,0.458890625112402,2020-05-18,2020,5
"2414","MA",2,"Nordeste",21015,"Codó",280000,8002.86739585714,21,81,32,49,49,32,1,1,0,1,0,82,33,49,50,32,52,8.98755518092541,12.5425448821514,0.433116773013599,2020-05-25,2020,5
"2415","MA",2,"Nordeste",21016,"Coelho Neto",94357,7245.19526267262,5,25,13,12,13,12,2,1,1,2,0,27,14,13,15,12,7,8.88809380576118,11.4548407398835,0.283874845288577,2020-02-03,2020,2
"2416","MA",2,"Nordeste",21016,"Coelho Neto",94357,7245.19526267262,6,22,12,10,16,6,0,0,0,0,0,22,12,10,16,6,10,8.88809380576118,11.4548407398835,0.277769740928059,2020-02-10,2020,2
"2417","MA",2,"Nordeste",21016,"Coelho Neto",94357,7245.19526267262,7,24,11,13,8,16,1,1,0,0,1,25,12,13,8,17,11,8.88809380576118,11.4548407398835,0.289950792287609,2020-02-17,2020,2
"2418","MA",2,"Nordeste",21016,"Coelho Neto",94357,7245.19526267262,8,33,18,15,19,14,1,0,1,1,0,34,18,16,20,14,15,8.88809380576118,11.4548407398835,0.335229761177588,2020-02-24,2020,2
"2419","MA",2,"Nordeste",21016,"Coelho Neto",94357,7245.19526267262,9,24,12,12,14,10,0,0,0,0,0,24,12,12,14,10,11,8.88809380576118,11.4548407398835,0.317878250607291,2020-03-02,2020,3
"2420","MA",2,"Nordeste",21016,"Coelho Neto",94357,7245.19526267262,10,25,8,17,13,12,0,0,0,0,0,25,8,17,13,12,15,8.88809380576118,11.4548407398835,0.341185890978497,2020-03-09,2020,3
"2421","MA",2,"Nordeste",21016,"Coelho Neto",94357,7245.19526267262,11,26,13,13,18,8,1,0,1,0,1,27,13,14,18,9,7,8.88809380576118,11.4548407398835,0.397391931201026,2020-03-16,2020,3
"2422","MA",2,"Nordeste",21016,"Coelho Neto",94357,7245.19526267262,12,24,17,7,13,11,0,0,0,0,0,24,17,7,13,11,12,8.88809380576118,11.4548407398835,0.487263074376,2020-03-23,2020,3
"2423","MA",2,"Nordeste",21016,"Coelho Neto",94357,7245.19526267262,13,32,13,19,15,17,0,0,0,0,0,32,13,19,15,17,10,8.88809380576118,11.4548407398835,0.431126132775398,2020-03-30,2020,3
"2424","MA",2,"Nordeste",21016,"Coelho Neto",94357,7245.19526267262,14,19,7,12,10,9,2,1,1,2,0,21,8,13,12,9,4,8.88809380576118,11.4548407398835,0.415815122691502,2020-04-06,2020,4
"2425","MA",2,"Nordeste",21016,"Coelho Neto",94357,7245.19526267262,15,19,6,13,16,3,0,0,0,0,0,19,6,13,16,3,9,8.88809380576118,11.4548407398835,0.405628794725255,2020-04-13,2020,4
"2426","MA",2,"Nordeste",21016,"Coelho Neto",94357,7245.19526267262,16,21,11,10,10,11,0,0,0,0,0,21,11,10,10,11,9,8.88809380576118,11.4548407398835,0.404399011364699,2020-04-20,2020,4
"2427","MA",2,"Nordeste",21016,"Coelho Neto",94357,7245.19526267262,17,27,12,15,15,12,0,0,0,0,0,27,12,15,15,12,8,8.88809380576118,11.4548407398835,0.422107625273647,2020-04-27,2020,4
"2428","MA",2,"Nordeste",21016,"Coelho Neto",94357,7245.19526267262,18,23,13,10,10,13,0,0,0,0,0,23,13,10,10,13,7,8.88809380576118,11.4548407398835,0.427137396338061,2020-05-04,2020,5
"2429","MA",2,"Nordeste",21016,"Coelho Neto",94357,7245.19526267262,19,25,15,10,11,14,1,0,1,1,0,26,15,11,12,14,11,8.88809380576118,11.4548407398835,0.445560183352986,2020-05-11,2020,5
"2430","MA",2,"Nordeste",21016,"Coelho Neto",94357,7245.19526267262,20,25,10,15,11,14,0,0,0,0,0,25,10,15,11,14,14,8.88809380576118,11.4548407398835,0.438964885098539,2020-05-18,2020,5
"2431","MA",2,"Nordeste",21016,"Coelho Neto",94357,7245.19526267262,21,23,13,10,11,12,0,0,0,0,0,23,13,10,11,12,16,8.88809380576118,11.4548407398835,0.435659058905164,2020-05-25,2020,5
"2432","MA",2,"Nordeste",21017,"Caxias",447282,9863.4951416556,5,117,39,78,57,60,0,0,0,0,0,117,39,78,57,60,57,9.19659586162595,13.0109445471625,0.272933581492119,2020-02-03,2020,2
"2433","MA",2,"Nordeste",21017,"Caxias",447282,9863.4951416556,6,104,31,73,42,62,0,0,0,0,0,104,31,73,42,62,45,9.19659586162595,13.0109445471625,0.266620551211519,2020-02-10,2020,2
"2434","MA",2,"Nordeste",21017,"Caxias",447282,9863.4951416556,7,115,37,78,62,53,2,2,0,0,2,117,39,78,62,55,34,9.19659586162595,13.0109445471625,0.279537695265626,2020-02-17,2020,2
"2435","MA",2,"Nordeste",21017,"Caxias",447282,9863.4951416556,8,154,45,109,79,75,3,1,2,0,3,157,46,111,79,78,61,9.19659586162595,13.0109445471625,0.335480332823116,2020-02-24,2020,2
"2436","MA",2,"Nordeste",21017,"Caxias",447282,9863.4951416556,9,119,41,78,64,55,0,0,0,0,0,119,41,78,64,55,63,9.19659586162595,13.0109445471625,0.309392804551286,2020-03-02,2020,3
"2437","MA",2,"Nordeste",21017,"Caxias",447282,9863.4951416556,10,124,38,86,63,61,1,1,0,0,1,125,39,86,63,62,61,9.19659586162595,13.0109445471625,0.329770369351022,2020-03-09,2020,3
"2438","MA",2,"Nordeste",21017,"Caxias",447282,9863.4951416556,11,120,41,79,61,59,2,2,0,1,1,122,43,79,62,60,67,9.19659586162595,13.0109445471625,0.404892934308322,2020-03-16,2020,3
"2439","MA",2,"Nordeste",21017,"Caxias",447282,9863.4951416556,12,131,42,89,73,58,1,0,1,0,1,132,42,90,73,59,58,9.19659586162595,13.0109445471625,0.516033059757471,2020-03-23,2020,3
"2440","MA",2,"Nordeste",21017,"Caxias",447282,9863.4951416556,13,95,33,62,38,57,1,0,1,0,1,96,33,63,38,58,41,9.19659586162595,13.0109445471625,0.465208952865351,2020-03-30,2020,3
"2441","MA",2,"Nordeste",21017,"Caxias",447282,9863.4951416556,14,112,44,68,63,49,1,1,0,1,0,113,45,68,64,49,42,9.19659586162595,13.0109445471625,0.455272503110291,2020-04-06,2020,4
"2442","MA",2,"Nordeste",21017,"Caxias",447282,9863.4951416556,15,98,45,53,48,50,2,0,2,1,1,100,45,55,49,51,55,9.19659586162595,13.0109445471625,0.434714260956721,2020-04-13,2020,4
"2443","MA",2,"Nordeste",21017,"Caxias",447282,9863.4951416556,16,115,40,75,57,58,0,0,0,0,0,115,40,75,57,58,66,9.19659586162595,13.0109445471625,0.433977391445904,2020-04-20,2020,4
"2444","MA",2,"Nordeste",21017,"Caxias",447282,9863.4951416556,17,113,36,77,53,60,3,1,2,1,2,116,37,79,54,62,65,9.19659586162595,13.0109445471625,0.422643214795474,2020-04-27,2020,4
"2445","MA",2,"Nordeste",21017,"Caxias",447282,9863.4951416556,18,116,37,79,61,55,0,0,0,0,0,116,37,79,61,55,64,9.19659586162595,13.0109445471625,0.426225963542985,2020-05-04,2020,5
"2446","MA",2,"Nordeste",21017,"Caxias",447282,9863.4951416556,19,113,34,79,58,55,1,0,1,1,0,114,34,80,59,55,43,9.19659586162595,13.0109445471625,0.464390094612673,2020-05-11,2020,5
"2447","MA",2,"Nordeste",21017,"Caxias",447282,9863.4951416556,20,115,42,73,68,47,2,2,0,0,2,117,44,73,68,49,72,9.19659586162595,13.0109445471625,0.456890319428312,2020-05-18,2020,5
"2448","MA",2,"Nordeste",21017,"Caxias",447282,9863.4951416556,21,139,43,96,83,56,3,2,1,1,2,142,45,97,84,58,90,9.19659586162595,13.0109445471625,0.445585964615713,2020-05-25,2020,5
"2449","MA",2,"Nordeste",21018,"Chapadas do Alto Itapecuru",222247,8708.47669354367,5,51,17,34,30,21,0,0,0,0,0,51,17,34,30,21,25,9.07205216288,12.3115446549723,0.254715694402758,2020-02-03,2020,2
"2450","MA",2,"Nordeste",21018,"Chapadas do Alto Itapecuru",222247,8708.47669354367,6,48,22,26,23,25,1,1,0,1,0,49,23,26,24,25,18,9.07205216288,12.3115446549723,0.24741326513024,2020-02-10,2020,2
"2451","MA",2,"Nordeste",21018,"Chapadas do Alto Itapecuru",222247,8708.47669354367,7,41,16,25,24,17,0,0,0,0,0,41,16,25,24,17,25,9.07205216288,12.3115446549723,0.260042058719977,2020-02-17,2020,2
"2452","MA",2,"Nordeste",21018,"Chapadas do Alto Itapecuru",222247,8708.47669354367,8,56,20,36,33,23,0,0,0,0,0,56,20,36,33,23,30,9.07205216288,12.3115446549723,0.29543517685515,2020-02-24,2020,2
"2453","MA",2,"Nordeste",21018,"Chapadas do Alto Itapecuru",222247,8708.47669354367,9,67,24,43,24,43,0,0,0,0,0,67,24,43,24,43,24,9.07205216288,12.3115446549723,0.27870368173155,2020-03-02,2020,3
"2454","MA",2,"Nordeste",21018,"Chapadas do Alto Itapecuru",222247,8708.47669354367,10,67,20,47,33,34,2,0,2,1,1,69,20,49,34,35,23,9.07205216288,12.3115446549723,0.311625409716217,2020-03-09,2020,3
"2455","MA",2,"Nordeste",21018,"Chapadas do Alto Itapecuru",222247,8708.47669354367,11,50,16,34,24,26,1,1,0,0,1,51,17,34,24,27,31,9.07205216288,12.3115446549723,0.364845526748986,2020-03-16,2020,3
"2456","MA",2,"Nordeste",21018,"Chapadas do Alto Itapecuru",222247,8708.47669354367,12,35,13,22,15,20,0,0,0,0,0,35,13,22,15,20,31,9.07205216288,12.3115446549723,0.465052326549085,2020-03-23,2020,3
"2457","MA",2,"Nordeste",21018,"Chapadas do Alto Itapecuru",222247,8708.47669354367,13,49,15,34,31,18,0,0,0,0,0,49,15,34,31,18,18,9.07205216288,12.3115446549723,0.399124626332913,2020-03-30,2020,3
"2458","MA",2,"Nordeste",21018,"Chapadas do Alto Itapecuru",222247,8708.47669354367,14,45,16,29,25,20,2,1,1,1,1,47,17,30,26,21,25,9.07205216288,12.3115446549723,0.406065906055968,2020-04-06,2020,4
"2459","MA",2,"Nordeste",21018,"Chapadas do Alto Itapecuru",222247,8708.47669354367,15,40,17,23,29,11,0,0,0,0,0,40,17,23,29,11,28,9.07205216288,12.3115446549723,0.379522516022408,2020-04-13,2020,4
"2460","MA",2,"Nordeste",21018,"Chapadas do Alto Itapecuru",222247,8708.47669354367,16,61,19,42,29,32,0,0,0,0,0,61,19,42,29,32,16,9.07205216288,12.3115446549723,0.376768240391214,2020-04-20,2020,4
"2461","MA",2,"Nordeste",21018,"Chapadas do Alto Itapecuru",222247,8708.47669354367,17,43,16,27,30,13,1,0,1,0,1,44,16,28,30,14,32,9.07205216288,12.3115446549723,0.375651664169494,2020-04-27,2020,4
"2462","MA",2,"Nordeste",21018,"Chapadas do Alto Itapecuru",222247,8708.47669354367,18,60,28,32,33,27,3,0,3,0,3,63,28,35,33,30,22,9.07205216288,12.3115446549723,0.383304088924382,2020-05-04,2020,5
"2463","MA",2,"Nordeste",21018,"Chapadas do Alto Itapecuru",222247,8708.47669354367,19,40,15,25,22,18,0,0,0,0,0,40,15,25,22,18,29,9.07205216288,12.3115446549723,0.402834428269086,2020-05-11,2020,5
"2464","MA",2,"Nordeste",21018,"Chapadas do Alto Itapecuru",222247,8708.47669354367,20,43,17,26,22,21,1,0,1,0,1,44,17,27,22,22,36,9.07205216288,12.3115446549723,0.400483934315138,2020-05-18,2020,5
"2465","MA",2,"Nordeste",21018,"Chapadas do Alto Itapecuru",222247,8708.47669354367,21,53,24,29,29,24,0,0,0,0,0,53,24,29,29,24,20,9.07205216288,12.3115446549723,0.388760676041868,2020-05-25,2020,5
"2466","MA",2,"Nordeste",21019,"Porto Franco",121114,18269.4480973298,5,25,10,15,14,11,0,0,0,0,0,25,10,15,14,11,10,9.81298544077838,11.7044875297956,0.274069587099115,2020-02-03,2020,2
"2467","MA",2,"Nordeste",21019,"Porto Franco",121114,18269.4480973298,6,36,11,25,21,15,0,0,0,0,0,36,11,25,21,15,13,9.81298544077838,11.7044875297956,0.282455739826975,2020-02-10,2020,2
"2468","MA",2,"Nordeste",21019,"Porto Franco",121114,18269.4480973298,7,38,11,27,20,18,1,1,0,1,0,39,12,27,21,18,12,9.81298544077838,11.7044875297956,0.281047880672534,2020-02-17,2020,2
"2469","MA",2,"Nordeste",21019,"Porto Franco",121114,18269.4480973298,8,29,11,18,16,13,2,1,1,0,2,31,12,19,16,15,9,9.81298544077838,11.7044875297956,0.316827045155978,2020-02-24,2020,2
"2470","MA",2,"Nordeste",21019,"Porto Franco",121114,18269.4480973298,9,31,10,21,15,16,1,0,1,0,1,32,10,22,15,17,12,9.81298544077838,11.7044875297956,0.311143818492665,2020-03-02,2020,3
"2471","MA",2,"Nordeste",21019,"Porto Franco",121114,18269.4480973298,10,30,10,20,15,15,0,0,0,0,0,30,10,20,15,15,12,9.81298544077838,11.7044875297956,0.321570788096044,2020-03-09,2020,3
"2472","MA",2,"Nordeste",21019,"Porto Franco",121114,18269.4480973298,11,19,6,13,9,10,1,0,1,1,0,20,6,14,10,10,9,9.81298544077838,11.7044875297956,0.369830806394652,2020-03-16,2020,3
"2473","MA",2,"Nordeste",21019,"Porto Franco",121114,18269.4480973298,12,24,10,14,14,10,0,0,0,0,0,24,10,14,14,10,12,9.81298544077838,11.7044875297956,0.438037800073918,2020-03-23,2020,3
"2474","MA",2,"Nordeste",21019,"Porto Franco",121114,18269.4480973298,13,19,5,14,8,11,0,0,0,0,0,19,5,14,8,11,13,9.81298544077838,11.7044875297956,0.388084413944125,2020-03-30,2020,3
"2475","MA",2,"Nordeste",21019,"Porto Franco",121114,18269.4480973298,14,14,4,10,6,8,1,0,1,1,0,15,4,11,7,8,11,9.81298544077838,11.7044875297956,0.388475157800934,2020-04-06,2020,4
"2476","MA",2,"Nordeste",21019,"Porto Franco",121114,18269.4480973298,15,21,5,16,9,12,0,0,0,0,0,21,5,16,9,12,14,9.81298544077838,11.7044875297956,0.370027361612442,2020-04-13,2020,4
"2477","MA",2,"Nordeste",21019,"Porto Franco",121114,18269.4480973298,16,35,8,27,17,18,0,0,0,0,0,35,8,27,17,18,10,9.81298544077838,11.7044875297956,0.373197818412026,2020-04-20,2020,4
"2478","MA",2,"Nordeste",21019,"Porto Franco",121114,18269.4480973298,17,21,5,16,10,11,0,0,0,0,0,21,5,16,10,11,9,9.81298544077838,11.7044875297956,0.380362944840551,2020-04-27,2020,4
"2479","MA",2,"Nordeste",21019,"Porto Franco",121114,18269.4480973298,18,30,10,20,12,18,1,1,0,1,0,31,11,20,13,18,14,9.81298544077838,11.7044875297956,0.388213721918416,2020-05-04,2020,5
"2480","MA",2,"Nordeste",21019,"Porto Franco",121114,18269.4480973298,19,24,9,15,9,15,0,0,0,0,0,24,9,15,9,15,23,9.81298544077838,11.7044875297956,0.436138627783396,2020-05-11,2020,5
"2481","MA",2,"Nordeste",21019,"Porto Franco",121114,18269.4480973298,20,27,9,18,17,10,0,0,0,0,0,27,9,18,17,10,20,9.81298544077838,11.7044875297956,0.42393006741501,2020-05-18,2020,5
"2482","MA",2,"Nordeste",21019,"Porto Franco",121114,18269.4480973298,21,23,6,17,14,9,0,0,0,0,0,23,6,17,14,9,15,9.81298544077838,11.7044875297956,0.385625068664115,2020-05-25,2020,5
"2483","MA",2,"Nordeste",21020,"Gerais de Balsas",144541,38035.8491120167,5,52,16,36,23,29,0,0,0,0,0,52,16,36,23,29,16,10.5462843916733,11.8813184833131,0.269493416358214,2020-02-03,2020,2
"2484","MA",2,"Nordeste",21020,"Gerais de Balsas",144541,38035.8491120167,6,52,17,35,26,26,2,1,1,1,1,54,18,36,27,27,13,10.5462843916733,11.8813184833131,0.273159600458798,2020-02-10,2020,2
"2485","MA",2,"Nordeste",21020,"Gerais de Balsas",144541,38035.8491120167,7,44,15,29,21,23,1,0,1,0,1,45,15,30,21,24,14,10.5462843916733,11.8813184833131,0.282813320359852,2020-02-17,2020,2
"2486","MA",2,"Nordeste",21020,"Gerais de Balsas",144541,38035.8491120167,8,71,25,46,36,35,0,0,0,0,0,71,25,46,36,35,10,10.5462843916733,11.8813184833131,0.315223854658118,2020-02-24,2020,2
"2487","MA",2,"Nordeste",21020,"Gerais de Balsas",144541,38035.8491120167,9,37,14,23,12,25,0,0,0,0,0,37,14,23,12,25,22,10.5462843916733,11.8813184833131,0.295159974248776,2020-03-02,2020,3
"2488","MA",2,"Nordeste",21020,"Gerais de Balsas",144541,38035.8491120167,10,45,15,30,22,23,0,0,0,0,0,45,15,30,22,23,21,10.5462843916733,11.8813184833131,0.323502648150168,2020-03-09,2020,3
"2489","MA",2,"Nordeste",21020,"Gerais de Balsas",144541,38035.8491120167,11,56,19,37,30,26,1,0,1,1,0,57,19,38,31,26,17,10.5462843916733,11.8813184833131,0.372828159375802,2020-03-16,2020,3
"2490","MA",2,"Nordeste",21020,"Gerais de Balsas",144541,38035.8491120167,12,50,17,33,25,25,0,0,0,0,0,50,17,33,25,25,14,10.5462843916733,11.8813184833131,0.438922032036624,2020-03-23,2020,3
"2491","MA",2,"Nordeste",21020,"Gerais de Balsas",144541,38035.8491120167,13,37,14,23,17,20,0,0,0,0,0,37,14,23,17,20,13,10.5462843916733,11.8813184833131,0.396410264879659,2020-03-30,2020,3
"2492","MA",2,"Nordeste",21020,"Gerais de Balsas",144541,38035.8491120167,14,54,18,36,26,28,0,0,0,0,0,54,18,36,26,28,11,10.5462843916733,11.8813184833131,0.385071207444422,2020-04-06,2020,4
"2493","MA",2,"Nordeste",21020,"Gerais de Balsas",144541,38035.8491120167,15,42,13,29,18,24,1,0,1,1,0,43,13,30,19,24,10,10.5462843916733,11.8813184833131,0.349632476224797,2020-04-13,2020,4
"2494","MA",2,"Nordeste",21020,"Gerais de Balsas",144541,38035.8491120167,16,41,15,26,18,23,0,0,0,0,0,41,15,26,18,23,17,10.5462843916733,11.8813184833131,0.368927287641948,2020-04-20,2020,4
"2495","MA",2,"Nordeste",21020,"Gerais de Balsas",144541,38035.8491120167,17,32,15,17,12,20,0,0,0,0,0,32,15,17,12,20,14,10.5462843916733,11.8813184833131,0.353568979206115,2020-04-27,2020,4
"2496","MA",2,"Nordeste",21020,"Gerais de Balsas",144541,38035.8491120167,18,47,14,33,24,23,0,0,0,0,0,47,14,33,24,23,17,10.5462843916733,11.8813184833131,0.376152056317353,2020-05-04,2020,5
"2497","MA",2,"Nordeste",21020,"Gerais de Balsas",144541,38035.8491120167,19,36,11,25,20,16,0,0,0,0,0,36,11,25,20,16,12,10.5462843916733,11.8813184833131,0.405170828536815,2020-05-11,2020,5
"2498","MA",2,"Nordeste",21020,"Gerais de Balsas",144541,38035.8491120167,20,45,13,32,23,22,0,0,0,0,0,45,13,32,23,22,12,10.5462843916733,11.8813184833131,0.381502285554261,2020-05-18,2020,5
"2499","MA",2,"Nordeste",21020,"Gerais de Balsas",144541,38035.8491120167,21,56,20,36,33,23,1,0,1,0,1,57,20,37,33,24,27,10.5462843916733,11.8813184833131,0.374906736987009,2020-05-25,2020,5
"2500","MA",2,"Nordeste",21021,"Chapadas das Mangabeiras",72567,19660.7131692091,5,23,13,10,13,10,0,0,0,0,0,23,13,10,13,10,7,9.88637766818103,11.1922655520212,0.286735978520606,2020-02-03,2020,2
"2501","MA",2,"Nordeste",21021,"Chapadas das Mangabeiras",72567,19660.7131692091,6,14,7,7,9,5,1,1,0,1,0,15,8,7,10,5,11,9.88637766818103,11.1922655520212,0.277687862791415,2020-02-10,2020,2
"2502","MA",2,"Nordeste",21021,"Chapadas das Mangabeiras",72567,19660.7131692091,7,12,3,9,7,5,0,0,0,0,0,12,3,9,7,5,9,9.88637766818103,11.1922655520212,0.270154819803514,2020-02-17,2020,2
"2503","MA",2,"Nordeste",21021,"Chapadas das Mangabeiras",72567,19660.7131692091,8,26,6,20,15,11,0,0,0,0,0,26,6,20,15,11,8,9.88637766818103,11.1922655520212,0.311939485380397,2020-02-24,2020,2
"2504","MA",2,"Nordeste",21021,"Chapadas das Mangabeiras",72567,19660.7131692091,9,18,4,14,11,7,1,0,1,0,1,19,4,15,11,8,11,9.88637766818103,11.1922655520212,0.306158577118866,2020-03-02,2020,3
"2505","MA",2,"Nordeste",21021,"Chapadas das Mangabeiras",72567,19660.7131692091,10,17,7,10,9,8,0,0,0,0,0,17,7,10,9,8,10,9.88637766818103,11.1922655520212,0.329341121352606,2020-03-09,2020,3
"2506","MA",2,"Nordeste",21021,"Chapadas das Mangabeiras",72567,19660.7131692091,11,16,5,11,8,8,0,0,0,0,0,16,5,11,8,8,15,9.88637766818103,11.1922655520212,0.379424684514214,2020-03-16,2020,3
"2507","MA",2,"Nordeste",21021,"Chapadas das Mangabeiras",72567,19660.7131692091,12,13,7,6,9,4,0,0,0,0,0,13,7,6,9,4,8,9.88637766818103,11.1922655520212,0.44470180844175,2020-03-23,2020,3
"2508","MA",2,"Nordeste",21021,"Chapadas das Mangabeiras",72567,19660.7131692091,13,8,3,5,5,3,0,0,0,0,0,8,3,5,5,3,9,9.88637766818103,11.1922655520212,0.384669231640538,2020-03-30,2020,3
"2509","MA",2,"Nordeste",21021,"Chapadas das Mangabeiras",72567,19660.7131692091,14,15,6,9,7,8,1,1,0,1,0,16,7,9,8,8,8,9.88637766818103,11.1922655520212,0.392154043159816,2020-04-06,2020,4
"2510","MA",2,"Nordeste",21021,"Chapadas das Mangabeiras",72567,19660.7131692091,15,21,8,13,14,7,1,1,0,0,1,22,9,13,14,8,3,9.88637766818103,11.1922655520212,0.383714851407035,2020-04-13,2020,4
"2511","MA",2,"Nordeste",21021,"Chapadas das Mangabeiras",72567,19660.7131692091,16,20,4,16,13,7,0,0,0,0,0,20,4,16,13,7,7,9.88637766818103,11.1922655520212,0.364740832493442,2020-04-20,2020,4
"2512","MA",2,"Nordeste",21021,"Chapadas das Mangabeiras",72567,19660.7131692091,17,17,7,10,8,9,0,0,0,0,0,17,7,10,8,9,6,9.88637766818103,11.1922655520212,0.35284356322959,2020-04-27,2020,4
"2513","MA",2,"Nordeste",21021,"Chapadas das Mangabeiras",72567,19660.7131692091,18,11,3,8,5,6,0,0,0,0,0,11,3,8,5,6,8,9.88637766818103,11.1922655520212,0.37306912789969,2020-05-04,2020,5
"2514","MA",2,"Nordeste",21021,"Chapadas das Mangabeiras",72567,19660.7131692091,19,20,4,16,7,13,0,0,0,0,0,20,4,16,7,13,8,9.88637766818103,11.1922655520212,0.406825001804907,2020-05-11,2020,5
"2515","MA",2,"Nordeste",21021,"Chapadas das Mangabeiras",72567,19660.7131692091,20,26,9,17,14,12,0,0,0,0,0,26,9,17,14,12,8,9.88637766818103,11.1922655520212,0.380330059760075,2020-05-18,2020,5
"2516","MA",2,"Nordeste",21021,"Chapadas das Mangabeiras",72567,19660.7131692091,21,21,5,16,13,8,0,0,0,0,0,21,5,16,13,8,2,9.88637766818103,11.1922655520212,0.380705635144221,2020-05-25,2020,5
"2517","MG",3,"Sudeste",31001,"Unaí",160148,32386.4492253416,5,41,5,36,20,21,0,0,0,0,0,41,5,36,20,21,13,10.3854953805105,11.9838536666671,0.276485478624335,2020-02-03,2020,2
"2518","MG",3,"Sudeste",31001,"Unaí",160148,32386.4492253416,6,29,7,22,15,14,0,0,0,0,0,29,7,22,15,14,17,10.3854953805105,11.9838536666671,0.265468065072911,2020-02-10,2020,2
"2519","MG",3,"Sudeste",31001,"Unaí",160148,32386.4492253416,7,39,11,28,15,24,0,0,0,0,0,39,11,28,15,24,17,10.3854953805105,11.9838536666671,0.278829662159327,2020-02-17,2020,2
"2520","MG",3,"Sudeste",31001,"Unaí",160148,32386.4492253416,8,36,9,27,15,21,1,1,0,1,0,37,10,27,16,21,22,10.3854953805105,11.9838536666671,0.31724559388494,2020-02-24,2020,2
"2521","MG",3,"Sudeste",31001,"Unaí",160148,32386.4492253416,9,35,6,29,15,20,0,0,0,0,0,35,6,29,15,20,18,10.3854953805105,11.9838536666671,0.293522995472042,2020-03-02,2020,3
"2522","MG",3,"Sudeste",31001,"Unaí",160148,32386.4492253416,10,31,9,22,12,19,0,0,0,0,0,31,9,22,12,19,13,10.3854953805105,11.9838536666671,0.309676773883539,2020-03-09,2020,3
"2523","MG",3,"Sudeste",31001,"Unaí",160148,32386.4492253416,11,30,3,27,10,20,0,0,0,0,0,30,3,27,10,20,15,10.3854953805105,11.9838536666671,0.381558241346598,2020-03-16,2020,3
"2524","MG",3,"Sudeste",31001,"Unaí",160148,32386.4492253416,12,26,6,20,13,13,0,0,0,0,0,26,6,20,13,13,17,10.3854953805105,11.9838536666671,0.475473559837065,2020-03-23,2020,3
"2525","MG",3,"Sudeste",31001,"Unaí",160148,32386.4492253416,13,31,9,22,7,24,1,1,0,0,1,32,10,22,7,25,17,10.3854953805105,11.9838536666671,0.412886481261441,2020-03-30,2020,3
"2526","MG",3,"Sudeste",31001,"Unaí",160148,32386.4492253416,14,38,5,33,18,20,0,0,0,0,0,38,5,33,18,20,24,10.3854953805105,11.9838536666671,0.403124408852465,2020-04-06,2020,4
"2527","MG",3,"Sudeste",31001,"Unaí",160148,32386.4492253416,15,22,7,15,8,14,0,0,0,0,0,22,7,15,8,14,12,10.3854953805105,11.9838536666671,0.37717463933187,2020-04-13,2020,4
"2528","MG",3,"Sudeste",31001,"Unaí",160148,32386.4492253416,16,49,11,38,19,30,0,0,0,0,0,49,11,38,19,30,17,10.3854953805105,11.9838536666671,0.390284032165834,2020-04-20,2020,4
"2529","MG",3,"Sudeste",31001,"Unaí",160148,32386.4492253416,17,35,7,28,13,22,0,0,0,0,0,35,7,28,13,22,13,10.3854953805105,11.9838536666671,0.384212978903129,2020-04-27,2020,4
"2530","MG",3,"Sudeste",31001,"Unaí",160148,32386.4492253416,18,28,3,25,11,17,0,0,0,0,0,28,3,25,11,17,20,10.3854953805105,11.9838536666671,0.369037802999846,2020-05-04,2020,5
"2531","MG",3,"Sudeste",31001,"Unaí",160148,32386.4492253416,19,39,10,29,13,26,0,0,0,0,0,39,10,29,13,26,9,10.3854953805105,11.9838536666671,0.369560954675528,2020-05-11,2020,5
"2532","MG",3,"Sudeste",31001,"Unaí",160148,32386.4492253416,20,47,10,37,18,29,0,0,0,0,0,47,10,37,18,29,11,10.3854953805105,11.9838536666671,0.361550791976504,2020-05-18,2020,5
"2533","MG",3,"Sudeste",31001,"Unaí",160148,32386.4492253416,21,35,7,28,14,21,1,1,0,1,0,36,8,28,15,21,16,10.3854953805105,11.9838536666671,0.361333340624338,2020-05-25,2020,5
"2534","MG",3,"Sudeste",31002,"Paracatu",237979,35543.4443576534,5,52,15,37,27,25,0,0,0,0,0,52,15,37,27,25,27,10.478511011972,12.3799377134665,0.297184655057013,2020-02-03,2020,2
"2535","MG",3,"Sudeste",31002,"Paracatu",237979,35543.4443576534,6,56,10,46,20,36,1,0,1,0,1,57,10,47,20,37,29,10.478511011972,12.3799377134665,0.283130470647271,2020-02-10,2020,2
"2536","MG",3,"Sudeste",31002,"Paracatu",237979,35543.4443576534,7,57,7,50,20,37,0,0,0,0,0,57,7,50,20,37,26,10.478511011972,12.3799377134665,0.298889719762815,2020-02-17,2020,2
"2537","MG",3,"Sudeste",31002,"Paracatu",237979,35543.4443576534,8,53,10,43,20,33,2,0,2,1,1,55,10,45,21,34,21,10.478511011972,12.3799377134665,0.343216792769595,2020-02-24,2020,2
"2538","MG",3,"Sudeste",31002,"Paracatu",237979,35543.4443576534,9,51,11,40,21,30,0,0,0,0,0,51,11,40,21,30,21,10.478511011972,12.3799377134665,0.311710128554893,2020-03-02,2020,3
"2539","MG",3,"Sudeste",31002,"Paracatu",237979,35543.4443576534,10,53,12,41,24,29,0,0,0,0,0,53,12,41,24,29,24,10.478511011972,12.3799377134665,0.330610828540981,2020-03-09,2020,3
"2540","MG",3,"Sudeste",31002,"Paracatu",237979,35543.4443576534,11,51,12,39,18,33,1,0,1,1,0,52,12,40,19,33,26,10.478511011972,12.3799377134665,0.391874848761775,2020-03-16,2020,3
"2541","MG",3,"Sudeste",31002,"Paracatu",237979,35543.4443576534,12,50,11,39,15,35,0,0,0,0,0,50,11,39,15,35,23,10.478511011972,12.3799377134665,0.472048433331913,2020-03-23,2020,3
"2542","MG",3,"Sudeste",31002,"Paracatu",237979,35543.4443576534,13,38,4,34,14,24,0,0,0,0,0,38,4,34,14,24,30,10.478511011972,12.3799377134665,0.430492350465213,2020-03-30,2020,3
"2543","MG",3,"Sudeste",31002,"Paracatu",237979,35543.4443576534,14,54,12,42,23,31,1,0,1,0,1,55,12,43,23,32,21,10.478511011972,12.3799377134665,0.427024935147143,2020-04-06,2020,4
"2544","MG",3,"Sudeste",31002,"Paracatu",237979,35543.4443576534,15,56,6,50,20,36,0,0,0,0,0,56,6,50,20,36,20,10.478511011972,12.3799377134665,0.396360287881719,2020-04-13,2020,4
"2545","MG",3,"Sudeste",31002,"Paracatu",237979,35543.4443576534,16,48,4,44,24,24,0,0,0,0,0,48,4,44,24,24,37,10.478511011972,12.3799377134665,0.399627383950521,2020-04-20,2020,4
"2546","MG",3,"Sudeste",31002,"Paracatu",237979,35543.4443576534,17,50,11,39,20,30,1,0,1,0,1,51,11,40,20,31,21,10.478511011972,12.3799377134665,0.391030313180527,2020-04-27,2020,4
"2547","MG",3,"Sudeste",31002,"Paracatu",237979,35543.4443576534,18,47,11,36,13,34,1,1,0,1,0,48,12,36,14,34,16,10.478511011972,12.3799377134665,0.37814913933571,2020-05-04,2020,5
"2548","MG",3,"Sudeste",31002,"Paracatu",237979,35543.4443576534,19,70,19,51,22,48,0,0,0,0,0,70,19,51,22,48,20,10.478511011972,12.3799377134665,0.391730786265521,2020-05-11,2020,5
"2549","MG",3,"Sudeste",31002,"Paracatu",237979,35543.4443576534,20,70,16,54,30,40,1,1,0,1,0,71,17,54,31,40,20,10.478511011972,12.3799377134665,0.390143521072332,2020-05-18,2020,5
"2550","MG",3,"Sudeste",31002,"Paracatu",237979,35543.4443576534,21,58,10,48,19,39,1,0,1,1,0,59,10,49,20,39,31,10.478511011972,12.3799377134665,0.378639845428037,2020-05-25,2020,5
"2551","MG",3,"Sudeste",31003,"Januária",292494,9226.47937550856,5,65,22,43,27,38,0,0,0,0,0,65,22,43,27,38,36,9.12983282196028,12.5861994326231,0.28968136922717,2020-02-03,2020,2
"2552","MG",3,"Sudeste",31003,"Januária",292494,9226.47937550856,6,69,23,46,28,41,1,0,1,0,1,70,23,47,28,42,22,9.12983282196028,12.5861994326231,0.274575414757824,2020-02-10,2020,2
"2553","MG",3,"Sudeste",31003,"Januária",292494,9226.47937550856,7,62,15,47,25,37,0,0,0,0,0,62,15,47,25,37,24,9.12983282196028,12.5861994326231,0.285053076942521,2020-02-17,2020,2
"2554","MG",3,"Sudeste",31003,"Januária",292494,9226.47937550856,8,55,14,41,19,36,0,0,0,0,0,55,14,41,19,36,33,9.12983282196028,12.5861994326231,0.31358599815348,2020-02-24,2020,2
"2555","MG",3,"Sudeste",31003,"Januária",292494,9226.47937550856,9,70,21,49,28,42,2,1,1,0,2,72,22,50,28,44,25,9.12983282196028,12.5861994326231,0.305596794035566,2020-03-02,2020,3
"2556","MG",3,"Sudeste",31003,"Januária",292494,9226.47937550856,10,60,19,41,26,34,1,0,1,1,0,61,19,42,27,34,26,9.12983282196028,12.5861994326231,0.308418754014489,2020-03-09,2020,3
"2557","MG",3,"Sudeste",31003,"Januária",292494,9226.47937550856,11,62,22,40,27,35,0,0,0,0,0,62,22,40,27,35,28,9.12983282196028,12.5861994326231,0.373801821640456,2020-03-16,2020,3
"2558","MG",3,"Sudeste",31003,"Januária",292494,9226.47937550856,12,57,19,38,22,35,0,0,0,0,0,57,19,38,22,35,30,9.12983282196028,12.5861994326231,0.493194659325437,2020-03-23,2020,3
"2559","MG",3,"Sudeste",31003,"Januária",292494,9226.47937550856,13,52,18,34,21,31,0,0,0,0,0,52,18,34,21,31,38,9.12983282196028,12.5861994326231,0.4393593556526,2020-03-30,2020,3
"2560","MG",3,"Sudeste",31003,"Januária",292494,9226.47937550856,14,67,20,47,27,40,0,0,0,0,0,67,20,47,27,40,31,9.12983282196028,12.5861994326231,0.430013127783489,2020-04-06,2020,4
"2561","MG",3,"Sudeste",31003,"Januária",292494,9226.47937550856,15,54,18,36,25,29,0,0,0,0,0,54,18,36,25,29,28,9.12983282196028,12.5861994326231,0.408140406718547,2020-04-13,2020,4
"2562","MG",3,"Sudeste",31003,"Januária",292494,9226.47937550856,16,74,17,57,28,46,0,0,0,0,0,74,17,57,28,46,35,9.12983282196028,12.5861994326231,0.404508293856813,2020-04-20,2020,4
"2563","MG",3,"Sudeste",31003,"Januária",292494,9226.47937550856,17,58,15,43,25,33,0,0,0,0,0,58,15,43,25,33,23,9.12983282196028,12.5861994326231,0.399671728076482,2020-04-27,2020,4
"2564","MG",3,"Sudeste",31003,"Januária",292494,9226.47937550856,18,58,14,44,23,35,1,1,0,1,0,59,15,44,24,35,40,9.12983282196028,12.5861994326231,0.386216974181548,2020-05-04,2020,5
"2565","MG",3,"Sudeste",31003,"Januária",292494,9226.47937550856,19,60,19,41,24,36,1,1,0,1,0,61,20,41,25,36,30,9.12983282196028,12.5861994326231,0.391900026091852,2020-05-11,2020,5
"2566","MG",3,"Sudeste",31003,"Januária",292494,9226.47937550856,20,78,16,62,31,47,0,0,0,0,0,78,16,62,31,47,29,9.12983282196028,12.5861994326231,0.377624845303736,2020-05-18,2020,5
"2567","MG",3,"Sudeste",31003,"Januária",292494,9226.47937550856,21,81,25,56,37,44,2,1,1,1,1,83,26,57,38,45,45,9.12983282196028,12.5861994326231,0.382894198490351,2020-05-25,2020,5
"2568","MG",3,"Sudeste",31004,"Janaúba",258479,12571.1388016048,5,51,7,44,25,26,1,0,1,1,0,52,7,45,26,26,18,9.43915889426703,12.4625697317196,0.275470582956002,2020-02-03,2020,2
"2569","MG",3,"Sudeste",31004,"Janaúba",258479,12571.1388016048,6,58,15,43,28,30,2,0,2,1,1,60,15,45,29,31,16,9.43915889426703,12.4625697317196,0.271333536789784,2020-02-10,2020,2
"2570","MG",3,"Sudeste",31004,"Janaúba",258479,12571.1388016048,7,78,18,60,33,45,0,0,0,0,0,78,18,60,33,45,25,9.43915889426703,12.4625697317196,0.281238317480653,2020-02-17,2020,2
"2571","MG",3,"Sudeste",31004,"Janaúba",258479,12571.1388016048,8,70,18,52,28,42,1,1,0,1,0,71,19,52,29,42,29,9.43915889426703,12.4625697317196,0.319154835062686,2020-02-24,2020,2
"2572","MG",3,"Sudeste",31004,"Janaúba",258479,12571.1388016048,9,54,11,43,15,39,2,1,1,0,2,56,12,44,15,41,30,9.43915889426703,12.4625697317196,0.305682087059339,2020-03-02,2020,3
"2573","MG",3,"Sudeste",31004,"Janaúba",258479,12571.1388016048,10,47,11,36,20,27,1,1,0,1,0,48,12,36,21,27,23,9.43915889426703,12.4625697317196,0.314676976407081,2020-03-09,2020,3
"2574","MG",3,"Sudeste",31004,"Janaúba",258479,12571.1388016048,11,43,9,34,11,32,1,0,1,0,1,44,9,35,11,33,32,9.43915889426703,12.4625697317196,0.374518430253734,2020-03-16,2020,3
"2575","MG",3,"Sudeste",31004,"Janaúba",258479,12571.1388016048,12,40,10,30,13,27,2,1,1,0,2,42,11,31,13,29,28,9.43915889426703,12.4625697317196,0.472263591637471,2020-03-23,2020,3
"2576","MG",3,"Sudeste",31004,"Janaúba",258479,12571.1388016048,13,62,10,52,21,41,1,0,1,1,0,63,10,53,22,41,30,9.43915889426703,12.4625697317196,0.418540884096479,2020-03-30,2020,3
"2577","MG",3,"Sudeste",31004,"Janaúba",258479,12571.1388016048,14,50,10,40,19,31,1,0,1,0,1,51,10,41,19,32,32,9.43915889426703,12.4625697317196,0.410852996714264,2020-04-06,2020,4
"2578","MG",3,"Sudeste",31004,"Janaúba",258479,12571.1388016048,15,48,8,40,20,28,1,0,1,0,1,49,8,41,20,29,31,9.43915889426703,12.4625697317196,0.376892130512499,2020-04-13,2020,4
"2579","MG",3,"Sudeste",31004,"Janaúba",258479,12571.1388016048,16,50,7,43,22,28,0,0,0,0,0,50,7,43,22,28,27,9.43915889426703,12.4625697317196,0.375664150964471,2020-04-20,2020,4
"2580","MG",3,"Sudeste",31004,"Janaúba",258479,12571.1388016048,17,61,15,46,27,34,1,1,0,0,1,62,16,46,27,35,29,9.43915889426703,12.4625697317196,0.377262813063327,2020-04-27,2020,4
"2581","MG",3,"Sudeste",31004,"Janaúba",258479,12571.1388016048,18,69,18,51,25,44,1,1,0,0,1,70,19,51,25,45,37,9.43915889426703,12.4625697317196,0.362192269551392,2020-05-04,2020,5
"2582","MG",3,"Sudeste",31004,"Janaúba",258479,12571.1388016048,19,55,5,50,26,29,1,0,1,0,1,56,5,51,26,30,20,9.43915889426703,12.4625697317196,0.375869739060255,2020-05-11,2020,5
"2583","MG",3,"Sudeste",31004,"Janaúba",258479,12571.1388016048,20,80,18,62,31,49,0,0,0,0,0,80,18,62,31,49,30,9.43915889426703,12.4625697317196,0.368763598087455,2020-05-18,2020,5
"2584","MG",3,"Sudeste",31004,"Janaúba",258479,12571.1388016048,21,64,15,49,23,41,0,0,0,0,0,64,15,49,23,41,32,9.43915889426703,12.4625697317196,0.375876009614291,2020-05-25,2020,5
"2585","MG",3,"Sudeste",31005,"Salinas",222711,11000.4331305144,5,48,12,36,17,31,0,0,0,0,0,48,12,36,17,31,24,9.30568992650663,12.3136302458289,0.281473311174639,2020-02-03,2020,2
"2586","MG",3,"Sudeste",31005,"Salinas",222711,11000.4331305144,6,40,6,34,13,27,0,0,0,0,0,40,6,34,13,27,26,9.30568992650663,12.3136302458289,0.269269516711777,2020-02-10,2020,2
"2587","MG",3,"Sudeste",31005,"Salinas",222711,11000.4331305144,7,51,11,40,16,35,0,0,0,0,0,51,11,40,16,35,21,9.30568992650663,12.3136302458289,0.285150133954417,2020-02-17,2020,2
"2588","MG",3,"Sudeste",31005,"Salinas",222711,11000.4331305144,8,50,13,37,16,34,0,0,0,0,0,50,13,37,16,34,28,9.30568992650663,12.3136302458289,0.312562749771598,2020-02-24,2020,2
"2589","MG",3,"Sudeste",31005,"Salinas",222711,11000.4331305144,9,57,12,45,15,42,0,0,0,0,0,57,12,45,15,42,21,9.30568992650663,12.3136302458289,0.298255382967878,2020-03-02,2020,3
"2590","MG",3,"Sudeste",31005,"Salinas",222711,11000.4331305144,10,34,7,27,18,16,1,0,1,0,1,35,7,28,18,17,36,9.30568992650663,12.3136302458289,0.319607597571804,2020-03-09,2020,3
"2591","MG",3,"Sudeste",31005,"Salinas",222711,11000.4331305144,11,51,10,41,21,30,1,1,0,1,0,52,11,41,22,30,25,9.30568992650663,12.3136302458289,0.376479750694719,2020-03-16,2020,3
"2592","MG",3,"Sudeste",31005,"Salinas",222711,11000.4331305144,12,48,14,34,13,35,0,0,0,0,0,48,14,34,13,35,29,9.30568992650663,12.3136302458289,0.46593041705092,2020-03-23,2020,3
"2593","MG",3,"Sudeste",31005,"Salinas",222711,11000.4331305144,13,33,7,26,13,20,2,1,1,1,1,35,8,27,14,21,33,9.30568992650663,12.3136302458289,0.416728411682585,2020-03-30,2020,3
"2594","MG",3,"Sudeste",31005,"Salinas",222711,11000.4331305144,14,42,5,37,18,24,0,0,0,0,0,42,5,37,18,24,26,9.30568992650663,12.3136302458289,0.39916892123252,2020-04-06,2020,4
"2595","MG",3,"Sudeste",31005,"Salinas",222711,11000.4331305144,15,50,16,34,21,29,0,0,0,0,0,50,16,34,21,29,22,9.30568992650663,12.3136302458289,0.363782738104361,2020-04-13,2020,4
"2596","MG",3,"Sudeste",31005,"Salinas",222711,11000.4331305144,16,55,13,42,19,36,0,0,0,0,0,55,13,42,19,36,36,9.30568992650663,12.3136302458289,0.369894192778698,2020-04-20,2020,4
"2597","MG",3,"Sudeste",31005,"Salinas",222711,11000.4331305144,17,53,11,42,25,28,0,0,0,0,0,53,11,42,25,28,20,9.30568992650663,12.3136302458289,0.346273037735701,2020-04-27,2020,4
"2598","MG",3,"Sudeste",31005,"Salinas",222711,11000.4331305144,18,38,10,28,13,25,0,0,0,0,0,38,10,28,13,25,27,9.30568992650663,12.3136302458289,0.363362525494107,2020-05-04,2020,5
"2599","MG",3,"Sudeste",31005,"Salinas",222711,11000.4331305144,19,46,13,33,9,37,2,2,0,1,1,48,15,33,10,38,24,9.30568992650663,12.3136302458289,0.371317685649136,2020-05-11,2020,5
"2600","MG",3,"Sudeste",31005,"Salinas",222711,11000.4331305144,20,56,10,46,19,37,0,0,0,0,0,56,10,46,19,37,14,9.30568992650663,12.3136302458289,0.357795037864538,2020-05-18,2020,5
"2601","MG",3,"Sudeste",31005,"Salinas",222711,11000.4331305144,21,49,11,38,17,32,0,0,0,0,0,49,11,38,17,32,25,9.30568992650663,12.3136302458289,0.364074109461182,2020-05-25,2020,5
"2602","MG",3,"Sudeste",31006,"Pirapora",175543,23235.2541581835,5,28,8,20,14,14,0,0,0,0,0,28,8,20,14,14,22,10.0534259800512,12.075639306122,0.298620363494075,2020-02-03,2020,2
"2603","MG",3,"Sudeste",31006,"Pirapora",175543,23235.2541581835,6,39,10,29,17,22,0,0,0,0,0,39,10,29,17,22,25,10.0534259800512,12.075639306122,0.295383573192651,2020-02-10,2020,2
"2604","MG",3,"Sudeste",31006,"Pirapora",175543,23235.2541581835,7,32,7,25,10,22,1,1,0,1,0,33,8,25,11,22,17,10.0534259800512,12.075639306122,0.296935965597075,2020-02-17,2020,2
"2605","MG",3,"Sudeste",31006,"Pirapora",175543,23235.2541581835,8,32,9,23,15,17,0,0,0,0,0,32,9,23,15,17,13,10.0534259800512,12.075639306122,0.339017386481919,2020-02-24,2020,2
"2606","MG",3,"Sudeste",31006,"Pirapora",175543,23235.2541581835,9,28,6,22,13,15,1,0,1,0,1,29,6,23,13,16,14,10.0534259800512,12.075639306122,0.325816665822653,2020-03-02,2020,3
"2607","MG",3,"Sudeste",31006,"Pirapora",175543,23235.2541581835,10,34,10,24,16,18,0,0,0,0,0,34,10,24,16,18,14,10.0534259800512,12.075639306122,0.326354970793197,2020-03-09,2020,3
"2608","MG",3,"Sudeste",31006,"Pirapora",175543,23235.2541581835,11,41,17,24,14,27,2,0,2,1,1,43,17,26,15,28,15,10.0534259800512,12.075639306122,0.382398710890425,2020-03-16,2020,3
"2609","MG",3,"Sudeste",31006,"Pirapora",175543,23235.2541581835,12,32,8,24,13,19,0,0,0,0,0,32,8,24,13,19,11,10.0534259800512,12.075639306122,0.479999036723168,2020-03-23,2020,3
"2610","MG",3,"Sudeste",31006,"Pirapora",175543,23235.2541581835,13,27,8,19,12,15,0,0,0,0,0,27,8,19,12,15,18,10.0534259800512,12.075639306122,0.443050371357794,2020-03-30,2020,3
"2611","MG",3,"Sudeste",31006,"Pirapora",175543,23235.2541581835,14,36,5,31,12,24,1,0,1,1,0,37,5,32,13,24,16,10.0534259800512,12.075639306122,0.412400342276024,2020-04-06,2020,4
"2612","MG",3,"Sudeste",31006,"Pirapora",175543,23235.2541581835,15,53,16,37,24,29,0,0,0,0,0,53,16,37,24,29,14,10.0534259800512,12.075639306122,0.393530801152123,2020-04-13,2020,4
"2613","MG",3,"Sudeste",31006,"Pirapora",175543,23235.2541581835,16,44,16,28,23,21,0,0,0,0,0,44,16,28,23,21,12,10.0534259800512,12.075639306122,0.405801979767559,2020-04-20,2020,4
"2614","MG",3,"Sudeste",31006,"Pirapora",175543,23235.2541581835,17,35,5,30,15,20,0,0,0,0,0,35,5,30,15,20,18,10.0534259800512,12.075639306122,0.405040450852683,2020-04-27,2020,4
"2615","MG",3,"Sudeste",31006,"Pirapora",175543,23235.2541581835,18,43,12,31,29,14,0,0,0,0,0,43,12,31,29,14,17,10.0534259800512,12.075639306122,0.381170244240939,2020-05-04,2020,5
"2616","MG",3,"Sudeste",31006,"Pirapora",175543,23235.2541581835,19,48,10,38,19,29,0,0,0,0,0,48,10,38,19,29,22,10.0534259800512,12.075639306122,0.389048779392759,2020-05-11,2020,5
"2617","MG",3,"Sudeste",31006,"Pirapora",175543,23235.2541581835,20,43,14,29,21,22,0,0,0,0,0,43,14,29,21,22,22,10.0534259800512,12.075639306122,0.384294769719528,2020-05-18,2020,5
"2618","MG",3,"Sudeste",31006,"Pirapora",175543,23235.2541581835,21,38,8,30,17,21,0,0,0,0,0,38,8,30,17,21,24,10.0534259800512,12.075639306122,0.382332614694659,2020-05-25,2020,5
"2619","MG",3,"Sudeste",31007,"Montes Claros",662545,18197.3918723558,5,142,22,120,43,99,1,0,1,1,0,143,22,121,44,99,62,9.80903355907922,13.403843759064,0.27210487268815,2020-02-03,2020,2
"2620","MG",3,"Sudeste",31007,"Montes Claros",662545,18197.3918723558,6,178,23,155,63,115,2,1,1,0,2,180,24,156,63,117,73,9.80903355907922,13.403843759064,0.263336043500748,2020-02-10,2020,2
"2621","MG",3,"Sudeste",31007,"Montes Claros",662545,18197.3918723558,7,163,35,128,53,110,1,0,1,0,1,164,35,129,53,111,69,9.80903355907922,13.403843759064,0.280819810319502,2020-02-17,2020,2
"2622","MG",3,"Sudeste",31007,"Montes Claros",662545,18197.3918723558,8,187,34,153,53,134,3,2,1,1,2,190,36,154,54,136,62,9.80903355907922,13.403843759064,0.323675648650106,2020-02-24,2020,2
"2623","MG",3,"Sudeste",31007,"Montes Claros",662545,18197.3918723558,9,158,26,132,54,104,4,0,4,2,2,162,26,136,56,106,64,9.80903355907922,13.403843759064,0.30780062337229,2020-03-02,2020,3
"2624","MG",3,"Sudeste",31007,"Montes Claros",662545,18197.3918723558,10,150,25,125,51,99,2,0,2,1,1,152,25,127,52,100,75,9.80903355907922,13.403843759064,0.308951031481509,2020-03-09,2020,3
"2625","MG",3,"Sudeste",31007,"Montes Claros",662545,18197.3918723558,11,147,29,118,46,101,3,0,3,1,2,150,29,121,47,103,91,9.80903355907922,13.403843759064,0.372384326864079,2020-03-16,2020,3
"2626","MG",3,"Sudeste",31007,"Montes Claros",662545,18197.3918723558,12,147,23,124,45,102,1,0,1,0,1,148,23,125,45,103,72,9.80903355907922,13.403843759064,0.499376630330056,2020-03-23,2020,3
"2627","MG",3,"Sudeste",31007,"Montes Claros",662545,18197.3918723558,13,148,31,117,50,98,1,0,1,1,0,149,31,118,51,98,63,9.80903355907922,13.403843759064,0.450563326719789,2020-03-30,2020,3
"2628","MG",3,"Sudeste",31007,"Montes Claros",662545,18197.3918723558,14,183,29,154,53,130,3,0,3,1,2,186,29,157,54,132,69,9.80903355907922,13.403843759064,0.443196506048719,2020-04-06,2020,4
"2629","MG",3,"Sudeste",31007,"Montes Claros",662545,18197.3918723558,15,161,33,128,57,104,1,0,1,1,0,162,33,129,58,104,61,9.80903355907922,13.403843759064,0.415713656231358,2020-04-13,2020,4
"2630","MG",3,"Sudeste",31007,"Montes Claros",662545,18197.3918723558,16,175,25,150,65,110,2,0,2,0,2,177,25,152,65,112,66,9.80903355907922,13.403843759064,0.417042064188156,2020-04-20,2020,4
"2631","MG",3,"Sudeste",31007,"Montes Claros",662545,18197.3918723558,17,178,24,154,57,121,2,1,1,1,1,180,25,155,58,122,75,9.80903355907922,13.403843759064,0.405027967027828,2020-04-27,2020,4
"2632","MG",3,"Sudeste",31007,"Montes Claros",662545,18197.3918723558,18,151,24,127,67,84,1,0,1,0,1,152,24,128,67,85,73,9.80903355907922,13.403843759064,0.381064863836222,2020-05-04,2020,5
"2633","MG",3,"Sudeste",31007,"Montes Claros",662545,18197.3918723558,19,185,28,157,60,125,4,1,3,2,2,189,29,160,62,127,82,9.80903355907922,13.403843759064,0.383071513676268,2020-05-11,2020,5
"2634","MG",3,"Sudeste",31007,"Montes Claros",662545,18197.3918723558,20,180,23,157,65,115,3,1,2,2,1,183,24,159,67,116,77,9.80903355907922,13.403843759064,0.377352238620859,2020-05-18,2020,5
"2635","MG",3,"Sudeste",31007,"Montes Claros",662545,18197.3918723558,21,156,29,127,53,103,3,0,3,0,3,159,29,130,53,106,71,9.80903355907922,13.403843759064,0.374095562322243,2020-05-25,2020,5
"2636","MG",3,"Sudeste",31008,"Grão Mogol",44889,19653.7347768941,5,9,1,8,3,6,0,0,0,0,0,9,1,8,3,6,6,9.88602266421924,10.7119480548515,0.315856759675921,2020-02-03,2020,2
"2637","MG",3,"Sudeste",31008,"Grão Mogol",44889,19653.7347768941,6,10,4,6,5,5,0,0,0,0,0,10,4,6,5,5,3,9.88602266421924,10.7119480548515,0.301190602648805,2020-02-10,2020,2
"2638","MG",3,"Sudeste",31008,"Grão Mogol",44889,19653.7347768941,7,9,5,4,2,7,0,0,0,0,0,9,5,4,2,7,4,9.88602266421924,10.7119480548515,0.289552264497812,2020-02-17,2020,2
"2639","MG",3,"Sudeste",31008,"Grão Mogol",44889,19653.7347768941,8,6,1,5,3,3,0,0,0,0,0,6,1,5,3,3,2,9.88602266421924,10.7119480548515,0.319943630922113,2020-02-24,2020,2
"2640","MG",3,"Sudeste",31008,"Grão Mogol",44889,19653.7347768941,9,3,1,2,1,2,1,0,1,1,0,4,1,3,2,2,4,9.88602266421924,10.7119480548515,0.336899126860102,2020-03-02,2020,3
"2641","MG",3,"Sudeste",31008,"Grão Mogol",44889,19653.7347768941,10,4,2,2,3,1,0,0,0,0,0,4,2,2,3,1,5,9.88602266421924,10.7119480548515,0.357145765591603,2020-03-09,2020,3
"2642","MG",3,"Sudeste",31008,"Grão Mogol",44889,19653.7347768941,11,6,2,4,2,4,0,0,0,0,0,6,2,4,2,4,1,9.88602266421924,10.7119480548515,0.360067091744601,2020-03-16,2020,3
"2643","MG",3,"Sudeste",31008,"Grão Mogol",44889,19653.7347768941,12,8,1,7,4,4,0,0,0,0,0,8,1,7,4,4,6,9.88602266421924,10.7119480548515,0.477350332331031,2020-03-23,2020,3
"2644","MG",3,"Sudeste",31008,"Grão Mogol",44889,19653.7347768941,13,8,1,7,3,5,0,0,0,0,0,8,1,7,3,5,5,9.88602266421924,10.7119480548515,0.412345308157699,2020-03-30,2020,3
"2645","MG",3,"Sudeste",31008,"Grão Mogol",44889,19653.7347768941,14,9,1,8,5,4,0,0,0,0,0,9,1,8,5,4,4,9.88602266421924,10.7119480548515,0.429670073423999,2020-04-06,2020,4
"2646","MG",3,"Sudeste",31008,"Grão Mogol",44889,19653.7347768941,15,9,1,8,3,6,0,0,0,0,0,9,1,8,3,6,4,9.88602266421924,10.7119480548515,0.392674177507297,2020-04-13,2020,4
"2647","MG",3,"Sudeste",31008,"Grão Mogol",44889,19653.7347768941,16,12,5,7,4,8,0,0,0,0,0,12,5,7,4,8,2,9.88602266421924,10.7119480548515,0.401974564456433,2020-04-20,2020,4
"2648","MG",3,"Sudeste",31008,"Grão Mogol",44889,19653.7347768941,17,12,1,11,8,4,0,0,0,0,0,12,1,11,8,4,4,9.88602266421924,10.7119480548515,0.39434423155683,2020-04-27,2020,4
"2649","MG",3,"Sudeste",31008,"Grão Mogol",44889,19653.7347768941,18,9,3,6,1,8,0,0,0,0,0,9,3,6,1,8,7,9.88602266421924,10.7119480548515,0.394029067163552,2020-05-04,2020,5
"2650","MG",3,"Sudeste",31008,"Grão Mogol",44889,19653.7347768941,19,9,0,9,6,3,0,0,0,0,0,9,0,9,6,3,4,9.88602266421924,10.7119480548515,0.417055263273417,2020-05-11,2020,5
"2651","MG",3,"Sudeste",31008,"Grão Mogol",44889,19653.7347768941,20,16,4,12,9,7,1,0,1,0,1,17,4,13,9,8,4,9.88602266421924,10.7119480548515,0.353896116534889,2020-05-18,2020,5
"2652","MG",3,"Sudeste",31008,"Grão Mogol",44889,19653.7347768941,21,11,2,9,4,7,0,0,0,0,0,11,2,9,4,7,1,9.88602266421924,10.7119480548515,0.384112897510676,2020-05-25,2020,5
"2653","MG",3,"Sudeste",31009,"Bocaiúva",73899,16238.9657776154,5,21,3,18,8,13,0,0,0,0,0,21,3,18,8,13,7,9.69516892804341,11.210454575045,0.265799660388931,2020-02-03,2020,2
"2654","MG",3,"Sudeste",31009,"Bocaiúva",73899,16238.9657776154,6,14,3,11,6,8,1,0,1,1,0,15,3,12,7,8,6,9.69516892804341,11.210454575045,0.26983834138005,2020-02-10,2020,2
"2655","MG",3,"Sudeste",31009,"Bocaiúva",73899,16238.9657776154,7,19,5,14,5,14,1,0,1,0,1,20,5,15,5,15,10,9.69516892804341,11.210454575045,0.279994274659513,2020-02-17,2020,2
"2656","MG",3,"Sudeste",31009,"Bocaiúva",73899,16238.9657776154,8,23,8,15,9,14,0,0,0,0,0,23,8,15,9,14,7,9.69516892804341,11.210454575045,0.334803243606357,2020-02-24,2020,2
"2657","MG",3,"Sudeste",31009,"Bocaiúva",73899,16238.9657776154,9,13,1,12,7,6,0,0,0,0,0,13,1,12,7,6,4,9.69516892804341,11.210454575045,0.301471943924925,2020-03-02,2020,3
"2658","MG",3,"Sudeste",31009,"Bocaiúva",73899,16238.9657776154,10,25,4,21,10,15,0,0,0,0,0,25,4,21,10,15,5,9.69516892804341,11.210454575045,0.301153720873872,2020-03-09,2020,3
"2659","MG",3,"Sudeste",31009,"Bocaiúva",73899,16238.9657776154,11,11,5,6,4,7,0,0,0,0,0,11,5,6,4,7,10,9.69516892804341,11.210454575045,0.365401739707747,2020-03-16,2020,3
"2660","MG",3,"Sudeste",31009,"Bocaiúva",73899,16238.9657776154,12,19,2,17,6,13,0,0,0,0,0,19,2,17,6,13,8,9.69516892804341,11.210454575045,0.470098959263652,2020-03-23,2020,3
"2661","MG",3,"Sudeste",31009,"Bocaiúva",73899,16238.9657776154,13,13,4,9,3,10,0,0,0,0,0,13,4,9,3,10,9,9.69516892804341,11.210454575045,0.438291861896846,2020-03-30,2020,3
"2662","MG",3,"Sudeste",31009,"Bocaiúva",73899,16238.9657776154,14,6,1,5,0,6,0,0,0,0,0,6,1,5,0,6,12,9.69516892804341,11.210454575045,0.422150607344986,2020-04-06,2020,4
"2663","MG",3,"Sudeste",31009,"Bocaiúva",73899,16238.9657776154,15,11,1,10,3,8,0,0,0,0,0,11,1,10,3,8,8,9.69516892804341,11.210454575045,0.390657890432622,2020-04-13,2020,4
"2664","MG",3,"Sudeste",31009,"Bocaiúva",73899,16238.9657776154,16,19,2,17,7,12,0,0,0,0,0,19,2,17,7,12,12,9.69516892804341,11.210454575045,0.389265234974994,2020-04-20,2020,4
"2665","MG",3,"Sudeste",31009,"Bocaiúva",73899,16238.9657776154,17,12,2,10,4,8,0,0,0,0,0,12,2,10,4,8,6,9.69516892804341,11.210454575045,0.376241689516953,2020-04-27,2020,4
"2666","MG",3,"Sudeste",31009,"Bocaiúva",73899,16238.9657776154,18,25,5,20,10,15,0,0,0,0,0,25,5,20,10,15,11,9.69516892804341,11.210454575045,0.368946635031301,2020-05-04,2020,5
"2667","MG",3,"Sudeste",31009,"Bocaiúva",73899,16238.9657776154,19,16,2,14,9,7,0,0,0,0,0,16,2,14,9,7,12,9.69516892804341,11.210454575045,0.380890130271455,2020-05-11,2020,5
"2668","MG",3,"Sudeste",31009,"Bocaiúva",73899,16238.9657776154,20,19,5,14,6,13,0,0,0,0,0,19,5,14,6,13,4,9.69516892804341,11.210454575045,0.378491416147397,2020-05-18,2020,5
"2669","MG",3,"Sudeste",31009,"Bocaiúva",73899,16238.9657776154,21,18,7,11,8,10,0,0,0,0,0,18,7,11,8,10,13,9.69516892804341,11.210454575045,0.369186649347029,2020-05-25,2020,5
"2670","MG",3,"Sudeste",31010,"Diamantina",84470,14016.3793440275,5,20,6,14,11,9,0,0,0,0,0,20,6,14,11,9,14,9.54798187788037,11.3441517207215,0.313435472495081,2020-02-03,2020,2
"2671","MG",3,"Sudeste",31010,"Diamantina",84470,14016.3793440275,6,27,5,22,8,19,0,0,0,0,0,27,5,22,8,19,9,9.54798187788037,11.3441517207215,0.291800762238157,2020-02-10,2020,2
"2672","MG",3,"Sudeste",31010,"Diamantina",84470,14016.3793440275,7,14,3,11,4,10,0,0,0,0,0,14,3,11,4,10,6,9.54798187788037,11.3441517207215,0.301434924331649,2020-02-17,2020,2
"2673","MG",3,"Sudeste",31010,"Diamantina",84470,14016.3793440275,8,27,5,22,7,20,0,0,0,0,0,27,5,22,7,20,14,9.54798187788037,11.3441517207215,0.379329234716013,2020-02-24,2020,2
"2674","MG",3,"Sudeste",31010,"Diamantina",84470,14016.3793440275,9,11,2,9,7,4,0,0,0,0,0,11,2,9,7,4,5,9.54798187788037,11.3441517207215,0.349432056210331,2020-03-02,2020,3
"2675","MG",3,"Sudeste",31010,"Diamantina",84470,14016.3793440275,10,19,3,16,5,14,0,0,0,0,0,19,3,16,5,14,14,9.54798187788037,11.3441517207215,0.332905792014282,2020-03-09,2020,3
"2676","MG",3,"Sudeste",31010,"Diamantina",84470,14016.3793440275,11,15,3,12,4,11,1,0,1,0,1,16,3,13,4,12,18,9.54798187788037,11.3441517207215,0.446467619873276,2020-03-16,2020,3
"2677","MG",3,"Sudeste",31010,"Diamantina",84470,14016.3793440275,12,25,2,23,12,13,0,0,0,0,0,25,2,23,12,13,20,9.54798187788037,11.3441517207215,0.535787491383393,2020-03-23,2020,3
"2678","MG",3,"Sudeste",31010,"Diamantina",84470,14016.3793440275,13,17,4,13,7,10,0,0,0,0,0,17,4,13,7,10,11,9.54798187788037,11.3441517207215,0.504371946690451,2020-03-30,2020,3
"2679","MG",3,"Sudeste",31010,"Diamantina",84470,14016.3793440275,14,25,6,19,7,18,0,0,0,0,0,25,6,19,7,18,7,9.54798187788037,11.3441517207215,0.503457718472174,2020-04-06,2020,4
"2680","MG",3,"Sudeste",31010,"Diamantina",84470,14016.3793440275,15,18,4,14,4,14,0,0,0,0,0,18,4,14,4,14,11,9.54798187788037,11.3441517207215,0.446451622910095,2020-04-13,2020,4
"2681","MG",3,"Sudeste",31010,"Diamantina",84470,14016.3793440275,16,14,3,11,5,9,0,0,0,0,0,14,3,11,5,9,6,9.54798187788037,11.3441517207215,0.4676755654435,2020-04-20,2020,4
"2682","MG",3,"Sudeste",31010,"Diamantina",84470,14016.3793440275,17,28,5,23,13,15,0,0,0,0,0,28,5,23,13,15,9,9.54798187788037,11.3441517207215,0.448407798262848,2020-04-27,2020,4
"2683","MG",3,"Sudeste",31010,"Diamantina",84470,14016.3793440275,18,16,1,15,7,9,0,0,0,0,0,16,1,15,7,9,12,9.54798187788037,11.3441517207215,0.43550296082343,2020-05-04,2020,5
"2684","MG",3,"Sudeste",31010,"Diamantina",84470,14016.3793440275,19,23,5,18,6,17,1,0,1,1,0,24,5,19,7,17,17,9.54798187788037,11.3441517207215,0.474214486793299,2020-05-11,2020,5
"2685","MG",3,"Sudeste",31010,"Diamantina",84470,14016.3793440275,20,12,3,9,1,11,0,0,0,0,0,12,3,9,1,11,8,9.54798187788037,11.3441517207215,0.465123119334434,2020-05-18,2020,5
"2686","MG",3,"Sudeste",31010,"Diamantina",84470,14016.3793440275,21,22,4,18,6,16,0,0,0,0,0,22,4,18,6,16,16,9.54798187788037,11.3441517207215,0.443236529519651,2020-05-25,2020,5
"2687","MG",3,"Sudeste",31011,"Capelinha",208265,12813.5604166327,5,32,12,20,12,20,0,0,0,0,0,32,12,20,12,20,16,9.45825929668098,12.2465665862467,0.28388140893788,2020-02-03,2020,2
"2688","MG",3,"Sudeste",31011,"Capelinha",208265,12813.5604166327,6,23,4,19,8,15,0,0,0,0,0,23,4,19,8,15,18,9.45825929668098,12.2465665862467,0.27705400738473,2020-02-10,2020,2
"2689","MG",3,"Sudeste",31011,"Capelinha",208265,12813.5604166327,7,48,14,34,16,32,0,0,0,0,0,48,14,34,16,32,13,9.45825929668098,12.2465665862467,0.284236505493523,2020-02-17,2020,2
"2690","MG",3,"Sudeste",31011,"Capelinha",208265,12813.5604166327,8,38,11,27,9,29,0,0,0,0,0,38,11,27,9,29,24,9.45825929668098,12.2465665862467,0.324762193859142,2020-02-24,2020,2
"2691","MG",3,"Sudeste",31011,"Capelinha",208265,12813.5604166327,9,28,6,22,9,19,0,0,0,0,0,28,6,22,9,19,23,9.45825929668098,12.2465665862467,0.324622998811639,2020-03-02,2020,3
"2692","MG",3,"Sudeste",31011,"Capelinha",208265,12813.5604166327,10,52,9,43,22,30,0,0,0,0,0,52,9,43,22,30,20,9.45825929668098,12.2465665862467,0.321293945584724,2020-03-09,2020,3
"2693","MG",3,"Sudeste",31011,"Capelinha",208265,12813.5604166327,11,36,12,24,12,24,1,0,1,0,1,37,12,25,12,25,19,9.45825929668098,12.2465665862467,0.374322688444142,2020-03-16,2020,3
"2694","MG",3,"Sudeste",31011,"Capelinha",208265,12813.5604166327,12,32,10,22,13,19,0,0,0,0,0,32,10,22,13,19,16,9.45825929668098,12.2465665862467,0.482502093545234,2020-03-23,2020,3
"2695","MG",3,"Sudeste",31011,"Capelinha",208265,12813.5604166327,13,32,11,21,13,19,0,0,0,0,0,32,11,21,13,19,22,9.45825929668098,12.2465665862467,0.413827466175639,2020-03-30,2020,3
"2696","MG",3,"Sudeste",31011,"Capelinha",208265,12813.5604166327,14,33,10,23,11,22,0,0,0,0,0,33,10,23,11,22,23,9.45825929668098,12.2465665862467,0.419009558317724,2020-04-06,2020,4
"2697","MG",3,"Sudeste",31011,"Capelinha",208265,12813.5604166327,15,35,7,28,11,24,0,0,0,0,0,35,7,28,11,24,7,9.45825929668098,12.2465665862467,0.378872729539759,2020-04-13,2020,4
"2698","MG",3,"Sudeste",31011,"Capelinha",208265,12813.5604166327,16,29,10,19,14,15,0,0,0,0,0,29,10,19,14,15,16,9.45825929668098,12.2465665862467,0.377662570714766,2020-04-20,2020,4
"2699","MG",3,"Sudeste",31011,"Capelinha",208265,12813.5604166327,17,24,6,18,7,17,0,0,0,0,0,24,6,18,7,17,23,9.45825929668098,12.2465665862467,0.392599424854917,2020-04-27,2020,4
"2700","MG",3,"Sudeste",31011,"Capelinha",208265,12813.5604166327,18,28,5,23,14,14,0,0,0,0,0,28,5,23,14,14,17,9.45825929668098,12.2465665862467,0.36774584121779,2020-05-04,2020,5
"2701","MG",3,"Sudeste",31011,"Capelinha",208265,12813.5604166327,19,22,9,13,7,15,0,0,0,0,0,22,9,13,7,15,21,9.45825929668098,12.2465665862467,0.380020758175838,2020-05-11,2020,5
"2702","MG",3,"Sudeste",31011,"Capelinha",208265,12813.5604166327,20,25,3,22,6,19,0,0,0,0,0,25,3,22,6,19,17,9.45825929668098,12.2465665862467,0.362914454859021,2020-05-18,2020,5
"2703","MG",3,"Sudeste",31011,"Capelinha",208265,12813.5604166327,21,44,9,35,12,32,0,0,0,0,0,44,9,35,12,32,15,9.45825929668098,12.2465665862467,0.348534912457927,2020-05-25,2020,5
"2704","MG",3,"Sudeste",31012,"Araçuaí",162235,8471.39294695966,5,31,12,19,12,19,3,1,2,1,2,34,13,21,13,21,21,9.04445023067238,11.9968011803696,0.288762977018204,2020-02-03,2020,2
"2705","MG",3,"Sudeste",31012,"Araçuaí",162235,8471.39294695966,6,27,9,18,11,16,0,0,0,0,0,27,9,18,11,16,21,9.04445023067238,11.9968011803696,0.268896366423803,2020-02-10,2020,2
"2706","MG",3,"Sudeste",31012,"Araçuaí",162235,8471.39294695966,7,25,9,16,10,15,3,2,1,2,1,28,11,17,12,16,18,9.04445023067238,11.9968011803696,0.285527866624501,2020-02-17,2020,2
"2707","MG",3,"Sudeste",31012,"Araçuaí",162235,8471.39294695966,8,29,11,18,14,15,1,0,1,1,0,30,11,19,15,15,27,9.04445023067238,11.9968011803696,0.334040229766826,2020-02-24,2020,2
"2708","MG",3,"Sudeste",31012,"Araçuaí",162235,8471.39294695966,9,24,8,16,5,19,0,0,0,0,0,24,8,16,5,19,20,9.04445023067238,11.9968011803696,0.305107802735498,2020-03-02,2020,3
"2709","MG",3,"Sudeste",31012,"Araçuaí",162235,8471.39294695966,10,21,10,11,9,12,0,0,0,0,0,21,10,11,9,12,30,9.04445023067238,11.9968011803696,0.325022624711654,2020-03-09,2020,3
"2710","MG",3,"Sudeste",31012,"Araçuaí",162235,8471.39294695966,11,26,9,17,8,18,0,0,0,0,0,26,9,17,8,18,12,9.04445023067238,11.9968011803696,0.379304173332993,2020-03-16,2020,3
"2711","MG",3,"Sudeste",31012,"Araçuaí",162235,8471.39294695966,12,23,5,18,9,14,0,0,0,0,0,23,5,18,9,14,21,9.04445023067238,11.9968011803696,0.475707107117103,2020-03-23,2020,3
"2712","MG",3,"Sudeste",31012,"Araçuaí",162235,8471.39294695966,13,26,9,17,11,15,1,1,0,0,1,27,10,17,11,16,18,9.04445023067238,11.9968011803696,0.447195171230175,2020-03-30,2020,3
"2713","MG",3,"Sudeste",31012,"Araçuaí",162235,8471.39294695966,14,25,5,20,15,10,0,0,0,0,0,25,5,20,15,10,20,9.04445023067238,11.9968011803696,0.425788083250532,2020-04-06,2020,4
"2714","MG",3,"Sudeste",31012,"Araçuaí",162235,8471.39294695966,15,31,9,22,15,16,1,1,0,0,1,32,10,22,15,17,19,9.04445023067238,11.9968011803696,0.396999161201073,2020-04-13,2020,4
"2715","MG",3,"Sudeste",31012,"Araçuaí",162235,8471.39294695966,16,25,8,17,12,13,0,0,0,0,0,25,8,17,12,13,14,9.04445023067238,11.9968011803696,0.392257966882547,2020-04-20,2020,4
"2716","MG",3,"Sudeste",31012,"Araçuaí",162235,8471.39294695966,17,21,5,16,8,13,0,0,0,0,0,21,5,16,8,13,18,9.04445023067238,11.9968011803696,0.395163717049992,2020-04-27,2020,4
"2717","MG",3,"Sudeste",31012,"Araçuaí",162235,8471.39294695966,18,29,8,21,7,22,0,0,0,0,0,29,8,21,7,22,14,9.04445023067238,11.9968011803696,0.385308146462614,2020-05-04,2020,5
"2718","MG",3,"Sudeste",31012,"Araçuaí",162235,8471.39294695966,19,32,10,22,13,19,0,0,0,0,0,32,10,22,13,19,19,9.04445023067238,11.9968011803696,0.394409956560572,2020-05-11,2020,5
"2719","MG",3,"Sudeste",31012,"Araçuaí",162235,8471.39294695966,20,27,9,18,11,16,0,0,0,0,0,27,9,18,11,16,21,9.04445023067238,11.9968011803696,0.389447520135403,2020-05-18,2020,5
"2720","MG",3,"Sudeste",31012,"Araçuaí",162235,8471.39294695966,21,26,9,17,10,16,2,0,2,2,0,28,9,19,12,16,26,9.04445023067238,11.9968011803696,0.394204006530838,2020-05-25,2020,5
"2721","MG",3,"Sudeste",31013,"Pedra Azul",82333,11275.2297120231,5,9,1,8,5,4,0,0,0,0,0,9,1,8,5,4,7,9.33036353773524,11.3185272783508,0.269965580196519,2020-02-03,2020,2
"2722","MG",3,"Sudeste",31013,"Pedra Azul",82333,11275.2297120231,6,6,3,3,3,3,0,0,0,0,0,6,3,3,3,3,8,9.33036353773524,11.3185272783508,0.259743710754936,2020-02-10,2020,2
"2723","MG",3,"Sudeste",31013,"Pedra Azul",82333,11275.2297120231,7,3,1,2,2,1,0,0,0,0,0,3,1,2,2,1,13,9.33036353773524,11.3185272783508,0.272108108360708,2020-02-17,2020,2
"2724","MG",3,"Sudeste",31013,"Pedra Azul",82333,11275.2297120231,8,5,4,1,3,2,0,0,0,0,0,5,4,1,3,2,11,9.33036353773524,11.3185272783508,0.310733169563732,2020-02-24,2020,2
"2725","MG",3,"Sudeste",31013,"Pedra Azul",82333,11275.2297120231,9,3,0,3,1,2,0,0,0,0,0,3,0,3,1,2,9,9.33036353773524,11.3185272783508,0.285906357827711,2020-03-02,2020,3
"2726","MG",3,"Sudeste",31013,"Pedra Azul",82333,11275.2297120231,10,10,1,9,4,6,0,0,0,0,0,10,1,9,4,6,9,9.33036353773524,11.3185272783508,0.324311541471459,2020-03-09,2020,3
"2727","MG",3,"Sudeste",31013,"Pedra Azul",82333,11275.2297120231,11,7,2,5,1,6,0,0,0,0,0,7,2,5,1,6,13,9.33036353773524,11.3185272783508,0.358656178232873,2020-03-16,2020,3
"2728","MG",3,"Sudeste",31013,"Pedra Azul",82333,11275.2297120231,12,2,0,2,0,2,0,0,0,0,0,2,0,2,0,2,11,9.33036353773524,11.3185272783508,0.464786318599242,2020-03-23,2020,3
"2729","MG",3,"Sudeste",31013,"Pedra Azul",82333,11275.2297120231,13,6,1,5,2,4,0,0,0,0,0,6,1,5,2,4,10,9.33036353773524,11.3185272783508,0.422825345687872,2020-03-30,2020,3
"2730","MG",3,"Sudeste",31013,"Pedra Azul",82333,11275.2297120231,14,6,2,4,3,3,0,0,0,0,0,6,2,4,3,3,15,9.33036353773524,11.3185272783508,0.414015834223693,2020-04-06,2020,4
"2731","MG",3,"Sudeste",31013,"Pedra Azul",82333,11275.2297120231,15,9,5,4,2,7,0,0,0,0,0,9,5,4,2,7,11,9.33036353773524,11.3185272783508,0.373946158015473,2020-04-13,2020,4
"2732","MG",3,"Sudeste",31013,"Pedra Azul",82333,11275.2297120231,16,8,3,5,3,5,0,0,0,0,0,8,3,5,3,5,9,9.33036353773524,11.3185272783508,0.380495028538514,2020-04-20,2020,4
"2733","MG",3,"Sudeste",31013,"Pedra Azul",82333,11275.2297120231,17,9,3,6,3,6,0,0,0,0,0,9,3,6,3,6,9,9.33036353773524,11.3185272783508,0.36259112797644,2020-04-27,2020,4
"2734","MG",3,"Sudeste",31013,"Pedra Azul",82333,11275.2297120231,18,6,1,5,1,5,0,0,0,0,0,6,1,5,1,5,10,9.33036353773524,11.3185272783508,0.380701113564635,2020-05-04,2020,5
"2735","MG",3,"Sudeste",31013,"Pedra Azul",82333,11275.2297120231,19,6,1,5,1,5,0,0,0,0,0,6,1,5,1,5,16,9.33036353773524,11.3185272783508,0.390788103729982,2020-05-11,2020,5
"2736","MG",3,"Sudeste",31013,"Pedra Azul",82333,11275.2297120231,20,8,5,3,1,7,0,0,0,0,0,8,5,3,1,7,10,9.33036353773524,11.3185272783508,0.363106812203922,2020-05-18,2020,5
"2737","MG",3,"Sudeste",31013,"Pedra Azul",82333,11275.2297120231,21,18,3,15,13,5,0,0,0,0,0,18,3,15,13,5,6,9.33036353773524,11.3185272783508,0.35455120623303,2020-05-25,2020,5
"2738","MG",3,"Sudeste",31014,"Almenara",187856,9500.65506930841,5,9,3,6,4,5,0,0,0,0,0,9,3,6,4,5,26,9.15911602987541,12.14343099087,0.2749181776392,2020-02-03,2020,2
"2739","MG",3,"Sudeste",31014,"Almenara",187856,9500.65506930841,6,5,1,4,2,3,1,0,1,1,0,6,1,5,3,3,35,9.15911602987541,12.14343099087,0.263144825112358,2020-02-10,2020,2
"2740","MG",3,"Sudeste",31014,"Almenara",187856,9500.65506930841,7,6,3,3,4,2,0,0,0,0,0,6,3,3,4,2,25,9.15911602987541,12.14343099087,0.286518990286405,2020-02-17,2020,2
"2741","MG",3,"Sudeste",31014,"Almenara",187856,9500.65506930841,8,5,0,5,1,4,0,0,0,0,0,5,0,5,1,4,26,9.15911602987541,12.14343099087,0.333010077295766,2020-02-24,2020,2
"2742","MG",3,"Sudeste",31014,"Almenara",187856,9500.65506930841,9,9,3,6,3,6,0,0,0,0,0,9,3,6,3,6,32,9.15911602987541,12.14343099087,0.303550281166949,2020-03-02,2020,3
"2743","MG",3,"Sudeste",31014,"Almenara",187856,9500.65506930841,10,8,0,8,4,4,0,0,0,0,0,8,0,8,4,4,20,9.15911602987541,12.14343099087,0.312631661170271,2020-03-09,2020,3
"2744","MG",3,"Sudeste",31014,"Almenara",187856,9500.65506930841,11,9,2,7,4,5,0,0,0,0,0,9,2,7,4,5,26,9.15911602987541,12.14343099087,0.365600791005178,2020-03-16,2020,3
"2745","MG",3,"Sudeste",31014,"Almenara",187856,9500.65506930841,12,3,3,0,0,3,1,0,1,0,1,4,3,1,0,4,23,9.15911602987541,12.14343099087,0.442889963619366,2020-03-23,2020,3
"2746","MG",3,"Sudeste",31014,"Almenara",187856,9500.65506930841,13,4,0,4,0,4,0,0,0,0,0,4,0,4,0,4,25,9.15911602987541,12.14343099087,0.394568251828992,2020-03-30,2020,3
"2747","MG",3,"Sudeste",31014,"Almenara",187856,9500.65506930841,14,2,2,0,2,0,0,0,0,0,0,2,2,0,2,0,15,9.15911602987541,12.14343099087,0.394366162301092,2020-04-06,2020,4
"2748","MG",3,"Sudeste",31014,"Almenara",187856,9500.65506930841,15,0,0,0,0,0,0,0,0,0,0,0,0,0,0,0,17,9.15911602987541,12.14343099087,0.368653037321331,2020-04-13,2020,4
"2749","MG",3,"Sudeste",31014,"Almenara",187856,9500.65506930841,16,2,0,2,0,2,0,0,0,0,0,2,0,2,0,2,13,9.15911602987541,12.14343099087,0.37488390650515,2020-04-20,2020,4
"2750","MG",3,"Sudeste",31014,"Almenara",187856,9500.65506930841,17,0,0,0,0,0,0,0,0,0,0,0,0,0,0,0,29,9.15911602987541,12.14343099087,0.356767313064054,2020-04-27,2020,4
"2751","MG",3,"Sudeste",31014,"Almenara",187856,9500.65506930841,18,4,2,2,1,3,1,1,0,0,1,5,3,2,1,4,20,9.15911602987541,12.14343099087,0.359070512676521,2020-05-04,2020,5
"2752","MG",3,"Sudeste",31014,"Almenara",187856,9500.65506930841,19,2,0,2,1,1,1,1,0,0,1,3,1,2,1,2,21,9.15911602987541,12.14343099087,0.376242704192274,2020-05-11,2020,5
"2753","MG",3,"Sudeste",31014,"Almenara",187856,9500.65506930841,20,3,0,3,0,3,0,0,0,0,0,3,0,3,0,3,17,9.15911602987541,12.14343099087,0.373956474200647,2020-05-18,2020,5
"2754","MG",3,"Sudeste",31014,"Almenara",187856,9500.65506930841,21,2,0,2,0,2,0,0,0,0,0,2,0,2,0,2,18,9.15911602987541,12.14343099087,0.365236824058066,2020-05-25,2020,5
"2755","MG",3,"Sudeste",31015,"Teófilo Otoni",274815,13404.6157955352,5,49,16,33,17,32,0,0,0,0,0,49,16,33,17,32,40,9.50335438897884,12.5238534229935,0.283798687727735,2020-02-03,2020,2
"2756","MG",3,"Sudeste",31015,"Teófilo Otoni",274815,13404.6157955352,6,67,20,47,23,44,1,0,1,0,1,68,20,48,23,45,44,9.50335438897884,12.5238534229935,0.2690108107445,2020-02-10,2020,2
"2757","MG",3,"Sudeste",31015,"Teófilo Otoni",274815,13404.6157955352,7,50,14,36,21,29,0,0,0,0,0,50,14,36,21,29,32,9.50335438897884,12.5238534229935,0.291731591063761,2020-02-17,2020,2
"2758","MG",3,"Sudeste",31015,"Teófilo Otoni",274815,13404.6157955352,8,64,15,49,37,27,0,0,0,0,0,64,15,49,37,27,30,9.50335438897884,12.5238534229935,0.341327626481491,2020-02-24,2020,2
"2759","MG",3,"Sudeste",31015,"Teófilo Otoni",274815,13404.6157955352,9,68,13,55,20,48,1,0,1,0,1,69,13,56,20,49,39,9.50335438897884,12.5238534229935,0.313449406877754,2020-03-02,2020,3
"2760","MG",3,"Sudeste",31015,"Teófilo Otoni",274815,13404.6157955352,10,60,20,40,25,35,0,0,0,0,0,60,20,40,25,35,34,9.50335438897884,12.5238534229935,0.318363084218171,2020-03-09,2020,3
"2761","MG",3,"Sudeste",31015,"Teófilo Otoni",274815,13404.6157955352,11,60,20,40,25,35,1,0,1,0,1,61,20,41,25,36,42,9.50335438897884,12.5238534229935,0.394849588783365,2020-03-16,2020,3
"2762","MG",3,"Sudeste",31015,"Teófilo Otoni",274815,13404.6157955352,12,47,14,33,16,31,1,0,1,1,0,48,14,34,17,31,35,9.50335438897884,12.5238534229935,0.508813970620828,2020-03-23,2020,3
"2763","MG",3,"Sudeste",31015,"Teófilo Otoni",274815,13404.6157955352,13,43,5,38,18,25,0,0,0,0,0,43,5,38,18,25,32,9.50335438897884,12.5238534229935,0.452062354754505,2020-03-30,2020,3
"2764","MG",3,"Sudeste",31015,"Teófilo Otoni",274815,13404.6157955352,14,64,18,46,21,43,2,1,1,2,0,66,19,47,23,43,27,9.50335438897884,12.5238534229935,0.453441982045907,2020-04-06,2020,4
"2765","MG",3,"Sudeste",31015,"Teófilo Otoni",274815,13404.6157955352,15,51,14,37,24,27,1,1,0,1,0,52,15,37,25,27,23,9.50335438897884,12.5238534229935,0.406165744820424,2020-04-13,2020,4
"2766","MG",3,"Sudeste",31015,"Teófilo Otoni",274815,13404.6157955352,16,51,16,35,20,31,0,0,0,0,0,51,16,35,20,31,48,9.50335438897884,12.5238534229935,0.41589334178898,2020-04-20,2020,4
"2767","MG",3,"Sudeste",31015,"Teófilo Otoni",274815,13404.6157955352,17,46,17,29,25,21,1,0,1,0,1,47,17,30,25,22,47,9.50335438897884,12.5238534229935,0.410724111538026,2020-04-27,2020,4
"2768","MG",3,"Sudeste",31015,"Teófilo Otoni",274815,13404.6157955352,18,82,26,56,27,55,0,0,0,0,0,82,26,56,27,55,38,9.50335438897884,12.5238534229935,0.388035203785011,2020-05-04,2020,5
"2769","MG",3,"Sudeste",31015,"Teófilo Otoni",274815,13404.6157955352,19,65,18,47,22,43,0,0,0,0,0,65,18,47,22,43,51,9.50335438897884,12.5238534229935,0.405179138283897,2020-05-11,2020,5
"2770","MG",3,"Sudeste",31015,"Teófilo Otoni",274815,13404.6157955352,20,56,15,41,20,36,1,0,1,0,1,57,15,42,20,37,53,9.50335438897884,12.5238534229935,0.398218292019155,2020-05-18,2020,5
"2771","MG",3,"Sudeste",31015,"Teófilo Otoni",274815,13404.6157955352,21,69,18,51,32,37,1,0,1,1,0,70,18,52,33,37,42,9.50335438897884,12.5238534229935,0.414563706966355,2020-05-25,2020,5
"2772","MG",3,"Sudeste",31016,"Nanuque",119320,13788.8414259135,5,25,13,12,10,15,0,0,0,0,0,25,13,12,10,15,18,9.53161495173308,11.6895642386287,0.287881957585999,2020-02-03,2020,2
"2773","MG",3,"Sudeste",31016,"Nanuque",119320,13788.8414259135,6,25,6,19,9,16,0,0,0,0,0,25,6,19,9,16,16,9.53161495173308,11.6895642386287,0.280353033320231,2020-02-10,2020,2
"2774","MG",3,"Sudeste",31016,"Nanuque",119320,13788.8414259135,7,15,6,9,9,6,0,0,0,0,0,15,6,9,9,6,16,9.53161495173308,11.6895642386287,0.290617095189332,2020-02-17,2020,2
"2775","MG",3,"Sudeste",31016,"Nanuque",119320,13788.8414259135,8,22,10,12,5,17,1,1,0,1,0,23,11,12,6,17,16,9.53161495173308,11.6895642386287,0.341037083491877,2020-02-24,2020,2
"2776","MG",3,"Sudeste",31016,"Nanuque",119320,13788.8414259135,9,22,10,12,10,12,1,0,1,1,0,23,10,13,11,12,25,9.53161495173308,11.6895642386287,0.335984757245056,2020-03-02,2020,3
"2777","MG",3,"Sudeste",31016,"Nanuque",119320,13788.8414259135,10,27,8,19,13,14,0,0,0,0,0,27,8,19,13,14,20,9.53161495173308,11.6895642386287,0.331125773779306,2020-03-09,2020,3
"2778","MG",3,"Sudeste",31016,"Nanuque",119320,13788.8414259135,11,16,3,13,7,9,0,0,0,0,0,16,3,13,7,9,17,9.53161495173308,11.6895642386287,0.394784110891239,2020-03-16,2020,3
"2779","MG",3,"Sudeste",31016,"Nanuque",119320,13788.8414259135,12,22,10,12,7,15,1,0,1,0,1,23,10,13,7,16,23,9.53161495173308,11.6895642386287,0.49479052731195,2020-03-23,2020,3
"2780","MG",3,"Sudeste",31016,"Nanuque",119320,13788.8414259135,13,25,10,15,12,13,1,1,0,1,0,26,11,15,13,13,19,9.53161495173308,11.6895642386287,0.439611451019861,2020-03-30,2020,3
"2781","MG",3,"Sudeste",31016,"Nanuque",119320,13788.8414259135,14,27,8,19,13,14,0,0,0,0,0,27,8,19,13,14,19,9.53161495173308,11.6895642386287,0.441413097316859,2020-04-06,2020,4
"2782","MG",3,"Sudeste",31016,"Nanuque",119320,13788.8414259135,15,24,6,18,8,16,0,0,0,0,0,24,6,18,8,16,16,9.53161495173308,11.6895642386287,0.388576852534555,2020-04-13,2020,4
"2783","MG",3,"Sudeste",31016,"Nanuque",119320,13788.8414259135,16,18,9,9,5,13,0,0,0,0,0,18,9,9,5,13,15,9.53161495173308,11.6895642386287,0.404842732406335,2020-04-20,2020,4
"2784","MG",3,"Sudeste",31016,"Nanuque",119320,13788.8414259135,17,20,6,14,10,10,0,0,0,0,0,20,6,14,10,10,20,9.53161495173308,11.6895642386287,0.38814468844662,2020-04-27,2020,4
"2785","MG",3,"Sudeste",31016,"Nanuque",119320,13788.8414259135,18,24,11,13,11,13,0,0,0,0,0,24,11,13,11,13,22,9.53161495173308,11.6895642386287,0.373298171246428,2020-05-04,2020,5
"2786","MG",3,"Sudeste",31016,"Nanuque",119320,13788.8414259135,19,31,8,23,13,18,0,0,0,0,0,31,8,23,13,18,14,9.53161495173308,11.6895642386287,0.400800656528188,2020-05-11,2020,5
"2787","MG",3,"Sudeste",31016,"Nanuque",119320,13788.8414259135,20,26,7,19,15,11,0,0,0,0,0,26,7,19,15,11,20,9.53161495173308,11.6895642386287,0.380438411717321,2020-05-18,2020,5
"2788","MG",3,"Sudeste",31016,"Nanuque",119320,13788.8414259135,21,21,5,16,10,11,0,0,0,0,0,21,5,16,10,11,18,9.53161495173308,11.6895642386287,0.375678778268217,2020-05-25,2020,5
"2789","MG",3,"Sudeste",31017,"Ituiutaba",153869,31579.0094150869,5,19,3,16,9,10,0,0,0,0,0,19,3,16,9,10,17,10.360247919841,11.9438568700376,0.278186043450787,2020-02-03,2020,2
"2790","MG",3,"Sudeste",31017,"Ituiutaba",153869,31579.0094150869,6,20,5,15,7,13,0,0,0,0,0,20,5,15,7,13,18,10.360247919841,11.9438568700376,0.271853010908668,2020-02-10,2020,2
"2791","MG",3,"Sudeste",31017,"Ituiutaba",153869,31579.0094150869,7,22,4,18,10,12,0,0,0,0,0,22,4,18,10,12,25,10.360247919841,11.9438568700376,0.287874041800248,2020-02-17,2020,2
"2792","MG",3,"Sudeste",31017,"Ituiutaba",153869,31579.0094150869,8,28,6,22,12,16,0,0,0,0,0,28,6,22,12,16,19,10.360247919841,11.9438568700376,0.342776578553643,2020-02-24,2020,2
"2793","MG",3,"Sudeste",31017,"Ituiutaba",153869,31579.0094150869,9,23,6,17,9,14,0,0,0,0,0,23,6,17,9,14,26,10.360247919841,11.9438568700376,0.311462256564105,2020-03-02,2020,3
"2794","MG",3,"Sudeste",31017,"Ituiutaba",153869,31579.0094150869,10,26,4,22,13,13,0,0,0,0,0,26,4,22,13,13,17,10.360247919841,11.9438568700376,0.312924396284871,2020-03-09,2020,3
"2795","MG",3,"Sudeste",31017,"Ituiutaba",153869,31579.0094150869,11,18,6,12,8,10,0,0,0,0,0,18,6,12,8,10,30,10.360247919841,11.9438568700376,0.395037751194766,2020-03-16,2020,3
"2796","MG",3,"Sudeste",31017,"Ituiutaba",153869,31579.0094150869,12,28,8,20,12,16,0,0,0,0,0,28,8,20,12,16,30,10.360247919841,11.9438568700376,0.471045552469736,2020-03-23,2020,3
"2797","MG",3,"Sudeste",31017,"Ituiutaba",153869,31579.0094150869,13,23,2,21,10,13,0,0,0,0,0,23,2,21,10,13,20,10.360247919841,11.9438568700376,0.433744627677707,2020-03-30,2020,3
"2798","MG",3,"Sudeste",31017,"Ituiutaba",153869,31579.0094150869,14,33,9,24,13,20,1,0,1,1,0,34,9,25,14,20,15,10.360247919841,11.9438568700376,0.420266029606584,2020-04-06,2020,4
"2799","MG",3,"Sudeste",31017,"Ituiutaba",153869,31579.0094150869,15,30,6,24,10,20,0,0,0,0,0,30,6,24,10,20,11,10.360247919841,11.9438568700376,0.407856265660767,2020-04-13,2020,4
"2800","MG",3,"Sudeste",31017,"Ituiutaba",153869,31579.0094150869,16,32,9,23,10,22,0,0,0,0,0,32,9,23,10,22,16,10.360247919841,11.9438568700376,0.403451589189337,2020-04-20,2020,4
"2801","MG",3,"Sudeste",31017,"Ituiutaba",153869,31579.0094150869,17,30,4,26,14,16,0,0,0,0,0,30,4,26,14,16,25,10.360247919841,11.9438568700376,0.386970405170039,2020-04-27,2020,4
"2802","MG",3,"Sudeste",31017,"Ituiutaba",153869,31579.0094150869,18,28,4,24,12,16,0,0,0,0,0,28,4,24,12,16,30,10.360247919841,11.9438568700376,0.363624847956304,2020-05-04,2020,5
"2803","MG",3,"Sudeste",31017,"Ituiutaba",153869,31579.0094150869,19,43,5,38,18,25,0,0,0,0,0,43,5,38,18,25,15,10.360247919841,11.9438568700376,0.372719933430946,2020-05-11,2020,5
"2804","MG",3,"Sudeste",31017,"Ituiutaba",153869,31579.0094150869,20,29,4,25,12,17,0,0,0,0,0,29,4,25,12,17,16,10.360247919841,11.9438568700376,0.387259895358755,2020-05-18,2020,5
"2805","MG",3,"Sudeste",31017,"Ituiutaba",153869,31579.0094150869,21,21,3,18,4,17,2,0,2,0,2,23,3,20,4,19,29,10.360247919841,11.9438568700376,0.373621486287708,2020-05-25,2020,5
"2806","MG",3,"Sudeste",31018,"Uberlândia",931094,51116.6857810919,5,201,26,175,72,129,2,0,2,1,1,203,26,177,73,130,118,10.8418662548115,13.7441155178649,0.279720643060395,2020-02-03,2020,2
"2807","MG",3,"Sudeste",31018,"Uberlândia",931094,51116.6857810919,6,202,25,177,75,127,0,0,0,0,0,202,25,177,75,127,110,10.8418662548115,13.7441155178649,0.27497156778873,2020-02-10,2020,2
"2808","MG",3,"Sudeste",31018,"Uberlândia",931094,51116.6857810919,7,207,29,178,81,126,1,0,1,1,0,208,29,179,82,126,101,10.8418662548115,13.7441155178649,0.285113611625921,2020-02-17,2020,2
"2809","MG",3,"Sudeste",31018,"Uberlândia",931094,51116.6857810919,8,176,26,150,50,126,4,1,3,3,1,180,27,153,53,127,106,10.8418662548115,13.7441155178649,0.335668315023835,2020-02-24,2020,2
"2810","MG",3,"Sudeste",31018,"Uberlândia",931094,51116.6857810919,9,205,29,176,75,130,1,0,1,0,1,206,29,177,75,131,118,10.8418662548115,13.7441155178649,0.305338425129145,2020-03-02,2020,3
"2811","MG",3,"Sudeste",31018,"Uberlândia",931094,51116.6857810919,10,188,27,161,61,127,0,0,0,0,0,188,27,161,61,127,115,10.8418662548115,13.7441155178649,0.312676733503307,2020-03-09,2020,3
"2812","MG",3,"Sudeste",31018,"Uberlândia",931094,51116.6857810919,11,199,25,174,61,138,0,0,0,0,0,199,25,174,61,138,109,10.8418662548115,13.7441155178649,0.396431705856911,2020-03-16,2020,3
"2813","MG",3,"Sudeste",31018,"Uberlândia",931094,51116.6857810919,12,190,25,165,66,124,3,0,3,1,2,193,25,168,67,126,99,10.8418662548115,13.7441155178649,0.509723224300359,2020-03-23,2020,3
"2814","MG",3,"Sudeste",31018,"Uberlândia",931094,51116.6857810919,13,224,38,186,77,147,0,0,0,0,0,224,38,186,77,147,96,10.8418662548115,13.7441155178649,0.461755118670272,2020-03-30,2020,3
"2815","MG",3,"Sudeste",31018,"Uberlândia",931094,51116.6857810919,14,184,21,163,72,112,1,0,1,1,0,185,21,164,73,112,111,10.8418662548115,13.7441155178649,0.44769820067294,2020-04-06,2020,4
"2816","MG",3,"Sudeste",31018,"Uberlândia",931094,51116.6857810919,15,195,25,170,64,131,2,0,2,2,0,197,25,172,66,131,103,10.8418662548115,13.7441155178649,0.429761230051087,2020-04-13,2020,4
"2817","MG",3,"Sudeste",31018,"Uberlândia",931094,51116.6857810919,16,183,31,152,56,127,2,0,2,0,2,185,31,154,56,129,95,10.8418662548115,13.7441155178649,0.427408249412239,2020-04-20,2020,4
"2818","MG",3,"Sudeste",31018,"Uberlândia",931094,51116.6857810919,17,219,37,182,67,152,1,0,1,1,0,220,37,183,68,152,91,10.8418662548115,13.7441155178649,0.409339451481552,2020-04-27,2020,4
"2819","MG",3,"Sudeste",31018,"Uberlândia",931094,51116.6857810919,18,214,30,184,74,140,1,0,1,0,1,215,30,185,74,141,82,10.8418662548115,13.7441155178649,0.380347182152721,2020-05-04,2020,5
"2820","MG",3,"Sudeste",31018,"Uberlândia",931094,51116.6857810919,19,236,30,206,69,167,1,1,0,0,1,237,31,206,69,168,109,10.8418662548115,13.7441155178649,0.386813633668432,2020-05-11,2020,5
"2821","MG",3,"Sudeste",31018,"Uberlândia",931094,51116.6857810919,20,240,30,210,85,155,1,0,1,1,0,241,30,211,86,155,105,10.8418662548115,13.7441155178649,0.395252526896784,2020-05-18,2020,5
"2822","MG",3,"Sudeste",31018,"Uberlândia",931094,51116.6857810919,21,237,27,210,71,166,1,1,0,1,0,238,28,210,72,166,125,10.8418662548115,13.7441155178649,0.380264125777433,2020-05-25,2020,5
"2823","MG",3,"Sudeste",31019,"Patrocínio",211523,32151.866117018,5,53,18,35,18,35,0,0,0,0,0,53,18,35,18,35,25,10.3782257720565,12.2620890186009,0.297161727238193,2020-02-03,2020,2
"2824","MG",3,"Sudeste",31019,"Patrocínio",211523,32151.866117018,6,34,14,20,11,23,0,0,0,0,0,34,14,20,11,23,30,10.3782257720565,12.2620890186009,0.284757172989822,2020-02-10,2020,2
"2825","MG",3,"Sudeste",31019,"Patrocínio",211523,32151.866117018,7,54,13,41,22,32,0,0,0,0,0,54,13,41,22,32,26,10.3782257720565,12.2620890186009,0.293475138542413,2020-02-17,2020,2
"2826","MG",3,"Sudeste",31019,"Patrocínio",211523,32151.866117018,8,45,12,33,12,33,0,0,0,0,0,45,12,33,12,33,13,10.3782257720565,12.2620890186009,0.339877938009262,2020-02-24,2020,2
"2827","MG",3,"Sudeste",31019,"Patrocínio",211523,32151.866117018,9,43,10,33,19,24,0,0,0,0,0,43,10,33,19,24,37,10.3782257720565,12.2620890186009,0.309894706942467,2020-03-02,2020,3
"2828","MG",3,"Sudeste",31019,"Patrocínio",211523,32151.866117018,10,31,10,21,11,20,1,0,1,0,1,32,10,22,11,21,25,10.3782257720565,12.2620890186009,0.321460777511976,2020-03-09,2020,3
"2829","MG",3,"Sudeste",31019,"Patrocínio",211523,32151.866117018,11,43,13,30,17,26,0,0,0,0,0,43,13,30,17,26,17,10.3782257720565,12.2620890186009,0.396459144504807,2020-03-16,2020,3
"2830","MG",3,"Sudeste",31019,"Patrocínio",211523,32151.866117018,12,41,9,32,14,27,0,0,0,0,0,41,9,32,14,27,27,10.3782257720565,12.2620890186009,0.486813874816815,2020-03-23,2020,3
"2831","MG",3,"Sudeste",31019,"Patrocínio",211523,32151.866117018,13,42,6,36,16,26,0,0,0,0,0,42,6,36,16,26,26,10.3782257720565,12.2620890186009,0.433665823259401,2020-03-30,2020,3
"2832","MG",3,"Sudeste",31019,"Patrocínio",211523,32151.866117018,14,35,10,25,10,25,1,0,1,0,1,36,10,26,10,26,18,10.3782257720565,12.2620890186009,0.430784224809658,2020-04-06,2020,4
"2833","MG",3,"Sudeste",31019,"Patrocínio",211523,32151.866117018,15,52,13,39,19,33,0,0,0,0,0,52,13,39,19,33,21,10.3782257720565,12.2620890186009,0.401159013328355,2020-04-13,2020,4
"2834","MG",3,"Sudeste",31019,"Patrocínio",211523,32151.866117018,16,51,5,46,26,25,0,0,0,0,0,51,5,46,26,25,27,10.3782257720565,12.2620890186009,0.389615086707984,2020-04-20,2020,4
"2835","MG",3,"Sudeste",31019,"Patrocínio",211523,32151.866117018,17,41,10,31,17,24,0,0,0,0,0,41,10,31,17,24,23,10.3782257720565,12.2620890186009,0.38640214317424,2020-04-27,2020,4
"2836","MG",3,"Sudeste",31019,"Patrocínio",211523,32151.866117018,18,50,14,36,16,34,0,0,0,0,0,50,14,36,16,34,22,10.3782257720565,12.2620890186009,0.37078301589729,2020-05-04,2020,5
"2837","MG",3,"Sudeste",31019,"Patrocínio",211523,32151.866117018,19,50,10,40,18,32,1,0,1,1,0,51,10,41,19,32,22,10.3782257720565,12.2620890186009,0.369770714290308,2020-05-11,2020,5
"2838","MG",3,"Sudeste",31019,"Patrocínio",211523,32151.866117018,20,59,12,47,23,36,0,0,0,0,0,59,12,47,23,36,21,10.3782257720565,12.2620890186009,0.365941580632415,2020-05-18,2020,5
"2839","MG",3,"Sudeste",31019,"Patrocínio",211523,32151.866117018,21,52,9,43,24,28,1,0,1,0,1,53,9,44,24,29,26,10.3782257720565,12.2620890186009,0.361797701642963,2020-05-25,2020,5
"2840","MG",3,"Sudeste",31020,"Patos de Minas",274609,28366.3427680447,5,60,16,44,22,38,1,0,1,0,1,61,16,45,22,39,37,10.2529586075454,12.5231035467243,0.301400073158569,2020-02-03,2020,2
"2841","MG",3,"Sudeste",31020,"Patos de Minas",274609,28366.3427680447,6,64,17,47,21,43,0,0,0,0,0,64,17,47,21,43,44,10.2529586075454,12.5231035467243,0.300303846572662,2020-02-10,2020,2
"2842","MG",3,"Sudeste",31020,"Patos de Minas",274609,28366.3427680447,7,59,16,43,15,44,1,0,1,0,1,60,16,44,15,45,42,10.2529586075454,12.5231035467243,0.30675413474532,2020-02-17,2020,2
"2843","MG",3,"Sudeste",31020,"Patos de Minas",274609,28366.3427680447,8,73,13,60,21,52,1,0,1,0,1,74,13,61,21,53,37,10.2529586075454,12.5231035467243,0.347189054536118,2020-02-24,2020,2
"2844","MG",3,"Sudeste",31020,"Patos de Minas",274609,28366.3427680447,9,72,16,56,26,46,0,0,0,0,0,72,16,56,26,46,42,10.2529586075454,12.5231035467243,0.321116452088814,2020-03-02,2020,3
"2845","MG",3,"Sudeste",31020,"Patos de Minas",274609,28366.3427680447,10,56,16,40,16,40,1,0,1,1,0,57,16,41,17,40,33,10.2529586075454,12.5231035467243,0.324150311846549,2020-03-09,2020,3
"2846","MG",3,"Sudeste",31020,"Patos de Minas",274609,28366.3427680447,11,55,10,45,16,39,0,0,0,0,0,55,10,45,16,39,41,10.2529586075454,12.5231035467243,0.408322865921245,2020-03-16,2020,3
"2847","MG",3,"Sudeste",31020,"Patos de Minas",274609,28366.3427680447,12,48,10,38,10,38,2,2,0,1,1,50,12,38,11,39,30,10.2529586075454,12.5231035467243,0.499558605981991,2020-03-23,2020,3
"2848","MG",3,"Sudeste",31020,"Patos de Minas",274609,28366.3427680447,13,56,10,46,14,42,3,0,3,3,0,59,10,49,17,42,25,10.2529586075454,12.5231035467243,0.452237378985723,2020-03-30,2020,3
"2849","MG",3,"Sudeste",31020,"Patos de Minas",274609,28366.3427680447,14,69,17,52,21,48,0,0,0,0,0,69,17,52,21,48,36,10.2529586075454,12.5231035467243,0.442190640134656,2020-04-06,2020,4
"2850","MG",3,"Sudeste",31020,"Patos de Minas",274609,28366.3427680447,15,54,11,43,15,39,1,0,1,0,1,55,11,44,15,40,20,10.2529586075454,12.5231035467243,0.41019373456338,2020-04-13,2020,4
"2851","MG",3,"Sudeste",31020,"Patos de Minas",274609,28366.3427680447,16,36,8,28,16,20,0,0,0,0,0,36,8,28,16,20,40,10.2529586075454,12.5231035467243,0.421530457387421,2020-04-20,2020,4
"2852","MG",3,"Sudeste",31020,"Patos de Minas",274609,28366.3427680447,17,69,17,52,19,50,0,0,0,0,0,69,17,52,19,50,36,10.2529586075454,12.5231035467243,0.413295014008193,2020-04-27,2020,4
"2853","MG",3,"Sudeste",31020,"Patos de Minas",274609,28366.3427680447,18,59,15,44,22,37,2,0,2,1,1,61,15,46,23,38,56,10.2529586075454,12.5231035467243,0.387223288447583,2020-05-04,2020,5
"2854","MG",3,"Sudeste",31020,"Patos de Minas",274609,28366.3427680447,19,68,24,44,25,43,1,0,1,0,1,69,24,45,25,44,30,10.2529586075454,12.5231035467243,0.397934053162353,2020-05-11,2020,5
"2855","MG",3,"Sudeste",31020,"Patos de Minas",274609,28366.3427680447,20,60,14,46,28,32,3,1,2,0,3,63,15,48,28,35,41,10.2529586075454,12.5231035467243,0.397870459225541,2020-05-18,2020,5
"2856","MG",3,"Sudeste",31020,"Patos de Minas",274609,28366.3427680447,21,78,14,64,23,55,0,0,0,0,0,78,14,64,23,55,36,10.2529586075454,12.5231035467243,0.397401930397841,2020-05-25,2020,5
"2857","MG",3,"Sudeste",31021,"Frutal",203298,38762.0155049238,5,36,11,25,13,23,0,0,0,0,0,36,11,25,13,23,32,10.5651960642638,12.2224281618897,0.295745658211781,2020-02-03,2020,2
"2858","MG",3,"Sudeste",31021,"Frutal",203298,38762.0155049238,6,45,7,38,18,27,0,0,0,0,0,45,7,38,18,27,19,10.5651960642638,12.2224281618897,0.290745396976532,2020-02-10,2020,2
"2859","MG",3,"Sudeste",31021,"Frutal",203298,38762.0155049238,7,33,12,21,15,18,0,0,0,0,0,33,12,21,15,18,27,10.5651960642638,12.2224281618897,0.294386070070137,2020-02-17,2020,2
"2860","MG",3,"Sudeste",31021,"Frutal",203298,38762.0155049238,8,35,12,23,13,22,1,0,1,0,1,36,12,24,13,23,28,10.5651960642638,12.2224281618897,0.33549873176405,2020-02-24,2020,2
"2861","MG",3,"Sudeste",31021,"Frutal",203298,38762.0155049238,9,25,6,19,14,11,0,0,0,0,0,25,6,19,14,11,22,10.5651960642638,12.2224281618897,0.315187362815348,2020-03-02,2020,3
"2862","MG",3,"Sudeste",31021,"Frutal",203298,38762.0155049238,10,37,7,30,12,25,0,0,0,0,0,37,7,30,12,25,23,10.5651960642638,12.2224281618897,0.33009223639156,2020-03-09,2020,3
"2863","MG",3,"Sudeste",31021,"Frutal",203298,38762.0155049238,11,43,8,35,15,28,0,0,0,0,0,43,8,35,15,28,36,10.5651960642638,12.2224281618897,0.385152365659077,2020-03-16,2020,3
"2864","MG",3,"Sudeste",31021,"Frutal",203298,38762.0155049238,12,31,7,24,15,16,0,0,0,0,0,31,7,24,15,16,20,10.5651960642638,12.2224281618897,0.46998030887586,2020-03-23,2020,3
"2865","MG",3,"Sudeste",31021,"Frutal",203298,38762.0155049238,13,39,11,28,16,23,0,0,0,0,0,39,11,28,16,23,22,10.5651960642638,12.2224281618897,0.423310781666581,2020-03-30,2020,3
"2866","MG",3,"Sudeste",31021,"Frutal",203298,38762.0155049238,14,25,7,18,13,12,0,0,0,0,0,25,7,18,13,12,22,10.5651960642638,12.2224281618897,0.407373321740357,2020-04-06,2020,4
"2867","MG",3,"Sudeste",31021,"Frutal",203298,38762.0155049238,15,30,9,21,9,21,0,0,0,0,0,30,9,21,9,21,29,10.5651960642638,12.2224281618897,0.393883999637587,2020-04-13,2020,4
"2868","MG",3,"Sudeste",31021,"Frutal",203298,38762.0155049238,16,37,6,31,13,24,0,0,0,0,0,37,6,31,13,24,28,10.5651960642638,12.2224281618897,0.394434503909762,2020-04-20,2020,4
"2869","MG",3,"Sudeste",31021,"Frutal",203298,38762.0155049238,17,42,12,30,19,23,0,0,0,0,0,42,12,30,19,23,23,10.5651960642638,12.2224281618897,0.392924585137945,2020-04-27,2020,4
"2870","MG",3,"Sudeste",31021,"Frutal",203298,38762.0155049238,18,40,8,32,16,24,0,0,0,0,0,40,8,32,16,24,27,10.5651960642638,12.2224281618897,0.377063384983061,2020-05-04,2020,5
"2871","MG",3,"Sudeste",31021,"Frutal",203298,38762.0155049238,19,46,13,33,23,23,1,0,1,0,1,47,13,34,23,24,30,10.5651960642638,12.2224281618897,0.385685112003252,2020-05-11,2020,5
"2872","MG",3,"Sudeste",31021,"Frutal",203298,38762.0155049238,20,48,8,40,11,37,0,0,0,0,0,48,8,40,11,37,27,10.5651960642638,12.2224281618897,0.388495449360761,2020-05-18,2020,5
"2873","MG",3,"Sudeste",31021,"Frutal",203298,38762.0155049238,21,27,9,18,14,13,0,0,0,0,0,27,9,18,14,13,30,10.5651960642638,12.2224281618897,0.383095579104954,2020-05-25,2020,5
"2874","MG",3,"Sudeste",31022,"Uberaba",397481,43784.6534503536,5,82,17,65,30,52,1,0,1,1,0,83,17,66,31,52,51,10.6870386571221,12.892902413192,0.286714995489708,2020-02-03,2020,2
"2875","MG",3,"Sudeste",31022,"Uberaba",397481,43784.6534503536,6,77,18,59,28,49,0,0,0,0,0,77,18,59,28,49,55,10.6870386571221,12.892902413192,0.282459845119261,2020-02-10,2020,2
"2876","MG",3,"Sudeste",31022,"Uberaba",397481,43784.6534503536,7,68,18,50,29,39,1,0,1,1,0,69,18,51,30,39,36,10.6870386571221,12.892902413192,0.298339729656019,2020-02-17,2020,2
"2877","MG",3,"Sudeste",31022,"Uberaba",397481,43784.6534503536,8,93,22,71,28,65,0,0,0,0,0,93,22,71,28,65,45,10.6870386571221,12.892902413192,0.346964007950766,2020-02-24,2020,2
"2878","MG",3,"Sudeste",31022,"Uberaba",397481,43784.6534503536,9,91,16,75,29,62,1,0,1,0,1,92,16,76,29,63,43,10.6870386571221,12.892902413192,0.319927658363497,2020-03-02,2020,3
"2879","MG",3,"Sudeste",31022,"Uberaba",397481,43784.6534503536,10,58,14,44,26,32,0,0,0,0,0,58,14,44,26,32,48,10.6870386571221,12.892902413192,0.322013609038975,2020-03-09,2020,3
"2880","MG",3,"Sudeste",31022,"Uberaba",397481,43784.6534503536,11,86,17,69,30,56,0,0,0,0,0,86,17,69,30,56,44,10.6870386571221,12.892902413192,0.399305387100072,2020-03-16,2020,3
"2881","MG",3,"Sudeste",31022,"Uberaba",397481,43784.6534503536,12,82,16,66,25,57,1,1,0,1,0,83,17,66,26,57,44,10.6870386571221,12.892902413192,0.498917455133014,2020-03-23,2020,3
"2882","MG",3,"Sudeste",31022,"Uberaba",397481,43784.6534503536,13,70,18,52,23,47,1,0,1,0,1,71,18,53,23,48,40,10.6870386571221,12.892902413192,0.460985053616117,2020-03-30,2020,3
"2883","MG",3,"Sudeste",31022,"Uberaba",397481,43784.6534503536,14,89,23,66,33,56,1,0,1,0,1,90,23,67,33,57,51,10.6870386571221,12.892902413192,0.448821344321846,2020-04-06,2020,4
"2884","MG",3,"Sudeste",31022,"Uberaba",397481,43784.6534503536,15,72,14,58,29,43,2,2,0,1,1,74,16,58,30,44,53,10.6870386571221,12.892902413192,0.430454258569746,2020-04-13,2020,4
"2885","MG",3,"Sudeste",31022,"Uberaba",397481,43784.6534503536,16,92,17,75,29,63,1,1,0,0,1,93,18,75,29,64,53,10.6870386571221,12.892902413192,0.436076889262191,2020-04-20,2020,4
"2886","MG",3,"Sudeste",31022,"Uberaba",397481,43784.6534503536,17,74,12,62,25,49,0,0,0,0,0,74,12,62,25,49,35,10.6870386571221,12.892902413192,0.415767544271329,2020-04-27,2020,4
"2887","MG",3,"Sudeste",31022,"Uberaba",397481,43784.6534503536,18,100,26,74,41,59,1,1,0,0,1,101,27,74,41,60,50,10.6870386571221,12.892902413192,0.393393572377295,2020-05-04,2020,5
"2888","MG",3,"Sudeste",31022,"Uberaba",397481,43784.6534503536,19,84,11,73,27,57,1,0,1,0,1,85,11,74,27,58,48,10.6870386571221,12.892902413192,0.401054172403022,2020-05-11,2020,5
"2889","MG",3,"Sudeste",31022,"Uberaba",397481,43784.6534503536,20,102,19,83,23,79,1,0,1,0,1,103,19,84,23,80,47,10.6870386571221,12.892902413192,0.409045251549107,2020-05-18,2020,5
"2890","MG",3,"Sudeste",31022,"Uberaba",397481,43784.6534503536,21,110,22,88,40,70,4,0,4,1,3,114,22,92,41,73,58,10.6870386571221,12.892902413192,0.393140194208268,2020-05-25,2020,5
"2891","MG",3,"Sudeste",31023,"Araxá",233114,54719.6650569678,5,47,13,34,25,22,0,0,0,0,0,47,13,34,25,22,26,10.9099784312428,12.3592828832804,0.306197074861858,2020-02-03,2020,2
"2892","MG",3,"Sudeste",31023,"Araxá",233114,54719.6650569678,6,61,16,45,21,40,1,1,0,1,0,62,17,45,22,40,26,10.9099784312428,12.3592828832804,0.28784884080121,2020-02-10,2020,2
"2893","MG",3,"Sudeste",31023,"Araxá",233114,54719.6650569678,7,57,11,46,20,37,0,0,0,0,0,57,11,46,20,37,32,10.9099784312428,12.3592828832804,0.306701823910773,2020-02-17,2020,2
"2894","MG",3,"Sudeste",31023,"Araxá",233114,54719.6650569678,8,43,10,33,19,24,0,0,0,0,0,43,10,33,19,24,33,10.9099784312428,12.3592828832804,0.350593751210713,2020-02-24,2020,2
"2895","MG",3,"Sudeste",31023,"Araxá",233114,54719.6650569678,9,57,13,44,22,35,1,1,0,0,1,58,14,44,22,36,32,10.9099784312428,12.3592828832804,0.324239891468896,2020-03-02,2020,3
"2896","MG",3,"Sudeste",31023,"Araxá",233114,54719.6650569678,10,47,11,36,18,29,1,0,1,0,1,48,11,37,18,30,33,10.9099784312428,12.3592828832804,0.329276583607494,2020-03-09,2020,3
"2897","MG",3,"Sudeste",31023,"Araxá",233114,54719.6650569678,11,62,11,51,17,45,2,0,2,0,2,64,11,53,17,47,22,10.9099784312428,12.3592828832804,0.392141582190897,2020-03-16,2020,3
"2898","MG",3,"Sudeste",31023,"Araxá",233114,54719.6650569678,12,35,5,30,11,24,1,0,1,0,1,36,5,31,11,25,30,10.9099784312428,12.3592828832804,0.500251659824728,2020-03-23,2020,3
"2899","MG",3,"Sudeste",31023,"Araxá",233114,54719.6650569678,13,36,9,27,16,20,2,0,2,1,1,38,9,29,17,21,29,10.9099784312428,12.3592828832804,0.453356657753714,2020-03-30,2020,3
"2900","MG",3,"Sudeste",31023,"Araxá",233114,54719.6650569678,14,39,10,29,11,28,0,0,0,0,0,39,10,29,11,28,26,10.9099784312428,12.3592828832804,0.432393744839132,2020-04-06,2020,4
"2901","MG",3,"Sudeste",31023,"Araxá",233114,54719.6650569678,15,51,9,42,22,29,0,0,0,0,0,51,9,42,22,29,25,10.9099784312428,12.3592828832804,0.413513636550579,2020-04-13,2020,4
"2902","MG",3,"Sudeste",31023,"Araxá",233114,54719.6650569678,16,52,9,43,24,28,0,0,0,0,0,52,9,43,24,28,29,10.9099784312428,12.3592828832804,0.415563079996433,2020-04-20,2020,4
"2903","MG",3,"Sudeste",31023,"Araxá",233114,54719.6650569678,17,61,9,52,25,36,1,0,1,1,0,62,9,53,26,36,33,10.9099784312428,12.3592828832804,0.404165317616678,2020-04-27,2020,4
"2904","MG",3,"Sudeste",31023,"Araxá",233114,54719.6650569678,18,49,6,43,19,30,0,0,0,0,0,49,6,43,19,30,22,10.9099784312428,12.3592828832804,0.386583164721631,2020-05-04,2020,5
"2905","MG",3,"Sudeste",31023,"Araxá",233114,54719.6650569678,19,63,16,47,27,36,2,1,1,1,1,65,17,48,28,37,23,10.9099784312428,12.3592828832804,0.396746963195077,2020-05-11,2020,5
"2906","MG",3,"Sudeste",31023,"Araxá",233114,54719.6650569678,20,59,9,50,27,32,1,1,0,0,1,60,10,50,27,33,46,10.9099784312428,12.3592828832804,0.412609119679108,2020-05-18,2020,5
"2907","MG",3,"Sudeste",31023,"Araxá",233114,54719.6650569678,21,61,9,52,19,42,1,0,1,0,1,62,9,53,19,43,37,10.9099784312428,12.3592828832804,0.39648681708293,2020-05-25,2020,5
"2908","MG",3,"Sudeste",31024,"Três Marias",105028,42710.7782095251,5,20,4,16,6,14,0,0,0,0,0,20,4,16,6,14,10,10.6622065844498,11.5619822602571,0.292905370227129,2020-02-03,2020,2
"2909","MG",3,"Sudeste",31024,"Três Marias",105028,42710.7782095251,6,23,7,16,10,13,0,0,0,0,0,23,7,16,10,13,10,10.6622065844498,11.5619822602571,0.273735790520699,2020-02-10,2020,2
"2910","MG",3,"Sudeste",31024,"Três Marias",105028,42710.7782095251,7,11,4,7,3,8,0,0,0,0,0,11,4,7,3,8,15,10.6622065844498,11.5619822602571,0.281991291640441,2020-02-17,2020,2
"2911","MG",3,"Sudeste",31024,"Três Marias",105028,42710.7782095251,8,22,4,18,8,14,0,0,0,0,0,22,4,18,8,14,7,10.6622065844498,11.5619822602571,0.322966173006255,2020-02-24,2020,2
"2912","MG",3,"Sudeste",31024,"Três Marias",105028,42710.7782095251,9,19,5,14,7,12,0,0,0,0,0,19,5,14,7,12,15,10.6622065844498,11.5619822602571,0.304323986133215,2020-03-02,2020,3
"2913","MG",3,"Sudeste",31024,"Três Marias",105028,42710.7782095251,10,12,5,7,4,8,0,0,0,0,0,12,5,7,4,8,19,10.6622065844498,11.5619822602571,0.301188793829273,2020-03-09,2020,3
"2914","MG",3,"Sudeste",31024,"Três Marias",105028,42710.7782095251,11,15,2,13,4,11,0,0,0,0,0,15,2,13,4,11,15,10.6622065844498,11.5619822602571,0.371674666422658,2020-03-16,2020,3
"2915","MG",3,"Sudeste",31024,"Três Marias",105028,42710.7782095251,12,12,2,10,4,8,0,0,0,0,0,12,2,10,4,8,18,10.6622065844498,11.5619822602571,0.450585912924942,2020-03-23,2020,3
"2916","MG",3,"Sudeste",31024,"Três Marias",105028,42710.7782095251,13,10,2,8,5,5,0,0,0,0,0,10,2,8,5,5,8,10.6622065844498,11.5619822602571,0.416300109627539,2020-03-30,2020,3
"2917","MG",3,"Sudeste",31024,"Três Marias",105028,42710.7782095251,14,23,11,12,10,13,0,0,0,0,0,23,11,12,10,13,14,10.6622065844498,11.5619822602571,0.407018020633171,2020-04-06,2020,4
"2918","MG",3,"Sudeste",31024,"Três Marias",105028,42710.7782095251,15,12,2,10,3,9,0,0,0,0,0,12,2,10,3,9,17,10.6622065844498,11.5619822602571,0.375818837469608,2020-04-13,2020,4
"2919","MG",3,"Sudeste",31024,"Três Marias",105028,42710.7782095251,16,17,4,13,8,9,0,0,0,0,0,17,4,13,8,9,16,10.6622065844498,11.5619822602571,0.385354382337232,2020-04-20,2020,4
"2920","MG",3,"Sudeste",31024,"Três Marias",105028,42710.7782095251,17,8,3,5,5,3,0,0,0,0,0,8,3,5,5,3,7,10.6622065844498,11.5619822602571,0.379834768652552,2020-04-27,2020,4
"2921","MG",3,"Sudeste",31024,"Três Marias",105028,42710.7782095251,18,15,5,10,4,11,0,0,0,0,0,15,5,10,4,11,10,10.6622065844498,11.5619822602571,0.346521665997373,2020-05-04,2020,5
"2922","MG",3,"Sudeste",31024,"Três Marias",105028,42710.7782095251,19,12,3,9,7,5,0,0,0,0,0,12,3,9,7,5,15,10.6622065844498,11.5619822602571,0.367655822343825,2020-05-11,2020,5
"2923","MG",3,"Sudeste",31024,"Três Marias",105028,42710.7782095251,20,21,4,17,10,11,0,0,0,0,0,21,4,17,10,11,4,10.6622065844498,11.5619822602571,0.361477320950753,2020-05-18,2020,5
"2924","MG",3,"Sudeste",31024,"Três Marias",105028,42710.7782095251,21,15,4,11,4,11,0,0,0,0,0,15,4,11,4,11,14,10.6622065844498,11.5619822602571,0.376756152767504,2020-05-25,2020,5
"2925","MG",3,"Sudeste",31025,"Curvelo",158518,16157.1108908767,5,37,9,28,14,23,1,0,1,1,0,38,9,29,15,23,24,9.69011553458662,11.9736234305203,0.308867572725422,2020-02-03,2020,2
"2926","MG",3,"Sudeste",31025,"Curvelo",158518,16157.1108908767,6,26,6,20,13,13,0,0,0,0,0,26,6,20,13,13,20,9.69011553458662,11.9736234305203,0.286318034607436,2020-02-10,2020,2
"2927","MG",3,"Sudeste",31025,"Curvelo",158518,16157.1108908767,7,30,9,21,17,13,0,0,0,0,0,30,9,21,17,13,18,9.69011553458662,11.9736234305203,0.312396777913394,2020-02-17,2020,2
"2928","MG",3,"Sudeste",31025,"Curvelo",158518,16157.1108908767,8,37,10,27,19,18,0,0,0,0,0,37,10,27,19,18,18,9.69011553458662,11.9736234305203,0.342714271632406,2020-02-24,2020,2
"2929","MG",3,"Sudeste",31025,"Curvelo",158518,16157.1108908767,9,33,12,21,15,18,0,0,0,0,0,33,12,21,15,18,20,9.69011553458662,11.9736234305203,0.326810703153161,2020-03-02,2020,3
"2930","MG",3,"Sudeste",31025,"Curvelo",158518,16157.1108908767,10,37,5,32,19,18,1,1,0,0,1,38,6,32,19,19,21,9.69011553458662,11.9736234305203,0.332247359580002,2020-03-09,2020,3
"2931","MG",3,"Sudeste",31025,"Curvelo",158518,16157.1108908767,11,33,3,30,18,15,0,0,0,0,0,33,3,30,18,15,32,9.69011553458662,11.9736234305203,0.379764890237154,2020-03-16,2020,3
"2932","MG",3,"Sudeste",31025,"Curvelo",158518,16157.1108908767,12,21,6,15,10,11,0,0,0,0,0,21,6,15,10,11,17,9.69011553458662,11.9736234305203,0.476411808785812,2020-03-23,2020,3
"2933","MG",3,"Sudeste",31025,"Curvelo",158518,16157.1108908767,13,33,12,21,12,21,0,0,0,0,0,33,12,21,12,21,12,9.69011553458662,11.9736234305203,0.441096857668626,2020-03-30,2020,3
"2934","MG",3,"Sudeste",31025,"Curvelo",158518,16157.1108908767,14,25,8,17,13,12,1,1,0,0,1,26,9,17,13,13,23,9.69011553458662,11.9736234305203,0.431803602468944,2020-04-06,2020,4
"2935","MG",3,"Sudeste",31025,"Curvelo",158518,16157.1108908767,15,32,6,26,9,23,0,0,0,0,0,32,6,26,9,23,22,9.69011553458662,11.9736234305203,0.401410681273605,2020-04-13,2020,4
"2936","MG",3,"Sudeste",31025,"Curvelo",158518,16157.1108908767,16,34,9,25,15,19,0,0,0,0,0,34,9,25,15,19,21,9.69011553458662,11.9736234305203,0.418506999687005,2020-04-20,2020,4
"2937","MG",3,"Sudeste",31025,"Curvelo",158518,16157.1108908767,17,29,8,21,12,17,0,0,0,0,0,29,8,21,12,17,25,9.69011553458662,11.9736234305203,0.410270888392986,2020-04-27,2020,4
"2938","MG",3,"Sudeste",31025,"Curvelo",158518,16157.1108908767,18,33,8,25,13,20,0,0,0,0,0,33,8,25,13,20,25,9.69011553458662,11.9736234305203,0.386601702368218,2020-05-04,2020,5
"2939","MG",3,"Sudeste",31025,"Curvelo",158518,16157.1108908767,19,45,15,30,26,19,0,0,0,0,0,45,15,30,26,19,27,9.69011553458662,11.9736234305203,0.415010003271144,2020-05-11,2020,5
"2940","MG",3,"Sudeste",31025,"Curvelo",158518,16157.1108908767,20,30,11,19,11,19,0,0,0,0,0,30,11,19,11,19,16,9.69011553458662,11.9736234305203,0.40138311574653,2020-05-18,2020,5
"2941","MG",3,"Sudeste",31025,"Curvelo",158518,16157.1108908767,21,35,12,23,17,18,1,0,1,0,1,36,12,24,17,19,18,9.69011553458662,11.9736234305203,0.392985830483701,2020-05-25,2020,5
"2942","MG",3,"Sudeste",31026,"Bom Despacho",181282,27405.0519412849,5,29,6,23,10,19,0,0,0,0,0,29,6,23,10,19,21,10.2184826527999,12.1078091088576,0.289701515147624,2020-02-03,2020,2
"2943","MG",3,"Sudeste",31026,"Bom Despacho",181282,27405.0519412849,6,38,4,34,8,30,1,0,1,0,1,39,4,35,8,31,16,10.2184826527999,12.1078091088576,0.27665933010413,2020-02-10,2020,2
"2944","MG",3,"Sudeste",31026,"Bom Despacho",181282,27405.0519412849,7,29,2,27,11,18,0,0,0,0,0,29,2,27,11,18,25,10.2184826527999,12.1078091088576,0.291231222816481,2020-02-17,2020,2
"2945","MG",3,"Sudeste",31026,"Bom Despacho",181282,27405.0519412849,8,35,11,24,11,24,0,0,0,0,0,35,11,24,11,24,22,10.2184826527999,12.1078091088576,0.33668672127062,2020-02-24,2020,2
"2946","MG",3,"Sudeste",31026,"Bom Despacho",181282,27405.0519412849,9,42,10,32,15,27,0,0,0,0,0,42,10,32,15,27,31,10.2184826527999,12.1078091088576,0.309956481733312,2020-03-02,2020,3
"2947","MG",3,"Sudeste",31026,"Bom Despacho",181282,27405.0519412849,10,30,8,22,9,21,0,0,0,0,0,30,8,22,9,21,29,10.2184826527999,12.1078091088576,0.314708021137558,2020-03-09,2020,3
"2948","MG",3,"Sudeste",31026,"Bom Despacho",181282,27405.0519412849,11,32,7,25,13,19,0,0,0,0,0,32,7,25,13,19,23,10.2184826527999,12.1078091088576,0.378220878703795,2020-03-16,2020,3
"2949","MG",3,"Sudeste",31026,"Bom Despacho",181282,27405.0519412849,12,24,5,19,11,13,0,0,0,0,0,24,5,19,11,13,21,10.2184826527999,12.1078091088576,0.481085778251319,2020-03-23,2020,3
"2950","MG",3,"Sudeste",31026,"Bom Despacho",181282,27405.0519412849,13,23,5,18,9,14,0,0,0,0,0,23,5,18,9,14,30,10.2184826527999,12.1078091088576,0.431262021887606,2020-03-30,2020,3
"2951","MG",3,"Sudeste",31026,"Bom Despacho",181282,27405.0519412849,14,27,6,21,10,17,1,0,1,0,1,28,6,22,10,18,29,10.2184826527999,12.1078091088576,0.425726065920763,2020-04-06,2020,4
"2952","MG",3,"Sudeste",31026,"Bom Despacho",181282,27405.0519412849,15,30,6,24,9,21,0,0,0,0,0,30,6,24,9,21,19,10.2184826527999,12.1078091088576,0.393602843446086,2020-04-13,2020,4
"2953","MG",3,"Sudeste",31026,"Bom Despacho",181282,27405.0519412849,16,28,6,22,14,14,0,0,0,0,0,28,6,22,14,14,21,10.2184826527999,12.1078091088576,0.39010436533541,2020-04-20,2020,4
"2954","MG",3,"Sudeste",31026,"Bom Despacho",181282,27405.0519412849,17,40,8,32,9,31,0,0,0,0,0,40,8,32,9,31,18,10.2184826527999,12.1078091088576,0.388623767368873,2020-04-27,2020,4
"2955","MG",3,"Sudeste",31026,"Bom Despacho",181282,27405.0519412849,18,30,6,24,10,20,0,0,0,0,0,30,6,24,10,20,27,10.2184826527999,12.1078091088576,0.361025078994744,2020-05-04,2020,5
"2956","MG",3,"Sudeste",31026,"Bom Despacho",181282,27405.0519412849,19,37,9,28,11,26,0,0,0,0,0,37,9,28,11,26,28,10.2184826527999,12.1078091088576,0.36188147326874,2020-05-11,2020,5
"2957","MG",3,"Sudeste",31026,"Bom Despacho",181282,27405.0519412849,20,57,11,46,20,37,0,0,0,0,0,57,11,46,20,37,25,10.2184826527999,12.1078091088576,0.366868858341796,2020-05-18,2020,5
"2958","MG",3,"Sudeste",31026,"Bom Despacho",181282,27405.0519412849,21,47,12,35,18,29,0,0,0,0,0,47,12,35,18,29,30,10.2184826527999,12.1078091088576,0.356334836191224,2020-05-25,2020,5
"2959","MG",3,"Sudeste",31027,"Sete Lagoas",439218,28288.6806938468,5,68,12,56,21,47,0,0,0,0,0,68,12,56,21,47,56,10.2502170281374,12.9927511519442,0.276712194133825,2020-02-03,2020,2
"2960","MG",3,"Sudeste",31027,"Sete Lagoas",439218,28288.6806938468,6,99,16,83,40,59,0,0,0,0,0,99,16,83,40,59,45,10.2502170281374,12.9927511519442,0.267336263200422,2020-02-10,2020,2
"2961","MG",3,"Sudeste",31027,"Sete Lagoas",439218,28288.6806938468,7,97,13,84,29,68,0,0,0,0,0,97,13,84,29,68,52,10.2502170281374,12.9927511519442,0.280345098202419,2020-02-17,2020,2
"2962","MG",3,"Sudeste",31027,"Sete Lagoas",439218,28288.6806938468,8,60,14,46,19,41,2,1,1,1,1,62,15,47,20,42,53,10.2502170281374,12.9927511519442,0.337427385976233,2020-02-24,2020,2
"2963","MG",3,"Sudeste",31027,"Sete Lagoas",439218,28288.6806938468,9,89,12,77,25,64,1,1,0,1,0,90,13,77,26,64,54,10.2502170281374,12.9927511519442,0.306346993755035,2020-03-02,2020,3
"2964","MG",3,"Sudeste",31027,"Sete Lagoas",439218,28288.6806938468,10,67,10,57,20,47,1,0,1,1,0,68,10,58,21,47,44,10.2502170281374,12.9927511519442,0.304447330249882,2020-03-09,2020,3
"2965","MG",3,"Sudeste",31027,"Sete Lagoas",439218,28288.6806938468,11,63,13,50,25,38,1,0,1,1,0,64,13,51,26,38,71,10.2502170281374,12.9927511519442,0.391979440252167,2020-03-16,2020,3
"2966","MG",3,"Sudeste",31027,"Sete Lagoas",439218,28288.6806938468,12,49,6,43,16,33,1,0,1,0,1,50,6,44,16,34,52,10.2502170281374,12.9927511519442,0.487827512442906,2020-03-23,2020,3
"2967","MG",3,"Sudeste",31027,"Sete Lagoas",439218,28288.6806938468,13,35,9,26,15,20,0,0,0,0,0,35,9,26,15,20,40,10.2502170281374,12.9927511519442,0.44287880841283,2020-03-30,2020,3
"2968","MG",3,"Sudeste",31027,"Sete Lagoas",439218,28288.6806938468,14,31,4,27,8,23,0,0,0,0,0,31,4,27,8,23,34,10.2502170281374,12.9927511519442,0.438119602978239,2020-04-06,2020,4
"2969","MG",3,"Sudeste",31027,"Sete Lagoas",439218,28288.6806938468,15,24,2,22,11,13,0,0,0,0,0,24,2,22,11,13,46,10.2502170281374,12.9927511519442,0.409902739821751,2020-04-13,2020,4
"2970","MG",3,"Sudeste",31027,"Sete Lagoas",439218,28288.6806938468,16,26,0,26,8,18,1,1,0,0,1,27,1,26,8,19,54,10.2502170281374,12.9927511519442,0.41313071251146,2020-04-20,2020,4
"2971","MG",3,"Sudeste",31027,"Sete Lagoas",439218,28288.6806938468,17,29,6,23,16,13,0,0,0,0,0,29,6,23,16,13,56,10.2502170281374,12.9927511519442,0.40054921012812,2020-04-27,2020,4
"2972","MG",3,"Sudeste",31027,"Sete Lagoas",439218,28288.6806938468,18,21,2,19,8,13,0,0,0,0,0,21,2,19,8,13,43,10.2502170281374,12.9927511519442,0.368848217147882,2020-05-04,2020,5
"2973","MG",3,"Sudeste",31027,"Sete Lagoas",439218,28288.6806938468,19,17,1,16,5,12,0,0,0,0,0,17,1,16,5,12,45,10.2502170281374,12.9927511519442,0.381818692556547,2020-05-11,2020,5
"2974","MG",3,"Sudeste",31027,"Sete Lagoas",439218,28288.6806938468,20,26,1,25,5,21,0,0,0,0,0,26,1,25,5,21,58,10.2502170281374,12.9927511519442,0.372559347587504,2020-05-18,2020,5
"2975","MG",3,"Sudeste",31027,"Sete Lagoas",439218,28288.6806938468,21,20,2,18,7,13,0,0,0,0,0,20,2,18,7,13,58,10.2502170281374,12.9927511519442,0.372422053371357,2020-05-25,2020,5
"2976","MG",3,"Sudeste",31028,"Conceição do Mato Dentro",82469,16820.5259873407,5,22,7,15,4,18,0,0,0,0,0,22,7,15,4,18,10,9.73035520458025,11.3201777441324,0.301344338605656,2020-02-03,2020,2
"2977","MG",3,"Sudeste",31028,"Conceição do Mato Dentro",82469,16820.5259873407,6,17,5,12,9,8,0,0,0,0,0,17,5,12,9,8,9,9.73035520458025,11.3201777441324,0.300329655797742,2020-02-10,2020,2
"2978","MG",3,"Sudeste",31028,"Conceição do Mato Dentro",82469,16820.5259873407,7,17,5,12,9,8,0,0,0,0,0,17,5,12,9,8,10,9.73035520458025,11.3201777441324,0.304805815761689,2020-02-17,2020,2
"2979","MG",3,"Sudeste",31028,"Conceição do Mato Dentro",82469,16820.5259873407,8,19,10,9,9,10,1,1,0,0,1,20,11,9,9,11,12,9.73035520458025,11.3201777441324,0.346570020308182,2020-02-24,2020,2
"2980","MG",3,"Sudeste",31028,"Conceição do Mato Dentro",82469,16820.5259873407,9,13,7,6,5,8,0,0,0,0,0,13,7,6,5,8,14,9.73035520458025,11.3201777441324,0.340611725718771,2020-03-02,2020,3
"2981","MG",3,"Sudeste",31028,"Conceição do Mato Dentro",82469,16820.5259873407,10,23,6,17,10,13,0,0,0,0,0,23,6,17,10,13,15,9.73035520458025,11.3201777441324,0.322029507545248,2020-03-09,2020,3
"2982","MG",3,"Sudeste",31028,"Conceição do Mato Dentro",82469,16820.5259873407,11,12,4,8,4,8,0,0,0,0,0,12,4,8,4,8,15,9.73035520458025,11.3201777441324,0.398107761289059,2020-03-16,2020,3
"2983","MG",3,"Sudeste",31028,"Conceição do Mato Dentro",82469,16820.5259873407,12,13,1,12,5,8,0,0,0,0,0,13,1,12,5,8,12,9.73035520458025,11.3201777441324,0.506304941044248,2020-03-23,2020,3
"2984","MG",3,"Sudeste",31028,"Conceição do Mato Dentro",82469,16820.5259873407,13,15,4,11,7,8,0,0,0,0,0,15,4,11,7,8,16,9.73035520458025,11.3201777441324,0.477137993688042,2020-03-30,2020,3
"2985","MG",3,"Sudeste",31028,"Conceição do Mato Dentro",82469,16820.5259873407,14,14,4,10,5,9,0,0,0,0,0,14,4,10,5,9,9,9.73035520458025,11.3201777441324,0.464401114674305,2020-04-06,2020,4
"2986","MG",3,"Sudeste",31028,"Conceição do Mato Dentro",82469,16820.5259873407,15,17,4,13,6,11,0,0,0,0,0,17,4,13,6,11,15,9.73035520458025,11.3201777441324,0.421472854326802,2020-04-13,2020,4
"2987","MG",3,"Sudeste",31028,"Conceição do Mato Dentro",82469,16820.5259873407,16,8,0,8,3,5,0,0,0,0,0,8,0,8,3,5,6,9.73035520458025,11.3201777441324,0.426596270727833,2020-04-20,2020,4
"2988","MG",3,"Sudeste",31028,"Conceição do Mato Dentro",82469,16820.5259873407,17,19,2,17,7,12,0,0,0,0,0,19,2,17,7,12,6,9.73035520458025,11.3201777441324,0.412557337077646,2020-04-27,2020,4
"2989","MG",3,"Sudeste",31028,"Conceição do Mato Dentro",82469,16820.5259873407,18,15,2,13,5,10,0,0,0,0,0,15,2,13,5,10,11,9.73035520458025,11.3201777441324,0.396652988588328,2020-05-04,2020,5
"2990","MG",3,"Sudeste",31028,"Conceição do Mato Dentro",82469,16820.5259873407,19,18,9,9,3,15,0,0,0,0,0,18,9,9,3,15,9,9.73035520458025,11.3201777441324,0.418903287882658,2020-05-11,2020,5
"2991","MG",3,"Sudeste",31028,"Conceição do Mato Dentro",82469,16820.5259873407,20,20,7,13,10,10,0,0,0,0,0,20,7,13,10,10,8,9.73035520458025,11.3201777441324,0.413192515718147,2020-05-18,2020,5
"2992","MG",3,"Sudeste",31028,"Conceição do Mato Dentro",82469,16820.5259873407,21,20,5,15,7,13,0,0,0,0,0,20,5,15,7,13,14,9.73035520458025,11.3201777441324,0.424232590891504,2020-05-25,2020,5
"2993","MG",3,"Sudeste",31029,"Pará de Minas",138787,26897.8420863626,5,23,3,20,7,16,0,0,0,0,0,23,3,20,7,16,14,10.1998013425343,11.8406956627261,0.284857750727413,2020-02-03,2020,2
"2994","MG",3,"Sudeste",31029,"Pará de Minas",138787,26897.8420863626,6,29,4,25,9,20,0,0,0,0,0,29,4,25,9,20,11,10.1998013425343,11.8406956627261,0.273394423162584,2020-02-10,2020,2
"2995","MG",3,"Sudeste",31029,"Pará de Minas",138787,26897.8420863626,7,23,6,17,11,12,0,0,0,0,0,23,6,17,11,12,17,10.1998013425343,11.8406956627261,0.277203757310051,2020-02-17,2020,2
"2996","MG",3,"Sudeste",31029,"Pará de Minas",138787,26897.8420863626,8,19,3,16,5,14,0,0,0,0,0,19,3,16,5,14,16,10.1998013425343,11.8406956627261,0.327918933295144,2020-02-24,2020,2
"2997","MG",3,"Sudeste",31029,"Pará de Minas",138787,26897.8420863626,9,28,1,27,10,18,1,0,1,1,0,29,1,28,11,18,19,10.1998013425343,11.8406956627261,0.303649784194851,2020-03-02,2020,3
"2998","MG",3,"Sudeste",31029,"Pará de Minas",138787,26897.8420863626,10,29,6,23,8,21,0,0,0,0,0,29,6,23,8,21,20,10.1998013425343,11.8406956627261,0.312683106303835,2020-03-09,2020,3
"2999","MG",3,"Sudeste",31029,"Pará de Minas",138787,26897.8420863626,11,16,4,12,5,11,0,0,0,0,0,16,4,12,5,11,20,10.1998013425343,11.8406956627261,0.370370722436392,2020-03-16,2020,3
"3000","MG",3,"Sudeste",31029,"Pará de Minas",138787,26897.8420863626,12,29,2,27,9,20,0,0,0,0,0,29,2,27,9,20,19,10.1998013425343,11.8406956627261,0.472307924309034,2020-03-23,2020,3
"3001","MG",3,"Sudeste",31029,"Pará de Minas",138787,26897.8420863626,13,21,2,19,8,13,0,0,0,0,0,21,2,19,8,13,18,10.1998013425343,11.8406956627261,0.430985008350634,2020-03-30,2020,3
"3002","MG",3,"Sudeste",31029,"Pará de Minas",138787,26897.8420863626,14,27,5,22,14,13,1,0,1,0,1,28,5,23,14,14,10,10.1998013425343,11.8406956627261,0.432728924983181,2020-04-06,2020,4
"3003","MG",3,"Sudeste",31029,"Pará de Minas",138787,26897.8420863626,15,25,6,19,9,16,0,0,0,0,0,25,6,19,9,16,16,10.1998013425343,11.8406956627261,0.403701681804875,2020-04-13,2020,4
"3004","MG",3,"Sudeste",31029,"Pará de Minas",138787,26897.8420863626,16,27,4,23,10,17,0,0,0,0,0,27,4,23,10,17,21,10.1998013425343,11.8406956627261,0.398539548912468,2020-04-20,2020,4
"3005","MG",3,"Sudeste",31029,"Pará de Minas",138787,26897.8420863626,17,29,8,21,10,19,0,0,0,0,0,29,8,21,10,19,13,10.1998013425343,11.8406956627261,0.394967407083206,2020-04-27,2020,4
"3006","MG",3,"Sudeste",31029,"Pará de Minas",138787,26897.8420863626,18,34,6,28,6,28,0,0,0,0,0,34,6,28,6,28,14,10.1998013425343,11.8406956627261,0.364860654389972,2020-05-04,2020,5
"3007","MG",3,"Sudeste",31029,"Pará de Minas",138787,26897.8420863626,19,33,6,27,13,20,1,1,0,1,0,34,7,27,14,20,16,10.1998013425343,11.8406956627261,0.367310187064187,2020-05-11,2020,5
"3008","MG",3,"Sudeste",31029,"Pará de Minas",138787,26897.8420863626,20,36,8,28,16,20,1,0,1,1,0,37,8,29,17,20,17,10.1998013425343,11.8406956627261,0.3666003421408,2020-05-18,2020,5
"3009","MG",3,"Sudeste",31029,"Pará de Minas",138787,26897.8420863626,21,30,7,23,14,16,1,0,1,1,0,31,7,24,15,16,11,10.1998013425343,11.8406956627261,0.361923146575672,2020-05-25,2020,5
"3010","MG",3,"Sudeste",31030,"Belo Horizonte",5268308,35549.2591819954,5,1051,147,904,293,758,14,5,9,6,8,1065,152,913,299,766,544,10.4786745962518,15.4772198063473,0.277700616535216,2020-02-03,2020,2
"3011","MG",3,"Sudeste",31030,"Belo Horizonte",5268308,35549.2591819954,6,1098,148,950,327,771,14,3,11,7,7,1112,151,961,334,778,618,10.4786745962518,15.4772198063473,0.270276668137376,2020-02-10,2020,2
"3012","MG",3,"Sudeste",31030,"Belo Horizonte",5268308,35549.2591819954,7,1133,164,969,334,799,11,2,9,4,7,1144,166,978,338,806,590,10.4786745962518,15.4772198063473,0.285388040370428,2020-02-17,2020,2
"3013","MG",3,"Sudeste",31030,"Belo Horizonte",5268308,35549.2591819954,8,1097,160,937,339,758,20,3,17,5,15,1117,163,954,344,773,586,10.4786745962518,15.4772198063473,0.348065933794253,2020-02-24,2020,2
"3014","MG",3,"Sudeste",31030,"Belo Horizonte",5268308,35549.2591819954,9,1126,162,964,357,769,14,3,11,3,11,1140,165,975,360,780,606,10.4786745962518,15.4772198063473,0.311808877505996,2020-03-02,2020,3
"3015","MG",3,"Sudeste",31030,"Belo Horizonte",5268308,35549.2591819954,10,1079,160,919,333,746,9,0,9,5,4,1088,160,928,338,750,634,10.4786745962518,15.4772198063473,0.311833133617278,2020-03-09,2020,3
"3016","MG",3,"Sudeste",31030,"Belo Horizonte",5268308,35549.2591819954,11,1091,161,930,348,743,13,1,12,5,8,1104,162,942,353,751,628,10.4786745962518,15.4772198063473,0.406044774818167,2020-03-16,2020,3
"3017","MG",3,"Sudeste",31030,"Belo Horizonte",5268308,35549.2591819954,12,984,140,844,335,649,17,7,10,8,9,1001,147,854,343,658,628,10.4786745962518,15.4772198063473,0.520119882260502,2020-03-23,2020,3
"3018","MG",3,"Sudeste",31030,"Belo Horizonte",5268308,35549.2591819954,13,1004,145,859,299,705,10,0,10,4,6,1014,145,869,303,711,625,10.4786745962518,15.4772198063473,0.483132108377291,2020-03-30,2020,3
"3019","MG",3,"Sudeste",31030,"Belo Horizonte",5268308,35549.2591819954,14,1046,148,898,320,726,12,5,7,4,8,1058,153,905,324,734,551,10.4786745962518,15.4772198063473,0.472036730159616,2020-04-06,2020,4
"3020","MG",3,"Sudeste",31030,"Belo Horizonte",5268308,35549.2591819954,15,1118,158,960,339,779,18,5,13,6,12,1136,163,973,345,791,531,10.4786745962518,15.4772198063473,0.452560318120687,2020-04-13,2020,4
"3021","MG",3,"Sudeste",31030,"Belo Horizonte",5268308,35549.2591819954,16,1113,171,942,357,756,22,4,18,12,10,1135,175,960,369,766,536,10.4786745962518,15.4772198063473,0.454039158520606,2020-04-20,2020,4
"3022","MG",3,"Sudeste",31030,"Belo Horizonte",5268308,35549.2591819954,17,1107,162,945,360,747,8,1,7,2,6,1115,163,952,362,753,536,10.4786745962518,15.4772198063473,0.438369337987402,2020-04-27,2020,4
"3023","MG",3,"Sudeste",31030,"Belo Horizonte",5268308,35549.2591819954,18,1092,167,925,357,735,16,2,14,4,12,1108,169,939,361,747,529,10.4786745962518,15.4772198063473,0.409641768588358,2020-05-04,2020,5
"3024","MG",3,"Sudeste",31030,"Belo Horizonte",5268308,35549.2591819954,19,1086,172,914,316,770,14,4,10,6,8,1100,176,924,322,778,565,10.4786745962518,15.4772198063473,0.417649825734265,2020-05-11,2020,5
"3025","MG",3,"Sudeste",31030,"Belo Horizonte",5268308,35549.2591819954,20,1226,169,1057,375,851,11,2,9,3,8,1237,171,1066,378,859,574,10.4786745962518,15.4772198063473,0.409573895927147,2020-05-18,2020,5
"3026","MG",3,"Sudeste",31030,"Belo Horizonte",5268308,35549.2591819954,21,1203,173,1030,349,854,13,5,8,5,8,1216,178,1038,354,862,605,10.4786745962518,15.4772198063473,0.396354309000181,2020-05-25,2020,5
"3027","MG",3,"Sudeste",31031,"Itabira",406384,43806.278840604,5,82,17,65,31,51,0,0,0,0,0,82,17,65,31,51,45,10.6875324386158,12.9150538043926,0.293414493094205,2020-02-03,2020,2
"3028","MG",3,"Sudeste",31031,"Itabira",406384,43806.278840604,6,61,6,55,20,41,0,0,0,0,0,61,6,55,20,41,45,10.6875324386158,12.9150538043926,0.286315533774308,2020-02-10,2020,2
"3029","MG",3,"Sudeste",31031,"Itabira",406384,43806.278840604,7,67,14,53,21,46,0,0,0,0,0,67,14,53,21,46,43,10.6875324386158,12.9150538043926,0.303966580074896,2020-02-17,2020,2
"3030","MG",3,"Sudeste",31031,"Itabira",406384,43806.278840604,8,83,14,69,20,63,1,0,1,0,1,84,14,70,20,64,50,10.6875324386158,12.9150538043926,0.354452279074843,2020-02-24,2020,2
"3031","MG",3,"Sudeste",31031,"Itabira",406384,43806.278840604,9,86,15,71,32,54,0,0,0,0,0,86,15,71,32,54,55,10.6875324386158,12.9150538043926,0.338543695712706,2020-03-02,2020,3
"3032","MG",3,"Sudeste",31031,"Itabira",406384,43806.278840604,10,74,12,62,24,50,0,0,0,0,0,74,12,62,24,50,61,10.6875324386158,12.9150538043926,0.325656021280447,2020-03-09,2020,3
"3033","MG",3,"Sudeste",31031,"Itabira",406384,43806.278840604,11,74,9,65,17,57,0,0,0,0,0,74,9,65,17,57,56,10.6875324386158,12.9150538043926,0.415815353906082,2020-03-16,2020,3
"3034","MG",3,"Sudeste",31031,"Itabira",406384,43806.278840604,12,69,13,56,17,52,0,0,0,0,0,69,13,56,17,52,52,10.6875324386158,12.9150538043926,0.52536663802916,2020-03-23,2020,3
"3035","MG",3,"Sudeste",31031,"Itabira",406384,43806.278840604,13,65,10,55,22,43,1,0,1,0,1,66,10,56,22,44,55,10.6875324386158,12.9150538043926,0.484761894094984,2020-03-30,2020,3
"3036","MG",3,"Sudeste",31031,"Itabira",406384,43806.278840604,14,74,8,66,23,51,1,0,1,0,1,75,8,67,23,52,41,10.6875324386158,12.9150538043926,0.471095597427391,2020-04-06,2020,4
"3037","MG",3,"Sudeste",31031,"Itabira",406384,43806.278840604,15,61,12,49,24,37,1,1,0,0,1,62,13,49,24,38,39,10.6875324386158,12.9150538043926,0.443188093545846,2020-04-13,2020,4
"3038","MG",3,"Sudeste",31031,"Itabira",406384,43806.278840604,16,67,11,56,18,49,0,0,0,0,0,67,11,56,18,49,38,10.6875324386158,12.9150538043926,0.451361639251679,2020-04-20,2020,4
"3039","MG",3,"Sudeste",31031,"Itabira",406384,43806.278840604,17,78,11,67,19,59,0,0,0,0,0,78,11,67,19,59,51,10.6875324386158,12.9150538043926,0.429465607879413,2020-04-27,2020,4
"3040","MG",3,"Sudeste",31031,"Itabira",406384,43806.278840604,18,83,14,69,33,50,1,0,1,1,0,84,14,70,34,50,61,10.6875324386158,12.9150538043926,0.403206180014317,2020-05-04,2020,5
"3041","MG",3,"Sudeste",31031,"Itabira",406384,43806.278840604,19,82,9,73,27,55,0,0,0,0,0,82,9,73,27,55,44,10.6875324386158,12.9150538043926,0.417479686248728,2020-05-11,2020,5
"3042","MG",3,"Sudeste",31031,"Itabira",406384,43806.278840604,20,87,14,73,32,55,1,0,1,0,1,88,14,74,32,56,52,10.6875324386158,12.9150538043926,0.415945334980976,2020-05-18,2020,5
"3043","MG",3,"Sudeste",31031,"Itabira",406384,43806.278840604,21,84,10,74,24,60,0,0,0,0,0,84,10,74,24,60,51,10.6875324386158,12.9150538043926,0.404509006325568,2020-05-25,2020,5
"3044","MG",3,"Sudeste",31032,"Itaguara",64994,51768.6299898452,5,9,3,6,1,8,0,0,0,0,0,9,3,6,1,8,7,10.854539646147,11.0820502369248,0.30250693561496,2020-02-03,2020,2
"3045","MG",3,"Sudeste",31032,"Itaguara",64994,51768.6299898452,6,10,1,9,3,7,0,0,0,0,0,10,1,9,3,7,8,10.854539646147,11.0820502369248,0.274631368832142,2020-02-10,2020,2
"3046","MG",3,"Sudeste",31032,"Itaguara",64994,51768.6299898452,7,10,3,7,2,8,1,0,1,1,0,11,3,8,3,8,8,10.854539646147,11.0820502369248,0.29125482338236,2020-02-17,2020,2
"3047","MG",3,"Sudeste",31032,"Itaguara",64994,51768.6299898452,8,19,4,15,6,13,0,0,0,0,0,19,4,15,6,13,11,10.854539646147,11.0820502369248,0.343404198860059,2020-02-24,2020,2
"3048","MG",3,"Sudeste",31032,"Itaguara",64994,51768.6299898452,9,21,3,18,7,14,0,0,0,0,0,21,3,18,7,14,6,10.854539646147,11.0820502369248,0.334243499117639,2020-03-02,2020,3
"3049","MG",3,"Sudeste",31032,"Itaguara",64994,51768.6299898452,10,11,3,8,4,7,0,0,0,0,0,11,3,8,4,7,5,10.854539646147,11.0820502369248,0.330779700294527,2020-03-09,2020,3
"3050","MG",3,"Sudeste",31032,"Itaguara",64994,51768.6299898452,11,12,3,9,6,6,0,0,0,0,0,12,3,9,6,6,5,10.854539646147,11.0820502369248,0.398863459775464,2020-03-16,2020,3
"3051","MG",3,"Sudeste",31032,"Itaguara",64994,51768.6299898452,12,13,3,10,8,5,0,0,0,0,0,13,3,10,8,5,9,10.854539646147,11.0820502369248,0.460096048627698,2020-03-23,2020,3
"3052","MG",3,"Sudeste",31032,"Itaguara",64994,51768.6299898452,13,9,1,8,5,4,0,0,0,0,0,9,1,8,5,4,8,10.854539646147,11.0820502369248,0.436516489368099,2020-03-30,2020,3
"3053","MG",3,"Sudeste",31032,"Itaguara",64994,51768.6299898452,14,5,1,4,2,3,0,0,0,0,0,5,1,4,2,3,10,10.854539646147,11.0820502369248,0.446286584070926,2020-04-06,2020,4
"3054","MG",3,"Sudeste",31032,"Itaguara",64994,51768.6299898452,15,9,2,7,1,8,0,0,0,0,0,9,2,7,1,8,9,10.854539646147,11.0820502369248,0.408772096482525,2020-04-13,2020,4
"3055","MG",3,"Sudeste",31032,"Itaguara",64994,51768.6299898452,16,14,2,12,3,11,0,0,0,0,0,14,2,12,3,11,9,10.854539646147,11.0820502369248,0.406352462816441,2020-04-20,2020,4
"3056","MG",3,"Sudeste",31032,"Itaguara",64994,51768.6299898452,17,15,1,14,5,10,0,0,0,0,0,15,1,14,5,10,7,10.854539646147,11.0820502369248,0.394540544781405,2020-04-27,2020,4
"3057","MG",3,"Sudeste",31032,"Itaguara",64994,51768.6299898452,18,15,3,12,5,10,0,0,0,0,0,15,3,12,5,10,11,10.854539646147,11.0820502369248,0.387650437006427,2020-05-04,2020,5
"3058","MG",3,"Sudeste",31032,"Itaguara",64994,51768.6299898452,19,16,7,9,8,8,1,0,1,0,1,17,7,10,8,9,10,10.854539646147,11.0820502369248,0.393123234027362,2020-05-11,2020,5
"3059","MG",3,"Sudeste",31032,"Itaguara",64994,51768.6299898452,20,11,4,7,4,7,0,0,0,0,0,11,4,7,4,7,6,10.854539646147,11.0820502369248,0.386454296247908,2020-05-18,2020,5
"3060","MG",3,"Sudeste",31032,"Itaguara",64994,51768.6299898452,21,14,2,12,5,9,0,0,0,0,0,14,2,12,5,9,9,10.854539646147,11.0820502369248,0.392481449393842,2020-05-25,2020,5
"3061","MG",3,"Sudeste",31033,"Ouro Preto",192082,77287.5391509876,5,42,11,31,16,26,0,0,0,0,0,42,11,31,16,26,24,11.2552880204297,12.1656776431691,0.291122990223488,2020-02-03,2020,2
"3062","MG",3,"Sudeste",31033,"Ouro Preto",192082,77287.5391509876,6,33,5,28,11,22,0,0,0,0,0,33,5,28,11,22,21,11.2552880204297,12.1656776431691,0.281870087211583,2020-02-10,2020,2
"3063","MG",3,"Sudeste",31033,"Ouro Preto",192082,77287.5391509876,7,40,9,31,13,27,0,0,0,0,0,40,9,31,13,27,19,11.2552880204297,12.1656776431691,0.287859585264001,2020-02-17,2020,2
"3064","MG",3,"Sudeste",31033,"Ouro Preto",192082,77287.5391509876,8,55,6,49,17,38,0,0,0,0,0,55,6,49,17,38,23,11.2552880204297,12.1656776431691,0.359907770975788,2020-02-24,2020,2
"3065","MG",3,"Sudeste",31033,"Ouro Preto",192082,77287.5391509876,9,36,6,30,12,24,0,0,0,0,0,36,6,30,12,24,21,11.2552880204297,12.1656776431691,0.315638046194532,2020-03-02,2020,3
"3066","MG",3,"Sudeste",31033,"Ouro Preto",192082,77287.5391509876,10,32,5,27,11,21,0,0,0,0,0,32,5,27,11,21,19,11.2552880204297,12.1656776431691,0.315875974409136,2020-03-09,2020,3
"3067","MG",3,"Sudeste",31033,"Ouro Preto",192082,77287.5391509876,11,33,13,20,12,21,0,0,0,0,0,33,13,20,12,21,20,11.2552880204297,12.1656776431691,0.418819194787523,2020-03-16,2020,3
"3068","MG",3,"Sudeste",31033,"Ouro Preto",192082,77287.5391509876,12,43,6,37,15,28,0,0,0,0,0,43,6,37,15,28,23,11.2552880204297,12.1656776431691,0.542642291685753,2020-03-23,2020,3
"3069","MG",3,"Sudeste",31033,"Ouro Preto",192082,77287.5391509876,13,24,5,19,10,14,0,0,0,0,0,24,5,19,10,14,26,11.2552880204297,12.1656776431691,0.507741409889601,2020-03-30,2020,3
"3070","MG",3,"Sudeste",31033,"Ouro Preto",192082,77287.5391509876,14,33,7,26,14,19,0,0,0,0,0,33,7,26,14,19,22,11.2552880204297,12.1656776431691,0.488452794801294,2020-04-06,2020,4
"3071","MG",3,"Sudeste",31033,"Ouro Preto",192082,77287.5391509876,15,30,11,19,8,22,0,0,0,0,0,30,11,19,8,22,28,11.2552880204297,12.1656776431691,0.458648255473166,2020-04-13,2020,4
"3072","MG",3,"Sudeste",31033,"Ouro Preto",192082,77287.5391509876,16,34,10,24,14,20,0,0,0,0,0,34,10,24,14,20,20,11.2552880204297,12.1656776431691,0.466697276751275,2020-04-20,2020,4
"3073","MG",3,"Sudeste",31033,"Ouro Preto",192082,77287.5391509876,17,37,5,32,7,30,0,0,0,0,0,37,5,32,7,30,21,11.2552880204297,12.1656776431691,0.448897068889507,2020-04-27,2020,4
"3074","MG",3,"Sudeste",31033,"Ouro Preto",192082,77287.5391509876,18,41,5,36,13,28,1,1,0,0,1,42,6,36,13,29,24,11.2552880204297,12.1656776431691,0.423701185735013,2020-05-04,2020,5
"3075","MG",3,"Sudeste",31033,"Ouro Preto",192082,77287.5391509876,19,48,8,40,13,35,0,0,0,0,0,48,8,40,13,35,19,11.2552880204297,12.1656776431691,0.43269813417868,2020-05-11,2020,5
"3076","MG",3,"Sudeste",31033,"Ouro Preto",192082,77287.5391509876,20,43,7,36,15,28,0,0,0,0,0,43,7,36,15,28,30,11.2552880204297,12.1656776431691,0.425830875975005,2020-05-18,2020,5
"3077","MG",3,"Sudeste",31033,"Ouro Preto",192082,77287.5391509876,21,45,9,36,12,33,0,0,0,0,0,45,9,36,12,33,25,11.2552880204297,12.1656776431691,0.417664458213021,2020-05-25,2020,5
"3078","MG",3,"Sudeste",31034,"Conselheiro Lafaiete",273311,31862.5782602969,5,59,12,47,20,39,0,0,0,0,0,59,12,47,20,39,34,10.3691875048696,12.518365619917,0.279578206321562,2020-02-03,2020,2
"3079","MG",3,"Sudeste",31034,"Conselheiro Lafaiete",273311,31862.5782602969,6,62,9,53,21,41,0,0,0,0,0,62,9,53,21,41,33,10.3691875048696,12.518365619917,0.277448652805658,2020-02-10,2020,2
"3080","MG",3,"Sudeste",31034,"Conselheiro Lafaiete",273311,31862.5782602969,7,53,11,42,12,41,1,1,0,0,1,54,12,42,12,42,40,10.3691875048696,12.518365619917,0.287435569948456,2020-02-17,2020,2
"3081","MG",3,"Sudeste",31034,"Conselheiro Lafaiete",273311,31862.5782602969,8,47,7,40,16,31,2,1,1,0,2,49,8,41,16,33,36,10.3691875048696,12.518365619917,0.33583100756243,2020-02-24,2020,2
"3082","MG",3,"Sudeste",31034,"Conselheiro Lafaiete",273311,31862.5782602969,9,58,9,49,14,44,1,0,1,0,1,59,9,50,14,45,42,10.3691875048696,12.518365619917,0.308907488489798,2020-03-02,2020,3
"3083","MG",3,"Sudeste",31034,"Conselheiro Lafaiete",273311,31862.5782602969,10,60,9,51,14,46,1,0,1,0,1,61,9,52,14,47,29,10.3691875048696,12.518365619917,0.309085735816524,2020-03-09,2020,3
"3084","MG",3,"Sudeste",31034,"Conselheiro Lafaiete",273311,31862.5782602969,11,49,10,39,15,34,0,0,0,0,0,49,10,39,15,34,48,10.3691875048696,12.518365619917,0.397075619262665,2020-03-16,2020,3
"3085","MG",3,"Sudeste",31034,"Conselheiro Lafaiete",273311,31862.5782602969,12,60,15,45,17,43,0,0,0,0,0,60,15,45,17,43,30,10.3691875048696,12.518365619917,0.499402104826168,2020-03-23,2020,3
"3086","MG",3,"Sudeste",31034,"Conselheiro Lafaiete",273311,31862.5782602969,13,46,6,40,14,32,1,1,0,1,0,47,7,40,15,32,27,10.3691875048696,12.518365619917,0.456940779925941,2020-03-30,2020,3
"3087","MG",3,"Sudeste",31034,"Conselheiro Lafaiete",273311,31862.5782602969,14,54,8,46,18,36,0,0,0,0,0,54,8,46,18,36,28,10.3691875048696,12.518365619917,0.455414997062977,2020-04-06,2020,4
"3088","MG",3,"Sudeste",31034,"Conselheiro Lafaiete",273311,31862.5782602969,15,39,2,37,10,29,0,0,0,0,0,39,2,37,10,29,30,10.3691875048696,12.518365619917,0.433448785018809,2020-04-13,2020,4
"3089","MG",3,"Sudeste",31034,"Conselheiro Lafaiete",273311,31862.5782602969,16,68,10,58,22,46,1,0,1,0,1,69,10,59,22,47,19,10.3691875048696,12.518365619917,0.442765868222841,2020-04-20,2020,4
"3090","MG",3,"Sudeste",31034,"Conselheiro Lafaiete",273311,31862.5782602969,17,71,10,61,23,48,0,0,0,0,0,71,10,61,23,48,40,10.3691875048696,12.518365619917,0.424701086988312,2020-04-27,2020,4
"3091","MG",3,"Sudeste",31034,"Conselheiro Lafaiete",273311,31862.5782602969,18,63,11,52,20,43,0,0,0,0,0,63,11,52,20,43,24,10.3691875048696,12.518365619917,0.404593705666175,2020-05-04,2020,5
"3092","MG",3,"Sudeste",31034,"Conselheiro Lafaiete",273311,31862.5782602969,19,77,10,67,24,53,1,0,1,0,1,78,10,68,24,54,31,10.3691875048696,12.518365619917,0.415991361052676,2020-05-11,2020,5
"3093","MG",3,"Sudeste",31034,"Conselheiro Lafaiete",273311,31862.5782602969,20,61,12,49,20,41,1,0,1,0,1,62,12,50,20,42,28,10.3691875048696,12.518365619917,0.403506672492724,2020-05-18,2020,5
"3094","MG",3,"Sudeste",31034,"Conselheiro Lafaiete",273311,31862.5782602969,21,77,12,65,29,48,0,0,0,0,0,77,12,65,29,48,39,10.3691875048696,12.518365619917,0.392268031469182,2020-05-25,2020,5
"3095","MG",3,"Sudeste",31035,"Guanhães",134944,14934.2025669908,5,23,6,17,6,17,0,0,0,0,0,23,6,17,6,17,21,9.61140933565196,11.8126151565463,0.30189838115386,2020-02-03,2020,2
"3096","MG",3,"Sudeste",31035,"Guanhães",134944,14934.2025669908,6,26,9,17,7,19,0,0,0,0,0,26,9,17,7,19,19,9.61140933565196,11.8126151565463,0.295557466554133,2020-02-10,2020,2
"3097","MG",3,"Sudeste",31035,"Guanhães",134944,14934.2025669908,7,30,12,18,11,19,0,0,0,0,0,30,12,18,11,19,28,9.61140933565196,11.8126151565463,0.298093222026419,2020-02-17,2020,2
"3098","MG",3,"Sudeste",31035,"Guanhães",134944,14934.2025669908,8,31,12,19,15,16,0,0,0,0,0,31,12,19,15,16,21,9.61140933565196,11.8126151565463,0.342895939749417,2020-02-24,2020,2
"3099","MG",3,"Sudeste",31035,"Guanhães",134944,14934.2025669908,9,32,12,20,13,19,0,0,0,0,0,32,12,20,13,19,23,9.61140933565196,11.8126151565463,0.337428146892639,2020-03-02,2020,3
"3100","MG",3,"Sudeste",31035,"Guanhães",134944,14934.2025669908,10,27,6,21,9,18,0,0,0,0,0,27,6,21,9,18,23,9.61140933565196,11.8126151565463,0.325126473441691,2020-03-09,2020,3
"3101","MG",3,"Sudeste",31035,"Guanhães",134944,14934.2025669908,11,15,2,13,8,7,0,0,0,0,0,15,2,13,8,7,23,9.61140933565196,11.8126151565463,0.403273971225627,2020-03-16,2020,3
"3102","MG",3,"Sudeste",31035,"Guanhães",134944,14934.2025669908,12,22,6,16,7,15,0,0,0,0,0,22,6,16,7,15,15,9.61140933565196,11.8126151565463,0.522899466810038,2020-03-23,2020,3
"3103","MG",3,"Sudeste",31035,"Guanhães",134944,14934.2025669908,13,21,4,17,2,19,0,0,0,0,0,21,4,17,2,19,12,9.61140933565196,11.8126151565463,0.489589957421358,2020-03-30,2020,3
"3104","MG",3,"Sudeste",31035,"Guanhães",134944,14934.2025669908,14,32,8,24,13,19,0,0,0,0,0,32,8,24,13,19,20,9.61140933565196,11.8126151565463,0.46188223104267,2020-04-06,2020,4
"3105","MG",3,"Sudeste",31035,"Guanhães",134944,14934.2025669908,15,22,7,15,10,12,0,0,0,0,0,22,7,15,10,12,12,9.61140933565196,11.8126151565463,0.436300343200885,2020-04-13,2020,4
"3106","MG",3,"Sudeste",31035,"Guanhães",134944,14934.2025669908,16,27,4,23,12,15,1,0,1,0,1,28,4,24,12,16,23,9.61140933565196,11.8126151565463,0.435199120780893,2020-04-20,2020,4
"3107","MG",3,"Sudeste",31035,"Guanhães",134944,14934.2025669908,17,30,10,20,11,19,1,0,1,0,1,31,10,21,11,20,20,9.61140933565196,11.8126151565463,0.414517008403865,2020-04-27,2020,4
"3108","MG",3,"Sudeste",31035,"Guanhães",134944,14934.2025669908,18,34,7,27,19,15,1,1,0,1,0,35,8,27,20,15,16,9.61140933565196,11.8126151565463,0.389224160915573,2020-05-04,2020,5
"3109","MG",3,"Sudeste",31035,"Guanhães",134944,14934.2025669908,19,32,7,25,10,22,0,0,0,0,0,32,7,25,10,22,15,9.61140933565196,11.8126151565463,0.41450636530487,2020-05-11,2020,5
"3110","MG",3,"Sudeste",31035,"Guanhães",134944,14934.2025669908,20,36,6,30,11,25,0,0,0,0,0,36,6,30,11,25,12,9.61140933565196,11.8126151565463,0.408159374820322,2020-05-18,2020,5
"3111","MG",3,"Sudeste",31035,"Guanhães",134944,14934.2025669908,21,37,13,24,11,26,0,0,0,0,0,37,13,24,11,26,16,9.61140933565196,11.8126151565463,0.40419034865184,2020-05-25,2020,5
"3112","MG",3,"Sudeste",31036,"Peçanha",80355,9899.13954178334,5,22,10,12,13,9,0,0,0,0,0,22,10,12,13,9,10,9.20020311737398,11.2942095969832,0.304507792205683,2020-02-03,2020,2
"3113","MG",3,"Sudeste",31036,"Peçanha",80355,9899.13954178334,6,20,9,11,9,11,3,2,1,1,2,23,11,12,10,13,7,9.20020311737398,11.2942095969832,0.291377862695256,2020-02-10,2020,2
"3114","MG",3,"Sudeste",31036,"Peçanha",80355,9899.13954178334,7,15,4,11,4,11,0,0,0,0,0,15,4,11,4,11,14,9.20020311737398,11.2942095969832,0.324970181831036,2020-02-17,2020,2
"3115","MG",3,"Sudeste",31036,"Peçanha",80355,9899.13954178334,8,14,5,9,7,7,0,0,0,0,0,14,5,9,7,7,13,9.20020311737398,11.2942095969832,0.370069260195342,2020-02-24,2020,2
"3116","MG",3,"Sudeste",31036,"Peçanha",80355,9899.13954178334,9,9,5,4,5,4,0,0,0,0,0,9,5,4,5,4,11,9.20020311737398,11.2942095969832,0.346204790913014,2020-03-02,2020,3
"3117","MG",3,"Sudeste",31036,"Peçanha",80355,9899.13954178334,10,16,6,10,5,11,2,0,2,1,1,18,6,12,6,12,11,9.20020311737398,11.2942095969832,0.347419600494703,2020-03-09,2020,3
"3118","MG",3,"Sudeste",31036,"Peçanha",80355,9899.13954178334,11,15,5,10,7,8,0,0,0,0,0,15,5,10,7,8,14,9.20020311737398,11.2942095969832,0.409899195049614,2020-03-16,2020,3
"3119","MG",3,"Sudeste",31036,"Peçanha",80355,9899.13954178334,12,16,4,12,5,11,1,1,0,0,1,17,5,12,5,12,6,9.20020311737398,11.2942095969832,0.542482852730558,2020-03-23,2020,3
"3120","MG",3,"Sudeste",31036,"Peçanha",80355,9899.13954178334,13,13,3,10,3,10,0,0,0,0,0,13,3,10,3,10,7,9.20020311737398,11.2942095969832,0.452065352346626,2020-03-30,2020,3
"3121","MG",3,"Sudeste",31036,"Peçanha",80355,9899.13954178334,14,10,3,7,3,7,0,0,0,0,0,10,3,7,3,7,8,9.20020311737398,11.2942095969832,0.486162545003163,2020-04-06,2020,4
"3122","MG",3,"Sudeste",31036,"Peçanha",80355,9899.13954178334,15,12,5,7,7,5,0,0,0,0,0,12,5,7,7,5,13,9.20020311737398,11.2942095969832,0.400390007904321,2020-04-13,2020,4
"3123","MG",3,"Sudeste",31036,"Peçanha",80355,9899.13954178334,16,17,6,11,8,9,1,0,1,0,1,18,6,12,8,10,8,9.20020311737398,11.2942095969832,0.414193079675235,2020-04-20,2020,4
"3124","MG",3,"Sudeste",31036,"Peçanha",80355,9899.13954178334,17,16,5,11,6,10,0,0,0,0,0,16,5,11,6,10,9,9.20020311737398,11.2942095969832,0.397589856589494,2020-04-27,2020,4
"3125","MG",3,"Sudeste",31036,"Peçanha",80355,9899.13954178334,18,15,8,7,8,7,0,0,0,0,0,15,8,7,8,7,6,9.20020311737398,11.2942095969832,0.378295710625956,2020-05-04,2020,5
"3126","MG",3,"Sudeste",31036,"Peçanha",80355,9899.13954178334,19,14,3,11,8,6,0,0,0,0,0,14,3,11,8,6,9,9.20020311737398,11.2942095969832,0.423856564295404,2020-05-11,2020,5
"3127","MG",3,"Sudeste",31036,"Peçanha",80355,9899.13954178334,20,24,7,17,10,14,0,0,0,0,0,24,7,17,10,14,8,9.20020311737398,11.2942095969832,0.378597423534681,2020-05-18,2020,5
"3128","MG",3,"Sudeste",31036,"Peçanha",80355,9899.13954178334,21,16,2,14,2,14,0,0,0,0,0,16,2,14,2,14,7,9.20020311737398,11.2942095969832,0.373229702063519,2020-05-25,2020,5
"3129","MG",3,"Sudeste",31037,"Governador Valadares",436696,18010.6600367304,5,90,15,75,31,59,1,0,1,0,1,91,15,76,31,60,66,9.79871908584552,12.9869925798256,0.291650495297489,2020-02-03,2020,2
"3130","MG",3,"Sudeste",31037,"Governador Valadares",436696,18010.6600367304,6,89,23,66,28,61,0,0,0,0,0,89,23,66,28,61,65,9.79871908584552,12.9869925798256,0.280304548639886,2020-02-10,2020,2
"3131","MG",3,"Sudeste",31037,"Governador Valadares",436696,18010.6600367304,7,84,18,66,27,57,0,0,0,0,0,84,18,66,27,57,55,9.79871908584552,12.9869925798256,0.299840542120079,2020-02-17,2020,2
"3132","MG",3,"Sudeste",31037,"Governador Valadares",436696,18010.6600367304,8,79,9,70,25,54,0,0,0,0,0,79,9,70,25,54,56,9.79871908584552,12.9869925798256,0.350517690646729,2020-02-24,2020,2
"3133","MG",3,"Sudeste",31037,"Governador Valadares",436696,18010.6600367304,9,97,22,75,37,60,1,0,1,0,1,98,22,76,37,61,64,9.79871908584552,12.9869925798256,0.334263843398114,2020-03-02,2020,3
"3134","MG",3,"Sudeste",31037,"Governador Valadares",436696,18010.6600367304,10,91,22,69,28,63,0,0,0,0,0,91,22,69,28,63,69,9.79871908584552,12.9869925798256,0.322680615928029,2020-03-09,2020,3
"3135","MG",3,"Sudeste",31037,"Governador Valadares",436696,18010.6600367304,11,92,20,72,37,55,0,0,0,0,0,92,20,72,37,55,67,9.79871908584552,12.9869925798256,0.401533769171015,2020-03-16,2020,3
"3136","MG",3,"Sudeste",31037,"Governador Valadares",436696,18010.6600367304,12,79,21,58,28,51,1,1,0,0,1,80,22,58,28,52,65,9.79871908584552,12.9869925798256,0.52037813039777,2020-03-23,2020,3
"3137","MG",3,"Sudeste",31037,"Governador Valadares",436696,18010.6600367304,13,77,14,63,33,44,2,0,2,0,2,79,14,65,33,46,71,9.79871908584552,12.9869925798256,0.466632893756926,2020-03-30,2020,3
"3138","MG",3,"Sudeste",31037,"Governador Valadares",436696,18010.6600367304,14,76,15,61,38,38,1,1,0,1,0,77,16,61,39,38,70,9.79871908584552,12.9869925798256,0.456623446992095,2020-04-06,2020,4
"3139","MG",3,"Sudeste",31037,"Governador Valadares",436696,18010.6600367304,15,108,22,86,36,72,0,0,0,0,0,108,22,86,36,72,53,9.79871908584552,12.9869925798256,0.415597141239814,2020-04-13,2020,4
"3140","MG",3,"Sudeste",31037,"Governador Valadares",436696,18010.6600367304,16,104,27,77,46,58,2,0,2,1,1,106,27,79,47,59,64,9.79871908584552,12.9869925798256,0.415620264649738,2020-04-20,2020,4
"3141","MG",3,"Sudeste",31037,"Governador Valadares",436696,18010.6600367304,17,102,29,73,41,61,1,0,1,1,0,103,29,74,42,61,57,9.79871908584552,12.9869925798256,0.4071316472049,2020-04-27,2020,4
"3142","MG",3,"Sudeste",31037,"Governador Valadares",436696,18010.6600367304,18,102,26,76,34,68,2,0,2,0,2,104,26,78,34,70,68,9.79871908584552,12.9869925798256,0.377513398669691,2020-05-04,2020,5
"3143","MG",3,"Sudeste",31037,"Governador Valadares",436696,18010.6600367304,19,121,34,87,41,80,1,0,1,0,1,122,34,88,41,81,69,9.79871908584552,12.9869925798256,0.396761087022283,2020-05-11,2020,5
"3144","MG",3,"Sudeste",31037,"Governador Valadares",436696,18010.6600367304,20,137,32,105,59,78,2,1,1,2,0,139,33,106,61,78,65,9.79871908584552,12.9869925798256,0.380781565961101,2020-05-18,2020,5
"3145","MG",3,"Sudeste",31037,"Governador Valadares",436696,18010.6600367304,21,100,29,71,49,51,2,1,1,0,2,102,30,72,49,53,80,9.79871908584552,12.9869925798256,0.387404743943181,2020-05-25,2020,5
"3146","MG",3,"Sudeste",31038,"Mantena",65123,11860.1728530627,5,14,5,9,7,7,0,0,0,0,0,14,5,9,7,7,9,9.38094124690273,11.0840330684114,0.281411221713567,2020-02-03,2020,2
"3147","MG",3,"Sudeste",31038,"Mantena",65123,11860.1728530627,6,12,3,9,4,8,0,0,0,0,0,12,3,9,4,8,17,9.38094124690273,11.0840330684114,0.273762465478701,2020-02-10,2020,2
"3148","MG",3,"Sudeste",31038,"Mantena",65123,11860.1728530627,7,11,3,8,4,7,2,0,2,2,0,13,3,10,6,7,7,9.38094124690273,11.0840330684114,0.295167701057831,2020-02-17,2020,2
"3149","MG",3,"Sudeste",31038,"Mantena",65123,11860.1728530627,8,12,2,10,4,8,0,0,0,0,0,12,2,10,4,8,9,9.38094124690273,11.0840330684114,0.336514342528205,2020-02-24,2020,2
"3150","MG",3,"Sudeste",31038,"Mantena",65123,11860.1728530627,9,11,5,6,5,6,0,0,0,0,0,11,5,6,5,6,7,9.38094124690273,11.0840330684114,0.324839967156172,2020-03-02,2020,3
"3151","MG",3,"Sudeste",31038,"Mantena",65123,11860.1728530627,10,10,1,9,6,4,0,0,0,0,0,10,1,9,6,4,7,9.38094124690273,11.0840330684114,0.315567587762903,2020-03-09,2020,3
"3152","MG",3,"Sudeste",31038,"Mantena",65123,11860.1728530627,11,19,4,15,8,11,1,0,1,0,1,20,4,16,8,12,6,9.38094124690273,11.0840330684114,0.367880404213064,2020-03-16,2020,3
"3153","MG",3,"Sudeste",31038,"Mantena",65123,11860.1728530627,12,11,3,8,5,6,0,0,0,0,0,11,3,8,5,6,6,9.38094124690273,11.0840330684114,0.490312506274255,2020-03-23,2020,3
"3154","MG",3,"Sudeste",31038,"Mantena",65123,11860.1728530627,13,7,2,5,6,1,0,0,0,0,0,7,2,5,6,1,6,9.38094124690273,11.0840330684114,0.420280280689222,2020-03-30,2020,3
"3155","MG",3,"Sudeste",31038,"Mantena",65123,11860.1728530627,14,12,2,10,3,9,0,0,0,0,0,12,2,10,3,9,2,9.38094124690273,11.0840330684114,0.426925136849951,2020-04-06,2020,4
"3156","MG",3,"Sudeste",31038,"Mantena",65123,11860.1728530627,15,13,1,12,9,4,0,0,0,0,0,13,1,12,9,4,6,9.38094124690273,11.0840330684114,0.382711263916316,2020-04-13,2020,4
"3157","MG",3,"Sudeste",31038,"Mantena",65123,11860.1728530627,16,14,0,14,3,11,1,1,0,1,0,15,1,14,4,11,7,9.38094124690273,11.0840330684114,0.405524386934113,2020-04-20,2020,4
"3158","MG",3,"Sudeste",31038,"Mantena",65123,11860.1728530627,17,7,3,4,3,4,0,0,0,0,0,7,3,4,3,4,11,9.38094124690273,11.0840330684114,0.392222116885179,2020-04-27,2020,4
"3159","MG",3,"Sudeste",31038,"Mantena",65123,11860.1728530627,18,11,3,8,4,7,0,0,0,0,0,11,3,8,4,7,7,9.38094124690273,11.0840330684114,0.380427694708634,2020-05-04,2020,5
"3160","MG",3,"Sudeste",31038,"Mantena",65123,11860.1728530627,19,16,5,11,9,7,0,0,0,0,0,16,5,11,9,7,3,9.38094124690273,11.0840330684114,0.406691991626374,2020-05-11,2020,5
"3161","MG",3,"Sudeste",31038,"Mantena",65123,11860.1728530627,20,7,1,6,2,5,0,0,0,0,0,7,1,6,2,5,12,9.38094124690273,11.0840330684114,0.386917271940491,2020-05-18,2020,5
"3162","MG",3,"Sudeste",31038,"Mantena",65123,11860.1728530627,21,13,2,11,3,10,0,0,0,0,0,13,2,11,3,10,13,9.38094124690273,11.0840330684114,0.396011355038949,2020-05-25,2020,5
"3163","MG",3,"Sudeste",31039,"Ipatinga",578295,34166.7528004565,5,117,19,98,29,88,3,0,3,2,1,120,19,101,31,89,49,10.4390083098783,13.2678393980775,0.296090033141473,2020-02-03,2020,2
"3164","MG",3,"Sudeste",31039,"Ipatinga",578295,34166.7528004565,6,135,16,119,46,89,0,0,0,0,0,135,16,119,46,89,68,10.4390083098783,13.2678393980775,0.293400695817068,2020-02-10,2020,2
"3165","MG",3,"Sudeste",31039,"Ipatinga",578295,34166.7528004565,7,112,13,99,31,81,3,0,3,2,1,115,13,102,33,82,80,10.4390083098783,13.2678393980775,0.30661606743927,2020-02-17,2020,2
"3166","MG",3,"Sudeste",31039,"Ipatinga",578295,34166.7528004565,8,101,10,91,24,77,0,0,0,0,0,101,10,91,24,77,53,10.4390083098783,13.2678393980775,0.356645090189998,2020-02-24,2020,2
"3167","MG",3,"Sudeste",31039,"Ipatinga",578295,34166.7528004565,9,118,27,91,44,74,2,0,2,0,2,120,27,93,44,76,74,10.4390083098783,13.2678393980775,0.336036904088938,2020-03-02,2020,3
"3168","MG",3,"Sudeste",31039,"Ipatinga",578295,34166.7528004565,10,118,23,95,40,78,1,0,1,0,1,119,23,96,40,79,78,10.4390083098783,13.2678393980775,0.331267445786091,2020-03-09,2020,3
"3169","MG",3,"Sudeste",31039,"Ipatinga",578295,34166.7528004565,11,108,8,100,30,78,1,0,1,1,0,109,8,101,31,78,64,10.4390083098783,13.2678393980775,0.431234883927341,2020-03-16,2020,3
"3170","MG",3,"Sudeste",31039,"Ipatinga",578295,34166.7528004565,12,105,15,90,36,69,2,0,2,0,2,107,15,92,36,71,58,10.4390083098783,13.2678393980775,0.542234499602701,2020-03-23,2020,3
"3171","MG",3,"Sudeste",31039,"Ipatinga",578295,34166.7528004565,13,102,16,86,38,64,1,0,1,0,1,103,16,87,38,65,64,10.4390083098783,13.2678393980775,0.484174774845995,2020-03-30,2020,3
"3172","MG",3,"Sudeste",31039,"Ipatinga",578295,34166.7528004565,14,120,20,100,29,91,0,0,0,0,0,120,20,100,29,91,56,10.4390083098783,13.2678393980775,0.472571719102073,2020-04-06,2020,4
"3173","MG",3,"Sudeste",31039,"Ipatinga",578295,34166.7528004565,15,120,12,108,39,81,2,0,2,1,1,122,12,110,40,82,61,10.4390083098783,13.2678393980775,0.430456151955359,2020-04-13,2020,4
"3174","MG",3,"Sudeste",31039,"Ipatinga",578295,34166.7528004565,16,138,26,112,39,99,3,1,2,0,3,141,27,114,39,102,73,10.4390083098783,13.2678393980775,0.438189411654787,2020-04-20,2020,4
"3175","MG",3,"Sudeste",31039,"Ipatinga",578295,34166.7528004565,17,116,20,96,44,72,0,0,0,0,0,116,20,96,44,72,51,10.4390083098783,13.2678393980775,0.426730056668846,2020-04-27,2020,4
"3176","MG",3,"Sudeste",31039,"Ipatinga",578295,34166.7528004565,18,121,25,96,32,89,0,0,0,0,0,121,25,96,32,89,55,10.4390083098783,13.2678393980775,0.391922842359473,2020-05-04,2020,5
"3177","MG",3,"Sudeste",31039,"Ipatinga",578295,34166.7528004565,19,137,26,111,37,100,0,0,0,0,0,137,26,111,37,100,70,10.4390083098783,13.2678393980775,0.410867573110809,2020-05-11,2020,5
"3178","MG",3,"Sudeste",31039,"Ipatinga",578295,34166.7528004565,20,163,28,135,44,119,1,0,1,0,1,164,28,136,44,120,53,10.4390083098783,13.2678393980775,0.396902145129844,2020-05-18,2020,5
"3179","MG",3,"Sudeste",31039,"Ipatinga",578295,34166.7528004565,21,131,18,113,39,92,1,0,1,1,0,132,18,114,40,92,74,10.4390083098783,13.2678393980775,0.406106148706991,2020-05-25,2020,5
"3180","MG",3,"Sudeste",31040,"Caratinga",267565,13146.9932309906,5,58,18,40,17,41,0,0,0,0,0,58,18,40,17,41,29,9.48394835982544,12.497117806455,0.326339588180414,2020-02-03,2020,2
"3181","MG",3,"Sudeste",31040,"Caratinga",267565,13146.9932309906,6,60,17,43,25,35,0,0,0,0,0,60,17,43,25,35,35,9.48394835982544,12.497117806455,0.310884613451896,2020-02-10,2020,2
"3182","MG",3,"Sudeste",31040,"Caratinga",267565,13146.9932309906,7,69,20,49,24,45,0,0,0,0,0,69,20,49,24,45,40,9.48394835982544,12.497117806455,0.332205329446999,2020-02-17,2020,2
"3183","MG",3,"Sudeste",31040,"Caratinga",267565,13146.9932309906,8,52,21,31,20,32,0,0,0,0,0,52,21,31,20,32,33,9.48394835982544,12.497117806455,0.384431359168641,2020-02-24,2020,2
"3184","MG",3,"Sudeste",31040,"Caratinga",267565,13146.9932309906,9,67,19,48,24,43,1,0,1,0,1,68,19,49,24,44,33,9.48394835982544,12.497117806455,0.376278384330336,2020-03-02,2020,3
"3185","MG",3,"Sudeste",31040,"Caratinga",267565,13146.9932309906,10,56,17,39,17,39,0,0,0,0,0,56,17,39,17,39,39,9.48394835982544,12.497117806455,0.356185039776292,2020-03-09,2020,3
"3186","MG",3,"Sudeste",31040,"Caratinga",267565,13146.9932309906,11,65,22,43,31,34,0,0,0,0,0,65,22,43,31,34,31,9.48394835982544,12.497117806455,0.433880713567932,2020-03-16,2020,3
"3187","MG",3,"Sudeste",31040,"Caratinga",267565,13146.9932309906,12,54,14,40,19,35,1,1,0,0,1,55,15,40,19,36,33,9.48394835982544,12.497117806455,0.537330357219614,2020-03-23,2020,3
"3188","MG",3,"Sudeste",31040,"Caratinga",267565,13146.9932309906,13,38,9,29,17,21,1,1,0,1,0,39,10,29,18,21,31,9.48394835982544,12.497117806455,0.488814907565621,2020-03-30,2020,3
"3189","MG",3,"Sudeste",31040,"Caratinga",267565,13146.9932309906,14,59,14,45,28,31,1,0,1,0,1,60,14,46,28,32,34,9.48394835982544,12.497117806455,0.47302515263292,2020-04-06,2020,4
"3190","MG",3,"Sudeste",31040,"Caratinga",267565,13146.9932309906,15,43,12,31,13,30,0,0,0,0,0,43,12,31,13,30,39,9.48394835982544,12.497117806455,0.426211258031508,2020-04-13,2020,4
"3191","MG",3,"Sudeste",31040,"Caratinga",267565,13146.9932309906,16,73,17,56,28,45,1,0,1,1,0,74,17,57,29,45,29,9.48394835982544,12.497117806455,0.44089099452583,2020-04-20,2020,4
"3192","MG",3,"Sudeste",31040,"Caratinga",267565,13146.9932309906,17,61,15,46,21,40,0,0,0,0,0,61,15,46,21,40,31,9.48394835982544,12.497117806455,0.445137931878418,2020-04-27,2020,4
"3193","MG",3,"Sudeste",31040,"Caratinga",267565,13146.9932309906,18,55,12,43,21,34,0,0,0,0,0,55,12,43,21,34,38,9.48394835982544,12.497117806455,0.416492822068961,2020-05-04,2020,5
"3194","MG",3,"Sudeste",31040,"Caratinga",267565,13146.9932309906,19,84,23,61,28,56,2,0,2,1,1,86,23,63,29,57,34,9.48394835982544,12.497117806455,0.428165485673596,2020-05-11,2020,5
"3195","MG",3,"Sudeste",31040,"Caratinga",267565,13146.9932309906,20,92,32,60,33,59,1,0,1,0,1,93,32,61,33,60,40,9.48394835982544,12.497117806455,0.411190409418567,2020-05-18,2020,5
"3196","MG",3,"Sudeste",31040,"Caratinga",267565,13146.9932309906,21,64,21,43,23,41,1,0,1,1,0,65,21,44,24,41,35,9.48394835982544,12.497117806455,0.426342283778168,2020-05-25,2020,5
"3197","MG",3,"Sudeste",31041,"Aimorés",152232,13311.2223726286,5,26,9,17,11,15,1,0,1,0,1,27,9,18,11,16,24,9.49636274583706,11.9331609519818,0.311376166463079,2020-02-03,2020,2
"3198","MG",3,"Sudeste",31041,"Aimorés",152232,13311.2223726286,6,34,11,23,16,18,0,0,0,0,0,34,11,23,16,18,19,9.49636274583706,11.9331609519818,0.309989506622291,2020-02-10,2020,2
"3199","MG",3,"Sudeste",31041,"Aimorés",152232,13311.2223726286,7,29,11,18,7,22,1,0,1,0,1,30,11,19,7,23,29,9.49636274583706,11.9331609519818,0.316642255534676,2020-02-17,2020,2
"3200","MG",3,"Sudeste",31041,"Aimorés",152232,13311.2223726286,8,42,15,27,18,24,1,1,0,0,1,43,16,27,18,25,27,9.49636274583706,11.9331609519818,0.356396123064428,2020-02-24,2020,2
"3201","MG",3,"Sudeste",31041,"Aimorés",152232,13311.2223726286,9,38,13,25,17,21,0,0,0,0,0,38,13,25,17,21,21,9.49636274583706,11.9331609519818,0.347272104068773,2020-03-02,2020,3
"3202","MG",3,"Sudeste",31041,"Aimorés",152232,13311.2223726286,10,30,8,22,14,16,1,1,0,0,1,31,9,22,14,17,26,9.49636274583706,11.9331609519818,0.350349500352664,2020-03-09,2020,3
"3203","MG",3,"Sudeste",31041,"Aimorés",152232,13311.2223726286,11,32,12,20,9,23,0,0,0,0,0,32,12,20,9,23,23,9.49636274583706,11.9331609519818,0.4136420257544,2020-03-16,2020,3
"3204","MG",3,"Sudeste",31041,"Aimorés",152232,13311.2223726286,12,42,20,22,12,30,0,0,0,0,0,42,20,22,12,30,29,9.49636274583706,11.9331609519818,0.520392232823141,2020-03-23,2020,3
"3205","MG",3,"Sudeste",31041,"Aimorés",152232,13311.2223726286,13,29,14,15,10,19,0,0,0,0,0,29,14,15,10,19,24,9.49636274583706,11.9331609519818,0.458061498912582,2020-03-30,2020,3
"3206","MG",3,"Sudeste",31041,"Aimorés",152232,13311.2223726286,14,22,3,19,11,11,0,0,0,0,0,22,3,19,11,11,16,9.49636274583706,11.9331609519818,0.460708030641313,2020-04-06,2020,4
"3207","MG",3,"Sudeste",31041,"Aimorés",152232,13311.2223726286,15,25,8,17,7,18,0,0,0,0,0,25,8,17,7,18,21,9.49636274583706,11.9331609519818,0.419888325318189,2020-04-13,2020,4
"3208","MG",3,"Sudeste",31041,"Aimorés",152232,13311.2223726286,16,34,11,23,8,26,0,0,0,0,0,34,11,23,8,26,22,9.49636274583706,11.9331609519818,0.425832060463877,2020-04-20,2020,4
"3209","MG",3,"Sudeste",31041,"Aimorés",152232,13311.2223726286,17,30,8,22,13,17,0,0,0,0,0,30,8,22,13,17,14,9.49636274583706,11.9331609519818,0.414198383763661,2020-04-27,2020,4
"3210","MG",3,"Sudeste",31041,"Aimorés",152232,13311.2223726286,18,21,9,12,11,10,0,0,0,0,0,21,9,12,11,10,25,9.49636274583706,11.9331609519818,0.408394315788149,2020-05-04,2020,5
"3211","MG",3,"Sudeste",31041,"Aimorés",152232,13311.2223726286,19,25,8,17,9,16,0,0,0,0,0,25,8,17,9,16,24,9.49636274583706,11.9331609519818,0.424946626944316,2020-05-11,2020,5
"3212","MG",3,"Sudeste",31041,"Aimorés",152232,13311.2223726286,20,42,12,30,11,31,0,0,0,0,0,42,12,30,11,31,28,9.49636274583706,11.9331609519818,0.406875591460261,2020-05-18,2020,5
"3213","MG",3,"Sudeste",31041,"Aimorés",152232,13311.2223726286,21,32,11,21,14,18,0,0,0,0,0,32,11,21,14,18,18,9.49636274583706,11.9331609519818,0.437993846487946,2020-05-25,2020,5
"3214","MG",3,"Sudeste",31042,"Piuí",86391,27126.6196672107,5,17,2,15,9,8,0,0,0,0,0,17,2,15,9,8,15,10.2082708002937,11.3666387826998,0.297606621513044,2020-02-03,2020,2
"3215","MG",3,"Sudeste",31042,"Piuí",86391,27126.6196672107,6,16,2,14,6,10,0,0,0,0,0,16,2,14,6,10,12,10.2082708002937,11.3666387826998,0.271120554362304,2020-02-10,2020,2
"3216","MG",3,"Sudeste",31042,"Piuí",86391,27126.6196672107,7,12,1,11,4,8,0,0,0,0,0,12,1,11,4,8,12,10.2082708002937,11.3666387826998,0.285482432994878,2020-02-17,2020,2
"3217","MG",3,"Sudeste",31042,"Piuí",86391,27126.6196672107,8,17,2,15,7,10,0,0,0,0,0,17,2,15,7,10,9,10.2082708002937,11.3666387826998,0.338909855098521,2020-02-24,2020,2
"3218","MG",3,"Sudeste",31042,"Piuí",86391,27126.6196672107,9,22,7,15,8,14,1,1,0,0,1,23,8,15,8,15,8,10.2082708002937,11.3666387826998,0.30312899923467,2020-03-02,2020,3
"3219","MG",3,"Sudeste",31042,"Piuí",86391,27126.6196672107,10,19,4,15,8,11,0,0,0,0,0,19,4,15,8,11,16,10.2082708002937,11.3666387826998,0.312027264584482,2020-03-09,2020,3
"3220","MG",3,"Sudeste",31042,"Piuí",86391,27126.6196672107,11,11,0,11,4,7,0,0,0,0,0,11,0,11,4,7,13,10.2082708002937,11.3666387826998,0.393944440321422,2020-03-16,2020,3
"3221","MG",3,"Sudeste",31042,"Piuí",86391,27126.6196672107,12,17,2,15,6,11,0,0,0,0,0,17,2,15,6,11,7,10.2082708002937,11.3666387826998,0.476819577036906,2020-03-23,2020,3
"3222","MG",3,"Sudeste",31042,"Piuí",86391,27126.6196672107,13,9,1,8,3,6,0,0,0,0,0,9,1,8,3,6,17,10.2082708002937,11.3666387826998,0.441662952401149,2020-03-30,2020,3
"3223","MG",3,"Sudeste",31042,"Piuí",86391,27126.6196672107,14,19,3,16,9,10,0,0,0,0,0,19,3,16,9,10,12,10.2082708002937,11.3666387826998,0.429572840890264,2020-04-06,2020,4
"3224","MG",3,"Sudeste",31042,"Piuí",86391,27126.6196672107,15,14,4,10,7,7,0,0,0,0,0,14,4,10,7,7,13,10.2082708002937,11.3666387826998,0.412419734792288,2020-04-13,2020,4
"3225","MG",3,"Sudeste",31042,"Piuí",86391,27126.6196672107,16,19,4,15,6,13,0,0,0,0,0,19,4,15,6,13,18,10.2082708002937,11.3666387826998,0.404940958036849,2020-04-20,2020,4
"3226","MG",3,"Sudeste",31042,"Piuí",86391,27126.6196672107,17,15,4,11,4,11,0,0,0,0,0,15,4,11,4,11,12,10.2082708002937,11.3666387826998,0.399585804777926,2020-04-27,2020,4
"3227","MG",3,"Sudeste",31042,"Piuí",86391,27126.6196672107,18,14,7,7,4,10,0,0,0,0,0,14,7,7,4,10,17,10.2082708002937,11.3666387826998,0.364001796862253,2020-05-04,2020,5
"3228","MG",3,"Sudeste",31042,"Piuí",86391,27126.6196672107,19,19,6,13,5,14,0,0,0,0,0,19,6,13,5,14,20,10.2082708002937,11.3666387826998,0.376127129224194,2020-05-11,2020,5
"3229","MG",3,"Sudeste",31042,"Piuí",86391,27126.6196672107,20,16,5,11,8,8,0,0,0,0,0,16,5,11,8,8,12,10.2082708002937,11.3666387826998,0.394155436434809,2020-05-18,2020,5
"3230","MG",3,"Sudeste",31042,"Piuí",86391,27126.6196672107,21,21,4,17,8,13,0,0,0,0,0,21,4,17,8,13,10,10.2082708002937,11.3666387826998,0.376098097101829,2020-05-25,2020,5
"3231","MG",3,"Sudeste",31043,"Divinópolis",567507,27258.1728047407,5,122,22,100,42,80,2,1,1,0,2,124,23,101,42,82,51,10.2131086745646,13.2490083630634,0.281023952120473,2020-02-03,2020,2
"3232","MG",3,"Sudeste",31043,"Divinópolis",567507,27258.1728047407,6,135,18,117,33,102,1,1,0,1,0,136,19,117,34,102,56,10.2131086745646,13.2490083630634,0.278268516883831,2020-02-10,2020,2
"3233","MG",3,"Sudeste",31043,"Divinópolis",567507,27258.1728047407,7,116,20,96,32,84,1,0,1,0,1,117,20,97,32,85,50,10.2131086745646,13.2490083630634,0.287233440593803,2020-02-17,2020,2
"3234","MG",3,"Sudeste",31043,"Divinópolis",567507,27258.1728047407,8,132,18,114,30,102,2,1,1,0,2,134,19,115,30,104,68,10.2131086745646,13.2490083630634,0.341886113942348,2020-02-24,2020,2
"3235","MG",3,"Sudeste",31043,"Divinópolis",567507,27258.1728047407,9,128,25,103,37,91,3,2,1,1,2,131,27,104,38,93,64,10.2131086745646,13.2490083630634,0.304984754850175,2020-03-02,2020,3
"3236","MG",3,"Sudeste",31043,"Divinópolis",567507,27258.1728047407,10,136,22,114,39,97,0,0,0,0,0,136,22,114,39,97,50,10.2131086745646,13.2490083630634,0.312529625299481,2020-03-09,2020,3
"3237","MG",3,"Sudeste",31043,"Divinópolis",567507,27258.1728047407,11,121,19,102,36,85,2,1,1,1,1,123,20,103,37,86,71,10.2131086745646,13.2490083630634,0.390754745380967,2020-03-16,2020,3
"3238","MG",3,"Sudeste",31043,"Divinópolis",567507,27258.1728047407,12,109,31,78,37,72,2,1,1,1,1,111,32,79,38,73,63,10.2131086745646,13.2490083630634,0.513797251032031,2020-03-23,2020,3
"3239","MG",3,"Sudeste",31043,"Divinópolis",567507,27258.1728047407,13,113,19,94,33,80,0,0,0,0,0,113,19,94,33,80,59,10.2131086745646,13.2490083630634,0.47468521640007,2020-03-30,2020,3
"3240","MG",3,"Sudeste",31043,"Divinópolis",567507,27258.1728047407,14,132,24,108,45,87,3,1,2,2,1,135,25,110,47,88,56,10.2131086745646,13.2490083630634,0.452182879539902,2020-04-06,2020,4
"3241","MG",3,"Sudeste",31043,"Divinópolis",567507,27258.1728047407,15,108,19,89,38,70,0,0,0,0,0,108,19,89,38,70,52,10.2131086745646,13.2490083630634,0.421475939884949,2020-04-13,2020,4
"3242","MG",3,"Sudeste",31043,"Divinópolis",567507,27258.1728047407,16,139,16,123,40,99,0,0,0,0,0,139,16,123,40,99,67,10.2131086745646,13.2490083630634,0.425952573883079,2020-04-20,2020,4
"3243","MG",3,"Sudeste",31043,"Divinópolis",567507,27258.1728047407,17,134,22,112,40,94,1,0,1,0,1,135,22,113,40,95,64,10.2131086745646,13.2490083630634,0.40960066098829,2020-04-27,2020,4
"3244","MG",3,"Sudeste",31043,"Divinópolis",567507,27258.1728047407,18,130,34,96,36,94,0,0,0,0,0,130,34,96,36,94,50,10.2131086745646,13.2490083630634,0.37904150582636,2020-05-04,2020,5
"3245","MG",3,"Sudeste",31043,"Divinópolis",567507,27258.1728047407,19,142,29,113,45,97,0,0,0,0,0,142,29,113,45,97,55,10.2131086745646,13.2490083630634,0.382792064712948,2020-05-11,2020,5
"3246","MG",3,"Sudeste",31043,"Divinópolis",567507,27258.1728047407,20,135,24,111,46,89,2,2,0,1,1,137,26,111,47,90,49,10.2131086745646,13.2490083630634,0.381349207190808,2020-05-18,2020,5
"3247","MG",3,"Sudeste",31043,"Divinópolis",567507,27258.1728047407,21,167,17,150,46,121,1,0,1,1,0,168,17,151,47,121,58,10.2131086745646,13.2490083630634,0.369946324851983,2020-05-25,2020,5
"3248","MG",3,"Sudeste",31044,"Formiga",160172,26563.2997733062,5,27,3,24,3,24,0,0,0,0,0,27,3,24,3,24,20,10.1872858343262,11.9840035168172,0.296855778022677,2020-02-03,2020,2
"3249","MG",3,"Sudeste",31044,"Formiga",160172,26563.2997733062,6,23,8,15,3,20,1,1,0,0,1,24,9,15,3,21,27,10.1872858343262,11.9840035168172,0.29020579122497,2020-02-10,2020,2
"3250","MG",3,"Sudeste",31044,"Formiga",160172,26563.2997733062,7,23,4,19,4,19,2,1,1,0,2,25,5,20,4,21,23,10.1872858343262,11.9840035168172,0.293855876614979,2020-02-17,2020,2
"3251","MG",3,"Sudeste",31044,"Formiga",160172,26563.2997733062,8,39,6,33,11,28,0,0,0,0,0,39,6,33,11,28,22,10.1872858343262,11.9840035168172,0.346570698301551,2020-02-24,2020,2
"3252","MG",3,"Sudeste",31044,"Formiga",160172,26563.2997733062,9,25,3,22,5,20,0,0,0,0,0,25,3,22,5,20,32,10.1872858343262,11.9840035168172,0.325131090106934,2020-03-02,2020,3
"3253","MG",3,"Sudeste",31044,"Formiga",160172,26563.2997733062,10,28,1,27,10,18,0,0,0,0,0,28,1,27,10,18,28,10.1872858343262,11.9840035168172,0.323655817541077,2020-03-09,2020,3
"3254","MG",3,"Sudeste",31044,"Formiga",160172,26563.2997733062,11,37,5,32,11,26,0,0,0,0,0,37,5,32,11,26,24,10.1872858343262,11.9840035168172,0.394124901653313,2020-03-16,2020,3
"3255","MG",3,"Sudeste",31044,"Formiga",160172,26563.2997733062,12,17,3,14,4,13,0,0,0,0,0,17,3,14,4,13,20,10.1872858343262,11.9840035168172,0.493122479793936,2020-03-23,2020,3
"3256","MG",3,"Sudeste",31044,"Formiga",160172,26563.2997733062,13,41,9,32,14,27,1,1,0,0,1,42,10,32,14,28,26,10.1872858343262,11.9840035168172,0.458650307527366,2020-03-30,2020,3
"3257","MG",3,"Sudeste",31044,"Formiga",160172,26563.2997733062,14,22,3,19,8,14,0,0,0,0,0,22,3,19,8,14,15,10.1872858343262,11.9840035168172,0.450950043325646,2020-04-06,2020,4
"3258","MG",3,"Sudeste",31044,"Formiga",160172,26563.2997733062,15,32,8,24,6,26,1,0,1,1,0,33,8,25,7,26,22,10.1872858343262,11.9840035168172,0.411626675503377,2020-04-13,2020,4
"3259","MG",3,"Sudeste",31044,"Formiga",160172,26563.2997733062,16,40,8,32,8,32,0,0,0,0,0,40,8,32,8,32,27,10.1872858343262,11.9840035168172,0.424424990786508,2020-04-20,2020,4
"3260","MG",3,"Sudeste",31044,"Formiga",160172,26563.2997733062,17,23,5,18,6,17,0,0,0,0,0,23,5,18,6,17,26,10.1872858343262,11.9840035168172,0.411247750668131,2020-04-27,2020,4
"3261","MG",3,"Sudeste",31044,"Formiga",160172,26563.2997733062,18,27,3,24,3,24,0,0,0,0,0,27,3,24,3,24,19,10.1872858343262,11.9840035168172,0.374178417429812,2020-05-04,2020,5
"3262","MG",3,"Sudeste",31044,"Formiga",160172,26563.2997733062,19,32,5,27,6,26,0,0,0,0,0,32,5,27,6,26,22,10.1872858343262,11.9840035168172,0.386928545692366,2020-05-11,2020,5
"3263","MG",3,"Sudeste",31044,"Formiga",160172,26563.2997733062,20,22,5,17,11,11,0,0,0,0,0,22,5,17,11,11,20,10.1872858343262,11.9840035168172,0.381138895532076,2020-05-18,2020,5
"3264","MG",3,"Sudeste",31044,"Formiga",160172,26563.2997733062,21,25,2,23,9,16,0,0,0,0,0,25,2,23,9,16,22,10.1872858343262,11.9840035168172,0.37209423374654,2020-05-25,2020,5
"3265","MG",3,"Sudeste",31045,"Campo Belo",118440,18279.7296636271,5,20,3,17,7,13,0,0,0,0,0,20,3,17,7,13,19,9.81354805625695,11.6821617822155,0.28204849472077,2020-02-03,2020,2
"3266","MG",3,"Sudeste",31045,"Campo Belo",118440,18279.7296636271,6,19,4,15,8,11,0,0,0,0,0,19,4,15,8,11,21,9.81354805625695,11.6821617822155,0.266285468199572,2020-02-10,2020,2
"3267","MG",3,"Sudeste",31045,"Campo Belo",118440,18279.7296636271,7,13,2,11,3,10,0,0,0,0,0,13,2,11,3,10,22,9.81354805625695,11.6821617822155,0.28131468804315,2020-02-17,2020,2
"3268","MG",3,"Sudeste",31045,"Campo Belo",118440,18279.7296636271,8,28,8,20,9,19,0,0,0,0,0,28,8,20,9,19,11,9.81354805625695,11.6821617822155,0.327390770313543,2020-02-24,2020,2
"3269","MG",3,"Sudeste",31045,"Campo Belo",118440,18279.7296636271,9,26,4,22,7,19,0,0,0,0,0,26,4,22,7,19,19,9.81354805625695,11.6821617822155,0.310720635559122,2020-03-02,2020,3
"3270","MG",3,"Sudeste",31045,"Campo Belo",118440,18279.7296636271,10,16,5,11,10,6,0,0,0,0,0,16,5,11,10,6,18,9.81354805625695,11.6821617822155,0.311337161788374,2020-03-09,2020,3
"3271","MG",3,"Sudeste",31045,"Campo Belo",118440,18279.7296636271,11,15,5,10,5,10,0,0,0,0,0,15,5,10,5,10,24,9.81354805625695,11.6821617822155,0.375238103182625,2020-03-16,2020,3
"3272","MG",3,"Sudeste",31045,"Campo Belo",118440,18279.7296636271,12,21,6,15,10,11,0,0,0,0,0,21,6,15,10,11,17,9.81354805625695,11.6821617822155,0.511382356601596,2020-03-23,2020,3
"3273","MG",3,"Sudeste",31045,"Campo Belo",118440,18279.7296636271,13,16,4,12,5,11,1,0,1,0,1,17,4,13,5,12,14,9.81354805625695,11.6821617822155,0.438899797130277,2020-03-30,2020,3
"3274","MG",3,"Sudeste",31045,"Campo Belo",118440,18279.7296636271,14,19,5,14,3,16,0,0,0,0,0,19,5,14,3,16,15,9.81354805625695,11.6821617822155,0.41565657638659,2020-04-06,2020,4
"3275","MG",3,"Sudeste",31045,"Campo Belo",118440,18279.7296636271,15,25,6,19,11,14,0,0,0,0,0,25,6,19,11,14,13,9.81354805625695,11.6821617822155,0.380648423752379,2020-04-13,2020,4
"3276","MG",3,"Sudeste",31045,"Campo Belo",118440,18279.7296636271,16,28,4,24,16,12,0,0,0,0,0,28,4,24,16,12,14,9.81354805625695,11.6821617822155,0.377884757393592,2020-04-20,2020,4
"3277","MG",3,"Sudeste",31045,"Campo Belo",118440,18279.7296636271,17,24,8,16,5,19,0,0,0,0,0,24,8,16,5,19,10,9.81354805625695,11.6821617822155,0.369879764998182,2020-04-27,2020,4
"3278","MG",3,"Sudeste",31045,"Campo Belo",118440,18279.7296636271,18,21,4,17,7,14,0,0,0,0,0,21,4,17,7,14,25,9.81354805625695,11.6821617822155,0.352215612857836,2020-05-04,2020,5
"3279","MG",3,"Sudeste",31045,"Campo Belo",118440,18279.7296636271,19,36,8,28,16,20,1,0,1,0,1,37,8,29,16,21,10,9.81354805625695,11.6821617822155,0.352985033391257,2020-05-11,2020,5
"3280","MG",3,"Sudeste",31045,"Campo Belo",118440,18279.7296636271,20,27,10,17,9,18,1,0,1,0,1,28,10,18,9,19,18,9.81354805625695,11.6821617822155,0.368945289503815,2020-05-18,2020,5
"3281","MG",3,"Sudeste",31045,"Campo Belo",118440,18279.7296636271,21,26,8,18,9,17,0,0,0,0,0,26,8,18,9,17,22,9.81354805625695,11.6821617822155,0.346137014935569,2020-05-25,2020,5
"3282","MG",3,"Sudeste",31046,"Oliveira",133101,19258.5326804457,5,20,5,15,8,12,0,0,0,0,0,20,5,15,8,12,11,9.865709497634,11.798863517503,0.284517328514881,2020-02-03,2020,2
"3283","MG",3,"Sudeste",31046,"Oliveira",133101,19258.5326804457,6,24,4,20,5,19,1,0,1,1,0,25,4,21,6,19,24,9.865709497634,11.798863517503,0.272783621882465,2020-02-10,2020,2
"3284","MG",3,"Sudeste",31046,"Oliveira",133101,19258.5326804457,7,26,3,23,11,15,0,0,0,0,0,26,3,23,11,15,21,9.865709497634,11.798863517503,0.274808279144898,2020-02-17,2020,2
"3285","MG",3,"Sudeste",31046,"Oliveira",133101,19258.5326804457,8,22,3,19,4,18,0,0,0,0,0,22,3,19,4,18,19,9.865709497634,11.798863517503,0.328339775591283,2020-02-24,2020,2
"3286","MG",3,"Sudeste",31046,"Oliveira",133101,19258.5326804457,9,27,5,22,14,13,0,0,0,0,0,27,5,22,14,13,17,9.865709497634,11.798863517503,0.316689184501625,2020-03-02,2020,3
"3287","MG",3,"Sudeste",31046,"Oliveira",133101,19258.5326804457,10,32,4,28,12,20,0,0,0,0,0,32,4,28,12,20,16,9.865709497634,11.798863517503,0.306519262438444,2020-03-09,2020,3
"3288","MG",3,"Sudeste",31046,"Oliveira",133101,19258.5326804457,11,20,2,18,8,12,0,0,0,0,0,20,2,18,8,12,21,9.865709497634,11.798863517503,0.370224475981028,2020-03-16,2020,3
"3289","MG",3,"Sudeste",31046,"Oliveira",133101,19258.5326804457,12,24,3,21,8,16,0,0,0,0,0,24,3,21,8,16,22,9.865709497634,11.798863517503,0.45052939268159,2020-03-23,2020,3
"3290","MG",3,"Sudeste",31046,"Oliveira",133101,19258.5326804457,13,27,4,23,10,17,0,0,0,0,0,27,4,23,10,17,14,9.865709497634,11.798863517503,0.406180734498445,2020-03-30,2020,3
"3291","MG",3,"Sudeste",31046,"Oliveira",133101,19258.5326804457,14,20,3,17,3,17,2,1,1,1,1,22,4,18,4,18,24,9.865709497634,11.798863517503,0.408596105437411,2020-04-06,2020,4
"3292","MG",3,"Sudeste",31046,"Oliveira",133101,19258.5326804457,15,27,3,24,10,17,0,0,0,0,0,27,3,24,10,17,25,9.865709497634,11.798863517503,0.371793654872392,2020-04-13,2020,4
"3293","MG",3,"Sudeste",31046,"Oliveira",133101,19258.5326804457,16,25,4,21,8,17,2,1,1,2,0,27,5,22,10,17,20,9.865709497634,11.798863517503,0.384432095446153,2020-04-20,2020,4
"3294","MG",3,"Sudeste",31046,"Oliveira",133101,19258.5326804457,17,23,2,21,5,18,0,0,0,0,0,23,2,21,5,18,17,9.865709497634,11.798863517503,0.380637098607498,2020-04-27,2020,4
"3295","MG",3,"Sudeste",31046,"Oliveira",133101,19258.5326804457,18,26,5,21,12,14,0,0,0,0,0,26,5,21,12,14,20,9.865709497634,11.798863517503,0.354752399652046,2020-05-04,2020,5
"3296","MG",3,"Sudeste",31046,"Oliveira",133101,19258.5326804457,19,16,4,12,8,8,0,0,0,0,0,16,4,12,8,8,20,9.865709497634,11.798863517503,0.37253740834459,2020-05-11,2020,5
"3297","MG",3,"Sudeste",31046,"Oliveira",133101,19258.5326804457,20,21,1,20,6,15,0,0,0,0,0,21,1,20,6,15,16,9.865709497634,11.798863517503,0.369172615394548,2020-05-18,2020,5
"3298","MG",3,"Sudeste",31046,"Oliveira",133101,19258.5326804457,21,24,7,17,8,16,1,0,1,0,1,25,7,18,8,17,17,9.865709497634,11.798863517503,0.356784027918667,2020-05-25,2020,5
"3299","MG",3,"Sudeste",31047,"Passos",242982,24515.7969224881,5,41,9,32,20,21,0,0,0,0,0,41,9,32,20,21,30,10.1070729611029,12.400742645505,0.306028604619684,2020-02-03,2020,2
"3300","MG",3,"Sudeste",31047,"Passos",242982,24515.7969224881,6,47,9,38,15,32,2,0,2,1,1,49,9,40,16,33,22,10.1070729611029,12.400742645505,0.294179754449612,2020-02-10,2020,2
"3301","MG",3,"Sudeste",31047,"Passos",242982,24515.7969224881,7,59,22,37,18,41,0,0,0,0,0,59,22,37,18,41,29,10.1070729611029,12.400742645505,0.303638456072679,2020-02-17,2020,2
"3302","MG",3,"Sudeste",31047,"Passos",242982,24515.7969224881,8,63,20,43,21,42,0,0,0,0,0,63,20,43,21,42,21,10.1070729611029,12.400742645505,0.343765775497374,2020-02-24,2020,2
"3303","MG",3,"Sudeste",31047,"Passos",242982,24515.7969224881,9,44,15,29,12,32,1,0,1,0,1,45,15,30,12,33,31,10.1070729611029,12.400742645505,0.312003701249007,2020-03-02,2020,3
"3304","MG",3,"Sudeste",31047,"Passos",242982,24515.7969224881,10,42,10,32,14,28,0,0,0,0,0,42,10,32,14,28,28,10.1070729611029,12.400742645505,0.322413750165278,2020-03-09,2020,3
"3305","MG",3,"Sudeste",31047,"Passos",242982,24515.7969224881,11,52,20,32,13,39,0,0,0,0,0,52,20,32,13,39,37,10.1070729611029,12.400742645505,0.407375617803559,2020-03-16,2020,3
"3306","MG",3,"Sudeste",31047,"Passos",242982,24515.7969224881,12,42,10,32,18,24,0,0,0,0,0,42,10,32,18,24,34,10.1070729611029,12.400742645505,0.52116341754441,2020-03-23,2020,3
"3307","MG",3,"Sudeste",31047,"Passos",242982,24515.7969224881,13,36,3,33,11,25,0,0,0,0,0,36,3,33,11,25,23,10.1070729611029,12.400742645505,0.477380719707628,2020-03-30,2020,3
"3308","MG",3,"Sudeste",31047,"Passos",242982,24515.7969224881,14,56,15,41,23,33,1,0,1,1,0,57,15,42,24,33,36,10.1070729611029,12.400742645505,0.458251537345751,2020-04-06,2020,4
"3309","MG",3,"Sudeste",31047,"Passos",242982,24515.7969224881,15,45,12,33,14,31,0,0,0,0,0,45,12,33,14,31,31,10.1070729611029,12.400742645505,0.419071785488441,2020-04-13,2020,4
"3310","MG",3,"Sudeste",31047,"Passos",242982,24515.7969224881,16,56,9,47,26,30,0,0,0,0,0,56,9,47,26,30,24,10.1070729611029,12.400742645505,0.431635700448778,2020-04-20,2020,4
"3311","MG",3,"Sudeste",31047,"Passos",242982,24515.7969224881,17,49,14,35,17,32,1,1,0,1,0,50,15,35,18,32,25,10.1070729611029,12.400742645505,0.412970368699452,2020-04-27,2020,4
"3312","MG",3,"Sudeste",31047,"Passos",242982,24515.7969224881,18,58,14,44,32,26,1,1,0,1,0,59,15,44,33,26,37,10.1070729611029,12.400742645505,0.385189572466867,2020-05-04,2020,5
"3313","MG",3,"Sudeste",31047,"Passos",242982,24515.7969224881,19,49,11,38,22,27,0,0,0,0,0,49,11,38,22,27,27,10.1070729611029,12.400742645505,0.399456731753169,2020-05-11,2020,5
"3314","MG",3,"Sudeste",31047,"Passos",242982,24515.7969224881,20,69,17,52,27,42,0,0,0,0,0,69,17,52,27,42,35,10.1070729611029,12.400742645505,0.407454155974503,2020-05-18,2020,5
"3315","MG",3,"Sudeste",31047,"Passos",242982,24515.7969224881,21,67,11,56,21,46,2,0,2,1,1,69,11,58,22,47,44,10.1070729611029,12.400742645505,0.39493433472314,2020-05-25,2020,5
"3316","MG",3,"Sudeste",31048,"São Sebastião do Paraíso",279679,24149.0316262572,5,55,15,40,18,37,0,0,0,0,0,55,15,40,18,37,48,10.0919995599851,12.541397795928,0.306005585861943,2020-02-03,2020,2
"3317","MG",3,"Sudeste",31048,"São Sebastião do Paraíso",279679,24149.0316262572,6,57,18,39,17,40,1,1,0,1,0,58,19,39,18,40,38,10.0919995599851,12.541397795928,0.297391035601748,2020-02-10,2020,2
"3318","MG",3,"Sudeste",31048,"São Sebastião do Paraíso",279679,24149.0316262572,7,52,13,39,14,38,0,0,0,0,0,52,13,39,14,38,54,10.0919995599851,12.541397795928,0.301942770502755,2020-02-17,2020,2
"3319","MG",3,"Sudeste",31048,"São Sebastião do Paraíso",279679,24149.0316262572,8,58,17,41,19,39,1,0,1,0,1,59,17,42,19,40,37,10.0919995599851,12.541397795928,0.357942387444748,2020-02-24,2020,2
"3320","MG",3,"Sudeste",31048,"São Sebastião do Paraíso",279679,24149.0316262572,9,45,9,36,19,26,0,0,0,0,0,45,9,36,19,26,36,10.0919995599851,12.541397795928,0.320616237574062,2020-03-02,2020,3
"3321","MG",3,"Sudeste",31048,"São Sebastião do Paraíso",279679,24149.0316262572,10,52,19,33,18,34,0,0,0,0,0,52,19,33,18,34,43,10.0919995599851,12.541397795928,0.329364174110963,2020-03-09,2020,3
"3322","MG",3,"Sudeste",31048,"São Sebastião do Paraíso",279679,24149.0316262572,11,45,12,33,11,34,0,0,0,0,0,45,12,33,11,34,36,10.0919995599851,12.541397795928,0.410132064450669,2020-03-16,2020,3
"3323","MG",3,"Sudeste",31048,"São Sebastião do Paraíso",279679,24149.0316262572,12,51,14,37,18,33,0,0,0,0,0,51,14,37,18,33,43,10.0919995599851,12.541397795928,0.506364595730831,2020-03-23,2020,3
"3324","MG",3,"Sudeste",31048,"São Sebastião do Paraíso",279679,24149.0316262572,13,50,10,40,18,32,0,0,0,0,0,50,10,40,18,32,36,10.0919995599851,12.541397795928,0.456384407938127,2020-03-30,2020,3
"3325","MG",3,"Sudeste",31048,"São Sebastião do Paraíso",279679,24149.0316262572,14,44,9,35,14,30,1,0,1,1,0,45,9,36,15,30,47,10.0919995599851,12.541397795928,0.452113448706796,2020-04-06,2020,4
"3326","MG",3,"Sudeste",31048,"São Sebastião do Paraíso",279679,24149.0316262572,15,52,22,30,20,32,0,0,0,0,0,52,22,30,20,32,32,10.0919995599851,12.541397795928,0.427458587064076,2020-04-13,2020,4
"3327","MG",3,"Sudeste",31048,"São Sebastião do Paraíso",279679,24149.0316262572,16,56,15,41,18,38,0,0,0,0,0,56,15,41,18,38,54,10.0919995599851,12.541397795928,0.428870937597396,2020-04-20,2020,4
"3328","MG",3,"Sudeste",31048,"São Sebastião do Paraíso",279679,24149.0316262572,17,55,12,43,19,36,1,0,1,1,0,56,12,44,20,36,42,10.0919995599851,12.541397795928,0.412801774606669,2020-04-27,2020,4
"3329","MG",3,"Sudeste",31048,"São Sebastião do Paraíso",279679,24149.0316262572,18,44,3,41,9,35,0,0,0,0,0,44,3,41,9,35,42,10.0919995599851,12.541397795928,0.394316006518922,2020-05-04,2020,5
"3330","MG",3,"Sudeste",31048,"São Sebastião do Paraíso",279679,24149.0316262572,19,63,13,50,26,37,1,0,1,1,0,64,13,51,27,37,30,10.0919995599851,12.541397795928,0.386167795821071,2020-05-11,2020,5
"3331","MG",3,"Sudeste",31048,"São Sebastião do Paraíso",279679,24149.0316262572,20,60,18,42,30,30,0,0,0,0,0,60,18,42,30,30,43,10.0919995599851,12.541397795928,0.395319465931128,2020-05-18,2020,5
"3332","MG",3,"Sudeste",31048,"São Sebastião do Paraíso",279679,24149.0316262572,21,60,11,49,22,38,0,0,0,0,0,60,11,49,22,38,44,10.0919995599851,12.541397795928,0.38738118126749,2020-05-25,2020,5
"3333","MG",3,"Sudeste",31049,"Alfenas",242312,24410.5343431196,5,60,12,48,14,46,0,0,0,0,0,60,12,48,14,46,32,10.1027700534841,12.39798143096,0.305650323482613,2020-02-03,2020,2
"3334","MG",3,"Sudeste",31049,"Alfenas",242312,24410.5343431196,6,47,11,36,14,33,0,0,0,0,0,47,11,36,14,33,27,10.1027700534841,12.39798143096,0.294129387418493,2020-02-10,2020,2
"3335","MG",3,"Sudeste",31049,"Alfenas",242312,24410.5343431196,7,44,10,34,16,28,0,0,0,0,0,44,10,34,16,28,39,10.1027700534841,12.39798143096,0.299374232394675,2020-02-17,2020,2
"3336","MG",3,"Sudeste",31049,"Alfenas",242312,24410.5343431196,8,47,16,31,22,25,0,0,0,0,0,47,16,31,22,25,26,10.1027700534841,12.39798143096,0.355753238370273,2020-02-24,2020,2
"3337","MG",3,"Sudeste",31049,"Alfenas",242312,24410.5343431196,9,65,17,48,24,41,0,0,0,0,0,65,17,48,24,41,29,10.1027700534841,12.39798143096,0.324716155904281,2020-03-02,2020,3
"3338","MG",3,"Sudeste",31049,"Alfenas",242312,24410.5343431196,10,38,8,30,9,29,0,0,0,0,0,38,8,30,9,29,24,10.1027700534841,12.39798143096,0.316916420970097,2020-03-09,2020,3
"3339","MG",3,"Sudeste",31049,"Alfenas",242312,24410.5343431196,11,48,17,31,19,29,0,0,0,0,0,48,17,31,19,29,37,10.1027700534841,12.39798143096,0.405218844970397,2020-03-16,2020,3
"3340","MG",3,"Sudeste",31049,"Alfenas",242312,24410.5343431196,12,36,10,26,11,25,0,0,0,0,0,36,10,26,11,25,35,10.1027700534841,12.39798143096,0.508547265845078,2020-03-23,2020,3
"3341","MG",3,"Sudeste",31049,"Alfenas",242312,24410.5343431196,13,38,9,29,15,23,0,0,0,0,0,38,9,29,15,23,36,10.1027700534841,12.39798143096,0.457849220355163,2020-03-30,2020,3
"3342","MG",3,"Sudeste",31049,"Alfenas",242312,24410.5343431196,14,34,6,28,13,21,0,0,0,0,0,34,6,28,13,21,38,10.1027700534841,12.39798143096,0.452525150953511,2020-04-06,2020,4
"3343","MG",3,"Sudeste",31049,"Alfenas",242312,24410.5343431196,15,51,9,42,15,36,1,0,1,0,1,52,9,43,15,37,22,10.1027700534841,12.39798143096,0.420469773265557,2020-04-13,2020,4
"3344","MG",3,"Sudeste",31049,"Alfenas",242312,24410.5343431196,16,55,9,46,29,26,0,0,0,0,0,55,9,46,29,26,30,10.1027700534841,12.39798143096,0.418714591355403,2020-04-20,2020,4
"3345","MG",3,"Sudeste",31049,"Alfenas",242312,24410.5343431196,17,47,19,28,15,32,0,0,0,0,0,47,19,28,15,32,34,10.1027700534841,12.39798143096,0.404718706401742,2020-04-27,2020,4
"3346","MG",3,"Sudeste",31049,"Alfenas",242312,24410.5343431196,18,55,17,38,13,42,0,0,0,0,0,55,17,38,13,42,19,10.1027700534841,12.39798143096,0.385633547734763,2020-05-04,2020,5
"3347","MG",3,"Sudeste",31049,"Alfenas",242312,24410.5343431196,19,53,11,42,14,39,0,0,0,0,0,53,11,42,14,39,35,10.1027700534841,12.39798143096,0.38962992754171,2020-05-11,2020,5
"3348","MG",3,"Sudeste",31049,"Alfenas",242312,24410.5343431196,20,64,15,49,23,41,0,0,0,0,0,64,15,49,23,41,34,10.1027700534841,12.39798143096,0.394909951812758,2020-05-18,2020,5
"3349","MG",3,"Sudeste",31049,"Alfenas",242312,24410.5343431196,21,63,17,46,27,36,0,0,0,0,0,63,17,46,27,36,33,10.1027700534841,12.39798143096,0.376859477009907,2020-05-25,2020,5
"3350","MG",3,"Sudeste",31050,"Varginha",475649,27088.3329892421,5,130,27,103,43,87,1,1,0,1,0,131,28,103,44,87,60,10.2068583971666,13.0724354662462,0.292476749780996,2020-02-03,2020,2
"3351","MG",3,"Sudeste",31050,"Varginha",475649,27088.3329892421,6,91,16,75,34,57,1,1,0,0,1,92,17,75,34,58,69,10.2068583971666,13.0724354662462,0.289860685523342,2020-02-10,2020,2
"3352","MG",3,"Sudeste",31050,"Varginha",475649,27088.3329892421,7,97,17,80,28,69,1,1,0,1,0,98,18,80,29,69,47,10.2068583971666,13.0724354662462,0.294548488370402,2020-02-17,2020,2
"3353","MG",3,"Sudeste",31050,"Varginha",475649,27088.3329892421,8,113,28,85,39,74,0,0,0,0,0,113,28,85,39,74,49,10.2068583971666,13.0724354662462,0.346666374215102,2020-02-24,2020,2
"3354","MG",3,"Sudeste",31050,"Varginha",475649,27088.3329892421,9,96,17,79,35,61,1,0,1,0,1,97,17,80,35,62,86,10.2068583971666,13.0724354662462,0.312103934277603,2020-03-02,2020,3
"3355","MG",3,"Sudeste",31050,"Varginha",475649,27088.3329892421,10,116,19,97,48,68,2,1,1,1,1,118,20,98,49,69,49,10.2068583971666,13.0724354662462,0.311841963300579,2020-03-09,2020,3
"3356","MG",3,"Sudeste",31050,"Varginha",475649,27088.3329892421,11,112,22,90,44,68,2,1,1,1,1,114,23,91,45,69,73,10.2068583971666,13.0724354662462,0.398937363205413,2020-03-16,2020,3
"3357","MG",3,"Sudeste",31050,"Varginha",475649,27088.3329892421,12,94,19,75,31,63,0,0,0,0,0,94,19,75,31,63,72,10.2068583971666,13.0724354662462,0.49714507617106,2020-03-23,2020,3
"3358","MG",3,"Sudeste",31050,"Varginha",475649,27088.3329892421,13,97,17,80,36,61,0,0,0,0,0,97,17,80,36,61,51,10.2068583971666,13.0724354662462,0.453673651085968,2020-03-30,2020,3
"3359","MG",3,"Sudeste",31050,"Varginha",475649,27088.3329892421,14,95,19,76,32,63,0,0,0,0,0,95,19,76,32,63,46,10.2068583971666,13.0724354662462,0.447392623558393,2020-04-06,2020,4
"3360","MG",3,"Sudeste",31050,"Varginha",475649,27088.3329892421,15,100,23,77,40,60,0,0,0,0,0,100,23,77,40,60,51,10.2068583971666,13.0724354662462,0.418825160116779,2020-04-13,2020,4
"3361","MG",3,"Sudeste",31050,"Varginha",475649,27088.3329892421,16,93,25,68,31,62,0,0,0,0,0,93,25,68,31,62,50,10.2068583971666,13.0724354662462,0.413812685666748,2020-04-20,2020,4
"3362","MG",3,"Sudeste",31050,"Varginha",475649,27088.3329892421,17,107,27,80,35,72,0,0,0,0,0,107,27,80,35,72,58,10.2068583971666,13.0724354662462,0.405319507777844,2020-04-27,2020,4
"3363","MG",3,"Sudeste",31050,"Varginha",475649,27088.3329892421,18,113,27,86,41,72,0,0,0,0,0,113,27,86,41,72,53,10.2068583971666,13.0724354662462,0.376595184078247,2020-05-04,2020,5
"3364","MG",3,"Sudeste",31050,"Varginha",475649,27088.3329892421,19,130,28,102,47,83,2,1,1,0,2,132,29,103,47,85,78,10.2068583971666,13.0724354662462,0.388322177027798,2020-05-11,2020,5
"3365","MG",3,"Sudeste",31050,"Varginha",475649,27088.3329892421,20,100,18,82,46,54,0,0,0,0,0,100,18,82,46,54,57,10.2068583971666,13.0724354662462,0.387393058928061,2020-05-18,2020,5
"3366","MG",3,"Sudeste",31050,"Varginha",475649,27088.3329892421,21,118,29,89,29,89,0,0,0,0,0,118,29,89,29,89,65,10.2068583971666,13.0724354662462,0.376404821937786,2020-05-25,2020,5
"3367","MG",3,"Sudeste",31051,"Poços de Caldas",373228,31537.837201255,5,65,16,49,21,44,0,0,0,0,0,65,16,49,21,44,54,10.3589432849652,12.8299447719362,0.301873642748475,2020-02-03,2020,2
"3368","MG",3,"Sudeste",31051,"Poços de Caldas",373228,31537.837201255,6,61,17,44,18,43,0,0,0,0,0,61,17,44,18,43,62,10.3589432849652,12.8299447719362,0.294746291014301,2020-02-10,2020,2
"3369","MG",3,"Sudeste",31051,"Poços de Caldas",373228,31537.837201255,7,76,21,55,26,50,0,0,0,0,0,76,21,55,26,50,69,10.3589432849652,12.8299447719362,0.295527066096232,2020-02-17,2020,2
"3370","MG",3,"Sudeste",31051,"Poços de Caldas",373228,31537.837201255,8,64,13,51,28,36,0,0,0,0,0,64,13,51,28,36,51,10.3589432849652,12.8299447719362,0.342145073980823,2020-02-24,2020,2
"3371","MG",3,"Sudeste",31051,"Poços de Caldas",373228,31537.837201255,9,70,23,47,22,48,0,0,0,0,0,70,23,47,22,48,53,10.3589432849652,12.8299447719362,0.31390779728267,2020-03-02,2020,3
"3372","MG",3,"Sudeste",31051,"Poços de Caldas",373228,31537.837201255,10,74,11,63,27,47,0,0,0,0,0,74,11,63,27,47,49,10.3589432849652,12.8299447719362,0.323434590155204,2020-03-09,2020,3
"3373","MG",3,"Sudeste",31051,"Poços de Caldas",373228,31537.837201255,11,61,13,48,25,36,0,0,0,0,0,61,13,48,25,36,51,10.3589432849652,12.8299447719362,0.425047669472753,2020-03-16,2020,3
"3374","MG",3,"Sudeste",31051,"Poços de Caldas",373228,31537.837201255,12,57,8,49,19,38,0,0,0,0,0,57,8,49,19,38,58,10.3589432849652,12.8299447719362,0.542940727475494,2020-03-23,2020,3
"3375","MG",3,"Sudeste",31051,"Poços de Caldas",373228,31537.837201255,13,62,13,49,27,35,0,0,0,0,0,62,13,49,27,35,50,10.3589432849652,12.8299447719362,0.490083569203536,2020-03-30,2020,3
"3376","MG",3,"Sudeste",31051,"Poços de Caldas",373228,31537.837201255,14,56,14,42,17,39,0,0,0,0,0,56,14,42,17,39,47,10.3589432849652,12.8299447719362,0.471971257090056,2020-04-06,2020,4
"3377","MG",3,"Sudeste",31051,"Poços de Caldas",373228,31537.837201255,15,64,14,50,21,43,0,0,0,0,0,64,14,50,21,43,36,10.3589432849652,12.8299447719362,0.438188316873742,2020-04-13,2020,4
"3378","MG",3,"Sudeste",31051,"Poços de Caldas",373228,31537.837201255,16,64,23,41,23,41,1,1,0,0,1,65,24,41,23,42,52,10.3589432849652,12.8299447719362,0.439375658330748,2020-04-20,2020,4
"3379","MG",3,"Sudeste",31051,"Poços de Caldas",373228,31537.837201255,17,69,16,53,24,45,0,0,0,0,0,69,16,53,24,45,42,10.3589432849652,12.8299447719362,0.425630377155945,2020-04-27,2020,4
"3380","MG",3,"Sudeste",31051,"Poços de Caldas",373228,31537.837201255,18,72,16,56,18,54,1,0,1,0,1,73,16,57,18,55,48,10.3589432849652,12.8299447719362,0.398464145443028,2020-05-04,2020,5
"3381","MG",3,"Sudeste",31051,"Poços de Caldas",373228,31537.837201255,19,66,15,51,30,36,0,0,0,0,0,66,15,51,30,36,70,10.3589432849652,12.8299447719362,0.403344714871622,2020-05-11,2020,5
"3382","MG",3,"Sudeste",31051,"Poços de Caldas",373228,31537.837201255,20,70,16,54,23,47,0,0,0,0,0,70,16,54,23,47,48,10.3589432849652,12.8299447719362,0.406083332377576,2020-05-18,2020,5
"3383","MG",3,"Sudeste",31051,"Poços de Caldas",373228,31537.837201255,21,87,19,68,34,53,1,0,1,0,1,88,19,69,34,54,62,10.3589432849652,12.8299447719362,0.391325157895853,2020-05-25,2020,5
"3384","MG",3,"Sudeste",31052,"Pouso Alegre",368694,59014.1243828758,5,78,18,60,30,48,1,1,0,1,0,79,19,60,31,48,44,10.9855320905571,12.8177223106968,0.289046101310831,2020-02-03,2020,2
"3385","MG",3,"Sudeste",31052,"Pouso Alegre",368694,59014.1243828758,6,69,18,51,17,52,0,0,0,0,0,69,18,51,17,52,31,10.9855320905571,12.8177223106968,0.282608201366989,2020-02-10,2020,2
"3386","MG",3,"Sudeste",31052,"Pouso Alegre",368694,59014.1243828758,7,98,20,78,32,66,0,0,0,0,0,98,20,78,32,66,35,10.9855320905571,12.8177223106968,0.292510199039573,2020-02-17,2020,2
"3387","MG",3,"Sudeste",31052,"Pouso Alegre",368694,59014.1243828758,8,76,12,64,23,53,0,0,0,0,0,76,12,64,23,53,46,10.9855320905571,12.8177223106968,0.343590341423745,2020-02-24,2020,2
"3388","MG",3,"Sudeste",31052,"Pouso Alegre",368694,59014.1243828758,9,90,19,71,43,47,0,0,0,0,0,90,19,71,43,47,53,10.9855320905571,12.8177223106968,0.313707465119822,2020-03-02,2020,3
"3389","MG",3,"Sudeste",31052,"Pouso Alegre",368694,59014.1243828758,10,79,14,65,24,55,2,0,2,0,2,81,14,67,24,57,40,10.9855320905571,12.8177223106968,0.325117024747874,2020-03-09,2020,3
"3390","MG",3,"Sudeste",31052,"Pouso Alegre",368694,59014.1243828758,11,72,13,59,17,55,1,1,0,1,0,73,14,59,18,55,43,10.9855320905571,12.8177223106968,0.405583635290693,2020-03-16,2020,3
"3391","MG",3,"Sudeste",31052,"Pouso Alegre",368694,59014.1243828758,12,86,20,66,33,53,0,0,0,0,0,86,20,66,33,53,33,10.9855320905571,12.8177223106968,0.505226786912715,2020-03-23,2020,3
"3392","MG",3,"Sudeste",31052,"Pouso Alegre",368694,59014.1243828758,13,74,15,59,19,55,1,0,1,0,1,75,15,60,19,56,43,10.9855320905571,12.8177223106968,0.450044221105042,2020-03-30,2020,3
"3393","MG",3,"Sudeste",31052,"Pouso Alegre",368694,59014.1243828758,14,77,18,59,27,50,0,0,0,0,0,77,18,59,27,50,37,10.9855320905571,12.8177223106968,0.448632625179444,2020-04-06,2020,4
"3394","MG",3,"Sudeste",31052,"Pouso Alegre",368694,59014.1243828758,15,68,21,47,28,40,0,0,0,0,0,68,21,47,28,40,47,10.9855320905571,12.8177223106968,0.420017133094134,2020-04-13,2020,4
"3395","MG",3,"Sudeste",31052,"Pouso Alegre",368694,59014.1243828758,16,79,15,64,21,58,2,1,1,1,1,81,16,65,22,59,44,10.9855320905571,12.8177223106968,0.423937598370151,2020-04-20,2020,4
"3396","MG",3,"Sudeste",31052,"Pouso Alegre",368694,59014.1243828758,17,88,14,74,29,59,0,0,0,0,0,88,14,74,29,59,45,10.9855320905571,12.8177223106968,0.410759060541495,2020-04-27,2020,4
"3397","MG",3,"Sudeste",31052,"Pouso Alegre",368694,59014.1243828758,18,76,22,54,32,44,0,0,0,0,0,76,22,54,32,44,44,10.9855320905571,12.8177223106968,0.391654668579989,2020-05-04,2020,5
"3398","MG",3,"Sudeste",31052,"Pouso Alegre",368694,59014.1243828758,19,90,24,66,25,65,0,0,0,0,0,90,24,66,25,65,51,10.9855320905571,12.8177223106968,0.397326143657731,2020-05-11,2020,5
"3399","MG",3,"Sudeste",31052,"Pouso Alegre",368694,59014.1243828758,20,93,13,80,27,66,1,0,1,1,0,94,13,81,28,66,54,10.9855320905571,12.8177223106968,0.395973608061952,2020-05-18,2020,5
"3400","MG",3,"Sudeste",31052,"Pouso Alegre",368694,59014.1243828758,21,108,21,87,44,64,1,0,1,0,1,109,21,88,44,65,44,10.9855320905571,12.8177223106968,0.389134593327056,2020-05-25,2020,5
"3401","MG",3,"Sudeste",31053,"Santa Rita do Sapucaí",152079,24997.8316473675,5,31,7,24,10,21,0,0,0,0,0,31,7,24,10,21,15,10.1265443659834,11.9321554016541,0.289824216548768,2020-02-03,2020,2
"3402","MG",3,"Sudeste",31053,"Santa Rita do Sapucaí",152079,24997.8316473675,6,29,7,22,9,20,0,0,0,0,0,29,7,22,9,20,17,10.1265443659834,11.9321554016541,0.294481839643974,2020-02-10,2020,2
"3403","MG",3,"Sudeste",31053,"Santa Rita do Sapucaí",152079,24997.8316473675,7,26,2,24,12,14,0,0,0,0,0,26,2,24,12,14,11,10.1265443659834,11.9321554016541,0.292027830790302,2020-02-17,2020,2
"3404","MG",3,"Sudeste",31053,"Santa Rita do Sapucaí",152079,24997.8316473675,8,22,5,17,6,16,0,0,0,0,0,22,5,17,6,16,15,10.1265443659834,11.9321554016541,0.343733855406137,2020-02-24,2020,2
"3405","MG",3,"Sudeste",31053,"Santa Rita do Sapucaí",152079,24997.8316473675,9,37,10,27,13,24,0,0,0,0,0,37,10,27,13,24,21,10.1265443659834,11.9321554016541,0.313333726154271,2020-03-02,2020,3
"3406","MG",3,"Sudeste",31053,"Santa Rita do Sapucaí",152079,24997.8316473675,10,28,3,25,14,14,0,0,0,0,0,28,3,25,14,14,22,10.1265443659834,11.9321554016541,0.322492142041054,2020-03-09,2020,3
"3407","MG",3,"Sudeste",31053,"Santa Rita do Sapucaí",152079,24997.8316473675,11,25,9,16,7,18,0,0,0,0,0,25,9,16,7,18,23,10.1265443659834,11.9321554016541,0.401419017131765,2020-03-16,2020,3
"3408","MG",3,"Sudeste",31053,"Santa Rita do Sapucaí",152079,24997.8316473675,12,19,5,14,3,16,0,0,0,0,0,19,5,14,3,16,25,10.1265443659834,11.9321554016541,0.490987378320964,2020-03-23,2020,3
"3409","MG",3,"Sudeste",31053,"Santa Rita do Sapucaí",152079,24997.8316473675,13,27,7,20,8,19,0,0,0,0,0,27,7,20,8,19,16,10.1265443659834,11.9321554016541,0.449466408685322,2020-03-30,2020,3
"3410","MG",3,"Sudeste",31053,"Santa Rita do Sapucaí",152079,24997.8316473675,14,37,13,24,12,25,0,0,0,0,0,37,13,24,12,25,27,10.1265443659834,11.9321554016541,0.456358269934614,2020-04-06,2020,4
"3411","MG",3,"Sudeste",31053,"Santa Rita do Sapucaí",152079,24997.8316473675,15,25,5,20,8,17,0,0,0,0,0,25,5,20,8,17,8,10.1265443659834,11.9321554016541,0.415726422207682,2020-04-13,2020,4
"3412","MG",3,"Sudeste",31053,"Santa Rita do Sapucaí",152079,24997.8316473675,16,33,7,26,12,21,0,0,0,0,0,33,7,26,12,21,17,10.1265443659834,11.9321554016541,0.430878466887224,2020-04-20,2020,4
"3413","MG",3,"Sudeste",31053,"Santa Rita do Sapucaí",152079,24997.8316473675,17,31,6,25,5,26,1,0,1,0,1,32,6,26,5,27,11,10.1265443659834,11.9321554016541,0.412922428156354,2020-04-27,2020,4
"3414","MG",3,"Sudeste",31053,"Santa Rita do Sapucaí",152079,24997.8316473675,18,35,13,22,16,19,0,0,0,0,0,35,13,22,16,19,23,10.1265443659834,11.9321554016541,0.383382408464568,2020-05-04,2020,5
"3415","MG",3,"Sudeste",31053,"Santa Rita do Sapucaí",152079,24997.8316473675,19,38,10,28,11,27,0,0,0,0,0,38,10,28,11,27,15,10.1265443659834,11.9321554016541,0.388041517914272,2020-05-11,2020,5
"3416","MG",3,"Sudeste",31053,"Santa Rita do Sapucaí",152079,24997.8316473675,20,32,6,26,12,20,0,0,0,0,0,32,6,26,12,20,26,10.1265443659834,11.9321554016541,0.406766455218457,2020-05-18,2020,5
"3417","MG",3,"Sudeste",31053,"Santa Rita do Sapucaí",152079,24997.8316473675,21,28,4,24,7,21,0,0,0,0,0,28,4,24,7,21,23,10.1265443659834,11.9321554016541,0.384665029346423,2020-05-25,2020,5
"3418","MG",3,"Sudeste",31054,"São Lourenço",221484,21430.0492157447,5,45,12,33,20,25,0,0,0,0,0,45,12,33,20,25,28,9.97254938504663,12.3081056310953,0.303908086994912,2020-02-03,2020,2
"3419","MG",3,"Sudeste",31054,"São Lourenço",221484,21430.0492157447,6,32,7,25,7,25,0,0,0,0,0,32,7,25,7,25,23,9.97254938504663,12.3081056310953,0.303064940098682,2020-02-10,2020,2
"3420","MG",3,"Sudeste",31054,"São Lourenço",221484,21430.0492157447,7,48,14,34,21,27,0,0,0,0,0,48,14,34,21,27,41,9.97254938504663,12.3081056310953,0.30266013274602,2020-02-17,2020,2
"3421","MG",3,"Sudeste",31054,"São Lourenço",221484,21430.0492157447,8,39,16,23,12,27,0,0,0,0,0,39,16,23,12,27,30,9.97254938504663,12.3081056310953,0.351970979139087,2020-02-24,2020,2
"3422","MG",3,"Sudeste",31054,"São Lourenço",221484,21430.0492157447,9,40,7,33,13,27,0,0,0,0,0,40,7,33,13,27,41,9.97254938504663,12.3081056310953,0.335008470941808,2020-03-02,2020,3
"3423","MG",3,"Sudeste",31054,"São Lourenço",221484,21430.0492157447,10,41,13,28,11,30,0,0,0,0,0,41,13,28,11,30,37,9.97254938504663,12.3081056310953,0.339655498617053,2020-03-09,2020,3
"3424","MG",3,"Sudeste",31054,"São Lourenço",221484,21430.0492157447,11,40,12,28,15,25,0,0,0,0,0,40,12,28,15,25,36,9.97254938504663,12.3081056310953,0.4426606666561,2020-03-16,2020,3
"3425","MG",3,"Sudeste",31054,"São Lourenço",221484,21430.0492157447,12,33,6,27,10,23,0,0,0,0,0,33,6,27,10,23,37,9.97254938504663,12.3081056310953,0.558566935351173,2020-03-23,2020,3
"3426","MG",3,"Sudeste",31054,"São Lourenço",221484,21430.0492157447,13,44,12,32,24,20,0,0,0,0,0,44,12,32,24,20,40,9.97254938504663,12.3081056310953,0.502189999828231,2020-03-30,2020,3
"3427","MG",3,"Sudeste",31054,"São Lourenço",221484,21430.0492157447,14,32,10,22,15,17,0,0,0,0,0,32,10,22,15,17,28,9.97254938504663,12.3081056310953,0.490347471078147,2020-04-06,2020,4
"3428","MG",3,"Sudeste",31054,"São Lourenço",221484,21430.0492157447,15,41,10,31,17,24,0,0,0,0,0,41,10,31,17,24,27,9.97254938504663,12.3081056310953,0.459459216610625,2020-04-13,2020,4
"3429","MG",3,"Sudeste",31054,"São Lourenço",221484,21430.0492157447,16,36,7,29,15,21,1,1,0,0,1,37,8,29,15,22,20,9.97254938504663,12.3081056310953,0.461807163115892,2020-04-20,2020,4
"3430","MG",3,"Sudeste",31054,"São Lourenço",221484,21430.0492157447,17,26,4,22,11,15,0,0,0,0,0,26,4,22,11,15,31,9.97254938504663,12.3081056310953,0.452701239392189,2020-04-27,2020,4
"3431","MG",3,"Sudeste",31054,"São Lourenço",221484,21430.0492157447,18,52,7,45,21,31,1,0,1,0,1,53,7,46,21,32,37,9.97254938504663,12.3081056310953,0.420359392698461,2020-05-04,2020,5
"3432","MG",3,"Sudeste",31054,"São Lourenço",221484,21430.0492157447,19,50,16,34,16,34,0,0,0,0,0,50,16,34,16,34,40,9.97254938504663,12.3081056310953,0.435281099421701,2020-05-11,2020,5
"3433","MG",3,"Sudeste",31054,"São Lourenço",221484,21430.0492157447,20,47,11,36,13,34,0,0,0,0,0,47,11,36,13,34,21,9.97254938504663,12.3081056310953,0.438042823868578,2020-05-18,2020,5
"3434","MG",3,"Sudeste",31054,"São Lourenço",221484,21430.0492157447,21,47,13,34,16,31,1,0,1,0,1,48,13,35,16,32,35,9.97254938504663,12.3081056310953,0.421758593059105,2020-05-25,2020,5
"3435","MG",3,"Sudeste",31055,"Andrelândia",75032,16353.3070255358,5,11,2,9,5,6,0,0,0,0,0,11,2,9,5,6,15,9.70218542043144,11.2256699681888,0.30876339291145,2020-02-03,2020,2
"3436","MG",3,"Sudeste",31055,"Andrelândia",75032,16353.3070255358,6,11,2,9,4,7,0,0,0,0,0,11,2,9,4,7,9,9.70218542043144,11.2256699681888,0.293392684325332,2020-02-10,2020,2
"3437","MG",3,"Sudeste",31055,"Andrelândia",75032,16353.3070255358,7,13,4,9,5,8,0,0,0,0,0,13,4,9,5,8,13,9.70218542043144,11.2256699681888,0.291994291804147,2020-02-17,2020,2
"3438","MG",3,"Sudeste",31055,"Andrelândia",75032,16353.3070255358,8,15,2,13,7,8,0,0,0,0,0,15,2,13,7,8,15,9.70218542043144,11.2256699681888,0.357370933852454,2020-02-24,2020,2
"3439","MG",3,"Sudeste",31055,"Andrelândia",75032,16353.3070255358,9,20,6,14,8,12,0,0,0,0,0,20,6,14,8,12,11,9.70218542043144,11.2256699681888,0.337297973233716,2020-03-02,2020,3
"3440","MG",3,"Sudeste",31055,"Andrelândia",75032,16353.3070255358,10,10,3,7,4,6,0,0,0,0,0,10,3,7,4,6,18,9.70218542043144,11.2256699681888,0.342880761929468,2020-03-09,2020,3
"3441","MG",3,"Sudeste",31055,"Andrelândia",75032,16353.3070255358,11,8,3,5,4,4,0,0,0,0,0,8,3,5,4,4,10,9.70218542043144,11.2256699681888,0.426844527162928,2020-03-16,2020,3
"3442","MG",3,"Sudeste",31055,"Andrelândia",75032,16353.3070255358,12,10,4,6,3,7,0,0,0,0,0,10,4,6,3,7,15,9.70218542043144,11.2256699681888,0.54370994873264,2020-03-23,2020,3
"3443","MG",3,"Sudeste",31055,"Andrelândia",75032,16353.3070255358,13,16,5,11,6,10,1,1,0,0,1,17,6,11,6,11,6,9.70218542043144,11.2256699681888,0.462411518749467,2020-03-30,2020,3
"3444","MG",3,"Sudeste",31055,"Andrelândia",75032,16353.3070255358,14,12,2,10,3,9,0,0,0,0,0,12,2,10,3,9,9,9.70218542043144,11.2256699681888,0.47792312563867,2020-04-06,2020,4
"3445","MG",3,"Sudeste",31055,"Andrelândia",75032,16353.3070255358,15,9,1,8,5,4,1,0,1,0,1,10,1,9,5,5,13,9.70218542043144,11.2256699681888,0.446781552682392,2020-04-13,2020,4
"3446","MG",3,"Sudeste",31055,"Andrelândia",75032,16353.3070255358,16,16,4,12,4,12,0,0,0,0,0,16,4,12,4,12,16,9.70218542043144,11.2256699681888,0.431308851333771,2020-04-20,2020,4
"3447","MG",3,"Sudeste",31055,"Andrelândia",75032,16353.3070255358,17,12,3,9,4,8,0,0,0,0,0,12,3,9,4,8,8,9.70218542043144,11.2256699681888,0.441884073424738,2020-04-27,2020,4
"3448","MG",3,"Sudeste",31055,"Andrelândia",75032,16353.3070255358,18,14,6,8,5,9,0,0,0,0,0,14,6,8,5,9,13,9.70218542043144,11.2256699681888,0.419673384903082,2020-05-04,2020,5
"3449","MG",3,"Sudeste",31055,"Andrelândia",75032,16353.3070255358,19,13,3,10,2,11,0,0,0,0,0,13,3,10,2,11,17,9.70218542043144,11.2256699681888,0.445674010847715,2020-05-11,2020,5
"3450","MG",3,"Sudeste",31055,"Andrelândia",75032,16353.3070255358,20,15,4,11,5,10,0,0,0,0,0,15,4,11,5,10,14,9.70218542043144,11.2256699681888,0.442513406928863,2020-05-18,2020,5
"3451","MG",3,"Sudeste",31055,"Andrelândia",75032,16353.3070255358,21,19,6,13,7,12,0,0,0,0,0,19,6,13,7,12,16,9.70218542043144,11.2256699681888,0.424985012283743,2020-05-25,2020,5
"3452","MG",3,"Sudeste",31056,"Itajubá",198111,22832.1261559934,5,49,10,39,15,34,0,0,0,0,0,49,10,39,15,34,28,10.035923865104,12.1965827586564,0.309469266022661,2020-02-03,2020,2
"3453","MG",3,"Sudeste",31056,"Itajubá",198111,22832.1261559934,6,52,16,36,16,36,0,0,0,0,0,52,16,36,16,36,35,10.035923865104,12.1965827586564,0.314978764038425,2020-02-10,2020,2
"3454","MG",3,"Sudeste",31056,"Itajubá",198111,22832.1261559934,7,42,6,36,17,25,0,0,0,0,0,42,6,36,17,25,29,10.035923865104,12.1965827586564,0.309263713090924,2020-02-17,2020,2
"3455","MG",3,"Sudeste",31056,"Itajubá",198111,22832.1261559934,8,44,8,36,18,26,0,0,0,0,0,44,8,36,18,26,22,10.035923865104,12.1965827586564,0.367286901518156,2020-02-24,2020,2
"3456","MG",3,"Sudeste",31056,"Itajubá",198111,22832.1261559934,9,38,9,29,10,28,0,0,0,0,0,38,9,29,10,28,29,10.035923865104,12.1965827586564,0.338161732501631,2020-03-02,2020,3
"3457","MG",3,"Sudeste",31056,"Itajubá",198111,22832.1261559934,10,44,7,37,14,30,0,0,0,0,0,44,7,37,14,30,30,10.035923865104,12.1965827586564,0.343910690657363,2020-03-09,2020,3
"3458","MG",3,"Sudeste",31056,"Itajubá",198111,22832.1261559934,11,35,7,28,14,21,0,0,0,0,0,35,7,28,14,21,30,10.035923865104,12.1965827586564,0.453313051845705,2020-03-16,2020,3
"3459","MG",3,"Sudeste",31056,"Itajubá",198111,22832.1261559934,12,31,5,26,11,20,0,0,0,0,0,31,5,26,11,20,25,10.035923865104,12.1965827586564,0.547450114551541,2020-03-23,2020,3
"3460","MG",3,"Sudeste",31056,"Itajubá",198111,22832.1261559934,13,40,9,31,12,28,0,0,0,0,0,40,9,31,12,28,23,10.035923865104,12.1965827586564,0.505842446378749,2020-03-30,2020,3
"3461","MG",3,"Sudeste",31056,"Itajubá",198111,22832.1261559934,14,21,2,19,12,9,0,0,0,0,0,21,2,19,12,9,33,10.035923865104,12.1965827586564,0.497075325561183,2020-04-06,2020,4
"3462","MG",3,"Sudeste",31056,"Itajubá",198111,22832.1261559934,15,27,4,23,7,20,0,0,0,0,0,27,4,23,7,20,28,10.035923865104,12.1965827586564,0.461082503235661,2020-04-13,2020,4
"3463","MG",3,"Sudeste",31056,"Itajubá",198111,22832.1261559934,16,41,7,34,13,28,1,0,1,1,0,42,7,35,14,28,22,10.035923865104,12.1965827586564,0.457399799164395,2020-04-20,2020,4
"3464","MG",3,"Sudeste",31056,"Itajubá",198111,22832.1261559934,17,42,9,33,15,27,1,1,0,0,1,43,10,33,15,28,23,10.035923865104,12.1965827586564,0.444864951297829,2020-04-27,2020,4
"3465","MG",3,"Sudeste",31056,"Itajubá",198111,22832.1261559934,18,41,5,36,7,34,0,0,0,0,0,41,5,36,7,34,31,10.035923865104,12.1965827586564,0.430045812382986,2020-05-04,2020,5
"3466","MG",3,"Sudeste",31056,"Itajubá",198111,22832.1261559934,19,37,8,29,9,28,0,0,0,0,0,37,8,29,9,28,34,10.035923865104,12.1965827586564,0.43282288055659,2020-05-11,2020,5
"3467","MG",3,"Sudeste",31056,"Itajubá",198111,22832.1261559934,20,40,6,34,12,28,1,0,1,0,1,41,6,35,12,29,24,10.035923865104,12.1965827586564,0.428774468896604,2020-05-18,2020,5
"3468","MG",3,"Sudeste",31056,"Itajubá",198111,22832.1261559934,21,47,10,37,18,29,0,0,0,0,0,47,10,37,18,29,22,10.035923865104,12.1965827586564,0.422627257987069,2020-05-25,2020,5
"3469","MG",3,"Sudeste",31057,"Lavras",164297,23814.5967222773,5,32,5,27,10,22,2,0,2,1,1,34,5,29,11,23,18,10.078053979322,12.0094310445769,0.28781329357191,2020-02-03,2020,2
"3470","MG",3,"Sudeste",31057,"Lavras",164297,23814.5967222773,6,34,10,24,12,22,1,0,1,1,0,35,10,25,13,22,21,10.078053979322,12.0094310445769,0.283837857689794,2020-02-10,2020,2
"3471","MG",3,"Sudeste",31057,"Lavras",164297,23814.5967222773,7,32,6,26,3,29,3,0,3,2,1,35,6,29,5,30,20,10.078053979322,12.0094310445769,0.292455849625966,2020-02-17,2020,2
"3472","MG",3,"Sudeste",31057,"Lavras",164297,23814.5967222773,8,36,5,31,9,27,1,0,1,0,1,37,5,32,9,28,16,10.078053979322,12.0094310445769,0.339154416983035,2020-02-24,2020,2
"3473","MG",3,"Sudeste",31057,"Lavras",164297,23814.5967222773,9,44,10,34,11,33,0,0,0,0,0,44,10,34,11,33,24,10.078053979322,12.0094310445769,0.305425706712401,2020-03-02,2020,3
"3474","MG",3,"Sudeste",31057,"Lavras",164297,23814.5967222773,10,40,6,34,11,29,1,0,1,0,1,41,6,35,11,30,24,10.078053979322,12.0094310445769,0.307680686696377,2020-03-09,2020,3
"3475","MG",3,"Sudeste",31057,"Lavras",164297,23814.5967222773,11,41,10,31,12,29,0,0,0,0,0,41,10,31,12,29,18,10.078053979322,12.0094310445769,0.40461534558967,2020-03-16,2020,3
"3476","MG",3,"Sudeste",31057,"Lavras",164297,23814.5967222773,12,28,7,21,6,22,1,0,1,0,1,29,7,22,6,23,21,10.078053979322,12.0094310445769,0.521256244883454,2020-03-23,2020,3
"3477","MG",3,"Sudeste",31057,"Lavras",164297,23814.5967222773,13,35,5,30,6,29,0,0,0,0,0,35,5,30,6,29,23,10.078053979322,12.0094310445769,0.489776941719668,2020-03-30,2020,3
"3478","MG",3,"Sudeste",31057,"Lavras",164297,23814.5967222773,14,39,9,30,18,21,0,0,0,0,0,39,9,30,18,21,20,10.078053979322,12.0094310445769,0.477592201635506,2020-04-06,2020,4
"3479","MG",3,"Sudeste",31057,"Lavras",164297,23814.5967222773,15,24,5,19,9,15,0,0,0,0,0,24,5,19,9,15,15,10.078053979322,12.0094310445769,0.447217023356938,2020-04-13,2020,4
"3480","MG",3,"Sudeste",31057,"Lavras",164297,23814.5967222773,16,40,10,30,17,23,0,0,0,0,0,40,10,30,17,23,25,10.078053979322,12.0094310445769,0.444357398269563,2020-04-20,2020,4
"3481","MG",3,"Sudeste",31057,"Lavras",164297,23814.5967222773,17,29,5,24,6,23,0,0,0,0,0,29,5,24,6,23,19,10.078053979322,12.0094310445769,0.426979987764229,2020-04-27,2020,4
"3482","MG",3,"Sudeste",31057,"Lavras",164297,23814.5967222773,18,26,7,19,11,15,0,0,0,0,0,26,7,19,11,15,20,10.078053979322,12.0094310445769,0.399413040123087,2020-05-04,2020,5
"3483","MG",3,"Sudeste",31057,"Lavras",164297,23814.5967222773,19,38,9,29,19,19,1,0,1,0,1,39,9,30,19,20,25,10.078053979322,12.0094310445769,0.407132943142599,2020-05-11,2020,5
"3484","MG",3,"Sudeste",31057,"Lavras",164297,23814.5967222773,20,43,9,34,18,25,0,0,0,0,0,43,9,34,18,25,20,10.078053979322,12.0094310445769,0.419277442532362,2020-05-18,2020,5
"3485","MG",3,"Sudeste",31057,"Lavras",164297,23814.5967222773,21,47,14,33,22,25,1,0,1,0,1,48,14,34,22,26,21,10.078053979322,12.0094310445769,0.399304587145358,2020-05-25,2020,5
"3486","MG",3,"Sudeste",31058,"São João Del Rei",194759,21463.4161050837,5,50,11,39,18,32,0,0,0,0,0,50,11,39,18,32,20,9.97410518828239,12.1795181757589,0.30940608772809,2020-02-03,2020,2
"3487","MG",3,"Sudeste",31058,"São João Del Rei",194759,21463.4161050837,6,53,12,41,21,32,1,0,1,0,1,54,12,42,21,33,27,9.97410518828239,12.1795181757589,0.3085239015669,2020-02-10,2020,2
"3488","MG",3,"Sudeste",31058,"São João Del Rei",194759,21463.4161050837,7,35,5,30,11,24,0,0,0,0,0,35,5,30,11,24,33,9.97410518828239,12.1795181757589,0.304305194635661,2020-02-17,2020,2
"3489","MG",3,"Sudeste",31058,"São João Del Rei",194759,21463.4161050837,8,30,4,26,8,22,1,0,1,1,0,31,4,27,9,22,19,9.97410518828239,12.1795181757589,0.367214181038093,2020-02-24,2020,2
"3490","MG",3,"Sudeste",31058,"São João Del Rei",194759,21463.4161050837,9,48,7,41,14,34,0,0,0,0,0,48,7,41,14,34,30,9.97410518828239,12.1795181757589,0.341915432658277,2020-03-02,2020,3
"3491","MG",3,"Sudeste",31058,"São João Del Rei",194759,21463.4161050837,10,33,5,28,5,28,0,0,0,0,0,33,5,28,5,28,34,9.97410518828239,12.1795181757589,0.346076606929235,2020-03-09,2020,3
"3492","MG",3,"Sudeste",31058,"São João Del Rei",194759,21463.4161050837,11,45,6,39,16,29,0,0,0,0,0,45,6,39,16,29,34,9.97410518828239,12.1795181757589,0.434412791180301,2020-03-16,2020,3
"3493","MG",3,"Sudeste",31058,"São João Del Rei",194759,21463.4161050837,12,28,8,20,10,18,0,0,0,0,0,28,8,20,10,18,28,9.97410518828239,12.1795181757589,0.549361914534644,2020-03-23,2020,3
"3494","MG",3,"Sudeste",31058,"São João Del Rei",194759,21463.4161050837,13,25,5,20,7,18,0,0,0,0,0,25,5,20,7,18,22,9.97410518828239,12.1795181757589,0.510024931980808,2020-03-30,2020,3
"3495","MG",3,"Sudeste",31058,"São João Del Rei",194759,21463.4161050837,14,36,6,30,11,25,0,0,0,0,0,36,6,30,11,25,23,9.97410518828239,12.1795181757589,0.50376862693631,2020-04-06,2020,4
"3496","MG",3,"Sudeste",31058,"São João Del Rei",194759,21463.4161050837,15,30,4,26,11,19,1,0,1,0,1,31,4,27,11,20,13,9.97410518828239,12.1795181757589,0.468694629213667,2020-04-13,2020,4
"3497","MG",3,"Sudeste",31058,"São João Del Rei",194759,21463.4161050837,16,24,11,13,8,16,0,0,0,0,0,24,11,13,8,16,19,9.97410518828239,12.1795181757589,0.475016922645446,2020-04-20,2020,4
"3498","MG",3,"Sudeste",31058,"São João Del Rei",194759,21463.4161050837,17,29,6,23,13,16,0,0,0,0,0,29,6,23,13,16,27,9.97410518828239,12.1795181757589,0.457453633673227,2020-04-27,2020,4
"3499","MG",3,"Sudeste",31058,"São João Del Rei",194759,21463.4161050837,18,32,6,26,12,20,0,0,0,0,0,32,6,26,12,20,23,9.97410518828239,12.1795181757589,0.435055462788774,2020-05-04,2020,5
"3500","MG",3,"Sudeste",31058,"São João Del Rei",194759,21463.4161050837,19,33,7,26,12,21,0,0,0,0,0,33,7,26,12,21,23,9.97410518828239,12.1795181757589,0.448378818429718,2020-05-11,2020,5
"3501","MG",3,"Sudeste",31058,"São João Del Rei",194759,21463.4161050837,20,44,12,32,21,23,0,0,0,0,0,44,12,32,21,23,24,9.97410518828239,12.1795181757589,0.447543341390981,2020-05-18,2020,5
"3502","MG",3,"Sudeste",31058,"São João Del Rei",194759,21463.4161050837,21,36,4,32,14,22,0,0,0,0,0,36,4,32,14,22,41,9.97410518828239,12.1795181757589,0.433606948821599,2020-05-25,2020,5
"3503","MG",3,"Sudeste",31059,"Barbacena",238595,19128.8204793059,5,33,8,25,8,25,0,0,0,0,0,33,8,25,8,25,40,9.85895140236848,12.3825228328522,0.300149588860338,2020-02-03,2020,2
"3504","MG",3,"Sudeste",31059,"Barbacena",238595,19128.8204793059,6,48,8,40,16,32,0,0,0,0,0,48,8,40,16,32,37,9.85895140236848,12.3825228328522,0.294723623015538,2020-02-10,2020,2
"3505","MG",3,"Sudeste",31059,"Barbacena",238595,19128.8204793059,7,56,7,49,13,43,1,0,1,0,1,57,7,50,13,44,42,9.85895140236848,12.3825228328522,0.299675306508923,2020-02-17,2020,2
"3506","MG",3,"Sudeste",31059,"Barbacena",238595,19128.8204793059,8,37,9,28,7,30,1,0,1,0,1,38,9,29,7,31,28,9.85895140236848,12.3825228328522,0.365396009040342,2020-02-24,2020,2
"3507","MG",3,"Sudeste",31059,"Barbacena",238595,19128.8204793059,9,46,4,42,10,36,0,0,0,0,0,46,4,42,10,36,34,9.85895140236848,12.3825228328522,0.333408483046802,2020-03-02,2020,3
"3508","MG",3,"Sudeste",31059,"Barbacena",238595,19128.8204793059,10,48,13,35,18,30,1,1,0,0,1,49,14,35,18,31,32,9.85895140236848,12.3825228328522,0.332248238372113,2020-03-09,2020,3
"3509","MG",3,"Sudeste",31059,"Barbacena",238595,19128.8204793059,11,46,8,38,18,28,1,0,1,0,1,47,8,39,18,29,37,9.85895140236848,12.3825228328522,0.429910479684105,2020-03-16,2020,3
"3510","MG",3,"Sudeste",31059,"Barbacena",238595,19128.8204793059,12,32,5,27,10,22,0,0,0,0,0,32,5,27,10,22,29,9.85895140236848,12.3825228328522,0.518767124498378,2020-03-23,2020,3
"3511","MG",3,"Sudeste",31059,"Barbacena",238595,19128.8204793059,13,40,1,39,10,30,0,0,0,0,0,40,1,39,10,30,40,9.85895140236848,12.3825228328522,0.478961262888809,2020-03-30,2020,3
"3512","MG",3,"Sudeste",31059,"Barbacena",238595,19128.8204793059,14,31,8,23,10,21,1,1,0,0,1,32,9,23,10,22,30,9.85895140236848,12.3825228328522,0.47943768133919,2020-04-06,2020,4
"3513","MG",3,"Sudeste",31059,"Barbacena",238595,19128.8204793059,15,53,6,47,13,40,1,0,1,1,0,54,6,48,14,40,32,9.85895140236848,12.3825228328522,0.450254655761289,2020-04-13,2020,4
"3514","MG",3,"Sudeste",31059,"Barbacena",238595,19128.8204793059,16,44,11,33,14,30,1,1,0,1,0,45,12,33,15,30,38,9.85895140236848,12.3825228328522,0.45840654609665,2020-04-20,2020,4
"3515","MG",3,"Sudeste",31059,"Barbacena",238595,19128.8204793059,17,50,8,42,15,35,0,0,0,0,0,50,8,42,15,35,34,9.85895140236848,12.3825228328522,0.450890593705844,2020-04-27,2020,4
"3516","MG",3,"Sudeste",31059,"Barbacena",238595,19128.8204793059,18,56,9,47,14,42,1,0,1,1,0,57,9,48,15,42,35,9.85895140236848,12.3825228328522,0.433534306468487,2020-05-04,2020,5
"3517","MG",3,"Sudeste",31059,"Barbacena",238595,19128.8204793059,19,41,9,32,16,25,2,0,2,1,1,43,9,34,17,26,26,9.85895140236848,12.3825228328522,0.44255925224153,2020-05-11,2020,5
"3518","MG",3,"Sudeste",31059,"Barbacena",238595,19128.8204793059,20,47,14,33,16,31,0,0,0,0,0,47,14,33,16,31,40,9.85895140236848,12.3825228328522,0.429341835720139,2020-05-18,2020,5
"3519","MG",3,"Sudeste",31059,"Barbacena",238595,19128.8204793059,21,50,10,40,14,36,0,0,0,0,0,50,10,40,14,36,34,9.85895140236848,12.3825228328522,0.416249395470794,2020-05-25,2020,5
"3520","MG",3,"Sudeste",31060,"Ponte Nova",186800,17466.6734867773,5,27,11,16,10,17,0,0,0,0,0,27,11,16,10,17,32,9.7680499721053,12.1377938047769,0.296436676962955,2020-02-03,2020,2
"3521","MG",3,"Sudeste",31060,"Ponte Nova",186800,17466.6734867773,6,32,13,19,12,20,0,0,0,0,0,32,13,19,12,20,26,9.7680499721053,12.1377938047769,0.302386777288471,2020-02-10,2020,2
"3522","MG",3,"Sudeste",31060,"Ponte Nova",186800,17466.6734867773,7,22,5,17,5,17,0,0,0,0,0,22,5,17,5,17,26,9.7680499721053,12.1377938047769,0.313459103927076,2020-02-17,2020,2
"3523","MG",3,"Sudeste",31060,"Ponte Nova",186800,17466.6734867773,8,33,12,21,14,19,1,0,1,0,1,34,12,22,14,20,28,9.7680499721053,12.1377938047769,0.351660582637367,2020-02-24,2020,2
"3524","MG",3,"Sudeste",31060,"Ponte Nova",186800,17466.6734867773,9,22,5,17,5,17,0,0,0,0,0,22,5,17,5,17,31,9.7680499721053,12.1377938047769,0.342757986024882,2020-03-02,2020,3
"3525","MG",3,"Sudeste",31060,"Ponte Nova",186800,17466.6734867773,10,47,10,37,20,27,2,1,1,2,0,49,11,38,22,27,34,9.7680499721053,12.1377938047769,0.321491005845864,2020-03-09,2020,3
"3526","MG",3,"Sudeste",31060,"Ponte Nova",186800,17466.6734867773,11,35,10,25,15,20,3,1,2,1,2,38,11,27,16,22,35,9.7680499721053,12.1377938047769,0.4177797116176,2020-03-16,2020,3
"3527","MG",3,"Sudeste",31060,"Ponte Nova",186800,17466.6734867773,12,30,3,27,10,20,0,0,0,0,0,30,3,27,10,20,41,9.7680499721053,12.1377938047769,0.556242153930109,2020-03-23,2020,3
"3528","MG",3,"Sudeste",31060,"Ponte Nova",186800,17466.6734867773,13,22,4,18,4,18,0,0,0,0,0,22,4,18,4,18,19,9.7680499721053,12.1377938047769,0.493726543351781,2020-03-30,2020,3
"3529","MG",3,"Sudeste",31060,"Ponte Nova",186800,17466.6734867773,14,22,5,17,5,17,0,0,0,0,0,22,5,17,5,17,29,9.7680499721053,12.1377938047769,0.478686578599328,2020-04-06,2020,4
"3530","MG",3,"Sudeste",31060,"Ponte Nova",186800,17466.6734867773,15,39,11,28,14,25,0,0,0,0,0,39,11,28,14,25,17,9.7680499721053,12.1377938047769,0.445059174942895,2020-04-13,2020,4
"3531","MG",3,"Sudeste",31060,"Ponte Nova",186800,17466.6734867773,16,45,13,32,19,26,1,1,0,1,0,46,14,32,20,26,25,9.7680499721053,12.1377938047769,0.446589196988235,2020-04-20,2020,4
"3532","MG",3,"Sudeste",31060,"Ponte Nova",186800,17466.6734867773,17,33,10,23,11,22,0,0,0,0,0,33,10,23,11,22,24,9.7680499721053,12.1377938047769,0.442863848452242,2020-04-27,2020,4
"3533","MG",3,"Sudeste",31060,"Ponte Nova",186800,17466.6734867773,18,38,16,22,12,26,0,0,0,0,0,38,16,22,12,26,23,9.7680499721053,12.1377938047769,0.429325157992139,2020-05-04,2020,5
"3534","MG",3,"Sudeste",31060,"Ponte Nova",186800,17466.6734867773,19,38,9,29,10,28,0,0,0,0,0,38,9,29,10,28,35,9.7680499721053,12.1377938047769,0.429468380830961,2020-05-11,2020,5
"3535","MG",3,"Sudeste",31060,"Ponte Nova",186800,17466.6734867773,20,40,9,31,11,29,0,0,0,0,0,40,9,31,11,29,29,9.7680499721053,12.1377938047769,0.431461460783036,2020-05-18,2020,5
"3536","MG",3,"Sudeste",31060,"Ponte Nova",186800,17466.6734867773,21,41,14,27,15,26,0,0,0,0,0,41,14,27,15,26,29,9.7680499721053,12.1377938047769,0.427999986397476,2020-05-25,2020,5
"3537","MG",3,"Sudeste",31061,"Manhuaçu",297164,17429.7507299673,5,73,16,57,28,45,2,2,0,1,1,75,18,57,29,46,41,9.76593383720511,12.602039453937,0.324458393699309,2020-02-03,2020,2
"3538","MG",3,"Sudeste",31061,"Manhuaçu",297164,17429.7507299673,6,73,25,48,30,43,0,0,0,0,0,73,25,48,30,43,39,9.76593383720511,12.602039453937,0.316257756902971,2020-02-10,2020,2
"3539","MG",3,"Sudeste",31061,"Manhuaçu",297164,17429.7507299673,7,75,29,46,28,47,0,0,0,0,0,75,29,46,28,47,39,9.76593383720511,12.602039453937,0.318244991550596,2020-02-17,2020,2
"3540","MG",3,"Sudeste",31061,"Manhuaçu",297164,17429.7507299673,8,73,25,48,27,46,1,1,0,1,0,74,26,48,28,46,32,9.76593383720511,12.602039453937,0.376400683167997,2020-02-24,2020,2
"3541","MG",3,"Sudeste",31061,"Manhuaçu",297164,17429.7507299673,9,70,25,45,36,34,1,0,1,0,1,71,25,46,36,35,27,9.76593383720511,12.602039453937,0.359996315629007,2020-03-02,2020,3
"3542","MG",3,"Sudeste",31061,"Manhuaçu",297164,17429.7507299673,10,93,39,54,38,55,0,0,0,0,0,93,39,54,38,55,48,9.76593383720511,12.602039453937,0.348436984314475,2020-03-09,2020,3
"3543","MG",3,"Sudeste",31061,"Manhuaçu",297164,17429.7507299673,11,69,17,52,34,35,2,0,2,0,2,71,17,54,34,37,37,9.76593383720511,12.602039453937,0.435396320141158,2020-03-16,2020,3
"3544","MG",3,"Sudeste",31061,"Manhuaçu",297164,17429.7507299673,12,71,25,46,29,42,0,0,0,0,0,71,25,46,29,42,32,9.76593383720511,12.602039453937,0.546932570693486,2020-03-23,2020,3
"3545","MG",3,"Sudeste",31061,"Manhuaçu",297164,17429.7507299673,13,58,18,40,24,34,1,0,1,1,0,59,18,41,25,34,30,9.76593383720511,12.602039453937,0.471519439232255,2020-03-30,2020,3
"3546","MG",3,"Sudeste",31061,"Manhuaçu",297164,17429.7507299673,14,78,30,48,30,48,0,0,0,0,0,78,30,48,30,48,33,9.76593383720511,12.602039453937,0.469004501629137,2020-04-06,2020,4
"3547","MG",3,"Sudeste",31061,"Manhuaçu",297164,17429.7507299673,15,80,22,58,33,47,0,0,0,0,0,80,22,58,33,47,28,9.76593383720511,12.602039453937,0.43144856925321,2020-04-13,2020,4
"3548","MG",3,"Sudeste",31061,"Manhuaçu",297164,17429.7507299673,16,69,25,44,29,40,1,1,0,0,1,70,26,44,29,41,42,9.76593383720511,12.602039453937,0.433561074148377,2020-04-20,2020,4
"3549","MG",3,"Sudeste",31061,"Manhuaçu",297164,17429.7507299673,17,70,31,39,36,34,2,1,1,0,2,72,32,40,36,36,40,9.76593383720511,12.602039453937,0.435069996384316,2020-04-27,2020,4
"3550","MG",3,"Sudeste",31061,"Manhuaçu",297164,17429.7507299673,18,74,26,48,30,44,0,0,0,0,0,74,26,48,30,44,35,9.76593383720511,12.602039453937,0.420785879331922,2020-05-04,2020,5
"3551","MG",3,"Sudeste",31061,"Manhuaçu",297164,17429.7507299673,19,77,24,53,29,48,2,2,0,2,0,79,26,53,31,48,42,9.76593383720511,12.602039453937,0.43676717649768,2020-05-11,2020,5
"3552","MG",3,"Sudeste",31061,"Manhuaçu",297164,17429.7507299673,20,107,40,67,42,65,0,0,0,0,0,107,40,67,42,65,35,9.76593383720511,12.602039453937,0.418959659704939,2020-05-18,2020,5
"3553","MG",3,"Sudeste",31061,"Manhuaçu",297164,17429.7507299673,21,101,34,67,46,55,0,0,0,0,0,101,34,67,46,55,43,9.76593383720511,12.602039453937,0.419369652869378,2020-05-25,2020,5
"3554","MG",3,"Sudeste",31062,"Viçosa",229637,14733.6298364375,5,46,10,36,11,35,0,0,0,0,0,46,10,36,11,35,31,9.59788790384026,12.3442550802701,0.306036662356653,2020-02-03,2020,2
"3555","MG",3,"Sudeste",31062,"Viçosa",229637,14733.6298364375,6,40,7,33,11,29,0,0,0,0,0,40,7,33,11,29,29,9.59788790384026,12.3442550802701,0.298606034350666,2020-02-10,2020,2
"3556","MG",3,"Sudeste",31062,"Viçosa",229637,14733.6298364375,7,38,4,34,16,22,0,0,0,0,0,38,4,34,16,22,22,9.59788790384026,12.3442550802701,0.308390219287107,2020-02-17,2020,2
"3557","MG",3,"Sudeste",31062,"Viçosa",229637,14733.6298364375,8,46,13,33,16,30,0,0,0,0,0,46,13,33,16,30,27,9.59788790384026,12.3442550802701,0.369513330547727,2020-02-24,2020,2
"3558","MG",3,"Sudeste",31062,"Viçosa",229637,14733.6298364375,9,42,8,34,10,32,0,0,0,0,0,42,8,34,10,32,37,9.59788790384026,12.3442550802701,0.318573713432343,2020-03-02,2020,3
"3559","MG",3,"Sudeste",31062,"Viçosa",229637,14733.6298364375,10,45,7,38,21,24,0,0,0,0,0,45,7,38,21,24,44,9.59788790384026,12.3442550802701,0.316223609031099,2020-03-09,2020,3
"3560","MG",3,"Sudeste",31062,"Viçosa",229637,14733.6298364375,11,33,9,24,11,22,1,1,0,0,1,34,10,24,11,23,33,9.59788790384026,12.3442550802701,0.449961607851812,2020-03-16,2020,3
"3561","MG",3,"Sudeste",31062,"Viçosa",229637,14733.6298364375,12,41,12,29,11,30,0,0,0,0,0,41,12,29,11,30,27,9.59788790384026,12.3442550802701,0.596550812406496,2020-03-23,2020,3
"3562","MG",3,"Sudeste",31062,"Viçosa",229637,14733.6298364375,13,24,6,18,4,20,0,0,0,0,0,24,6,18,4,20,29,9.59788790384026,12.3442550802701,0.541089393455562,2020-03-30,2020,3
"3563","MG",3,"Sudeste",31062,"Viçosa",229637,14733.6298364375,14,27,4,23,6,21,0,0,0,0,0,27,4,23,6,21,25,9.59788790384026,12.3442550802701,0.523646035935673,2020-04-06,2020,4
"3564","MG",3,"Sudeste",31062,"Viçosa",229637,14733.6298364375,15,59,16,43,16,43,0,0,0,0,0,59,16,43,16,43,33,9.59788790384026,12.3442550802701,0.494893547517988,2020-04-13,2020,4
"3565","MG",3,"Sudeste",31062,"Viçosa",229637,14733.6298364375,16,41,9,32,17,24,0,0,0,0,0,41,9,32,17,24,46,9.59788790384026,12.3442550802701,0.50837468282804,2020-04-20,2020,4
"3566","MG",3,"Sudeste",31062,"Viçosa",229637,14733.6298364375,17,23,5,18,10,13,0,0,0,0,0,23,5,18,10,13,38,9.59788790384026,12.3442550802701,0.47949411824612,2020-04-27,2020,4
"3567","MG",3,"Sudeste",31062,"Viçosa",229637,14733.6298364375,18,37,10,27,14,23,0,0,0,0,0,37,10,27,14,23,22,9.59788790384026,12.3442550802701,0.458795528465641,2020-05-04,2020,5
"3568","MG",3,"Sudeste",31062,"Viçosa",229637,14733.6298364375,19,35,14,21,6,29,0,0,0,0,0,35,14,21,6,29,29,9.59788790384026,12.3442550802701,0.460013977110769,2020-05-11,2020,5
"3569","MG",3,"Sudeste",31062,"Viçosa",229637,14733.6298364375,20,46,10,36,17,29,0,0,0,0,0,46,10,36,17,29,24,9.59788790384026,12.3442550802701,0.470224685608196,2020-05-18,2020,5
"3570","MG",3,"Sudeste",31062,"Viçosa",229637,14733.6298364375,21,56,12,44,19,37,0,0,0,0,0,56,12,44,19,37,29,9.59788790384026,12.3442550802701,0.449415676460303,2020-05-25,2020,5
"3571","MG",3,"Sudeste",31063,"Muriaé",291697,16109.5650779405,5,46,12,34,17,29,0,0,0,0,0,46,12,34,17,29,41,9.68716847878241,12.583470871264,0.303582975074334,2020-02-03,2020,2
"3572","MG",3,"Sudeste",31063,"Muriaé",291697,16109.5650779405,6,42,12,30,21,21,0,0,0,0,0,42,12,30,21,21,32,9.68716847878241,12.583470871264,0.306370422512382,2020-02-10,2020,2
"3573","MG",3,"Sudeste",31063,"Muriaé",291697,16109.5650779405,7,57,18,39,15,42,1,0,1,0,1,58,18,40,15,43,46,9.68716847878241,12.583470871264,0.304458989141701,2020-02-17,2020,2
"3574","MG",3,"Sudeste",31063,"Muriaé",291697,16109.5650779405,8,45,15,30,18,27,0,0,0,0,0,45,15,30,18,27,36,9.68716847878241,12.583470871264,0.362577369098208,2020-02-24,2020,2
"3575","MG",3,"Sudeste",31063,"Muriaé",291697,16109.5650779405,9,62,16,46,19,43,0,0,0,0,0,62,16,46,19,43,36,9.68716847878241,12.583470871264,0.323039289576514,2020-03-02,2020,3
"3576","MG",3,"Sudeste",31063,"Muriaé",291697,16109.5650779405,10,73,18,55,26,47,0,0,0,0,0,73,18,55,26,47,52,9.68716847878241,12.583470871264,0.324004958259584,2020-03-09,2020,3
"3577","MG",3,"Sudeste",31063,"Muriaé",291697,16109.5650779405,11,57,15,42,23,34,0,0,0,0,0,57,15,42,23,34,61,9.68716847878241,12.583470871264,0.413205349886994,2020-03-16,2020,3
"3578","MG",3,"Sudeste",31063,"Muriaé",291697,16109.5650779405,12,51,11,40,17,34,0,0,0,0,0,51,11,40,17,34,37,9.68716847878241,12.583470871264,0.526836890340153,2020-03-23,2020,3
"3579","MG",3,"Sudeste",31063,"Muriaé",291697,16109.5650779405,13,42,19,23,17,25,0,0,0,0,0,42,19,23,17,25,37,9.68716847878241,12.583470871264,0.497862079866066,2020-03-30,2020,3
"3580","MG",3,"Sudeste",31063,"Muriaé",291697,16109.5650779405,14,48,19,29,27,21,0,0,0,0,0,48,19,29,27,21,51,9.68716847878241,12.583470871264,0.482496785098614,2020-04-06,2020,4
"3581","MG",3,"Sudeste",31063,"Muriaé",291697,16109.5650779405,15,51,15,36,21,30,1,0,1,0,1,52,15,37,21,31,31,9.68716847878241,12.583470871264,0.4345283910248,2020-04-13,2020,4
"3582","MG",3,"Sudeste",31063,"Muriaé",291697,16109.5650779405,16,72,14,58,25,47,2,0,2,0,2,74,14,60,25,49,49,9.68716847878241,12.583470871264,0.439262158224919,2020-04-20,2020,4
"3583","MG",3,"Sudeste",31063,"Muriaé",291697,16109.5650779405,17,66,16,50,33,33,0,0,0,0,0,66,16,50,33,33,41,9.68716847878241,12.583470871264,0.424878976809921,2020-04-27,2020,4
"3584","MG",3,"Sudeste",31063,"Muriaé",291697,16109.5650779405,18,48,12,36,24,24,0,0,0,0,0,48,12,36,24,24,43,9.68716847878241,12.583470871264,0.411868210261908,2020-05-04,2020,5
"3585","MG",3,"Sudeste",31063,"Muriaé",291697,16109.5650779405,19,71,21,50,26,45,1,0,1,1,0,72,21,51,27,45,44,9.68716847878241,12.583470871264,0.432302039351849,2020-05-11,2020,5
"3586","MG",3,"Sudeste",31063,"Muriaé",291697,16109.5650779405,20,72,19,53,34,38,0,0,0,0,0,72,19,53,34,38,46,9.68716847878241,12.583470871264,0.414551732642512,2020-05-18,2020,5
"3587","MG",3,"Sudeste",31063,"Muriaé",291697,16109.5650779405,21,66,15,51,22,44,1,0,1,1,0,67,15,52,23,44,53,9.68716847878241,12.583470871264,0.407246702591037,2020-05-25,2020,5
"3588","MG",3,"Sudeste",31064,"Ubá",296805,21114.7754751436,5,48,18,30,21,27,0,0,0,0,0,48,18,30,21,27,40,9.95772833388236,12.6008306364946,0.295197007127461,2020-02-03,2020,2
"3589","MG",3,"Sudeste",31064,"Ubá",296805,21114.7754751436,6,52,15,37,20,32,0,0,0,0,0,52,15,37,20,32,43,9.95772833388236,12.6008306364946,0.295944339772241,2020-02-10,2020,2
"3590","MG",3,"Sudeste",31064,"Ubá",296805,21114.7754751436,7,46,12,34,12,34,0,0,0,0,0,46,12,34,12,34,37,9.95772833388236,12.6008306364946,0.300551556184295,2020-02-17,2020,2
"3591","MG",3,"Sudeste",31064,"Ubá",296805,21114.7754751436,8,56,17,39,16,40,0,0,0,0,0,56,17,39,16,40,45,9.95772833388236,12.6008306364946,0.384603452206088,2020-02-24,2020,2
"3592","MG",3,"Sudeste",31064,"Ubá",296805,21114.7754751436,9,62,22,40,23,39,1,1,0,0,1,63,23,40,23,40,39,9.95772833388236,12.6008306364946,0.340242811902616,2020-03-02,2020,3
"3593","MG",3,"Sudeste",31064,"Ubá",296805,21114.7754751436,10,60,16,44,14,46,0,0,0,0,0,60,16,44,14,46,40,9.95772833388236,12.6008306364946,0.333170668822843,2020-03-09,2020,3
"3594","MG",3,"Sudeste",31064,"Ubá",296805,21114.7754751436,11,49,19,30,17,32,0,0,0,0,0,49,19,30,17,32,48,9.95772833388236,12.6008306364946,0.416268110777725,2020-03-16,2020,3
"3595","MG",3,"Sudeste",31064,"Ubá",296805,21114.7754751436,12,50,13,37,12,38,1,0,1,0,1,51,13,38,12,39,34,9.95772833388236,12.6008306364946,0.534552261335832,2020-03-23,2020,3
"3596","MG",3,"Sudeste",31064,"Ubá",296805,21114.7754751436,13,57,11,46,19,38,0,0,0,0,0,57,11,46,19,38,18,9.95772833388236,12.6008306364946,0.502140622329598,2020-03-30,2020,3
"3597","MG",3,"Sudeste",31064,"Ubá",296805,21114.7754751436,14,52,17,35,19,33,0,0,0,0,0,52,17,35,19,33,32,9.95772833388236,12.6008306364946,0.498749285886183,2020-04-06,2020,4
"3598","MG",3,"Sudeste",31064,"Ubá",296805,21114.7754751436,15,52,19,33,20,32,0,0,0,0,0,52,19,33,20,32,31,9.95772833388236,12.6008306364946,0.450655648459174,2020-04-13,2020,4
"3599","MG",3,"Sudeste",31064,"Ubá",296805,21114.7754751436,16,62,19,43,23,39,1,0,1,1,0,63,19,44,24,39,30,9.95772833388236,12.6008306364946,0.445037298772822,2020-04-20,2020,4
"3600","MG",3,"Sudeste",31064,"Ubá",296805,21114.7754751436,17,56,21,35,20,36,2,0,2,0,2,58,21,37,20,38,35,9.95772833388236,12.6008306364946,0.432620464609608,2020-04-27,2020,4
"3601","MG",3,"Sudeste",31064,"Ubá",296805,21114.7754751436,18,64,12,52,21,43,0,0,0,0,0,64,12,52,21,43,53,9.95772833388236,12.6008306364946,0.416616824352753,2020-05-04,2020,5
"3602","MG",3,"Sudeste",31064,"Ubá",296805,21114.7754751436,19,52,14,38,21,31,1,0,1,0,1,53,14,39,21,32,36,9.95772833388236,12.6008306364946,0.434725374816395,2020-05-11,2020,5
"3603","MG",3,"Sudeste",31064,"Ubá",296805,21114.7754751436,20,68,17,51,28,40,1,0,1,0,1,69,17,52,28,41,41,9.95772833388236,12.6008306364946,0.41369829067756,2020-05-18,2020,5
"3604","MG",3,"Sudeste",31064,"Ubá",296805,21114.7754751436,21,70,26,44,26,44,1,0,1,1,0,71,26,45,27,44,37,9.95772833388236,12.6008306364946,0.401082325923941,2020-05-25,2020,5
"3605","MG",3,"Sudeste",31065,"Juiz de Fora",792397,26441.4531930964,5,142,23,119,45,97,0,0,0,0,0,142,23,119,45,97,112,10.1826882543727,13.5828178078327,0.257074180133828,2020-02-03,2020,2
"3606","MG",3,"Sudeste",31065,"Juiz de Fora",792397,26441.4531930964,6,149,28,121,43,106,3,0,3,1,2,152,28,124,44,108,121,10.1826882543727,13.5828178078327,0.264565011284408,2020-02-10,2020,2
"3607","MG",3,"Sudeste",31065,"Juiz de Fora",792397,26441.4531930964,7,122,25,97,43,79,2,0,2,1,1,124,25,99,44,80,112,10.1826882543727,13.5828178078327,0.276654039885536,2020-02-17,2020,2
"3608","MG",3,"Sudeste",31065,"Juiz de Fora",792397,26441.4531930964,8,139,28,111,37,102,1,1,0,0,1,140,29,111,37,103,131,10.1826882543727,13.5828178078327,0.356674979166827,2020-02-24,2020,2
"3609","MG",3,"Sudeste",31065,"Juiz de Fora",792397,26441.4531930964,9,130,29,101,39,91,2,0,2,1,1,132,29,103,40,92,105,10.1826882543727,13.5828178078327,0.291896866330942,2020-03-02,2020,3
"3610","MG",3,"Sudeste",31065,"Juiz de Fora",792397,26441.4531930964,10,146,29,117,50,96,2,0,2,1,1,148,29,119,51,97,117,10.1826882543727,13.5828178078327,0.294664349724598,2020-03-09,2020,3
"3611","MG",3,"Sudeste",31065,"Juiz de Fora",792397,26441.4531930964,11,133,40,93,62,71,1,1,0,0,1,134,41,93,62,72,127,10.1826882543727,13.5828178078327,0.430659805572672,2020-03-16,2020,3
"3612","MG",3,"Sudeste",31065,"Juiz de Fora",792397,26441.4531930964,12,117,29,88,34,83,0,0,0,0,0,117,29,88,34,83,125,10.1826882543727,13.5828178078327,0.550828995528665,2020-03-23,2020,3
"3613","MG",3,"Sudeste",31065,"Juiz de Fora",792397,26441.4531930964,13,138,38,100,36,102,3,1,2,1,2,141,39,102,37,104,98,10.1826882543727,13.5828178078327,0.511008955265254,2020-03-30,2020,3
"3614","MG",3,"Sudeste",31065,"Juiz de Fora",792397,26441.4531930964,14,150,35,115,44,106,0,0,0,0,0,150,35,115,44,106,88,10.1826882543727,13.5828178078327,0.502176263945596,2020-04-06,2020,4
"3615","MG",3,"Sudeste",31065,"Juiz de Fora",792397,26441.4531930964,15,156,21,135,57,99,1,0,1,1,0,157,21,136,58,99,125,10.1826882543727,13.5828178078327,0.480631144531192,2020-04-13,2020,4
"3616","MG",3,"Sudeste",31065,"Juiz de Fora",792397,26441.4531930964,16,162,53,109,49,113,0,0,0,0,0,162,53,109,49,113,117,10.1826882543727,13.5828178078327,0.48227802073785,2020-04-20,2020,4
"3617","MG",3,"Sudeste",31065,"Juiz de Fora",792397,26441.4531930964,17,153,35,118,57,96,0,0,0,0,0,153,35,118,57,96,119,10.1826882543727,13.5828178078327,0.464431725076603,2020-04-27,2020,4
"3618","MG",3,"Sudeste",31065,"Juiz de Fora",792397,26441.4531930964,18,133,28,105,47,86,0,0,0,0,0,133,28,105,47,86,116,10.1826882543727,13.5828178078327,0.43871015764893,2020-05-04,2020,5
"3619","MG",3,"Sudeste",31065,"Juiz de Fora",792397,26441.4531930964,19,134,32,102,52,82,1,0,1,0,1,135,32,103,52,83,127,10.1826882543727,13.5828178078327,0.454772188128727,2020-05-11,2020,5
"3620","MG",3,"Sudeste",31065,"Juiz de Fora",792397,26441.4531930964,20,129,37,92,43,86,0,0,0,0,0,129,37,92,43,86,123,10.1826882543727,13.5828178078327,0.440331408745037,2020-05-18,2020,5
"3621","MG",3,"Sudeste",31065,"Juiz de Fora",792397,26441.4531930964,21,164,43,121,51,113,2,0,2,0,2,166,43,123,51,115,106,10.1826882543727,13.5828178078327,0.426691422942852,2020-05-25,2020,5
"3622","MG",3,"Sudeste",31066,"Cataguases",227094,20092.893563106,5,45,10,35,18,27,0,0,0,0,0,45,10,35,18,27,39,9.90812147745786,12.3331193076654,0.299452355780856,2020-02-03,2020,2
"3623","MG",3,"Sudeste",31066,"Cataguases",227094,20092.893563106,6,43,9,34,14,29,0,0,0,0,0,43,9,34,14,29,37,9.90812147745786,12.3331193076654,0.305769619351059,2020-02-10,2020,2
"3624","MG",3,"Sudeste",31066,"Cataguases",227094,20092.893563106,7,27,10,17,11,16,1,0,1,1,0,28,10,18,12,16,41,9.90812147745786,12.3331193076654,0.308622236864348,2020-02-17,2020,2
"3625","MG",3,"Sudeste",31066,"Cataguases",227094,20092.893563106,8,35,5,30,9,26,0,0,0,0,0,35,5,30,9,26,30,9.90812147745786,12.3331193076654,0.381456519645712,2020-02-24,2020,2
"3626","MG",3,"Sudeste",31066,"Cataguases",227094,20092.893563106,9,50,11,39,19,31,0,0,0,0,0,50,11,39,19,31,42,9.90812147745786,12.3331193076654,0.334558596779959,2020-03-02,2020,3
"3627","MG",3,"Sudeste",31066,"Cataguases",227094,20092.893563106,10,39,10,29,9,30,0,0,0,0,0,39,10,29,9,30,42,9.90812147745786,12.3331193076654,0.332776990718948,2020-03-09,2020,3
"3628","MG",3,"Sudeste",31066,"Cataguases",227094,20092.893563106,11,34,8,26,15,19,0,0,0,0,0,34,8,26,15,19,34,9.90812147745786,12.3331193076654,0.427806960270378,2020-03-16,2020,3
"3629","MG",3,"Sudeste",31066,"Cataguases",227094,20092.893563106,12,36,15,21,14,22,0,0,0,0,0,36,15,21,14,22,29,9.90812147745786,12.3331193076654,0.564144811187984,2020-03-23,2020,3
"3630","MG",3,"Sudeste",31066,"Cataguases",227094,20092.893563106,13,31,9,22,11,20,1,0,1,0,1,32,9,23,11,21,38,9.90812147745786,12.3331193076654,0.514002481288126,2020-03-30,2020,3
"3631","MG",3,"Sudeste",31066,"Cataguases",227094,20092.893563106,14,33,9,24,12,21,0,0,0,0,0,33,9,24,12,21,38,9.90812147745786,12.3331193076654,0.497979431019733,2020-04-06,2020,4
"3632","MG",3,"Sudeste",31066,"Cataguases",227094,20092.893563106,15,42,5,37,5,37,0,0,0,0,0,42,5,37,5,37,23,9.90812147745786,12.3331193076654,0.471267430631394,2020-04-13,2020,4
"3633","MG",3,"Sudeste",31066,"Cataguases",227094,20092.893563106,16,40,8,32,13,27,0,0,0,0,0,40,8,32,13,27,36,9.90812147745786,12.3331193076654,0.484335970319594,2020-04-20,2020,4
"3634","MG",3,"Sudeste",31066,"Cataguases",227094,20092.893563106,17,56,14,42,26,30,0,0,0,0,0,56,14,42,26,30,31,9.90812147745786,12.3331193076654,0.473959945891152,2020-04-27,2020,4
"3635","MG",3,"Sudeste",31066,"Cataguases",227094,20092.893563106,18,39,8,31,12,27,0,0,0,0,0,39,8,31,12,27,37,9.90812147745786,12.3331193076654,0.450212322982964,2020-05-04,2020,5
"3636","MG",3,"Sudeste",31066,"Cataguases",227094,20092.893563106,19,47,11,36,20,27,0,0,0,0,0,47,11,36,20,27,43,9.90812147745786,12.3331193076654,0.460672057966162,2020-05-11,2020,5
"3637","MG",3,"Sudeste",31066,"Cataguases",227094,20092.893563106,20,47,11,36,17,30,0,0,0,0,0,47,11,36,17,30,40,9.90812147745786,12.3331193076654,0.449993635946825,2020-05-18,2020,5
"3638","MG",3,"Sudeste",31066,"Cataguases",227094,20092.893563106,21,50,11,39,21,29,0,0,0,0,0,50,11,39,21,29,32,9.90812147745786,12.3331193076654,0.431156633525136,2020-05-25,2020,5
"3639","MS",5,"Centro-oeste",50001,"Baixo Pantanal",153045,24658.7393311771,5,41,11,30,14,27,0,0,0,0,0,41,11,30,14,27,20,10.1128866533993,11.9384872747775,0.29816374564549,2020-02-03,2020,2
"3640","MS",5,"Centro-oeste",50001,"Baixo Pantanal",153045,24658.7393311771,6,39,14,25,14,25,1,0,1,0,1,40,14,26,14,26,24,10.1128866533993,11.9384872747775,0.279350135384797,2020-02-10,2020,2
"3641","MS",5,"Centro-oeste",50001,"Baixo Pantanal",153045,24658.7393311771,7,35,12,23,15,20,0,0,0,0,0,35,12,23,15,20,33,10.1128866533993,11.9384872747775,0.294930293544819,2020-02-17,2020,2
"3642","MS",5,"Centro-oeste",50001,"Baixo Pantanal",153045,24658.7393311771,8,34,14,20,17,17,0,0,0,0,0,34,14,20,17,17,22,10.1128866533993,11.9384872747775,0.346099599178117,2020-02-24,2020,2
"3643","MS",5,"Centro-oeste",50001,"Baixo Pantanal",153045,24658.7393311771,9,42,14,28,13,29,1,1,0,0,1,43,15,28,13,30,25,10.1128866533993,11.9384872747775,0.319584332786642,2020-03-02,2020,3
"3644","MS",5,"Centro-oeste",50001,"Baixo Pantanal",153045,24658.7393311771,10,34,8,26,9,25,1,0,1,1,0,35,8,27,10,25,37,10.1128866533993,11.9384872747775,0.317982413078617,2020-03-09,2020,3
"3645","MS",5,"Centro-oeste",50001,"Baixo Pantanal",153045,24658.7393311771,11,50,21,29,23,27,0,0,0,0,0,50,21,29,23,27,16,10.1128866533993,11.9384872747775,0.415313420024687,2020-03-16,2020,3
"3646","MS",5,"Centro-oeste",50001,"Baixo Pantanal",153045,24658.7393311771,12,42,16,26,21,21,0,0,0,0,0,42,16,26,21,21,17,10.1128866533993,11.9384872747775,0.464926904891467,2020-03-23,2020,3
"3647","MS",5,"Centro-oeste",50001,"Baixo Pantanal",153045,24658.7393311771,13,32,17,15,14,18,0,0,0,0,0,32,17,15,14,18,14,10.1128866533993,11.9384872747775,0.436319034173045,2020-03-30,2020,3
"3648","MS",5,"Centro-oeste",50001,"Baixo Pantanal",153045,24658.7393311771,14,45,13,32,19,26,0,0,0,0,0,45,13,32,19,26,21,10.1128866533993,11.9384872747775,0.439529584001098,2020-04-06,2020,4
"3649","MS",5,"Centro-oeste",50001,"Baixo Pantanal",153045,24658.7393311771,15,41,12,29,14,27,2,2,0,1,1,43,14,29,15,28,15,10.1128866533993,11.9384872747775,0.413973087664098,2020-04-13,2020,4
"3650","MS",5,"Centro-oeste",50001,"Baixo Pantanal",153045,24658.7393311771,16,56,25,31,21,35,0,0,0,0,0,56,25,31,21,35,15,10.1128866533993,11.9384872747775,0.4289591822548,2020-04-20,2020,4
"3651","MS",5,"Centro-oeste",50001,"Baixo Pantanal",153045,24658.7393311771,17,51,17,34,20,31,1,1,0,1,0,52,18,34,21,31,13,10.1128866533993,11.9384872747775,0.413070220583728,2020-04-27,2020,4
"3652","MS",5,"Centro-oeste",50001,"Baixo Pantanal",153045,24658.7393311771,18,44,11,33,22,22,0,0,0,0,0,44,11,33,22,22,11,10.1128866533993,11.9384872747775,0.410553487657445,2020-05-04,2020,5
"3653","MS",5,"Centro-oeste",50001,"Baixo Pantanal",153045,24658.7393311771,19,44,21,23,23,21,2,0,2,2,0,46,21,25,25,21,9,10.1128866533993,11.9384872747775,0.424156669805121,2020-05-11,2020,5
"3654","MS",5,"Centro-oeste",50001,"Baixo Pantanal",153045,24658.7393311771,20,62,23,39,24,38,1,1,0,0,1,63,24,39,24,39,9,10.1128866533993,11.9384872747775,0.426212177472695,2020-05-18,2020,5
"3655","MS",5,"Centro-oeste",50001,"Baixo Pantanal",153045,24658.7393311771,21,54,18,36,25,29,0,0,0,0,0,54,18,36,25,29,20,10.1128866533993,11.9384872747775,0.412289303505978,2020-05-25,2020,5
"3656","MS",5,"Centro-oeste",50002,"Aquidauana",112953,18657.7559819571,5,19,7,12,9,10,0,0,0,0,0,19,7,12,9,10,14,9.83401720896808,11.6347270819684,0.296506267820331,2020-02-03,2020,2
"3657","MS",5,"Centro-oeste",50002,"Aquidauana",112953,18657.7559819571,6,21,7,14,14,7,1,0,1,0,1,22,7,15,14,8,10,9.83401720896808,11.6347270819684,0.290966284985203,2020-02-10,2020,2
"3658","MS",5,"Centro-oeste",50002,"Aquidauana",112953,18657.7559819571,7,21,7,14,8,13,0,0,0,0,0,21,7,14,8,13,10,9.83401720896808,11.6347270819684,0.287995193877657,2020-02-17,2020,2
"3659","MS",5,"Centro-oeste",50002,"Aquidauana",112953,18657.7559819571,8,29,12,17,11,18,0,0,0,0,0,29,12,17,11,18,9,9.83401720896808,11.6347270819684,0.341823462020746,2020-02-24,2020,2
"3660","MS",5,"Centro-oeste",50002,"Aquidauana",112953,18657.7559819571,9,28,13,15,17,11,0,0,0,0,0,28,13,15,17,11,20,9.83401720896808,11.6347270819684,0.312743301023007,2020-03-02,2020,3
"3661","MS",5,"Centro-oeste",50002,"Aquidauana",112953,18657.7559819571,10,28,4,24,12,16,1,0,1,0,1,29,4,25,12,17,20,9.83401720896808,11.6347270819684,0.317787322982613,2020-03-09,2020,3
"3662","MS",5,"Centro-oeste",50002,"Aquidauana",112953,18657.7559819571,11,30,9,21,15,15,0,0,0,0,0,30,9,21,15,15,15,9.83401720896808,11.6347270819684,0.38184634197767,2020-03-16,2020,3
"3663","MS",5,"Centro-oeste",50002,"Aquidauana",112953,18657.7559819571,12,26,11,15,10,16,0,0,0,0,0,26,11,15,10,16,17,9.83401720896808,11.6347270819684,0.468721102732126,2020-03-23,2020,3
"3664","MS",5,"Centro-oeste",50002,"Aquidauana",112953,18657.7559819571,13,24,12,12,14,10,1,1,0,0,1,25,13,12,14,11,17,9.83401720896808,11.6347270819684,0.405063942387161,2020-03-30,2020,3
"3665","MS",5,"Centro-oeste",50002,"Aquidauana",112953,18657.7559819571,14,28,12,16,13,15,1,1,0,0,1,29,13,16,13,16,15,9.83401720896808,11.6347270819684,0.415642351922265,2020-04-06,2020,4
"3666","MS",5,"Centro-oeste",50002,"Aquidauana",112953,18657.7559819571,15,39,12,27,17,22,0,0,0,0,0,39,12,27,17,22,12,9.83401720896808,11.6347270819684,0.397060029807613,2020-04-13,2020,4
"3667","MS",5,"Centro-oeste",50002,"Aquidauana",112953,18657.7559819571,16,42,17,25,21,21,0,0,0,0,0,42,17,25,21,21,8,9.83401720896808,11.6347270819684,0.399879006296661,2020-04-20,2020,4
"3668","MS",5,"Centro-oeste",50002,"Aquidauana",112953,18657.7559819571,17,30,10,20,19,11,1,1,0,0,1,31,11,20,19,12,13,9.83401720896808,11.6347270819684,0.40968753782038,2020-04-27,2020,4
"3669","MS",5,"Centro-oeste",50002,"Aquidauana",112953,18657.7559819571,18,34,15,19,16,18,0,0,0,0,0,34,15,19,16,18,15,9.83401720896808,11.6347270819684,0.388140607460105,2020-05-04,2020,5
"3670","MS",5,"Centro-oeste",50002,"Aquidauana",112953,18657.7559819571,19,48,17,31,26,22,0,0,0,0,0,48,17,31,26,22,17,9.83401720896808,11.6347270819684,0.410261756021423,2020-05-11,2020,5
"3671","MS",5,"Centro-oeste",50002,"Aquidauana",112953,18657.7559819571,20,32,5,27,18,14,1,1,0,0,1,33,6,27,18,15,14,9.83401720896808,11.6347270819684,0.408555056511244,2020-05-18,2020,5
"3672","MS",5,"Centro-oeste",50002,"Aquidauana",112953,18657.7559819571,21,42,22,20,21,21,0,0,0,0,0,42,22,20,21,21,19,9.83401720896808,11.6347270819684,0.398469174263956,2020-05-25,2020,5
"3673","MS",5,"Centro-oeste",50003,"Alto Taquari",130164,36891.8419460834,5,19,7,12,11,8,0,0,0,0,0,19,7,12,11,8,21,10.5157457201136,11.7765504728282,0.28475185781609,2020-02-03,2020,2
"3674","MS",5,"Centro-oeste",50003,"Alto Taquari",130164,36891.8419460834,6,29,8,21,15,14,0,0,0,0,0,29,8,21,15,14,16,10.5157457201136,11.7765504728282,0.281172380342259,2020-02-10,2020,2
"3675","MS",5,"Centro-oeste",50003,"Alto Taquari",130164,36891.8419460834,7,42,19,23,15,27,0,0,0,0,0,42,19,23,15,27,14,10.5157457201136,11.7765504728282,0.295104427644517,2020-02-17,2020,2
"3676","MS",5,"Centro-oeste",50003,"Alto Taquari",130164,36891.8419460834,8,34,12,22,18,16,0,0,0,0,0,34,12,22,18,16,10,10.5157457201136,11.7765504728282,0.328501002504666,2020-02-24,2020,2
"3677","MS",5,"Centro-oeste",50003,"Alto Taquari",130164,36891.8419460834,9,27,8,19,10,17,1,1,0,0,1,28,9,19,10,18,14,10.5157457201136,11.7765504728282,0.30407482387388,2020-03-02,2020,3
"3678","MS",5,"Centro-oeste",50003,"Alto Taquari",130164,36891.8419460834,10,25,11,14,12,13,1,1,0,1,0,26,12,14,13,13,19,10.5157457201136,11.7765504728282,0.316957490011416,2020-03-09,2020,3
"3679","MS",5,"Centro-oeste",50003,"Alto Taquari",130164,36891.8419460834,11,31,8,23,11,20,0,0,0,0,0,31,8,23,11,20,15,10.5157457201136,11.7765504728282,0.366802003810069,2020-03-16,2020,3
"3680","MS",5,"Centro-oeste",50003,"Alto Taquari",130164,36891.8419460834,12,30,4,26,13,17,1,1,0,1,0,31,5,26,14,17,13,10.5157457201136,11.7765504728282,0.460997184152632,2020-03-23,2020,3
"3681","MS",5,"Centro-oeste",50003,"Alto Taquari",130164,36891.8419460834,13,28,9,19,8,20,0,0,0,0,0,28,9,19,8,20,19,10.5157457201136,11.7765504728282,0.41472972143413,2020-03-30,2020,3
"3682","MS",5,"Centro-oeste",50003,"Alto Taquari",130164,36891.8419460834,14,37,15,22,17,20,1,0,1,1,0,38,15,23,18,20,9,10.5157457201136,11.7765504728282,0.391271708482445,2020-04-06,2020,4
"3683","MS",5,"Centro-oeste",50003,"Alto Taquari",130164,36891.8419460834,15,28,4,24,19,9,0,0,0,0,0,28,4,24,19,9,12,10.5157457201136,11.7765504728282,0.378815577952109,2020-04-13,2020,4
"3684","MS",5,"Centro-oeste",50003,"Alto Taquari",130164,36891.8419460834,16,30,10,20,16,14,0,0,0,0,0,30,10,20,16,14,15,10.5157457201136,11.7765504728282,0.385674751089651,2020-04-20,2020,4
"3685","MS",5,"Centro-oeste",50003,"Alto Taquari",130164,36891.8419460834,17,54,18,36,27,27,0,0,0,0,0,54,18,36,27,27,13,10.5157457201136,11.7765504728282,0.377650916443674,2020-04-27,2020,4
"3686","MS",5,"Centro-oeste",50003,"Alto Taquari",130164,36891.8419460834,18,38,10,28,22,16,1,1,0,1,0,39,11,28,23,16,13,10.5157457201136,11.7765504728282,0.373808309929323,2020-05-04,2020,5
"3687","MS",5,"Centro-oeste",50003,"Alto Taquari",130164,36891.8419460834,19,39,11,28,19,20,1,1,0,0,1,40,12,28,19,21,12,10.5157457201136,11.7765504728282,0.390137549698552,2020-05-11,2020,5
"3688","MS",5,"Centro-oeste",50003,"Alto Taquari",130164,36891.8419460834,20,46,16,30,18,28,1,1,0,0,1,47,17,30,18,29,16,10.5157457201136,11.7765504728282,0.383563739229451,2020-05-18,2020,5
"3689","MS",5,"Centro-oeste",50003,"Alto Taquari",130164,36891.8419460834,21,51,7,44,21,30,0,0,0,0,0,51,7,44,21,30,16,10.5157457201136,11.7765504728282,0.361939242046048,2020-05-25,2020,5
"3690","MS",5,"Centro-oeste",50004,"Campo Grande",1018063,33371.2627431996,5,246,44,202,77,169,0,0,0,0,0,246,44,202,77,169,103,10.4154504117007,13.8334123602288,0.283306604622483,2020-02-03,2020,2
"3691","MS",5,"Centro-oeste",50004,"Campo Grande",1018063,33371.2627431996,6,264,53,211,89,175,3,1,2,1,2,267,54,213,90,177,112,10.4154504117007,13.8334123602288,0.279557901545702,2020-02-10,2020,2
"3692","MS",5,"Centro-oeste",50004,"Campo Grande",1018063,33371.2627431996,7,229,42,187,84,145,3,1,2,1,2,232,43,189,85,147,111,10.4154504117007,13.8334123602288,0.293207808857629,2020-02-17,2020,2
"3693","MS",5,"Centro-oeste",50004,"Campo Grande",1018063,33371.2627431996,8,185,34,151,62,123,4,0,4,0,4,189,34,155,62,127,103,10.4154504117007,13.8334123602288,0.341800543298944,2020-02-24,2020,2
"3694","MS",5,"Centro-oeste",50004,"Campo Grande",1018063,33371.2627431996,9,161,35,126,59,102,3,2,1,1,2,164,37,127,60,104,110,10.4154504117007,13.8334123602288,0.31005755408192,2020-03-02,2020,3
"3695","MS",5,"Centro-oeste",50004,"Campo Grande",1018063,33371.2627431996,10,222,48,174,83,139,3,0,3,1,2,225,48,177,84,141,124,10.4154504117007,13.8334123602288,0.323387615416629,2020-03-09,2020,3
"3696","MS",5,"Centro-oeste",50004,"Campo Grande",1018063,33371.2627431996,11,220,36,184,89,131,4,0,4,1,3,224,36,188,90,134,143,10.4154504117007,13.8334123602288,0.41517512876071,2020-03-16,2020,3
"3697","MS",5,"Centro-oeste",50004,"Campo Grande",1018063,33371.2627431996,12,233,44,189,85,148,1,0,1,0,1,234,44,190,85,149,100,10.4154504117007,13.8334123602288,0.537059593800135,2020-03-23,2020,3
"3698","MS",5,"Centro-oeste",50004,"Campo Grande",1018063,33371.2627431996,13,268,52,216,99,169,5,1,4,2,3,273,53,220,101,172,103,10.4154504117007,13.8334123602288,0.472285833751034,2020-03-30,2020,3
"3699","MS",5,"Centro-oeste",50004,"Campo Grande",1018063,33371.2627431996,14,250,55,195,92,158,3,0,3,1,2,253,55,198,93,160,114,10.4154504117007,13.8334123602288,0.44430438979799,2020-04-06,2020,4
"3700","MS",5,"Centro-oeste",50004,"Campo Grande",1018063,33371.2627431996,15,274,65,209,108,166,4,0,4,1,3,278,65,213,109,169,105,10.4154504117007,13.8334123602288,0.423661420421811,2020-04-13,2020,4
"3701","MS",5,"Centro-oeste",50004,"Campo Grande",1018063,33371.2627431996,16,266,57,209,97,169,4,3,1,2,2,270,60,210,99,171,90,10.4154504117007,13.8334123602288,0.426013730814786,2020-04-20,2020,4
"3702","MS",5,"Centro-oeste",50004,"Campo Grande",1018063,33371.2627431996,17,255,60,195,105,150,3,1,2,2,1,258,61,197,107,151,109,10.4154504117007,13.8334123602288,0.414604467338255,2020-04-27,2020,4
"3703","MS",5,"Centro-oeste",50004,"Campo Grande",1018063,33371.2627431996,18,323,63,260,118,205,0,0,0,0,0,323,63,260,118,205,112,10.4154504117007,13.8334123602288,0.389784988335796,2020-05-04,2020,5
"3704","MS",5,"Centro-oeste",50004,"Campo Grande",1018063,33371.2627431996,19,307,68,239,130,177,1,1,0,0,1,308,69,239,130,178,98,10.4154504117007,13.8334123602288,0.404108314202271,2020-05-11,2020,5
"3705","MS",5,"Centro-oeste",50004,"Campo Grande",1018063,33371.2627431996,20,319,59,260,108,211,4,0,4,4,0,323,59,264,112,211,121,10.4154504117007,13.8334123602288,0.395384177680516,2020-05-18,2020,5
"3706","MS",5,"Centro-oeste",50004,"Campo Grande",1018063,33371.2627431996,21,306,73,233,105,201,1,0,1,1,0,307,73,234,106,201,119,10.4154504117007,13.8334123602288,0.38505338680443,2020-05-25,2020,5
"3707","MS",5,"Centro-oeste",50005,"Cassilândia",74663,67997.1133210559,5,30,7,23,16,14,0,0,0,0,0,30,7,23,16,14,9,11.1272205320962,11.2207399338204,0.29776946723378,2020-02-03,2020,2
"3708","MS",5,"Centro-oeste",50005,"Cassilândia",74663,67997.1133210559,6,15,4,11,4,11,0,0,0,0,0,15,4,11,4,11,5,11.1272205320962,11.2207399338204,0.291555040901202,2020-02-10,2020,2
"3709","MS",5,"Centro-oeste",50005,"Cassilândia",74663,67997.1133210559,7,19,2,17,6,13,0,0,0,0,0,19,2,17,6,13,6,11.1272205320962,11.2207399338204,0.308889439325938,2020-02-17,2020,2
"3710","MS",5,"Centro-oeste",50005,"Cassilândia",74663,67997.1133210559,8,14,5,9,7,7,0,0,0,0,0,14,5,9,7,7,3,11.1272205320962,11.2207399338204,0.331031771559446,2020-02-24,2020,2
"3711","MS",5,"Centro-oeste",50005,"Cassilândia",74663,67997.1133210559,9,26,7,19,12,14,0,0,0,0,0,26,7,19,12,14,9,11.1272205320962,11.2207399338204,0.322532597114462,2020-03-02,2020,3
"3712","MS",5,"Centro-oeste",50005,"Cassilândia",74663,67997.1133210559,10,21,4,17,10,11,0,0,0,0,0,21,4,17,10,11,11,11.1272205320962,11.2207399338204,0.327702739393804,2020-03-09,2020,3
"3713","MS",5,"Centro-oeste",50005,"Cassilândia",74663,67997.1133210559,11,26,8,18,10,16,0,0,0,0,0,26,8,18,10,16,9,11.1272205320962,11.2207399338204,0.374884135347574,2020-03-16,2020,3
"3714","MS",5,"Centro-oeste",50005,"Cassilândia",74663,67997.1133210559,12,17,3,14,9,8,0,0,0,0,0,17,3,14,9,8,10,11.1272205320962,11.2207399338204,0.46010264692894,2020-03-23,2020,3
"3715","MS",5,"Centro-oeste",50005,"Cassilândia",74663,67997.1133210559,13,24,5,19,14,10,0,0,0,0,0,24,5,19,14,10,7,11.1272205320962,11.2207399338204,0.418075343402262,2020-03-30,2020,3
"3716","MS",5,"Centro-oeste",50005,"Cassilândia",74663,67997.1133210559,14,26,7,19,14,12,0,0,0,0,0,26,7,19,14,12,7,11.1272205320962,11.2207399338204,0.419566023118911,2020-04-06,2020,4
"3717","MS",5,"Centro-oeste",50005,"Cassilândia",74663,67997.1133210559,15,24,5,19,12,12,0,0,0,0,0,24,5,19,12,12,7,11.1272205320962,11.2207399338204,0.388466766316676,2020-04-13,2020,4
"3718","MS",5,"Centro-oeste",50005,"Cassilândia",74663,67997.1133210559,16,29,8,21,10,19,0,0,0,0,0,29,8,21,10,19,5,11.1272205320962,11.2207399338204,0.388136605947543,2020-04-20,2020,4
"3719","MS",5,"Centro-oeste",50005,"Cassilândia",74663,67997.1133210559,17,21,8,13,11,10,0,0,0,0,0,21,8,13,11,10,7,11.1272205320962,11.2207399338204,0.392429552342667,2020-04-27,2020,4
"3720","MS",5,"Centro-oeste",50005,"Cassilândia",74663,67997.1133210559,18,27,8,19,12,15,0,0,0,0,0,27,8,19,12,15,10,11.1272205320962,11.2207399338204,0.382462227441895,2020-05-04,2020,5
"3721","MS",5,"Centro-oeste",50005,"Cassilândia",74663,67997.1133210559,19,26,4,22,11,15,0,0,0,0,0,26,4,22,11,15,8,11.1272205320962,11.2207399338204,0.379653304036263,2020-05-11,2020,5
"3722","MS",5,"Centro-oeste",50005,"Cassilândia",74663,67997.1133210559,20,24,7,17,12,12,0,0,0,0,0,24,7,17,12,12,2,11.1272205320962,11.2207399338204,0.377902356772896,2020-05-18,2020,5
"3723","MS",5,"Centro-oeste",50005,"Cassilândia",74663,67997.1133210559,21,20,2,18,8,12,0,0,0,0,0,20,2,18,8,12,13,11.1272205320962,11.2207399338204,0.371936626058096,2020-05-25,2020,5
"3724","MS",5,"Centro-oeste",50006,"Paranaíba",82475,64283.5510931797,5,22,6,16,8,14,0,0,0,0,0,22,6,16,8,14,9,11.0710590624634,11.3202504960968,0.300371769814667,2020-02-03,2020,2
"3725","MS",5,"Centro-oeste",50006,"Paranaíba",82475,64283.5510931797,6,13,2,11,4,9,0,0,0,0,0,13,2,11,4,9,9,11.0710590624634,11.3202504960968,0.302333531905445,2020-02-10,2020,2
"3726","MS",5,"Centro-oeste",50006,"Paranaíba",82475,64283.5510931797,7,20,4,16,8,12,0,0,0,0,0,20,4,16,8,12,14,11.0710590624634,11.3202504960968,0.317856403061297,2020-02-17,2020,2
"3727","MS",5,"Centro-oeste",50006,"Paranaíba",82475,64283.5510931797,8,14,1,13,3,11,0,0,0,0,0,14,1,13,3,11,16,11.0710590624634,11.3202504960968,0.341239939907935,2020-02-24,2020,2
"3728","MS",5,"Centro-oeste",50006,"Paranaíba",82475,64283.5510931797,9,16,2,14,7,9,0,0,0,0,0,16,2,14,7,9,16,11.0710590624634,11.3202504960968,0.327202420892595,2020-03-02,2020,3
"3729","MS",5,"Centro-oeste",50006,"Paranaíba",82475,64283.5510931797,10,16,6,10,5,11,0,0,0,0,0,16,6,10,5,11,12,11.0710590624634,11.3202504960968,0.345709323680719,2020-03-09,2020,3
"3730","MS",5,"Centro-oeste",50006,"Paranaíba",82475,64283.5510931797,11,15,4,11,4,11,0,0,0,0,0,15,4,11,4,11,9,11.0710590624634,11.3202504960968,0.402004300339687,2020-03-16,2020,3
"3731","MS",5,"Centro-oeste",50006,"Paranaíba",82475,64283.5510931797,12,14,2,12,5,9,1,1,0,0,1,15,3,12,5,10,18,11.0710590624634,11.3202504960968,0.470890945003315,2020-03-23,2020,3
"3732","MS",5,"Centro-oeste",50006,"Paranaíba",82475,64283.5510931797,13,20,8,12,7,13,0,0,0,0,0,20,8,12,7,13,16,11.0710590624634,11.3202504960968,0.447031465975935,2020-03-30,2020,3
"3733","MS",5,"Centro-oeste",50006,"Paranaíba",82475,64283.5510931797,14,18,4,14,5,13,0,0,0,0,0,18,4,14,5,13,17,11.0710590624634,11.3202504960968,0.433027271963813,2020-04-06,2020,4
"3734","MS",5,"Centro-oeste",50006,"Paranaíba",82475,64283.5510931797,15,24,10,14,12,12,0,0,0,0,0,24,10,14,12,12,12,11.0710590624634,11.3202504960968,0.431637629811624,2020-04-13,2020,4
"3735","MS",5,"Centro-oeste",50006,"Paranaíba",82475,64283.5510931797,16,18,1,17,8,10,0,0,0,0,0,18,1,17,8,10,15,11.0710590624634,11.3202504960968,0.412326957773298,2020-04-20,2020,4
"3736","MS",5,"Centro-oeste",50006,"Paranaíba",82475,64283.5510931797,17,23,8,15,16,7,1,1,0,1,0,24,9,15,17,7,10,11.0710590624634,11.3202504960968,0.400813286715218,2020-04-27,2020,4
"3737","MS",5,"Centro-oeste",50006,"Paranaíba",82475,64283.5510931797,18,22,8,14,10,12,0,0,0,0,0,22,8,14,10,12,14,11.0710590624634,11.3202504960968,0.386303423881058,2020-05-04,2020,5
"3738","MS",5,"Centro-oeste",50006,"Paranaíba",82475,64283.5510931797,19,23,9,14,13,10,0,0,0,0,0,23,9,14,13,10,11,11.0710590624634,11.3202504960968,0.399030232792596,2020-05-11,2020,5
"3739","MS",5,"Centro-oeste",50006,"Paranaíba",82475,64283.5510931797,20,24,11,13,11,13,0,0,0,0,0,24,11,13,11,13,18,11.0710590624634,11.3202504960968,0.395074806723915,2020-05-18,2020,5
"3740","MS",5,"Centro-oeste",50006,"Paranaíba",82475,64283.5510931797,21,24,9,15,9,15,1,1,0,0,1,25,10,15,9,16,10,11.0710590624634,11.3202504960968,0.387605185389528,2020-05-25,2020,5
"3741","MS",5,"Centro-oeste",50007,"Três Lagoas",183776,82129.0708067974,5,49,9,40,24,25,0,0,0,0,0,49,9,40,24,25,23,11.3160473229822,12.121472903664,0.30966813963456,2020-02-03,2020,2
"3742","MS",5,"Centro-oeste",50007,"Três Lagoas",183776,82129.0708067974,6,47,12,35,25,22,0,0,0,0,0,47,12,35,25,22,16,11.3160473229822,12.121472903664,0.296131416898724,2020-02-10,2020,2
"3743","MS",5,"Centro-oeste",50007,"Três Lagoas",183776,82129.0708067974,7,50,11,39,20,30,0,0,0,0,0,50,11,39,20,30,10,11.3160473229822,12.121472903664,0.312770107196304,2020-02-17,2020,2
"3744","MS",5,"Centro-oeste",50007,"Três Lagoas",183776,82129.0708067974,8,34,11,23,20,14,0,0,0,0,0,34,11,23,20,14,17,11.3160473229822,12.121472903664,0.35509830564355,2020-02-24,2020,2
"3745","MS",5,"Centro-oeste",50007,"Três Lagoas",183776,82129.0708067974,9,40,8,32,21,19,1,1,0,0,1,41,9,32,21,20,17,11.3160473229822,12.121472903664,0.315292852188008,2020-03-02,2020,3
"3746","MS",5,"Centro-oeste",50007,"Três Lagoas",183776,82129.0708067974,10,47,10,37,15,32,0,0,0,0,0,47,10,37,15,32,19,11.3160473229822,12.121472903664,0.337099704592083,2020-03-09,2020,3
"3747","MS",5,"Centro-oeste",50007,"Três Lagoas",183776,82129.0708067974,11,49,18,31,22,27,0,0,0,0,0,49,18,31,22,27,21,11.3160473229822,12.121472903664,0.393619346842937,2020-03-16,2020,3
"3748","MS",5,"Centro-oeste",50007,"Três Lagoas",183776,82129.0708067974,12,46,16,30,20,26,0,0,0,0,0,46,16,30,20,26,22,11.3160473229822,12.121472903664,0.502355420945243,2020-03-23,2020,3
"3749","MS",5,"Centro-oeste",50007,"Três Lagoas",183776,82129.0708067974,13,47,8,39,13,34,0,0,0,0,0,47,8,39,13,34,22,11.3160473229822,12.121472903664,0.466388533308765,2020-03-30,2020,3
"3750","MS",5,"Centro-oeste",50007,"Três Lagoas",183776,82129.0708067974,14,41,12,29,22,19,0,0,0,0,0,41,12,29,22,19,15,11.3160473229822,12.121472903664,0.44743454669174,2020-04-06,2020,4
"3751","MS",5,"Centro-oeste",50007,"Três Lagoas",183776,82129.0708067974,15,40,13,27,11,29,0,0,0,0,0,40,13,27,11,29,18,11.3160473229822,12.121472903664,0.419889145991753,2020-04-13,2020,4
"3752","MS",5,"Centro-oeste",50007,"Três Lagoas",183776,82129.0708067974,16,56,14,42,27,29,0,0,0,0,0,56,14,42,27,29,27,11.3160473229822,12.121472903664,0.433787122207488,2020-04-20,2020,4
"3753","MS",5,"Centro-oeste",50007,"Três Lagoas",183776,82129.0708067974,17,58,18,40,20,38,0,0,0,0,0,58,18,40,20,38,15,11.3160473229822,12.121472903664,0.431745903984475,2020-04-27,2020,4
"3754","MS",5,"Centro-oeste",50007,"Três Lagoas",183776,82129.0708067974,18,48,8,40,11,37,0,0,0,0,0,48,8,40,11,37,22,11.3160473229822,12.121472903664,0.414845335137423,2020-05-04,2020,5
"3755","MS",5,"Centro-oeste",50007,"Três Lagoas",183776,82129.0708067974,19,63,25,38,24,39,1,0,1,0,1,64,25,39,24,40,29,11.3160473229822,12.121472903664,0.431301608953492,2020-05-11,2020,5
"3756","MS",5,"Centro-oeste",50007,"Três Lagoas",183776,82129.0708067974,20,51,15,36,18,33,0,0,0,0,0,51,15,36,18,33,16,11.3160473229822,12.121472903664,0.427793751441356,2020-05-18,2020,5
"3757","MS",5,"Centro-oeste",50007,"Três Lagoas",183776,82129.0708067974,21,48,19,29,20,28,0,0,0,0,0,48,19,29,20,28,30,11.3160473229822,12.121472903664,0.416185571643379,2020-05-25,2020,5
"3758","MS",5,"Centro-oeste",50008,"Nova Andradina",102562,36446.336365223,5,21,9,12,7,14,0,0,0,0,0,21,9,12,7,14,12,10.503596221143,11.5382227727444,0.29932286984028,2020-02-03,2020,2
"3759","MS",5,"Centro-oeste",50008,"Nova Andradina",102562,36446.336365223,6,22,9,13,5,17,0,0,0,0,0,22,9,13,5,17,14,10.503596221143,11.5382227727444,0.290307961738585,2020-02-10,2020,2
"3760","MS",5,"Centro-oeste",50008,"Nova Andradina",102562,36446.336365223,7,25,6,19,7,18,0,0,0,0,0,25,6,19,7,18,14,10.503596221143,11.5382227727444,0.292242029771734,2020-02-17,2020,2
"3761","MS",5,"Centro-oeste",50008,"Nova Andradina",102562,36446.336365223,8,19,8,11,9,10,0,0,0,0,0,19,8,11,9,10,12,10.503596221143,11.5382227727444,0.331847671517085,2020-02-24,2020,2
"3762","MS",5,"Centro-oeste",50008,"Nova Andradina",102562,36446.336365223,9,26,9,17,9,17,0,0,0,0,0,26,9,17,9,17,3,10.503596221143,11.5382227727444,0.310312516463662,2020-03-02,2020,3
"3763","MS",5,"Centro-oeste",50008,"Nova Andradina",102562,36446.336365223,10,34,10,24,14,20,0,0,0,0,0,34,10,24,14,20,13,10.503596221143,11.5382227727444,0.320906369373928,2020-03-09,2020,3
"3764","MS",5,"Centro-oeste",50008,"Nova Andradina",102562,36446.336365223,11,34,14,20,12,22,0,0,0,0,0,34,14,20,12,22,7,10.503596221143,11.5382227727444,0.379146786796218,2020-03-16,2020,3
"3765","MS",5,"Centro-oeste",50008,"Nova Andradina",102562,36446.336365223,12,27,6,21,13,14,0,0,0,0,0,27,6,21,13,14,8,10.503596221143,11.5382227727444,0.477213568003815,2020-03-23,2020,3
"3766","MS",5,"Centro-oeste",50008,"Nova Andradina",102562,36446.336365223,13,22,6,16,8,14,0,0,0,0,0,22,6,16,8,14,7,10.503596221143,11.5382227727444,0.463000945436206,2020-03-30,2020,3
"3767","MS",5,"Centro-oeste",50008,"Nova Andradina",102562,36446.336365223,14,29,9,20,15,14,0,0,0,0,0,29,9,20,15,14,11,10.503596221143,11.5382227727444,0.428159105197716,2020-04-06,2020,4
"3768","MS",5,"Centro-oeste",50008,"Nova Andradina",102562,36446.336365223,15,27,10,17,12,15,1,0,1,0,1,28,10,18,12,16,12,10.503596221143,11.5382227727444,0.398948309693715,2020-04-13,2020,4
"3769","MS",5,"Centro-oeste",50008,"Nova Andradina",102562,36446.336365223,16,35,10,25,16,19,0,0,0,0,0,35,10,25,16,19,13,10.503596221143,11.5382227727444,0.41604290436588,2020-04-20,2020,4
"3770","MS",5,"Centro-oeste",50008,"Nova Andradina",102562,36446.336365223,17,32,10,22,12,20,0,0,0,0,0,32,10,22,12,20,7,10.503596221143,11.5382227727444,0.422919403177541,2020-04-27,2020,4
"3771","MS",5,"Centro-oeste",50008,"Nova Andradina",102562,36446.336365223,18,22,10,12,9,13,0,0,0,0,0,22,10,12,9,13,13,10.503596221143,11.5382227727444,0.376474209723434,2020-05-04,2020,5
"3772","MS",5,"Centro-oeste",50008,"Nova Andradina",102562,36446.336365223,19,26,7,19,15,11,0,0,0,0,0,26,7,19,15,11,7,10.503596221143,11.5382227727444,0.40639920946866,2020-05-11,2020,5
"3773","MS",5,"Centro-oeste",50008,"Nova Andradina",102562,36446.336365223,20,21,12,9,7,14,0,0,0,0,0,21,12,9,7,14,9,10.503596221143,11.5382227727444,0.398725014168724,2020-05-18,2020,5
"3774","MS",5,"Centro-oeste",50008,"Nova Andradina",102562,36446.336365223,21,33,12,21,12,21,0,0,0,0,0,33,12,21,12,21,6,10.503596221143,11.5382227727444,0.382819067089686,2020-05-25,2020,5
"3775","MS",5,"Centro-oeste",50009,"Bodoquena",110869,25248.9355663892,5,29,12,17,15,14,0,0,0,0,0,29,12,17,15,14,17,10.1365392780284,11.6161046031532,0.297062455952748,2020-02-03,2020,2
"3776","MS",5,"Centro-oeste",50009,"Bodoquena",110869,25248.9355663892,6,28,10,18,11,17,0,0,0,0,0,28,10,18,11,17,17,10.1365392780284,11.6161046031532,0.29674493680294,2020-02-10,2020,2
"3777","MS",5,"Centro-oeste",50009,"Bodoquena",110869,25248.9355663892,7,37,7,30,17,20,0,0,0,0,0,37,7,30,17,20,12,10.1365392780284,11.6161046031532,0.305853277636489,2020-02-17,2020,2
"3778","MS",5,"Centro-oeste",50009,"Bodoquena",110869,25248.9355663892,8,34,11,23,13,21,0,0,0,0,0,34,11,23,13,21,11,10.1365392780284,11.6161046031532,0.339485181619094,2020-02-24,2020,2
"3779","MS",5,"Centro-oeste",50009,"Bodoquena",110869,25248.9355663892,9,16,5,11,7,9,1,0,1,0,1,17,5,12,7,10,10,10.1365392780284,11.6161046031532,0.31888129767583,2020-03-02,2020,3
"3780","MS",5,"Centro-oeste",50009,"Bodoquena",110869,25248.9355663892,10,19,4,15,8,11,1,0,1,0,1,20,4,16,8,12,23,10.1365392780284,11.6161046031532,0.312433935338529,2020-03-09,2020,3
"3781","MS",5,"Centro-oeste",50009,"Bodoquena",110869,25248.9355663892,11,15,8,7,5,10,0,0,0,0,0,15,8,7,5,10,13,10.1365392780284,11.6161046031532,0.390154265248919,2020-03-16,2020,3
"3782","MS",5,"Centro-oeste",50009,"Bodoquena",110869,25248.9355663892,12,19,7,12,11,8,0,0,0,0,0,19,7,12,11,8,14,10.1365392780284,11.6161046031532,0.479813493037313,2020-03-23,2020,3
"3783","MS",5,"Centro-oeste",50009,"Bodoquena",110869,25248.9355663892,13,13,2,11,4,9,0,0,0,0,0,13,2,11,4,9,10,10.1365392780284,11.6161046031532,0.446170945009566,2020-03-30,2020,3
"3784","MS",5,"Centro-oeste",50009,"Bodoquena",110869,25248.9355663892,14,25,11,14,12,13,0,0,0,0,0,25,11,14,12,13,13,10.1365392780284,11.6161046031532,0.438842759161406,2020-04-06,2020,4
"3785","MS",5,"Centro-oeste",50009,"Bodoquena",110869,25248.9355663892,15,32,12,20,12,20,1,1,0,0,1,33,13,20,12,21,7,10.1365392780284,11.6161046031532,0.40909007609032,2020-04-13,2020,4
"3786","MS",5,"Centro-oeste",50009,"Bodoquena",110869,25248.9355663892,16,20,7,13,8,12,2,1,1,1,1,22,8,14,9,13,9,10.1365392780284,11.6161046031532,0.402406509573641,2020-04-20,2020,4
"3787","MS",5,"Centro-oeste",50009,"Bodoquena",110869,25248.9355663892,17,38,12,26,19,19,1,1,0,0,1,39,13,26,19,20,7,10.1365392780284,11.6161046031532,0.407442451454958,2020-04-27,2020,4
"3788","MS",5,"Centro-oeste",50009,"Bodoquena",110869,25248.9355663892,18,38,17,21,22,16,1,1,0,0,1,39,18,21,22,17,13,10.1365392780284,11.6161046031532,0.431767565698279,2020-05-04,2020,5
"3789","MS",5,"Centro-oeste",50009,"Bodoquena",110869,25248.9355663892,19,40,16,24,22,18,0,0,0,0,0,40,16,24,22,18,19,10.1365392780284,11.6161046031532,0.450814354761243,2020-05-11,2020,5
"3790","MS",5,"Centro-oeste",50009,"Bodoquena",110869,25248.9355663892,20,34,16,18,13,21,1,0,1,1,0,35,16,19,14,21,16,10.1365392780284,11.6161046031532,0.434724751655181,2020-05-18,2020,5
"3791","MS",5,"Centro-oeste",50009,"Bodoquena",110869,25248.9355663892,21,41,15,26,19,22,2,1,1,1,1,43,16,27,20,23,17,10.1365392780284,11.6161046031532,0.414257291730817,2020-05-25,2020,5
"3792","MS",5,"Centro-oeste",50010,"Dourados",590463,42214.4648154753,5,133,53,80,55,78,1,1,0,1,0,134,54,80,56,78,78,10.6505182094318,13.2886622538927,0.312345168372768,2020-02-03,2020,2
"3793","MS",5,"Centro-oeste",50010,"Dourados",590463,42214.4648154753,6,132,33,99,43,89,0,0,0,0,0,132,33,99,43,89,66,10.6505182094318,13.2886622538927,0.301451028182971,2020-02-10,2020,2
"3794","MS",5,"Centro-oeste",50010,"Dourados",590463,42214.4648154753,7,149,48,101,59,90,1,1,0,1,0,150,49,101,60,90,57,10.6505182094318,13.2886622538927,0.318166858347457,2020-02-17,2020,2
"3795","MS",5,"Centro-oeste",50010,"Dourados",590463,42214.4648154753,8,146,44,102,44,102,1,0,1,0,1,147,44,103,44,103,60,10.6505182094318,13.2886622538927,0.356091909075212,2020-02-24,2020,2
"3796","MS",5,"Centro-oeste",50010,"Dourados",590463,42214.4648154753,9,139,46,93,68,71,2,1,1,2,0,141,47,94,70,71,71,10.6505182094318,13.2886622538927,0.329884459719062,2020-03-02,2020,3
"3797","MS",5,"Centro-oeste",50010,"Dourados",590463,42214.4648154753,10,152,47,105,60,92,5,2,3,3,2,157,49,108,63,94,85,10.6505182094318,13.2886622538927,0.342323229867494,2020-03-09,2020,3
"3798","MS",5,"Centro-oeste",50010,"Dourados",590463,42214.4648154753,11,162,52,110,67,95,2,0,2,0,2,164,52,112,67,97,69,10.6505182094318,13.2886622538927,0.419640545589037,2020-03-16,2020,3
"3799","MS",5,"Centro-oeste",50010,"Dourados",590463,42214.4648154753,12,170,69,101,74,96,2,1,1,1,1,172,70,102,75,97,69,10.6505182094318,13.2886622538927,0.520831985979067,2020-03-23,2020,3
"3800","MS",5,"Centro-oeste",50010,"Dourados",590463,42214.4648154753,13,134,41,93,55,79,1,0,1,1,0,135,41,94,56,79,82,10.6505182094318,13.2886622538927,0.467205861976432,2020-03-30,2020,3
"3801","MS",5,"Centro-oeste",50010,"Dourados",590463,42214.4648154753,14,172,50,122,62,110,2,1,1,1,1,174,51,123,63,111,65,10.6505182094318,13.2886622538927,0.452397357708442,2020-04-06,2020,4
"3802","MS",5,"Centro-oeste",50010,"Dourados",590463,42214.4648154753,15,176,50,126,82,94,2,0,2,0,2,178,50,128,82,96,59,10.6505182094318,13.2886622538927,0.426139230962824,2020-04-13,2020,4
"3803","MS",5,"Centro-oeste",50010,"Dourados",590463,42214.4648154753,16,211,73,138,79,132,2,2,0,1,1,213,75,138,80,133,66,10.6505182094318,13.2886622538927,0.428300332767881,2020-04-20,2020,4
"3804","MS",5,"Centro-oeste",50010,"Dourados",590463,42214.4648154753,17,176,52,124,71,105,1,0,1,0,1,177,52,125,71,106,60,10.6505182094318,13.2886622538927,0.414000385841949,2020-04-27,2020,4
"3805","MS",5,"Centro-oeste",50010,"Dourados",590463,42214.4648154753,18,166,62,104,72,94,4,2,2,2,2,170,64,106,74,96,64,10.6505182094318,13.2886622538927,0.40202435176791,2020-05-04,2020,5
"3806","MS",5,"Centro-oeste",50010,"Dourados",590463,42214.4648154753,19,180,63,117,74,106,4,2,2,1,3,184,65,119,75,109,53,10.6505182094318,13.2886622538927,0.42318223372274,2020-05-11,2020,5
"3807","MS",5,"Centro-oeste",50010,"Dourados",590463,42214.4648154753,20,206,67,139,86,120,1,0,1,0,1,207,67,140,86,121,63,10.6505182094318,13.2886622538927,0.419397886251351,2020-05-18,2020,5
"3808","MS",5,"Centro-oeste",50010,"Dourados",590463,42214.4648154753,21,208,65,143,85,123,1,0,1,0,1,209,65,144,85,124,77,10.6505182094318,13.2886622538927,0.413711598140694,2020-05-25,2020,5
"3809","MS",5,"Centro-oeste",50011,"Iguatemi",250361,31999.0284356589,5,51,20,31,18,33,0,0,0,0,0,51,20,31,18,33,17,10.3734608199353,12.4306591552789,0.308068385627751,2020-02-03,2020,2
"3810","MS",5,"Centro-oeste",50011,"Iguatemi",250361,31999.0284356589,6,46,23,23,19,27,1,0,1,0,1,47,23,24,19,28,19,10.3734608199353,12.4306591552789,0.300679264469701,2020-02-10,2020,2
"3811","MS",5,"Centro-oeste",50011,"Iguatemi",250361,31999.0284356589,7,37,14,23,19,18,2,1,1,1,1,39,15,24,20,19,36,10.3734608199353,12.4306591552789,0.316519360048261,2020-02-17,2020,2
"3812","MS",5,"Centro-oeste",50011,"Iguatemi",250361,31999.0284356589,8,38,14,24,17,21,1,1,0,1,0,39,15,24,18,21,30,10.3734608199353,12.4306591552789,0.349612951017163,2020-02-24,2020,2
"3813","MS",5,"Centro-oeste",50011,"Iguatemi",250361,31999.0284356589,9,48,22,26,23,25,0,0,0,0,0,48,22,26,23,25,34,10.3734608199353,12.4306591552789,0.333691332280656,2020-03-02,2020,3
"3814","MS",5,"Centro-oeste",50011,"Iguatemi",250361,31999.0284356589,10,58,26,32,31,27,1,0,1,0,1,59,26,33,31,28,25,10.3734608199353,12.4306591552789,0.339280112478435,2020-03-09,2020,3
"3815","MS",5,"Centro-oeste",50011,"Iguatemi",250361,31999.0284356589,11,51,22,29,21,30,0,0,0,0,0,51,22,29,21,30,34,10.3734608199353,12.4306591552789,0.390662182323612,2020-03-16,2020,3
"3816","MS",5,"Centro-oeste",50011,"Iguatemi",250361,31999.0284356589,12,58,25,33,18,40,2,1,1,2,0,60,26,34,20,40,35,10.3734608199353,12.4306591552789,0.488114370769158,2020-03-23,2020,3
"3817","MS",5,"Centro-oeste",50011,"Iguatemi",250361,31999.0284356589,13,66,18,48,34,32,0,0,0,0,0,66,18,48,34,32,20,10.3734608199353,12.4306591552789,0.442037569080401,2020-03-30,2020,3
"3818","MS",5,"Centro-oeste",50011,"Iguatemi",250361,31999.0284356589,14,61,22,39,28,33,1,1,0,0,1,62,23,39,28,34,32,10.3734608199353,12.4306591552789,0.424531093319409,2020-04-06,2020,4
"3819","MS",5,"Centro-oeste",50011,"Iguatemi",250361,31999.0284356589,15,66,21,45,31,35,1,0,1,1,0,67,21,46,32,35,36,10.3734608199353,12.4306591552789,0.400192206135696,2020-04-13,2020,4
"3820","MS",5,"Centro-oeste",50011,"Iguatemi",250361,31999.0284356589,16,92,35,57,43,49,2,1,1,0,2,94,36,58,43,51,32,10.3734608199353,12.4306591552789,0.4036803890076,2020-04-20,2020,4
"3821","MS",5,"Centro-oeste",50011,"Iguatemi",250361,31999.0284356589,17,83,34,49,31,52,1,1,0,1,0,84,35,49,32,52,27,10.3734608199353,12.4306591552789,0.404791771879065,2020-04-27,2020,4
"3822","MS",5,"Centro-oeste",50011,"Iguatemi",250361,31999.0284356589,18,69,31,38,33,36,2,1,1,2,0,71,32,39,35,36,20,10.3734608199353,12.4306591552789,0.38214724873697,2020-05-04,2020,5
"3823","MS",5,"Centro-oeste",50011,"Iguatemi",250361,31999.0284356589,19,84,25,59,42,42,1,0,1,0,1,85,25,60,42,43,27,10.3734608199353,12.4306591552789,0.400216332867092,2020-05-11,2020,5
"3824","MS",5,"Centro-oeste",50011,"Iguatemi",250361,31999.0284356589,20,79,28,51,32,47,0,0,0,0,0,79,28,51,32,47,38,10.3734608199353,12.4306591552789,0.413459349406974,2020-05-18,2020,5
"3825","MS",5,"Centro-oeste",50011,"Iguatemi",250361,31999.0284356589,21,72,26,46,19,53,0,0,0,0,0,72,26,46,19,53,38,10.3734608199353,12.4306591552789,0.394301883680361,2020-05-25,2020,5
"3826","MT",5,"Centro-oeste",51001,"Aripuanã",173174,23696.2444560962,5,30,9,21,21,9,0,0,0,0,0,30,9,21,21,9,14,10.0730718527987,12.0620521483686,0.341692668369642,2020-02-03,2020,2
"3827","MT",5,"Centro-oeste",51001,"Aripuanã",173174,23696.2444560962,6,32,8,24,17,15,2,2,0,1,1,34,10,24,18,16,12,10.0730718527987,12.0620521483686,0.329969826781905,2020-02-10,2020,2
"3828","MT",5,"Centro-oeste",51001,"Aripuanã",173174,23696.2444560962,7,33,6,27,17,16,2,1,1,2,0,35,7,28,19,16,13,10.0730718527987,12.0620521483686,0.332164281316885,2020-02-17,2020,2
"3829","MT",5,"Centro-oeste",51001,"Aripuanã",173174,23696.2444560962,8,31,6,25,9,22,0,0,0,0,0,31,6,25,9,22,17,10.0730718527987,12.0620521483686,0.372606709267308,2020-02-24,2020,2
"3830","MT",5,"Centro-oeste",51001,"Aripuanã",173174,23696.2444560962,9,33,10,23,14,19,0,0,0,0,0,33,10,23,14,19,16,10.0730718527987,12.0620521483686,0.359786249565731,2020-03-02,2020,3
"3831","MT",5,"Centro-oeste",51001,"Aripuanã",173174,23696.2444560962,10,38,12,26,18,20,0,0,0,0,0,38,12,26,18,20,18,10.0730718527987,12.0620521483686,0.368312263306777,2020-03-09,2020,3
"3832","MT",5,"Centro-oeste",51001,"Aripuanã",173174,23696.2444560962,11,38,13,25,25,13,0,0,0,0,0,38,13,25,25,13,12,10.0730718527987,12.0620521483686,0.406943126046813,2020-03-16,2020,3
"3833","MT",5,"Centro-oeste",51001,"Aripuanã",173174,23696.2444560962,12,33,6,27,14,19,0,0,0,0,0,33,6,27,14,19,6,10.0730718527987,12.0620521483686,0.508958215909246,2020-03-23,2020,3
"3834","MT",5,"Centro-oeste",51001,"Aripuanã",173174,23696.2444560962,13,25,6,19,12,13,0,0,0,0,0,25,6,19,12,13,8,10.0730718527987,12.0620521483686,0.455255450204135,2020-03-30,2020,3
"3835","MT",5,"Centro-oeste",51001,"Aripuanã",173174,23696.2444560962,14,30,8,22,19,11,0,0,0,0,0,30,8,22,19,11,15,10.0730718527987,12.0620521483686,0.432419540350337,2020-04-06,2020,4
"3836","MT",5,"Centro-oeste",51001,"Aripuanã",173174,23696.2444560962,15,30,5,25,12,18,0,0,0,0,0,30,5,25,12,18,9,10.0730718527987,12.0620521483686,0.421542153451481,2020-04-13,2020,4
"3837","MT",5,"Centro-oeste",51001,"Aripuanã",173174,23696.2444560962,16,35,9,26,13,22,0,0,0,0,0,35,9,26,13,22,13,10.0730718527987,12.0620521483686,0.425192282974435,2020-04-20,2020,4
"3838","MT",5,"Centro-oeste",51001,"Aripuanã",173174,23696.2444560962,17,42,16,26,20,22,0,0,0,0,0,42,16,26,20,22,11,10.0730718527987,12.0620521483686,0.428851700518126,2020-04-27,2020,4
"3839","MT",5,"Centro-oeste",51001,"Aripuanã",173174,23696.2444560962,18,31,5,26,17,14,0,0,0,0,0,31,5,26,17,14,16,10.0730718527987,12.0620521483686,0.411237276852082,2020-05-04,2020,5
"3840","MT",5,"Centro-oeste",51001,"Aripuanã",173174,23696.2444560962,19,27,8,19,14,13,0,0,0,0,0,27,8,19,14,13,16,10.0730718527987,12.0620521483686,0.421916203063775,2020-05-11,2020,5
"3841","MT",5,"Centro-oeste",51001,"Aripuanã",173174,23696.2444560962,20,43,10,33,17,26,0,0,0,0,0,43,10,33,17,26,15,10.0730718527987,12.0620521483686,0.423038511157789,2020-05-18,2020,5
"3842","MT",5,"Centro-oeste",51001,"Aripuanã",173174,23696.2444560962,21,38,4,34,19,19,1,0,1,1,0,39,4,35,20,19,15,10.0730718527987,12.0620521483686,0.418433680116227,2020-05-25,2020,5
"3843","MT",5,"Centro-oeste",51002,"Alta Floresta",108647,26432.3705890637,5,24,6,18,11,13,0,0,0,0,0,24,6,18,11,13,9,10.1823446966924,11.5958593737065,0.317310795610742,2020-02-03,2020,2
"3844","MT",5,"Centro-oeste",51002,"Alta Floresta",108647,26432.3705890637,6,37,10,27,16,21,0,0,0,0,0,37,10,27,16,21,7,10.1823446966924,11.5958593737065,0.312025402916518,2020-02-10,2020,2
"3845","MT",5,"Centro-oeste",51002,"Alta Floresta",108647,26432.3705890637,7,31,10,21,10,21,0,0,0,0,0,31,10,21,10,21,6,10.1823446966924,11.5958593737065,0.327668976328812,2020-02-17,2020,2
"3846","MT",5,"Centro-oeste",51002,"Alta Floresta",108647,26432.3705890637,8,30,2,28,20,10,0,0,0,0,0,30,2,28,20,10,11,10.1823446966924,11.5958593737065,0.373578610548345,2020-02-24,2020,2
"3847","MT",5,"Centro-oeste",51002,"Alta Floresta",108647,26432.3705890637,9,30,6,24,9,21,0,0,0,0,0,30,6,24,9,21,11,10.1823446966924,11.5958593737065,0.353064748093797,2020-03-02,2020,3
"3848","MT",5,"Centro-oeste",51002,"Alta Floresta",108647,26432.3705890637,10,17,4,13,9,8,0,0,0,0,0,17,4,13,9,8,11,10.1823446966924,11.5958593737065,0.37600981012197,2020-03-09,2020,3
"3849","MT",5,"Centro-oeste",51002,"Alta Floresta",108647,26432.3705890637,11,35,4,31,16,19,0,0,0,0,0,35,4,31,16,19,15,10.1823446966924,11.5958593737065,0.426779769065559,2020-03-16,2020,3
"3850","MT",5,"Centro-oeste",51002,"Alta Floresta",108647,26432.3705890637,12,29,6,23,13,16,0,0,0,0,0,29,6,23,13,16,6,10.1823446966924,11.5958593737065,0.531021260365116,2020-03-23,2020,3
"3851","MT",5,"Centro-oeste",51002,"Alta Floresta",108647,26432.3705890637,13,28,7,21,10,18,1,0,1,0,1,29,7,22,10,19,12,10.1823446966924,11.5958593737065,0.451401298805436,2020-03-30,2020,3
"3852","MT",5,"Centro-oeste",51002,"Alta Floresta",108647,26432.3705890637,14,21,6,15,10,11,0,0,0,0,0,21,6,15,10,11,12,10.1823446966924,11.5958593737065,0.452361988384052,2020-04-06,2020,4
"3853","MT",5,"Centro-oeste",51002,"Alta Floresta",108647,26432.3705890637,15,30,9,21,12,18,0,0,0,0,0,30,9,21,12,18,8,10.1823446966924,11.5958593737065,0.432832035955392,2020-04-13,2020,4
"3854","MT",5,"Centro-oeste",51002,"Alta Floresta",108647,26432.3705890637,16,36,4,32,16,20,0,0,0,0,0,36,4,32,16,20,15,10.1823446966924,11.5958593737065,0.444433421175905,2020-04-20,2020,4
"3855","MT",5,"Centro-oeste",51002,"Alta Floresta",108647,26432.3705890637,17,24,1,23,13,11,0,0,0,0,0,24,1,23,13,11,15,10.1823446966924,11.5958593737065,0.421346665740956,2020-04-27,2020,4
"3856","MT",5,"Centro-oeste",51002,"Alta Floresta",108647,26432.3705890637,18,22,1,21,12,10,0,0,0,0,0,22,1,21,12,10,8,10.1823446966924,11.5958593737065,0.421196059117754,2020-05-04,2020,5
"3857","MT",5,"Centro-oeste",51002,"Alta Floresta",108647,26432.3705890637,19,35,11,24,14,21,0,0,0,0,0,35,11,24,14,21,9,10.1823446966924,11.5958593737065,0.415337496260828,2020-05-11,2020,5
"3858","MT",5,"Centro-oeste",51002,"Alta Floresta",108647,26432.3705890637,20,34,13,21,18,16,0,0,0,0,0,34,13,21,18,16,9,10.1823446966924,11.5958593737065,0.435431134193927,2020-05-18,2020,5
"3859","MT",5,"Centro-oeste",51002,"Alta Floresta",108647,26432.3705890637,21,28,4,24,10,18,0,0,0,0,0,28,4,24,10,18,13,10.1823446966924,11.5958593737065,0.429433553458517,2020-05-25,2020,5
"3860","MT",5,"Centro-oeste",51003,"Colíder",158041,25639.2465598168,5,35,5,30,18,17,1,0,1,1,0,36,5,31,19,17,9,10.1518795252603,11.9706097720173,0.331682738904126,2020-02-03,2020,2
"3861","MT",5,"Centro-oeste",51003,"Colíder",158041,25639.2465598168,6,53,11,42,21,32,1,0,1,0,1,54,11,43,21,33,20,10.1518795252603,11.9706097720173,0.312111067886333,2020-02-10,2020,2
"3862","MT",5,"Centro-oeste",51003,"Colíder",158041,25639.2465598168,7,43,11,32,22,21,0,0,0,0,0,43,11,32,22,21,13,10.1518795252603,11.9706097720173,0.331143846883506,2020-02-17,2020,2
"3863","MT",5,"Centro-oeste",51003,"Colíder",158041,25639.2465598168,8,38,11,27,20,18,0,0,0,0,0,38,11,27,20,18,8,10.1518795252603,11.9706097720173,0.351501067765259,2020-02-24,2020,2
"3864","MT",5,"Centro-oeste",51003,"Colíder",158041,25639.2465598168,9,62,16,46,23,39,0,0,0,0,0,62,16,46,23,39,21,10.1518795252603,11.9706097720173,0.333822781568623,2020-03-02,2020,3
"3865","MT",5,"Centro-oeste",51003,"Colíder",158041,25639.2465598168,10,35,7,28,15,20,0,0,0,0,0,35,7,28,15,20,20,10.1518795252603,11.9706097720173,0.351353053367858,2020-03-09,2020,3
"3866","MT",5,"Centro-oeste",51003,"Colíder",158041,25639.2465598168,11,43,13,30,23,20,1,1,0,1,0,44,14,30,24,20,16,10.1518795252603,11.9706097720173,0.394040620709176,2020-03-16,2020,3
"3867","MT",5,"Centro-oeste",51003,"Colíder",158041,25639.2465598168,12,41,13,28,14,27,1,0,1,0,1,42,13,29,14,28,21,10.1518795252603,11.9706097720173,0.469830864154273,2020-03-23,2020,3
"3868","MT",5,"Centro-oeste",51003,"Colíder",158041,25639.2465598168,13,45,8,37,20,25,0,0,0,0,0,45,8,37,20,25,16,10.1518795252603,11.9706097720173,0.408825705153237,2020-03-30,2020,3
"3869","MT",5,"Centro-oeste",51003,"Colíder",158041,25639.2465598168,14,35,6,29,14,21,2,1,1,1,1,37,7,30,15,22,19,10.1518795252603,11.9706097720173,0.420060601342798,2020-04-06,2020,4
"3870","MT",5,"Centro-oeste",51003,"Colíder",158041,25639.2465598168,15,40,9,31,21,19,1,1,0,1,0,41,10,31,22,19,17,10.1518795252603,11.9706097720173,0.40612314815915,2020-04-13,2020,4
"3871","MT",5,"Centro-oeste",51003,"Colíder",158041,25639.2465598168,16,40,9,31,19,21,0,0,0,0,0,40,9,31,19,21,20,10.1518795252603,11.9706097720173,0.399621780768201,2020-04-20,2020,4
"3872","MT",5,"Centro-oeste",51003,"Colíder",158041,25639.2465598168,17,44,9,35,18,26,0,0,0,0,0,44,9,35,18,26,16,10.1518795252603,11.9706097720173,0.400331243707412,2020-04-27,2020,4
"3873","MT",5,"Centro-oeste",51003,"Colíder",158041,25639.2465598168,18,48,15,33,20,28,0,0,0,0,0,48,15,33,20,28,9,10.1518795252603,11.9706097720173,0.38001461279608,2020-05-04,2020,5
"3874","MT",5,"Centro-oeste",51003,"Colíder",158041,25639.2465598168,19,37,11,26,13,24,0,0,0,0,0,37,11,26,13,24,17,10.1518795252603,11.9706097720173,0.399024949676706,2020-05-11,2020,5
"3875","MT",5,"Centro-oeste",51003,"Colíder",158041,25639.2465598168,20,47,13,34,21,26,0,0,0,0,0,47,13,34,21,26,10,10.1518795252603,11.9706097720173,0.39392889239229,2020-05-18,2020,5
"3876","MT",5,"Centro-oeste",51003,"Colíder",158041,25639.2465598168,21,56,13,43,28,28,0,0,0,0,0,56,13,43,28,28,17,10.1518795252603,11.9706097720173,0.393977001754785,2020-05-25,2020,5
"3877","MT",5,"Centro-oeste",51004,"Parecis",113087,100824.873209918,5,46,15,31,20,26,0,0,0,0,0,46,15,31,20,26,8,11.5211403622146,11.6359127129691,0.313512756828225,2020-02-03,2020,2
"3878","MT",5,"Centro-oeste",51004,"Parecis",113087,100824.873209918,6,31,5,26,15,16,1,0,1,0,1,32,5,27,15,17,5,11.5211403622146,11.6359127129691,0.299357164621124,2020-02-10,2020,2
"3879","MT",5,"Centro-oeste",51004,"Parecis",113087,100824.873209918,7,46,13,33,22,24,0,0,0,0,0,46,13,33,22,24,10,11.5211403622146,11.6359127129691,0.310384019184031,2020-02-17,2020,2
"3880","MT",5,"Centro-oeste",51004,"Parecis",113087,100824.873209918,8,35,8,27,14,21,0,0,0,0,0,35,8,27,14,21,6,11.5211403622146,11.6359127129691,0.342864194293309,2020-02-24,2020,2
"3881","MT",5,"Centro-oeste",51004,"Parecis",113087,100824.873209918,9,43,13,30,23,20,0,0,0,0,0,43,13,30,23,20,15,11.5211403622146,11.6359127129691,0.321304874796719,2020-03-02,2020,3
"3882","MT",5,"Centro-oeste",51004,"Parecis",113087,100824.873209918,10,41,13,28,24,17,0,0,0,0,0,41,13,28,24,17,10,11.5211403622146,11.6359127129691,0.342080550785601,2020-03-09,2020,3
"3883","MT",5,"Centro-oeste",51004,"Parecis",113087,100824.873209918,11,28,12,16,14,14,0,0,0,0,0,28,12,16,14,14,7,11.5211403622146,11.6359127129691,0.375576621993391,2020-03-16,2020,3
"3884","MT",5,"Centro-oeste",51004,"Parecis",113087,100824.873209918,12,40,12,28,18,22,0,0,0,0,0,40,12,28,18,22,10,11.5211403622146,11.6359127129691,0.46541064340279,2020-03-23,2020,3
"3885","MT",5,"Centro-oeste",51004,"Parecis",113087,100824.873209918,13,30,13,17,16,14,0,0,0,0,0,30,13,17,16,14,7,11.5211403622146,11.6359127129691,0.415432333039452,2020-03-30,2020,3
"3886","MT",5,"Centro-oeste",51004,"Parecis",113087,100824.873209918,14,43,17,26,21,22,0,0,0,0,0,43,17,26,21,22,8,11.5211403622146,11.6359127129691,0.410970538598811,2020-04-06,2020,4
"3887","MT",5,"Centro-oeste",51004,"Parecis",113087,100824.873209918,15,28,8,20,14,14,0,0,0,0,0,28,8,20,14,14,9,11.5211403622146,11.6359127129691,0.383823010126696,2020-04-13,2020,4
"3888","MT",5,"Centro-oeste",51004,"Parecis",113087,100824.873209918,16,46,12,34,20,26,1,0,1,0,1,47,12,35,20,27,6,11.5211403622146,11.6359127129691,0.399450171878311,2020-04-20,2020,4
"3889","MT",5,"Centro-oeste",51004,"Parecis",113087,100824.873209918,17,27,12,15,12,15,0,0,0,0,0,27,12,15,12,15,12,11.5211403622146,11.6359127129691,0.400666974222963,2020-04-27,2020,4
"3890","MT",5,"Centro-oeste",51004,"Parecis",113087,100824.873209918,18,31,8,23,11,20,0,0,0,0,0,31,8,23,11,20,5,11.5211403622146,11.6359127129691,0.384239215331568,2020-05-04,2020,5
"3891","MT",5,"Centro-oeste",51004,"Parecis",113087,100824.873209918,19,49,14,35,16,33,0,0,0,0,0,49,14,35,16,33,6,11.5211403622146,11.6359127129691,0.392798165326404,2020-05-11,2020,5
"3892","MT",5,"Centro-oeste",51004,"Parecis",113087,100824.873209918,20,40,15,25,20,20,0,0,0,0,0,40,15,25,20,20,6,11.5211403622146,11.6359127129691,0.401622408971276,2020-05-18,2020,5
"3893","MT",5,"Centro-oeste",51004,"Parecis",113087,100824.873209918,21,44,16,28,20,24,0,0,0,0,0,44,16,28,20,24,9,11.5211403622146,11.6359127129691,0.400007075216659,2020-05-25,2020,5
"3894","MT",5,"Centro-oeste",51005,"Arinos",83825,35837.2945287205,5,22,8,14,10,12,0,0,0,0,0,22,8,14,10,12,7,10.4867443767596,11.3364865713344,0.321325628982919,2020-02-03,2020,2
"3895","MT",5,"Centro-oeste",51005,"Arinos",83825,35837.2945287205,6,28,4,24,14,14,0,0,0,0,0,28,4,24,14,14,15,10.4867443767596,11.3364865713344,0.30647924949596,2020-02-10,2020,2
"3896","MT",5,"Centro-oeste",51005,"Arinos",83825,35837.2945287205,7,23,6,17,12,11,0,0,0,0,0,23,6,17,12,11,5,10.4867443767596,11.3364865713344,0.301563904996504,2020-02-17,2020,2
"3897","MT",5,"Centro-oeste",51005,"Arinos",83825,35837.2945287205,8,28,7,21,14,14,0,0,0,0,0,28,7,21,14,14,9,10.4867443767596,11.3364865713344,0.350360543577031,2020-02-24,2020,2
"3898","MT",5,"Centro-oeste",51005,"Arinos",83825,35837.2945287205,9,19,6,13,7,12,0,0,0,0,0,19,6,13,7,12,7,10.4867443767596,11.3364865713344,0.332811204477144,2020-03-02,2020,3
"3899","MT",5,"Centro-oeste",51005,"Arinos",83825,35837.2945287205,10,13,2,11,4,9,0,0,0,0,0,13,2,11,4,9,8,10.4867443767596,11.3364865713344,0.349606021992995,2020-03-09,2020,3
"3900","MT",5,"Centro-oeste",51005,"Arinos",83825,35837.2945287205,11,23,8,15,13,10,0,0,0,0,0,23,8,15,13,10,8,10.4867443767596,11.3364865713344,0.384115559677815,2020-03-16,2020,3
"3901","MT",5,"Centro-oeste",51005,"Arinos",83825,35837.2945287205,12,12,4,8,6,6,1,1,0,0,1,13,5,8,6,7,5,10.4867443767596,11.3364865713344,0.453980936833145,2020-03-23,2020,3
"3902","MT",5,"Centro-oeste",51005,"Arinos",83825,35837.2945287205,13,15,4,11,9,6,0,0,0,0,0,15,4,11,9,6,3,10.4867443767596,11.3364865713344,0.406971935577984,2020-03-30,2020,3
"3903","MT",5,"Centro-oeste",51005,"Arinos",83825,35837.2945287205,14,22,1,21,12,10,0,0,0,0,0,22,1,21,12,10,3,10.4867443767596,11.3364865713344,0.381702752083333,2020-04-06,2020,4
"3904","MT",5,"Centro-oeste",51005,"Arinos",83825,35837.2945287205,15,21,2,19,12,9,0,0,0,0,0,21,2,19,12,9,3,10.4867443767596,11.3364865713344,0.380305715452345,2020-04-13,2020,4
"3905","MT",5,"Centro-oeste",51005,"Arinos",83825,35837.2945287205,16,22,10,12,11,11,1,0,1,0,1,23,10,13,11,12,9,10.4867443767596,11.3364865713344,0.386322413865434,2020-04-20,2020,4
"3906","MT",5,"Centro-oeste",51005,"Arinos",83825,35837.2945287205,17,24,7,17,14,10,1,1,0,0,1,25,8,17,14,11,5,10.4867443767596,11.3364865713344,0.382285910071384,2020-04-27,2020,4
"3907","MT",5,"Centro-oeste",51005,"Arinos",83825,35837.2945287205,18,23,4,19,15,8,0,0,0,0,0,23,4,19,15,8,14,10.4867443767596,11.3364865713344,0.382395242357442,2020-05-04,2020,5
"3908","MT",5,"Centro-oeste",51005,"Arinos",83825,35837.2945287205,19,30,4,26,13,17,0,0,0,0,0,30,4,26,13,17,4,10.4867443767596,11.3364865713344,0.383483378974811,2020-05-11,2020,5
"3909","MT",5,"Centro-oeste",51005,"Arinos",83825,35837.2945287205,20,32,4,28,16,16,0,0,0,0,0,32,4,28,16,16,7,10.4867443767596,11.3364865713344,0.385177129765276,2020-05-18,2020,5
"3910","MT",5,"Centro-oeste",51005,"Arinos",83825,35837.2945287205,21,29,8,21,10,19,0,0,0,0,0,29,8,21,10,19,10,10.4867443767596,11.3364865713344,0.392601961290876,2020-05-25,2020,5
"3911","MT",5,"Centro-oeste",51006,"Alto Teles Pires",267191,72465.2071640138,5,90,13,77,36,54,0,0,0,0,0,90,13,77,36,54,17,11.1908618244673,12.4957190374426,0.303823323648735,2020-02-03,2020,2
"3912","MT",5,"Centro-oeste",51006,"Alto Teles Pires",267191,72465.2071640138,6,99,10,89,39,60,0,0,0,0,0,99,10,89,39,60,17,11.1908618244673,12.4957190374426,0.304619451219727,2020-02-10,2020,2
"3913","MT",5,"Centro-oeste",51006,"Alto Teles Pires",267191,72465.2071640138,7,86,14,72,35,51,1,1,0,1,0,87,15,72,36,51,22,11.1908618244673,12.4957190374426,0.318276875558261,2020-02-17,2020,2
"3914","MT",5,"Centro-oeste",51006,"Alto Teles Pires",267191,72465.2071640138,8,99,28,71,36,63,1,1,0,1,0,100,29,71,37,63,27,11.1908618244673,12.4957190374426,0.343605151098745,2020-02-24,2020,2
"3915","MT",5,"Centro-oeste",51006,"Alto Teles Pires",267191,72465.2071640138,9,89,25,64,37,52,0,0,0,0,0,89,25,64,37,52,25,11.1908618244673,12.4957190374426,0.325067434323632,2020-03-02,2020,3
"3916","MT",5,"Centro-oeste",51006,"Alto Teles Pires",267191,72465.2071640138,10,91,20,71,30,61,1,0,1,0,1,92,20,72,30,62,17,11.1908618244673,12.4957190374426,0.334665683062393,2020-03-09,2020,3
"3917","MT",5,"Centro-oeste",51006,"Alto Teles Pires",267191,72465.2071640138,11,86,22,64,37,49,0,0,0,0,0,86,22,64,37,49,23,11.1908618244673,12.4957190374426,0.393016645235551,2020-03-16,2020,3
"3918","MT",5,"Centro-oeste",51006,"Alto Teles Pires",267191,72465.2071640138,12,72,19,53,28,44,1,1,0,0,1,73,20,53,28,45,25,11.1908618244673,12.4957190374426,0.481532275692896,2020-03-23,2020,3
"3919","MT",5,"Centro-oeste",51006,"Alto Teles Pires",267191,72465.2071640138,13,81,20,61,35,46,2,0,2,1,1,83,20,63,36,47,29,11.1908618244673,12.4957190374426,0.422584703792836,2020-03-30,2020,3
"3920","MT",5,"Centro-oeste",51006,"Alto Teles Pires",267191,72465.2071640138,14,94,20,74,38,56,3,1,2,1,2,97,21,76,39,58,28,11.1908618244673,12.4957190374426,0.426825287975349,2020-04-06,2020,4
"3921","MT",5,"Centro-oeste",51006,"Alto Teles Pires",267191,72465.2071640138,15,99,25,74,32,67,1,0,1,1,0,100,25,75,33,67,20,11.1908618244673,12.4957190374426,0.396963114829082,2020-04-13,2020,4
"3922","MT",5,"Centro-oeste",51006,"Alto Teles Pires",267191,72465.2071640138,16,87,18,69,34,53,1,0,1,0,1,88,18,70,34,54,14,11.1908618244673,12.4957190374426,0.402412589982216,2020-04-20,2020,4
"3923","MT",5,"Centro-oeste",51006,"Alto Teles Pires",267191,72465.2071640138,17,100,18,82,48,52,1,0,1,1,0,101,18,83,49,52,13,11.1908618244673,12.4957190374426,0.408913069602865,2020-04-27,2020,4
"3924","MT",5,"Centro-oeste",51006,"Alto Teles Pires",267191,72465.2071640138,18,95,19,76,40,55,2,1,1,0,2,97,20,77,40,57,20,11.1908618244673,12.4957190374426,0.396387792313044,2020-05-04,2020,5
"3925","MT",5,"Centro-oeste",51006,"Alto Teles Pires",267191,72465.2071640138,19,100,16,84,49,51,1,0,1,0,1,101,16,85,49,52,15,11.1908618244673,12.4957190374426,0.410172300393338,2020-05-11,2020,5
"3926","MT",5,"Centro-oeste",51006,"Alto Teles Pires",267191,72465.2071640138,20,109,24,85,45,64,1,1,0,1,0,110,25,85,46,64,20,11.1908618244673,12.4957190374426,0.402525986852776,2020-05-18,2020,5
"3927","MT",5,"Centro-oeste",51006,"Alto Teles Pires",267191,72465.2071640138,21,106,17,89,36,70,0,0,0,0,0,106,17,89,36,70,22,11.1908618244673,12.4957190374426,0.398678668041044,2020-05-25,2020,5
"3928","MT",5,"Centro-oeste",51007,"Sinop",209969,43868.8872591668,5,83,13,70,31,52,2,1,1,0,2,85,14,71,31,54,14,10.6889606293336,12.2547151797552,0.309535027604122,2020-02-03,2020,2
"3929","MT",5,"Centro-oeste",51007,"Sinop",209969,43868.8872591668,6,73,17,56,31,42,0,0,0,0,0,73,17,56,31,42,11,10.6889606293336,12.2547151797552,0.303352755656784,2020-02-10,2020,2
"3930","MT",5,"Centro-oeste",51007,"Sinop",209969,43868.8872591668,7,76,21,55,34,42,0,0,0,0,0,76,21,55,34,42,16,10.6889606293336,12.2547151797552,0.323058535575185,2020-02-17,2020,2
"3931","MT",5,"Centro-oeste",51007,"Sinop",209969,43868.8872591668,8,76,14,62,36,40,0,0,0,0,0,76,14,62,36,40,15,10.6889606293336,12.2547151797552,0.348130646248807,2020-02-24,2020,2
"3932","MT",5,"Centro-oeste",51007,"Sinop",209969,43868.8872591668,9,78,16,62,25,53,0,0,0,0,0,78,16,62,25,53,22,10.6889606293336,12.2547151797552,0.327752960875903,2020-03-02,2020,3
"3933","MT",5,"Centro-oeste",51007,"Sinop",209969,43868.8872591668,10,75,8,67,29,46,0,0,0,0,0,75,8,67,29,46,25,10.6889606293336,12.2547151797552,0.339630922677342,2020-03-09,2020,3
"3934","MT",5,"Centro-oeste",51007,"Sinop",209969,43868.8872591668,11,68,12,56,30,38,1,0,1,0,1,69,12,57,30,39,20,10.6889606293336,12.2547151797552,0.398022903217488,2020-03-16,2020,3
"3935","MT",5,"Centro-oeste",51007,"Sinop",209969,43868.8872591668,12,84,16,68,45,39,0,0,0,0,0,84,16,68,45,39,21,10.6889606293336,12.2547151797552,0.512245375675657,2020-03-23,2020,3
"3936","MT",5,"Centro-oeste",51007,"Sinop",209969,43868.8872591668,13,72,13,59,29,43,0,0,0,0,0,72,13,59,29,43,31,10.6889606293336,12.2547151797552,0.461648016572571,2020-03-30,2020,3
"3937","MT",5,"Centro-oeste",51007,"Sinop",209969,43868.8872591668,14,60,10,50,25,35,1,0,1,0,1,61,10,51,25,36,27,10.6889606293336,12.2547151797552,0.434365950953653,2020-04-06,2020,4
"3938","MT",5,"Centro-oeste",51007,"Sinop",209969,43868.8872591668,15,76,17,59,33,43,1,0,1,0,1,77,17,60,33,44,23,10.6889606293336,12.2547151797552,0.419135682866316,2020-04-13,2020,4
"3939","MT",5,"Centro-oeste",51007,"Sinop",209969,43868.8872591668,16,84,21,63,43,41,1,0,1,1,0,85,21,64,44,41,16,10.6889606293336,12.2547151797552,0.419399886186411,2020-04-20,2020,4
"3940","MT",5,"Centro-oeste",51007,"Sinop",209969,43868.8872591668,17,78,18,60,31,47,0,0,0,0,0,78,18,60,31,47,22,10.6889606293336,12.2547151797552,0.404185395249091,2020-04-27,2020,4
"3941","MT",5,"Centro-oeste",51007,"Sinop",209969,43868.8872591668,18,79,14,65,40,39,1,0,1,0,1,80,14,66,40,40,26,10.6889606293336,12.2547151797552,0.38515516204783,2020-05-04,2020,5
"3942","MT",5,"Centro-oeste",51007,"Sinop",209969,43868.8872591668,19,94,15,79,41,53,0,0,0,0,0,94,15,79,41,53,19,10.6889606293336,12.2547151797552,0.390002655570003,2020-05-11,2020,5
"3943","MT",5,"Centro-oeste",51007,"Sinop",209969,43868.8872591668,20,90,19,71,34,56,0,0,0,0,0,90,19,71,34,56,16,10.6889606293336,12.2547151797552,0.393125393461006,2020-05-18,2020,5
"3944","MT",5,"Centro-oeste",51007,"Sinop",209969,43868.8872591668,21,86,15,71,39,47,0,0,0,0,0,86,15,71,39,47,26,10.6889606293336,12.2547151797552,0.386590718807844,2020-05-25,2020,5
"3945","MT",5,"Centro-oeste",51008,"Paranatinga",37097,31368.118397175,5,14,8,6,6,8,0,0,0,0,0,14,8,6,6,8,3,10.3535473184223,10.5212913827923,0.337468209255756,2020-02-03,2020,2
"3946","MT",5,"Centro-oeste",51008,"Paranatinga",37097,31368.118397175,6,11,2,9,5,6,0,0,0,0,0,11,2,9,5,6,4,10.3535473184223,10.5212913827923,0.302129961881287,2020-02-10,2020,2
"3947","MT",5,"Centro-oeste",51008,"Paranatinga",37097,31368.118397175,7,11,6,5,5,6,0,0,0,0,0,11,6,5,5,6,3,10.3535473184223,10.5212913827923,0.32386489008975,2020-02-17,2020,2
"3948","MT",5,"Centro-oeste",51008,"Paranatinga",37097,31368.118397175,8,9,2,7,7,2,0,0,0,0,0,9,2,7,7,2,2,10.3535473184223,10.5212913827923,0.380517735220741,2020-02-24,2020,2
"3949","MT",5,"Centro-oeste",51008,"Paranatinga",37097,31368.118397175,9,6,1,5,5,1,0,0,0,0,0,6,1,5,5,1,5,10.3535473184223,10.5212913827923,0.345056995917003,2020-03-02,2020,3
"3950","MT",5,"Centro-oeste",51008,"Paranatinga",37097,31368.118397175,10,15,4,11,8,7,0,0,0,0,0,15,4,11,8,7,4,10.3535473184223,10.5212913827923,0.365263646869836,2020-03-09,2020,3
"3951","MT",5,"Centro-oeste",51008,"Paranatinga",37097,31368.118397175,11,9,5,4,5,4,0,0,0,0,0,9,5,4,5,4,3,10.3535473184223,10.5212913827923,0.406025909818168,2020-03-16,2020,3
"3952","MT",5,"Centro-oeste",51008,"Paranatinga",37097,31368.118397175,12,10,3,7,6,4,0,0,0,0,0,10,3,7,6,4,4,10.3535473184223,10.5212913827923,0.49363465743634,2020-03-23,2020,3
"3953","MT",5,"Centro-oeste",51008,"Paranatinga",37097,31368.118397175,13,9,3,6,5,4,0,0,0,0,0,9,3,6,5,4,0,10.3535473184223,10.5212913827923,0.439074443079561,2020-03-30,2020,3
"3954","MT",5,"Centro-oeste",51008,"Paranatinga",37097,31368.118397175,14,8,3,5,5,3,0,0,0,0,0,8,3,5,5,3,2,10.3535473184223,10.5212913827923,0.449169825358333,2020-04-06,2020,4
"3955","MT",5,"Centro-oeste",51008,"Paranatinga",37097,31368.118397175,15,8,3,5,4,4,0,0,0,0,0,8,3,5,4,4,3,10.3535473184223,10.5212913827923,0.406301855877684,2020-04-13,2020,4
"3956","MT",5,"Centro-oeste",51008,"Paranatinga",37097,31368.118397175,16,10,3,7,3,7,1,0,1,0,1,11,3,8,3,8,7,10.3535473184223,10.5212913827923,0.403739643368067,2020-04-20,2020,4
"3957","MT",5,"Centro-oeste",51008,"Paranatinga",37097,31368.118397175,17,12,4,8,4,8,1,0,1,0,1,13,4,9,4,9,3,10.3535473184223,10.5212913827923,0.395153957936364,2020-04-27,2020,4
"3958","MT",5,"Centro-oeste",51008,"Paranatinga",37097,31368.118397175,18,8,2,6,4,4,0,0,0,0,0,8,2,6,4,4,9,10.3535473184223,10.5212913827923,0.417005839376062,2020-05-04,2020,5
"3959","MT",5,"Centro-oeste",51008,"Paranatinga",37097,31368.118397175,19,5,3,2,3,2,0,0,0,0,0,5,3,2,3,2,3,10.3535473184223,10.5212913827923,0.42926513961746,2020-05-11,2020,5
"3960","MT",5,"Centro-oeste",51008,"Paranatinga",37097,31368.118397175,20,11,6,5,5,6,0,0,0,0,0,11,6,5,5,6,5,10.3535473184223,10.5212913827923,0.420737324941663,2020-05-18,2020,5
"3961","MT",5,"Centro-oeste",51008,"Paranatinga",37097,31368.118397175,21,7,3,4,4,3,0,0,0,0,0,7,3,4,4,3,4,10.3535473184223,10.5212913827923,0.446045228151366,2020-05-25,2020,5
"3962","MT",5,"Centro-oeste",51009,"Norte Araguaia",134387,29288.1462439075,5,32,11,21,18,14,0,0,0,0,0,32,11,21,18,14,13,10.2849381480923,11.8084789762024,0.324039848820587,2020-02-03,2020,2
"3963","MT",5,"Centro-oeste",51009,"Norte Araguaia",134387,29288.1462439075,6,40,11,29,23,17,0,0,0,0,0,40,11,29,23,17,10,10.2849381480923,11.8084789762024,0.318754761568404,2020-02-10,2020,2
"3964","MT",5,"Centro-oeste",51009,"Norte Araguaia",134387,29288.1462439075,7,50,13,37,27,23,0,0,0,0,0,50,13,37,27,23,7,10.2849381480923,11.8084789762024,0.329089200572136,2020-02-17,2020,2
"3965","MT",5,"Centro-oeste",51009,"Norte Araguaia",134387,29288.1462439075,8,41,11,30,22,19,0,0,0,0,0,41,11,30,22,19,8,10.2849381480923,11.8084789762024,0.351305393265937,2020-02-24,2020,2
"3966","MT",5,"Centro-oeste",51009,"Norte Araguaia",134387,29288.1462439075,9,44,12,32,25,19,1,0,1,0,1,45,12,33,25,20,5,10.2849381480923,11.8084789762024,0.329406767737439,2020-03-02,2020,3
"3967","MT",5,"Centro-oeste",51009,"Norte Araguaia",134387,29288.1462439075,10,43,15,28,25,18,0,0,0,0,0,43,15,28,25,18,10,10.2849381480923,11.8084789762024,0.346447462655797,2020-03-09,2020,3
"3968","MT",5,"Centro-oeste",51009,"Norte Araguaia",134387,29288.1462439075,11,34,9,25,23,11,0,0,0,0,0,34,9,25,23,11,11,10.2849381480923,11.8084789762024,0.38811970919853,2020-03-16,2020,3
"3969","MT",5,"Centro-oeste",51009,"Norte Araguaia",134387,29288.1462439075,12,45,13,32,21,24,0,0,0,0,0,45,13,32,21,24,8,10.2849381480923,11.8084789762024,0.477418887367206,2020-03-23,2020,3
"3970","MT",5,"Centro-oeste",51009,"Norte Araguaia",134387,29288.1462439075,13,20,4,16,10,10,0,0,0,0,0,20,4,16,10,10,12,10.2849381480923,11.8084789762024,0.39549710979859,2020-03-30,2020,3
"3971","MT",5,"Centro-oeste",51009,"Norte Araguaia",134387,29288.1462439075,14,28,9,19,14,14,0,0,0,0,0,28,9,19,14,14,12,10.2849381480923,11.8084789762024,0.394899547529456,2020-04-06,2020,4
"3972","MT",5,"Centro-oeste",51009,"Norte Araguaia",134387,29288.1462439075,15,41,9,32,21,20,0,0,0,0,0,41,9,32,21,20,8,10.2849381480923,11.8084789762024,0.386715921498989,2020-04-13,2020,4
"3973","MT",5,"Centro-oeste",51009,"Norte Araguaia",134387,29288.1462439075,16,30,7,23,11,19,0,0,0,0,0,30,7,23,11,19,12,10.2849381480923,11.8084789762024,0.395635550174108,2020-04-20,2020,4
"3974","MT",5,"Centro-oeste",51009,"Norte Araguaia",134387,29288.1462439075,17,27,7,20,13,14,0,0,0,0,0,27,7,20,13,14,9,10.2849381480923,11.8084789762024,0.387629189735994,2020-04-27,2020,4
"3975","MT",5,"Centro-oeste",51009,"Norte Araguaia",134387,29288.1462439075,18,32,10,22,16,16,0,0,0,0,0,32,10,22,16,16,15,10.2849381480923,11.8084789762024,0.38590603510678,2020-05-04,2020,5
"3976","MT",5,"Centro-oeste",51009,"Norte Araguaia",134387,29288.1462439075,19,33,12,21,19,14,0,0,0,0,0,33,12,21,19,14,11,10.2849381480923,11.8084789762024,0.41126097817647,2020-05-11,2020,5
"3977","MT",5,"Centro-oeste",51009,"Norte Araguaia",134387,29288.1462439075,20,33,8,25,18,15,0,0,0,0,0,33,8,25,18,15,7,10.2849381480923,11.8084789762024,0.399282745994224,2020-05-18,2020,5
"3978","MT",5,"Centro-oeste",51009,"Norte Araguaia",134387,29288.1462439075,21,48,11,37,27,21,0,0,0,0,0,48,11,37,27,21,11,10.2849381480923,11.8084789762024,0.418832224279682,2020-05-25,2020,5
"3979","MT",5,"Centro-oeste",51010,"Canarana",118050,50135.6243762812,5,35,16,19,16,19,0,0,0,0,0,35,16,19,16,19,15,10.8224870997806,11.6788635425137,0.311732915767854,2020-02-03,2020,2
"3980","MT",5,"Centro-oeste",51010,"Canarana",118050,50135.6243762812,6,29,10,19,15,14,0,0,0,0,0,29,10,19,15,14,4,10.8224870997806,11.6788635425137,0.297947747387976,2020-02-10,2020,2
"3981","MT",5,"Centro-oeste",51010,"Canarana",118050,50135.6243762812,7,38,10,28,21,17,0,0,0,0,0,38,10,28,21,17,12,10.8224870997806,11.6788635425137,0.313220931278759,2020-02-17,2020,2
"3982","MT",5,"Centro-oeste",51010,"Canarana",118050,50135.6243762812,8,35,9,26,13,22,0,0,0,0,0,35,9,26,13,22,10,10.8224870997806,11.6788635425137,0.345794520787134,2020-02-24,2020,2
"3983","MT",5,"Centro-oeste",51010,"Canarana",118050,50135.6243762812,9,42,12,30,16,26,0,0,0,0,0,42,12,30,16,26,14,10.8224870997806,11.6788635425137,0.32096732050591,2020-03-02,2020,3
"3984","MT",5,"Centro-oeste",51010,"Canarana",118050,50135.6243762812,10,34,7,27,18,16,0,0,0,0,0,34,7,27,18,16,14,10.8224870997806,11.6788635425137,0.350357586855638,2020-03-09,2020,3
"3985","MT",5,"Centro-oeste",51010,"Canarana",118050,50135.6243762812,11,43,15,28,24,19,1,1,0,1,0,44,16,28,25,19,9,10.8224870997806,11.6788635425137,0.382996801215817,2020-03-16,2020,3
"3986","MT",5,"Centro-oeste",51010,"Canarana",118050,50135.6243762812,12,31,12,19,18,13,0,0,0,0,0,31,12,19,18,13,11,10.8224870997806,11.6788635425137,0.465042177445102,2020-03-23,2020,3
"3987","MT",5,"Centro-oeste",51010,"Canarana",118050,50135.6243762812,13,28,7,21,8,20,0,0,0,0,0,28,7,21,8,20,14,10.8224870997806,11.6788635425137,0.424865502737774,2020-03-30,2020,3
"3988","MT",5,"Centro-oeste",51010,"Canarana",118050,50135.6243762812,14,47,9,38,27,20,0,0,0,0,0,47,9,38,27,20,10,10.8224870997806,11.6788635425137,0.428248643157938,2020-04-06,2020,4
"3989","MT",5,"Centro-oeste",51010,"Canarana",118050,50135.6243762812,15,33,11,22,16,17,0,0,0,0,0,33,11,22,16,17,9,10.8224870997806,11.6788635425137,0.392795696737193,2020-04-13,2020,4
"3990","MT",5,"Centro-oeste",51010,"Canarana",118050,50135.6243762812,16,31,10,21,16,15,0,0,0,0,0,31,10,21,16,15,17,10.8224870997806,11.6788635425137,0.405801520370091,2020-04-20,2020,4
"3991","MT",5,"Centro-oeste",51010,"Canarana",118050,50135.6243762812,17,38,10,28,20,18,1,1,0,0,1,39,11,28,20,19,7,10.8224870997806,11.6788635425137,0.397212959496388,2020-04-27,2020,4
"3992","MT",5,"Centro-oeste",51010,"Canarana",118050,50135.6243762812,18,21,8,13,8,13,1,1,0,0,1,22,9,13,8,14,15,10.8224870997806,11.6788635425137,0.395949573447765,2020-05-04,2020,5
"3993","MT",5,"Centro-oeste",51010,"Canarana",118050,50135.6243762812,19,35,11,24,18,17,0,0,0,0,0,35,11,24,18,17,4,10.8224870997806,11.6788635425137,0.399412802314689,2020-05-11,2020,5
"3994","MT",5,"Centro-oeste",51010,"Canarana",118050,50135.6243762812,20,48,11,37,22,26,0,0,0,0,0,48,11,37,22,26,18,10.8224870997806,11.6788635425137,0.39451541330799,2020-05-18,2020,5
"3995","MT",5,"Centro-oeste",51010,"Canarana",118050,50135.6243762812,21,43,10,33,18,25,0,0,0,0,0,43,10,33,18,25,6,10.8224870997806,11.6788635425137,0.379543047296072,2020-05-25,2020,5
"3996","MT",5,"Centro-oeste",51011,"Médio Araguaia",69925,30491.3265196997,5,25,9,16,11,14,0,0,0,0,0,25,9,16,11,14,11,10.3251975457496,11.1551785180702,0.284637441832238,2020-02-03,2020,2
"3997","MT",5,"Centro-oeste",51011,"Médio Araguaia",69925,30491.3265196997,6,30,7,23,10,20,0,0,0,0,0,30,7,23,10,20,8,10.3251975457496,11.1551785180702,0.283725331141419,2020-02-10,2020,2
"3998","MT",5,"Centro-oeste",51011,"Médio Araguaia",69925,30491.3265196997,7,20,5,15,5,15,0,0,0,0,0,20,5,15,5,15,6,10.3251975457496,11.1551785180702,0.280498373029046,2020-02-17,2020,2
"3999","MT",5,"Centro-oeste",51011,"Médio Araguaia",69925,30491.3265196997,8,19,3,16,9,10,0,0,0,0,0,19,3,16,9,10,6,10.3251975457496,11.1551785180702,0.335258828149889,2020-02-24,2020,2
"4000","MT",5,"Centro-oeste",51011,"Médio Araguaia",69925,30491.3265196997,9,25,5,20,6,19,0,0,0,0,0,25,5,20,6,19,8,10.3251975457496,11.1551785180702,0.302610018585672,2020-03-02,2020,3
"4001","MT",5,"Centro-oeste",51011,"Médio Araguaia",69925,30491.3265196997,10,19,2,17,10,9,0,0,0,0,0,19,2,17,10,9,9,10.3251975457496,11.1551785180702,0.317599952835168,2020-03-09,2020,3
"4002","MT",5,"Centro-oeste",51011,"Médio Araguaia",69925,30491.3265196997,11,21,9,12,5,16,0,0,0,0,0,21,9,12,5,16,13,10.3251975457496,11.1551785180702,0.410827004800836,2020-03-16,2020,3
"4003","MT",5,"Centro-oeste",51011,"Médio Araguaia",69925,30491.3265196997,12,30,7,23,11,19,0,0,0,0,0,30,7,23,11,19,11,10.3251975457496,11.1551785180702,0.500033220979649,2020-03-23,2020,3
"4004","MT",5,"Centro-oeste",51011,"Médio Araguaia",69925,30491.3265196997,13,21,5,16,9,12,0,0,0,0,0,21,5,16,9,12,7,10.3251975457496,11.1551785180702,0.430142420818977,2020-03-30,2020,3
"4005","MT",5,"Centro-oeste",51011,"Médio Araguaia",69925,30491.3265196997,14,12,5,7,5,7,0,0,0,0,0,12,5,7,5,7,12,10.3251975457496,11.1551785180702,0.439837593484401,2020-04-06,2020,4
"4006","MT",5,"Centro-oeste",51011,"Médio Araguaia",69925,30491.3265196997,15,23,3,20,9,14,0,0,0,0,0,23,3,20,9,14,6,10.3251975457496,11.1551785180702,0.414027116137721,2020-04-13,2020,4
"4007","MT",5,"Centro-oeste",51011,"Médio Araguaia",69925,30491.3265196997,16,11,2,9,4,7,0,0,0,0,0,11,2,9,4,7,10,10.3251975457496,11.1551785180702,0.432795911074908,2020-04-20,2020,4
"4008","MT",5,"Centro-oeste",51011,"Médio Araguaia",69925,30491.3265196997,17,17,2,15,7,10,0,0,0,0,0,17,2,15,7,10,5,10.3251975457496,11.1551785180702,0.396097958501959,2020-04-27,2020,4
"4009","MT",5,"Centro-oeste",51011,"Médio Araguaia",69925,30491.3265196997,18,26,5,21,12,14,0,0,0,0,0,26,5,21,12,14,11,10.3251975457496,11.1551785180702,0.393833279910335,2020-05-04,2020,5
"4010","MT",5,"Centro-oeste",51011,"Médio Araguaia",69925,30491.3265196997,19,22,7,15,7,15,0,0,0,0,0,22,7,15,7,15,3,10.3251975457496,11.1551785180702,0.436049346941776,2020-05-11,2020,5
"4011","MT",5,"Centro-oeste",51011,"Médio Araguaia",69925,30491.3265196997,20,22,8,14,13,9,0,0,0,0,0,22,8,14,13,9,12,10.3251975457496,11.1551785180702,0.446155874504328,2020-05-18,2020,5
"4012","MT",5,"Centro-oeste",51011,"Médio Araguaia",69925,30491.3265196997,21,29,4,25,11,18,1,0,1,0,1,30,4,26,11,19,12,10.3251975457496,11.1551785180702,0.430757568480327,2020-05-25,2020,5
"4013","MT",5,"Centro-oeste",51012,"Alto Guaporé",76023,26608.0097744104,5,26,6,20,18,8,0,0,0,0,0,26,6,20,18,8,4,10.1889675687812,11.2387912050637,0.320722606197795,2020-02-03,2020,2
"4014","MT",5,"Centro-oeste",51012,"Alto Guaporé",76023,26608.0097744104,6,19,9,10,6,13,0,0,0,0,0,19,9,10,6,13,4,10.1889675687812,11.2387912050637,0.323028263243328,2020-02-10,2020,2
"4015","MT",5,"Centro-oeste",51012,"Alto Guaporé",76023,26608.0097744104,7,25,3,22,15,10,1,0,1,0,1,26,3,23,15,11,4,10.1889675687812,11.2387912050637,0.325763962824389,2020-02-17,2020,2
"4016","MT",5,"Centro-oeste",51012,"Alto Guaporé",76023,26608.0097744104,8,26,9,17,15,11,0,0,0,0,0,26,9,17,15,11,9,10.1889675687812,11.2387912050637,0.367510582883499,2020-02-24,2020,2
"4017","MT",5,"Centro-oeste",51012,"Alto Guaporé",76023,26608.0097744104,9,18,4,14,10,8,1,0,1,0,1,19,4,15,10,9,6,10.1889675687812,11.2387912050637,0.331974891499141,2020-03-02,2020,3
"4018","MT",5,"Centro-oeste",51012,"Alto Guaporé",76023,26608.0097744104,10,24,7,17,9,15,0,0,0,0,0,24,7,17,9,15,7,10.1889675687812,11.2387912050637,0.357604242626804,2020-03-09,2020,3
"4019","MT",5,"Centro-oeste",51012,"Alto Guaporé",76023,26608.0097744104,11,17,5,12,6,11,0,0,0,0,0,17,5,12,6,11,7,10.1889675687812,11.2387912050637,0.429087999004918,2020-03-16,2020,3
"4020","MT",5,"Centro-oeste",51012,"Alto Guaporé",76023,26608.0097744104,12,19,3,16,9,10,0,0,0,0,0,19,3,16,9,10,6,10.1889675687812,11.2387912050637,0.458640484508293,2020-03-23,2020,3
"4021","MT",5,"Centro-oeste",51012,"Alto Guaporé",76023,26608.0097744104,13,9,2,7,2,7,2,1,1,1,1,11,3,8,3,8,7,10.1889675687812,11.2387912050637,0.438097395549908,2020-03-30,2020,3
"4022","MT",5,"Centro-oeste",51012,"Alto Guaporé",76023,26608.0097744104,14,28,7,21,13,15,0,0,0,0,0,28,7,21,13,15,11,10.1889675687812,11.2387912050637,0.432906444894497,2020-04-06,2020,4
"4023","MT",5,"Centro-oeste",51012,"Alto Guaporé",76023,26608.0097744104,15,33,8,25,17,16,1,0,1,0,1,34,8,26,17,17,7,10.1889675687812,11.2387912050637,0.420500545826819,2020-04-13,2020,4
"4024","MT",5,"Centro-oeste",51012,"Alto Guaporé",76023,26608.0097744104,16,18,5,13,7,11,0,0,0,0,0,18,5,13,7,11,10,10.1889675687812,11.2387912050637,0.433158005740718,2020-04-20,2020,4
"4025","MT",5,"Centro-oeste",51012,"Alto Guaporé",76023,26608.0097744104,17,24,2,22,9,15,0,0,0,0,0,24,2,22,9,15,5,10.1889675687812,11.2387912050637,0.404960938576222,2020-04-27,2020,4
"4026","MT",5,"Centro-oeste",51012,"Alto Guaporé",76023,26608.0097744104,18,25,6,19,13,12,1,0,1,1,0,26,6,20,14,12,6,10.1889675687812,11.2387912050637,0.407920068473734,2020-05-04,2020,5
"4027","MT",5,"Centro-oeste",51012,"Alto Guaporé",76023,26608.0097744104,19,25,7,18,14,11,0,0,0,0,0,25,7,18,14,11,3,10.1889675687812,11.2387912050637,0.404129086875628,2020-05-11,2020,5
"4028","MT",5,"Centro-oeste",51012,"Alto Guaporé",76023,26608.0097744104,20,23,8,15,8,15,0,0,0,0,0,23,8,15,8,15,9,10.1889675687812,11.2387912050637,0.428069388884809,2020-05-18,2020,5
"4029","MT",5,"Centro-oeste",51012,"Alto Guaporé",76023,26608.0097744104,21,20,6,14,11,9,0,0,0,0,0,20,6,14,11,9,9,10.1889675687812,11.2387912050637,0.429011795370341,2020-05-25,2020,5
"4030","MT",5,"Centro-oeste",51013,"Tangará da Serra",174002,34748.9320906081,5,43,5,38,10,33,0,0,0,0,0,43,5,38,10,33,15,10.4559041193152,12.0668220723835,0.325133115798349,2020-02-03,2020,2
"4031","MT",5,"Centro-oeste",51013,"Tangará da Serra",174002,34748.9320906081,6,53,10,43,20,33,0,0,0,0,0,53,10,43,20,33,21,10.4559041193152,12.0668220723835,0.308202967530761,2020-02-10,2020,2
"4032","MT",5,"Centro-oeste",51013,"Tangará da Serra",174002,34748.9320906081,7,46,6,40,19,27,0,0,0,0,0,46,6,40,19,27,14,10.4559041193152,12.0668220723835,0.333935630019237,2020-02-17,2020,2
"4033","MT",5,"Centro-oeste",51013,"Tangará da Serra",174002,34748.9320906081,8,47,6,41,23,24,0,0,0,0,0,47,6,41,23,24,21,10.4559041193152,12.0668220723835,0.353310557710075,2020-02-24,2020,2
"4034","MT",5,"Centro-oeste",51013,"Tangará da Serra",174002,34748.9320906081,9,46,12,34,23,23,1,0,1,1,0,47,12,35,24,23,22,10.4559041193152,12.0668220723835,0.338336008832175,2020-03-02,2020,3
"4035","MT",5,"Centro-oeste",51013,"Tangará da Serra",174002,34748.9320906081,10,41,8,33,23,18,0,0,0,0,0,41,8,33,23,18,15,10.4559041193152,12.0668220723835,0.348086474857385,2020-03-09,2020,3
"4036","MT",5,"Centro-oeste",51013,"Tangará da Serra",174002,34748.9320906081,11,43,3,40,17,26,1,0,1,0,1,44,3,41,17,27,20,10.4559041193152,12.0668220723835,0.409151480322794,2020-03-16,2020,3
"4037","MT",5,"Centro-oeste",51013,"Tangará da Serra",174002,34748.9320906081,12,49,9,40,18,31,1,1,0,0,1,50,10,40,18,32,19,10.4559041193152,12.0668220723835,0.517147921101463,2020-03-23,2020,3
"4038","MT",5,"Centro-oeste",51013,"Tangará da Serra",174002,34748.9320906081,13,43,9,34,23,20,1,0,1,1,0,44,9,35,24,20,16,10.4559041193152,12.0668220723835,0.477684147595493,2020-03-30,2020,3
"4039","MT",5,"Centro-oeste",51013,"Tangará da Serra",174002,34748.9320906081,14,48,6,42,17,31,0,0,0,0,0,48,6,42,17,31,21,10.4559041193152,12.0668220723835,0.459239759584599,2020-04-06,2020,4
"4040","MT",5,"Centro-oeste",51013,"Tangará da Serra",174002,34748.9320906081,15,46,12,34,18,28,0,0,0,0,0,46,12,34,18,28,16,10.4559041193152,12.0668220723835,0.4435855934738,2020-04-13,2020,4
"4041","MT",5,"Centro-oeste",51013,"Tangará da Serra",174002,34748.9320906081,16,57,10,47,29,28,0,0,0,0,0,57,10,47,29,28,19,10.4559041193152,12.0668220723835,0.441115061229248,2020-04-20,2020,4
"4042","MT",5,"Centro-oeste",51013,"Tangará da Serra",174002,34748.9320906081,17,49,8,41,21,28,0,0,0,0,0,49,8,41,21,28,12,10.4559041193152,12.0668220723835,0.417214391714068,2020-04-27,2020,4
"4043","MT",5,"Centro-oeste",51013,"Tangará da Serra",174002,34748.9320906081,18,45,9,36,21,24,0,0,0,0,0,45,9,36,21,24,8,10.4559041193152,12.0668220723835,0.410389473113333,2020-05-04,2020,5
"4044","MT",5,"Centro-oeste",51013,"Tangará da Serra",174002,34748.9320906081,19,48,9,39,29,19,0,0,0,0,0,48,9,39,29,19,21,10.4559041193152,12.0668220723835,0.422446151276798,2020-05-11,2020,5
"4045","MT",5,"Centro-oeste",51013,"Tangará da Serra",174002,34748.9320906081,20,61,10,51,14,47,1,0,1,0,1,62,10,52,14,48,15,10.4559041193152,12.0668220723835,0.415076102482456,2020-05-18,2020,5
"4046","MT",5,"Centro-oeste",51013,"Tangará da Serra",174002,34748.9320906081,21,46,8,38,22,24,1,1,0,0,1,47,9,38,22,25,17,10.4559041193152,12.0668220723835,0.415201474364029,2020-05-25,2020,5
"4047","MT",5,"Centro-oeste",51014,"Jauru",111030,24009.4011543727,5,23,1,22,7,16,0,0,0,0,0,23,1,22,7,16,22,10.0862007473954,11.6175557140483,0.2709039583433,2020-02-03,2020,2
"4048","MT",5,"Centro-oeste",51014,"Jauru",111030,24009.4011543727,6,32,5,27,8,24,1,0,1,1,0,33,5,28,9,24,13,10.0862007473954,11.6175557140483,0.285016083759352,2020-02-10,2020,2
"4049","MT",5,"Centro-oeste",51014,"Jauru",111030,24009.4011543727,7,24,2,22,11,13,0,0,0,0,0,24,2,22,11,13,12,10.0862007473954,11.6175557140483,0.306844581929697,2020-02-17,2020,2
"4050","MT",5,"Centro-oeste",51014,"Jauru",111030,24009.4011543727,8,29,5,24,8,21,0,0,0,0,0,29,5,24,8,21,24,10.0862007473954,11.6175557140483,0.30898197207237,2020-02-24,2020,2
"4051","MT",5,"Centro-oeste",51014,"Jauru",111030,24009.4011543727,9,27,5,22,11,16,0,0,0,0,0,27,5,22,11,16,13,10.0862007473954,11.6175557140483,0.321302392296679,2020-03-02,2020,3
"4052","MT",5,"Centro-oeste",51014,"Jauru",111030,24009.4011543727,10,14,2,12,3,11,0,0,0,0,0,14,2,12,3,11,19,10.0862007473954,11.6175557140483,0.325085778374945,2020-03-09,2020,3
"4053","MT",5,"Centro-oeste",51014,"Jauru",111030,24009.4011543727,11,24,2,22,11,13,0,0,0,0,0,24,2,22,11,13,13,10.0862007473954,11.6175557140483,0.373592790605238,2020-03-16,2020,3
"4054","MT",5,"Centro-oeste",51014,"Jauru",111030,24009.4011543727,12,16,3,13,9,7,0,0,0,0,0,16,3,13,9,7,10,10.0862007473954,11.6175557140483,0.422535282466262,2020-03-23,2020,3
"4055","MT",5,"Centro-oeste",51014,"Jauru",111030,24009.4011543727,13,16,3,13,7,9,0,0,0,0,0,16,3,13,7,9,12,10.0862007473954,11.6175557140483,0.400312337627229,2020-03-30,2020,3
"4056","MT",5,"Centro-oeste",51014,"Jauru",111030,24009.4011543727,14,25,3,22,11,14,0,0,0,0,0,25,3,22,11,14,10,10.0862007473954,11.6175557140483,0.427193484266266,2020-04-06,2020,4
"4057","MT",5,"Centro-oeste",51014,"Jauru",111030,24009.4011543727,15,33,8,25,14,19,0,0,0,0,0,33,8,25,14,19,8,10.0862007473954,11.6175557140483,0.395498259458466,2020-04-13,2020,4
"4058","MT",5,"Centro-oeste",51014,"Jauru",111030,24009.4011543727,16,21,5,16,12,9,0,0,0,0,0,21,5,16,12,9,16,10.0862007473954,11.6175557140483,0.416952728038871,2020-04-20,2020,4
"4059","MT",5,"Centro-oeste",51014,"Jauru",111030,24009.4011543727,17,22,5,17,11,11,0,0,0,0,0,22,5,17,11,11,12,10.0862007473954,11.6175557140483,0.388285361658187,2020-04-27,2020,4
"4060","MT",5,"Centro-oeste",51014,"Jauru",111030,24009.4011543727,18,33,6,27,15,18,2,1,1,0,2,35,7,28,15,20,13,10.0862007473954,11.6175557140483,0.381610307253721,2020-05-04,2020,5
"4061","MT",5,"Centro-oeste",51014,"Jauru",111030,24009.4011543727,19,26,6,20,16,10,0,0,0,0,0,26,6,20,16,10,12,10.0862007473954,11.6175557140483,0.391695066474351,2020-05-11,2020,5
"4062","MT",5,"Centro-oeste",51014,"Jauru",111030,24009.4011543727,20,26,2,24,7,19,0,0,0,0,0,26,2,24,7,19,15,10.0862007473954,11.6175557140483,0.374104021927239,2020-05-18,2020,5
"4063","MT",5,"Centro-oeste",51014,"Jauru",111030,24009.4011543727,21,32,9,23,14,18,0,0,0,0,0,32,9,23,14,18,14,10.0862007473954,11.6175557140483,0.370619497022703,2020-05-25,2020,5
"4064","MT",5,"Centro-oeste",51015,"Alto Paraguai",33357,20154.8931426687,5,6,3,3,2,4,0,0,0,0,0,6,3,3,2,4,5,9.91120237375942,10.4150229243714,0.248309388968125,2020-02-03,2020,2
"4065","MT",5,"Centro-oeste",51015,"Alto Paraguai",33357,20154.8931426687,6,2,0,2,1,1,0,0,0,0,0,2,0,2,1,1,2,9.91120237375942,10.4150229243714,0.265510705751435,2020-02-10,2020,2
"4066","MT",5,"Centro-oeste",51015,"Alto Paraguai",33357,20154.8931426687,7,6,2,4,3,3,0,0,0,0,0,6,2,4,3,3,5,9.91120237375942,10.4150229243714,0.296795958941905,2020-02-17,2020,2
"4067","MT",5,"Centro-oeste",51015,"Alto Paraguai",33357,20154.8931426687,8,7,0,7,3,4,0,0,0,0,0,7,0,7,3,4,7,9.91120237375942,10.4150229243714,0.293750355463193,2020-02-24,2020,2
"4068","MT",5,"Centro-oeste",51015,"Alto Paraguai",33357,20154.8931426687,9,9,1,8,7,2,1,0,1,0,1,10,1,9,7,3,4,9.91120237375942,10.4150229243714,0.277738992357219,2020-03-02,2020,3
"4069","MT",5,"Centro-oeste",51015,"Alto Paraguai",33357,20154.8931426687,10,7,2,5,4,3,0,0,0,0,0,7,2,5,4,3,5,9.91120237375942,10.4150229243714,0.249975826807479,2020-03-09,2020,3
"4070","MT",5,"Centro-oeste",51015,"Alto Paraguai",33357,20154.8931426687,11,7,1,6,1,6,0,0,0,0,0,7,1,6,1,6,3,9.91120237375942,10.4150229243714,0.347015035210582,2020-03-16,2020,3
"4071","MT",5,"Centro-oeste",51015,"Alto Paraguai",33357,20154.8931426687,12,8,4,4,4,4,0,0,0,0,0,8,4,4,4,4,8,9.91120237375942,10.4150229243714,0.457897968262435,2020-03-23,2020,3
"4072","MT",5,"Centro-oeste",51015,"Alto Paraguai",33357,20154.8931426687,13,5,2,3,2,3,0,0,0,0,0,5,2,3,2,3,5,9.91120237375942,10.4150229243714,0.344426296039194,2020-03-30,2020,3
"4073","MT",5,"Centro-oeste",51015,"Alto Paraguai",33357,20154.8931426687,14,4,0,4,2,2,0,0,0,0,0,4,0,4,2,2,1,9.91120237375942,10.4150229243714,0.366159580394808,2020-04-06,2020,4
"4074","MT",5,"Centro-oeste",51015,"Alto Paraguai",33357,20154.8931426687,15,12,1,11,8,4,0,0,0,0,0,12,1,11,8,4,2,9.91120237375942,10.4150229243714,0.328609924393511,2020-04-13,2020,4
"4075","MT",5,"Centro-oeste",51015,"Alto Paraguai",33357,20154.8931426687,16,7,1,6,2,5,0,0,0,0,0,7,1,6,2,5,9,9.91120237375942,10.4150229243714,0.366416863052211,2020-04-20,2020,4
"4076","MT",5,"Centro-oeste",51015,"Alto Paraguai",33357,20154.8931426687,17,10,0,10,4,6,0,0,0,0,0,10,0,10,4,6,3,9.91120237375942,10.4150229243714,0.39058822495244,2020-04-27,2020,4
"4077","MT",5,"Centro-oeste",51015,"Alto Paraguai",33357,20154.8931426687,18,10,0,10,3,7,0,0,0,0,0,10,0,10,3,7,1,9.91120237375942,10.4150229243714,0.357697284170342,2020-05-04,2020,5
"4078","MT",5,"Centro-oeste",51015,"Alto Paraguai",33357,20154.8931426687,19,4,1,3,0,4,0,0,0,0,0,4,1,3,0,4,5,9.91120237375942,10.4150229243714,0.363551432721175,2020-05-11,2020,5
"4079","MT",5,"Centro-oeste",51015,"Alto Paraguai",33357,20154.8931426687,20,8,2,6,4,4,0,0,0,0,0,8,2,6,4,4,1,9.91120237375942,10.4150229243714,0.401910594813156,2020-05-18,2020,5
"4080","MT",5,"Centro-oeste",51015,"Alto Paraguai",33357,20154.8931426687,21,13,0,13,5,8,0,0,0,0,0,13,0,13,5,8,4,9.91120237375942,10.4150229243714,0.364963473468287,2020-05-25,2020,5
"4081","MT",5,"Centro-oeste",51016,"Rosário Oeste",30839,18466.0716699634,5,3,0,3,2,1,0,0,0,0,0,3,0,3,2,1,2,9.8236903635101,10.33653540173,0.317230982616426,2020-02-03,2020,2
"4082","MT",5,"Centro-oeste",51016,"Rosário Oeste",30839,18466.0716699634,6,8,0,8,6,2,0,0,0,0,0,8,0,8,6,2,4,9.8236903635101,10.33653540173,0.329571873810664,2020-02-10,2020,2
"4083","MT",5,"Centro-oeste",51016,"Rosário Oeste",30839,18466.0716699634,7,6,2,4,1,5,0,0,0,0,0,6,2,4,1,5,3,9.8236903635101,10.33653540173,0.313775350543241,2020-02-17,2020,2
"4084","MT",5,"Centro-oeste",51016,"Rosário Oeste",30839,18466.0716699634,8,4,0,4,2,2,0,0,0,0,0,4,0,4,2,2,1,9.8236903635101,10.33653540173,0.346350376456991,2020-02-24,2020,2
"4085","MT",5,"Centro-oeste",51016,"Rosário Oeste",30839,18466.0716699634,9,6,0,6,2,4,0,0,0,0,0,6,0,6,2,4,3,9.8236903635101,10.33653540173,0.31042508872263,2020-03-02,2020,3
"4086","MT",5,"Centro-oeste",51016,"Rosário Oeste",30839,18466.0716699634,10,5,0,5,0,5,0,0,0,0,0,5,0,5,0,5,5,9.8236903635101,10.33653540173,0.328878703883413,2020-03-09,2020,3
"4087","MT",5,"Centro-oeste",51016,"Rosário Oeste",30839,18466.0716699634,11,12,1,11,10,2,0,0,0,0,0,12,1,11,10,2,2,9.8236903635101,10.33653540173,0.406692738088327,2020-03-16,2020,3
"4088","MT",5,"Centro-oeste",51016,"Rosário Oeste",30839,18466.0716699634,12,5,1,4,2,3,0,0,0,0,0,5,1,4,2,3,4,9.8236903635101,10.33653540173,0.474251351340573,2020-03-23,2020,3
"4089","MT",5,"Centro-oeste",51016,"Rosário Oeste",30839,18466.0716699634,13,7,2,5,2,5,0,0,0,0,0,7,2,5,2,5,3,9.8236903635101,10.33653540173,0.409813606672937,2020-03-30,2020,3
"4090","MT",5,"Centro-oeste",51016,"Rosário Oeste",30839,18466.0716699634,14,7,1,6,4,3,0,0,0,0,0,7,1,6,4,3,4,9.8236903635101,10.33653540173,0.420641973635871,2020-04-06,2020,4
"4091","MT",5,"Centro-oeste",51016,"Rosário Oeste",30839,18466.0716699634,15,10,1,9,7,3,0,0,0,0,0,10,1,9,7,3,2,9.8236903635101,10.33653540173,0.401509864641449,2020-04-13,2020,4
"4092","MT",5,"Centro-oeste",51016,"Rosário Oeste",30839,18466.0716699634,16,8,2,6,3,5,0,0,0,0,0,8,2,6,3,5,5,9.8236903635101,10.33653540173,0.411357918494046,2020-04-20,2020,4
"4093","MT",5,"Centro-oeste",51016,"Rosário Oeste",30839,18466.0716699634,17,3,0,3,2,1,1,1,0,1,0,4,1,3,3,1,4,9.8236903635101,10.33653540173,0.409671532155418,2020-04-27,2020,4
"4094","MT",5,"Centro-oeste",51016,"Rosário Oeste",30839,18466.0716699634,18,8,1,7,4,4,0,0,0,0,0,8,1,7,4,4,2,9.8236903635101,10.33653540173,0.4184956390424,2020-05-04,2020,5
"4095","MT",5,"Centro-oeste",51016,"Rosário Oeste",30839,18466.0716699634,19,8,0,8,3,5,0,0,0,0,0,8,0,8,3,5,4,9.8236903635101,10.33653540173,0.423225607049451,2020-05-11,2020,5
"4096","MT",5,"Centro-oeste",51016,"Rosário Oeste",30839,18466.0716699634,20,4,0,4,1,3,0,0,0,0,0,4,0,4,1,3,1,9.8236903635101,10.33653540173,0.436882165847858,2020-05-18,2020,5
"4097","MT",5,"Centro-oeste",51016,"Rosário Oeste",30839,18466.0716699634,21,4,1,3,2,2,0,0,0,0,0,4,1,3,2,2,5,9.8236903635101,10.33653540173,0.416430139601094,2020-05-25,2020,5
"4098","MT",5,"Centro-oeste",51017,"Cuiabá",955206,35399.3458204722,5,275,24,251,100,175,1,1,0,0,1,276,25,251,100,176,109,10.4744486193034,13.7696823030078,0.2778087193937,2020-02-03,2020,2
"4099","MT",5,"Centro-oeste",51017,"Cuiabá",955206,35399.3458204722,6,299,35,264,110,189,4,1,3,2,2,303,36,267,112,191,114,10.4744486193034,13.7696823030078,0.273833832782682,2020-02-10,2020,2
"4100","MT",5,"Centro-oeste",51017,"Cuiabá",955206,35399.3458204722,7,261,39,222,95,166,5,1,4,1,4,266,40,226,96,170,112,10.4744486193034,13.7696823030078,0.290760820505499,2020-02-17,2020,2
"4101","MT",5,"Centro-oeste",51017,"Cuiabá",955206,35399.3458204722,8,242,29,213,85,157,2,1,1,0,2,244,30,214,85,159,96,10.4744486193034,13.7696823030078,0.334893977065349,2020-02-24,2020,2
"4102","MT",5,"Centro-oeste",51017,"Cuiabá",955206,35399.3458204722,9,206,23,183,77,129,2,0,2,1,1,208,23,185,78,130,101,10.4744486193034,13.7696823030078,0.312969496377576,2020-03-02,2020,3
"4103","MT",5,"Centro-oeste",51017,"Cuiabá",955206,35399.3458204722,10,260,26,234,101,159,6,1,5,2,4,266,27,239,103,163,131,10.4744486193034,13.7696823030078,0.324728217169773,2020-03-09,2020,3
"4104","MT",5,"Centro-oeste",51017,"Cuiabá",955206,35399.3458204722,11,314,35,279,124,190,3,1,2,1,2,317,36,281,125,192,116,10.4744486193034,13.7696823030078,0.394842095785517,2020-03-16,2020,3
"4105","MT",5,"Centro-oeste",51017,"Cuiabá",955206,35399.3458204722,12,228,27,201,88,140,1,0,1,0,1,229,27,202,88,141,109,10.4744486193034,13.7696823030078,0.515003776802323,2020-03-23,2020,3
"4106","MT",5,"Centro-oeste",51017,"Cuiabá",955206,35399.3458204722,13,234,24,210,86,148,2,1,1,0,2,236,25,211,86,150,84,10.4744486193034,13.7696823030078,0.464833364254247,2020-03-30,2020,3
"4107","MT",5,"Centro-oeste",51017,"Cuiabá",955206,35399.3458204722,14,278,28,250,110,168,4,3,1,1,3,282,31,251,111,171,101,10.4744486193034,13.7696823030078,0.456722818294018,2020-04-06,2020,4
"4108","MT",5,"Centro-oeste",51017,"Cuiabá",955206,35399.3458204722,15,289,42,247,111,178,4,0,4,0,4,293,42,251,111,182,92,10.4744486193034,13.7696823030078,0.430458057220667,2020-04-13,2020,4
"4109","MT",5,"Centro-oeste",51017,"Cuiabá",955206,35399.3458204722,16,274,25,249,101,173,3,1,2,1,2,277,26,251,102,175,96,10.4744486193034,13.7696823030078,0.430092973341061,2020-04-20,2020,4
"4110","MT",5,"Centro-oeste",51017,"Cuiabá",955206,35399.3458204722,17,241,26,215,95,146,4,1,3,1,3,245,27,218,96,149,108,10.4744486193034,13.7696823030078,0.411854231198369,2020-04-27,2020,4
"4111","MT",5,"Centro-oeste",51017,"Cuiabá",955206,35399.3458204722,18,243,22,221,91,152,4,0,4,3,1,247,22,225,94,153,87,10.4744486193034,13.7696823030078,0.388295054534472,2020-05-04,2020,5
"4112","MT",5,"Centro-oeste",51017,"Cuiabá",955206,35399.3458204722,19,234,22,212,97,137,2,0,2,0,2,236,22,214,97,139,93,10.4744486193034,13.7696823030078,0.396483463404133,2020-05-11,2020,5
"4113","MT",5,"Centro-oeste",51017,"Cuiabá",955206,35399.3458204722,20,253,18,235,85,168,1,0,1,1,0,254,18,236,86,168,101,10.4744486193034,13.7696823030078,0.394149507040284,2020-05-18,2020,5
"4114","MT",5,"Centro-oeste",51017,"Cuiabá",955206,35399.3458204722,21,276,23,253,105,171,3,0,3,1,2,279,23,256,106,173,123,10.4744486193034,13.7696823030078,0.385656567820202,2020-05-25,2020,5
"4115","MT",5,"Centro-oeste",51018,"Alto Pantanal",141581,18770.7337252174,5,38,6,32,23,15,2,0,2,1,1,40,6,34,24,16,17,9.8400542191318,11.8606272704477,0.291471530864167,2020-02-03,2020,2
"4116","MT",5,"Centro-oeste",51018,"Alto Pantanal",141581,18770.7337252174,6,55,8,47,25,30,0,0,0,0,0,55,8,47,25,30,14,9.8400542191318,11.8606272704477,0.265508338059529,2020-02-10,2020,2
"4117","MT",5,"Centro-oeste",51018,"Alto Pantanal",141581,18770.7337252174,7,44,12,32,21,23,0,0,0,0,0,44,12,32,21,23,25,9.8400542191318,11.8606272704477,0.295228051551091,2020-02-17,2020,2
"4118","MT",5,"Centro-oeste",51018,"Alto Pantanal",141581,18770.7337252174,8,53,12,41,25,28,0,0,0,0,0,53,12,41,25,28,18,9.8400542191318,11.8606272704477,0.305609657866264,2020-02-24,2020,2
"4119","MT",5,"Centro-oeste",51018,"Alto Pantanal",141581,18770.7337252174,9,33,12,21,17,16,0,0,0,0,0,33,12,21,17,16,23,9.8400542191318,11.8606272704477,0.290334697852103,2020-03-02,2020,3
"4120","MT",5,"Centro-oeste",51018,"Alto Pantanal",141581,18770.7337252174,10,22,5,17,13,9,1,0,1,0,1,23,5,18,13,10,26,9.8400542191318,11.8606272704477,0.30632038012215,2020-03-09,2020,3
"4121","MT",5,"Centro-oeste",51018,"Alto Pantanal",141581,18770.7337252174,11,29,4,25,11,18,0,0,0,0,0,29,4,25,11,18,24,9.8400542191318,11.8606272704477,0.370221724332448,2020-03-16,2020,3
"4122","MT",5,"Centro-oeste",51018,"Alto Pantanal",141581,18770.7337252174,12,36,9,27,17,19,2,1,1,1,1,38,10,28,18,20,19,9.8400542191318,11.8606272704477,0.455924824173937,2020-03-23,2020,3
"4123","MT",5,"Centro-oeste",51018,"Alto Pantanal",141581,18770.7337252174,13,31,4,27,13,18,1,0,1,1,0,32,4,28,14,18,24,9.8400542191318,11.8606272704477,0.426957444858423,2020-03-30,2020,3
"4124","MT",5,"Centro-oeste",51018,"Alto Pantanal",141581,18770.7337252174,14,33,8,25,12,21,0,0,0,0,0,33,8,25,12,21,20,9.8400542191318,11.8606272704477,0.416636841324944,2020-04-06,2020,4
"4125","MT",5,"Centro-oeste",51018,"Alto Pantanal",141581,18770.7337252174,15,37,10,27,19,18,0,0,0,0,0,37,10,27,19,18,15,9.8400542191318,11.8606272704477,0.401013892903088,2020-04-13,2020,4
"4126","MT",5,"Centro-oeste",51018,"Alto Pantanal",141581,18770.7337252174,16,33,6,27,15,18,0,0,0,0,0,33,6,27,15,18,14,9.8400542191318,11.8606272704477,0.403357314946689,2020-04-20,2020,4
"4127","MT",5,"Centro-oeste",51018,"Alto Pantanal",141581,18770.7337252174,17,35,7,28,11,24,0,0,0,0,0,35,7,28,11,24,12,9.8400542191318,11.8606272704477,0.390387836445804,2020-04-27,2020,4
"4128","MT",5,"Centro-oeste",51018,"Alto Pantanal",141581,18770.7337252174,18,41,12,29,19,22,0,0,0,0,0,41,12,29,19,22,16,9.8400542191318,11.8606272704477,0.390088192284464,2020-05-04,2020,5
"4129","MT",5,"Centro-oeste",51018,"Alto Pantanal",141581,18770.7337252174,19,48,11,37,18,30,1,0,1,0,1,49,11,38,18,31,13,9.8400542191318,11.8606272704477,0.398995217682038,2020-05-11,2020,5
"4130","MT",5,"Centro-oeste",51018,"Alto Pantanal",141581,18770.7337252174,20,50,4,46,25,25,0,0,0,0,0,50,4,46,25,25,18,9.8400542191318,11.8606272704477,0.378020788885907,2020-05-18,2020,5
"4131","MT",5,"Centro-oeste",51018,"Alto Pantanal",141581,18770.7337252174,21,47,9,38,21,26,1,1,0,1,0,48,10,38,22,26,17,9.8400542191318,11.8606272704477,0.372976559839053,2020-05-25,2020,5
"4132","MT",5,"Centro-oeste",51019,"Primavera do Leste",108832,61484.5574731697,5,56,7,49,26,30,0,0,0,0,0,56,7,49,26,30,10,11.026541324267,11.5975606878069,0.29842215225209,2020-02-03,2020,2
"4133","MT",5,"Centro-oeste",51019,"Primavera do Leste",108832,61484.5574731697,6,54,6,48,20,34,0,0,0,0,0,54,6,48,20,34,18,11.026541324267,11.5975606878069,0.29277433978454,2020-02-10,2020,2
"4134","MT",5,"Centro-oeste",51019,"Primavera do Leste",108832,61484.5574731697,7,29,7,22,11,18,0,0,0,0,0,29,7,22,11,18,12,11.026541324267,11.5975606878069,0.308679702884663,2020-02-17,2020,2
"4135","MT",5,"Centro-oeste",51019,"Primavera do Leste",108832,61484.5574731697,8,40,12,28,16,24,0,0,0,0,0,40,12,28,16,24,8,11.026541324267,11.5975606878069,0.350068940184849,2020-02-24,2020,2
"4136","MT",5,"Centro-oeste",51019,"Primavera do Leste",108832,61484.5574731697,9,46,9,37,19,27,0,0,0,0,0,46,9,37,19,27,13,11.026541324267,11.5975606878069,0.321761297661348,2020-03-02,2020,3
"4137","MT",5,"Centro-oeste",51019,"Primavera do Leste",108832,61484.5574731697,10,34,7,27,13,21,0,0,0,0,0,34,7,27,13,21,12,11.026541324267,11.5975606878069,0.336406519369357,2020-03-09,2020,3
"4138","MT",5,"Centro-oeste",51019,"Primavera do Leste",108832,61484.5574731697,11,29,6,23,9,20,0,0,0,0,0,29,6,23,9,20,11,11.026541324267,11.5975606878069,0.394517567004049,2020-03-16,2020,3
"4139","MT",5,"Centro-oeste",51019,"Primavera do Leste",108832,61484.5574731697,12,51,9,42,25,26,0,0,0,0,0,51,9,42,25,26,7,11.026541324267,11.5975606878069,0.473239121459559,2020-03-23,2020,3
"4140","MT",5,"Centro-oeste",51019,"Primavera do Leste",108832,61484.5574731697,13,28,5,23,13,15,0,0,0,0,0,28,5,23,13,15,7,11.026541324267,11.5975606878069,0.426560728557325,2020-03-30,2020,3
"4141","MT",5,"Centro-oeste",51019,"Primavera do Leste",108832,61484.5574731697,14,41,6,35,18,23,1,0,1,0,1,42,6,36,18,24,10,11.026541324267,11.5975606878069,0.424574039111888,2020-04-06,2020,4
"4142","MT",5,"Centro-oeste",51019,"Primavera do Leste",108832,61484.5574731697,15,41,4,37,15,26,0,0,0,0,0,41,4,37,15,26,5,11.026541324267,11.5975606878069,0.40203086136295,2020-04-13,2020,4
"4143","MT",5,"Centro-oeste",51019,"Primavera do Leste",108832,61484.5574731697,16,31,4,27,13,18,0,0,0,0,0,31,4,27,13,18,12,11.026541324267,11.5975606878069,0.404295208700923,2020-04-20,2020,4
"4144","MT",5,"Centro-oeste",51019,"Primavera do Leste",108832,61484.5574731697,17,27,5,22,12,15,0,0,0,0,0,27,5,22,12,15,7,11.026541324267,11.5975606878069,0.398409562456595,2020-04-27,2020,4
"4145","MT",5,"Centro-oeste",51019,"Primavera do Leste",108832,61484.5574731697,18,38,6,32,11,27,0,0,0,0,0,38,6,32,11,27,9,11.026541324267,11.5975606878069,0.3757660362472,2020-05-04,2020,5
"4146","MT",5,"Centro-oeste",51019,"Primavera do Leste",108832,61484.5574731697,19,46,8,38,22,24,0,0,0,0,0,46,8,38,22,24,7,11.026541324267,11.5975606878069,0.386877479569954,2020-05-11,2020,5
"4147","MT",5,"Centro-oeste",51019,"Primavera do Leste",108832,61484.5574731697,20,37,8,29,17,20,0,0,0,0,0,37,8,29,17,20,11,11.026541324267,11.5975606878069,0.405755990600189,2020-05-18,2020,5
"4148","MT",5,"Centro-oeste",51019,"Primavera do Leste",108832,61484.5574731697,21,48,10,38,22,26,0,0,0,0,0,48,10,38,22,26,5,11.026541324267,11.5975606878069,0.388843369362312,2020-05-25,2020,5
"4149","MT",5,"Centro-oeste",51020,"Tesouro",55885,27489.7268517491,5,11,2,9,6,5,0,0,0,0,0,11,2,9,6,5,2,10.2215676448331,10.9310512868197,0.375822894761106,2020-02-03,2020,2
"4150","MT",5,"Centro-oeste",51020,"Tesouro",55885,27489.7268517491,6,10,4,6,3,7,0,0,0,0,0,10,4,6,3,7,11,10.2215676448331,10.9310512868197,0.329744654916921,2020-02-10,2020,2
"4151","MT",5,"Centro-oeste",51020,"Tesouro",55885,27489.7268517491,7,14,6,8,7,7,0,0,0,0,0,14,6,8,7,7,8,10.2215676448331,10.9310512868197,0.342175021599042,2020-02-17,2020,2
"4152","MT",5,"Centro-oeste",51020,"Tesouro",55885,27489.7268517491,8,18,7,11,11,7,0,0,0,0,0,18,7,11,11,7,5,10.2215676448331,10.9310512868197,0.369091007397262,2020-02-24,2020,2
"4153","MT",5,"Centro-oeste",51020,"Tesouro",55885,27489.7268517491,9,13,4,9,3,10,0,0,0,0,0,13,4,9,3,10,14,10.2215676448331,10.9310512868197,0.320881229064953,2020-03-02,2020,3
"4154","MT",5,"Centro-oeste",51020,"Tesouro",55885,27489.7268517491,10,12,3,9,6,6,0,0,0,0,0,12,3,9,6,6,11,10.2215676448331,10.9310512868197,0.365257099225185,2020-03-09,2020,3
"4155","MT",5,"Centro-oeste",51020,"Tesouro",55885,27489.7268517491,11,13,3,10,5,8,0,0,0,0,0,13,3,10,5,8,3,10.2215676448331,10.9310512868197,0.403012612744989,2020-03-16,2020,3
"4156","MT",5,"Centro-oeste",51020,"Tesouro",55885,27489.7268517491,12,11,2,9,5,6,0,0,0,0,0,11,2,9,5,6,6,10.2215676448331,10.9310512868197,0.501564677160548,2020-03-23,2020,3
"4157","MT",5,"Centro-oeste",51020,"Tesouro",55885,27489.7268517491,13,10,3,7,4,6,0,0,0,0,0,10,3,7,4,6,5,10.2215676448331,10.9310512868197,0.446208900165892,2020-03-30,2020,3
"4158","MT",5,"Centro-oeste",51020,"Tesouro",55885,27489.7268517491,14,9,2,7,5,4,0,0,0,0,0,9,2,7,5,4,8,10.2215676448331,10.9310512868197,0.427365372413182,2020-04-06,2020,4
"4159","MT",5,"Centro-oeste",51020,"Tesouro",55885,27489.7268517491,15,16,4,12,8,8,0,0,0,0,0,16,4,12,8,8,10,10.2215676448331,10.9310512868197,0.391876626647589,2020-04-13,2020,4
"4160","MT",5,"Centro-oeste",51020,"Tesouro",55885,27489.7268517491,16,10,4,6,4,6,0,0,0,0,0,10,4,6,4,6,6,10.2215676448331,10.9310512868197,0.401447955144589,2020-04-20,2020,4
"4161","MT",5,"Centro-oeste",51020,"Tesouro",55885,27489.7268517491,17,9,3,6,3,6,0,0,0,0,0,9,3,6,3,6,6,10.2215676448331,10.9310512868197,0.413279324218263,2020-04-27,2020,4
"4162","MT",5,"Centro-oeste",51020,"Tesouro",55885,27489.7268517491,18,18,3,15,9,9,0,0,0,0,0,18,3,15,9,9,5,10.2215676448331,10.9310512868197,0.40462203072784,2020-05-04,2020,5
"4163","MT",5,"Centro-oeste",51020,"Tesouro",55885,27489.7268517491,19,7,1,6,2,5,0,0,0,0,0,7,1,6,2,5,8,10.2215676448331,10.9310512868197,0.453873947744905,2020-05-11,2020,5
"4164","MT",5,"Centro-oeste",51020,"Tesouro",55885,27489.7268517491,20,10,4,6,8,2,0,0,0,0,0,10,4,6,8,2,6,10.2215676448331,10.9310512868197,0.448503196614611,2020-05-18,2020,5
"4165","MT",5,"Centro-oeste",51020,"Tesouro",55885,27489.7268517491,21,10,3,7,2,8,1,0,1,0,1,11,3,8,2,9,4,10.2215676448331,10.9310512868197,0.437242947305917,2020-05-25,2020,5
"4166","MT",5,"Centro-oeste",51021,"Rondonópolis",323403,47207.8353683175,5,78,13,65,30,48,1,1,0,0,1,79,14,65,30,49,44,10.7623151613626,12.68665450252,0.303127228866236,2020-02-03,2020,2
"4167","MT",5,"Centro-oeste",51021,"Rondonópolis",323403,47207.8353683175,6,90,12,78,41,49,2,1,1,0,2,92,13,79,41,51,44,10.7623151613626,12.68665450252,0.304732992284515,2020-02-10,2020,2
"4168","MT",5,"Centro-oeste",51021,"Rondonópolis",323403,47207.8353683175,7,82,13,69,29,53,3,0,3,1,2,85,13,72,30,55,36,10.7623151613626,12.68665450252,0.31682956039867,2020-02-17,2020,2
"4169","MT",5,"Centro-oeste",51021,"Rondonópolis",323403,47207.8353683175,8,84,23,61,28,56,1,0,1,0,1,85,23,62,28,57,27,10.7623151613626,12.68665450252,0.353407693978982,2020-02-24,2020,2
"4170","MT",5,"Centro-oeste",51021,"Rondonópolis",323403,47207.8353683175,9,92,22,70,36,56,1,0,1,0,1,93,22,71,36,57,47,10.7623151613626,12.68665450252,0.333269501765047,2020-03-02,2020,3
"4171","MT",5,"Centro-oeste",51021,"Rondonópolis",323403,47207.8353683175,10,89,14,75,37,52,2,1,1,1,1,91,15,76,38,53,40,10.7623151613626,12.68665450252,0.348622430747171,2020-03-09,2020,3
"4172","MT",5,"Centro-oeste",51021,"Rondonópolis",323403,47207.8353683175,11,88,16,72,34,54,2,0,2,0,2,90,16,74,34,56,40,10.7623151613626,12.68665450252,0.417293597688957,2020-03-16,2020,3
"4173","MT",5,"Centro-oeste",51021,"Rondonópolis",323403,47207.8353683175,12,92,20,72,41,51,0,0,0,0,0,92,20,72,41,51,36,10.7623151613626,12.68665450252,0.521740114351454,2020-03-23,2020,3
"4174","MT",5,"Centro-oeste",51021,"Rondonópolis",323403,47207.8353683175,13,88,18,70,31,57,1,0,1,0,1,89,18,71,31,58,35,10.7623151613626,12.68665450252,0.459661188496238,2020-03-30,2020,3
"4175","MT",5,"Centro-oeste",51021,"Rondonópolis",323403,47207.8353683175,14,92,21,71,46,46,0,0,0,0,0,92,21,71,46,46,28,10.7623151613626,12.68665450252,0.435699391498548,2020-04-06,2020,4
"4176","MT",5,"Centro-oeste",51021,"Rondonópolis",323403,47207.8353683175,15,79,15,64,32,47,1,0,1,0,1,80,15,65,32,48,30,10.7623151613626,12.68665450252,0.41703263012773,2020-04-13,2020,4
"4177","MT",5,"Centro-oeste",51021,"Rondonópolis",323403,47207.8353683175,16,92,20,72,40,52,0,0,0,0,0,92,20,72,40,52,28,10.7623151613626,12.68665450252,0.416548956170735,2020-04-20,2020,4
"4178","MT",5,"Centro-oeste",51021,"Rondonópolis",323403,47207.8353683175,17,91,18,73,29,62,0,0,0,0,0,91,18,73,29,62,27,10.7623151613626,12.68665450252,0.41096409399512,2020-04-27,2020,4
"4179","MT",5,"Centro-oeste",51021,"Rondonópolis",323403,47207.8353683175,18,102,10,92,39,63,1,1,0,0,1,103,11,92,39,64,31,10.7623151613626,12.68665450252,0.387134738194875,2020-05-04,2020,5
"4180","MT",5,"Centro-oeste",51021,"Rondonópolis",323403,47207.8353683175,19,85,20,65,29,56,0,0,0,0,0,85,20,65,29,56,34,10.7623151613626,12.68665450252,0.389752733795826,2020-05-11,2020,5
"4181","MT",5,"Centro-oeste",51021,"Rondonópolis",323403,47207.8353683175,20,107,12,95,38,69,0,0,0,0,0,107,12,95,38,69,24,10.7623151613626,12.68665450252,0.397375402050831,2020-05-18,2020,5
"4182","MT",5,"Centro-oeste",51021,"Rondonópolis",323403,47207.8353683175,21,103,21,82,39,64,2,0,2,2,0,105,21,84,41,64,47,10.7623151613626,12.68665450252,0.385844979861082,2020-05-25,2020,5
"4183","MT",5,"Centro-oeste",51022,"Alto Araguaia",42669,56582.5282875155,5,6,2,4,2,4,0,0,0,0,0,6,2,4,2,4,4,10.9434555290378,10.6612279402383,0.262231751984371,2020-02-03,2020,2
"4184","MT",5,"Centro-oeste",51022,"Alto Araguaia",42669,56582.5282875155,6,5,2,3,5,0,0,0,0,0,0,5,2,3,5,0,3,10.9434555290378,10.6612279402383,0.260531951420835,2020-02-10,2020,2
"4185","MT",5,"Centro-oeste",51022,"Alto Araguaia",42669,56582.5282875155,7,5,0,5,2,3,0,0,0,0,0,5,0,5,2,3,6,10.9434555290378,10.6612279402383,0.275427922241516,2020-02-17,2020,2
"4186","MT",5,"Centro-oeste",51022,"Alto Araguaia",42669,56582.5282875155,8,9,1,8,5,4,0,0,0,0,0,9,1,8,5,4,2,10.9434555290378,10.6612279402383,0.307680716214978,2020-02-24,2020,2
"4187","MT",5,"Centro-oeste",51022,"Alto Araguaia",42669,56582.5282875155,9,12,3,9,4,8,0,0,0,0,0,12,3,9,4,8,4,10.9434555290378,10.6612279402383,0.300603609257628,2020-03-02,2020,3
"4188","MT",5,"Centro-oeste",51022,"Alto Araguaia",42669,56582.5282875155,10,8,2,6,1,7,0,0,0,0,0,8,2,6,1,7,4,10.9434555290378,10.6612279402383,0.314625365294464,2020-03-09,2020,3
"4189","MT",5,"Centro-oeste",51022,"Alto Araguaia",42669,56582.5282875155,11,10,3,7,4,6,0,0,0,0,0,10,3,7,4,6,2,10.9434555290378,10.6612279402383,0.360535769182791,2020-03-16,2020,3
"4190","MT",5,"Centro-oeste",51022,"Alto Araguaia",42669,56582.5282875155,12,10,3,7,6,4,1,0,1,1,0,11,3,8,7,4,8,10.9434555290378,10.6612279402383,0.40773648209688,2020-03-23,2020,3
"4191","MT",5,"Centro-oeste",51022,"Alto Araguaia",42669,56582.5282875155,13,10,1,9,4,6,0,0,0,0,0,10,1,9,4,6,11,10.9434555290378,10.6612279402383,0.364152383917388,2020-03-30,2020,3
"4192","MT",5,"Centro-oeste",51022,"Alto Araguaia",42669,56582.5282875155,14,11,3,8,2,9,0,0,0,0,0,11,3,8,2,9,2,10.9434555290378,10.6612279402383,0.370997832350965,2020-04-06,2020,4
"4193","MT",5,"Centro-oeste",51022,"Alto Araguaia",42669,56582.5282875155,15,7,0,7,6,1,0,0,0,0,0,7,0,7,6,1,5,10.9434555290378,10.6612279402383,0.349233161919236,2020-04-13,2020,4
"4194","MT",5,"Centro-oeste",51022,"Alto Araguaia",42669,56582.5282875155,16,11,1,10,7,4,0,0,0,0,0,11,1,10,7,4,5,10.9434555290378,10.6612279402383,0.358311289963351,2020-04-20,2020,4
"4195","MT",5,"Centro-oeste",51022,"Alto Araguaia",42669,56582.5282875155,17,6,2,4,3,3,0,0,0,0,0,6,2,4,3,3,3,10.9434555290378,10.6612279402383,0.363152761341196,2020-04-27,2020,4
"4196","MT",5,"Centro-oeste",51022,"Alto Araguaia",42669,56582.5282875155,18,5,0,5,4,1,0,0,0,0,0,5,0,5,4,1,5,10.9434555290378,10.6612279402383,0.339795529031835,2020-05-04,2020,5
"4197","MT",5,"Centro-oeste",51022,"Alto Araguaia",42669,56582.5282875155,19,10,2,8,7,3,0,0,0,0,0,10,2,8,7,3,3,10.9434555290378,10.6612279402383,0.344649122454163,2020-05-11,2020,5
"4198","MT",5,"Centro-oeste",51022,"Alto Araguaia",42669,56582.5282875155,20,7,3,4,2,5,0,0,0,0,0,7,3,4,2,5,3,10.9434555290378,10.6612279402383,0.363390551683654,2020-05-18,2020,5
"4199","MT",5,"Centro-oeste",51022,"Alto Araguaia",42669,56582.5282875155,21,13,1,12,6,7,0,0,0,0,0,13,1,12,6,7,3,10.9434555290378,10.6612279402383,0.339258647498789,2020-05-25,2020,5
"4200","PA",1,"Norte",15001,"Óbidos",211269,18545.8835548045,5,74,34,40,47,27,1,1,0,0,1,75,35,40,47,28,13,9.82800313261753,12.2608874820034,0.259780342953896,2020-02-03,2020,2
"4201","PA",1,"Norte",15001,"Óbidos",211269,18545.8835548045,6,70,27,43,36,34,2,1,1,0,2,72,28,44,36,36,17,9.82800313261753,12.2608874820034,0.254256945791683,2020-02-10,2020,2
"4202","PA",1,"Norte",15001,"Óbidos",211269,18545.8835548045,7,79,33,46,39,40,0,0,0,0,0,79,33,46,39,40,14,9.82800313261753,12.2608874820034,0.268212369252272,2020-02-17,2020,2
"4203","PA",1,"Norte",15001,"Óbidos",211269,18545.8835548045,8,82,40,42,52,30,3,2,1,1,2,85,42,43,53,32,18,9.82800313261753,12.2608874820034,0.310319883015375,2020-02-24,2020,2
"4204","PA",1,"Norte",15001,"Óbidos",211269,18545.8835548045,9,77,36,41,39,38,2,1,1,2,0,79,37,42,41,38,11,9.82800313261753,12.2608874820034,0.276778542436401,2020-03-02,2020,3
"4205","PA",1,"Norte",15001,"Óbidos",211269,18545.8835548045,10,72,34,38,37,35,1,0,1,1,0,73,34,39,38,35,17,9.82800313261753,12.2608874820034,0.295360982358632,2020-03-09,2020,3
"4206","PA",1,"Norte",15001,"Óbidos",211269,18545.8835548045,11,72,29,43,40,32,1,0,1,0,1,73,29,44,40,33,17,9.82800313261753,12.2608874820034,0.343752880838018,2020-03-16,2020,3
"4207","PA",1,"Norte",15001,"Óbidos",211269,18545.8835548045,12,67,26,41,37,30,0,0,0,0,0,67,26,41,37,30,18,9.82800313261753,12.2608874820034,0.402908289280851,2020-03-23,2020,3
"4208","PA",1,"Norte",15001,"Óbidos",211269,18545.8835548045,13,62,27,35,32,30,1,1,0,0,1,63,28,35,32,31,15,9.82800313261753,12.2608874820034,0.396671993129792,2020-03-30,2020,3
"4209","PA",1,"Norte",15001,"Óbidos",211269,18545.8835548045,14,71,24,47,38,33,0,0,0,0,0,71,24,47,38,33,9,9.82800313261753,12.2608874820034,0.402234271776925,2020-04-06,2020,4
"4210","PA",1,"Norte",15001,"Óbidos",211269,18545.8835548045,15,63,22,41,37,26,2,0,2,0,2,65,22,43,37,28,18,9.82800313261753,12.2608874820034,0.389872803336376,2020-04-13,2020,4
"4211","PA",1,"Norte",15001,"Óbidos",211269,18545.8835548045,16,61,26,35,37,24,1,0,1,0,1,62,26,36,37,25,14,9.82800313261753,12.2608874820034,0.406622045625342,2020-04-20,2020,4
"4212","PA",1,"Norte",15001,"Óbidos",211269,18545.8835548045,17,57,17,40,32,25,1,0,1,1,0,58,17,41,33,25,14,9.82800313261753,12.2608874820034,0.380968312154841,2020-04-27,2020,4
"4213","PA",1,"Norte",15001,"Óbidos",211269,18545.8835548045,18,88,33,55,48,40,1,0,1,1,0,89,33,56,49,40,19,9.82800313261753,12.2608874820034,0.384077160560581,2020-05-04,2020,5
"4214","PA",1,"Norte",15001,"Óbidos",211269,18545.8835548045,19,91,29,62,44,47,0,0,0,0,0,91,29,62,44,47,25,9.82800313261753,12.2608874820034,0.397808023568877,2020-05-11,2020,5
"4215","PA",1,"Norte",15001,"Óbidos",211269,18545.8835548045,20,93,43,50,57,36,0,0,0,0,0,93,43,50,57,36,37,9.82800313261753,12.2608874820034,0.402782501471944,2020-05-18,2020,5
"4216","PA",1,"Norte",15001,"Óbidos",211269,18545.8835548045,21,77,30,47,43,34,2,0,2,0,2,79,30,49,43,36,39,9.82800313261753,12.2608874820034,0.406596906700032,2020-05-25,2020,5
"4217","PA",1,"Norte",15002,"Santarém",531849,13550.3259769784,5,196,61,135,83,113,0,0,0,0,0,196,61,135,83,113,59,9.51416588336006,13.1841148934487,0.272763395185938,2020-02-03,2020,2
"4218","PA",1,"Norte",15002,"Santarém",531849,13550.3259769784,6,206,62,144,97,109,0,0,0,0,0,206,62,144,97,109,44,9.51416588336006,13.1841148934487,0.265935518356589,2020-02-10,2020,2
"4219","PA",1,"Norte",15002,"Santarém",531849,13550.3259769784,7,204,67,137,96,108,2,1,1,0,2,206,68,138,96,110,42,9.51416588336006,13.1841148934487,0.288832029556662,2020-02-17,2020,2
"4220","PA",1,"Norte",15002,"Santarém",531849,13550.3259769784,8,220,79,141,103,117,3,1,2,2,1,223,80,143,105,118,54,9.51416588336006,13.1841148934487,0.320655353398107,2020-02-24,2020,2
"4221","PA",1,"Norte",15002,"Santarém",531849,13550.3259769784,9,174,73,101,70,104,1,1,0,1,0,175,74,101,71,104,60,9.51416588336006,13.1841148934487,0.306551985979557,2020-03-02,2020,3
"4222","PA",1,"Norte",15002,"Santarém",531849,13550.3259769784,10,177,58,119,72,105,1,0,1,0,1,178,58,120,72,106,47,9.51416588336006,13.1841148934487,0.323483949887717,2020-03-09,2020,3
"4223","PA",1,"Norte",15002,"Santarém",531849,13550.3259769784,11,209,70,139,96,113,3,2,1,3,0,212,72,140,99,113,51,9.51416588336006,13.1841148934487,0.36695796544498,2020-03-16,2020,3
"4224","PA",1,"Norte",15002,"Santarém",531849,13550.3259769784,12,149,45,104,68,81,1,1,0,0,1,150,46,104,68,82,51,9.51416588336006,13.1841148934487,0.44170942778829,2020-03-23,2020,3
"4225","PA",1,"Norte",15002,"Santarém",531849,13550.3259769784,13,139,45,94,65,74,1,0,1,1,0,140,45,95,66,74,42,9.51416588336006,13.1841148934487,0.420568615110647,2020-03-30,2020,3
"4226","PA",1,"Norte",15002,"Santarém",531849,13550.3259769784,14,151,54,97,84,67,1,0,1,0,1,152,54,98,84,68,44,9.51416588336006,13.1841148934487,0.426392071762207,2020-04-06,2020,4
"4227","PA",1,"Norte",15002,"Santarém",531849,13550.3259769784,15,151,48,103,62,89,1,0,1,0,1,152,48,104,62,90,55,9.51416588336006,13.1841148934487,0.41655780207191,2020-04-13,2020,4
"4228","PA",1,"Norte",15002,"Santarém",531849,13550.3259769784,16,173,53,120,94,79,2,1,1,1,1,175,54,121,95,80,56,9.51416588336006,13.1841148934487,0.418357043293596,2020-04-20,2020,4
"4229","PA",1,"Norte",15002,"Santarém",531849,13550.3259769784,17,195,72,123,101,94,0,0,0,0,0,195,72,123,101,94,71,9.51416588336006,13.1841148934487,0.410071066479873,2020-04-27,2020,4
"4230","PA",1,"Norte",15002,"Santarém",531849,13550.3259769784,18,178,57,121,85,93,0,0,0,0,0,178,57,121,85,93,63,9.51416588336006,13.1841148934487,0.405897435985908,2020-05-04,2020,5
"4231","PA",1,"Norte",15002,"Santarém",531849,13550.3259769784,19,179,56,123,88,91,2,1,1,1,1,181,57,124,89,92,104,9.51416588336006,13.1841148934487,0.431773737610534,2020-05-11,2020,5
"4232","PA",1,"Norte",15002,"Santarém",531849,13550.3259769784,20,178,67,111,93,85,1,1,0,1,0,179,68,111,94,85,122,9.51416588336006,13.1841148934487,0.471150975847117,2020-05-18,2020,5
"4233","PA",1,"Norte",15002,"Santarém",531849,13550.3259769784,21,186,53,133,90,96,0,0,0,0,0,186,53,133,90,96,140,9.51416588336006,13.1841148934487,0.446804487842422,2020-05-25,2020,5
"4234","PA",1,"Norte",15003,"Almeirim",75877,12001.9738698156,5,24,16,8,17,7,2,2,0,0,2,26,18,8,17,9,2,9.39282640439458,11.2368688871577,0.283615180469529,2020-02-03,2020,2
"4235","PA",1,"Norte",15003,"Almeirim",75877,12001.9738698156,6,34,17,17,20,14,0,0,0,0,0,34,17,17,20,14,5,9.39282640439458,11.2368688871577,0.294466813313105,2020-02-10,2020,2
"4236","PA",1,"Norte",15003,"Almeirim",75877,12001.9738698156,7,28,16,12,17,11,0,0,0,0,0,28,16,12,17,11,7,9.39282640439458,11.2368688871577,0.297816189293302,2020-02-17,2020,2
"4237","PA",1,"Norte",15003,"Almeirim",75877,12001.9738698156,8,26,12,14,14,12,0,0,0,0,0,26,12,14,14,12,7,9.39282640439458,11.2368688871577,0.318427370205229,2020-02-24,2020,2
"4238","PA",1,"Norte",15003,"Almeirim",75877,12001.9738698156,9,38,26,12,21,17,0,0,0,0,0,38,26,12,21,17,3,9.39282640439458,11.2368688871577,0.310767384067599,2020-03-02,2020,3
"4239","PA",1,"Norte",15003,"Almeirim",75877,12001.9738698156,10,22,10,12,12,10,0,0,0,0,0,22,10,12,12,10,2,9.39282640439458,11.2368688871577,0.331552149022376,2020-03-09,2020,3
"4240","PA",1,"Norte",15003,"Almeirim",75877,12001.9738698156,11,26,16,10,16,10,0,0,0,0,0,26,16,10,16,10,4,9.39282640439458,11.2368688871577,0.349791451564334,2020-03-16,2020,3
"4241","PA",1,"Norte",15003,"Almeirim",75877,12001.9738698156,12,26,15,11,13,13,0,0,0,0,0,26,15,11,13,13,4,9.39282640439458,11.2368688871577,0.40031083347468,2020-03-23,2020,3
"4242","PA",1,"Norte",15003,"Almeirim",75877,12001.9738698156,13,11,7,4,9,2,0,0,0,0,0,11,7,4,9,2,5,9.39282640439458,11.2368688871577,0.397882714311415,2020-03-30,2020,3
"4243","PA",1,"Norte",15003,"Almeirim",75877,12001.9738698156,14,22,9,13,12,10,0,0,0,0,0,22,9,13,12,10,7,9.39282640439458,11.2368688871577,0.415801815048373,2020-04-06,2020,4
"4244","PA",1,"Norte",15003,"Almeirim",75877,12001.9738698156,15,18,11,7,13,5,0,0,0,0,0,18,11,7,13,5,4,9.39282640439458,11.2368688871577,0.394407334481847,2020-04-13,2020,4
"4245","PA",1,"Norte",15003,"Almeirim",75877,12001.9738698156,16,22,12,10,11,11,0,0,0,0,0,22,12,10,11,11,7,9.39282640439458,11.2368688871577,0.420499368021467,2020-04-20,2020,4
"4246","PA",1,"Norte",15003,"Almeirim",75877,12001.9738698156,17,27,16,11,17,10,0,0,0,0,0,27,16,11,17,10,9,9.39282640439458,11.2368688871577,0.441235109852963,2020-04-27,2020,4
"4247","PA",1,"Norte",15003,"Almeirim",75877,12001.9738698156,18,24,16,8,18,6,0,0,0,0,0,24,16,8,18,6,6,9.39282640439458,11.2368688871577,0.446624059557288,2020-05-04,2020,5
"4248","PA",1,"Norte",15003,"Almeirim",75877,12001.9738698156,19,27,17,10,19,8,1,1,0,1,0,28,18,10,20,8,11,9.39282640439458,11.2368688871577,0.499253375420974,2020-05-11,2020,5
"4249","PA",1,"Norte",15003,"Almeirim",75877,12001.9738698156,20,13,5,8,8,5,0,0,0,0,0,13,5,8,8,5,17,9.39282640439458,11.2368688871577,0.49323920645323,2020-05-18,2020,5
"4250","PA",1,"Norte",15003,"Almeirim",75877,12001.9738698156,21,30,21,9,17,13,0,0,0,0,0,30,21,9,17,13,7,9.39282640439458,11.2368688871577,0.446398884628286,2020-05-25,2020,5
"4251","PA",1,"Norte",15004,"Portel",155915,10226.9846858865,5,59,43,16,26,33,2,1,1,0,2,61,44,17,26,35,6,9.23278506338498,11.9570662659402,0.299337543643359,2020-02-03,2020,2
"4252","PA",1,"Norte",15004,"Portel",155915,10226.9846858865,6,51,33,18,31,20,1,1,0,0,1,52,34,18,31,21,5,9.23278506338498,11.9570662659402,0.312228771332483,2020-02-10,2020,2
"4253","PA",1,"Norte",15004,"Portel",155915,10226.9846858865,7,67,45,22,29,38,0,0,0,0,0,67,45,22,29,38,6,9.23278506338498,11.9570662659402,0.290626079470007,2020-02-17,2020,2
"4254","PA",1,"Norte",15004,"Portel",155915,10226.9846858865,8,55,40,15,28,27,0,0,0,0,0,55,40,15,28,27,6,9.23278506338498,11.9570662659402,0.344921109607496,2020-02-24,2020,2
"4255","PA",1,"Norte",15004,"Portel",155915,10226.9846858865,9,52,32,20,33,19,0,0,0,0,0,52,32,20,33,19,8,9.23278506338498,11.9570662659402,0.317282503839022,2020-03-02,2020,3
"4256","PA",1,"Norte",15004,"Portel",155915,10226.9846858865,10,52,37,15,27,25,2,1,1,1,1,54,38,16,28,26,6,9.23278506338498,11.9570662659402,0.349668144984492,2020-03-09,2020,3
"4257","PA",1,"Norte",15004,"Portel",155915,10226.9846858865,11,61,45,16,34,27,2,2,0,1,1,63,47,16,35,28,9,9.23278506338498,11.9570662659402,0.39052903253489,2020-03-16,2020,3
"4258","PA",1,"Norte",15004,"Portel",155915,10226.9846858865,12,53,43,10,30,23,0,0,0,0,0,53,43,10,30,23,7,9.23278506338498,11.9570662659402,0.521269784712422,2020-03-23,2020,3
"4259","PA",1,"Norte",15004,"Portel",155915,10226.9846858865,13,42,32,10,25,17,0,0,0,0,0,42,32,10,25,17,10,9.23278506338498,11.9570662659402,0.459008330103387,2020-03-30,2020,3
"4260","PA",1,"Norte",15004,"Portel",155915,10226.9846858865,14,63,44,19,32,31,1,1,0,1,0,64,45,19,33,31,8,9.23278506338498,11.9570662659402,0.4547086304938,2020-04-06,2020,4
"4261","PA",1,"Norte",15004,"Portel",155915,10226.9846858865,15,67,51,16,38,29,2,2,0,0,2,69,53,16,38,31,8,9.23278506338498,11.9570662659402,0.451873101455388,2020-04-13,2020,4
"4262","PA",1,"Norte",15004,"Portel",155915,10226.9846858865,16,56,39,17,33,23,0,0,0,0,0,56,39,17,33,23,5,9.23278506338498,11.9570662659402,0.456225652276865,2020-04-20,2020,4
"4263","PA",1,"Norte",15004,"Portel",155915,10226.9846858865,17,35,25,10,14,21,4,3,1,3,1,39,28,11,17,22,4,9.23278506338498,11.9570662659402,0.455371915845433,2020-04-27,2020,4
"4264","PA",1,"Norte",15004,"Portel",155915,10226.9846858865,18,47,36,11,34,13,1,0,1,0,1,48,36,12,34,14,18,9.23278506338498,11.9570662659402,0.53409554135516,2020-05-04,2020,5
"4265","PA",1,"Norte",15004,"Portel",155915,10226.9846858865,19,62,37,25,39,23,2,2,0,1,1,64,39,25,40,24,15,9.23278506338498,11.9570662659402,0.616107117625957,2020-05-11,2020,5
"4266","PA",1,"Norte",15004,"Portel",155915,10226.9846858865,20,50,36,14,25,25,2,1,1,1,1,52,37,15,26,26,23,9.23278506338498,11.9570662659402,0.604668447035497,2020-05-18,2020,5
"4267","PA",1,"Norte",15004,"Portel",155915,10226.9846858865,21,49,34,15,29,20,0,0,0,0,0,49,34,15,29,20,15,9.23278506338498,11.9570662659402,0.555035685463268,2020-05-25,2020,5
"4268","PA",1,"Norte",15005,"Furos de Breves",234720,9069.95269061009,5,114,80,34,59,55,1,1,0,1,0,115,81,34,60,55,11,9.11272232706582,12.3661485933768,0.295714255365143,2020-02-03,2020,2
"4269","PA",1,"Norte",15005,"Furos de Breves",234720,9069.95269061009,6,110,71,39,55,55,0,0,0,0,0,110,71,39,55,55,12,9.11272232706582,12.3661485933768,0.293774306924279,2020-02-10,2020,2
"4270","PA",1,"Norte",15005,"Furos de Breves",234720,9069.95269061009,7,110,76,34,59,51,0,0,0,0,0,110,76,34,59,51,12,9.11272232706582,12.3661485933768,0.312762824247341,2020-02-17,2020,2
"4271","PA",1,"Norte",15005,"Furos de Breves",234720,9069.95269061009,8,116,83,33,70,46,1,1,0,0,1,117,84,33,70,47,11,9.11272232706582,12.3661485933768,0.340403004235113,2020-02-24,2020,2
"4272","PA",1,"Norte",15005,"Furos de Breves",234720,9069.95269061009,9,117,74,43,63,54,0,0,0,0,0,117,74,43,63,54,11,9.11272232706582,12.3661485933768,0.346954025752919,2020-03-02,2020,3
"4273","PA",1,"Norte",15005,"Furos de Breves",234720,9069.95269061009,10,110,71,39,54,56,0,0,0,0,0,110,71,39,54,56,14,9.11272232706582,12.3661485933768,0.351758715382656,2020-03-09,2020,3
"4274","PA",1,"Norte",15005,"Furos de Breves",234720,9069.95269061009,11,115,78,37,57,58,3,2,1,3,0,118,80,38,60,58,10,9.11272232706582,12.3661485933768,0.395679520975397,2020-03-16,2020,3
"4275","PA",1,"Norte",15005,"Furos de Breves",234720,9069.95269061009,12,76,49,27,42,34,1,0,1,1,0,77,49,28,43,34,14,9.11272232706582,12.3661485933768,0.468484248814425,2020-03-23,2020,3
"4276","PA",1,"Norte",15005,"Furos de Breves",234720,9069.95269061009,13,68,44,24,39,29,1,0,1,1,0,69,44,25,40,29,14,9.11272232706582,12.3661485933768,0.441544291196491,2020-03-30,2020,3
"4277","PA",1,"Norte",15005,"Furos de Breves",234720,9069.95269061009,14,93,56,37,51,42,2,2,0,1,1,95,58,37,52,43,9,9.11272232706582,12.3661485933768,0.460528282474949,2020-04-06,2020,4
"4278","PA",1,"Norte",15005,"Furos de Breves",234720,9069.95269061009,15,98,64,34,57,41,2,1,1,1,1,100,65,35,58,42,13,9.11272232706582,12.3661485933768,0.459304485179392,2020-04-13,2020,4
"4279","PA",1,"Norte",15005,"Furos de Breves",234720,9069.95269061009,16,90,62,28,58,32,0,0,0,0,0,90,62,28,58,32,13,9.11272232706582,12.3661485933768,0.496970414567901,2020-04-20,2020,4
"4280","PA",1,"Norte",15005,"Furos de Breves",234720,9069.95269061009,17,82,54,28,37,45,1,0,1,0,1,83,54,29,37,46,26,9.11272232706582,12.3661485933768,0.527332863677163,2020-04-27,2020,4
"4281","PA",1,"Norte",15005,"Furos de Breves",234720,9069.95269061009,18,80,53,27,47,33,1,0,1,0,1,81,53,28,47,34,38,9.11272232706582,12.3661485933768,0.559386478092457,2020-05-04,2020,5
"4282","PA",1,"Norte",15005,"Furos de Breves",234720,9069.95269061009,19,83,57,26,50,33,0,0,0,0,0,83,57,26,50,33,26,9.11272232706582,12.3661485933768,0.565989353063515,2020-05-11,2020,5
"4283","PA",1,"Norte",15005,"Furos de Breves",234720,9069.95269061009,20,83,57,26,44,39,3,2,1,3,0,86,59,27,47,39,28,9.11272232706582,12.3661485933768,0.548391732315612,2020-05-18,2020,5
"4284","PA",1,"Norte",15005,"Furos de Breves",234720,9069.95269061009,21,94,59,35,52,42,0,0,0,0,0,94,59,35,52,42,23,9.11272232706582,12.3661485933768,0.512145480164529,2020-05-25,2020,5
"4285","PA",1,"Norte",15006,"Arari",180421,7232.51613232384,5,49,26,23,28,21,0,0,0,0,0,49,26,23,28,21,10,8.88634226737996,12.103048287818,0.303356219290091,2020-02-03,2020,2
"4286","PA",1,"Norte",15006,"Arari",180421,7232.51613232384,6,58,29,29,30,28,1,1,0,0,1,59,30,29,30,29,7,8.88634226737996,12.103048287818,0.29190734136652,2020-02-10,2020,2
"4287","PA",1,"Norte",15006,"Arari",180421,7232.51613232384,7,46,25,21,33,13,0,0,0,0,0,46,25,21,33,13,7,8.88634226737996,12.103048287818,0.310306380184186,2020-02-17,2020,2
"4288","PA",1,"Norte",15006,"Arari",180421,7232.51613232384,8,46,22,24,29,17,1,1,0,1,0,47,23,24,30,17,10,8.88634226737996,12.103048287818,0.338195257700654,2020-02-24,2020,2
"4289","PA",1,"Norte",15006,"Arari",180421,7232.51613232384,9,43,23,20,26,17,0,0,0,0,0,43,23,20,26,17,12,8.88634226737996,12.103048287818,0.323062735979316,2020-03-02,2020,3
"4290","PA",1,"Norte",15006,"Arari",180421,7232.51613232384,10,39,28,11,19,20,0,0,0,0,0,39,28,11,19,20,19,8.88634226737996,12.103048287818,0.360065309232116,2020-03-09,2020,3
"4291","PA",1,"Norte",15006,"Arari",180421,7232.51613232384,11,46,28,18,29,17,2,0,2,1,1,48,28,20,30,18,13,8.88634226737996,12.103048287818,0.397587435464849,2020-03-16,2020,3
"4292","PA",1,"Norte",15006,"Arari",180421,7232.51613232384,12,53,25,28,29,24,0,0,0,0,0,53,25,28,29,24,18,8.88634226737996,12.103048287818,0.478046318888373,2020-03-23,2020,3
"4293","PA",1,"Norte",15006,"Arari",180421,7232.51613232384,13,40,24,16,22,18,0,0,0,0,0,40,24,16,22,18,8,8.88634226737996,12.103048287818,0.438577853571928,2020-03-30,2020,3
"4294","PA",1,"Norte",15006,"Arari",180421,7232.51613232384,14,38,19,19,22,16,0,0,0,0,0,38,19,19,22,16,13,8.88634226737996,12.103048287818,0.44628702423404,2020-04-06,2020,4
"4295","PA",1,"Norte",15006,"Arari",180421,7232.51613232384,15,37,18,19,27,10,2,2,0,1,1,39,20,19,28,11,8,8.88634226737996,12.103048287818,0.454158099254789,2020-04-13,2020,4
"4296","PA",1,"Norte",15006,"Arari",180421,7232.51613232384,16,36,22,14,18,18,0,0,0,0,0,36,22,14,18,18,14,8.88634226737996,12.103048287818,0.469323628517557,2020-04-20,2020,4
"4297","PA",1,"Norte",15006,"Arari",180421,7232.51613232384,17,48,17,31,24,24,2,1,1,2,0,50,18,32,26,24,27,8.88634226737996,12.103048287818,0.474394645880616,2020-04-27,2020,4
"4298","PA",1,"Norte",15006,"Arari",180421,7232.51613232384,18,50,35,15,27,23,0,0,0,0,0,50,35,15,27,23,25,8.88634226737996,12.103048287818,0.499564063071959,2020-05-04,2020,5
"4299","PA",1,"Norte",15006,"Arari",180421,7232.51613232384,19,39,24,15,25,14,0,0,0,0,0,39,24,15,25,14,24,8.88634226737996,12.103048287818,0.517555617715016,2020-05-11,2020,5
"4300","PA",1,"Norte",15006,"Arari",180421,7232.51613232384,20,37,17,20,22,15,0,0,0,0,0,37,17,20,22,15,25,8.88634226737996,12.103048287818,0.499506374496373,2020-05-18,2020,5
"4301","PA",1,"Norte",15006,"Arari",180421,7232.51613232384,21,43,26,17,28,15,0,0,0,0,0,43,26,17,28,15,18,8.88634226737996,12.103048287818,0.450332342638107,2020-05-25,2020,5
"4302","PA",1,"Norte",15007,"Belém",2381117,20223.6760531843,5,484,119,365,202,282,9,1,8,4,5,493,120,373,206,287,293,9.91460927887844,14.6830802632789,0.288331106923667,2020-02-03,2020,2
"4303","PA",1,"Norte",15007,"Belém",2381117,20223.6760531843,6,476,113,363,182,294,5,1,4,0,5,481,114,367,182,299,232,9.91460927887844,14.6830802632789,0.283623462203439,2020-02-10,2020,2
"4304","PA",1,"Norte",15007,"Belém",2381117,20223.6760531843,7,447,99,348,192,255,5,4,1,2,3,452,103,349,194,258,275,9.91460927887844,14.6830802632789,0.302764367516087,2020-02-17,2020,2
"4305","PA",1,"Norte",15007,"Belém",2381117,20223.6760531843,8,510,132,378,226,284,5,2,3,3,2,515,134,381,229,286,281,9.91460927887844,14.6830802632789,0.357291712863936,2020-02-24,2020,2
"4306","PA",1,"Norte",15007,"Belém",2381117,20223.6760531843,9,492,115,377,214,278,6,1,5,1,5,498,116,382,215,283,320,9.91460927887844,14.6830802632789,0.333060323454978,2020-03-02,2020,3
"4307","PA",1,"Norte",15007,"Belém",2381117,20223.6760531843,10,472,115,357,203,269,8,4,4,4,4,480,119,361,207,273,308,9.91460927887844,14.6830802632789,0.353564981394569,2020-03-09,2020,3
"4308","PA",1,"Norte",15007,"Belém",2381117,20223.6760531843,11,442,114,328,191,251,9,2,7,2,7,451,116,335,193,258,357,9.91460927887844,14.6830802632789,0.404704752860428,2020-03-16,2020,3
"4309","PA",1,"Norte",15007,"Belém",2381117,20223.6760531843,12,396,92,304,159,237,4,2,2,4,0,400,94,306,163,237,317,9.91460927887844,14.6830802632789,0.50902373630267,2020-03-23,2020,3
"4310","PA",1,"Norte",15007,"Belém",2381117,20223.6760531843,13,364,93,271,146,218,3,1,2,3,0,367,94,273,149,218,291,9.91460927887844,14.6830802632789,0.478361479873896,2020-03-30,2020,3
"4311","PA",1,"Norte",15007,"Belém",2381117,20223.6760531843,14,388,111,277,178,210,4,1,3,2,2,392,112,280,180,212,296,9.91460927887844,14.6830802632789,0.488035628857503,2020-04-06,2020,4
"4312","PA",1,"Norte",15007,"Belém",2381117,20223.6760531843,15,415,108,307,204,211,6,2,4,5,1,421,110,311,209,212,524,9.91460927887844,14.6830802632789,0.494241542067466,2020-04-13,2020,4
"4313","PA",1,"Norte",15007,"Belém",2381117,20223.6760531843,16,414,105,309,198,216,5,3,2,3,2,419,108,311,201,218,1084,9.91460927887844,14.6830802632789,0.517538125398556,2020-04-20,2020,4
"4314","PA",1,"Norte",15007,"Belém",2381117,20223.6760531843,17,426,105,321,182,244,4,2,2,3,1,430,107,323,185,245,1441,9.91460927887844,14.6830802632789,0.519040108437711,2020-04-27,2020,4
"4315","PA",1,"Norte",15007,"Belém",2381117,20223.6760531843,18,396,105,291,189,207,4,3,1,2,2,400,108,292,191,209,1157,9.91460927887844,14.6830802632789,0.510210750784978,2020-05-04,2020,5
"4316","PA",1,"Norte",15007,"Belém",2381117,20223.6760531843,19,464,115,349,191,273,6,4,2,4,2,470,119,351,195,275,850,9.91460927887844,14.6830802632789,0.538454000849035,2020-05-11,2020,5
"4317","PA",1,"Norte",15007,"Belém",2381117,20223.6760531843,20,466,113,353,201,265,4,1,3,2,2,470,114,356,203,267,604,9.91460927887844,14.6830802632789,0.501909452491362,2020-05-18,2020,5
"4318","PA",1,"Norte",15007,"Belém",2381117,20223.6760531843,21,450,99,351,194,256,5,2,3,1,4,455,101,354,195,260,401,9.91460927887844,14.6830802632789,0.443645644319829,2020-05-25,2020,5
"4319","PA",1,"Norte",15008,"Castanhal",348294,16537.6927737199,5,99,23,76,49,50,2,1,1,0,2,101,24,77,49,52,31,9.71339746511838,12.7608022296769,0.2934602657814,2020-02-03,2020,2
"4320","PA",1,"Norte",15008,"Castanhal",348294,16537.6927737199,6,81,25,56,38,43,0,0,0,0,0,81,25,56,38,43,30,9.71339746511838,12.7608022296769,0.282086194456403,2020-02-10,2020,2
"4321","PA",1,"Norte",15008,"Castanhal",348294,16537.6927737199,7,100,28,72,56,44,0,0,0,0,0,100,28,72,56,44,42,9.71339746511838,12.7608022296769,0.302012371831983,2020-02-17,2020,2
"4322","PA",1,"Norte",15008,"Castanhal",348294,16537.6927737199,8,108,29,79,53,55,2,1,1,0,2,110,30,80,53,57,31,9.71339746511838,12.7608022296769,0.352419750969832,2020-02-24,2020,2
"4323","PA",1,"Norte",15008,"Castanhal",348294,16537.6927737199,9,103,31,72,47,56,0,0,0,0,0,103,31,72,47,56,41,9.71339746511838,12.7608022296769,0.331134607315916,2020-03-02,2020,3
"4324","PA",1,"Norte",15008,"Castanhal",348294,16537.6927737199,10,91,37,54,45,46,0,0,0,0,0,91,37,54,45,46,44,9.71339746511838,12.7608022296769,0.342631544708043,2020-03-09,2020,3
"4325","PA",1,"Norte",15008,"Castanhal",348294,16537.6927737199,11,83,32,51,35,48,0,0,0,0,0,83,32,51,35,48,36,9.71339746511838,12.7608022296769,0.392752369651027,2020-03-16,2020,3
"4326","PA",1,"Norte",15008,"Castanhal",348294,16537.6927737199,12,81,19,62,47,34,4,4,0,4,0,85,23,62,51,34,48,9.71339746511838,12.7608022296769,0.477872638567965,2020-03-23,2020,3
"4327","PA",1,"Norte",15008,"Castanhal",348294,16537.6927737199,13,64,24,40,31,33,0,0,0,0,0,64,24,40,31,33,34,9.71339746511838,12.7608022296769,0.449243528003591,2020-03-30,2020,3
"4328","PA",1,"Norte",15008,"Castanhal",348294,16537.6927737199,14,75,27,48,43,32,0,0,0,0,0,75,27,48,43,32,35,9.71339746511838,12.7608022296769,0.453693440104215,2020-04-06,2020,4
"4329","PA",1,"Norte",15008,"Castanhal",348294,16537.6927737199,15,82,23,59,45,37,0,0,0,0,0,82,23,59,45,37,42,9.71339746511838,12.7608022296769,0.449220472596312,2020-04-13,2020,4
"4330","PA",1,"Norte",15008,"Castanhal",348294,16537.6927737199,16,66,18,48,29,37,0,0,0,0,0,66,18,48,29,37,56,9.71339746511838,12.7608022296769,0.46712530224948,2020-04-20,2020,4
"4331","PA",1,"Norte",15008,"Castanhal",348294,16537.6927737199,17,101,37,64,54,47,1,0,1,0,1,102,37,65,54,48,87,9.71339746511838,12.7608022296769,0.479732661481603,2020-04-27,2020,4
"4332","PA",1,"Norte",15008,"Castanhal",348294,16537.6927737199,18,93,20,73,46,47,1,1,0,0,1,94,21,73,46,48,123,9.71339746511838,12.7608022296769,0.496464877807213,2020-05-04,2020,5
"4333","PA",1,"Norte",15008,"Castanhal",348294,16537.6927737199,19,71,19,52,30,41,2,0,2,0,2,73,19,54,30,43,104,9.71339746511838,12.7608022296769,0.517613278744427,2020-05-11,2020,5
"4334","PA",1,"Norte",15008,"Castanhal",348294,16537.6927737199,20,91,21,70,44,47,1,0,1,1,0,92,21,71,45,47,83,9.71339746511838,12.7608022296769,0.480044560332353,2020-05-18,2020,5
"4335","PA",1,"Norte",15008,"Castanhal",348294,16537.6927737199,21,100,35,65,52,48,1,0,1,0,1,101,35,66,52,49,81,9.71339746511838,12.7608022296769,0.434979826484222,2020-05-25,2020,5
"4336","PA",1,"Norte",15009,"Salgado",273785,8138.49492444802,5,61,19,42,29,32,2,1,1,2,0,63,20,43,31,32,36,9.00436054318425,12.5200984058215,0.312400151949567,2020-02-03,2020,2
"4337","PA",1,"Norte",15009,"Salgado",273785,8138.49492444802,6,63,21,42,28,35,0,0,0,0,0,63,21,42,28,35,25,9.00436054318425,12.5200984058215,0.293816414931127,2020-02-10,2020,2
"4338","PA",1,"Norte",15009,"Salgado",273785,8138.49492444802,7,56,20,36,28,28,1,0,1,1,0,57,20,37,29,28,23,9.00436054318425,12.5200984058215,0.309315786581431,2020-02-17,2020,2
"4339","PA",1,"Norte",15009,"Salgado",273785,8138.49492444802,8,52,22,30,31,21,0,0,0,0,0,52,22,30,31,21,25,9.00436054318425,12.5200984058215,0.34535972788751,2020-02-24,2020,2
"4340","PA",1,"Norte",15009,"Salgado",273785,8138.49492444802,9,51,19,32,27,24,0,0,0,0,0,51,19,32,27,24,31,9.00436054318425,12.5200984058215,0.337664400379598,2020-03-02,2020,3
"4341","PA",1,"Norte",15009,"Salgado",273785,8138.49492444802,10,59,25,34,37,22,0,0,0,0,0,59,25,34,37,22,34,9.00436054318425,12.5200984058215,0.35490983460279,2020-03-09,2020,3
"4342","PA",1,"Norte",15009,"Salgado",273785,8138.49492444802,11,49,21,28,28,21,1,1,0,1,0,50,22,28,29,21,27,9.00436054318425,12.5200984058215,0.393368569173918,2020-03-16,2020,3
"4343","PA",1,"Norte",15009,"Salgado",273785,8138.49492444802,12,61,24,37,36,25,1,0,1,0,1,62,24,38,36,26,35,9.00436054318425,12.5200984058215,0.475039574948545,2020-03-23,2020,3
"4344","PA",1,"Norte",15009,"Salgado",273785,8138.49492444802,13,47,19,28,25,22,0,0,0,0,0,47,19,28,25,22,28,9.00436054318425,12.5200984058215,0.440420387450929,2020-03-30,2020,3
"4345","PA",1,"Norte",15009,"Salgado",273785,8138.49492444802,14,48,23,25,27,21,0,0,0,0,0,48,23,25,27,21,30,9.00436054318425,12.5200984058215,0.462393373504171,2020-04-06,2020,4
"4346","PA",1,"Norte",15009,"Salgado",273785,8138.49492444802,15,48,19,29,31,17,0,0,0,0,0,48,19,29,31,17,43,9.00436054318425,12.5200984058215,0.475749407885214,2020-04-13,2020,4
"4347","PA",1,"Norte",15009,"Salgado",273785,8138.49492444802,16,43,19,24,22,21,0,0,0,0,0,43,19,24,22,21,57,9.00436054318425,12.5200984058215,0.486177721478817,2020-04-20,2020,4
"4348","PA",1,"Norte",15009,"Salgado",273785,8138.49492444802,17,73,20,53,39,34,0,0,0,0,0,73,20,53,39,34,77,9.00436054318425,12.5200984058215,0.490746582791774,2020-04-27,2020,4
"4349","PA",1,"Norte",15009,"Salgado",273785,8138.49492444802,18,44,19,25,28,16,1,1,0,0,1,45,20,25,28,17,89,9.00436054318425,12.5200984058215,0.507461369559009,2020-05-04,2020,5
"4350","PA",1,"Norte",15009,"Salgado",273785,8138.49492444802,19,49,18,31,23,26,0,0,0,0,0,49,18,31,23,26,104,9.00436054318425,12.5200984058215,0.510473563975884,2020-05-11,2020,5
"4351","PA",1,"Norte",15009,"Salgado",273785,8138.49492444802,20,47,23,24,28,19,0,0,0,0,0,47,23,24,28,19,76,9.00436054318425,12.5200984058215,0.492336872488136,2020-05-18,2020,5
"4352","PA",1,"Norte",15009,"Salgado",273785,8138.49492444802,21,43,14,29,23,20,0,0,0,0,0,43,14,29,23,20,61,9.00436054318425,12.5200984058215,0.44849130627172,2020-05-25,2020,5
"4353","PA",1,"Norte",15010,"Bragantina",427450,10251.165533115,5,109,35,74,53,56,0,0,0,0,0,109,35,74,53,56,45,9.2351466886498,12.9655926014544,0.306323558321334,2020-02-03,2020,2
"4354","PA",1,"Norte",15010,"Bragantina",427450,10251.165533115,6,117,46,71,60,57,1,0,1,1,0,118,46,72,61,57,44,9.2351466886498,12.9655926014544,0.290204052308031,2020-02-10,2020,2
"4355","PA",1,"Norte",15010,"Bragantina",427450,10251.165533115,7,103,49,54,63,40,0,0,0,0,0,103,49,54,63,40,38,9.2351466886498,12.9655926014544,0.30806617337636,2020-02-17,2020,2
"4356","PA",1,"Norte",15010,"Bragantina",427450,10251.165533115,8,117,41,76,53,64,2,1,1,2,0,119,42,77,55,64,52,9.2351466886498,12.9655926014544,0.352241779773353,2020-02-24,2020,2
"4357","PA",1,"Norte",15010,"Bragantina",427450,10251.165533115,9,118,49,69,65,53,0,0,0,0,0,118,49,69,65,53,45,9.2351466886498,12.9655926014544,0.335367731917066,2020-03-02,2020,3
"4358","PA",1,"Norte",15010,"Bragantina",427450,10251.165533115,10,105,39,66,54,51,3,2,1,3,0,108,41,67,57,51,52,9.2351466886498,12.9655926014544,0.356998139451024,2020-03-09,2020,3
"4359","PA",1,"Norte",15010,"Bragantina",427450,10251.165533115,11,128,45,83,58,70,1,1,0,1,0,129,46,83,59,70,47,9.2351466886498,12.9655926014544,0.396143214491761,2020-03-16,2020,3
"4360","PA",1,"Norte",15010,"Bragantina",427450,10251.165533115,12,107,44,63,59,48,0,0,0,0,0,107,44,63,59,48,54,9.2351466886498,12.9655926014544,0.496682266842685,2020-03-23,2020,3
"4361","PA",1,"Norte",15010,"Bragantina",427450,10251.165533115,13,68,23,45,42,26,0,0,0,0,0,68,23,45,42,26,36,9.2351466886498,12.9655926014544,0.449528519816557,2020-03-30,2020,3
"4362","PA",1,"Norte",15010,"Bragantina",427450,10251.165533115,14,88,40,48,56,32,3,0,3,1,2,91,40,51,57,34,47,9.2351466886498,12.9655926014544,0.45265751475106,2020-04-06,2020,4
"4363","PA",1,"Norte",15010,"Bragantina",427450,10251.165533115,15,79,29,50,48,31,1,0,1,0,1,80,29,51,48,32,41,9.2351466886498,12.9655926014544,0.45204303028124,2020-04-13,2020,4
"4364","PA",1,"Norte",15010,"Bragantina",427450,10251.165533115,16,90,33,57,44,46,1,1,0,1,0,91,34,57,45,46,67,9.2351466886498,12.9655926014544,0.476214138609851,2020-04-20,2020,4
"4365","PA",1,"Norte",15010,"Bragantina",427450,10251.165533115,17,87,35,52,42,45,1,1,0,1,0,88,36,52,43,45,78,9.2351466886498,12.9655926014544,0.484979206117277,2020-04-27,2020,4
"4366","PA",1,"Norte",15010,"Bragantina",427450,10251.165533115,18,73,35,38,37,36,2,2,0,1,1,75,37,38,38,37,133,9.2351466886498,12.9655926014544,0.487368245774377,2020-05-04,2020,5
"4367","PA",1,"Norte",15010,"Bragantina",427450,10251.165533115,19,89,33,56,48,41,0,0,0,0,0,89,33,56,48,41,128,9.2351466886498,12.9655926014544,0.505487238853254,2020-05-11,2020,5
"4368","PA",1,"Norte",15010,"Bragantina",427450,10251.165533115,20,108,46,62,63,45,2,0,2,2,0,110,46,64,65,45,125,9.2351466886498,12.9655926014544,0.486321922675196,2020-05-18,2020,5
"4369","PA",1,"Norte",15010,"Bragantina",427450,10251.165533115,21,98,39,59,48,50,0,0,0,0,0,98,39,59,48,50,86,9.2351466886498,12.9655926014544,0.450570461035916,2020-05-25,2020,5
"4370","PA",1,"Norte",15011,"Cametá",503601,8876.90432967766,5,150,67,83,75,75,1,0,1,0,1,151,67,84,75,76,34,9.09120816368431,13.1295395668533,0.29531088540901,2020-02-03,2020,2
"4371","PA",1,"Norte",15011,"Cametá",503601,8876.90432967766,6,160,68,92,92,68,0,0,0,0,0,160,68,92,92,68,38,9.09120816368431,13.1295395668533,0.282531678458584,2020-02-10,2020,2
"4372","PA",1,"Norte",15011,"Cametá",503601,8876.90432967766,7,154,65,89,80,74,1,0,1,0,1,155,65,90,80,75,38,9.09120816368431,13.1295395668533,0.28502201315668,2020-02-17,2020,2
"4373","PA",1,"Norte",15011,"Cametá",503601,8876.90432967766,8,155,73,82,85,70,3,1,2,1,2,158,74,84,86,72,35,9.09120816368431,13.1295395668533,0.336993373228611,2020-02-24,2020,2
"4374","PA",1,"Norte",15011,"Cametá",503601,8876.90432967766,9,139,60,79,77,62,5,1,4,1,4,144,61,83,78,66,39,9.09120816368431,13.1295395668533,0.316366385624553,2020-03-02,2020,3
"4375","PA",1,"Norte",15011,"Cametá",503601,8876.90432967766,10,136,60,76,76,60,1,0,1,0,1,137,60,77,76,61,35,9.09120816368431,13.1295395668533,0.337336822129934,2020-03-09,2020,3
"4376","PA",1,"Norte",15011,"Cametá",503601,8876.90432967766,11,136,54,82,79,57,1,0,1,1,0,137,54,83,80,57,53,9.09120816368431,13.1295395668533,0.385700543432954,2020-03-16,2020,3
"4377","PA",1,"Norte",15011,"Cametá",503601,8876.90432967766,12,138,58,80,79,59,2,2,0,2,0,140,60,80,81,59,42,9.09120816368431,13.1295395668533,0.48415393112362,2020-03-23,2020,3
"4378","PA",1,"Norte",15011,"Cametá",503601,8876.90432967766,13,125,53,72,77,48,0,0,0,0,0,125,53,72,77,48,33,9.09120816368431,13.1295395668533,0.463744268823932,2020-03-30,2020,3
"4379","PA",1,"Norte",15011,"Cametá",503601,8876.90432967766,14,116,41,75,64,52,1,0,1,0,1,117,41,76,64,53,30,9.09120816368431,13.1295395668533,0.48213469803448,2020-04-06,2020,4
"4380","PA",1,"Norte",15011,"Cametá",503601,8876.90432967766,15,146,60,86,91,55,1,1,0,0,1,147,61,86,91,56,29,9.09120816368431,13.1295395668533,0.457530305728708,2020-04-13,2020,4
"4381","PA",1,"Norte",15011,"Cametá",503601,8876.90432967766,16,126,44,82,59,67,4,4,0,4,0,130,48,82,63,67,58,9.09120816368431,13.1295395668533,0.464378911669708,2020-04-20,2020,4
"4382","PA",1,"Norte",15011,"Cametá",503601,8876.90432967766,17,132,51,81,68,64,2,2,0,1,1,134,53,81,69,65,62,9.09120816368431,13.1295395668533,0.494593133676474,2020-04-27,2020,4
"4383","PA",1,"Norte",15011,"Cametá",503601,8876.90432967766,18,131,52,79,71,60,1,0,1,1,0,132,52,80,72,60,138,9.09120816368431,13.1295395668533,0.518948635077318,2020-05-04,2020,5
"4384","PA",1,"Norte",15011,"Cametá",503601,8876.90432967766,19,115,49,66,55,60,0,0,0,0,0,115,49,66,55,60,132,9.09120816368431,13.1295395668533,0.545821528448403,2020-05-11,2020,5
"4385","PA",1,"Norte",15011,"Cametá",503601,8876.90432967766,20,141,42,99,87,54,3,1,2,1,2,144,43,101,88,56,88,9.09120816368431,13.1295395668533,0.522796335706858,2020-05-18,2020,5
"4386","PA",1,"Norte",15011,"Cametá",503601,8876.90432967766,21,143,52,91,82,61,2,2,0,2,0,145,54,91,84,61,72,9.09120816368431,13.1295395668533,0.482767891081058,2020-05-25,2020,5
"4387","PA",1,"Norte",15012,"Tomé-Açu",345631,11029.3964096392,5,88,37,51,45,43,2,2,0,1,1,90,39,51,46,44,18,9.3083193881427,12.7531270109634,0.299836837018084,2020-02-03,2020,2
"4388","PA",1,"Norte",15012,"Tomé-Açu",345631,11029.3964096392,6,109,53,56,61,48,0,0,0,0,0,109,53,56,61,48,21,9.3083193881427,12.7531270109634,0.294705702196518,2020-02-10,2020,2
"4389","PA",1,"Norte",15012,"Tomé-Açu",345631,11029.3964096392,7,111,45,66,56,55,1,0,1,1,0,112,45,67,57,55,32,9.3083193881427,12.7531270109634,0.294055073482113,2020-02-17,2020,2
"4390","PA",1,"Norte",15012,"Tomé-Açu",345631,11029.3964096392,8,90,36,54,53,37,2,2,0,0,2,92,38,54,53,39,25,9.3083193881427,12.7531270109634,0.329247347381642,2020-02-24,2020,2
"4391","PA",1,"Norte",15012,"Tomé-Açu",345631,11029.3964096392,9,93,44,49,47,46,3,2,1,0,3,96,46,50,47,49,28,9.3083193881427,12.7531270109634,0.311884150423262,2020-03-02,2020,3
"4392","PA",1,"Norte",15012,"Tomé-Açu",345631,11029.3964096392,10,94,50,44,56,38,1,1,0,0,1,95,51,44,56,39,30,9.3083193881427,12.7531270109634,0.340281032452711,2020-03-09,2020,3
"4393","PA",1,"Norte",15012,"Tomé-Açu",345631,11029.3964096392,11,100,41,59,53,47,1,1,0,0,1,101,42,59,53,48,23,9.3083193881427,12.7531270109634,0.379815559929453,2020-03-16,2020,3
"4394","PA",1,"Norte",15012,"Tomé-Açu",345631,11029.3964096392,12,101,52,49,52,49,1,1,0,0,1,102,53,49,52,50,16,9.3083193881427,12.7531270109634,0.456061026406358,2020-03-23,2020,3
"4395","PA",1,"Norte",15012,"Tomé-Açu",345631,11029.3964096392,13,62,26,36,31,31,0,0,0,0,0,62,26,36,31,31,39,9.3083193881427,12.7531270109634,0.422902693239043,2020-03-30,2020,3
"4396","PA",1,"Norte",15012,"Tomé-Açu",345631,11029.3964096392,14,110,54,56,59,51,3,3,0,2,1,113,57,56,61,52,30,9.3083193881427,12.7531270109634,0.41733668066562,2020-04-06,2020,4
"4397","PA",1,"Norte",15012,"Tomé-Açu",345631,11029.3964096392,15,92,45,47,50,42,1,0,1,1,0,93,45,48,51,42,30,9.3083193881427,12.7531270109634,0.417802008176898,2020-04-13,2020,4
"4398","PA",1,"Norte",15012,"Tomé-Açu",345631,11029.3964096392,16,110,44,66,73,37,1,1,0,1,0,111,45,66,74,37,27,9.3083193881427,12.7531270109634,0.419702258463439,2020-04-20,2020,4
"4399","PA",1,"Norte",15012,"Tomé-Açu",345631,11029.3964096392,17,72,31,41,34,38,2,0,2,1,1,74,31,43,35,39,45,9.3083193881427,12.7531270109634,0.44486619630758,2020-04-27,2020,4
"4400","PA",1,"Norte",15012,"Tomé-Açu",345631,11029.3964096392,18,92,49,43,59,33,1,1,0,0,1,93,50,43,59,34,61,9.3083193881427,12.7531270109634,0.458175706421845,2020-05-04,2020,5
"4401","PA",1,"Norte",15012,"Tomé-Açu",345631,11029.3964096392,19,80,29,51,45,35,1,1,0,1,0,81,30,51,46,35,59,9.3083193881427,12.7531270109634,0.481330651658976,2020-05-11,2020,5
"4402","PA",1,"Norte",15012,"Tomé-Açu",345631,11029.3964096392,20,103,44,59,52,51,0,0,0,0,0,103,44,59,52,51,70,9.3083193881427,12.7531270109634,0.461749576055478,2020-05-18,2020,5
"4403","PA",1,"Norte",15012,"Tomé-Açu",345631,11029.3964096392,21,103,42,61,63,40,3,1,2,1,2,106,43,63,64,42,46,9.3083193881427,12.7531270109634,0.443453583002359,2020-05-25,2020,5
"4404","PA",1,"Norte",15013,"Guamá",488143,8657.74018834645,5,125,65,60,73,52,3,2,1,3,0,128,67,61,76,52,39,9.06620901927568,13.0983636746964,0.294593974127079,2020-02-03,2020,2
"4405","PA",1,"Norte",15013,"Guamá",488143,8657.74018834645,6,122,53,69,71,51,3,1,2,2,1,125,54,71,73,52,35,9.06620901927568,13.0983636746964,0.293162832047517,2020-02-10,2020,2
"4406","PA",1,"Norte",15013,"Guamá",488143,8657.74018834645,7,155,71,84,73,82,1,0,1,0,1,156,71,85,73,83,41,9.06620901927568,13.0983636746964,0.287609886115333,2020-02-17,2020,2
"4407","PA",1,"Norte",15013,"Guamá",488143,8657.74018834645,8,136,61,75,75,61,1,1,0,1,0,137,62,75,76,61,40,9.06620901927568,13.0983636746964,0.34351293708391,2020-02-24,2020,2
"4408","PA",1,"Norte",15013,"Guamá",488143,8657.74018834645,9,142,74,68,89,53,1,0,1,0,1,143,74,69,89,54,40,9.06620901927568,13.0983636746964,0.324302715226339,2020-03-02,2020,3
"4409","PA",1,"Norte",15013,"Guamá",488143,8657.74018834645,10,95,50,45,52,43,0,0,0,0,0,95,50,45,52,43,43,9.06620901927568,13.0983636746964,0.343870005503784,2020-03-09,2020,3
"4410","PA",1,"Norte",15013,"Guamá",488143,8657.74018834645,11,125,61,64,63,62,0,0,0,0,0,125,61,64,63,62,44,9.06620901927568,13.0983636746964,0.39339813808469,2020-03-16,2020,3
"4411","PA",1,"Norte",15013,"Guamá",488143,8657.74018834645,12,112,64,48,59,53,3,2,1,1,2,115,66,49,60,55,38,9.06620901927568,13.0983636746964,0.479437392820341,2020-03-23,2020,3
"4412","PA",1,"Norte",15013,"Guamá",488143,8657.74018834645,13,79,42,37,51,28,1,0,1,0,1,80,42,38,51,29,34,9.06620901927568,13.0983636746964,0.431439078079829,2020-03-30,2020,3
"4413","PA",1,"Norte",15013,"Guamá",488143,8657.74018834645,14,93,40,53,55,38,1,0,1,0,1,94,40,54,55,39,57,9.06620901927568,13.0983636746964,0.440526808283027,2020-04-06,2020,4
"4414","PA",1,"Norte",15013,"Guamá",488143,8657.74018834645,15,113,58,55,68,45,0,0,0,0,0,113,58,55,68,45,50,9.06620901927568,13.0983636746964,0.427500095726572,2020-04-13,2020,4
"4415","PA",1,"Norte",15013,"Guamá",488143,8657.74018834645,16,124,53,71,71,53,5,3,2,1,4,129,56,73,72,57,47,9.06620901927568,13.0983636746964,0.431308003907978,2020-04-20,2020,4
"4416","PA",1,"Norte",15013,"Guamá",488143,8657.74018834645,17,126,66,60,68,58,1,1,0,0,1,127,67,60,68,59,58,9.06620901927568,13.0983636746964,0.447007456053795,2020-04-27,2020,4
"4417","PA",1,"Norte",15013,"Guamá",488143,8657.74018834645,18,98,46,52,55,43,0,0,0,0,0,98,46,52,55,43,69,9.06620901927568,13.0983636746964,0.464363491356265,2020-05-04,2020,5
"4418","PA",1,"Norte",15013,"Guamá",488143,8657.74018834645,19,123,58,65,81,42,3,3,0,2,1,126,61,65,83,43,70,9.06620901927568,13.0983636746964,0.497743345507675,2020-05-11,2020,5
"4419","PA",1,"Norte",15013,"Guamá",488143,8657.74018834645,20,106,59,47,62,44,1,0,1,0,1,107,59,48,62,45,76,9.06620901927568,13.0983636746964,0.476198919793377,2020-05-18,2020,5
"4420","PA",1,"Norte",15013,"Guamá",488143,8657.74018834645,21,110,52,58,68,42,5,3,2,4,1,115,55,60,72,43,69,9.06620901927568,13.0983636746964,0.450656966341805,2020-05-25,2020,5
"4421","PA",1,"Norte",15014,"Itaituba",221823,16142.9391547766,5,83,40,43,57,26,0,0,0,0,0,83,40,43,57,26,19,9.68923802901065,12.3096350455466,0.312027633845829,2020-02-03,2020,2
"4422","PA",1,"Norte",15014,"Itaituba",221823,16142.9391547766,6,88,34,54,44,44,0,0,0,0,0,88,34,54,44,44,18,9.68923802901065,12.3096350455466,0.304293568445084,2020-02-10,2020,2
"4423","PA",1,"Norte",15014,"Itaituba",221823,16142.9391547766,7,114,46,68,67,47,0,0,0,0,0,114,46,68,67,47,14,9.68923802901065,12.3096350455466,0.326822524899677,2020-02-17,2020,2
"4424","PA",1,"Norte",15014,"Itaituba",221823,16142.9391547766,8,102,47,55,66,36,2,0,2,0,2,104,47,57,66,38,18,9.68923802901065,12.3096350455466,0.346277665952124,2020-02-24,2020,2
"4425","PA",1,"Norte",15014,"Itaituba",221823,16142.9391547766,9,75,38,37,44,31,2,0,2,1,1,77,38,39,45,32,27,9.68923802901065,12.3096350455466,0.355598750048632,2020-03-02,2020,3
"4426","PA",1,"Norte",15014,"Itaituba",221823,16142.9391547766,10,59,26,33,31,28,1,0,1,0,1,60,26,34,31,29,26,9.68923802901065,12.3096350455466,0.35041085435258,2020-03-09,2020,3
"4427","PA",1,"Norte",15014,"Itaituba",221823,16142.9391547766,11,87,34,53,50,37,1,0,1,0,1,88,34,54,50,38,29,9.68923802901065,12.3096350455466,0.393754572503459,2020-03-16,2020,3
"4428","PA",1,"Norte",15014,"Itaituba",221823,16142.9391547766,12,89,40,49,49,40,0,0,0,0,0,89,40,49,49,40,10,9.68923802901065,12.3096350455466,0.451883469722002,2020-03-23,2020,3
"4429","PA",1,"Norte",15014,"Itaituba",221823,16142.9391547766,13,55,21,34,28,27,0,0,0,0,0,55,21,34,28,27,23,9.68923802901065,12.3096350455466,0.417206599346049,2020-03-30,2020,3
"4430","PA",1,"Norte",15014,"Itaituba",221823,16142.9391547766,14,71,35,36,43,28,1,1,0,0,1,72,36,36,43,29,25,9.68923802901065,12.3096350455466,0.428093519590806,2020-04-06,2020,4
"4431","PA",1,"Norte",15014,"Itaituba",221823,16142.9391547766,15,70,27,43,44,26,1,1,0,0,1,71,28,43,44,27,20,9.68923802901065,12.3096350455466,0.407869993032647,2020-04-13,2020,4
"4432","PA",1,"Norte",15014,"Itaituba",221823,16142.9391547766,16,83,38,45,48,35,2,0,2,0,2,85,38,47,48,37,17,9.68923802901065,12.3096350455466,0.404057945062971,2020-04-20,2020,4
"4433","PA",1,"Norte",15014,"Itaituba",221823,16142.9391547766,17,70,33,37,43,27,2,1,1,1,1,72,34,38,44,28,25,9.68923802901065,12.3096350455466,0.405257726383629,2020-04-27,2020,4
"4434","PA",1,"Norte",15014,"Itaituba",221823,16142.9391547766,18,77,37,40,48,29,3,0,3,1,2,80,37,43,49,31,36,9.68923802901065,12.3096350455466,0.403120789029683,2020-05-04,2020,5
"4435","PA",1,"Norte",15014,"Itaituba",221823,16142.9391547766,19,61,22,39,40,21,0,0,0,0,0,61,22,39,40,21,24,9.68923802901065,12.3096350455466,0.428940559380911,2020-05-11,2020,5
"4436","PA",1,"Norte",15014,"Itaituba",221823,16142.9391547766,20,68,29,39,41,27,1,1,0,1,0,69,30,39,42,27,34,9.68923802901065,12.3096350455466,0.444228383990741,2020-05-18,2020,5
"4437","PA",1,"Norte",15014,"Itaituba",221823,16142.9391547766,21,89,42,47,41,48,0,0,0,0,0,89,42,47,41,48,43,9.68923802901065,12.3096350455466,0.428197969697345,2020-05-25,2020,5
"4438","PA",1,"Norte",15015,"Altamira",312142,31414.6584765908,5,132,56,76,78,54,1,0,1,0,1,133,56,77,78,55,36,10.3550298934296,12.6512134914573,0.298934972630472,2020-02-03,2020,2
"4439","PA",1,"Norte",15015,"Altamira",312142,31414.6584765908,6,111,53,58,55,56,0,0,0,0,0,111,53,58,55,56,25,10.3550298934296,12.6512134914573,0.292786652217597,2020-02-10,2020,2
"4440","PA",1,"Norte",15015,"Altamira",312142,31414.6584765908,7,125,65,60,70,55,3,2,1,2,1,128,67,61,72,56,35,10.3550298934296,12.6512134914573,0.294810013561285,2020-02-17,2020,2
"4441","PA",1,"Norte",15015,"Altamira",312142,31414.6584765908,8,136,61,75,85,51,2,0,2,1,1,138,61,77,86,52,28,10.3550298934296,12.6512134914573,0.343194046402922,2020-02-24,2020,2
"4442","PA",1,"Norte",15015,"Altamira",312142,31414.6584765908,9,112,47,65,62,50,3,2,1,0,3,115,49,66,62,53,37,10.3550298934296,12.6512134914573,0.323087808925376,2020-03-02,2020,3
"4443","PA",1,"Norte",15015,"Altamira",312142,31414.6584765908,10,115,52,63,60,55,0,0,0,0,0,115,52,63,60,55,30,10.3550298934296,12.6512134914573,0.337113195118016,2020-03-09,2020,3
"4444","PA",1,"Norte",15015,"Altamira",312142,31414.6584765908,11,103,44,59,63,40,1,0,1,0,1,104,44,60,63,41,35,10.3550298934296,12.6512134914573,0.380991153804277,2020-03-16,2020,3
"4445","PA",1,"Norte",15015,"Altamira",312142,31414.6584765908,12,102,50,52,54,48,0,0,0,0,0,102,50,52,54,48,28,10.3550298934296,12.6512134914573,0.459998350128512,2020-03-23,2020,3
"4446","PA",1,"Norte",15015,"Altamira",312142,31414.6584765908,13,94,47,47,46,48,4,1,3,1,3,98,48,50,47,51,25,10.3550298934296,12.6512134914573,0.407039783857806,2020-03-30,2020,3
"4447","PA",1,"Norte",15015,"Altamira",312142,31414.6584765908,14,104,48,56,58,46,1,1,0,1,0,105,49,56,59,46,31,10.3550298934296,12.6512134914573,0.419412795796417,2020-04-06,2020,4
"4448","PA",1,"Norte",15015,"Altamira",312142,31414.6584765908,15,106,37,69,65,41,0,0,0,0,0,106,37,69,65,41,33,10.3550298934296,12.6512134914573,0.409777718271197,2020-04-13,2020,4
"4449","PA",1,"Norte",15015,"Altamira",312142,31414.6584765908,16,113,51,62,65,48,2,0,2,1,1,115,51,64,66,49,28,10.3550298934296,12.6512134914573,0.40529514348259,2020-04-20,2020,4
"4450","PA",1,"Norte",15015,"Altamira",312142,31414.6584765908,17,97,53,44,59,38,0,0,0,0,0,97,53,44,59,38,34,10.3550298934296,12.6512134914573,0.415654208547953,2020-04-27,2020,4
"4451","PA",1,"Norte",15015,"Altamira",312142,31414.6584765908,18,113,57,56,61,52,0,0,0,0,0,113,57,56,61,52,43,10.3550298934296,12.6512134914573,0.41079942439299,2020-05-04,2020,5
"4452","PA",1,"Norte",15015,"Altamira",312142,31414.6584765908,19,86,39,47,52,34,1,1,0,1,0,87,40,47,53,34,34,10.3550298934296,12.6512134914573,0.452096287178726,2020-05-11,2020,5
"4453","PA",1,"Norte",15015,"Altamira",312142,31414.6584765908,20,90,34,56,48,42,1,0,1,0,1,91,34,57,48,43,47,10.3550298934296,12.6512134914573,0.451868638970355,2020-05-18,2020,5
"4454","PA",1,"Norte",15015,"Altamira",312142,31414.6584765908,21,99,47,52,50,49,0,0,0,0,0,99,47,52,50,49,39,10.3550298934296,12.6512134914573,0.44563008857665,2020-05-25,2020,5
"4455","PA",1,"Norte",15016,"Tucuruí",389741,26464.1607445714,5,101,42,59,57,44,1,0,1,0,1,102,42,60,57,45,27,10.1835466718894,12.8732376949279,0.293644119123833,2020-02-03,2020,2
"4456","PA",1,"Norte",15016,"Tucuruí",389741,26464.1607445714,6,103,44,59,56,47,1,0,1,0,1,104,44,60,56,48,27,10.1835466718894,12.8732376949279,0.269940037922129,2020-02-10,2020,2
"4457","PA",1,"Norte",15016,"Tucuruí",389741,26464.1607445714,7,128,60,68,76,52,2,1,1,0,2,130,61,69,76,54,32,10.1835466718894,12.8732376949279,0.299442288935392,2020-02-17,2020,2
"4458","PA",1,"Norte",15016,"Tucuruí",389741,26464.1607445714,8,103,46,57,61,42,1,0,1,0,1,104,46,58,61,43,35,10.1835466718894,12.8732376949279,0.326499399983609,2020-02-24,2020,2
"4459","PA",1,"Norte",15016,"Tucuruí",389741,26464.1607445714,9,112,52,60,69,43,0,0,0,0,0,112,52,60,69,43,37,10.1835466718894,12.8732376949279,0.313856983991368,2020-03-02,2020,3
"4460","PA",1,"Norte",15016,"Tucuruí",389741,26464.1607445714,10,93,40,53,55,38,4,1,3,2,2,97,41,56,57,40,38,10.1835466718894,12.8732376949279,0.330966460380211,2020-03-09,2020,3
"4461","PA",1,"Norte",15016,"Tucuruí",389741,26464.1607445714,11,96,39,57,49,47,0,0,0,0,0,96,39,57,49,47,22,10.1835466718894,12.8732376949279,0.379610274205835,2020-03-16,2020,3
"4462","PA",1,"Norte",15016,"Tucuruí",389741,26464.1607445714,12,89,37,52,53,36,0,0,0,0,0,89,37,52,53,36,31,10.1835466718894,12.8732376949279,0.458397099559686,2020-03-23,2020,3
"4463","PA",1,"Norte",15016,"Tucuruí",389741,26464.1607445714,13,68,28,40,37,31,0,0,0,0,0,68,28,40,37,31,40,10.1835466718894,12.8732376949279,0.417316364890723,2020-03-30,2020,3
"4464","PA",1,"Norte",15016,"Tucuruí",389741,26464.1607445714,14,85,34,51,50,35,1,0,1,1,0,86,34,52,51,35,33,10.1835466718894,12.8732376949279,0.41673835071934,2020-04-06,2020,4
"4465","PA",1,"Norte",15016,"Tucuruí",389741,26464.1607445714,15,89,31,58,57,32,2,1,1,1,1,91,32,59,58,33,36,10.1835466718894,12.8732376949279,0.397894206815784,2020-04-13,2020,4
"4466","PA",1,"Norte",15016,"Tucuruí",389741,26464.1607445714,16,92,40,52,55,37,1,1,0,1,0,93,41,52,56,37,33,10.1835466718894,12.8732376949279,0.407738882065908,2020-04-20,2020,4
"4467","PA",1,"Norte",15016,"Tucuruí",389741,26464.1607445714,17,86,34,52,45,41,1,0,1,1,0,87,34,53,46,41,37,10.1835466718894,12.8732376949279,0.408040052315905,2020-04-27,2020,4
"4468","PA",1,"Norte",15016,"Tucuruí",389741,26464.1607445714,18,67,35,32,37,30,0,0,0,0,0,67,35,32,37,30,43,10.1835466718894,12.8732376949279,0.423883255797167,2020-05-04,2020,5
"4469","PA",1,"Norte",15016,"Tucuruí",389741,26464.1607445714,19,75,25,50,35,40,0,0,0,0,0,75,25,50,35,40,64,10.1835466718894,12.8732376949279,0.434186856792397,2020-05-11,2020,5
"4470","PA",1,"Norte",15016,"Tucuruí",389741,26464.1607445714,20,95,42,53,56,39,1,1,0,1,0,96,43,53,57,39,66,10.1835466718894,12.8732376949279,0.459423241421605,2020-05-18,2020,5
"4471","PA",1,"Norte",15016,"Tucuruí",389741,26464.1607445714,21,109,54,55,61,48,1,0,1,1,0,110,54,56,62,48,41,10.1835466718894,12.8732376949279,0.421425874622048,2020-05-25,2020,5
"4472","PA",1,"Norte",15017,"Paragominas",354221,16856.0558000232,5,50,16,34,30,20,0,0,0,0,0,50,16,34,30,20,19,9.73246526587384,12.7776762911109,0.275397835407018,2020-02-03,2020,2
"4473","PA",1,"Norte",15017,"Paragominas",354221,16856.0558000232,6,51,17,34,31,20,1,1,0,1,0,52,18,34,32,20,28,9.73246526587384,12.7776762911109,0.267971850186782,2020-02-10,2020,2
"4474","PA",1,"Norte",15017,"Paragominas",354221,16856.0558000232,7,53,24,29,24,29,1,0,1,0,1,54,24,30,24,30,28,9.73246526587384,12.7776762911109,0.284478989507381,2020-02-17,2020,2
"4475","PA",1,"Norte",15017,"Paragominas",354221,16856.0558000232,8,49,23,26,20,29,1,0,1,0,1,50,23,27,20,30,30,9.73246526587384,12.7776762911109,0.321500949326953,2020-02-24,2020,2
"4476","PA",1,"Norte",15017,"Paragominas",354221,16856.0558000232,9,42,23,19,26,16,0,0,0,0,0,42,23,19,26,16,23,9.73246526587384,12.7776762911109,0.302825291780146,2020-03-02,2020,3
"4477","PA",1,"Norte",15017,"Paragominas",354221,16856.0558000232,10,47,16,31,26,21,2,1,1,2,0,49,17,32,28,21,34,9.73246526587384,12.7776762911109,0.316341044161253,2020-03-09,2020,3
"4478","PA",1,"Norte",15017,"Paragominas",354221,16856.0558000232,11,61,26,35,31,30,2,0,2,0,2,63,26,37,31,32,19,9.73246526587384,12.7776762911109,0.364697435201487,2020-03-16,2020,3
"4479","PA",1,"Norte",15017,"Paragominas",354221,16856.0558000232,12,36,16,20,22,14,1,0,1,1,0,37,16,21,23,14,31,9.73246526587384,12.7776762911109,0.440682312316516,2020-03-23,2020,3
"4480","PA",1,"Norte",15017,"Paragominas",354221,16856.0558000232,13,39,14,25,26,13,1,1,0,0,1,40,15,25,26,14,19,9.73246526587384,12.7776762911109,0.400975749057408,2020-03-30,2020,3
"4481","PA",1,"Norte",15017,"Paragominas",354221,16856.0558000232,14,52,20,32,31,21,0,0,0,0,0,52,20,32,31,21,21,9.73246526587384,12.7776762911109,0.404122012745045,2020-04-06,2020,4
"4482","PA",1,"Norte",15017,"Paragominas",354221,16856.0558000232,15,43,17,26,24,19,2,0,2,1,1,45,17,28,25,20,18,9.73246526587384,12.7776762911109,0.3791541514273,2020-04-13,2020,4
"4483","PA",1,"Norte",15017,"Paragominas",354221,16856.0558000232,16,50,14,36,25,25,1,0,1,1,0,51,14,37,26,25,27,9.73246526587384,12.7776762911109,0.384901451605408,2020-04-20,2020,4
"4484","PA",1,"Norte",15017,"Paragominas",354221,16856.0558000232,17,55,27,28,33,22,1,0,1,0,1,56,27,29,33,23,34,9.73246526587384,12.7776762911109,0.394045446243648,2020-04-27,2020,4
"4485","PA",1,"Norte",15017,"Paragominas",354221,16856.0558000232,18,51,29,22,26,25,0,0,0,0,0,51,29,22,26,25,36,9.73246526587384,12.7776762911109,0.404119479755739,2020-05-04,2020,5
"4486","PA",1,"Norte",15017,"Paragominas",354221,16856.0558000232,19,54,19,35,31,23,2,2,0,2,0,56,21,35,33,23,48,9.73246526587384,12.7776762911109,0.436772081093582,2020-05-11,2020,5
"4487","PA",1,"Norte",15017,"Paragominas",354221,16856.0558000232,20,47,27,20,24,23,0,0,0,0,0,47,27,20,24,23,49,9.73246526587384,12.7776762911109,0.418081371262679,2020-05-18,2020,5
"4488","PA",1,"Norte",15017,"Paragominas",354221,16856.0558000232,21,49,22,27,32,17,0,0,0,0,0,49,22,27,32,17,58,9.73246526587384,12.7776762911109,0.405859242277189,2020-05-25,2020,5
"4489","PA",1,"Norte",15018,"São Félix do Xingu",222632,14764.5766841245,5,65,41,24,36,29,1,0,1,0,1,66,41,25,36,30,14,9.59998612354179,12.3132754631072,0.306368069881829,2020-02-03,2020,2
"4490","PA",1,"Norte",15018,"São Félix do Xingu",222632,14764.5766841245,6,65,23,42,36,29,1,1,0,0,1,66,24,42,36,30,20,9.59998612354179,12.3132754631072,0.303188604884758,2020-02-10,2020,2
"4491","PA",1,"Norte",15018,"São Félix do Xingu",222632,14764.5766841245,7,46,18,28,23,23,1,1,0,0,1,47,19,28,23,24,12,9.59998612354179,12.3132754631072,0.305524373593678,2020-02-17,2020,2
"4492","PA",1,"Norte",15018,"São Félix do Xingu",222632,14764.5766841245,8,52,21,31,32,20,1,0,1,0,1,53,21,32,32,21,12,9.59998612354179,12.3132754631072,0.342078405581723,2020-02-24,2020,2
"4493","PA",1,"Norte",15018,"São Félix do Xingu",222632,14764.5766841245,9,42,23,19,27,15,1,0,1,0,1,43,23,20,27,16,9,9.59998612354179,12.3132754631072,0.329229861005881,2020-03-02,2020,3
"4494","PA",1,"Norte",15018,"São Félix do Xingu",222632,14764.5766841245,10,42,19,23,23,19,1,1,0,0,1,43,20,23,23,20,13,9.59998612354179,12.3132754631072,0.327917840198432,2020-03-09,2020,3
"4495","PA",1,"Norte",15018,"São Félix do Xingu",222632,14764.5766841245,11,39,22,17,18,21,0,0,0,0,0,39,22,17,18,21,9,9.59998612354179,12.3132754631072,0.364059746508026,2020-03-16,2020,3
"4496","PA",1,"Norte",15018,"São Félix do Xingu",222632,14764.5766841245,12,32,13,19,22,10,1,0,1,1,0,33,13,20,23,10,14,9.59998612354179,12.3132754631072,0.43648353687681,2020-03-23,2020,3
"4497","PA",1,"Norte",15018,"São Félix do Xingu",222632,14764.5766841245,13,32,21,11,18,14,1,1,0,0,1,33,22,11,18,15,12,9.59998612354179,12.3132754631072,0.392497981478659,2020-03-30,2020,3
"4498","PA",1,"Norte",15018,"São Félix do Xingu",222632,14764.5766841245,14,43,21,22,23,20,0,0,0,0,0,43,21,22,23,20,5,9.59998612354179,12.3132754631072,0.392635447760559,2020-04-06,2020,4
"4499","PA",1,"Norte",15018,"São Félix do Xingu",222632,14764.5766841245,15,44,17,27,18,26,0,0,0,0,0,44,17,27,18,26,17,9.59998612354179,12.3132754631072,0.37568799795784,2020-04-13,2020,4
"4500","PA",1,"Norte",15018,"São Félix do Xingu",222632,14764.5766841245,16,45,22,23,18,27,1,0,1,1,0,46,22,24,19,27,15,9.59998612354179,12.3132754631072,0.389457436606273,2020-04-20,2020,4
"4501","PA",1,"Norte",15018,"São Félix do Xingu",222632,14764.5766841245,17,47,22,25,26,21,1,1,0,1,0,48,23,25,27,21,11,9.59998612354179,12.3132754631072,0.408113510711694,2020-04-27,2020,4
"4502","PA",1,"Norte",15018,"São Félix do Xingu",222632,14764.5766841245,18,46,22,24,22,24,0,0,0,0,0,46,22,24,22,24,13,9.59998612354179,12.3132754631072,0.418837458078783,2020-05-04,2020,5
"4503","PA",1,"Norte",15018,"São Félix do Xingu",222632,14764.5766841245,19,45,23,22,23,22,0,0,0,0,0,45,23,22,23,22,15,9.59998612354179,12.3132754631072,0.422860302684305,2020-05-11,2020,5
"4504","PA",1,"Norte",15018,"São Félix do Xingu",222632,14764.5766841245,20,47,17,30,31,16,1,0,1,0,1,48,17,31,31,17,13,9.59998612354179,12.3132754631072,0.420487165322216,2020-05-18,2020,5
"4505","PA",1,"Norte",15018,"São Félix do Xingu",222632,14764.5766841245,21,51,28,23,36,15,0,0,0,0,0,51,28,23,36,15,21,9.59998612354179,12.3132754631072,0.408908951262445,2020-05-25,2020,5
"4506","PA",1,"Norte",15019,"Parauapebas",331080,78446.9845697717,5,140,34,106,68,72,0,0,0,0,0,140,34,106,68,72,30,11.270178319816,12.7101153169993,0.289972461622951,2020-02-03,2020,2
"4507","PA",1,"Norte",15019,"Parauapebas",331080,78446.9845697717,6,106,25,81,51,55,0,0,0,0,0,106,25,81,51,55,19,11.270178319816,12.7101153169993,0.280535289236863,2020-02-10,2020,2
"4508","PA",1,"Norte",15019,"Parauapebas",331080,78446.9845697717,7,152,45,107,77,75,1,1,0,1,0,153,46,107,78,75,18,11.270178319816,12.7101153169993,0.299335522340067,2020-02-17,2020,2
"4509","PA",1,"Norte",15019,"Parauapebas",331080,78446.9845697717,8,144,38,106,76,68,0,0,0,0,0,144,38,106,76,68,32,11.270178319816,12.7101153169993,0.332786094524509,2020-02-24,2020,2
"4510","PA",1,"Norte",15019,"Parauapebas",331080,78446.9845697717,9,139,40,99,56,83,1,0,1,1,0,140,40,100,57,83,29,11.270178319816,12.7101153169993,0.312819359211859,2020-03-02,2020,3
"4511","PA",1,"Norte",15019,"Parauapebas",331080,78446.9845697717,10,122,31,91,59,63,0,0,0,0,0,122,31,91,59,63,32,11.270178319816,12.7101153169993,0.329373139146067,2020-03-09,2020,3
"4512","PA",1,"Norte",15019,"Parauapebas",331080,78446.9845697717,11,134,32,102,61,73,0,0,0,0,0,134,32,102,61,73,23,11.270178319816,12.7101153169993,0.38674568915107,2020-03-16,2020,3
"4513","PA",1,"Norte",15019,"Parauapebas",331080,78446.9845697717,12,128,38,90,56,72,0,0,0,0,0,128,38,90,56,72,24,11.270178319816,12.7101153169993,0.453890353206388,2020-03-23,2020,3
"4514","PA",1,"Norte",15019,"Parauapebas",331080,78446.9845697717,13,95,31,64,45,50,0,0,0,0,0,95,31,64,45,50,31,11.270178319816,12.7101153169993,0.402040072628019,2020-03-30,2020,3
"4515","PA",1,"Norte",15019,"Parauapebas",331080,78446.9845697717,14,111,35,76,43,68,1,0,1,1,0,112,35,77,44,68,24,11.270178319816,12.7101153169993,0.415748922540724,2020-04-06,2020,4
"4516","PA",1,"Norte",15019,"Parauapebas",331080,78446.9845697717,15,91,13,78,37,54,0,0,0,0,0,91,13,78,37,54,30,11.270178319816,12.7101153169993,0.43064289709207,2020-04-13,2020,4
"4517","PA",1,"Norte",15019,"Parauapebas",331080,78446.9845697717,16,135,33,102,62,73,1,0,1,1,0,136,33,103,63,73,32,11.270178319816,12.7101153169993,0.425902500647508,2020-04-20,2020,4
"4518","PA",1,"Norte",15019,"Parauapebas",331080,78446.9845697717,17,115,27,88,64,51,0,0,0,0,0,115,27,88,64,51,43,11.270178319816,12.7101153169993,0.415207258433926,2020-04-27,2020,4
"4519","PA",1,"Norte",15019,"Parauapebas",331080,78446.9845697717,18,95,31,64,38,57,0,0,0,0,0,95,31,64,38,57,43,11.270178319816,12.7101153169993,0.428944737242382,2020-05-04,2020,5
"4520","PA",1,"Norte",15019,"Parauapebas",331080,78446.9845697717,19,138,37,101,68,70,0,0,0,0,0,138,37,101,68,70,60,11.270178319816,12.7101153169993,0.434209001788329,2020-05-11,2020,5
"4521","PA",1,"Norte",15019,"Parauapebas",331080,78446.9845697717,20,143,35,108,64,79,1,0,1,1,0,144,35,109,65,79,51,11.270178319816,12.7101153169993,0.471342236263405,2020-05-18,2020,5
"4522","PA",1,"Norte",15019,"Parauapebas",331080,78446.9845697717,21,128,34,94,53,75,0,0,0,0,0,128,34,94,53,75,55,11.270178319816,12.7101153169993,0.416078220639232,2020-05-25,2020,5
"4523","PA",1,"Norte",15020,"Marabá",338296,28385.5278860525,5,100,24,76,49,51,1,1,0,1,0,101,25,76,50,51,38,10.2536347127915,12.7316765308739,0.284626906171127,2020-02-03,2020,2
"4524","PA",1,"Norte",15020,"Marabá",338296,28385.5278860525,6,93,27,66,47,46,2,1,1,2,0,95,28,67,49,46,37,10.2536347127915,12.7316765308739,0.283156753562498,2020-02-10,2020,2
"4525","PA",1,"Norte",15020,"Marabá",338296,28385.5278860525,7,90,35,55,43,47,1,0,1,0,1,91,35,56,43,48,36,10.2536347127915,12.7316765308739,0.293011331032104,2020-02-17,2020,2
"4526","PA",1,"Norte",15020,"Marabá",338296,28385.5278860525,8,111,34,77,49,62,1,1,0,1,0,112,35,77,50,62,33,10.2536347127915,12.7316765308739,0.336218281731969,2020-02-24,2020,2
"4527","PA",1,"Norte",15020,"Marabá",338296,28385.5278860525,9,100,34,66,43,57,0,0,0,0,0,100,34,66,43,57,26,10.2536347127915,12.7316765308739,0.308032568906159,2020-03-02,2020,3
"4528","PA",1,"Norte",15020,"Marabá",338296,28385.5278860525,10,95,27,68,40,55,0,0,0,0,0,95,27,68,40,55,39,10.2536347127915,12.7316765308739,0.327030855831541,2020-03-09,2020,3
"4529","PA",1,"Norte",15020,"Marabá",338296,28385.5278860525,11,106,30,76,45,61,1,1,0,0,1,107,31,76,45,62,44,10.2536347127915,12.7316765308739,0.36978250943249,2020-03-16,2020,3
"4530","PA",1,"Norte",15020,"Marabá",338296,28385.5278860525,12,93,33,60,42,51,0,0,0,0,0,93,33,60,42,51,27,10.2536347127915,12.7316765308739,0.466646934162288,2020-03-23,2020,3
"4531","PA",1,"Norte",15020,"Marabá",338296,28385.5278860525,13,84,22,62,45,39,0,0,0,0,0,84,22,62,45,39,35,10.2536347127915,12.7316765308739,0.429290222764726,2020-03-30,2020,3
"4532","PA",1,"Norte",15020,"Marabá",338296,28385.5278860525,14,101,31,70,55,46,0,0,0,0,0,101,31,70,55,46,34,10.2536347127915,12.7316765308739,0.429393146128111,2020-04-06,2020,4
"4533","PA",1,"Norte",15020,"Marabá",338296,28385.5278860525,15,87,36,51,40,47,0,0,0,0,0,87,36,51,40,47,23,10.2536347127915,12.7316765308739,0.411276477067173,2020-04-13,2020,4
"4534","PA",1,"Norte",15020,"Marabá",338296,28385.5278860525,16,100,32,68,47,53,0,0,0,0,0,100,32,68,47,53,35,10.2536347127915,12.7316765308739,0.415779763037861,2020-04-20,2020,4
"4535","PA",1,"Norte",15020,"Marabá",338296,28385.5278860525,17,95,25,70,46,49,0,0,0,0,0,95,25,70,46,49,45,10.2536347127915,12.7316765308739,0.426239190807972,2020-04-27,2020,4
"4536","PA",1,"Norte",15020,"Marabá",338296,28385.5278860525,18,79,28,51,36,43,0,0,0,0,0,79,28,51,36,43,68,10.2536347127915,12.7316765308739,0.421317072953292,2020-05-04,2020,5
"4537","PA",1,"Norte",15020,"Marabá",338296,28385.5278860525,19,82,30,52,40,42,1,1,0,1,0,83,31,52,41,42,70,10.2536347127915,12.7316765308739,0.444403642996475,2020-05-11,2020,5
"4538","PA",1,"Norte",15020,"Marabá",338296,28385.5278860525,20,77,26,51,37,40,1,0,1,0,1,78,26,52,37,41,80,10.2536347127915,12.7316765308739,0.435593068278907,2020-05-18,2020,5
"4539","PA",1,"Norte",15020,"Marabá",338296,28385.5278860525,21,96,38,58,53,43,0,0,0,0,0,96,38,58,53,43,50,10.2536347127915,12.7316765308739,0.414012429612116,2020-05-25,2020,5
"4540","PA",1,"Norte",15021,"Redenção",197953,22576.0017842114,5,66,29,37,39,27,0,0,0,0,0,66,29,37,39,27,21,10.0246427531239,12.1957849077617,0.280898563210333,2020-02-03,2020,2
"4541","PA",1,"Norte",15021,"Redenção",197953,22576.0017842114,6,55,23,32,30,25,1,0,1,1,0,56,23,33,31,25,21,10.0246427531239,12.1957849077617,0.266285433414363,2020-02-10,2020,2
"4542","PA",1,"Norte",15021,"Redenção",197953,22576.0017842114,7,80,37,43,45,35,0,0,0,0,0,80,37,43,45,35,26,10.0246427531239,12.1957849077617,0.283829066889872,2020-02-17,2020,2
"4543","PA",1,"Norte",15021,"Redenção",197953,22576.0017842114,8,70,31,39,46,24,0,0,0,0,0,70,31,39,46,24,36,10.0246427531239,12.1957849077617,0.314455238308104,2020-02-24,2020,2
"4544","PA",1,"Norte",15021,"Redenção",197953,22576.0017842114,9,65,21,44,40,25,0,0,0,0,0,65,21,44,40,25,19,10.0246427531239,12.1957849077617,0.302411459521132,2020-03-02,2020,3
"4545","PA",1,"Norte",15021,"Redenção",197953,22576.0017842114,10,85,30,55,50,35,1,1,0,1,0,86,31,55,51,35,26,10.0246427531239,12.1957849077617,0.314760418570913,2020-03-09,2020,3
"4546","PA",1,"Norte",15021,"Redenção",197953,22576.0017842114,11,64,21,43,42,22,0,0,0,0,0,64,21,43,42,22,22,10.0246427531239,12.1957849077617,0.374898744535141,2020-03-16,2020,3
"4547","PA",1,"Norte",15021,"Redenção",197953,22576.0017842114,12,56,23,33,38,18,1,0,1,0,1,57,23,34,38,19,21,10.0246427531239,12.1957849077617,0.451354851733651,2020-03-23,2020,3
"4548","PA",1,"Norte",15021,"Redenção",197953,22576.0017842114,13,60,23,37,40,20,1,0,1,0,1,61,23,38,40,21,28,10.0246427531239,12.1957849077617,0.393056705444128,2020-03-30,2020,3
"4549","PA",1,"Norte",15021,"Redenção",197953,22576.0017842114,14,74,26,48,47,27,0,0,0,0,0,74,26,48,47,27,18,10.0246427531239,12.1957849077617,0.39526622216979,2020-04-06,2020,4
"4550","PA",1,"Norte",15021,"Redenção",197953,22576.0017842114,15,55,22,33,26,29,1,1,0,0,1,56,23,33,26,30,19,10.0246427531239,12.1957849077617,0.370518474615717,2020-04-13,2020,4
"4551","PA",1,"Norte",15021,"Redenção",197953,22576.0017842114,16,55,17,38,31,24,0,0,0,0,0,55,17,38,31,24,14,10.0246427531239,12.1957849077617,0.37913683564973,2020-04-20,2020,4
"4552","PA",1,"Norte",15021,"Redenção",197953,22576.0017842114,17,65,24,41,38,27,0,0,0,0,0,65,24,41,38,27,27,10.0246427531239,12.1957849077617,0.379990669276066,2020-04-27,2020,4
"4553","PA",1,"Norte",15021,"Redenção",197953,22576.0017842114,18,70,28,42,43,27,0,0,0,0,0,70,28,42,43,27,20,10.0246427531239,12.1957849077617,0.381633048394349,2020-05-04,2020,5
"4554","PA",1,"Norte",15021,"Redenção",197953,22576.0017842114,19,65,32,33,35,30,1,0,1,1,0,66,32,34,36,30,20,10.0246427531239,12.1957849077617,0.395249191642926,2020-05-11,2020,5
"4555","PA",1,"Norte",15021,"Redenção",197953,22576.0017842114,20,63,23,40,40,23,0,0,0,0,0,63,23,40,40,23,27,10.0246427531239,12.1957849077617,0.388566448912931,2020-05-18,2020,5
"4556","PA",1,"Norte",15021,"Redenção",197953,22576.0017842114,21,69,26,43,35,34,0,0,0,0,0,69,26,43,35,34,30,10.0246427531239,12.1957849077617,0.381909809170507,2020-05-25,2020,5
"4557","PA",1,"Norte",15022,"Conceição do Araguaia",164785,13227.591836939,5,20,7,13,8,12,0,0,0,0,0,20,7,13,8,12,16,9.49006021763372,12.0123968728975,0.290388614097466,2020-02-03,2020,2
"4558","PA",1,"Norte",15022,"Conceição do Araguaia",164785,13227.591836939,6,27,10,17,19,8,0,0,0,0,0,27,10,17,19,8,12,9.49006021763372,12.0123968728975,0.27598205029996,2020-02-10,2020,2
"4559","PA",1,"Norte",15022,"Conceição do Araguaia",164785,13227.591836939,7,42,7,35,21,21,1,1,0,1,0,43,8,35,22,21,14,9.49006021763372,12.0123968728975,0.299644131063872,2020-02-17,2020,2
"4560","PA",1,"Norte",15022,"Conceição do Araguaia",164785,13227.591836939,8,32,10,22,14,18,0,0,0,0,0,32,10,22,14,18,19,9.49006021763372,12.0123968728975,0.324259170674907,2020-02-24,2020,2
"4561","PA",1,"Norte",15022,"Conceição do Araguaia",164785,13227.591836939,9,19,5,14,16,3,0,0,0,0,0,19,5,14,16,3,16,9.49006021763372,12.0123968728975,0.307275686048618,2020-03-02,2020,3
"4562","PA",1,"Norte",15022,"Conceição do Araguaia",164785,13227.591836939,10,45,13,32,33,12,1,1,0,1,0,46,14,32,34,12,5,9.49006021763372,12.0123968728975,0.321644271432516,2020-03-09,2020,3
"4563","PA",1,"Norte",15022,"Conceição do Araguaia",164785,13227.591836939,11,20,10,10,11,9,0,0,0,0,0,20,10,10,11,9,11,9.49006021763372,12.0123968728975,0.383100391049928,2020-03-16,2020,3
"4564","PA",1,"Norte",15022,"Conceição do Araguaia",164785,13227.591836939,12,27,3,24,11,16,0,0,0,0,0,27,3,24,11,16,13,9.49006021763372,12.0123968728975,0.452981573732904,2020-03-23,2020,3
"4565","PA",1,"Norte",15022,"Conceição do Araguaia",164785,13227.591836939,13,20,5,15,7,13,0,0,0,0,0,20,5,15,7,13,12,9.49006021763372,12.0123968728975,0.398630998828265,2020-03-30,2020,3
"4566","PA",1,"Norte",15022,"Conceição do Araguaia",164785,13227.591836939,14,29,10,19,22,7,1,1,0,1,0,30,11,19,23,7,8,9.49006021763372,12.0123968728975,0.396296339508823,2020-04-06,2020,4
"4567","PA",1,"Norte",15022,"Conceição do Araguaia",164785,13227.591836939,15,31,14,17,20,11,0,0,0,0,0,31,14,17,20,11,12,9.49006021763372,12.0123968728975,0.393967474003038,2020-04-13,2020,4
"4568","PA",1,"Norte",15022,"Conceição do Araguaia",164785,13227.591836939,16,26,10,16,14,12,0,0,0,0,0,26,10,16,14,12,10,9.49006021763372,12.0123968728975,0.383465881426614,2020-04-20,2020,4
"4569","PA",1,"Norte",15022,"Conceição do Araguaia",164785,13227.591836939,17,30,9,21,10,20,0,0,0,0,0,30,9,21,10,20,11,9.49006021763372,12.0123968728975,0.385748870877105,2020-04-27,2020,4
"4570","PA",1,"Norte",15022,"Conceição do Araguaia",164785,13227.591836939,18,19,5,14,11,8,1,0,1,1,0,20,5,15,12,8,8,9.49006021763372,12.0123968728975,0.395570451551184,2020-05-04,2020,5
"4571","PA",1,"Norte",15022,"Conceição do Araguaia",164785,13227.591836939,19,40,14,26,23,17,3,2,1,0,3,43,16,27,23,20,13,9.49006021763372,12.0123968728975,0.402825419539652,2020-05-11,2020,5
"4572","PA",1,"Norte",15022,"Conceição do Araguaia",164785,13227.591836939,20,26,9,17,17,9,0,0,0,0,0,26,9,17,17,9,13,9.49006021763372,12.0123968728975,0.401270637842299,2020-05-18,2020,5
"4573","PA",1,"Norte",15022,"Conceição do Araguaia",164785,13227.591836939,21,25,8,17,14,11,0,0,0,0,0,25,8,17,14,11,14,9.49006021763372,12.0123968728975,0.383995604362302,2020-05-25,2020,5
"4574","PB",2,"Nordeste",25001,"Catolé do Rocha",123679,11018.5955039255,5,22,12,10,9,13,0,0,0,0,0,22,12,10,9,13,16,9.30733962484997,11.7254447784069,0.253374359814975,2020-02-03,2020,2
"4575","PB",2,"Nordeste",25001,"Catolé do Rocha",123679,11018.5955039255,6,32,15,17,11,21,0,0,0,0,0,32,15,17,11,21,18,9.30733962484997,11.7254447784069,0.256172406778808,2020-02-10,2020,2
"4576","PB",2,"Nordeste",25001,"Catolé do Rocha",123679,11018.5955039255,7,19,11,8,9,10,0,0,0,0,0,19,11,8,9,10,14,9.30733962484997,11.7254447784069,0.256227877582462,2020-02-17,2020,2
"4577","PB",2,"Nordeste",25001,"Catolé do Rocha",123679,11018.5955039255,8,26,10,16,10,16,0,0,0,0,0,26,10,16,10,16,19,9.30733962484997,11.7254447784069,0.301502019591449,2020-02-24,2020,2
"4578","PB",2,"Nordeste",25001,"Catolé do Rocha",123679,11018.5955039255,9,30,18,12,15,15,0,0,0,0,0,30,18,12,15,15,14,9.30733962484997,11.7254447784069,0.277582540625512,2020-03-02,2020,3
"4579","PB",2,"Nordeste",25001,"Catolé do Rocha",123679,11018.5955039255,10,26,11,15,7,19,1,1,0,0,1,27,12,15,7,20,20,9.30733962484997,11.7254447784069,0.296515851514714,2020-03-09,2020,3
"4580","PB",2,"Nordeste",25001,"Catolé do Rocha",123679,11018.5955039255,11,27,11,16,13,14,0,0,0,0,0,27,11,16,13,14,21,9.30733962484997,11.7254447784069,0.350758402345663,2020-03-16,2020,3
"4581","PB",2,"Nordeste",25001,"Catolé do Rocha",123679,11018.5955039255,12,29,12,17,18,11,0,0,0,0,0,29,12,17,18,11,16,9.30733962484997,11.7254447784069,0.451345119916974,2020-03-23,2020,3
"4582","PB",2,"Nordeste",25001,"Catolé do Rocha",123679,11018.5955039255,13,23,10,13,11,12,0,0,0,0,0,23,10,13,11,12,10,9.30733962484997,11.7254447784069,0.404432189245589,2020-03-30,2020,3
"4583","PB",2,"Nordeste",25001,"Catolé do Rocha",123679,11018.5955039255,14,18,9,9,9,9,0,0,0,0,0,18,9,9,9,9,13,9.30733962484997,11.7254447784069,0.376714216525395,2020-04-06,2020,4
"4584","PB",2,"Nordeste",25001,"Catolé do Rocha",123679,11018.5955039255,15,24,13,11,11,13,0,0,0,0,0,24,13,11,11,13,18,9.30733962484997,11.7254447784069,0.369489090429261,2020-04-13,2020,4
"4585","PB",2,"Nordeste",25001,"Catolé do Rocha",123679,11018.5955039255,16,35,12,23,15,20,1,0,1,0,1,36,12,24,15,21,16,9.30733962484997,11.7254447784069,0.354534435448846,2020-04-20,2020,4
"4586","PB",2,"Nordeste",25001,"Catolé do Rocha",123679,11018.5955039255,17,33,11,22,15,18,0,0,0,0,0,33,11,22,15,18,14,9.30733962484997,11.7254447784069,0.348035194681225,2020-04-27,2020,4
"4587","PB",2,"Nordeste",25001,"Catolé do Rocha",123679,11018.5955039255,18,29,16,13,8,21,0,0,0,0,0,29,16,13,8,21,20,9.30733962484997,11.7254447784069,0.361380863674611,2020-05-04,2020,5
"4588","PB",2,"Nordeste",25001,"Catolé do Rocha",123679,11018.5955039255,19,37,18,19,17,20,0,0,0,0,0,37,18,19,17,20,18,9.30733962484997,11.7254447784069,0.394219766117095,2020-05-11,2020,5
"4589","PB",2,"Nordeste",25001,"Catolé do Rocha",123679,11018.5955039255,20,35,16,19,18,17,0,0,0,0,0,35,16,19,18,17,23,9.30733962484997,11.7254447784069,0.408028554417897,2020-05-18,2020,5
"4590","PB",2,"Nordeste",25001,"Catolé do Rocha",123679,11018.5955039255,21,34,11,23,15,19,1,1,0,1,0,35,12,23,16,19,19,9.30733962484997,11.7254447784069,0.400193207465651,2020-05-25,2020,5
"4591","PB",2,"Nordeste",25002,"Cajazeiras",178104,12329.1720102861,5,42,14,28,17,25,0,0,0,0,0,42,14,28,17,25,19,9.41972344145313,12.0901229283181,0.270394388607313,2020-02-03,2020,2
"4592","PB",2,"Nordeste",25002,"Cajazeiras",178104,12329.1720102861,6,44,14,30,18,26,0,0,0,0,0,44,14,30,18,26,19,9.41972344145313,12.0901229283181,0.254072571506585,2020-02-10,2020,2
"4593","PB",2,"Nordeste",25002,"Cajazeiras",178104,12329.1720102861,7,41,17,24,17,24,0,0,0,0,0,41,17,24,17,24,38,9.41972344145313,12.0901229283181,0.270032724937838,2020-02-17,2020,2
"4594","PB",2,"Nordeste",25002,"Cajazeiras",178104,12329.1720102861,8,43,19,24,13,30,0,0,0,0,0,43,19,24,13,30,24,9.41972344145313,12.0901229283181,0.312176043083812,2020-02-24,2020,2
"4595","PB",2,"Nordeste",25002,"Cajazeiras",178104,12329.1720102861,9,41,22,19,16,25,0,0,0,0,0,41,22,19,16,25,27,9.41972344145313,12.0901229283181,0.292429959657721,2020-03-02,2020,3
"4596","PB",2,"Nordeste",25002,"Cajazeiras",178104,12329.1720102861,10,48,14,34,22,26,0,0,0,0,0,48,14,34,22,26,22,9.41972344145313,12.0901229283181,0.313881701397909,2020-03-09,2020,3
"4597","PB",2,"Nordeste",25002,"Cajazeiras",178104,12329.1720102861,11,41,9,32,11,30,1,1,0,0,1,42,10,32,11,31,21,9.41972344145313,12.0901229283181,0.381185581438535,2020-03-16,2020,3
"4598","PB",2,"Nordeste",25002,"Cajazeiras",178104,12329.1720102861,12,35,14,21,11,24,1,0,1,1,0,36,14,22,12,24,29,9.41972344145313,12.0901229283181,0.485062207631772,2020-03-23,2020,3
"4599","PB",2,"Nordeste",25002,"Cajazeiras",178104,12329.1720102861,13,19,5,14,10,9,1,0,1,0,1,20,5,15,10,10,28,9.41972344145313,12.0901229283181,0.437366630184063,2020-03-30,2020,3
"4600","PB",2,"Nordeste",25002,"Cajazeiras",178104,12329.1720102861,14,18,7,11,8,10,0,0,0,0,0,18,7,11,8,10,29,9.41972344145313,12.0901229283181,0.417296560182764,2020-04-06,2020,4
"4601","PB",2,"Nordeste",25002,"Cajazeiras",178104,12329.1720102861,15,26,7,19,9,17,0,0,0,0,0,26,7,19,9,17,24,9.41972344145313,12.0901229283181,0.400914672713107,2020-04-13,2020,4
"4602","PB",2,"Nordeste",25002,"Cajazeiras",178104,12329.1720102861,16,30,14,16,16,14,0,0,0,0,0,30,14,16,16,14,24,9.41972344145313,12.0901229283181,0.390462239308828,2020-04-20,2020,4
"4603","PB",2,"Nordeste",25002,"Cajazeiras",178104,12329.1720102861,17,38,8,30,15,23,0,0,0,0,0,38,8,30,15,23,28,9.41972344145313,12.0901229283181,0.390459770882603,2020-04-27,2020,4
"4604","PB",2,"Nordeste",25002,"Cajazeiras",178104,12329.1720102861,18,27,11,16,15,12,0,0,0,0,0,27,11,16,15,12,22,9.41972344145313,12.0901229283181,0.399457227998263,2020-05-04,2020,5
"4605","PB",2,"Nordeste",25002,"Cajazeiras",178104,12329.1720102861,19,53,27,26,26,27,0,0,0,0,0,53,27,26,26,27,26,9.41972344145313,12.0901229283181,0.429814678505884,2020-05-11,2020,5
"4606","PB",2,"Nordeste",25002,"Cajazeiras",178104,12329.1720102861,20,48,23,25,23,25,0,0,0,0,0,48,23,25,23,25,22,9.41972344145313,12.0901229283181,0.417849445068405,2020-05-18,2020,5
"4607","PB",2,"Nordeste",25002,"Cajazeiras",178104,12329.1720102861,21,53,19,34,22,31,0,0,0,0,0,53,19,34,22,31,24,9.41972344145313,12.0901229283181,0.403840629658913,2020-05-25,2020,5
"4608","PB",2,"Nordeste",25003,"Sousa",190043,12301.1284292502,5,48,16,32,19,29,0,0,0,0,0,48,16,32,19,29,22,9.41744627936791,12.1550056413265,0.271388408701599,2020-02-03,2020,2
"4609","PB",2,"Nordeste",25003,"Sousa",190043,12301.1284292502,6,43,11,32,16,27,1,1,0,1,0,44,12,32,17,27,28,9.41744627936791,12.1550056413265,0.264754257706443,2020-02-10,2020,2
"4610","PB",2,"Nordeste",25003,"Sousa",190043,12301.1284292502,7,41,15,26,18,23,0,0,0,0,0,41,15,26,18,23,25,9.41744627936791,12.1550056413265,0.273956168618582,2020-02-17,2020,2
"4611","PB",2,"Nordeste",25003,"Sousa",190043,12301.1284292502,8,51,17,34,18,33,0,0,0,0,0,51,17,34,18,33,30,9.41744627936791,12.1550056413265,0.313529975391328,2020-02-24,2020,2
"4612","PB",2,"Nordeste",25003,"Sousa",190043,12301.1284292502,9,60,19,41,27,33,1,0,1,0,1,61,19,42,27,34,29,9.41744627936791,12.1550056413265,0.291217336507688,2020-03-02,2020,3
"4613","PB",2,"Nordeste",25003,"Sousa",190043,12301.1284292502,10,46,17,29,20,26,0,0,0,0,0,46,17,29,20,26,23,9.41744627936791,12.1550056413265,0.331670763395924,2020-03-09,2020,3
"4614","PB",2,"Nordeste",25003,"Sousa",190043,12301.1284292502,11,57,16,41,19,38,0,0,0,0,0,57,16,41,19,38,29,9.41744627936791,12.1550056413265,0.385247986108107,2020-03-16,2020,3
"4615","PB",2,"Nordeste",25003,"Sousa",190043,12301.1284292502,12,39,13,26,16,23,1,0,1,0,1,40,13,27,16,24,30,9.41744627936791,12.1550056413265,0.488329920119585,2020-03-23,2020,3
"4616","PB",2,"Nordeste",25003,"Sousa",190043,12301.1284292502,13,42,13,29,18,24,2,1,1,0,2,44,14,30,18,26,27,9.41744627936791,12.1550056413265,0.431587298746065,2020-03-30,2020,3
"4617","PB",2,"Nordeste",25003,"Sousa",190043,12301.1284292502,14,45,14,31,25,20,1,1,0,0,1,46,15,31,25,21,34,9.41744627936791,12.1550056413265,0.404277010194176,2020-04-06,2020,4
"4618","PB",2,"Nordeste",25003,"Sousa",190043,12301.1284292502,15,47,12,35,15,32,0,0,0,0,0,47,12,35,15,32,30,9.41744627936791,12.1550056413265,0.378910106736208,2020-04-13,2020,4
"4619","PB",2,"Nordeste",25003,"Sousa",190043,12301.1284292502,16,49,10,39,19,30,0,0,0,0,0,49,10,39,19,30,18,9.41744627936791,12.1550056413265,0.378541479469023,2020-04-20,2020,4
"4620","PB",2,"Nordeste",25003,"Sousa",190043,12301.1284292502,17,35,8,27,14,21,1,1,0,0,1,36,9,27,14,22,27,9.41744627936791,12.1550056413265,0.377249837730519,2020-04-27,2020,4
"4621","PB",2,"Nordeste",25003,"Sousa",190043,12301.1284292502,18,48,14,34,15,33,0,0,0,0,0,48,14,34,15,33,29,9.41744627936791,12.1550056413265,0.385577664795736,2020-05-04,2020,5
"4622","PB",2,"Nordeste",25003,"Sousa",190043,12301.1284292502,19,37,12,25,12,25,0,0,0,0,0,37,12,25,12,25,24,9.41744627936791,12.1550056413265,0.436976044463039,2020-05-11,2020,5
"4623","PB",2,"Nordeste",25003,"Sousa",190043,12301.1284292502,20,44,10,34,17,27,0,0,0,0,0,44,10,34,17,27,26,9.41744627936791,12.1550056413265,0.426523197126573,2020-05-18,2020,5
"4624","PB",2,"Nordeste",25003,"Sousa",190043,12301.1284292502,21,51,11,40,21,30,0,0,0,0,0,51,11,40,21,30,22,9.41744627936791,12.1550056413265,0.403942588151091,2020-05-25,2020,5
"4625","PB",2,"Nordeste",25004,"Patos",135227,14842.9946729573,5,32,8,24,14,18,0,0,0,0,0,32,8,24,14,18,22,9.60528329373211,11.8147101267948,0.257709763761868,2020-02-03,2020,2
"4626","PB",2,"Nordeste",25004,"Patos",135227,14842.9946729573,6,33,7,26,7,26,0,0,0,0,0,33,7,26,7,26,14,9.60528329373211,11.8147101267948,0.263582629233488,2020-02-10,2020,2
"4627","PB",2,"Nordeste",25004,"Patos",135227,14842.9946729573,7,37,9,28,17,20,0,0,0,0,0,37,9,28,17,20,14,9.60528329373211,11.8147101267948,0.269412219907254,2020-02-17,2020,2
"4628","PB",2,"Nordeste",25004,"Patos",135227,14842.9946729573,8,29,4,25,11,18,1,1,0,0,1,30,5,25,11,19,12,9.60528329373211,11.8147101267948,0.314405049524987,2020-02-24,2020,2
"4629","PB",2,"Nordeste",25004,"Patos",135227,14842.9946729573,9,34,6,28,11,23,0,0,0,0,0,34,6,28,11,23,21,9.60528329373211,11.8147101267948,0.282196348762837,2020-03-02,2020,3
"4630","PB",2,"Nordeste",25004,"Patos",135227,14842.9946729573,10,27,3,24,8,19,1,1,0,0,1,28,4,24,8,20,24,9.60528329373211,11.8147101267948,0.309378266322819,2020-03-09,2020,3
"4631","PB",2,"Nordeste",25004,"Patos",135227,14842.9946729573,11,33,11,22,17,16,0,0,0,0,0,33,11,22,17,16,14,9.60528329373211,11.8147101267948,0.372405615978831,2020-03-16,2020,3
"4632","PB",2,"Nordeste",25004,"Patos",135227,14842.9946729573,12,28,5,23,10,18,0,0,0,0,0,28,5,23,10,18,12,9.60528329373211,11.8147101267948,0.495419310694604,2020-03-23,2020,3
"4633","PB",2,"Nordeste",25004,"Patos",135227,14842.9946729573,13,28,6,22,15,13,0,0,0,0,0,28,6,22,15,13,17,9.60528329373211,11.8147101267948,0.459913578876517,2020-03-30,2020,3
"4634","PB",2,"Nordeste",25004,"Patos",135227,14842.9946729573,14,32,4,28,11,21,0,0,0,0,0,32,4,28,11,21,21,9.60528329373211,11.8147101267948,0.439158242569783,2020-04-06,2020,4
"4635","PB",2,"Nordeste",25004,"Patos",135227,14842.9946729573,15,25,3,22,7,18,1,0,1,0,1,26,3,23,7,19,16,9.60528329373211,11.8147101267948,0.40490610723836,2020-04-13,2020,4
"4636","PB",2,"Nordeste",25004,"Patos",135227,14842.9946729573,16,29,3,26,13,16,0,0,0,0,0,29,3,26,13,16,11,9.60528329373211,11.8147101267948,0.39996326326422,2020-04-20,2020,4
"4637","PB",2,"Nordeste",25004,"Patos",135227,14842.9946729573,17,27,6,21,14,13,1,0,1,0,1,28,6,22,14,14,25,9.60528329373211,11.8147101267948,0.38445121423031,2020-04-27,2020,4
"4638","PB",2,"Nordeste",25004,"Patos",135227,14842.9946729573,18,36,6,30,15,21,0,0,0,0,0,36,6,30,15,21,23,9.60528329373211,11.8147101267948,0.417914875398511,2020-05-04,2020,5
"4639","PB",2,"Nordeste",25004,"Patos",135227,14842.9946729573,19,32,8,24,7,25,1,1,0,1,0,33,9,24,8,25,22,9.60528329373211,11.8147101267948,0.463746405226841,2020-05-11,2020,5
"4640","PB",2,"Nordeste",25004,"Patos",135227,14842.9946729573,20,33,11,22,13,20,1,1,0,0,1,34,12,22,13,21,32,9.60528329373211,11.8147101267948,0.441487672242793,2020-05-18,2020,5
"4641","PB",2,"Nordeste",25004,"Patos",135227,14842.9946729573,21,35,9,26,10,25,0,0,0,0,0,35,9,26,10,25,24,9.60528329373211,11.8147101267948,0.416587071785337,2020-05-25,2020,5
"4642","PB",2,"Nordeste",25005,"Piancó",71129,9361.78627100058,5,11,4,7,7,4,0,0,0,0,0,11,4,7,7,4,6,9.14439139218269,11.1722504088631,0.293314277795694,2020-02-03,2020,2
"4643","PB",2,"Nordeste",25005,"Piancó",71129,9361.78627100058,6,14,3,11,5,9,0,0,0,0,0,14,3,11,5,9,3,9.14439139218269,11.1722504088631,0.27216059685313,2020-02-10,2020,2
"4644","PB",2,"Nordeste",25005,"Piancó",71129,9361.78627100058,7,12,5,7,5,7,0,0,0,0,0,12,5,7,5,7,10,9.14439139218269,11.1722504088631,0.267024201083922,2020-02-17,2020,2
"4645","PB",2,"Nordeste",25005,"Piancó",71129,9361.78627100058,8,20,6,14,8,12,0,0,0,0,0,20,6,14,8,12,11,9.14439139218269,11.1722504088631,0.317750973839043,2020-02-24,2020,2
"4646","PB",2,"Nordeste",25005,"Piancó",71129,9361.78627100058,9,20,7,13,11,9,0,0,0,0,0,20,7,13,11,9,8,9.14439139218269,11.1722504088631,0.30222921282258,2020-03-02,2020,3
"4647","PB",2,"Nordeste",25005,"Piancó",71129,9361.78627100058,10,12,7,5,6,6,0,0,0,0,0,12,7,5,6,6,10,9.14439139218269,11.1722504088631,0.315416543745718,2020-03-09,2020,3
"4648","PB",2,"Nordeste",25005,"Piancó",71129,9361.78627100058,11,11,5,6,2,9,0,0,0,0,0,11,5,6,2,9,9,9.14439139218269,11.1722504088631,0.375781394278375,2020-03-16,2020,3
"4649","PB",2,"Nordeste",25005,"Piancó",71129,9361.78627100058,12,11,2,9,1,10,0,0,0,0,0,11,2,9,1,10,11,9.14439139218269,11.1722504088631,0.476393757381294,2020-03-23,2020,3
"4650","PB",2,"Nordeste",25005,"Piancó",71129,9361.78627100058,13,19,8,11,8,11,0,0,0,0,0,19,8,11,8,11,12,9.14439139218269,11.1722504088631,0.42562495225775,2020-03-30,2020,3
"4651","PB",2,"Nordeste",25005,"Piancó",71129,9361.78627100058,14,13,1,12,3,10,0,0,0,0,0,13,1,12,3,10,11,9.14439139218269,11.1722504088631,0.407444363218269,2020-04-06,2020,4
"4652","PB",2,"Nordeste",25005,"Piancó",71129,9361.78627100058,15,13,3,10,7,6,0,0,0,0,0,13,3,10,7,6,13,9.14439139218269,11.1722504088631,0.374920779159848,2020-04-13,2020,4
"4653","PB",2,"Nordeste",25005,"Piancó",71129,9361.78627100058,16,17,2,15,8,9,0,0,0,0,0,17,2,15,8,9,11,9.14439139218269,11.1722504088631,0.362085988991814,2020-04-20,2020,4
"4654","PB",2,"Nordeste",25005,"Piancó",71129,9361.78627100058,17,19,8,11,8,11,0,0,0,0,0,19,8,11,8,11,6,9.14439139218269,11.1722504088631,0.368045461395773,2020-04-27,2020,4
"4655","PB",2,"Nordeste",25005,"Piancó",71129,9361.78627100058,18,18,2,16,9,9,1,0,1,0,1,19,2,17,9,10,13,9.14439139218269,11.1722504088631,0.405476679377431,2020-05-04,2020,5
"4656","PB",2,"Nordeste",25005,"Piancó",71129,9361.78627100058,19,17,5,12,5,12,0,0,0,0,0,17,5,12,5,12,13,9.14439139218269,11.1722504088631,0.421736427595971,2020-05-11,2020,5
"4657","PB",2,"Nordeste",25005,"Piancó",71129,9361.78627100058,20,21,11,10,9,12,0,0,0,0,0,21,11,10,9,12,9,9.14439139218269,11.1722504088631,0.402768490609089,2020-05-18,2020,5
"4658","PB",2,"Nordeste",25005,"Piancó",71129,9361.78627100058,21,15,4,11,6,9,1,1,0,1,0,16,5,11,7,9,10,9.14439139218269,11.1722504088631,0.379984595861457,2020-05-25,2020,5
"4659","PB",2,"Nordeste",25006,"Itaporanga",85901,9315.24073573067,5,25,9,16,10,15,0,0,0,0,0,25,9,16,10,15,9,9.1394071265805,11.3609507493481,0.263863293050142,2020-02-03,2020,2
"4660","PB",2,"Nordeste",25006,"Itaporanga",85901,9315.24073573067,6,22,6,16,9,13,0,0,0,0,0,22,6,16,9,13,8,9.1394071265805,11.3609507493481,0.255022510708751,2020-02-10,2020,2
"4661","PB",2,"Nordeste",25006,"Itaporanga",85901,9315.24073573067,7,21,8,13,8,13,0,0,0,0,0,21,8,13,8,13,8,9.1394071265805,11.3609507493481,0.256286499215971,2020-02-17,2020,2
"4662","PB",2,"Nordeste",25006,"Itaporanga",85901,9315.24073573067,8,18,10,8,11,7,0,0,0,0,0,18,10,8,11,7,8,9.1394071265805,11.3609507493481,0.29962355805646,2020-02-24,2020,2
"4663","PB",2,"Nordeste",25006,"Itaporanga",85901,9315.24073573067,9,22,11,11,10,12,0,0,0,0,0,22,11,11,10,12,7,9.1394071265805,11.3609507493481,0.293049756367073,2020-03-02,2020,3
"4664","PB",2,"Nordeste",25006,"Itaporanga",85901,9315.24073573067,10,13,5,8,5,8,1,0,1,1,0,14,5,9,6,8,5,9.1394071265805,11.3609507493481,0.316496976801919,2020-03-09,2020,3
"4665","PB",2,"Nordeste",25006,"Itaporanga",85901,9315.24073573067,11,14,5,9,7,7,0,0,0,0,0,14,5,9,7,7,11,9.1394071265805,11.3609507493481,0.35942443886632,2020-03-16,2020,3
"4666","PB",2,"Nordeste",25006,"Itaporanga",85901,9315.24073573067,12,19,8,11,7,12,0,0,0,0,0,19,8,11,7,12,12,9.1394071265805,11.3609507493481,0.467509969257491,2020-03-23,2020,3
"4667","PB",2,"Nordeste",25006,"Itaporanga",85901,9315.24073573067,13,18,5,13,6,12,0,0,0,0,0,18,5,13,6,12,13,9.1394071265805,11.3609507493481,0.400954888621909,2020-03-30,2020,3
"4668","PB",2,"Nordeste",25006,"Itaporanga",85901,9315.24073573067,14,16,2,14,10,6,0,0,0,0,0,16,2,14,10,6,13,9.1394071265805,11.3609507493481,0.383792191543871,2020-04-06,2020,4
"4669","PB",2,"Nordeste",25006,"Itaporanga",85901,9315.24073573067,15,24,7,17,10,14,1,1,0,1,0,25,8,17,11,14,11,9.1394071265805,11.3609507493481,0.381002048796573,2020-04-13,2020,4
"4670","PB",2,"Nordeste",25006,"Itaporanga",85901,9315.24073573067,16,19,3,16,7,12,0,0,0,0,0,19,3,16,7,12,15,9.1394071265805,11.3609507493481,0.368427942271718,2020-04-20,2020,4
"4671","PB",2,"Nordeste",25006,"Itaporanga",85901,9315.24073573067,17,16,7,9,8,8,0,0,0,0,0,16,7,9,8,8,7,9.1394071265805,11.3609507493481,0.37583933552178,2020-04-27,2020,4
"4672","PB",2,"Nordeste",25006,"Itaporanga",85901,9315.24073573067,18,20,8,12,9,11,0,0,0,0,0,20,8,12,9,11,8,9.1394071265805,11.3609507493481,0.398542651754977,2020-05-04,2020,5
"4673","PB",2,"Nordeste",25006,"Itaporanga",85901,9315.24073573067,19,22,11,11,15,7,0,0,0,0,0,22,11,11,15,7,12,9.1394071265805,11.3609507493481,0.408734644169093,2020-05-11,2020,5
"4674","PB",2,"Nordeste",25006,"Itaporanga",85901,9315.24073573067,20,18,7,11,5,13,0,0,0,0,0,18,7,11,5,13,11,9.1394071265805,11.3609507493481,0.415604973809994,2020-05-18,2020,5
"4675","PB",2,"Nordeste",25006,"Itaporanga",85901,9315.24073573067,21,22,9,13,7,15,0,0,0,0,0,22,9,13,7,15,5,9.1394071265805,11.3609507493481,0.39771668680656,2020-05-25,2020,5
"4676","PB",2,"Nordeste",25007,"Serra do Teixeira",122625,8105.79800913354,5,25,8,17,10,15,0,0,0,0,0,25,8,17,10,15,16,9.00033488819206,11.7168861968677,0.28198349276875,2020-02-03,2020,2
"4677","PB",2,"Nordeste",25007,"Serra do Teixeira",122625,8105.79800913354,6,31,10,21,13,18,2,1,1,2,0,33,11,22,15,18,13,9.00033488819206,11.7168861968677,0.292418294760965,2020-02-10,2020,2
"4678","PB",2,"Nordeste",25007,"Serra do Teixeira",122625,8105.79800913354,7,31,13,18,9,22,0,0,0,0,0,31,13,18,9,22,16,9.00033488819206,11.7168861968677,0.296135264558243,2020-02-17,2020,2
"4679","PB",2,"Nordeste",25007,"Serra do Teixeira",122625,8105.79800913354,8,30,8,22,10,20,1,0,1,0,1,31,8,23,10,21,18,9.00033488819206,11.7168861968677,0.319796976813542,2020-02-24,2020,2
"4680","PB",2,"Nordeste",25007,"Serra do Teixeira",122625,8105.79800913354,9,35,8,27,11,24,0,0,0,0,0,35,8,27,11,24,17,9.00033488819206,11.7168861968677,0.303520700074885,2020-03-02,2020,3
"4681","PB",2,"Nordeste",25007,"Serra do Teixeira",122625,8105.79800913354,10,24,10,14,8,16,0,0,0,0,0,24,10,14,8,16,20,9.00033488819206,11.7168861968677,0.326363793802473,2020-03-09,2020,3
"4682","PB",2,"Nordeste",25007,"Serra do Teixeira",122625,8105.79800913354,11,27,9,18,10,17,0,0,0,0,0,27,9,18,10,17,11,9.00033488819206,11.7168861968677,0.397060956229464,2020-03-16,2020,3
"4683","PB",2,"Nordeste",25007,"Serra do Teixeira",122625,8105.79800913354,12,32,7,25,16,16,1,1,0,0,1,33,8,25,16,17,17,9.00033488819206,11.7168861968677,0.491625640962939,2020-03-23,2020,3
"4684","PB",2,"Nordeste",25007,"Serra do Teixeira",122625,8105.79800913354,13,23,8,15,11,12,0,0,0,0,0,23,8,15,11,12,15,9.00033488819206,11.7168861968677,0.435534270529558,2020-03-30,2020,3
"4685","PB",2,"Nordeste",25007,"Serra do Teixeira",122625,8105.79800913354,14,29,8,21,18,11,0,0,0,0,0,29,8,21,18,11,8,9.00033488819206,11.7168861968677,0.423199522147869,2020-04-06,2020,4
"4686","PB",2,"Nordeste",25007,"Serra do Teixeira",122625,8105.79800913354,15,29,9,20,16,13,2,2,0,2,0,31,11,20,18,13,11,9.00033488819206,11.7168861968677,0.398679144602038,2020-04-13,2020,4
"4687","PB",2,"Nordeste",25007,"Serra do Teixeira",122625,8105.79800913354,16,33,10,23,14,19,0,0,0,0,0,33,10,23,14,19,14,9.00033488819206,11.7168861968677,0.383498164562974,2020-04-20,2020,4
"4688","PB",2,"Nordeste",25007,"Serra do Teixeira",122625,8105.79800913354,17,47,15,32,20,27,2,2,0,1,1,49,17,32,21,28,13,9.00033488819206,11.7168861968677,0.397308233385322,2020-04-27,2020,4
"4689","PB",2,"Nordeste",25007,"Serra do Teixeira",122625,8105.79800913354,18,34,7,27,15,19,0,0,0,0,0,34,7,27,15,19,16,9.00033488819206,11.7168861968677,0.417246486101066,2020-05-04,2020,5
"4690","PB",2,"Nordeste",25007,"Serra do Teixeira",122625,8105.79800913354,19,27,7,20,10,17,0,0,0,0,0,27,7,20,10,17,16,9.00033488819206,11.7168861968677,0.442903690962773,2020-05-11,2020,5
"4691","PB",2,"Nordeste",25007,"Serra do Teixeira",122625,8105.79800913354,20,31,12,19,12,19,0,0,0,0,0,31,12,19,12,19,15,9.00033488819206,11.7168861968677,0.42946989362259,2020-05-18,2020,5
"4692","PB",2,"Nordeste",25007,"Serra do Teixeira",122625,8105.79800913354,21,23,14,9,12,11,0,0,0,0,0,23,14,9,12,11,10,9.00033488819206,11.7168861968677,0.419810417471866,2020-05-25,2020,5
"4693","PB",2,"Nordeste",25008,"Seridó Ocidental Paraibano",41242,13335.0921739974,5,7,1,6,3,4,0,0,0,0,0,7,1,6,3,4,6,9.49815434877801,10.6272124335602,0.264125030082553,2020-02-03,2020,2
"4694","PB",2,"Nordeste",25008,"Seridó Ocidental Paraibano",41242,13335.0921739974,6,7,2,5,5,2,0,0,0,0,0,7,2,5,5,2,5,9.49815434877801,10.6272124335602,0.26231580667041,2020-02-10,2020,2
"4695","PB",2,"Nordeste",25008,"Seridó Ocidental Paraibano",41242,13335.0921739974,7,9,4,5,5,4,1,0,1,1,0,10,4,6,6,4,5,9.49815434877801,10.6272124335602,0.280088172233714,2020-02-17,2020,2
"4696","PB",2,"Nordeste",25008,"Seridó Ocidental Paraibano",41242,13335.0921739974,8,10,3,7,4,6,0,0,0,0,0,10,3,7,4,6,6,9.49815434877801,10.6272124335602,0.32046185554157,2020-02-24,2020,2
"4697","PB",2,"Nordeste",25008,"Seridó Ocidental Paraibano",41242,13335.0921739974,9,11,1,10,6,5,0,0,0,0,0,11,1,10,6,5,4,9.49815434877801,10.6272124335602,0.292320890499623,2020-03-02,2020,3
"4698","PB",2,"Nordeste",25008,"Seridó Ocidental Paraibano",41242,13335.0921739974,10,10,1,9,1,9,0,0,0,0,0,10,1,9,1,9,1,9.49815434877801,10.6272124335602,0.314259302261614,2020-03-09,2020,3
"4699","PB",2,"Nordeste",25008,"Seridó Ocidental Paraibano",41242,13335.0921739974,11,9,2,7,4,5,0,0,0,0,0,9,2,7,4,5,8,9.49815434877801,10.6272124335602,0.390492264373022,2020-03-16,2020,3
"4700","PB",2,"Nordeste",25008,"Seridó Ocidental Paraibano",41242,13335.0921739974,12,7,1,6,0,7,0,0,0,0,0,7,1,6,0,7,6,9.49815434877801,10.6272124335602,0.475974558689023,2020-03-23,2020,3
"4701","PB",2,"Nordeste",25008,"Seridó Ocidental Paraibano",41242,13335.0921739974,13,8,0,8,5,3,0,0,0,0,0,8,0,8,5,3,4,9.49815434877801,10.6272124335602,0.463981932483703,2020-03-30,2020,3
"4702","PB",2,"Nordeste",25008,"Seridó Ocidental Paraibano",41242,13335.0921739974,14,9,4,5,2,7,0,0,0,0,0,9,4,5,2,7,5,9.49815434877801,10.6272124335602,0.434430996855473,2020-04-06,2020,4
"4703","PB",2,"Nordeste",25008,"Seridó Ocidental Paraibano",41242,13335.0921739974,15,9,5,4,4,5,0,0,0,0,0,9,5,4,4,5,4,9.49815434877801,10.6272124335602,0.418211403965101,2020-04-13,2020,4
"4704","PB",2,"Nordeste",25008,"Seridó Ocidental Paraibano",41242,13335.0921739974,16,11,3,8,7,4,0,0,0,0,0,11,3,8,7,4,6,9.49815434877801,10.6272124335602,0.409654721498679,2020-04-20,2020,4
"4705","PB",2,"Nordeste",25008,"Seridó Ocidental Paraibano",41242,13335.0921739974,17,10,1,9,2,8,0,0,0,0,0,10,1,9,2,8,2,9.49815434877801,10.6272124335602,0.384768884082383,2020-04-27,2020,4
"4706","PB",2,"Nordeste",25008,"Seridó Ocidental Paraibano",41242,13335.0921739974,18,13,3,10,6,7,1,1,0,0,1,14,4,10,6,8,2,9.49815434877801,10.6272124335602,0.40481610100583,2020-05-04,2020,5
"4707","PB",2,"Nordeste",25008,"Seridó Ocidental Paraibano",41242,13335.0921739974,19,5,1,4,1,4,0,0,0,0,0,5,1,4,1,4,7,9.49815434877801,10.6272124335602,0.476699236519842,2020-05-11,2020,5
"4708","PB",2,"Nordeste",25008,"Seridó Ocidental Paraibano",41242,13335.0921739974,20,6,1,5,3,3,0,0,0,0,0,6,1,5,3,3,9,9.49815434877801,10.6272124335602,0.469399492557575,2020-05-18,2020,5
"4709","PB",2,"Nordeste",25008,"Seridó Ocidental Paraibano",41242,13335.0921739974,21,9,1,8,6,3,0,0,0,0,0,9,1,8,6,3,9,9.49815434877801,10.6272124335602,0.434142495190291,2020-05-25,2020,5
"4710","PB",2,"Nordeste",25009,"Seridó Oriental Paraibano",79590,8986.2966089961,5,18,6,12,6,12,0,0,0,0,0,18,6,12,6,12,13,9.1034560969861,11.2846437357999,0.28121721111833,2020-02-03,2020,2
"4711","PB",2,"Nordeste",25009,"Seridó Oriental Paraibano",79590,8986.2966089961,6,20,7,13,13,7,0,0,0,0,0,20,7,13,13,7,1,9.1034560969861,11.2846437357999,0.27114938936411,2020-02-10,2020,2
"4712","PB",2,"Nordeste",25009,"Seridó Oriental Paraibano",79590,8986.2966089961,7,15,4,11,8,7,0,0,0,0,0,15,4,11,8,7,5,9.1034560969861,11.2846437357999,0.279653098943091,2020-02-17,2020,2
"4713","PB",2,"Nordeste",25009,"Seridó Oriental Paraibano",79590,8986.2966089961,8,17,1,16,5,12,0,0,0,0,0,17,1,16,5,12,9,9.1034560969861,11.2846437357999,0.313667205413516,2020-02-24,2020,2
"4714","PB",2,"Nordeste",25009,"Seridó Oriental Paraibano",79590,8986.2966089961,9,16,8,8,5,11,0,0,0,0,0,16,8,8,5,11,5,9.1034560969861,11.2846437357999,0.286649834776365,2020-03-02,2020,3
"4715","PB",2,"Nordeste",25009,"Seridó Oriental Paraibano",79590,8986.2966089961,10,17,7,10,8,9,0,0,0,0,0,17,7,10,8,9,12,9.1034560969861,11.2846437357999,0.322216290200358,2020-03-09,2020,3
"4716","PB",2,"Nordeste",25009,"Seridó Oriental Paraibano",79590,8986.2966089961,11,17,3,14,8,9,0,0,0,0,0,17,3,14,8,9,10,9.1034560969861,11.2846437357999,0.384291267022155,2020-03-16,2020,3
"4717","PB",2,"Nordeste",25009,"Seridó Oriental Paraibano",79590,8986.2966089961,12,19,6,13,6,13,0,0,0,0,0,19,6,13,6,13,13,9.1034560969861,11.2846437357999,0.474764224083592,2020-03-23,2020,3
"4718","PB",2,"Nordeste",25009,"Seridó Oriental Paraibano",79590,8986.2966089961,13,15,6,9,4,11,0,0,0,0,0,15,6,9,4,11,11,9.1034560969861,11.2846437357999,0.432769188155354,2020-03-30,2020,3
"4719","PB",2,"Nordeste",25009,"Seridó Oriental Paraibano",79590,8986.2966089961,14,31,12,19,16,15,0,0,0,0,0,31,12,19,16,15,8,9.1034560969861,11.2846437357999,0.411710968759657,2020-04-06,2020,4
"4720","PB",2,"Nordeste",25009,"Seridó Oriental Paraibano",79590,8986.2966089961,15,17,4,13,11,6,1,1,0,0,1,18,5,13,11,7,10,9.1034560969861,11.2846437357999,0.393265808826942,2020-04-13,2020,4
"4721","PB",2,"Nordeste",25009,"Seridó Oriental Paraibano",79590,8986.2966089961,16,18,7,11,6,12,0,0,0,0,0,18,7,11,6,12,12,9.1034560969861,11.2846437357999,0.389302591136464,2020-04-20,2020,4
"4722","PB",2,"Nordeste",25009,"Seridó Oriental Paraibano",79590,8986.2966089961,17,18,7,11,9,9,1,1,0,0,1,19,8,11,9,10,9,9.1034560969861,11.2846437357999,0.376563538280386,2020-04-27,2020,4
"4723","PB",2,"Nordeste",25009,"Seridó Oriental Paraibano",79590,8986.2966089961,18,22,10,12,13,9,1,0,1,0,1,23,10,13,13,10,9,9.1034560969861,11.2846437357999,0.399087137660101,2020-05-04,2020,5
"4724","PB",2,"Nordeste",25009,"Seridó Oriental Paraibano",79590,8986.2966089961,19,13,3,10,7,6,0,0,0,0,0,13,3,10,7,6,6,9.1034560969861,11.2846437357999,0.449741556044914,2020-05-11,2020,5
"4725","PB",2,"Nordeste",25009,"Seridó Oriental Paraibano",79590,8986.2966089961,20,21,10,11,9,12,1,0,1,0,1,22,10,12,9,13,16,9.1034560969861,11.2846437357999,0.443698800922441,2020-05-18,2020,5
"4726","PB",2,"Nordeste",25009,"Seridó Oriental Paraibano",79590,8986.2966089961,21,24,10,14,11,13,0,0,0,0,0,24,10,14,11,13,6,9.1034560969861,11.2846437357999,0.426368263341446,2020-05-25,2020,5
"4727","PB",2,"Nordeste",25010,"Cariri Ocidental",128799,11232.8248663421,5,25,7,18,15,10,1,0,1,0,1,26,7,19,15,11,20,9.32659556252405,11.7660083286471,0.249167472995115,2020-02-03,2020,2
"4728","PB",2,"Nordeste",25010,"Cariri Ocidental",128799,11232.8248663421,6,37,17,20,17,20,0,0,0,0,0,37,17,20,17,20,13,9.32659556252405,11.7660083286471,0.243437221691291,2020-02-10,2020,2
"4729","PB",2,"Nordeste",25010,"Cariri Ocidental",128799,11232.8248663421,7,18,2,16,5,13,1,1,0,1,0,19,3,16,6,13,19,9.32659556252405,11.7660083286471,0.263610071259728,2020-02-17,2020,2
"4730","PB",2,"Nordeste",25010,"Cariri Ocidental",128799,11232.8248663421,8,26,7,19,8,18,0,0,0,0,0,26,7,19,8,18,20,9.32659556252405,11.7660083286471,0.303362677579045,2020-02-24,2020,2
"4731","PB",2,"Nordeste",25010,"Cariri Ocidental",128799,11232.8248663421,9,32,13,19,17,15,0,0,0,0,0,32,13,19,17,15,19,9.32659556252405,11.7660083286471,0.269995436734647,2020-03-02,2020,3
"4732","PB",2,"Nordeste",25010,"Cariri Ocidental",128799,11232.8248663421,10,29,6,23,15,14,0,0,0,0,0,29,6,23,15,14,17,9.32659556252405,11.7660083286471,0.300273402523755,2020-03-09,2020,3
"4733","PB",2,"Nordeste",25010,"Cariri Ocidental",128799,11232.8248663421,11,41,18,23,12,29,0,0,0,0,0,41,18,23,12,29,28,9.32659556252405,11.7660083286471,0.354420281197273,2020-03-16,2020,3
"4734","PB",2,"Nordeste",25010,"Cariri Ocidental",128799,11232.8248663421,12,18,8,10,8,10,1,0,1,1,0,19,8,11,9,10,17,9.32659556252405,11.7660083286471,0.443395904515495,2020-03-23,2020,3
"4735","PB",2,"Nordeste",25010,"Cariri Ocidental",128799,11232.8248663421,13,14,6,8,3,11,2,0,2,0,2,16,6,10,3,13,17,9.32659556252405,11.7660083286471,0.396841689002638,2020-03-30,2020,3
"4736","PB",2,"Nordeste",25010,"Cariri Ocidental",128799,11232.8248663421,14,31,11,20,13,18,0,0,0,0,0,31,11,20,13,18,17,9.32659556252405,11.7660083286471,0.381723740807686,2020-04-06,2020,4
"4737","PB",2,"Nordeste",25010,"Cariri Ocidental",128799,11232.8248663421,15,26,12,14,7,19,1,1,0,0,1,27,13,14,7,20,19,9.32659556252405,11.7660083286471,0.360964715167354,2020-04-13,2020,4
"4738","PB",2,"Nordeste",25010,"Cariri Ocidental",128799,11232.8248663421,16,42,19,23,18,24,0,0,0,0,0,42,19,23,18,24,19,9.32659556252405,11.7660083286471,0.355407349549861,2020-04-20,2020,4
"4739","PB",2,"Nordeste",25010,"Cariri Ocidental",128799,11232.8248663421,17,20,10,10,11,9,0,0,0,0,0,20,10,10,11,9,25,9.32659556252405,11.7660083286471,0.358367724275285,2020-04-27,2020,4
"4740","PB",2,"Nordeste",25010,"Cariri Ocidental",128799,11232.8248663421,18,31,8,23,18,13,0,0,0,0,0,31,8,23,18,13,17,9.32659556252405,11.7660083286471,0.373989839720316,2020-05-04,2020,5
"4741","PB",2,"Nordeste",25010,"Cariri Ocidental",128799,11232.8248663421,19,30,8,22,12,18,0,0,0,0,0,30,8,22,12,18,30,9.32659556252405,11.7660083286471,0.409840705697895,2020-05-11,2020,5
"4742","PB",2,"Nordeste",25010,"Cariri Ocidental",128799,11232.8248663421,20,39,14,25,16,23,0,0,0,0,0,39,14,25,16,23,21,9.32659556252405,11.7660083286471,0.39569456696661,2020-05-18,2020,5
"4743","PB",2,"Nordeste",25010,"Cariri Ocidental",128799,11232.8248663421,21,27,8,19,11,16,0,0,0,0,0,27,8,19,11,16,13,9.32659556252405,11.7660083286471,0.379805710067205,2020-05-25,2020,5
"4744","PB",2,"Nordeste",25011,"Cariri Oriental",67264,10231.0486405804,5,16,5,11,4,12,0,0,0,0,0,16,5,11,4,12,12,9.23318236010284,11.1163804542366,0.283509185797105,2020-02-03,2020,2
"4745","PB",2,"Nordeste",25011,"Cariri Oriental",67264,10231.0486405804,6,17,4,13,9,8,0,0,0,0,0,17,4,13,9,8,12,9.23318236010284,11.1163804542366,0.276599211055436,2020-02-10,2020,2
"4746","PB",2,"Nordeste",25011,"Cariri Oriental",67264,10231.0486405804,7,20,8,12,8,12,0,0,0,0,0,20,8,12,8,12,12,9.23318236010284,11.1163804542366,0.289269376662878,2020-02-17,2020,2
"4747","PB",2,"Nordeste",25011,"Cariri Oriental",67264,10231.0486405804,8,10,5,5,5,5,0,0,0,0,0,10,5,5,5,5,11,9.23318236010284,11.1163804542366,0.319495858661181,2020-02-24,2020,2
"4748","PB",2,"Nordeste",25011,"Cariri Oriental",67264,10231.0486405804,9,14,8,6,5,9,0,0,0,0,0,14,8,6,5,9,6,9.23318236010284,11.1163804542366,0.291754189070339,2020-03-02,2020,3
"4749","PB",2,"Nordeste",25011,"Cariri Oriental",67264,10231.0486405804,10,13,6,7,5,8,0,0,0,0,0,13,6,7,5,8,9,9.23318236010284,11.1163804542366,0.324544525475057,2020-03-09,2020,3
"4750","PB",2,"Nordeste",25011,"Cariri Oriental",67264,10231.0486405804,11,22,8,14,9,13,0,0,0,0,0,22,8,14,9,13,7,9.23318236010284,11.1163804542366,0.363829709348232,2020-03-16,2020,3
"4751","PB",2,"Nordeste",25011,"Cariri Oriental",67264,10231.0486405804,12,12,6,6,4,8,0,0,0,0,0,12,6,6,4,8,8,9.23318236010284,11.1163804542366,0.446846504607416,2020-03-23,2020,3
"4752","PB",2,"Nordeste",25011,"Cariri Oriental",67264,10231.0486405804,13,15,3,12,7,8,0,0,0,0,0,15,3,12,7,8,11,9.23318236010284,11.1163804542366,0.410565782256175,2020-03-30,2020,3
"4753","PB",2,"Nordeste",25011,"Cariri Oriental",67264,10231.0486405804,14,14,8,6,4,10,0,0,0,0,0,14,8,6,4,10,12,9.23318236010284,11.1163804542366,0.393181169394585,2020-04-06,2020,4
"4754","PB",2,"Nordeste",25011,"Cariri Oriental",67264,10231.0486405804,15,13,8,5,5,8,0,0,0,0,0,13,8,5,5,8,7,9.23318236010284,11.1163804542366,0.399582199952647,2020-04-13,2020,4
"4755","PB",2,"Nordeste",25011,"Cariri Oriental",67264,10231.0486405804,16,23,9,14,13,10,0,0,0,0,0,23,9,14,13,10,14,9.23318236010284,11.1163804542366,0.369738931228787,2020-04-20,2020,4
"4756","PB",2,"Nordeste",25011,"Cariri Oriental",67264,10231.0486405804,17,17,5,12,8,9,0,0,0,0,0,17,5,12,8,9,7,9.23318236010284,11.1163804542366,0.374240939073855,2020-04-27,2020,4
"4757","PB",2,"Nordeste",25011,"Cariri Oriental",67264,10231.0486405804,18,13,4,9,4,9,0,0,0,0,0,13,4,9,4,9,8,9.23318236010284,11.1163804542366,0.389742787615781,2020-05-04,2020,5
"4758","PB",2,"Nordeste",25011,"Cariri Oriental",67264,10231.0486405804,19,15,9,6,5,10,0,0,0,0,0,15,9,6,5,10,12,9.23318236010284,11.1163804542366,0.418097334262939,2020-05-11,2020,5
"4759","PB",2,"Nordeste",25011,"Cariri Oriental",67264,10231.0486405804,20,16,4,12,4,12,0,0,0,0,0,16,4,12,4,12,12,9.23318236010284,11.1163804542366,0.421049211562235,2020-05-18,2020,5
"4760","PB",2,"Nordeste",25011,"Cariri Oriental",67264,10231.0486405804,21,22,6,16,9,13,0,0,0,0,0,22,6,16,9,13,8,9.23318236010284,11.1163804542366,0.404124207009984,2020-05-25,2020,5
"4761","PB",2,"Nordeste",25012,"Curimataú Ocidental",129109,9614.67639087903,5,29,10,19,9,20,0,0,0,0,0,29,10,19,9,20,10,9.17104600076163,11.7684122878053,0.263690756464431,2020-02-03,2020,2
"4762","PB",2,"Nordeste",25012,"Curimataú Ocidental",129109,9614.67639087903,6,26,11,15,10,16,1,1,0,1,0,27,12,15,11,16,7,9.17104600076163,11.7684122878053,0.262588534998649,2020-02-10,2020,2
"4763","PB",2,"Nordeste",25012,"Curimataú Ocidental",129109,9614.67639087903,7,27,9,18,13,14,0,0,0,0,0,27,9,18,13,14,21,9.17104600076163,11.7684122878053,0.276652445517867,2020-02-17,2020,2
"4764","PB",2,"Nordeste",25012,"Curimataú Ocidental",129109,9614.67639087903,8,29,12,17,13,16,0,0,0,0,0,29,12,17,13,16,21,9.17104600076163,11.7684122878053,0.314810053074316,2020-02-24,2020,2
"4765","PB",2,"Nordeste",25012,"Curimataú Ocidental",129109,9614.67639087903,9,36,17,19,15,21,0,0,0,0,0,36,17,19,15,21,17,9.17104600076163,11.7684122878053,0.290791170297212,2020-03-02,2020,3
"4766","PB",2,"Nordeste",25012,"Curimataú Ocidental",129109,9614.67639087903,10,40,15,25,17,23,0,0,0,0,0,40,15,25,17,23,20,9.17104600076163,11.7684122878053,0.322512706493677,2020-03-09,2020,3
"4767","PB",2,"Nordeste",25012,"Curimataú Ocidental",129109,9614.67639087903,11,26,14,12,12,14,0,0,0,0,0,26,14,12,12,14,19,9.17104600076163,11.7684122878053,0.369175543774963,2020-03-16,2020,3
"4768","PB",2,"Nordeste",25012,"Curimataú Ocidental",129109,9614.67639087903,12,20,10,10,4,16,0,0,0,0,0,20,10,10,4,16,16,9.17104600076163,11.7684122878053,0.474236187382457,2020-03-23,2020,3
"4769","PB",2,"Nordeste",25012,"Curimataú Ocidental",129109,9614.67639087903,13,29,15,14,16,13,0,0,0,0,0,29,15,14,16,13,18,9.17104600076163,11.7684122878053,0.431637763326311,2020-03-30,2020,3
"4770","PB",2,"Nordeste",25012,"Curimataú Ocidental",129109,9614.67639087903,14,23,14,9,15,8,1,1,0,1,0,24,15,9,16,8,16,9.17104600076163,11.7684122878053,0.408735750925295,2020-04-06,2020,4
"4771","PB",2,"Nordeste",25012,"Curimataú Ocidental",129109,9614.67639087903,15,19,7,12,8,11,0,0,0,0,0,19,7,12,8,11,14,9.17104600076163,11.7684122878053,0.387464243947003,2020-04-13,2020,4
"4772","PB",2,"Nordeste",25012,"Curimataú Ocidental",129109,9614.67639087903,16,30,15,15,10,20,0,0,0,0,0,30,15,15,10,20,12,9.17104600076163,11.7684122878053,0.372271028566175,2020-04-20,2020,4
"4773","PB",2,"Nordeste",25012,"Curimataú Ocidental",129109,9614.67639087903,17,41,14,27,16,25,0,0,0,0,0,41,14,27,16,25,17,9.17104600076163,11.7684122878053,0.362908789413465,2020-04-27,2020,4
"4774","PB",2,"Nordeste",25012,"Curimataú Ocidental",129109,9614.67639087903,18,27,13,14,12,15,1,0,1,1,0,28,13,15,13,15,15,9.17104600076163,11.7684122878053,0.383194806018314,2020-05-04,2020,5
"4775","PB",2,"Nordeste",25012,"Curimataú Ocidental",129109,9614.67639087903,19,29,15,14,12,17,1,0,1,1,0,30,15,15,13,17,21,9.17104600076163,11.7684122878053,0.413280581497746,2020-05-11,2020,5
"4776","PB",2,"Nordeste",25012,"Curimataú Ocidental",129109,9614.67639087903,20,29,11,18,14,15,0,0,0,0,0,29,11,18,14,15,23,9.17104600076163,11.7684122878053,0.400067592647308,2020-05-18,2020,5
"4777","PB",2,"Nordeste",25012,"Curimataú Ocidental",129109,9614.67639087903,21,24,7,17,11,13,0,0,0,0,0,24,7,17,11,13,22,9.17104600076163,11.7684122878053,0.389161934440715,2020-05-25,2020,5
"4778","PB",2,"Nordeste",25013,"Curimataú Oriental",96368,8628.99147528225,5,10,3,7,2,8,0,0,0,0,0,10,3,7,2,8,10,9.06288291459291,11.4759294752835,0.283394657354105,2020-02-03,2020,2
"4779","PB",2,"Nordeste",25013,"Curimataú Oriental",96368,8628.99147528225,6,10,5,5,3,7,0,0,0,0,0,10,5,5,3,7,11,9.06288291459291,11.4759294752835,0.28026889068521,2020-02-10,2020,2
"4780","PB",2,"Nordeste",25013,"Curimataú Oriental",96368,8628.99147528225,7,10,6,4,3,7,0,0,0,0,0,10,6,4,3,7,16,9.06288291459291,11.4759294752835,0.286442379311138,2020-02-17,2020,2
"4781","PB",2,"Nordeste",25013,"Curimataú Oriental",96368,8628.99147528225,8,13,7,6,3,10,0,0,0,0,0,13,7,6,3,10,11,9.06288291459291,11.4759294752835,0.327749818581744,2020-02-24,2020,2
"4782","PB",2,"Nordeste",25013,"Curimataú Oriental",96368,8628.99147528225,9,19,8,11,9,10,0,0,0,0,0,19,8,11,9,10,11,9.06288291459291,11.4759294752835,0.303564029915656,2020-03-02,2020,3
"4783","PB",2,"Nordeste",25013,"Curimataú Oriental",96368,8628.99147528225,10,19,10,9,7,12,1,0,1,1,0,20,10,10,8,12,7,9.06288291459291,11.4759294752835,0.337228793569632,2020-03-09,2020,3
"4784","PB",2,"Nordeste",25013,"Curimataú Oriental",96368,8628.99147528225,11,17,4,13,5,12,0,0,0,0,0,17,4,13,5,12,13,9.06288291459291,11.4759294752835,0.387489556629429,2020-03-16,2020,3
"4785","PB",2,"Nordeste",25013,"Curimataú Oriental",96368,8628.99147528225,12,19,6,13,6,13,0,0,0,0,0,19,6,13,6,13,17,9.06288291459291,11.4759294752835,0.47661173498638,2020-03-23,2020,3
"4786","PB",2,"Nordeste",25013,"Curimataú Oriental",96368,8628.99147528225,13,11,3,8,4,7,0,0,0,0,0,11,3,8,4,7,12,9.06288291459291,11.4759294752835,0.442065705446771,2020-03-30,2020,3
"4787","PB",2,"Nordeste",25013,"Curimataú Oriental",96368,8628.99147528225,14,30,12,18,17,13,0,0,0,0,0,30,12,18,17,13,15,9.06288291459291,11.4759294752835,0.424065226315086,2020-04-06,2020,4
"4788","PB",2,"Nordeste",25013,"Curimataú Oriental",96368,8628.99147528225,15,23,12,11,13,10,0,0,0,0,0,23,12,11,13,10,14,9.06288291459291,11.4759294752835,0.389448514929949,2020-04-13,2020,4
"4789","PB",2,"Nordeste",25013,"Curimataú Oriental",96368,8628.99147528225,16,17,6,11,10,7,1,0,1,1,0,18,6,12,11,7,12,9.06288291459291,11.4759294752835,0.382874260761227,2020-04-20,2020,4
"4790","PB",2,"Nordeste",25013,"Curimataú Oriental",96368,8628.99147528225,17,22,12,10,7,15,0,0,0,0,0,22,12,10,7,15,11,9.06288291459291,11.4759294752835,0.372784788982772,2020-04-27,2020,4
"4791","PB",2,"Nordeste",25013,"Curimataú Oriental",96368,8628.99147528225,18,19,9,10,13,6,0,0,0,0,0,19,9,10,13,6,15,9.06288291459291,11.4759294752835,0.392770741075836,2020-05-04,2020,5
"4792","PB",2,"Nordeste",25013,"Curimataú Oriental",96368,8628.99147528225,19,19,11,8,10,9,0,0,0,0,0,19,11,8,10,9,13,9.06288291459291,11.4759294752835,0.438896343144863,2020-05-11,2020,5
"4793","PB",2,"Nordeste",25013,"Curimataú Oriental",96368,8628.99147528225,20,30,21,9,16,14,0,0,0,0,0,30,21,9,16,14,8,9.06288291459291,11.4759294752835,0.436733694059775,2020-05-18,2020,5
"4794","PB",2,"Nordeste",25013,"Curimataú Oriental",96368,8628.99147528225,21,29,15,14,18,11,0,0,0,0,0,29,15,14,18,11,13,9.06288291459291,11.4759294752835,0.40768349371199,2020-05-25,2020,5
"4795","PB",2,"Nordeste",25014,"Esperança",57692,10489.9733356445,5,14,6,8,8,6,1,0,1,0,1,15,6,9,8,7,7,9.25817515950384,10.9628737947034,0.283483922479952,2020-02-03,2020,2
"4796","PB",2,"Nordeste",25014,"Esperança",57692,10489.9733356445,6,18,9,9,8,10,0,0,0,0,0,18,9,9,8,10,15,9.25817515950384,10.9628737947034,0.264767310828221,2020-02-10,2020,2
"4797","PB",2,"Nordeste",25014,"Esperança",57692,10489.9733356445,7,18,6,12,9,9,0,0,0,0,0,18,6,12,9,9,4,9.25817515950384,10.9628737947034,0.28091428166736,2020-02-17,2020,2
"4798","PB",2,"Nordeste",25014,"Esperança",57692,10489.9733356445,8,21,9,12,9,12,0,0,0,0,0,21,9,12,9,12,8,9.25817515950384,10.9628737947034,0.330534332665893,2020-02-24,2020,2
"4799","PB",2,"Nordeste",25014,"Esperança",57692,10489.9733356445,9,14,2,12,2,12,1,0,1,0,1,15,2,13,2,13,9,9.25817515950384,10.9628737947034,0.291555661637686,2020-03-02,2020,3
"4800","PB",2,"Nordeste",25014,"Esperança",57692,10489.9733356445,10,22,6,16,11,11,0,0,0,0,0,22,6,16,11,11,6,9.25817515950384,10.9628737947034,0.314260265982545,2020-03-09,2020,3
"4801","PB",2,"Nordeste",25014,"Esperança",57692,10489.9733356445,11,6,5,1,5,1,0,0,0,0,0,6,5,1,5,1,2,9.25817515950384,10.9628737947034,0.38917761443131,2020-03-16,2020,3
"4802","PB",2,"Nordeste",25014,"Esperança",57692,10489.9733356445,12,20,7,13,10,10,0,0,0,0,0,20,7,13,10,10,10,9.25817515950384,10.9628737947034,0.502817970285733,2020-03-23,2020,3
"4803","PB",2,"Nordeste",25014,"Esperança",57692,10489.9733356445,13,9,3,6,4,5,0,0,0,0,0,9,3,6,4,5,9,9.25817515950384,10.9628737947034,0.436608265104843,2020-03-30,2020,3
"4804","PB",2,"Nordeste",25014,"Esperança",57692,10489.9733356445,14,12,9,3,5,7,0,0,0,0,0,12,9,3,5,7,10,9.25817515950384,10.9628737947034,0.428432711087678,2020-04-06,2020,4
"4805","PB",2,"Nordeste",25014,"Esperança",57692,10489.9733356445,15,7,2,5,2,5,0,0,0,0,0,7,2,5,2,5,6,9.25817515950384,10.9628737947034,0.405869450037182,2020-04-13,2020,4
"4806","PB",2,"Nordeste",25014,"Esperança",57692,10489.9733356445,16,14,3,11,6,8,0,0,0,0,0,14,3,11,6,8,6,9.25817515950384,10.9628737947034,0.397777093795306,2020-04-20,2020,4
"4807","PB",2,"Nordeste",25014,"Esperança",57692,10489.9733356445,17,12,5,7,3,9,0,0,0,0,0,12,5,7,3,9,11,9.25817515950384,10.9628737947034,0.393760875868705,2020-04-27,2020,4
"4808","PB",2,"Nordeste",25014,"Esperança",57692,10489.9733356445,18,14,8,6,6,8,0,0,0,0,0,14,8,6,6,8,9,9.25817515950384,10.9628737947034,0.409508993247041,2020-05-04,2020,5
"4809","PB",2,"Nordeste",25014,"Esperança",57692,10489.9733356445,19,17,5,12,3,14,0,0,0,0,0,17,5,12,3,14,10,9.25817515950384,10.9628737947034,0.448127805448249,2020-05-11,2020,5
"4810","PB",2,"Nordeste",25014,"Esperança",57692,10489.9733356445,20,11,3,8,5,6,0,0,0,0,0,11,3,8,5,6,9,9.25817515950384,10.9628737947034,0.435322626367676,2020-05-18,2020,5
"4811","PB",2,"Nordeste",25014,"Esperança",57692,10489.9733356445,21,14,4,10,7,7,0,0,0,0,0,14,4,10,7,7,6,9.25817515950384,10.9628737947034,0.425677645898637,2020-05-25,2020,5
"4812","PB",2,"Nordeste",25015,"Brejo Paraibano",115731,10883.9201282284,5,28,17,11,13,15,0,0,0,0,0,28,17,11,13,15,8,9.29504176141869,11.6590238116067,0.260551245084484,2020-02-03,2020,2
"4813","PB",2,"Nordeste",25015,"Brejo Paraibano",115731,10883.9201282284,6,22,12,10,10,12,0,0,0,0,0,22,12,10,10,12,14,9.29504176141869,11.6590238116067,0.267883528170937,2020-02-10,2020,2
"4814","PB",2,"Nordeste",25015,"Brejo Paraibano",115731,10883.9201282284,7,24,8,16,9,15,0,0,0,0,0,24,8,16,9,15,23,9.29504176141869,11.6590238116067,0.270946999980594,2020-02-17,2020,2
"4815","PB",2,"Nordeste",25015,"Brejo Paraibano",115731,10883.9201282284,8,18,12,6,9,9,0,0,0,0,0,18,12,6,9,9,15,9.29504176141869,11.6590238116067,0.328171250845876,2020-02-24,2020,2
"4816","PB",2,"Nordeste",25015,"Brejo Paraibano",115731,10883.9201282284,9,32,13,19,16,16,0,0,0,0,0,32,13,19,16,16,15,9.29504176141869,11.6590238116067,0.289498528411101,2020-03-02,2020,3
"4817","PB",2,"Nordeste",25015,"Brejo Paraibano",115731,10883.9201282284,10,31,14,17,20,11,0,0,0,0,0,31,14,17,20,11,15,9.29504176141869,11.6590238116067,0.318553879317035,2020-03-09,2020,3
"4818","PB",2,"Nordeste",25015,"Brejo Paraibano",115731,10883.9201282284,11,18,6,12,7,11,0,0,0,0,0,18,6,12,7,11,22,9.29504176141869,11.6590238116067,0.377862337542924,2020-03-16,2020,3
"4819","PB",2,"Nordeste",25015,"Brejo Paraibano",115731,10883.9201282284,12,25,14,11,13,12,0,0,0,0,0,25,14,11,13,12,14,9.29504176141869,11.6590238116067,0.489712381951729,2020-03-23,2020,3
"4820","PB",2,"Nordeste",25015,"Brejo Paraibano",115731,10883.9201282284,13,25,9,16,11,14,1,0,1,0,1,26,9,17,11,15,13,9.29504176141869,11.6590238116067,0.443280873554534,2020-03-30,2020,3
"4821","PB",2,"Nordeste",25015,"Brejo Paraibano",115731,10883.9201282284,14,31,13,18,8,23,0,0,0,0,0,31,13,18,8,23,17,9.29504176141869,11.6590238116067,0.427801304938877,2020-04-06,2020,4
"4822","PB",2,"Nordeste",25015,"Brejo Paraibano",115731,10883.9201282284,15,30,14,16,18,12,0,0,0,0,0,30,14,16,18,12,17,9.29504176141869,11.6590238116067,0.403341861179056,2020-04-13,2020,4
"4823","PB",2,"Nordeste",25015,"Brejo Paraibano",115731,10883.9201282284,16,28,11,17,9,19,0,0,0,0,0,28,11,17,9,19,19,9.29504176141869,11.6590238116067,0.408143696059824,2020-04-20,2020,4
"4824","PB",2,"Nordeste",25015,"Brejo Paraibano",115731,10883.9201282284,17,24,13,11,10,14,0,0,0,0,0,24,13,11,10,14,13,9.29504176141869,11.6590238116067,0.398578508882427,2020-04-27,2020,4
"4825","PB",2,"Nordeste",25015,"Brejo Paraibano",115731,10883.9201282284,18,28,11,17,12,16,2,2,0,0,2,30,13,17,12,18,19,9.29504176141869,11.6590238116067,0.412049885670517,2020-05-04,2020,5
"4826","PB",2,"Nordeste",25015,"Brejo Paraibano",115731,10883.9201282284,19,21,9,12,8,13,1,1,0,1,0,22,10,12,9,13,19,9.29504176141869,11.6590238116067,0.46006132552191,2020-05-11,2020,5
"4827","PB",2,"Nordeste",25015,"Brejo Paraibano",115731,10883.9201282284,20,31,15,16,10,21,0,0,0,0,0,31,15,16,10,21,15,9.29504176141869,11.6590238116067,0.456842158990655,2020-05-18,2020,5
"4828","PB",2,"Nordeste",25015,"Brejo Paraibano",115731,10883.9201282284,21,36,16,20,21,15,1,1,0,1,0,37,17,20,22,15,21,9.29504176141869,11.6590238116067,0.43035092432937,2020-05-25,2020,5
"4829","PB",2,"Nordeste",25016,"Guarabira",171646,11594.2365128229,5,21,7,14,11,10,1,0,1,0,1,22,7,15,11,11,24,9.35826340127958,12.053189495381,0.276382440174359,2020-02-03,2020,2
"4830","PB",2,"Nordeste",25016,"Guarabira",171646,11594.2365128229,6,28,9,19,14,14,0,0,0,0,0,28,9,19,14,14,27,9.35826340127958,12.053189495381,0.267211976734809,2020-02-10,2020,2
"4831","PB",2,"Nordeste",25016,"Guarabira",171646,11594.2365128229,7,12,3,9,5,7,1,0,1,1,0,13,3,10,6,7,26,9.35826340127958,12.053189495381,0.289750007896317,2020-02-17,2020,2
"4832","PB",2,"Nordeste",25016,"Guarabira",171646,11594.2365128229,8,27,9,18,14,13,0,0,0,0,0,27,9,18,14,13,22,9.35826340127958,12.053189495381,0.332248744191805,2020-02-24,2020,2
"4833","PB",2,"Nordeste",25016,"Guarabira",171646,11594.2365128229,9,32,12,20,18,14,0,0,0,0,0,32,12,20,18,14,16,9.35826340127958,12.053189495381,0.301542567248584,2020-03-02,2020,3
"4834","PB",2,"Nordeste",25016,"Guarabira",171646,11594.2365128229,10,30,17,13,11,19,1,0,1,1,0,31,17,14,12,19,17,9.35826340127958,12.053189495381,0.333572043697947,2020-03-09,2020,3
"4835","PB",2,"Nordeste",25016,"Guarabira",171646,11594.2365128229,11,30,11,19,11,19,2,1,1,0,2,32,12,20,11,21,14,9.35826340127958,12.053189495381,0.389649229983363,2020-03-16,2020,3
"4836","PB",2,"Nordeste",25016,"Guarabira",171646,11594.2365128229,12,26,4,22,15,11,0,0,0,0,0,26,4,22,15,11,20,9.35826340127958,12.053189495381,0.482628644075087,2020-03-23,2020,3
"4837","PB",2,"Nordeste",25016,"Guarabira",171646,11594.2365128229,13,29,6,23,11,18,0,0,0,0,0,29,6,23,11,18,21,9.35826340127958,12.053189495381,0.441290471120817,2020-03-30,2020,3
"4838","PB",2,"Nordeste",25016,"Guarabira",171646,11594.2365128229,14,27,9,18,11,16,1,1,0,0,1,28,10,18,11,17,22,9.35826340127958,12.053189495381,0.432625629914459,2020-04-06,2020,4
"4839","PB",2,"Nordeste",25016,"Guarabira",171646,11594.2365128229,15,47,20,27,21,26,0,0,0,0,0,47,20,27,21,26,19,9.35826340127958,12.053189495381,0.41075166173508,2020-04-13,2020,4
"4840","PB",2,"Nordeste",25016,"Guarabira",171646,11594.2365128229,16,52,24,28,21,31,0,0,0,0,0,52,24,28,21,31,22,9.35826340127958,12.053189495381,0.403386004548802,2020-04-20,2020,4
"4841","PB",2,"Nordeste",25016,"Guarabira",171646,11594.2365128229,17,45,13,32,17,28,0,0,0,0,0,45,13,32,17,28,26,9.35826340127958,12.053189495381,0.393350122401262,2020-04-27,2020,4
"4842","PB",2,"Nordeste",25016,"Guarabira",171646,11594.2365128229,18,36,10,26,13,23,1,1,0,0,1,37,11,26,13,24,21,9.35826340127958,12.053189495381,0.419512183078525,2020-05-04,2020,5
"4843","PB",2,"Nordeste",25016,"Guarabira",171646,11594.2365128229,19,36,12,24,18,18,0,0,0,0,0,36,12,24,18,18,40,9.35826340127958,12.053189495381,0.466326848935567,2020-05-11,2020,5
"4844","PB",2,"Nordeste",25016,"Guarabira",171646,11594.2365128229,20,53,22,31,21,32,1,1,0,0,1,54,23,31,21,33,30,9.35826340127958,12.053189495381,0.446122214103988,2020-05-18,2020,5
"4845","PB",2,"Nordeste",25016,"Guarabira",171646,11594.2365128229,21,44,19,25,20,24,0,0,0,0,0,44,19,25,20,24,26,9.35826340127958,12.053189495381,0.415680857086903,2020-05-25,2020,5
"4846","PB",2,"Nordeste",25017,"Campina Grande",536714,19732.9310450631,5,160,43,117,58,102,0,0,0,0,0,160,43,117,58,102,70,9.89004414576628,13.193220643161,0.269463024293183,2020-02-03,2020,2
"4847","PB",2,"Nordeste",25017,"Campina Grande",536714,19732.9310450631,6,157,39,118,56,101,1,1,0,0,1,158,40,118,56,102,60,9.89004414576628,13.193220643161,0.266366037812856,2020-02-10,2020,2
"4848","PB",2,"Nordeste",25017,"Campina Grande",536714,19732.9310450631,7,150,40,110,58,92,1,0,1,0,1,151,40,111,58,93,67,9.89004414576628,13.193220643161,0.279058164102108,2020-02-17,2020,2
"4849","PB",2,"Nordeste",25017,"Campina Grande",536714,19732.9310450631,8,155,41,114,58,97,1,0,1,0,1,156,41,115,58,98,67,9.89004414576628,13.193220643161,0.329615840806217,2020-02-24,2020,2
"4850","PB",2,"Nordeste",25017,"Campina Grande",536714,19732.9310450631,9,153,49,104,60,93,0,0,0,0,0,153,49,104,60,93,76,9.89004414576628,13.193220643161,0.292910347089174,2020-03-02,2020,3
"4851","PB",2,"Nordeste",25017,"Campina Grande",536714,19732.9310450631,10,125,31,94,46,79,1,0,1,0,1,126,31,95,46,80,65,9.89004414576628,13.193220643161,0.31585617786677,2020-03-09,2020,3
"4852","PB",2,"Nordeste",25017,"Campina Grande",536714,19732.9310450631,11,117,36,81,47,70,0,0,0,0,0,117,36,81,47,70,65,9.89004414576628,13.193220643161,0.388389254141715,2020-03-16,2020,3
"4853","PB",2,"Nordeste",25017,"Campina Grande",536714,19732.9310450631,12,105,27,78,36,69,1,1,0,0,1,106,28,78,36,70,71,9.89004414576628,13.193220643161,0.520984486883098,2020-03-23,2020,3
"4854","PB",2,"Nordeste",25017,"Campina Grande",536714,19732.9310450631,13,123,28,95,40,83,0,0,0,0,0,123,28,95,40,83,68,9.89004414576628,13.193220643161,0.473294240632924,2020-03-30,2020,3
"4855","PB",2,"Nordeste",25017,"Campina Grande",536714,19732.9310450631,14,135,40,95,65,70,2,0,2,1,1,137,40,97,66,71,54,9.89004414576628,13.193220643161,0.455840652280562,2020-04-06,2020,4
"4856","PB",2,"Nordeste",25017,"Campina Grande",536714,19732.9310450631,15,99,39,60,41,58,0,0,0,0,0,99,39,60,41,58,79,9.89004414576628,13.193220643161,0.432120873630831,2020-04-13,2020,4
"4857","PB",2,"Nordeste",25017,"Campina Grande",536714,19732.9310450631,16,145,39,106,58,87,0,0,0,0,0,145,39,106,58,87,47,9.89004414576628,13.193220643161,0.431822201758529,2020-04-20,2020,4
"4858","PB",2,"Nordeste",25017,"Campina Grande",536714,19732.9310450631,17,147,48,99,65,82,1,0,1,0,1,148,48,100,65,83,75,9.89004414576628,13.193220643161,0.413139586445994,2020-04-27,2020,4
"4859","PB",2,"Nordeste",25017,"Campina Grande",536714,19732.9310450631,18,130,43,87,58,72,1,1,0,0,1,131,44,87,58,73,61,9.89004414576628,13.193220643161,0.406736352859993,2020-05-04,2020,5
"4860","PB",2,"Nordeste",25017,"Campina Grande",536714,19732.9310450631,19,120,40,80,37,83,1,0,1,1,0,121,40,81,38,83,95,9.89004414576628,13.193220643161,0.441912016748969,2020-05-11,2020,5
"4861","PB",2,"Nordeste",25017,"Campina Grande",536714,19732.9310450631,20,155,58,97,60,95,1,0,1,0,1,156,58,98,60,96,118,9.89004414576628,13.193220643161,0.439623160420642,2020-05-18,2020,5
"4862","PB",2,"Nordeste",25017,"Campina Grande",536714,19732.9310450631,21,159,48,111,55,104,2,2,0,2,0,161,50,111,57,104,134,9.89004414576628,13.193220643161,0.443885845863157,2020-05-25,2020,5
"4863","PB",2,"Nordeste",25018,"Itabaiana",111661,10131.3094003278,5,37,13,24,22,15,1,0,1,1,0,38,13,25,23,15,15,9.22338584854665,11.6232227745828,0.284706773381535,2020-02-03,2020,2
"4864","PB",2,"Nordeste",25018,"Itabaiana",111661,10131.3094003278,6,30,15,15,12,18,0,0,0,0,0,30,15,15,12,18,14,9.22338584854665,11.6232227745828,0.279523761398629,2020-02-10,2020,2
"4865","PB",2,"Nordeste",25018,"Itabaiana",111661,10131.3094003278,7,29,7,22,10,19,1,0,1,0,1,30,7,23,10,20,4,9.22338584854665,11.6232227745828,0.298965466798478,2020-02-17,2020,2
"4866","PB",2,"Nordeste",25018,"Itabaiana",111661,10131.3094003278,8,30,11,19,14,16,0,0,0,0,0,30,11,19,14,16,15,9.22338584854665,11.6232227745828,0.336802252584202,2020-02-24,2020,2
"4867","PB",2,"Nordeste",25018,"Itabaiana",111661,10131.3094003278,9,35,15,20,15,20,1,1,0,0,1,36,16,20,15,21,12,9.22338584854665,11.6232227745828,0.311756519309566,2020-03-02,2020,3
"4868","PB",2,"Nordeste",25018,"Itabaiana",111661,10131.3094003278,10,18,6,12,10,8,0,0,0,0,0,18,6,12,10,8,8,9.22338584854665,11.6232227745828,0.343380094638598,2020-03-09,2020,3
"4869","PB",2,"Nordeste",25018,"Itabaiana",111661,10131.3094003278,11,23,10,13,7,16,0,0,0,0,0,23,10,13,7,16,11,9.22338584854665,11.6232227745828,0.393006816583636,2020-03-16,2020,3
"4870","PB",2,"Nordeste",25018,"Itabaiana",111661,10131.3094003278,12,21,11,10,12,9,0,0,0,0,0,21,11,10,12,9,12,9.22338584854665,11.6232227745828,0.491462149016037,2020-03-23,2020,3
"4871","PB",2,"Nordeste",25018,"Itabaiana",111661,10131.3094003278,13,12,5,7,4,8,0,0,0,0,0,12,5,7,4,8,16,9.22338584854665,11.6232227745828,0.434310675541925,2020-03-30,2020,3
"4872","PB",2,"Nordeste",25018,"Itabaiana",111661,10131.3094003278,14,28,12,16,15,13,0,0,0,0,0,28,12,16,15,13,19,9.22338584854665,11.6232227745828,0.429428331990405,2020-04-06,2020,4
"4873","PB",2,"Nordeste",25018,"Itabaiana",111661,10131.3094003278,15,27,9,18,9,18,0,0,0,0,0,27,9,18,9,18,24,9.22338584854665,11.6232227745828,0.417631518009319,2020-04-13,2020,4
"4874","PB",2,"Nordeste",25018,"Itabaiana",111661,10131.3094003278,16,26,11,15,10,16,0,0,0,0,0,26,11,15,10,16,6,9.22338584854665,11.6232227745828,0.40617293490177,2020-04-20,2020,4
"4875","PB",2,"Nordeste",25018,"Itabaiana",111661,10131.3094003278,17,28,12,16,12,16,1,0,1,1,0,29,12,17,13,16,15,9.22338584854665,11.6232227745828,0.398463696555802,2020-04-27,2020,4
"4876","PB",2,"Nordeste",25018,"Itabaiana",111661,10131.3094003278,18,24,9,15,10,14,0,0,0,0,0,24,9,15,10,14,14,9.22338584854665,11.6232227745828,0.409100530451076,2020-05-04,2020,5
"4877","PB",2,"Nordeste",25018,"Itabaiana",111661,10131.3094003278,19,29,8,21,18,11,0,0,0,0,0,29,8,21,18,11,19,9.22338584854665,11.6232227745828,0.469318030634179,2020-05-11,2020,5
"4878","PB",2,"Nordeste",25018,"Itabaiana",111661,10131.3094003278,20,29,14,15,14,15,0,0,0,0,0,29,14,15,14,15,19,9.22338584854665,11.6232227745828,0.461569909928271,2020-05-18,2020,5
"4879","PB",2,"Nordeste",25018,"Itabaiana",111661,10131.3094003278,21,32,11,21,19,13,0,0,0,0,0,32,11,21,19,13,27,9.22338584854665,11.6232227745828,0.430913071935171,2020-05-25,2020,5
"4880","PB",2,"Nordeste",25019,"Umbuzeiro",54322,7853.21209068149,5,11,6,5,8,3,0,0,0,0,0,11,6,5,8,3,3,8.96867791061001,10.902684580406,0.291828586930902,2020-02-03,2020,2
"4881","PB",2,"Nordeste",25019,"Umbuzeiro",54322,7853.21209068149,6,11,3,8,5,6,0,0,0,0,0,11,3,8,5,6,5,8.96867791061001,10.902684580406,0.285033077802709,2020-02-10,2020,2
"4882","PB",2,"Nordeste",25019,"Umbuzeiro",54322,7853.21209068149,7,13,4,9,4,9,0,0,0,0,0,13,4,9,4,9,8,8.96867791061001,10.902684580406,0.29632117640473,2020-02-17,2020,2
"4883","PB",2,"Nordeste",25019,"Umbuzeiro",54322,7853.21209068149,8,10,5,5,4,6,0,0,0,0,0,10,5,5,4,6,9,8.96867791061001,10.902684580406,0.349396400058572,2020-02-24,2020,2
"4884","PB",2,"Nordeste",25019,"Umbuzeiro",54322,7853.21209068149,9,19,9,10,5,14,0,0,0,0,0,19,9,10,5,14,6,8.96867791061001,10.902684580406,0.321915511008184,2020-03-02,2020,3
"4885","PB",2,"Nordeste",25019,"Umbuzeiro",54322,7853.21209068149,10,4,2,2,2,2,0,0,0,0,0,4,2,2,2,2,10,8.96867791061001,10.902684580406,0.344412609783075,2020-03-09,2020,3
"4886","PB",2,"Nordeste",25019,"Umbuzeiro",54322,7853.21209068149,11,6,1,5,4,2,0,0,0,0,0,6,1,5,4,2,10,8.96867791061001,10.902684580406,0.416084097972661,2020-03-16,2020,3
"4887","PB",2,"Nordeste",25019,"Umbuzeiro",54322,7853.21209068149,12,14,3,11,9,5,0,0,0,0,0,14,3,11,9,5,6,8.96867791061001,10.902684580406,0.487833001383183,2020-03-23,2020,3
"4888","PB",2,"Nordeste",25019,"Umbuzeiro",54322,7853.21209068149,13,6,2,4,2,4,0,0,0,0,0,6,2,4,2,4,6,8.96867791061001,10.902684580406,0.465189406585403,2020-03-30,2020,3
"4889","PB",2,"Nordeste",25019,"Umbuzeiro",54322,7853.21209068149,14,9,4,5,6,3,0,0,0,0,0,9,4,5,6,3,7,8.96867791061001,10.902684580406,0.440098241126029,2020-04-06,2020,4
"4890","PB",2,"Nordeste",25019,"Umbuzeiro",54322,7853.21209068149,15,5,3,2,2,3,1,1,0,1,0,6,4,2,3,3,7,8.96867791061001,10.902684580406,0.42500947679127,2020-04-13,2020,4
"4891","PB",2,"Nordeste",25019,"Umbuzeiro",54322,7853.21209068149,16,10,6,4,7,3,0,0,0,0,0,10,6,4,7,3,4,8.96867791061001,10.902684580406,0.419630745145694,2020-04-20,2020,4
"4892","PB",2,"Nordeste",25019,"Umbuzeiro",54322,7853.21209068149,17,13,7,6,4,9,0,0,0,0,0,13,7,6,4,9,7,8.96867791061001,10.902684580406,0.416001257505203,2020-04-27,2020,4
"4893","PB",2,"Nordeste",25019,"Umbuzeiro",54322,7853.21209068149,18,7,2,5,3,4,1,1,0,0,1,8,3,5,3,5,6,8.96867791061001,10.902684580406,0.430281304675379,2020-05-04,2020,5
"4894","PB",2,"Nordeste",25019,"Umbuzeiro",54322,7853.21209068149,19,9,1,8,1,8,0,0,0,0,0,9,1,8,1,8,6,8.96867791061001,10.902684580406,0.481818286458161,2020-05-11,2020,5
"4895","PB",2,"Nordeste",25019,"Umbuzeiro",54322,7853.21209068149,20,17,5,12,9,8,0,0,0,0,0,17,5,12,9,8,9,8.96867791061001,10.902684580406,0.486304113171446,2020-05-18,2020,5
"4896","PB",2,"Nordeste",25019,"Umbuzeiro",54322,7853.21209068149,21,12,6,6,8,4,0,0,0,0,0,12,6,6,8,4,9,8.96867791061001,10.902684580406,0.441938996114875,2020-05-25,2020,5
"4897","PB",2,"Nordeste",25020,"Litoral Norte",153223,11900.0117603754,5,41,16,25,18,23,0,0,0,0,0,41,16,25,18,23,21,9.38429466736597,11.9396496555685,0.271699068603447,2020-02-03,2020,2
"4898","PB",2,"Nordeste",25020,"Litoral Norte",153223,11900.0117603754,6,32,7,25,20,12,1,1,0,0,1,33,8,25,20,13,28,9.38429466736597,11.9396496555685,0.272208176729118,2020-02-10,2020,2
"4899","PB",2,"Nordeste",25020,"Litoral Norte",153223,11900.0117603754,7,33,12,21,14,19,1,0,1,0,1,34,12,22,14,20,22,9.38429466736597,11.9396496555685,0.292080965605114,2020-02-17,2020,2
"4900","PB",2,"Nordeste",25020,"Litoral Norte",153223,11900.0117603754,8,60,27,33,31,29,0,0,0,0,0,60,27,33,31,29,21,9.38429466736597,11.9396496555685,0.333105114264738,2020-02-24,2020,2
"4901","PB",2,"Nordeste",25020,"Litoral Norte",153223,11900.0117603754,9,45,22,23,23,22,0,0,0,0,0,45,22,23,23,22,20,9.38429466736597,11.9396496555685,0.302399379146103,2020-03-02,2020,3
"4902","PB",2,"Nordeste",25020,"Litoral Norte",153223,11900.0117603754,10,30,18,12,13,17,1,1,0,0,1,31,19,12,13,18,14,9.38429466736597,11.9396496555685,0.330267470795129,2020-03-09,2020,3
"4903","PB",2,"Nordeste",25020,"Litoral Norte",153223,11900.0117603754,11,47,24,23,20,27,0,0,0,0,0,47,24,23,20,27,20,9.38429466736597,11.9396496555685,0.377659796720191,2020-03-16,2020,3
"4904","PB",2,"Nordeste",25020,"Litoral Norte",153223,11900.0117603754,12,41,21,20,24,17,0,0,0,0,0,41,21,20,24,17,19,9.38429466736597,11.9396496555685,0.482037929445636,2020-03-23,2020,3
"4905","PB",2,"Nordeste",25020,"Litoral Norte",153223,11900.0117603754,13,38,20,18,19,19,1,0,1,0,1,39,20,19,19,20,18,9.38429466736597,11.9396496555685,0.440345898383394,2020-03-30,2020,3
"4906","PB",2,"Nordeste",25020,"Litoral Norte",153223,11900.0117603754,14,45,28,17,22,23,0,0,0,0,0,45,28,17,22,23,19,9.38429466736597,11.9396496555685,0.416675424872853,2020-04-06,2020,4
"4907","PB",2,"Nordeste",25020,"Litoral Norte",153223,11900.0117603754,15,42,24,18,16,26,0,0,0,0,0,42,24,18,16,26,14,9.38429466736597,11.9396496555685,0.404004493303548,2020-04-13,2020,4
"4908","PB",2,"Nordeste",25020,"Litoral Norte",153223,11900.0117603754,16,55,26,29,20,35,0,0,0,0,0,55,26,29,20,35,20,9.38429466736597,11.9396496555685,0.414816384684353,2020-04-20,2020,4
"4909","PB",2,"Nordeste",25020,"Litoral Norte",153223,11900.0117603754,17,47,21,26,27,20,1,1,0,1,0,48,22,26,28,20,20,9.38429466736597,11.9396496555685,0.396815161085432,2020-04-27,2020,4
"4910","PB",2,"Nordeste",25020,"Litoral Norte",153223,11900.0117603754,18,54,26,28,22,32,0,0,0,0,0,54,26,28,22,32,17,9.38429466736597,11.9396496555685,0.415180799398447,2020-05-04,2020,5
"4911","PB",2,"Nordeste",25020,"Litoral Norte",153223,11900.0117603754,19,43,23,20,23,20,0,0,0,0,0,43,23,20,23,20,23,9.38429466736597,11.9396496555685,0.459613402489579,2020-05-11,2020,5
"4912","PB",2,"Nordeste",25020,"Litoral Norte",153223,11900.0117603754,20,50,27,23,27,23,0,0,0,0,0,50,27,23,27,23,27,9.38429466736597,11.9396496555685,0.436885792804864,2020-05-18,2020,5
"4913","PB",2,"Nordeste",25020,"Litoral Norte",153223,11900.0117603754,21,25,16,9,13,12,2,1,1,2,0,27,17,10,15,12,29,9.38429466736597,11.9396496555685,0.42350397034005,2020-05-25,2020,5
"4914","PB",2,"Nordeste",25021,"Sapé",140664,9573.26668081385,5,26,8,18,14,12,2,1,1,0,2,28,9,19,14,14,19,9.16672977215928,11.8541293468244,0.259329688951097,2020-02-03,2020,2
"4915","PB",2,"Nordeste",25021,"Sapé",140664,9573.26668081385,6,43,22,21,22,21,1,0,1,0,1,44,22,22,22,22,16,9.16672977215928,11.8541293468244,0.265777652030667,2020-02-10,2020,2
"4916","PB",2,"Nordeste",25021,"Sapé",140664,9573.26668081385,7,31,14,17,13,18,0,0,0,0,0,31,14,17,13,18,17,9.16672977215928,11.8541293468244,0.278972120952155,2020-02-17,2020,2
"4917","PB",2,"Nordeste",25021,"Sapé",140664,9573.26668081385,8,36,16,20,18,18,1,0,1,1,0,37,16,21,19,18,17,9.16672977215928,11.8541293468244,0.326392505437488,2020-02-24,2020,2
"4918","PB",2,"Nordeste",25021,"Sapé",140664,9573.26668081385,9,26,7,19,13,13,0,0,0,0,0,26,7,19,13,13,16,9.16672977215928,11.8541293468244,0.29443117906158,2020-03-02,2020,3
"4919","PB",2,"Nordeste",25021,"Sapé",140664,9573.26668081385,10,29,14,15,15,14,0,0,0,0,0,29,14,15,15,14,20,9.16672977215928,11.8541293468244,0.32935285459416,2020-03-09,2020,3
"4920","PB",2,"Nordeste",25021,"Sapé",140664,9573.26668081385,11,43,17,26,26,17,0,0,0,0,0,43,17,26,26,17,25,9.16672977215928,11.8541293468244,0.385801091459733,2020-03-16,2020,3
"4921","PB",2,"Nordeste",25021,"Sapé",140664,9573.26668081385,12,22,7,15,10,12,1,0,1,1,0,23,7,16,11,12,22,9.16672977215928,11.8541293468244,0.47974631176585,2020-03-23,2020,3
"4922","PB",2,"Nordeste",25021,"Sapé",140664,9573.26668081385,13,27,7,20,11,16,2,0,2,1,1,29,7,22,12,17,12,9.16672977215928,11.8541293468244,0.432686600579562,2020-03-30,2020,3
"4923","PB",2,"Nordeste",25021,"Sapé",140664,9573.26668081385,14,33,11,22,21,12,1,1,0,1,0,34,12,22,22,12,16,9.16672977215928,11.8541293468244,0.417305877443462,2020-04-06,2020,4
"4924","PB",2,"Nordeste",25021,"Sapé",140664,9573.26668081385,15,26,10,16,16,10,0,0,0,0,0,26,10,16,16,10,21,9.16672977215928,11.8541293468244,0.411450549539118,2020-04-13,2020,4
"4925","PB",2,"Nordeste",25021,"Sapé",140664,9573.26668081385,16,25,9,16,11,14,0,0,0,0,0,25,9,16,11,14,12,9.16672977215928,11.8541293468244,0.404389177681746,2020-04-20,2020,4
"4926","PB",2,"Nordeste",25021,"Sapé",140664,9573.26668081385,17,17,4,13,7,10,0,0,0,0,0,17,4,13,7,10,17,9.16672977215928,11.8541293468244,0.3993084854342,2020-04-27,2020,4
"4927","PB",2,"Nordeste",25021,"Sapé",140664,9573.26668081385,18,23,13,10,14,9,0,0,0,0,0,23,13,10,14,9,21,9.16672977215928,11.8541293468244,0.404757616383365,2020-05-04,2020,5
"4928","PB",2,"Nordeste",25021,"Sapé",140664,9573.26668081385,19,37,19,18,17,20,2,1,1,1,1,39,20,19,18,21,31,9.16672977215928,11.8541293468244,0.458403112831041,2020-05-11,2020,5
"4929","PB",2,"Nordeste",25021,"Sapé",140664,9573.26668081385,20,23,8,15,8,15,0,0,0,0,0,23,8,15,8,15,31,9.16672977215928,11.8541293468244,0.445145865697917,2020-05-18,2020,5
"4930","PB",2,"Nordeste",25021,"Sapé",140664,9573.26668081385,21,33,9,24,18,15,0,0,0,0,0,33,9,24,18,15,32,9.16672977215928,11.8541293468244,0.414570654386863,2020-05-25,2020,5
"4931","PB",2,"Nordeste",25022,"João Pessoa",1159054,24145.3394984013,5,293,73,220,105,188,3,0,3,1,2,296,73,223,106,190,169,10.0918466590247,13.9631147131261,0.263826606264582,2020-02-03,2020,2
"4932","PB",2,"Nordeste",25022,"João Pessoa",1159054,24145.3394984013,6,300,76,224,97,203,0,0,0,0,0,300,76,224,97,203,148,10.0918466590247,13.9631147131261,0.263224289267476,2020-02-10,2020,2
"4933","PB",2,"Nordeste",25022,"João Pessoa",1159054,24145.3394984013,7,304,87,217,107,197,3,1,2,0,3,307,88,219,107,200,124,10.0918466590247,13.9631147131261,0.281802799713017,2020-02-17,2020,2
"4934","PB",2,"Nordeste",25022,"João Pessoa",1159054,24145.3394984013,8,315,71,244,114,201,3,0,3,1,2,318,71,247,115,203,118,10.0918466590247,13.9631147131261,0.331838325568892,2020-02-24,2020,2
"4935","PB",2,"Nordeste",25022,"João Pessoa",1159054,24145.3394984013,9,340,97,243,135,205,4,2,2,2,2,344,99,245,137,207,148,10.0918466590247,13.9631147131261,0.298913746027357,2020-03-02,2020,3
"4936","PB",2,"Nordeste",25022,"João Pessoa",1159054,24145.3394984013,10,231,59,172,83,148,1,1,0,0,1,232,60,172,83,149,152,10.0918466590247,13.9631147131261,0.318769281589407,2020-03-09,2020,3
"4937","PB",2,"Nordeste",25022,"João Pessoa",1159054,24145.3394984013,11,250,78,172,96,154,5,1,4,2,3,255,79,176,98,157,162,10.0918466590247,13.9631147131261,0.403304763842743,2020-03-16,2020,3
"4938","PB",2,"Nordeste",25022,"João Pessoa",1159054,24145.3394984013,12,224,55,169,77,147,3,0,3,0,3,227,55,172,77,150,135,10.0918466590247,13.9631147131261,0.548803914698162,2020-03-23,2020,3
"4939","PB",2,"Nordeste",25022,"João Pessoa",1159054,24145.3394984013,13,216,49,167,89,127,4,3,1,1,3,220,52,168,90,130,154,10.0918466590247,13.9631147131261,0.493480476055122,2020-03-30,2020,3
"4940","PB",2,"Nordeste",25022,"João Pessoa",1159054,24145.3394984013,14,216,55,161,91,125,2,1,1,0,2,218,56,162,91,127,148,10.0918466590247,13.9631147131261,0.482383612044184,2020-04-06,2020,4
"4941","PB",2,"Nordeste",25022,"João Pessoa",1159054,24145.3394984013,15,212,57,155,80,132,4,2,2,2,2,216,59,157,82,134,172,10.0918466590247,13.9631147131261,0.468746178522903,2020-04-13,2020,4
"4942","PB",2,"Nordeste",25022,"João Pessoa",1159054,24145.3394984013,16,216,59,157,81,135,2,0,2,0,2,218,59,159,81,137,166,10.0918466590247,13.9631147131261,0.472039556698175,2020-04-20,2020,4
"4943","PB",2,"Nordeste",25022,"João Pessoa",1159054,24145.3394984013,17,241,57,184,88,153,5,4,1,3,2,246,61,185,91,155,196,10.0918466590247,13.9631147131261,0.455871528393675,2020-04-27,2020,4
"4944","PB",2,"Nordeste",25022,"João Pessoa",1159054,24145.3394984013,18,235,72,163,89,146,2,1,1,0,2,237,73,164,89,148,257,10.0918466590247,13.9631147131261,0.445932481591656,2020-05-04,2020,5
"4945","PB",2,"Nordeste",25022,"João Pessoa",1159054,24145.3394984013,19,238,57,181,84,154,2,1,1,2,0,240,58,182,86,154,271,10.0918466590247,13.9631147131261,0.483248877807486,2020-05-11,2020,5
"4946","PB",2,"Nordeste",25022,"João Pessoa",1159054,24145.3394984013,20,242,63,179,88,154,3,2,1,0,3,245,65,180,88,157,262,10.0918466590247,13.9631147131261,0.476936167567244,2020-05-18,2020,5
"4947","PB",2,"Nordeste",25022,"João Pessoa",1159054,24145.3394984013,21,271,70,201,85,186,3,2,1,1,2,274,72,202,86,188,291,10.0918466590247,13.9631147131261,0.447027971321105,2020-05-25,2020,5
"4948","PB",2,"Nordeste",25023,"Litoral Sul",89490,25286.0757657839,5,24,12,12,13,11,0,0,0,0,0,24,12,12,13,11,19,10.1380091582204,11.4018821661769,0.277902179181516,2020-02-03,2020,2
"4949","PB",2,"Nordeste",25023,"Litoral Sul",89490,25286.0757657839,6,23,11,12,8,15,0,0,0,0,0,23,11,12,8,15,5,10.1380091582204,11.4018821661769,0.276052405553969,2020-02-10,2020,2
"4950","PB",2,"Nordeste",25023,"Litoral Sul",89490,25286.0757657839,7,32,8,24,12,20,0,0,0,0,0,32,8,24,12,20,9,10.1380091582204,11.4018821661769,0.298671408375893,2020-02-17,2020,2
"4951","PB",2,"Nordeste",25023,"Litoral Sul",89490,25286.0757657839,8,26,10,16,13,13,0,0,0,0,0,26,10,16,13,13,14,10.1380091582204,11.4018821661769,0.328366947666937,2020-02-24,2020,2
"4952","PB",2,"Nordeste",25023,"Litoral Sul",89490,25286.0757657839,9,28,15,13,11,17,0,0,0,0,0,28,15,13,11,17,11,10.1380091582204,11.4018821661769,0.31105674682324,2020-03-02,2020,3
"4953","PB",2,"Nordeste",25023,"Litoral Sul",89490,25286.0757657839,10,14,5,9,5,9,0,0,0,0,0,14,5,9,5,9,13,10.1380091582204,11.4018821661769,0.333859525592366,2020-03-09,2020,3
"4954","PB",2,"Nordeste",25023,"Litoral Sul",89490,25286.0757657839,11,19,7,12,12,7,0,0,0,0,0,19,7,12,12,7,9,10.1380091582204,11.4018821661769,0.387122164272738,2020-03-16,2020,3
"4955","PB",2,"Nordeste",25023,"Litoral Sul",89490,25286.0757657839,12,19,4,15,6,13,0,0,0,0,0,19,4,15,6,13,17,10.1380091582204,11.4018821661769,0.481789616311422,2020-03-23,2020,3
"4956","PB",2,"Nordeste",25023,"Litoral Sul",89490,25286.0757657839,13,28,7,21,11,17,0,0,0,0,0,28,7,21,11,17,15,10.1380091582204,11.4018821661769,0.441415492321356,2020-03-30,2020,3
"4957","PB",2,"Nordeste",25023,"Litoral Sul",89490,25286.0757657839,14,23,10,13,12,11,0,0,0,0,0,23,10,13,12,11,10,10.1380091582204,11.4018821661769,0.422445878163448,2020-04-06,2020,4
"4958","PB",2,"Nordeste",25023,"Litoral Sul",89490,25286.0757657839,15,23,8,15,11,12,0,0,0,0,0,23,8,15,11,12,9,10.1380091582204,11.4018821661769,0.415148557198617,2020-04-13,2020,4
"4959","PB",2,"Nordeste",25023,"Litoral Sul",89490,25286.0757657839,16,18,10,8,9,9,0,0,0,0,0,18,10,8,9,9,8,10.1380091582204,11.4018821661769,0.414869274217623,2020-04-20,2020,4
"4960","PB",2,"Nordeste",25023,"Litoral Sul",89490,25286.0757657839,17,22,8,14,9,13,0,0,0,0,0,22,8,14,9,13,14,10.1380091582204,11.4018821661769,0.415452629631082,2020-04-27,2020,4
"4961","PB",2,"Nordeste",25023,"Litoral Sul",89490,25286.0757657839,18,19,6,13,7,12,0,0,0,0,0,19,6,13,7,12,18,10.1380091582204,11.4018821661769,0.423127404180626,2020-05-04,2020,5
"4962","PB",2,"Nordeste",25023,"Litoral Sul",89490,25286.0757657839,19,24,9,15,9,15,0,0,0,0,0,24,9,15,9,15,19,10.1380091582204,11.4018821661769,0.465043196657623,2020-05-11,2020,5
"4963","PB",2,"Nordeste",25023,"Litoral Sul",89490,25286.0757657839,20,26,9,17,11,15,1,1,0,1,0,27,10,17,12,15,17,10.1380091582204,11.4018821661769,0.461661350642776,2020-05-18,2020,5
"4964","PB",2,"Nordeste",25023,"Litoral Sul",89490,25286.0757657839,21,16,8,8,7,9,2,1,1,0,2,18,9,9,7,11,14,10.1380091582204,11.4018821661769,0.421121745626265,2020-05-25,2020,5
"4965","PE",2,"Nordeste",26001,"Araripina",335907,9679.03150035575,5,85,33,52,50,35,2,0,2,1,1,87,33,54,51,36,29,9.17771712364898,12.7245896149188,0.271222056296693,2020-02-03,2020,2
"4966","PE",2,"Nordeste",26001,"Araripina",335907,9679.03150035575,6,101,42,59,40,61,1,1,0,0,1,102,43,59,40,62,42,9.17771712364898,12.7245896149188,0.264474938569372,2020-02-10,2020,2
"4967","PE",2,"Nordeste",26001,"Araripina",335907,9679.03150035575,7,108,43,65,55,53,4,1,3,1,3,112,44,68,56,56,40,9.17771712364898,12.7245896149188,0.279299812396411,2020-02-17,2020,2
"4968","PE",2,"Nordeste",26001,"Araripina",335907,9679.03150035575,8,108,54,54,53,55,1,1,0,1,0,109,55,54,54,55,40,9.17771712364898,12.7245896149188,0.310809489952895,2020-02-24,2020,2
"4969","PE",2,"Nordeste",26001,"Araripina",335907,9679.03150035575,9,111,43,68,62,49,3,0,3,1,2,114,43,71,63,51,43,9.17771712364898,12.7245896149188,0.291739464396737,2020-03-02,2020,3
"4970","PE",2,"Nordeste",26001,"Araripina",335907,9679.03150035575,10,89,35,54,42,47,2,1,1,0,2,91,36,55,42,49,44,9.17771712364898,12.7245896149188,0.309279953891586,2020-03-09,2020,3
"4971","PE",2,"Nordeste",26001,"Araripina",335907,9679.03150035575,11,87,36,51,42,45,2,2,0,0,2,89,38,51,42,47,43,9.17771712364898,12.7245896149188,0.372590398794231,2020-03-16,2020,3
"4972","PE",2,"Nordeste",26001,"Araripina",335907,9679.03150035575,12,67,29,38,29,38,0,0,0,0,0,67,29,38,29,38,44,9.17771712364898,12.7245896149188,0.468269134303463,2020-03-23,2020,3
"4973","PE",2,"Nordeste",26001,"Araripina",335907,9679.03150035575,13,86,32,54,47,39,2,1,1,0,2,88,33,55,47,41,41,9.17771712364898,12.7245896149188,0.432278611783735,2020-03-30,2020,3
"4974","PE",2,"Nordeste",26001,"Araripina",335907,9679.03150035575,14,86,44,42,47,39,0,0,0,0,0,86,44,42,47,39,46,9.17771712364898,12.7245896149188,0.407697656963724,2020-04-06,2020,4
"4975","PE",2,"Nordeste",26001,"Araripina",335907,9679.03150035575,15,82,38,44,40,42,1,1,0,0,1,83,39,44,40,43,42,9.17771712364898,12.7245896149188,0.398699887746743,2020-04-13,2020,4
"4976","PE",2,"Nordeste",26001,"Araripina",335907,9679.03150035575,16,89,34,55,44,45,2,0,2,1,1,91,34,57,45,46,45,9.17771712364898,12.7245896149188,0.387829931295812,2020-04-20,2020,4
"4977","PE",2,"Nordeste",26001,"Araripina",335907,9679.03150035575,17,89,41,48,51,38,1,0,1,1,0,90,41,49,52,38,43,9.17771712364898,12.7245896149188,0.391062498704631,2020-04-27,2020,4
"4978","PE",2,"Nordeste",26001,"Araripina",335907,9679.03150035575,18,92,40,52,51,41,2,0,2,0,2,94,40,54,51,43,40,9.17771712364898,12.7245896149188,0.401862548242895,2020-05-04,2020,5
"4979","PE",2,"Nordeste",26001,"Araripina",335907,9679.03150035575,19,107,44,63,45,62,3,2,1,1,2,110,46,64,46,64,45,9.17771712364898,12.7245896149188,0.43170300795586,2020-05-11,2020,5
"4980","PE",2,"Nordeste",26001,"Araripina",335907,9679.03150035575,20,102,36,66,39,63,2,1,1,1,1,104,37,67,40,64,46,9.17771712364898,12.7245896149188,0.41893994476223,2020-05-18,2020,5
"4981","PE",2,"Nordeste",26001,"Araripina",335907,9679.03150035575,21,111,45,66,62,49,1,0,1,0,1,112,45,67,62,50,31,9.17771712364898,12.7245896149188,0.410022095638895,2020-05-25,2020,5
"4982","PE",2,"Nordeste",26002,"Salgueiro",173486,10117.767896545,5,48,10,38,26,22,0,0,0,0,0,48,10,38,26,22,16,9.22204835493122,12.0638521834707,0.268391321367343,2020-02-03,2020,2
"4983","PE",2,"Nordeste",26002,"Salgueiro",173486,10117.767896545,6,39,11,28,17,22,0,0,0,0,0,39,11,28,17,22,16,9.22204835493122,12.0638521834707,0.260025925179493,2020-02-10,2020,2
"4984","PE",2,"Nordeste",26002,"Salgueiro",173486,10117.767896545,7,58,13,45,22,36,0,0,0,0,0,58,13,45,22,36,6,9.22204835493122,12.0638521834707,0.276184026010524,2020-02-17,2020,2
"4985","PE",2,"Nordeste",26002,"Salgueiro",173486,10117.767896545,8,61,17,44,37,24,1,0,1,1,0,62,17,45,38,24,18,9.22204835493122,12.0638521834707,0.302665461202462,2020-02-24,2020,2
"4986","PE",2,"Nordeste",26002,"Salgueiro",173486,10117.767896545,9,47,8,39,16,31,0,0,0,0,0,47,8,39,16,31,21,9.22204835493122,12.0638521834707,0.29661663274657,2020-03-02,2020,3
"4987","PE",2,"Nordeste",26002,"Salgueiro",173486,10117.767896545,10,51,12,39,23,28,0,0,0,0,0,51,12,39,23,28,24,9.22204835493122,12.0638521834707,0.31607010545598,2020-03-09,2020,3
"4988","PE",2,"Nordeste",26002,"Salgueiro",173486,10117.767896545,11,50,13,37,24,26,1,1,0,0,1,51,14,37,24,27,25,9.22204835493122,12.0638521834707,0.379320731669626,2020-03-16,2020,3
"4989","PE",2,"Nordeste",26002,"Salgueiro",173486,10117.767896545,12,43,7,36,24,19,0,0,0,0,0,43,7,36,24,19,23,9.22204835493122,12.0638521834707,0.466372373596842,2020-03-23,2020,3
"4990","PE",2,"Nordeste",26002,"Salgueiro",173486,10117.767896545,13,41,14,27,16,25,1,0,1,0,1,42,14,28,16,26,17,9.22204835493122,12.0638521834707,0.429956233556007,2020-03-30,2020,3
"4991","PE",2,"Nordeste",26002,"Salgueiro",173486,10117.767896545,14,35,9,26,18,17,1,1,0,1,0,36,10,26,19,17,26,9.22204835493122,12.0638521834707,0.41530849998888,2020-04-06,2020,4
"4992","PE",2,"Nordeste",26002,"Salgueiro",173486,10117.767896545,15,35,9,26,16,19,1,0,1,0,1,36,9,27,16,20,19,9.22204835493122,12.0638521834707,0.412443078175965,2020-04-13,2020,4
"4993","PE",2,"Nordeste",26002,"Salgueiro",173486,10117.767896545,16,36,11,25,11,25,0,0,0,0,0,36,11,25,11,25,24,9.22204835493122,12.0638521834707,0.398939077934313,2020-04-20,2020,4
"4994","PE",2,"Nordeste",26002,"Salgueiro",173486,10117.767896545,17,43,10,33,18,25,2,0,2,2,0,45,10,35,20,25,28,9.22204835493122,12.0638521834707,0.397282509682295,2020-04-27,2020,4
"4995","PE",2,"Nordeste",26002,"Salgueiro",173486,10117.767896545,18,58,16,42,26,32,0,0,0,0,0,58,16,42,26,32,32,9.22204835493122,12.0638521834707,0.404833670595582,2020-05-04,2020,5
"4996","PE",2,"Nordeste",26002,"Salgueiro",173486,10117.767896545,19,69,23,46,32,37,2,0,2,0,2,71,23,48,32,39,18,9.22204835493122,12.0638521834707,0.434516792412947,2020-05-11,2020,5
"4997","PE",2,"Nordeste",26002,"Salgueiro",173486,10117.767896545,20,36,11,25,10,26,1,0,1,0,1,37,11,26,10,27,20,9.22204835493122,12.0638521834707,0.43004981257675,2020-05-18,2020,5
"4998","PE",2,"Nordeste",26002,"Salgueiro",173486,10117.767896545,21,54,12,42,23,31,1,0,1,1,0,55,12,43,24,31,21,9.22204835493122,12.0638521834707,0.42384926771813,2020-05-25,2020,5
"4999","PE",2,"Nordeste",26003,"Pajeú",333724,10933.3804186094,5,76,8,68,33,43,2,0,2,1,1,78,8,70,34,44,37,9.29957581227498,12.7180695830403,0.256841569262875,2020-02-03,2020,2
"5000","PE",2,"Nordeste",26003,"Pajeú",333724,10933.3804186094,6,95,13,82,44,51,1,1,0,0,1,96,14,82,44,52,25,9.29957581227498,12.7180695830403,0.253839186385192,2020-02-10,2020,2
"5001","PE",2,"Nordeste",26003,"Pajeú",333724,10933.3804186094,7,101,27,74,39,62,1,1,0,0,1,102,28,74,39,63,45,9.29957581227498,12.7180695830403,0.26328476261908,2020-02-17,2020,2
"5002","PE",2,"Nordeste",26003,"Pajeú",333724,10933.3804186094,8,91,25,66,35,56,2,2,0,0,2,93,27,66,35,58,42,9.29957581227498,12.7180695830403,0.303841842931393,2020-02-24,2020,2
"5003","PE",2,"Nordeste",26003,"Pajeú",333724,10933.3804186094,9,81,14,67,32,49,1,0,1,1,0,82,14,68,33,49,64,9.29957581227498,12.7180695830403,0.291677677570169,2020-03-02,2020,3
"5004","PE",2,"Nordeste",26003,"Pajeú",333724,10933.3804186094,10,100,18,82,38,62,0,0,0,0,0,100,18,82,38,62,51,9.29957581227498,12.7180695830403,0.305965273219478,2020-03-09,2020,3
"5005","PE",2,"Nordeste",26003,"Pajeú",333724,10933.3804186094,11,72,12,60,30,42,4,1,3,2,2,76,13,63,32,44,51,9.29957581227498,12.7180695830403,0.370667548253633,2020-03-16,2020,3
"5006","PE",2,"Nordeste",26003,"Pajeú",333724,10933.3804186094,12,84,15,69,34,50,0,0,0,0,0,84,15,69,34,50,52,9.29957581227498,12.7180695830403,0.455817644711882,2020-03-23,2020,3
"5007","PE",2,"Nordeste",26003,"Pajeú",333724,10933.3804186094,13,70,9,61,21,49,0,0,0,0,0,70,9,61,21,49,48,9.29957581227498,12.7180695830403,0.415654065999987,2020-03-30,2020,3
"5008","PE",2,"Nordeste",26003,"Pajeú",333724,10933.3804186094,14,75,18,57,36,39,1,0,1,1,0,76,18,58,37,39,57,9.29957581227498,12.7180695830403,0.402967417075067,2020-04-06,2020,4
"5009","PE",2,"Nordeste",26003,"Pajeú",333724,10933.3804186094,15,79,19,60,35,44,1,1,0,1,0,80,20,60,36,44,38,9.29957581227498,12.7180695830403,0.399817410388094,2020-04-13,2020,4
"5010","PE",2,"Nordeste",26003,"Pajeú",333724,10933.3804186094,16,82,24,58,44,38,0,0,0,0,0,82,24,58,44,38,49,9.29957581227498,12.7180695830403,0.395617167502788,2020-04-20,2020,4
"5011","PE",2,"Nordeste",26003,"Pajeú",333724,10933.3804186094,17,79,10,69,34,45,1,0,1,0,1,80,10,70,34,46,47,9.29957581227498,12.7180695830403,0.383113573385115,2020-04-27,2020,4
"5012","PE",2,"Nordeste",26003,"Pajeú",333724,10933.3804186094,18,77,17,60,28,49,1,1,0,1,0,78,18,60,29,49,53,9.29957581227498,12.7180695830403,0.391116343487332,2020-05-04,2020,5
"5013","PE",2,"Nordeste",26003,"Pajeú",333724,10933.3804186094,19,93,19,74,48,45,0,0,0,0,0,93,19,74,48,45,50,9.29957581227498,12.7180695830403,0.414177700412461,2020-05-11,2020,5
"5014","PE",2,"Nordeste",26003,"Pajeú",333724,10933.3804186094,20,88,16,72,40,48,0,0,0,0,0,88,16,72,40,48,51,9.29957581227498,12.7180695830403,0.410283033857485,2020-05-18,2020,5
"5015","PE",2,"Nordeste",26003,"Pajeú",333724,10933.3804186094,21,78,14,64,30,48,1,1,0,0,1,79,15,64,30,49,54,9.29957581227498,12.7180695830403,0.408320455682765,2020-05-25,2020,5
"5016","PE",2,"Nordeste",26004,"Sertão do Moxotó",235845,11330.3460396447,5,52,22,30,18,34,0,0,0,0,0,52,22,30,18,34,19,9.33523989544839,12.3709300885725,0.274869537701863,2020-02-03,2020,2
"5017","PE",2,"Nordeste",26004,"Sertão do Moxotó",235845,11330.3460396447,6,55,26,29,29,26,0,0,0,0,0,55,26,29,29,26,26,9.33523989544839,12.3709300885725,0.265414952839769,2020-02-10,2020,2
"5018","PE",2,"Nordeste",26004,"Sertão do Moxotó",235845,11330.3460396447,7,59,15,44,24,35,1,1,0,1,0,60,16,44,25,35,34,9.33523989544839,12.3709300885725,0.281620957728709,2020-02-17,2020,2
"5019","PE",2,"Nordeste",26004,"Sertão do Moxotó",235845,11330.3460396447,8,71,25,46,32,39,2,2,0,2,0,73,27,46,34,39,19,9.33523989544839,12.3709300885725,0.327312370949001,2020-02-24,2020,2
"5020","PE",2,"Nordeste",26004,"Sertão do Moxotó",235845,11330.3460396447,9,66,30,36,26,40,1,1,0,0,1,67,31,36,26,41,23,9.33523989544839,12.3709300885725,0.304224531115313,2020-03-02,2020,3
"5021","PE",2,"Nordeste",26004,"Sertão do Moxotó",235845,11330.3460396447,10,55,20,35,26,29,2,1,1,1,1,57,21,36,27,30,26,9.33523989544839,12.3709300885725,0.326129929567501,2020-03-09,2020,3
"5022","PE",2,"Nordeste",26004,"Sertão do Moxotó",235845,11330.3460396447,11,47,13,34,15,32,1,1,0,0,1,48,14,34,15,33,28,9.33523989544839,12.3709300885725,0.378402298687698,2020-03-16,2020,3
"5023","PE",2,"Nordeste",26004,"Sertão do Moxotó",235845,11330.3460396447,12,54,15,39,24,30,0,0,0,0,0,54,15,39,24,30,35,9.33523989544839,12.3709300885725,0.462013957279922,2020-03-23,2020,3
"5024","PE",2,"Nordeste",26004,"Sertão do Moxotó",235845,11330.3460396447,13,46,22,24,26,20,0,0,0,0,0,46,22,24,26,20,29,9.33523989544839,12.3709300885725,0.423602482729215,2020-03-30,2020,3
"5025","PE",2,"Nordeste",26004,"Sertão do Moxotó",235845,11330.3460396447,14,46,16,30,22,24,0,0,0,0,0,46,16,30,22,24,35,9.33523989544839,12.3709300885725,0.415421190895995,2020-04-06,2020,4
"5026","PE",2,"Nordeste",26004,"Sertão do Moxotó",235845,11330.3460396447,15,49,18,31,22,27,0,0,0,0,0,49,18,31,22,27,18,9.33523989544839,12.3709300885725,0.409424836061071,2020-04-13,2020,4
"5027","PE",2,"Nordeste",26004,"Sertão do Moxotó",235845,11330.3460396447,16,56,20,36,25,31,1,0,1,0,1,57,20,37,25,32,31,9.33523989544839,12.3709300885725,0.412607490446195,2020-04-20,2020,4
"5028","PE",2,"Nordeste",26004,"Sertão do Moxotó",235845,11330.3460396447,17,68,27,41,33,35,2,2,0,0,2,70,29,41,33,37,24,9.33523989544839,12.3709300885725,0.410275187775541,2020-04-27,2020,4
"5029","PE",2,"Nordeste",26004,"Sertão do Moxotó",235845,11330.3460396447,18,64,28,36,35,29,1,0,1,0,1,65,28,37,35,30,32,9.33523989544839,12.3709300885725,0.411387822939719,2020-05-04,2020,5
"5030","PE",2,"Nordeste",26004,"Sertão do Moxotó",235845,11330.3460396447,19,65,21,44,34,31,0,0,0,0,0,65,21,44,34,31,27,9.33523989544839,12.3709300885725,0.440350611559532,2020-05-11,2020,5
"5031","PE",2,"Nordeste",26004,"Sertão do Moxotó",235845,11330.3460396447,20,68,24,44,34,34,2,1,1,1,1,70,25,45,35,35,39,9.33523989544839,12.3709300885725,0.425323831698904,2020-05-18,2020,5
"5032","PE",2,"Nordeste",26004,"Sertão do Moxotó",235845,11330.3460396447,21,58,20,38,23,35,0,0,0,0,0,58,20,38,23,35,36,9.33523989544839,12.3709300885725,0.421786688504981,2020-05-25,2020,5
"5033","PE",2,"Nordeste",26005,"Petrolina",521016,17102.4699638207,5,171,52,119,70,101,2,2,0,0,2,173,54,119,70,103,53,9.74697817438866,13.1635360304367,0.259775917894698,2020-02-03,2020,2
"5034","PE",2,"Nordeste",26005,"Petrolina",521016,17102.4699638207,6,154,45,109,67,87,3,2,1,3,0,157,47,110,70,87,43,9.74697817438866,13.1635360304367,0.262363522153257,2020-02-10,2020,2
"5035","PE",2,"Nordeste",26005,"Petrolina",521016,17102.4699638207,7,187,55,132,70,117,2,1,1,1,1,189,56,133,71,118,50,9.74697817438866,13.1635360304367,0.279156559616985,2020-02-17,2020,2
"5036","PE",2,"Nordeste",26005,"Petrolina",521016,17102.4699638207,8,166,44,122,64,102,1,0,1,0,1,167,44,123,64,103,61,9.74697817438866,13.1635360304367,0.318221280140849,2020-02-24,2020,2
"5037","PE",2,"Nordeste",26005,"Petrolina",521016,17102.4699638207,9,140,38,102,67,73,1,0,1,1,0,141,38,103,68,73,60,9.74697817438866,13.1635360304367,0.301654278133719,2020-03-02,2020,3
"5038","PE",2,"Nordeste",26005,"Petrolina",521016,17102.4699638207,10,170,53,117,74,96,3,0,3,2,1,173,53,120,76,97,51,9.74697817438866,13.1635360304367,0.311489902040838,2020-03-09,2020,3
"5039","PE",2,"Nordeste",26005,"Petrolina",521016,17102.4699638207,11,120,36,84,58,62,4,0,4,1,3,124,36,88,59,65,52,9.74697817438866,13.1635360304367,0.398160878048429,2020-03-16,2020,3
"5040","PE",2,"Nordeste",26005,"Petrolina",521016,17102.4699638207,12,124,35,89,53,71,1,0,1,0,1,125,35,90,53,72,48,9.74697817438866,13.1635360304367,0.503506628994547,2020-03-23,2020,3
"5041","PE",2,"Nordeste",26005,"Petrolina",521016,17102.4699638207,13,151,36,115,62,89,0,0,0,0,0,151,36,115,62,89,52,9.74697817438866,13.1635360304367,0.458664773062804,2020-03-30,2020,3
"5042","PE",2,"Nordeste",26005,"Petrolina",521016,17102.4699638207,14,127,39,88,56,71,2,1,1,1,1,129,40,89,57,72,64,9.74697817438866,13.1635360304367,0.440542457977398,2020-04-06,2020,4
"5043","PE",2,"Nordeste",26005,"Petrolina",521016,17102.4699638207,15,156,47,109,65,91,1,1,0,0,1,157,48,109,65,92,67,9.74697817438866,13.1635360304367,0.425108012248425,2020-04-13,2020,4
"5044","PE",2,"Nordeste",26005,"Petrolina",521016,17102.4699638207,16,147,40,107,65,82,1,0,1,0,1,148,40,108,65,83,45,9.74697817438866,13.1635360304367,0.425602818833687,2020-04-20,2020,4
"5045","PE",2,"Nordeste",26005,"Petrolina",521016,17102.4699638207,17,168,46,122,67,101,3,1,2,2,1,171,47,124,69,102,47,9.74697817438866,13.1635360304367,0.411665025093074,2020-04-27,2020,4
"5046","PE",2,"Nordeste",26005,"Petrolina",521016,17102.4699638207,18,164,47,117,70,94,1,0,1,0,1,165,47,118,70,95,61,9.74697817438866,13.1635360304367,0.407059115666091,2020-05-04,2020,5
"5047","PE",2,"Nordeste",26005,"Petrolina",521016,17102.4699638207,19,168,52,116,73,95,2,0,2,1,1,170,52,118,74,96,57,9.74697817438866,13.1635360304367,0.433520152587472,2020-05-11,2020,5
"5048","PE",2,"Nordeste",26005,"Petrolina",521016,17102.4699638207,20,169,52,117,62,107,1,0,1,1,0,170,52,118,63,107,47,9.74697817438866,13.1635360304367,0.423139846681039,2020-05-18,2020,5
"5049","PE",2,"Nordeste",26005,"Petrolina",521016,17102.4699638207,21,166,45,121,70,96,1,1,0,1,0,167,46,121,71,96,52,9.74697817438866,13.1635360304367,0.416350694163017,2020-05-25,2020,5
"5050","PE",2,"Nordeste",26006,"Itaparica",149762,16877.7463606923,5,31,15,16,15,16,0,0,0,0,0,31,15,16,15,16,15,9.73375124979911,11.9168026463231,0.286270231065787,2020-02-03,2020,2
"5051","PE",2,"Nordeste",26006,"Itaparica",149762,16877.7463606923,6,25,8,17,8,17,1,0,1,0,1,26,8,18,8,18,11,9.73375124979911,11.9168026463231,0.26785574589648,2020-02-10,2020,2
"5052","PE",2,"Nordeste",26006,"Itaparica",149762,16877.7463606923,7,31,10,21,21,10,0,0,0,0,0,31,10,21,21,10,16,9.73375124979911,11.9168026463231,0.287018851291848,2020-02-17,2020,2
"5053","PE",2,"Nordeste",26006,"Itaparica",149762,16877.7463606923,8,34,14,20,15,19,2,0,2,1,1,36,14,22,16,20,14,9.73375124979911,11.9168026463231,0.331591363614606,2020-02-24,2020,2
"5054","PE",2,"Nordeste",26006,"Itaparica",149762,16877.7463606923,9,43,18,25,27,16,0,0,0,0,0,43,18,25,27,16,18,9.73375124979911,11.9168026463231,0.314630196293933,2020-03-02,2020,3
"5055","PE",2,"Nordeste",26006,"Itaparica",149762,16877.7463606923,10,32,10,22,16,16,1,0,1,0,1,33,10,23,16,17,14,9.73375124979911,11.9168026463231,0.35456197058596,2020-03-09,2020,3
"5056","PE",2,"Nordeste",26006,"Itaparica",149762,16877.7463606923,11,37,16,21,16,21,0,0,0,0,0,37,16,21,16,21,9,9.73375124979911,11.9168026463231,0.383355257369729,2020-03-16,2020,3
"5057","PE",2,"Nordeste",26006,"Itaparica",149762,16877.7463606923,12,33,11,22,15,18,0,0,0,0,0,33,11,22,15,18,18,9.73375124979911,11.9168026463231,0.474853980958534,2020-03-23,2020,3
"5058","PE",2,"Nordeste",26006,"Itaparica",149762,16877.7463606923,13,37,13,24,18,19,0,0,0,0,0,37,13,24,18,19,11,9.73375124979911,11.9168026463231,0.435884771837113,2020-03-30,2020,3
"5059","PE",2,"Nordeste",26006,"Itaparica",149762,16877.7463606923,14,45,15,30,29,16,1,1,0,0,1,46,16,30,29,17,16,9.73375124979911,11.9168026463231,0.429635968400101,2020-04-06,2020,4
"5060","PE",2,"Nordeste",26006,"Itaparica",149762,16877.7463606923,15,32,9,23,16,16,0,0,0,0,0,32,9,23,16,16,11,9.73375124979911,11.9168026463231,0.4117222229213,2020-04-13,2020,4
"5061","PE",2,"Nordeste",26006,"Itaparica",149762,16877.7463606923,16,43,17,26,22,21,0,0,0,0,0,43,17,26,22,21,19,9.73375124979911,11.9168026463231,0.409389922476988,2020-04-20,2020,4
"5062","PE",2,"Nordeste",26006,"Itaparica",149762,16877.7463606923,17,51,17,34,25,26,1,1,0,1,0,52,18,34,26,26,19,9.73375124979911,11.9168026463231,0.400638333175761,2020-04-27,2020,4
"5063","PE",2,"Nordeste",26006,"Itaparica",149762,16877.7463606923,18,39,12,27,20,19,1,1,0,0,1,40,13,27,20,20,20,9.73375124979911,11.9168026463231,0.40554962571394,2020-05-04,2020,5
"5064","PE",2,"Nordeste",26006,"Itaparica",149762,16877.7463606923,19,45,13,32,20,25,0,0,0,0,0,45,13,32,20,25,14,9.73375124979911,11.9168026463231,0.447825418468066,2020-05-11,2020,5
"5065","PE",2,"Nordeste",26006,"Itaparica",149762,16877.7463606923,20,48,23,25,22,26,0,0,0,0,0,48,23,25,22,26,17,9.73375124979911,11.9168026463231,0.417800784046216,2020-05-18,2020,5
"5066","PE",2,"Nordeste",26006,"Itaparica",149762,16877.7463606923,21,38,15,23,25,13,2,2,0,1,1,40,17,23,26,14,17,9.73375124979911,11.9168026463231,0.423769181579452,2020-05-25,2020,5
"5067","PE",2,"Nordeste",26007,"Vale do Ipanema",197793,8315.52206387486,5,44,26,18,19,25,0,0,0,0,0,44,26,18,19,25,21,9.02587917544981,12.1949763082624,0.274946951263241,2020-02-03,2020,2
"5068","PE",2,"Nordeste",26007,"Vale do Ipanema",197793,8315.52206387486,6,47,25,22,20,27,0,0,0,0,0,47,25,22,20,27,26,9.02587917544981,12.1949763082624,0.265680083524026,2020-02-10,2020,2
"5069","PE",2,"Nordeste",26007,"Vale do Ipanema",197793,8315.52206387486,7,60,30,30,27,33,0,0,0,0,0,60,30,30,27,33,24,9.02587917544981,12.1949763082624,0.277462808034001,2020-02-17,2020,2
"5070","PE",2,"Nordeste",26007,"Vale do Ipanema",197793,8315.52206387486,8,50,21,29,21,29,0,0,0,0,0,50,21,29,21,29,30,9.02587917544981,12.1949763082624,0.324179661460447,2020-02-24,2020,2
"5071","PE",2,"Nordeste",26007,"Vale do Ipanema",197793,8315.52206387486,9,67,35,32,32,35,3,2,1,0,3,70,37,33,32,38,25,9.02587917544981,12.1949763082624,0.296970373618635,2020-03-02,2020,3
"5072","PE",2,"Nordeste",26007,"Vale do Ipanema",197793,8315.52206387486,10,40,18,22,20,20,0,0,0,0,0,40,18,22,20,20,25,9.02587917544981,12.1949763082624,0.322158399000304,2020-03-09,2020,3
"5073","PE",2,"Nordeste",26007,"Vale do Ipanema",197793,8315.52206387486,11,39,16,23,23,16,1,0,1,1,0,40,16,24,24,16,20,9.02587917544981,12.1949763082624,0.382098958999783,2020-03-16,2020,3
"5074","PE",2,"Nordeste",26007,"Vale do Ipanema",197793,8315.52206387486,12,43,21,22,26,17,0,0,0,0,0,43,21,22,26,17,23,9.02587917544981,12.1949763082624,0.447977874394696,2020-03-23,2020,3
"5075","PE",2,"Nordeste",26007,"Vale do Ipanema",197793,8315.52206387486,13,37,16,21,19,18,0,0,0,0,0,37,16,21,19,18,24,9.02587917544981,12.1949763082624,0.403854891576902,2020-03-30,2020,3
"5076","PE",2,"Nordeste",26007,"Vale do Ipanema",197793,8315.52206387486,14,44,29,15,22,22,2,1,1,1,1,46,30,16,23,23,11,9.02587917544981,12.1949763082624,0.400665974803491,2020-04-06,2020,4
"5077","PE",2,"Nordeste",26007,"Vale do Ipanema",197793,8315.52206387486,15,38,29,9,17,21,0,0,0,0,0,38,29,9,17,21,24,9.02587917544981,12.1949763082624,0.382208539187235,2020-04-13,2020,4
"5078","PE",2,"Nordeste",26007,"Vale do Ipanema",197793,8315.52206387486,16,47,23,24,20,27,1,1,0,0,1,48,24,24,20,28,28,9.02587917544981,12.1949763082624,0.388066609771576,2020-04-20,2020,4
"5079","PE",2,"Nordeste",26007,"Vale do Ipanema",197793,8315.52206387486,17,59,33,26,22,37,2,1,1,0,2,61,34,27,22,39,27,9.02587917544981,12.1949763082624,0.388997114799982,2020-04-27,2020,4
"5080","PE",2,"Nordeste",26007,"Vale do Ipanema",197793,8315.52206387486,18,60,32,28,33,27,0,0,0,0,0,60,32,28,33,27,34,9.02587917544981,12.1949763082624,0.407718198905825,2020-05-04,2020,5
"5081","PE",2,"Nordeste",26007,"Vale do Ipanema",197793,8315.52206387486,19,44,20,24,30,14,0,0,0,0,0,44,20,24,30,14,33,9.02587917544981,12.1949763082624,0.438016815325037,2020-05-11,2020,5
"5082","PE",2,"Nordeste",26007,"Vale do Ipanema",197793,8315.52206387486,20,50,32,18,23,27,1,0,1,1,0,51,32,19,24,27,32,9.02587917544981,12.1949763082624,0.438069631476892,2020-05-18,2020,5
"5083","PE",2,"Nordeste",26007,"Vale do Ipanema",197793,8315.52206387486,21,44,30,14,22,22,0,0,0,0,0,44,30,14,22,22,34,9.02587917544981,12.1949763082624,0.43116611890737,2020-05-25,2020,5
"5084","PE",2,"Nordeste",26008,"Vale do Ipojuca",948109,15767.8703915056,5,225,90,135,90,135,2,1,1,0,2,227,91,136,90,137,126,9.66572962908198,13.7622247535305,0.270264454617041,2020-02-03,2020,2
"5085","PE",2,"Nordeste",26008,"Vale do Ipojuca",948109,15767.8703915056,6,245,98,147,101,144,3,2,1,1,2,248,100,148,102,146,117,9.66572962908198,13.7622247535305,0.268743716351855,2020-02-10,2020,2
"5086","PE",2,"Nordeste",26008,"Vale do Ipojuca",948109,15767.8703915056,7,235,97,138,110,125,1,1,0,1,0,236,98,138,111,125,137,9.66572962908198,13.7622247535305,0.28260462757419,2020-02-17,2020,2
"5087","PE",2,"Nordeste",26008,"Vale do Ipojuca",948109,15767.8703915056,8,237,107,130,103,134,2,0,2,2,0,239,107,132,105,134,148,9.66572962908198,13.7622247535305,0.339111026286624,2020-02-24,2020,2
"5088","PE",2,"Nordeste",26008,"Vale do Ipojuca",948109,15767.8703915056,9,227,88,139,94,133,4,0,4,2,2,231,88,143,96,135,135,9.66572962908198,13.7622247535305,0.306547694985293,2020-03-02,2020,3
"5089","PE",2,"Nordeste",26008,"Vale do Ipojuca",948109,15767.8703915056,10,199,86,113,83,116,0,0,0,0,0,199,86,113,83,116,133,9.66572962908198,13.7622247535305,0.321959454289749,2020-03-09,2020,3
"5090","PE",2,"Nordeste",26008,"Vale do Ipojuca",948109,15767.8703915056,11,228,86,142,96,132,3,1,2,2,1,231,87,144,98,133,136,9.66572962908198,13.7622247535305,0.393671889141311,2020-03-16,2020,3
"5091","PE",2,"Nordeste",26008,"Vale do Ipojuca",948109,15767.8703915056,12,258,116,142,106,152,3,1,2,3,0,261,117,144,109,152,130,9.66572962908198,13.7622247535305,0.504832023908214,2020-03-23,2020,3
"5092","PE",2,"Nordeste",26008,"Vale do Ipojuca",948109,15767.8703915056,13,224,81,143,96,128,4,2,2,1,3,228,83,145,97,131,124,9.66572962908198,13.7622247535305,0.461021988221616,2020-03-30,2020,3
"5093","PE",2,"Nordeste",26008,"Vale do Ipojuca",948109,15767.8703915056,14,208,83,125,92,116,2,2,0,2,0,210,85,125,94,116,123,9.66572962908198,13.7622247535305,0.44867269935957,2020-04-06,2020,4
"5094","PE",2,"Nordeste",26008,"Vale do Ipojuca",948109,15767.8703915056,15,234,101,133,95,139,1,1,0,0,1,235,102,133,95,140,138,9.66572962908198,13.7622247535305,0.436710504603269,2020-04-13,2020,4
"5095","PE",2,"Nordeste",26008,"Vale do Ipojuca",948109,15767.8703915056,16,253,114,139,95,158,1,1,0,0,1,254,115,139,95,159,138,9.66572962908198,13.7622247535305,0.433836791253904,2020-04-20,2020,4
"5096","PE",2,"Nordeste",26008,"Vale do Ipojuca",948109,15767.8703915056,17,221,81,140,103,118,1,0,1,0,1,222,81,141,103,119,146,9.66572962908198,13.7622247535305,0.413904699889531,2020-04-27,2020,4
"5097","PE",2,"Nordeste",26008,"Vale do Ipojuca",948109,15767.8703915056,18,218,93,125,87,131,2,2,0,2,0,220,95,125,89,131,153,9.66572962908198,13.7622247535305,0.414398183089695,2020-05-04,2020,5
"5098","PE",2,"Nordeste",26008,"Vale do Ipojuca",948109,15767.8703915056,19,230,99,131,102,128,0,0,0,0,0,230,99,131,102,128,141,9.66572962908198,13.7622247535305,0.4440325117531,2020-05-11,2020,5
"5099","PE",2,"Nordeste",26008,"Vale do Ipojuca",948109,15767.8703915056,20,244,106,138,109,135,0,0,0,0,0,244,106,138,109,135,156,9.66572962908198,13.7622247535305,0.442416395492566,2020-05-18,2020,5
"5100","PE",2,"Nordeste",26008,"Vale do Ipojuca",948109,15767.8703915056,21,275,114,161,118,157,0,0,0,0,0,275,114,161,118,157,174,9.66572962908198,13.7622247535305,0.428352787828375,2020-05-25,2020,5
"5101","PE",2,"Nordeste",26009,"Alto Capibaribe",323497,11886.3973965446,5,86,40,46,34,52,1,0,1,0,1,87,40,47,34,53,38,9.38314994936944,12.6869451193098,0.277574025093664,2020-02-03,2020,2
"5102","PE",2,"Nordeste",26009,"Alto Capibaribe",323497,11886.3973965446,6,78,34,44,36,42,1,1,0,1,0,79,35,44,37,42,31,9.38314994936944,12.6869451193098,0.278777487180891,2020-02-10,2020,2
"5103","PE",2,"Nordeste",26009,"Alto Capibaribe",323497,11886.3973965446,7,83,42,41,38,45,1,0,1,1,0,84,42,42,39,45,35,9.38314994936944,12.6869451193098,0.294319063320759,2020-02-17,2020,2
"5104","PE",2,"Nordeste",26009,"Alto Capibaribe",323497,11886.3973965446,8,64,29,35,33,31,1,1,0,0,1,65,30,35,33,32,38,9.38314994936944,12.6869451193098,0.351670913461606,2020-02-24,2020,2
"5105","PE",2,"Nordeste",26009,"Alto Capibaribe",323497,11886.3973965446,9,74,42,32,33,41,1,0,1,0,1,75,42,33,33,42,35,9.38314994936944,12.6869451193098,0.318828230367984,2020-03-02,2020,3
"5106","PE",2,"Nordeste",26009,"Alto Capibaribe",323497,11886.3973965446,10,58,21,37,30,28,0,0,0,0,0,58,21,37,30,28,31,9.38314994936944,12.6869451193098,0.33802405091584,2020-03-09,2020,3
"5107","PE",2,"Nordeste",26009,"Alto Capibaribe",323497,11886.3973965446,11,67,25,42,30,37,0,0,0,0,0,67,25,42,30,37,39,9.38314994936944,12.6869451193098,0.399918796981292,2020-03-16,2020,3
"5108","PE",2,"Nordeste",26009,"Alto Capibaribe",323497,11886.3973965446,12,76,36,40,37,39,0,0,0,0,0,76,36,40,37,39,34,9.38314994936944,12.6869451193098,0.52541915044589,2020-03-23,2020,3
"5109","PE",2,"Nordeste",26009,"Alto Capibaribe",323497,11886.3973965446,13,68,32,36,31,37,1,0,1,0,1,69,32,37,31,38,34,9.38314994936944,12.6869451193098,0.479072562123833,2020-03-30,2020,3
"5110","PE",2,"Nordeste",26009,"Alto Capibaribe",323497,11886.3973965446,14,68,20,48,30,38,0,0,0,0,0,68,20,48,30,38,36,9.38314994936944,12.6869451193098,0.460450260182886,2020-04-06,2020,4
"5111","PE",2,"Nordeste",26009,"Alto Capibaribe",323497,11886.3973965446,15,63,32,31,25,38,3,2,1,1,2,66,34,32,26,40,29,9.38314994936944,12.6869451193098,0.443637960749946,2020-04-13,2020,4
"5112","PE",2,"Nordeste",26009,"Alto Capibaribe",323497,11886.3973965446,16,62,23,39,24,38,1,1,0,0,1,63,24,39,24,39,33,9.38314994936944,12.6869451193098,0.432505406315102,2020-04-20,2020,4
"5113","PE",2,"Nordeste",26009,"Alto Capibaribe",323497,11886.3973965446,17,87,46,41,39,48,1,1,0,1,0,88,47,41,40,48,28,9.38314994936944,12.6869451193098,0.411044636745129,2020-04-27,2020,4
"5114","PE",2,"Nordeste",26009,"Alto Capibaribe",323497,11886.3973965446,18,57,24,33,23,34,0,0,0,0,0,57,24,33,23,34,44,9.38314994936944,12.6869451193098,0.414703002169114,2020-05-04,2020,5
"5115","PE",2,"Nordeste",26009,"Alto Capibaribe",323497,11886.3973965446,19,84,33,51,37,47,0,0,0,0,0,84,33,51,37,47,43,9.38314994936944,12.6869451193098,0.438013844834079,2020-05-11,2020,5
"5116","PE",2,"Nordeste",26009,"Alto Capibaribe",323497,11886.3973965446,20,79,34,45,34,45,1,0,1,0,1,80,34,46,34,46,42,9.38314994936944,12.6869451193098,0.433610870912436,2020-05-18,2020,5
"5117","PE",2,"Nordeste",26009,"Alto Capibaribe",323497,11886.3973965446,21,91,42,49,39,52,0,0,0,0,0,91,42,49,39,52,45,9.38314994936944,12.6869451193098,0.412864595533568,2020-05-25,2020,5
"5118","PE",2,"Nordeste",26010,"Médio Capibaribe",260251,10475.9001214212,5,52,11,41,18,34,1,1,0,0,1,53,12,41,18,35,35,9.25683267154447,12.469401828929,0.272270679545366,2020-02-03,2020,2
"5119","PE",2,"Nordeste",26010,"Médio Capibaribe",260251,10475.9001214212,6,58,19,39,27,31,3,1,2,1,2,61,20,41,28,33,30,9.25683267154447,12.469401828929,0.272983560906661,2020-02-10,2020,2
"5120","PE",2,"Nordeste",26010,"Médio Capibaribe",260251,10475.9001214212,7,65,23,42,24,41,1,0,1,0,1,66,23,43,24,42,29,9.25683267154447,12.469401828929,0.281322880154344,2020-02-17,2020,2
"5121","PE",2,"Nordeste",26010,"Médio Capibaribe",260251,10475.9001214212,8,65,20,45,24,41,0,0,0,0,0,65,20,45,24,41,32,9.25683267154447,12.469401828929,0.331714015829077,2020-02-24,2020,2
"5122","PE",2,"Nordeste",26010,"Médio Capibaribe",260251,10475.9001214212,9,70,31,39,32,38,0,0,0,0,0,70,31,39,32,38,44,9.25683267154447,12.469401828929,0.301494880415173,2020-03-02,2020,3
"5123","PE",2,"Nordeste",26010,"Médio Capibaribe",260251,10475.9001214212,10,51,14,37,19,32,1,1,0,1,0,52,15,37,20,32,41,9.25683267154447,12.469401828929,0.318008908369979,2020-03-09,2020,3
"5124","PE",2,"Nordeste",26010,"Médio Capibaribe",260251,10475.9001214212,11,52,23,29,23,29,0,0,0,0,0,52,23,29,23,29,45,9.25683267154447,12.469401828929,0.383517987031526,2020-03-16,2020,3
"5125","PE",2,"Nordeste",26010,"Médio Capibaribe",260251,10475.9001214212,12,35,12,23,16,19,0,0,0,0,0,35,12,23,16,19,45,9.25683267154447,12.469401828929,0.465022978169714,2020-03-23,2020,3
"5126","PE",2,"Nordeste",26010,"Médio Capibaribe",260251,10475.9001214212,13,60,28,32,26,34,0,0,0,0,0,60,28,32,26,34,30,9.25683267154447,12.469401828929,0.430677074806319,2020-03-30,2020,3
"5127","PE",2,"Nordeste",26010,"Médio Capibaribe",260251,10475.9001214212,14,46,16,30,24,22,0,0,0,0,0,46,16,30,24,22,53,9.25683267154447,12.469401828929,0.428513082079816,2020-04-06,2020,4
"5128","PE",2,"Nordeste",26010,"Médio Capibaribe",260251,10475.9001214212,15,46,14,32,20,26,1,0,1,0,1,47,14,33,20,27,39,9.25683267154447,12.469401828929,0.419742295338357,2020-04-13,2020,4
"5129","PE",2,"Nordeste",26010,"Médio Capibaribe",260251,10475.9001214212,16,51,16,35,29,22,0,0,0,0,0,51,16,35,29,22,37,9.25683267154447,12.469401828929,0.414075694929948,2020-04-20,2020,4
"5130","PE",2,"Nordeste",26010,"Médio Capibaribe",260251,10475.9001214212,17,58,15,43,27,31,1,1,0,0,1,59,16,43,27,32,46,9.25683267154447,12.469401828929,0.402643701755917,2020-04-27,2020,4
"5131","PE",2,"Nordeste",26010,"Médio Capibaribe",260251,10475.9001214212,18,60,17,43,24,36,1,0,1,0,1,61,17,44,24,37,63,9.25683267154447,12.469401828929,0.399266123827858,2020-05-04,2020,5
"5132","PE",2,"Nordeste",26010,"Médio Capibaribe",260251,10475.9001214212,19,67,25,42,27,40,1,1,0,1,0,68,26,42,28,40,48,9.25683267154447,12.469401828929,0.432551260333467,2020-05-11,2020,5
"5133","PE",2,"Nordeste",26010,"Médio Capibaribe",260251,10475.9001214212,20,51,21,30,27,24,0,0,0,0,0,51,21,30,27,24,65,9.25683267154447,12.469401828929,0.436384799598622,2020-05-18,2020,5
"5134","PE",2,"Nordeste",26010,"Médio Capibaribe",260251,10475.9001214212,21,66,25,41,25,41,0,0,0,0,0,66,25,41,25,41,47,9.25683267154447,12.469401828929,0.410367869017985,2020-05-25,2020,5
"5135","PE",2,"Nordeste",26011,"Garanhuns",472537,12772.7918776096,5,121,58,63,38,83,1,1,0,1,0,122,59,63,39,83,86,9.45507255297827,13.0658713297284,0.264172626708362,2020-02-03,2020,2
"5136","PE",2,"Nordeste",26011,"Garanhuns",472537,12772.7918776096,6,115,52,63,44,71,0,0,0,0,0,115,52,63,44,71,64,9.45507255297827,13.0658713297284,0.258321539009477,2020-02-10,2020,2
"5137","PE",2,"Nordeste",26011,"Garanhuns",472537,12772.7918776096,7,111,44,67,43,68,1,0,1,1,0,112,44,68,44,68,66,9.45507255297827,13.0658713297284,0.270065459236994,2020-02-17,2020,2
"5138","PE",2,"Nordeste",26011,"Garanhuns",472537,12772.7918776096,8,128,58,70,73,55,1,0,1,0,1,129,58,71,73,56,65,9.45507255297827,13.0658713297284,0.323349045731552,2020-02-24,2020,2
"5139","PE",2,"Nordeste",26011,"Garanhuns",472537,12772.7918776096,9,117,55,62,49,68,0,0,0,0,0,117,55,62,49,68,56,9.45507255297827,13.0658713297284,0.292823525067009,2020-03-02,2020,3
"5140","PE",2,"Nordeste",26011,"Garanhuns",472537,12772.7918776096,10,96,54,42,39,57,2,1,1,0,2,98,55,43,39,59,66,9.45507255297827,13.0658713297284,0.314343001718526,2020-03-09,2020,3
"5141","PE",2,"Nordeste",26011,"Garanhuns",472537,12772.7918776096,11,100,43,57,40,60,0,0,0,0,0,100,43,57,40,60,45,9.45507255297827,13.0658713297284,0.383530903010991,2020-03-16,2020,3
"5142","PE",2,"Nordeste",26011,"Garanhuns",472537,12772.7918776096,12,101,49,52,48,53,1,0,1,1,0,102,49,53,49,53,66,9.45507255297827,13.0658713297284,0.490185045858147,2020-03-23,2020,3
"5143","PE",2,"Nordeste",26011,"Garanhuns",472537,12772.7918776096,13,89,34,55,31,58,3,1,2,1,2,92,35,57,32,60,75,9.45507255297827,13.0658713297284,0.430082900669785,2020-03-30,2020,3
"5144","PE",2,"Nordeste",26011,"Garanhuns",472537,12772.7918776096,14,107,42,65,51,56,2,1,1,0,2,109,43,66,51,58,66,9.45507255297827,13.0658713297284,0.423395217546364,2020-04-06,2020,4
"5145","PE",2,"Nordeste",26011,"Garanhuns",472537,12772.7918776096,15,113,47,66,53,60,3,2,1,1,2,116,49,67,54,62,66,9.45507255297827,13.0658713297284,0.416370628117841,2020-04-13,2020,4
"5146","PE",2,"Nordeste",26011,"Garanhuns",472537,12772.7918776096,16,106,43,63,40,66,1,0,1,1,0,107,43,64,41,66,54,9.45507255297827,13.0658713297284,0.412835474243764,2020-04-20,2020,4
"5147","PE",2,"Nordeste",26011,"Garanhuns",472537,12772.7918776096,17,120,56,64,45,75,3,1,2,1,2,123,57,66,46,77,77,9.45507255297827,13.0658713297284,0.392622637103872,2020-04-27,2020,4
"5148","PE",2,"Nordeste",26011,"Garanhuns",472537,12772.7918776096,18,111,56,55,42,69,0,0,0,0,0,111,56,55,42,69,78,9.45507255297827,13.0658713297284,0.396731519205715,2020-05-04,2020,5
"5149","PE",2,"Nordeste",26011,"Garanhuns",472537,12772.7918776096,19,127,64,63,57,70,0,0,0,0,0,127,64,63,57,70,75,9.45507255297827,13.0658713297284,0.428498113749028,2020-05-11,2020,5
"5150","PE",2,"Nordeste",26011,"Garanhuns",472537,12772.7918776096,20,124,57,67,54,70,2,1,1,1,1,126,58,68,55,71,79,9.45507255297827,13.0658713297284,0.431900896865407,2020-05-18,2020,5
"5151","PE",2,"Nordeste",26011,"Garanhuns",472537,12772.7918776096,21,127,52,75,53,74,1,0,1,1,0,128,52,76,54,74,61,9.45507255297827,13.0658713297284,0.419907695714011,2020-05-25,2020,5
"5152","PE",2,"Nordeste",26012,"Brejo Pernambucano",225453,9079.43439213495,5,57,21,36,25,32,0,0,0,0,0,57,21,36,25,32,38,9.11376717804004,12.3258669904806,0.271803571792137,2020-02-03,2020,2
"5153","PE",2,"Nordeste",26012,"Brejo Pernambucano",225453,9079.43439213495,6,65,27,38,34,31,1,0,1,0,1,66,27,39,34,32,36,9.11376717804004,12.3258669904806,0.272174440488708,2020-02-10,2020,2
"5154","PE",2,"Nordeste",26012,"Brejo Pernambucano",225453,9079.43439213495,7,54,23,31,28,26,1,1,0,1,0,55,24,31,29,26,34,9.11376717804004,12.3258669904806,0.282584061496389,2020-02-17,2020,2
"5155","PE",2,"Nordeste",26012,"Brejo Pernambucano",225453,9079.43439213495,8,67,31,36,34,33,1,0,1,1,0,68,31,37,35,33,30,9.11376717804004,12.3258669904806,0.335094460571318,2020-02-24,2020,2
"5156","PE",2,"Nordeste",26012,"Brejo Pernambucano",225453,9079.43439213495,9,57,26,31,25,32,0,0,0,0,0,57,26,31,25,32,50,9.11376717804004,12.3258669904806,0.308205282345461,2020-03-02,2020,3
"5157","PE",2,"Nordeste",26012,"Brejo Pernambucano",225453,9079.43439213495,10,43,26,17,22,21,0,0,0,0,0,43,26,17,22,21,51,9.11376717804004,12.3258669904806,0.329195790742292,2020-03-09,2020,3
"5158","PE",2,"Nordeste",26012,"Brejo Pernambucano",225453,9079.43439213495,11,47,23,24,23,24,2,0,2,0,2,49,23,26,23,26,35,9.11376717804004,12.3258669904806,0.383683608758802,2020-03-16,2020,3
"5159","PE",2,"Nordeste",26012,"Brejo Pernambucano",225453,9079.43439213495,12,41,19,22,23,18,0,0,0,0,0,41,19,22,23,18,42,9.11376717804004,12.3258669904806,0.473032302822378,2020-03-23,2020,3
"5160","PE",2,"Nordeste",26012,"Brejo Pernambucano",225453,9079.43439213495,13,52,25,27,20,32,0,0,0,0,0,52,25,27,20,32,31,9.11376717804004,12.3258669904806,0.428154421922925,2020-03-30,2020,3
"5161","PE",2,"Nordeste",26012,"Brejo Pernambucano",225453,9079.43439213495,14,51,23,28,27,24,0,0,0,0,0,51,23,28,27,24,35,9.11376717804004,12.3258669904806,0.409907769920918,2020-04-06,2020,4
"5162","PE",2,"Nordeste",26012,"Brejo Pernambucano",225453,9079.43439213495,15,49,23,26,27,22,0,0,0,0,0,49,23,26,27,22,36,9.11376717804004,12.3258669904806,0.400503874407813,2020-04-13,2020,4
"5163","PE",2,"Nordeste",26012,"Brejo Pernambucano",225453,9079.43439213495,16,41,22,19,20,21,0,0,0,0,0,41,22,19,20,21,25,9.11376717804004,12.3258669904806,0.39948692439686,2020-04-20,2020,4
"5164","PE",2,"Nordeste",26012,"Brejo Pernambucano",225453,9079.43439213495,17,47,23,24,21,26,1,0,1,0,1,48,23,25,21,27,40,9.11376717804004,12.3258669904806,0.385972963827243,2020-04-27,2020,4
"5165","PE",2,"Nordeste",26012,"Brejo Pernambucano",225453,9079.43439213495,18,54,19,35,29,25,0,0,0,0,0,54,19,35,29,25,42,9.11376717804004,12.3258669904806,0.396007719158661,2020-05-04,2020,5
"5166","PE",2,"Nordeste",26012,"Brejo Pernambucano",225453,9079.43439213495,19,54,30,24,30,24,1,0,1,1,0,55,30,25,31,24,33,9.11376717804004,12.3258669904806,0.425955818056485,2020-05-11,2020,5
"5167","PE",2,"Nordeste",26012,"Brejo Pernambucano",225453,9079.43439213495,20,56,24,32,25,31,1,1,0,1,0,57,25,32,26,31,51,9.11376717804004,12.3258669904806,0.429823144250641,2020-05-18,2020,5
"5168","PE",2,"Nordeste",26012,"Brejo Pernambucano",225453,9079.43439213495,21,44,15,29,24,20,0,0,0,0,0,44,15,29,24,20,42,9.11376717804004,12.3258669904806,0.40782329343565,2020-05-25,2020,5
"5169","PE",2,"Nordeste",26013,"Mata Setentrional Pernambucana",570923,27202.2446623625,5,148,52,96,69,79,1,0,1,0,1,149,52,97,69,80,85,10.2110547732307,13.2550096284066,0.275642077455642,2020-02-03,2020,2
"5170","PE",2,"Nordeste",26013,"Mata Setentrional Pernambucana",570923,27202.2446623625,6,138,49,89,64,74,3,0,3,1,2,141,49,92,65,76,71,10.2110547732307,13.2550096284066,0.270563975274994,2020-02-10,2020,2
"5171","PE",2,"Nordeste",26013,"Mata Setentrional Pernambucana",570923,27202.2446623625,7,124,37,87,54,70,1,0,1,0,1,125,37,88,54,71,68,10.2110547732307,13.2550096284066,0.284731905614369,2020-02-17,2020,2
"5172","PE",2,"Nordeste",26013,"Mata Setentrional Pernambucana",570923,27202.2446623625,8,137,48,89,72,65,2,1,1,1,1,139,49,90,73,66,80,10.2110547732307,13.2550096284066,0.340942161976865,2020-02-24,2020,2
"5173","PE",2,"Nordeste",26013,"Mata Setentrional Pernambucana",570923,27202.2446623625,9,126,46,80,57,69,0,0,0,0,0,126,46,80,57,69,77,10.2110547732307,13.2550096284066,0.312575966575574,2020-03-02,2020,3
"5174","PE",2,"Nordeste",26013,"Mata Setentrional Pernambucana",570923,27202.2446623625,10,130,48,82,66,64,0,0,0,0,0,130,48,82,66,64,91,10.2110547732307,13.2550096284066,0.328830831574947,2020-03-09,2020,3
"5175","PE",2,"Nordeste",26013,"Mata Setentrional Pernambucana",570923,27202.2446623625,11,118,45,73,55,63,0,0,0,0,0,118,45,73,55,63,76,10.2110547732307,13.2550096284066,0.389963583296488,2020-03-16,2020,3
"5176","PE",2,"Nordeste",26013,"Mata Setentrional Pernambucana",570923,27202.2446623625,12,106,42,64,54,52,0,0,0,0,0,106,42,64,54,52,82,10.2110547732307,13.2550096284066,0.486383296238979,2020-03-23,2020,3
"5177","PE",2,"Nordeste",26013,"Mata Setentrional Pernambucana",570923,27202.2446623625,13,95,31,64,59,36,1,0,1,1,0,96,31,65,60,36,87,10.2110547732307,13.2550096284066,0.454424063461125,2020-03-30,2020,3
"5178","PE",2,"Nordeste",26013,"Mata Setentrional Pernambucana",570923,27202.2446623625,14,110,37,73,50,60,1,0,1,0,1,111,37,74,50,61,95,10.2110547732307,13.2550096284066,0.44360452771148,2020-04-06,2020,4
"5179","PE",2,"Nordeste",26013,"Mata Setentrional Pernambucana",570923,27202.2446623625,15,117,33,84,61,56,1,0,1,0,1,118,33,85,61,57,84,10.2110547732307,13.2550096284066,0.433313962246378,2020-04-13,2020,4
"5180","PE",2,"Nordeste",26013,"Mata Setentrional Pernambucana",570923,27202.2446623625,16,128,46,82,67,61,2,0,2,1,1,130,46,84,68,62,97,10.2110547732307,13.2550096284066,0.430470729738997,2020-04-20,2020,4
"5181","PE",2,"Nordeste",26013,"Mata Setentrional Pernambucana",570923,27202.2446623625,17,124,38,86,61,63,0,0,0,0,0,124,38,86,61,63,100,10.2110547732307,13.2550096284066,0.416854455297599,2020-04-27,2020,4
"5182","PE",2,"Nordeste",26013,"Mata Setentrional Pernambucana",570923,27202.2446623625,18,140,56,84,66,74,1,0,1,1,0,141,56,85,67,74,124,10.2110547732307,13.2550096284066,0.421498909586272,2020-05-04,2020,5
"5183","PE",2,"Nordeste",26013,"Mata Setentrional Pernambucana",570923,27202.2446623625,19,128,34,94,62,66,0,0,0,0,0,128,34,94,62,66,134,10.2110547732307,13.2550096284066,0.453275343628044,2020-05-11,2020,5
"5184","PE",2,"Nordeste",26013,"Mata Setentrional Pernambucana",570923,27202.2446623625,20,132,50,82,61,71,2,2,0,1,1,134,52,82,62,72,140,10.2110547732307,13.2550096284066,0.443002619726437,2020-05-18,2020,5
"5185","PE",2,"Nordeste",26013,"Mata Setentrional Pernambucana",570923,27202.2446623625,21,125,42,83,57,68,6,1,5,1,5,131,43,88,58,73,121,10.2110547732307,13.2550096284066,0.421982624357212,2020-05-25,2020,5
"5186","PE",2,"Nordeste",26014,"Vitória de Santo Antão",232853,21234.6616443421,5,63,25,38,30,33,0,0,0,0,0,63,25,38,30,33,30,9.9633901087538,12.3581626321583,0.261632733351013,2020-02-03,2020,2
"5187","PE",2,"Nordeste",26014,"Vitória de Santo Antão",232853,21234.6616443421,6,62,21,41,26,36,0,0,0,0,0,62,21,41,26,36,33,9.9633901087538,12.3581626321583,0.259877641633802,2020-02-10,2020,2
"5188","PE",2,"Nordeste",26014,"Vitória de Santo Antão",232853,21234.6616443421,7,60,18,42,23,37,1,0,1,0,1,61,18,43,23,38,35,9.9633901087538,12.3581626321583,0.275417311879855,2020-02-17,2020,2
"5189","PE",2,"Nordeste",26014,"Vitória de Santo Antão",232853,21234.6616443421,8,56,18,38,17,39,0,0,0,0,0,56,18,38,17,39,40,9.9633901087538,12.3581626321583,0.327221519805353,2020-02-24,2020,2
"5190","PE",2,"Nordeste",26014,"Vitória de Santo Antão",232853,21234.6616443421,9,54,20,34,25,29,1,0,1,0,1,55,20,35,25,30,31,9.9633901087538,12.3581626321583,0.298836344288878,2020-03-02,2020,3
"5191","PE",2,"Nordeste",26014,"Vitória de Santo Antão",232853,21234.6616443421,10,59,19,40,26,33,0,0,0,0,0,59,19,40,26,33,30,9.9633901087538,12.3581626321583,0.309765744686499,2020-03-09,2020,3
"5192","PE",2,"Nordeste",26014,"Vitória de Santo Antão",232853,21234.6616443421,11,40,16,24,15,25,0,0,0,0,0,40,16,24,15,25,36,9.9633901087538,12.3581626321583,0.379000164662152,2020-03-16,2020,3
"5193","PE",2,"Nordeste",26014,"Vitória de Santo Antão",232853,21234.6616443421,12,46,18,28,15,31,0,0,0,0,0,46,18,28,15,31,31,9.9633901087538,12.3581626321583,0.472788395095501,2020-03-23,2020,3
"5194","PE",2,"Nordeste",26014,"Vitória de Santo Antão",232853,21234.6616443421,13,40,17,23,20,20,0,0,0,0,0,40,17,23,20,20,33,9.9633901087538,12.3581626321583,0.434038407577642,2020-03-30,2020,3
"5195","PE",2,"Nordeste",26014,"Vitória de Santo Antão",232853,21234.6616443421,14,55,17,38,26,29,0,0,0,0,0,55,17,38,26,29,34,9.9633901087538,12.3581626321583,0.421094237976441,2020-04-06,2020,4
"5196","PE",2,"Nordeste",26014,"Vitória de Santo Antão",232853,21234.6616443421,15,47,18,29,17,30,2,0,2,1,1,49,18,31,18,31,49,9.9633901087538,12.3581626321583,0.423976250492974,2020-04-13,2020,4
"5197","PE",2,"Nordeste",26014,"Vitória de Santo Antão",232853,21234.6616443421,16,49,19,30,26,23,0,0,0,0,0,49,19,30,26,23,42,9.9633901087538,12.3581626321583,0.435237786761657,2020-04-20,2020,4
"5198","PE",2,"Nordeste",26014,"Vitória de Santo Antão",232853,21234.6616443421,17,54,20,34,25,29,0,0,0,0,0,54,20,34,25,29,67,9.9633901087538,12.3581626321583,0.421977333101556,2020-04-27,2020,4
"5199","PE",2,"Nordeste",26014,"Vitória de Santo Antão",232853,21234.6616443421,18,55,22,33,25,30,0,0,0,0,0,55,22,33,25,30,78,9.9633901087538,12.3581626321583,0.418551655606484,2020-05-04,2020,5
"5200","PE",2,"Nordeste",26014,"Vitória de Santo Antão",232853,21234.6616443421,19,53,23,30,20,33,0,0,0,0,0,53,23,30,20,33,80,9.9633901087538,12.3581626321583,0.444562249211669,2020-05-11,2020,5
"5201","PE",2,"Nordeste",26014,"Vitória de Santo Antão",232853,21234.6616443421,20,53,15,38,28,25,0,0,0,0,0,53,15,38,28,25,68,9.9633901087538,12.3581626321583,0.440311856135822,2020-05-18,2020,5
"5202","PE",2,"Nordeste",26014,"Vitória de Santo Antão",232853,21234.6616443421,21,52,17,35,25,27,0,0,0,0,0,52,17,35,25,27,55,9.9633901087538,12.3581626321583,0.406746534186818,2020-05-25,2020,5
"5203","PE",2,"Nordeste",26015,"Mata Meridional Pernambucana",608639,10015.3338776516,5,114,40,74,53,61,1,1,0,0,1,115,41,74,53,62,73,9.21187258530275,13.3189805958904,0.282724202161515,2020-02-03,2020,2
"5204","PE",2,"Nordeste",26015,"Mata Meridional Pernambucana",608639,10015.3338776516,6,115,36,79,68,47,2,1,1,1,1,117,37,80,69,48,82,9.21187258530275,13.3189805958904,0.277097223012026,2020-02-10,2020,2
"5205","PE",2,"Nordeste",26015,"Mata Meridional Pernambucana",608639,10015.3338776516,7,145,49,96,90,55,0,0,0,0,0,145,49,96,90,55,74,9.21187258530275,13.3189805958904,0.295314172156423,2020-02-17,2020,2
"5206","PE",2,"Nordeste",26015,"Mata Meridional Pernambucana",608639,10015.3338776516,8,107,35,72,52,55,0,0,0,0,0,107,35,72,52,55,83,9.21187258530275,13.3189805958904,0.336679429496968,2020-02-24,2020,2
"5207","PE",2,"Nordeste",26015,"Mata Meridional Pernambucana",608639,10015.3338776516,9,124,49,75,66,58,1,0,1,0,1,125,49,76,66,59,95,9.21187258530275,13.3189805958904,0.314767934835841,2020-03-02,2020,3
"5208","PE",2,"Nordeste",26015,"Mata Meridional Pernambucana",608639,10015.3338776516,10,104,36,68,53,51,4,0,4,1,3,108,36,72,54,54,75,9.21187258530275,13.3189805958904,0.343173698301516,2020-03-09,2020,3
"5209","PE",2,"Nordeste",26015,"Mata Meridional Pernambucana",608639,10015.3338776516,11,109,48,61,55,54,2,0,2,1,1,111,48,63,56,55,87,9.21187258530275,13.3189805958904,0.397217046942178,2020-03-16,2020,3
"5210","PE",2,"Nordeste",26015,"Mata Meridional Pernambucana",608639,10015.3338776516,12,108,44,64,55,53,1,1,0,1,0,109,45,64,56,53,83,9.21187258530275,13.3189805958904,0.493706354040796,2020-03-23,2020,3
"5211","PE",2,"Nordeste",26015,"Mata Meridional Pernambucana",608639,10015.3338776516,13,119,49,70,60,59,0,0,0,0,0,119,49,70,60,59,64,9.21187258530275,13.3189805958904,0.453114195410086,2020-03-30,2020,3
"5212","PE",2,"Nordeste",26015,"Mata Meridional Pernambucana",608639,10015.3338776516,14,115,43,72,59,56,1,0,1,0,1,116,43,73,59,57,89,9.21187258530275,13.3189805958904,0.435799518776959,2020-04-06,2020,4
"5213","PE",2,"Nordeste",26015,"Mata Meridional Pernambucana",608639,10015.3338776516,15,138,45,93,81,57,1,0,1,0,1,139,45,94,81,58,82,9.21187258530275,13.3189805958904,0.430798260692221,2020-04-13,2020,4
"5214","PE",2,"Nordeste",26015,"Mata Meridional Pernambucana",608639,10015.3338776516,16,109,42,67,61,48,0,0,0,0,0,109,42,67,61,48,86,9.21187258530275,13.3189805958904,0.430963483685696,2020-04-20,2020,4
"5215","PE",2,"Nordeste",26015,"Mata Meridional Pernambucana",608639,10015.3338776516,17,118,46,72,59,59,1,1,0,1,0,119,47,72,60,59,108,9.21187258530275,13.3189805958904,0.411512189401187,2020-04-27,2020,4
"5216","PE",2,"Nordeste",26015,"Mata Meridional Pernambucana",608639,10015.3338776516,18,116,44,72,61,55,2,1,1,1,1,118,45,73,62,56,131,9.21187258530275,13.3189805958904,0.416563685095665,2020-05-04,2020,5
"5217","PE",2,"Nordeste",26015,"Mata Meridional Pernambucana",608639,10015.3338776516,19,147,51,96,86,61,3,0,3,1,2,150,51,99,87,63,152,9.21187258530275,13.3189805958904,0.463259604904341,2020-05-11,2020,5
"5218","PE",2,"Nordeste",26015,"Mata Meridional Pernambucana",608639,10015.3338776516,20,152,61,91,82,70,1,1,0,1,0,153,62,91,83,70,160,9.21187258530275,13.3189805958904,0.463392005254167,2020-05-18,2020,5
"5219","PE",2,"Nordeste",26015,"Mata Meridional Pernambucana",608639,10015.3338776516,21,126,49,77,59,67,1,0,1,1,0,127,49,78,60,67,159,9.21187258530275,13.3189805958904,0.438285251619459,2020-05-25,2020,5
"5220","PE",2,"Nordeste",26016,"Itamaracá",192675,23790.129361256,5,40,13,27,19,21,0,0,0,0,0,40,13,27,19,21,18,10.0770260409138,12.1687601106462,0.285851830353676,2020-02-03,2020,2
"5221","PE",2,"Nordeste",26016,"Itamaracá",192675,23790.129361256,6,40,9,31,13,27,0,0,0,0,0,40,9,31,13,27,17,10.0770260409138,12.1687601106462,0.282600437967592,2020-02-10,2020,2
"5222","PE",2,"Nordeste",26016,"Itamaracá",192675,23790.129361256,7,36,6,30,17,19,0,0,0,0,0,36,6,30,17,19,21,10.0770260409138,12.1687601106462,0.306210482889507,2020-02-17,2020,2
"5223","PE",2,"Nordeste",26016,"Itamaracá",192675,23790.129361256,8,42,11,31,24,18,0,0,0,0,0,42,11,31,24,18,33,10.0770260409138,12.1687601106462,0.356498259094383,2020-02-24,2020,2
"5224","PE",2,"Nordeste",26016,"Itamaracá",192675,23790.129361256,9,41,11,30,18,23,0,0,0,0,0,41,11,30,18,23,25,10.0770260409138,12.1687601106462,0.331482728143454,2020-03-02,2020,3
"5225","PE",2,"Nordeste",26016,"Itamaracá",192675,23790.129361256,10,34,9,25,18,16,0,0,0,0,0,34,9,25,18,16,19,10.0770260409138,12.1687601106462,0.33712788158915,2020-03-09,2020,3
"5226","PE",2,"Nordeste",26016,"Itamaracá",192675,23790.129361256,11,41,15,26,18,23,0,0,0,0,0,41,15,26,18,23,19,10.0770260409138,12.1687601106462,0.414721403887742,2020-03-16,2020,3
"5227","PE",2,"Nordeste",26016,"Itamaracá",192675,23790.129361256,12,25,6,19,17,8,0,0,0,0,0,25,6,19,17,8,36,10.0770260409138,12.1687601106462,0.525497507017486,2020-03-23,2020,3
"5228","PE",2,"Nordeste",26016,"Itamaracá",192675,23790.129361256,13,42,12,30,20,22,0,0,0,0,0,42,12,30,20,22,19,10.0770260409138,12.1687601106462,0.486639027347887,2020-03-30,2020,3
"5229","PE",2,"Nordeste",26016,"Itamaracá",192675,23790.129361256,14,37,8,29,16,21,0,0,0,0,0,37,8,29,16,21,25,10.0770260409138,12.1687601106462,0.488570151713771,2020-04-06,2020,4
"5230","PE",2,"Nordeste",26016,"Itamaracá",192675,23790.129361256,15,40,16,24,20,20,0,0,0,0,0,40,16,24,20,20,33,10.0770260409138,12.1687601106462,0.488850443134207,2020-04-13,2020,4
"5231","PE",2,"Nordeste",26016,"Itamaracá",192675,23790.129361256,16,36,11,25,17,19,0,0,0,0,0,36,11,25,17,19,33,10.0770260409138,12.1687601106462,0.494036271262173,2020-04-20,2020,4
"5232","PE",2,"Nordeste",26016,"Itamaracá",192675,23790.129361256,17,52,19,33,23,29,0,0,0,0,0,52,19,33,23,29,37,10.0770260409138,12.1687601106462,0.47590433916118,2020-04-27,2020,4
"5233","PE",2,"Nordeste",26016,"Itamaracá",192675,23790.129361256,18,45,9,36,23,22,1,0,1,0,1,46,9,37,23,23,49,10.0770260409138,12.1687601106462,0.455712687637755,2020-05-04,2020,5
"5234","PE",2,"Nordeste",26016,"Itamaracá",192675,23790.129361256,19,47,14,33,26,21,2,1,1,2,0,49,15,34,28,21,53,10.0770260409138,12.1687601106462,0.491965440256493,2020-05-11,2020,5
"5235","PE",2,"Nordeste",26016,"Itamaracá",192675,23790.129361256,20,41,18,23,15,26,2,0,2,0,2,43,18,25,15,28,42,10.0770260409138,12.1687601106462,0.48307495112952,2020-05-18,2020,5
"5236","PE",2,"Nordeste",26016,"Itamaracá",192675,23790.129361256,21,45,16,29,21,24,0,0,0,0,0,45,16,29,21,24,39,10.0770260409138,12.1687601106462,0.457914820772613,2020-05-25,2020,5
"5237","PE",2,"Nordeste",26017,"Recife",3524437,23189.2724620443,5,753,172,581,290,463,7,0,7,3,4,760,172,588,293,467,461,10.05144505684,15.0752312651604,0.271769883446535,2020-02-03,2020,2
"5238","PE",2,"Nordeste",26017,"Recife",3524437,23189.2724620443,6,716,150,566,273,443,5,3,2,2,3,721,153,568,275,446,493,10.05144505684,15.0752312651604,0.273139408242935,2020-02-10,2020,2
"5239","PE",2,"Nordeste",26017,"Recife",3524437,23189.2724620443,7,679,158,521,280,399,5,1,4,3,2,684,159,525,283,401,472,10.05144505684,15.0752312651604,0.294407697564267,2020-02-17,2020,2
"5240","PE",2,"Nordeste",26017,"Recife",3524437,23189.2724620443,8,770,169,601,278,492,8,2,6,4,4,778,171,607,282,496,457,10.05144505684,15.0752312651604,0.356447829665555,2020-02-24,2020,2
"5241","PE",2,"Nordeste",26017,"Recife",3524437,23189.2724620443,9,702,168,534,261,441,4,2,2,0,4,706,170,536,261,445,487,10.05144505684,15.0752312651604,0.326931121365633,2020-03-02,2020,3
"5242","PE",2,"Nordeste",26017,"Recife",3524437,23189.2724620443,10,679,170,509,282,397,5,0,5,3,2,684,170,514,285,399,488,10.05144505684,15.0752312651604,0.320923094802477,2020-03-09,2020,3
"5243","PE",2,"Nordeste",26017,"Recife",3524437,23189.2724620443,11,662,156,506,270,392,7,3,4,4,3,669,159,510,274,395,475,10.05144505684,15.0752312651604,0.440483273265427,2020-03-16,2020,3
"5244","PE",2,"Nordeste",26017,"Recife",3524437,23189.2724620443,12,649,139,510,235,414,4,1,3,0,4,653,140,513,235,418,514,10.05144505684,15.0752312651604,0.575830145107368,2020-03-23,2020,3
"5245","PE",2,"Nordeste",26017,"Recife",3524437,23189.2724620443,13,569,147,422,209,360,9,6,3,4,5,578,153,425,213,365,529,10.05144505684,15.0752312651604,0.535397824939128,2020-03-30,2020,3
"5246","PE",2,"Nordeste",26017,"Recife",3524437,23189.2724620443,14,627,154,473,234,393,4,1,3,1,3,631,155,476,235,396,586,10.05144505684,15.0752312651604,0.527630228202394,2020-04-06,2020,4
"5247","PE",2,"Nordeste",26017,"Recife",3524437,23189.2724620443,15,629,150,479,240,389,3,1,2,1,2,632,151,481,241,391,749,10.05144505684,15.0752312651604,0.520743123812734,2020-04-13,2020,4
"5248","PE",2,"Nordeste",26017,"Recife",3524437,23189.2724620443,16,632,133,499,263,369,6,2,4,2,4,638,135,503,265,373,860,10.05144505684,15.0752312651604,0.535979248873939,2020-04-20,2020,4
"5249","PE",2,"Nordeste",26017,"Recife",3524437,23189.2724620443,17,658,156,502,247,411,4,0,4,1,3,662,156,506,248,414,1058,10.05144505684,15.0752312651604,0.51765472159785,2020-04-27,2020,4
"5250","PE",2,"Nordeste",26017,"Recife",3524437,23189.2724620443,18,685,167,518,271,414,2,0,2,2,0,687,167,520,273,414,1224,10.05144505684,15.0752312651604,0.490253081831251,2020-05-04,2020,5
"5251","PE",2,"Nordeste",26017,"Recife",3524437,23189.2724620443,19,745,176,569,297,448,6,2,4,2,4,751,178,573,299,452,1185,10.05144505684,15.0752312651604,0.531819591767852,2020-05-11,2020,5
"5252","PE",2,"Nordeste",26017,"Recife",3524437,23189.2724620443,20,703,154,549,277,426,4,1,3,3,1,707,155,552,280,427,988,10.05144505684,15.0752312651604,0.538509222549507,2020-05-18,2020,5
"5253","PE",2,"Nordeste",26017,"Recife",3524437,23189.2724620443,21,750,170,580,290,460,5,0,5,1,4,755,170,585,291,464,857,10.05144505684,15.0752312651604,0.504455384025089,2020-05-25,2020,5
"5254","PE",2,"Nordeste",26018,"Suape",306613,71336.555113971,5,82,25,57,43,39,1,1,0,0,1,83,26,57,43,40,39,11.1751641694651,12.6333416450428,0.278802522418889,2020-02-03,2020,2
"5255","PE",2,"Nordeste",26018,"Suape",306613,71336.555113971,6,69,13,56,30,39,0,0,0,0,0,69,13,56,30,39,41,11.1751641694651,12.6333416450428,0.276109011701242,2020-02-10,2020,2
"5256","PE",2,"Nordeste",26018,"Suape",306613,71336.555113971,7,79,27,52,32,47,0,0,0,0,0,79,27,52,32,47,23,11.1751641694651,12.6333416450428,0.298400289836199,2020-02-17,2020,2
"5257","PE",2,"Nordeste",26018,"Suape",306613,71336.555113971,8,96,27,69,57,39,0,0,0,0,0,96,27,69,57,39,36,11.1751641694651,12.6333416450428,0.346284913764903,2020-02-24,2020,2
"5258","PE",2,"Nordeste",26018,"Suape",306613,71336.555113971,9,89,27,62,47,42,1,1,0,1,0,90,28,62,48,42,35,11.1751641694651,12.6333416450428,0.320369658241852,2020-03-02,2020,3
"5259","PE",2,"Nordeste",26018,"Suape",306613,71336.555113971,10,73,22,51,30,43,2,0,2,2,0,75,22,53,32,43,36,11.1751641694651,12.6333416450428,0.330226811697177,2020-03-09,2020,3
"5260","PE",2,"Nordeste",26018,"Suape",306613,71336.555113971,11,65,15,50,32,33,1,0,1,0,1,66,15,51,32,34,40,11.1751641694651,12.6333416450428,0.4080676292208,2020-03-16,2020,3
"5261","PE",2,"Nordeste",26018,"Suape",306613,71336.555113971,12,81,26,55,37,44,2,0,2,1,1,83,26,57,38,45,40,11.1751641694651,12.6333416450428,0.515740336921976,2020-03-23,2020,3
"5262","PE",2,"Nordeste",26018,"Suape",306613,71336.555113971,13,67,16,51,36,31,0,0,0,0,0,67,16,51,36,31,47,11.1751641694651,12.6333416450428,0.484537764828438,2020-03-30,2020,3
"5263","PE",2,"Nordeste",26018,"Suape",306613,71336.555113971,14,81,17,64,38,43,1,0,1,0,1,82,17,65,38,44,52,11.1751641694651,12.6333416450428,0.473583595283099,2020-04-06,2020,4
"5264","PE",2,"Nordeste",26018,"Suape",306613,71336.555113971,15,98,35,63,39,59,0,0,0,0,0,98,35,63,39,59,38,11.1751641694651,12.6333416450428,0.472894476437196,2020-04-13,2020,4
"5265","PE",2,"Nordeste",26018,"Suape",306613,71336.555113971,16,80,25,55,46,34,1,0,1,1,0,81,25,56,47,34,57,11.1751641694651,12.6333416450428,0.480185990461461,2020-04-20,2020,4
"5266","PE",2,"Nordeste",26018,"Suape",306613,71336.555113971,17,73,24,49,38,35,0,0,0,0,0,73,24,49,38,35,66,11.1751641694651,12.6333416450428,0.462165289740889,2020-04-27,2020,4
"5267","PE",2,"Nordeste",26018,"Suape",306613,71336.555113971,18,97,33,64,49,48,2,1,1,1,1,99,34,65,50,49,91,11.1751641694651,12.6333416450428,0.450239611086239,2020-05-04,2020,5
"5268","PE",2,"Nordeste",26018,"Suape",306613,71336.555113971,19,77,33,44,41,36,1,0,1,0,1,78,33,45,41,37,106,11.1751641694651,12.6333416450428,0.486759979505997,2020-05-11,2020,5
"5269","PE",2,"Nordeste",26018,"Suape",306613,71336.555113971,20,101,32,69,47,54,0,0,0,0,0,101,32,69,47,54,102,11.1751641694651,12.6333416450428,0.475263578773193,2020-05-18,2020,5
"5270","PE",2,"Nordeste",26018,"Suape",306613,71336.555113971,21,83,29,54,47,36,0,0,0,0,0,83,29,54,47,36,77,11.1751641694651,12.6333416450428,0.450678328955131,2020-05-25,2020,5
"5271","PI",2,"Nordeste",22001,"Baixo Parnaíba Piauiense",345487,8364.21832746239,5,92,36,56,44,48,3,0,3,0,3,95,36,59,44,51,33,9.03171816344342,12.7527102948539,0.26939127115058,2020-02-03,2020,2
"5272","PI",2,"Nordeste",22001,"Baixo Parnaíba Piauiense",345487,8364.21832746239,6,93,36,57,45,48,1,0,1,0,1,94,36,58,45,49,46,9.03171816344342,12.7527102948539,0.262042457054976,2020-02-10,2020,2
"5273","PI",2,"Nordeste",22001,"Baixo Parnaíba Piauiense",345487,8364.21832746239,7,83,34,49,42,41,1,0,1,0,1,84,34,50,42,42,39,9.03171816344342,12.7527102948539,0.274421255140983,2020-02-17,2020,2
"5274","PI",2,"Nordeste",22001,"Baixo Parnaíba Piauiense",345487,8364.21832746239,8,78,36,42,36,42,0,0,0,0,0,78,36,42,36,42,35,9.03171816344342,12.7527102948539,0.311906247928515,2020-02-24,2020,2
"5275","PI",2,"Nordeste",22001,"Baixo Parnaíba Piauiense",345487,8364.21832746239,9,77,38,39,29,48,4,3,1,3,1,81,41,40,32,49,35,9.03171816344342,12.7527102948539,0.291933821518183,2020-03-02,2020,3
"5276","PI",2,"Nordeste",22001,"Baixo Parnaíba Piauiense",345487,8364.21832746239,10,72,27,45,31,41,3,1,2,2,1,75,28,47,33,42,37,9.03171816344342,12.7527102948539,0.318375815316434,2020-03-09,2020,3
"5277","PI",2,"Nordeste",22001,"Baixo Parnaíba Piauiense",345487,8364.21832746239,11,89,37,52,43,46,2,2,0,1,1,91,39,52,44,47,43,9.03171816344342,12.7527102948539,0.378299594608567,2020-03-16,2020,3
"5278","PI",2,"Nordeste",22001,"Baixo Parnaíba Piauiense",345487,8364.21832746239,12,77,27,50,37,40,0,0,0,0,0,77,27,50,37,40,42,9.03171816344342,12.7527102948539,0.489598348465128,2020-03-23,2020,3
"5279","PI",2,"Nordeste",22001,"Baixo Parnaíba Piauiense",345487,8364.21832746239,13,77,34,43,35,42,1,0,1,1,0,78,34,44,36,42,51,9.03171816344342,12.7527102948539,0.442264680456525,2020-03-30,2020,3
"5280","PI",2,"Nordeste",22001,"Baixo Parnaíba Piauiense",345487,8364.21832746239,14,80,31,49,38,42,2,2,0,1,1,82,33,49,39,43,43,9.03171816344342,12.7527102948539,0.424090193753432,2020-04-06,2020,4
"5281","PI",2,"Nordeste",22001,"Baixo Parnaíba Piauiense",345487,8364.21832746239,15,70,30,40,35,35,0,0,0,0,0,70,30,40,35,35,36,9.03171816344342,12.7527102948539,0.402382562638356,2020-04-13,2020,4
"5282","PI",2,"Nordeste",22001,"Baixo Parnaíba Piauiense",345487,8364.21832746239,16,80,32,48,36,44,0,0,0,0,0,80,32,48,36,44,41,9.03171816344342,12.7527102948539,0.406793772816788,2020-04-20,2020,4
"5283","PI",2,"Nordeste",22001,"Baixo Parnaíba Piauiense",345487,8364.21832746239,17,69,28,41,25,44,0,0,0,0,0,69,28,41,25,44,32,9.03171816344342,12.7527102948539,0.416659008473204,2020-04-27,2020,4
"5284","PI",2,"Nordeste",22001,"Baixo Parnaíba Piauiense",345487,8364.21832746239,18,87,37,50,46,41,1,0,1,1,0,88,37,51,47,41,35,9.03171816344342,12.7527102948539,0.43145251290519,2020-05-04,2020,5
"5285","PI",2,"Nordeste",22001,"Baixo Parnaíba Piauiense",345487,8364.21832746239,19,83,27,56,43,40,1,1,0,1,0,84,28,56,44,40,42,9.03171816344342,12.7527102948539,0.471614116792682,2020-05-11,2020,5
"5286","PI",2,"Nordeste",22001,"Baixo Parnaíba Piauiense",345487,8364.21832746239,20,76,30,46,34,42,2,0,2,0,2,78,30,48,34,44,48,9.03171816344342,12.7527102948539,0.449840221666854,2020-05-18,2020,5
"5287","PI",2,"Nordeste",22001,"Baixo Parnaíba Piauiense",345487,8364.21832746239,21,74,28,46,41,33,1,0,1,1,0,75,28,47,42,33,51,9.03171816344342,12.7527102948539,0.442017703547361,2020-05-25,2020,5
"5288","PI",2,"Nordeste",22002,"Litoral Piauiense",321364,11949.3382907544,5,92,34,58,44,48,0,0,0,0,0,92,34,58,44,48,31,9.38843118266788,12.6803297160555,0.279954960580124,2020-02-03,2020,2
"5289","PI",2,"Nordeste",22002,"Litoral Piauiense",321364,11949.3382907544,6,94,43,51,43,51,2,0,2,1,1,96,43,53,44,52,41,9.38843118266788,12.6803297160555,0.278461000468962,2020-02-10,2020,2
"5290","PI",2,"Nordeste",22002,"Litoral Piauiense",321364,11949.3382907544,7,97,30,67,41,56,1,1,0,1,0,98,31,67,42,56,53,9.38843118266788,12.6803297160555,0.293355969499518,2020-02-17,2020,2
"5291","PI",2,"Nordeste",22002,"Litoral Piauiense",321364,11949.3382907544,8,95,49,46,51,44,1,1,0,0,1,96,50,46,51,45,37,9.38843118266788,12.6803297160555,0.331337395530376,2020-02-24,2020,2
"5292","PI",2,"Nordeste",22002,"Litoral Piauiense",321364,11949.3382907544,9,81,34,47,31,50,0,0,0,0,0,81,34,47,31,50,36,9.38843118266788,12.6803297160555,0.30302520129428,2020-03-02,2020,3
"5293","PI",2,"Nordeste",22002,"Litoral Piauiense",321364,11949.3382907544,10,74,30,44,30,44,0,0,0,0,0,74,30,44,30,44,44,9.38843118266788,12.6803297160555,0.33704432083846,2020-03-09,2020,3
"5294","PI",2,"Nordeste",22002,"Litoral Piauiense",321364,11949.3382907544,11,91,38,53,46,45,1,0,1,1,0,92,38,54,47,45,38,9.38843118266788,12.6803297160555,0.42402874251508,2020-03-16,2020,3
"5295","PI",2,"Nordeste",22002,"Litoral Piauiense",321364,11949.3382907544,12,78,31,47,28,50,2,1,1,2,0,80,32,48,30,50,40,9.38843118266788,12.6803297160555,0.530254083179443,2020-03-23,2020,3
"5296","PI",2,"Nordeste",22002,"Litoral Piauiense",321364,11949.3382907544,13,62,21,41,27,35,1,1,0,0,1,63,22,41,27,36,48,9.38843118266788,12.6803297160555,0.492742968472083,2020-03-30,2020,3
"5297","PI",2,"Nordeste",22002,"Litoral Piauiense",321364,11949.3382907544,14,93,34,59,38,55,0,0,0,0,0,93,34,59,38,55,47,9.38843118266788,12.6803297160555,0.479044570518272,2020-04-06,2020,4
"5298","PI",2,"Nordeste",22002,"Litoral Piauiense",321364,11949.3382907544,15,85,37,48,37,48,1,0,1,0,1,86,37,49,37,49,42,9.38843118266788,12.6803297160555,0.450716953632248,2020-04-13,2020,4
"5299","PI",2,"Nordeste",22002,"Litoral Piauiense",321364,11949.3382907544,16,72,30,42,33,39,0,0,0,0,0,72,30,42,33,39,36,9.38843118266788,12.6803297160555,0.460475973714963,2020-04-20,2020,4
"5300","PI",2,"Nordeste",22002,"Litoral Piauiense",321364,11949.3382907544,17,72,31,41,33,39,3,0,3,1,2,75,31,44,34,41,39,9.38843118266788,12.6803297160555,0.437922335766508,2020-04-27,2020,4
"5301","PI",2,"Nordeste",22002,"Litoral Piauiense",321364,11949.3382907544,18,83,35,48,41,42,0,0,0,0,0,83,35,48,41,42,37,9.38843118266788,12.6803297160555,0.439993789765139,2020-05-04,2020,5
"5302","PI",2,"Nordeste",22002,"Litoral Piauiense",321364,11949.3382907544,19,72,26,46,33,39,0,0,0,0,0,72,26,46,33,39,43,9.38843118266788,12.6803297160555,0.472730195166949,2020-05-11,2020,5
"5303","PI",2,"Nordeste",22002,"Litoral Piauiense",321364,11949.3382907544,20,87,37,50,46,41,2,1,1,1,1,89,38,51,47,42,41,9.38843118266788,12.6803297160555,0.451314163131923,2020-05-18,2020,5
"5304","PI",2,"Nordeste",22002,"Litoral Piauiense",321364,11949.3382907544,21,78,31,47,35,43,0,0,0,0,0,78,31,47,35,43,50,9.38843118266788,12.6803297160555,0.448701703898032,2020-05-25,2020,5
"5305","PI",2,"Nordeste",22003,"Teresina",1062514,21563.1743407616,5,277,53,224,100,177,0,0,0,0,0,277,53,224,100,177,110,9.97874224705915,13.8761483561645,0.264196463973587,2020-02-03,2020,2
"5306","PI",2,"Nordeste",22003,"Teresina",1062514,21563.1743407616,6,276,46,230,104,172,1,0,1,1,0,277,46,231,105,172,136,9.97874224705915,13.8761483561645,0.258686988059077,2020-02-10,2020,2
"5307","PI",2,"Nordeste",22003,"Teresina",1062514,21563.1743407616,7,266,47,219,90,176,2,0,2,0,2,268,47,221,90,178,143,9.97874224705915,13.8761483561645,0.278297019140704,2020-02-17,2020,2
"5308","PI",2,"Nordeste",22003,"Teresina",1062514,21563.1743407616,8,243,61,182,91,152,6,2,4,3,3,249,63,186,94,155,123,9.97874224705915,13.8761483561645,0.335897634127204,2020-02-24,2020,2
"5309","PI",2,"Nordeste",22003,"Teresina",1062514,21563.1743407616,9,231,46,185,83,148,2,2,0,1,1,233,48,185,84,149,115,9.97874224705915,13.8761483561645,0.295115924577268,2020-03-02,2020,3
"5310","PI",2,"Nordeste",22003,"Teresina",1062514,21563.1743407616,10,225,40,185,74,151,2,1,1,1,1,227,41,186,75,152,134,9.97874224705915,13.8761483561645,0.316994883088974,2020-03-09,2020,3
"5311","PI",2,"Nordeste",22003,"Teresina",1062514,21563.1743407616,11,259,60,199,97,162,4,0,4,3,1,263,60,203,100,163,145,9.97874224705915,13.8761483561645,0.4119900868674,2020-03-16,2020,3
"5312","PI",2,"Nordeste",22003,"Teresina",1062514,21563.1743407616,12,220,45,175,83,137,1,0,1,0,1,221,45,176,83,138,141,9.97874224705915,13.8761483561645,0.561399719839884,2020-03-23,2020,3
"5313","PI",2,"Nordeste",22003,"Teresina",1062514,21563.1743407616,13,210,42,168,76,134,2,1,1,0,2,212,43,169,76,136,123,9.97874224705915,13.8761483561645,0.50698511027403,2020-03-30,2020,3
"5314","PI",2,"Nordeste",22003,"Teresina",1062514,21563.1743407616,14,206,38,168,77,129,3,0,3,0,3,209,38,171,77,132,142,9.97874224705915,13.8761483561645,0.500697638346759,2020-04-06,2020,4
"5315","PI",2,"Nordeste",22003,"Teresina",1062514,21563.1743407616,15,220,52,168,75,145,5,1,4,4,1,225,53,172,79,146,120,9.97874224705915,13.8761483561645,0.474364300813643,2020-04-13,2020,4
"5316","PI",2,"Nordeste",22003,"Teresina",1062514,21563.1743407616,16,183,38,145,66,117,2,0,2,0,2,185,38,147,66,119,107,9.97874224705915,13.8761483561645,0.469863250719444,2020-04-20,2020,4
"5317","PI",2,"Nordeste",22003,"Teresina",1062514,21563.1743407616,17,175,40,135,56,119,2,1,1,1,1,177,41,136,57,120,124,9.97874224705915,13.8761483561645,0.457727527164443,2020-04-27,2020,4
"5318","PI",2,"Nordeste",22003,"Teresina",1062514,21563.1743407616,18,183,44,139,73,110,1,0,1,1,0,184,44,140,74,110,115,9.97874224705915,13.8761483561645,0.447583334251635,2020-05-04,2020,5
"5319","PI",2,"Nordeste",22003,"Teresina",1062514,21563.1743407616,19,217,49,168,72,145,3,1,2,0,3,220,50,170,72,148,152,9.97874224705915,13.8761483561645,0.488883339507027,2020-05-11,2020,5
"5320","PI",2,"Nordeste",22003,"Teresina",1062514,21563.1743407616,20,219,43,176,75,144,1,1,0,0,1,220,44,176,75,145,130,9.97874224705915,13.8761483561645,0.466827447364762,2020-05-18,2020,5
"5321","PI",2,"Nordeste",22003,"Teresina",1062514,21563.1743407616,21,219,43,176,69,150,1,0,1,0,1,220,43,177,69,151,162,9.97874224705915,13.8761483561645,0.453878821242849,2020-05-25,2020,5
"5322","PI",2,"Nordeste",22004,"Campo Maior",228434,8881.30387888843,5,38,16,22,17,21,0,0,0,0,0,38,16,22,17,21,30,9.09170365841543,12.3390026073314,0.256885696476099,2020-02-03,2020,2
"5323","PI",2,"Nordeste",22004,"Campo Maior",228434,8881.30387888843,6,54,23,31,25,29,0,0,0,0,0,54,23,31,25,29,25,9.09170365841543,12.3390026073314,0.252829191974958,2020-02-10,2020,2
"5324","PI",2,"Nordeste",22004,"Campo Maior",228434,8881.30387888843,7,35,12,23,20,15,0,0,0,0,0,35,12,23,20,15,25,9.09170365841543,12.3390026073314,0.261969687251623,2020-02-17,2020,2
"5325","PI",2,"Nordeste",22004,"Campo Maior",228434,8881.30387888843,8,48,25,23,22,26,1,0,1,0,1,49,25,24,22,27,48,9.09170365841543,12.3390026073314,0.307861890192691,2020-02-24,2020,2
"5326","PI",2,"Nordeste",22004,"Campo Maior",228434,8881.30387888843,9,37,20,17,21,16,0,0,0,0,0,37,20,17,21,16,32,9.09170365841543,12.3390026073314,0.285731930917264,2020-03-02,2020,3
"5327","PI",2,"Nordeste",22004,"Campo Maior",228434,8881.30387888843,10,43,19,24,17,26,0,0,0,0,0,43,19,24,17,26,39,9.09170365841543,12.3390026073314,0.308769919488164,2020-03-09,2020,3
"5328","PI",2,"Nordeste",22004,"Campo Maior",228434,8881.30387888843,11,42,13,29,15,27,0,0,0,0,0,42,13,29,15,27,44,9.09170365841543,12.3390026073314,0.380976754533993,2020-03-16,2020,3
"5329","PI",2,"Nordeste",22004,"Campo Maior",228434,8881.30387888843,12,37,9,28,19,18,0,0,0,0,0,37,9,28,19,18,36,9.09170365841543,12.3390026073314,0.497542126581875,2020-03-23,2020,3
"5330","PI",2,"Nordeste",22004,"Campo Maior",228434,8881.30387888843,13,32,14,18,16,16,1,1,0,0,1,33,15,18,16,17,29,9.09170365841543,12.3390026073314,0.44305342095658,2020-03-30,2020,3
"5331","PI",2,"Nordeste",22004,"Campo Maior",228434,8881.30387888843,14,50,22,28,16,34,1,0,1,0,1,51,22,29,16,35,25,9.09170365841543,12.3390026073314,0.425024636696744,2020-04-06,2020,4
"5332","PI",2,"Nordeste",22004,"Campo Maior",228434,8881.30387888843,15,41,17,24,19,22,0,0,0,0,0,41,17,24,19,22,36,9.09170365841543,12.3390026073314,0.392867171318196,2020-04-13,2020,4
"5333","PI",2,"Nordeste",22004,"Campo Maior",228434,8881.30387888843,16,34,13,21,20,14,0,0,0,0,0,34,13,21,20,14,31,9.09170365841543,12.3390026073314,0.404017237640543,2020-04-20,2020,4
"5334","PI",2,"Nordeste",22004,"Campo Maior",228434,8881.30387888843,17,41,21,20,20,21,0,0,0,0,0,41,21,20,20,21,30,9.09170365841543,12.3390026073314,0.407553264868292,2020-04-27,2020,4
"5335","PI",2,"Nordeste",22004,"Campo Maior",228434,8881.30387888843,18,55,19,36,23,32,0,0,0,0,0,55,19,36,23,32,30,9.09170365841543,12.3390026073314,0.407167885721112,2020-05-04,2020,5
"5336","PI",2,"Nordeste",22004,"Campo Maior",228434,8881.30387888843,19,44,13,31,16,28,0,0,0,0,0,44,13,31,16,28,27,9.09170365841543,12.3390026073314,0.44807596143805,2020-05-11,2020,5
"5337","PI",2,"Nordeste",22004,"Campo Maior",228434,8881.30387888843,20,43,18,25,19,24,0,0,0,0,0,43,18,25,19,24,37,9.09170365841543,12.3390026073314,0.423430459648683,2020-05-18,2020,5
"5338","PI",2,"Nordeste",22004,"Campo Maior",228434,8881.30387888843,21,45,14,31,17,28,1,1,0,0,1,46,15,31,17,29,30,9.09170365841543,12.3390026073314,0.414074303517138,2020-05-25,2020,5
"5339","PI",2,"Nordeste",22005,"Médio Parnaíba Piauiense",135185,8756.35135887857,5,22,5,17,9,13,1,0,1,0,1,23,5,18,9,14,19,9.07753458562187,11.8143994896904,0.258123727053507,2020-02-03,2020,2
"5340","PI",2,"Nordeste",22005,"Médio Parnaíba Piauiense",135185,8756.35135887857,6,25,11,14,14,11,1,1,0,1,0,26,12,14,15,11,10,9.07753458562187,11.8143994896904,0.242847426320815,2020-02-10,2020,2
"5341","PI",2,"Nordeste",22005,"Médio Parnaíba Piauiense",135185,8756.35135887857,7,29,14,15,8,21,0,0,0,0,0,29,14,15,8,21,17,9.07753458562187,11.8143994896904,0.256983203231609,2020-02-17,2020,2
"5342","PI",2,"Nordeste",22005,"Médio Parnaíba Piauiense",135185,8756.35135887857,8,24,8,16,13,11,0,0,0,0,0,24,8,16,13,11,19,9.07753458562187,11.8143994896904,0.292273509004473,2020-02-24,2020,2
"5343","PI",2,"Nordeste",22005,"Médio Parnaíba Piauiense",135185,8756.35135887857,9,31,10,21,15,16,0,0,0,0,0,31,10,21,15,16,23,9.07753458562187,11.8143994896904,0.277002086822437,2020-03-02,2020,3
"5344","PI",2,"Nordeste",22005,"Médio Parnaíba Piauiense",135185,8756.35135887857,10,12,4,8,5,7,2,1,1,1,1,14,5,9,6,8,18,9.07753458562187,11.8143994896904,0.307459406213397,2020-03-09,2020,3
"5345","PI",2,"Nordeste",22005,"Médio Parnaíba Piauiense",135185,8756.35135887857,11,27,7,20,12,15,0,0,0,0,0,27,7,20,12,15,15,9.07753458562187,11.8143994896904,0.36693446110271,2020-03-16,2020,3
"5346","PI",2,"Nordeste",22005,"Médio Parnaíba Piauiense",135185,8756.35135887857,12,18,5,13,9,9,1,1,0,1,0,19,6,13,10,9,19,9.07753458562187,11.8143994896904,0.475861404771261,2020-03-23,2020,3
"5347","PI",2,"Nordeste",22005,"Médio Parnaíba Piauiense",135185,8756.35135887857,13,22,7,15,10,12,0,0,0,0,0,22,7,15,10,12,22,9.07753458562187,11.8143994896904,0.420849650046669,2020-03-30,2020,3
"5348","PI",2,"Nordeste",22005,"Médio Parnaíba Piauiense",135185,8756.35135887857,14,20,11,9,11,9,0,0,0,0,0,20,11,9,11,9,24,9.07753458562187,11.8143994896904,0.410929722518901,2020-04-06,2020,4
"5349","PI",2,"Nordeste",22005,"Médio Parnaíba Piauiense",135185,8756.35135887857,15,29,10,19,11,18,0,0,0,0,0,29,10,19,11,18,12,9.07753458562187,11.8143994896904,0.380130656041619,2020-04-13,2020,4
"5350","PI",2,"Nordeste",22005,"Médio Parnaíba Piauiense",135185,8756.35135887857,16,28,12,16,10,18,0,0,0,0,0,28,12,16,10,18,10,9.07753458562187,11.8143994896904,0.394608851383615,2020-04-20,2020,4
"5351","PI",2,"Nordeste",22005,"Médio Parnaíba Piauiense",135185,8756.35135887857,17,27,10,17,11,16,0,0,0,0,0,27,10,17,11,16,18,9.07753458562187,11.8143994896904,0.40003995280626,2020-04-27,2020,4
"5352","PI",2,"Nordeste",22005,"Médio Parnaíba Piauiense",135185,8756.35135887857,18,36,13,23,15,21,0,0,0,0,0,36,13,23,15,21,13,9.07753458562187,11.8143994896904,0.413201529050833,2020-05-04,2020,5
"5353","PI",2,"Nordeste",22005,"Médio Parnaíba Piauiense",135185,8756.35135887857,19,33,14,19,10,23,0,0,0,0,0,33,14,19,10,23,22,9.07753458562187,11.8143994896904,0.439107510073742,2020-05-11,2020,5
"5354","PI",2,"Nordeste",22005,"Médio Parnaíba Piauiense",135185,8756.35135887857,20,34,6,28,10,24,1,1,0,0,1,35,7,28,10,25,17,9.07753458562187,11.8143994896904,0.42777484052549,2020-05-18,2020,5
"5355","PI",2,"Nordeste",22005,"Médio Parnaíba Piauiense",135185,8756.35135887857,21,25,8,17,9,16,0,0,0,0,0,25,8,17,9,16,21,9.07753458562187,11.8143994896904,0.405118128370486,2020-05-25,2020,5
"5356","PI",2,"Nordeste",22006,"Valença do Piauí",106797,8908.33514855286,5,29,8,21,7,22,0,0,0,0,0,29,8,21,7,22,16,9.09474265099157,11.5786851152261,0.244222214190107,2020-02-03,2020,2
"5357","PI",2,"Nordeste",22006,"Valença do Piauí",106797,8908.33514855286,6,18,5,13,9,9,0,0,0,0,0,18,5,13,9,9,10,9.09474265099157,11.5786851152261,0.236594441029516,2020-02-10,2020,2
"5358","PI",2,"Nordeste",22006,"Valença do Piauí",106797,8908.33514855286,7,22,6,16,10,12,0,0,0,0,0,22,6,16,10,12,11,9.09474265099157,11.5786851152261,0.247268692703705,2020-02-17,2020,2
"5359","PI",2,"Nordeste",22006,"Valença do Piauí",106797,8908.33514855286,8,12,4,8,7,5,0,0,0,0,0,12,4,8,7,5,11,9.09474265099157,11.5786851152261,0.282486127653723,2020-02-24,2020,2
"5360","PI",2,"Nordeste",22006,"Valença do Piauí",106797,8908.33514855286,9,21,7,14,10,11,0,0,0,0,0,21,7,14,10,11,18,9.09474265099157,11.5786851152261,0.261538757898851,2020-03-02,2020,3
"5361","PI",2,"Nordeste",22006,"Valença do Piauí",106797,8908.33514855286,10,18,8,10,11,7,0,0,0,0,0,18,8,10,11,7,16,9.09474265099157,11.5786851152261,0.279239734115681,2020-03-09,2020,3
"5362","PI",2,"Nordeste",22006,"Valença do Piauí",106797,8908.33514855286,11,16,4,12,7,9,1,0,1,1,0,17,4,13,8,9,17,9.09474265099157,11.5786851152261,0.357376100968846,2020-03-16,2020,3
"5363","PI",2,"Nordeste",22006,"Valença do Piauí",106797,8908.33514855286,12,18,3,15,8,10,0,0,0,0,0,18,3,15,8,10,15,9.09474265099157,11.5786851152261,0.447398973311049,2020-03-23,2020,3
"5364","PI",2,"Nordeste",22006,"Valença do Piauí",106797,8908.33514855286,13,14,2,12,6,8,2,1,1,0,2,16,3,13,6,10,20,9.09474265099157,11.5786851152261,0.403699074408263,2020-03-30,2020,3
"5365","PI",2,"Nordeste",22006,"Valença do Piauí",106797,8908.33514855286,14,19,5,14,6,13,0,0,0,0,0,19,5,14,6,13,18,9.09474265099157,11.5786851152261,0.397356182480374,2020-04-06,2020,4
"5366","PI",2,"Nordeste",22006,"Valença do Piauí",106797,8908.33514855286,15,17,4,13,6,11,1,1,0,1,0,18,5,13,7,11,11,9.09474265099157,11.5786851152261,0.402661128667207,2020-04-13,2020,4
"5367","PI",2,"Nordeste",22006,"Valença do Piauí",106797,8908.33514855286,16,19,2,17,7,12,0,0,0,0,0,19,2,17,7,12,17,9.09474265099157,11.5786851152261,0.382696741182165,2020-04-20,2020,4
"5368","PI",2,"Nordeste",22006,"Valença do Piauí",106797,8908.33514855286,17,12,2,10,5,7,0,0,0,0,0,12,2,10,5,7,18,9.09474265099157,11.5786851152261,0.384210013788839,2020-04-27,2020,4
"5369","PI",2,"Nordeste",22006,"Valença do Piauí",106797,8908.33514855286,18,22,6,16,9,13,0,0,0,0,0,22,6,16,9,13,25,9.09474265099157,11.5786851152261,0.389778049144768,2020-05-04,2020,5
"5370","PI",2,"Nordeste",22006,"Valença do Piauí",106797,8908.33514855286,19,11,2,9,10,1,0,0,0,0,0,11,2,9,10,1,14,9.09474265099157,11.5786851152261,0.437791241012764,2020-05-11,2020,5
"5371","PI",2,"Nordeste",22006,"Valença do Piauí",106797,8908.33514855286,20,16,7,9,11,5,0,0,0,0,0,16,7,9,11,5,18,9.09474265099157,11.5786851152261,0.409107731124612,2020-05-18,2020,5
"5372","PI",2,"Nordeste",22006,"Valença do Piauí",106797,8908.33514855286,21,21,7,14,12,9,0,0,0,0,0,21,7,14,12,9,21,9.09474265099157,11.5786851152261,0.391086230581886,2020-05-25,2020,5
"5373","PI",2,"Nordeste",22007,"Alto Parnaíba Piauiense",46956,72669.738710069,5,16,4,12,8,8,0,0,0,0,0,16,4,12,8,8,7,11.1936803280362,10.7569662719984,0.260660944427886,2020-02-03,2020,2
"5374","PI",2,"Nordeste",22007,"Alto Parnaíba Piauiense",46956,72669.738710069,6,18,8,10,9,9,0,0,0,0,0,18,8,10,9,9,4,11.1936803280362,10.7569662719984,0.238891906134347,2020-02-10,2020,2
"5375","PI",2,"Nordeste",22007,"Alto Parnaíba Piauiense",46956,72669.738710069,7,26,9,17,12,14,0,0,0,0,0,26,9,17,12,14,3,11.1936803280362,10.7569662719984,0.271489194687201,2020-02-17,2020,2
"5376","PI",2,"Nordeste",22007,"Alto Parnaíba Piauiense",46956,72669.738710069,8,11,3,8,9,2,0,0,0,0,0,11,3,8,9,2,3,11.1936803280362,10.7569662719984,0.277769687920544,2020-02-24,2020,2
"5377","PI",2,"Nordeste",22007,"Alto Parnaíba Piauiense",46956,72669.738710069,9,10,5,5,5,5,0,0,0,0,0,10,5,5,5,5,3,11.1936803280362,10.7569662719984,0.256524008164138,2020-03-02,2020,3
"5378","PI",2,"Nordeste",22007,"Alto Parnaíba Piauiense",46956,72669.738710069,10,12,5,7,6,6,0,0,0,0,0,12,5,7,6,6,2,11.1936803280362,10.7569662719984,0.267381186498408,2020-03-09,2020,3
"5379","PI",2,"Nordeste",22007,"Alto Parnaíba Piauiense",46956,72669.738710069,11,15,3,12,10,5,0,0,0,0,0,15,3,12,10,5,8,11.1936803280362,10.7569662719984,0.351950035138593,2020-03-16,2020,3
"5380","PI",2,"Nordeste",22007,"Alto Parnaíba Piauiense",46956,72669.738710069,12,10,4,6,4,6,0,0,0,0,0,10,4,6,4,6,7,11.1936803280362,10.7569662719984,0.420977610039431,2020-03-23,2020,3
"5381","PI",2,"Nordeste",22007,"Alto Parnaíba Piauiense",46956,72669.738710069,13,14,6,8,7,7,0,0,0,0,0,14,6,8,7,7,5,11.1936803280362,10.7569662719984,0.369340801706154,2020-03-30,2020,3
"5382","PI",2,"Nordeste",22007,"Alto Parnaíba Piauiense",46956,72669.738710069,14,17,4,13,11,6,0,0,0,0,0,17,4,13,11,6,6,11.1936803280362,10.7569662719984,0.382593004835784,2020-04-06,2020,4
"5383","PI",2,"Nordeste",22007,"Alto Parnaíba Piauiense",46956,72669.738710069,15,13,6,7,5,8,0,0,0,0,0,13,6,7,5,8,3,11.1936803280362,10.7569662719984,0.324869563725067,2020-04-13,2020,4
"5384","PI",2,"Nordeste",22007,"Alto Parnaíba Piauiense",46956,72669.738710069,16,15,3,12,6,9,0,0,0,0,0,15,3,12,6,9,8,11.1936803280362,10.7569662719984,0.348225658778841,2020-04-20,2020,4
"5385","PI",2,"Nordeste",22007,"Alto Parnaíba Piauiense",46956,72669.738710069,17,13,5,8,7,6,0,0,0,0,0,13,5,8,7,6,6,11.1936803280362,10.7569662719984,0.360291096116015,2020-04-27,2020,4
"5386","PI",2,"Nordeste",22007,"Alto Parnaíba Piauiense",46956,72669.738710069,18,16,3,13,8,8,0,0,0,0,0,16,3,13,8,8,3,11.1936803280362,10.7569662719984,0.38100231549232,2020-05-04,2020,5
"5387","PI",2,"Nordeste",22007,"Alto Parnaíba Piauiense",46956,72669.738710069,19,16,4,12,10,6,1,1,0,0,1,17,5,12,10,7,8,11.1936803280362,10.7569662719984,0.39666778837469,2020-05-11,2020,5
"5388","PI",2,"Nordeste",22007,"Alto Parnaíba Piauiense",46956,72669.738710069,20,14,5,9,8,6,0,0,0,0,0,14,5,9,8,6,3,11.1936803280362,10.7569662719984,0.36220332906013,2020-05-18,2020,5
"5389","PI",2,"Nordeste",22007,"Alto Parnaíba Piauiense",46956,72669.738710069,21,21,10,11,9,12,0,0,0,0,0,21,10,11,9,12,5,11.1936803280362,10.7569662719984,0.349487799646775,2020-05-25,2020,5
"5390","PI",2,"Nordeste",22009,"Floriano",125026,18505.3599090589,5,33,4,29,12,21,0,0,0,0,0,33,4,29,12,21,19,9.82581569391828,11.7362769946554,0.255268015798428,2020-02-03,2020,2
"5391","PI",2,"Nordeste",22009,"Floriano",125026,18505.3599090589,6,27,5,22,11,16,0,0,0,0,0,27,5,22,11,16,15,9.82581569391828,11.7362769946554,0.243422993633263,2020-02-10,2020,2
"5392","PI",2,"Nordeste",22009,"Floriano",125026,18505.3599090589,7,24,8,16,10,14,0,0,0,0,0,24,8,16,10,14,20,9.82581569391828,11.7362769946554,0.251201161290371,2020-02-17,2020,2
"5393","PI",2,"Nordeste",22009,"Floriano",125026,18505.3599090589,8,40,13,27,12,28,0,0,0,0,0,40,13,27,12,28,19,9.82581569391828,11.7362769946554,0.301878029600979,2020-02-24,2020,2
"5394","PI",2,"Nordeste",22009,"Floriano",125026,18505.3599090589,9,33,6,27,13,20,0,0,0,0,0,33,6,27,13,20,19,9.82581569391828,11.7362769946554,0.278760085697495,2020-03-02,2020,3
"5395","PI",2,"Nordeste",22009,"Floriano",125026,18505.3599090589,10,23,2,21,4,19,0,0,0,0,0,23,2,21,4,19,26,9.82581569391828,11.7362769946554,0.294356575367112,2020-03-09,2020,3
"5396","PI",2,"Nordeste",22009,"Floriano",125026,18505.3599090589,11,35,12,23,14,21,0,0,0,0,0,35,12,23,14,21,19,9.82581569391828,11.7362769946554,0.368321026139785,2020-03-16,2020,3
"5397","PI",2,"Nordeste",22009,"Floriano",125026,18505.3599090589,12,27,7,20,11,16,0,0,0,0,0,27,7,20,11,16,20,9.82581569391828,11.7362769946554,0.479961353124926,2020-03-23,2020,3
"5398","PI",2,"Nordeste",22009,"Floriano",125026,18505.3599090589,13,25,7,18,12,13,0,0,0,0,0,25,7,18,12,13,18,9.82581569391828,11.7362769946554,0.432460594847015,2020-03-30,2020,3
"5399","PI",2,"Nordeste",22009,"Floriano",125026,18505.3599090589,14,32,7,25,6,26,0,0,0,0,0,32,7,25,6,26,18,9.82581569391828,11.7362769946554,0.427915669247286,2020-04-06,2020,4
"5400","PI",2,"Nordeste",22009,"Floriano",125026,18505.3599090589,15,35,9,26,12,23,0,0,0,0,0,35,9,26,12,23,14,9.82581569391828,11.7362769946554,0.405011987049423,2020-04-13,2020,4
"5401","PI",2,"Nordeste",22009,"Floriano",125026,18505.3599090589,16,30,7,23,17,13,0,0,0,0,0,30,7,23,17,13,22,9.82581569391828,11.7362769946554,0.423787305566176,2020-04-20,2020,4
"5402","PI",2,"Nordeste",22009,"Floriano",125026,18505.3599090589,17,30,9,21,10,20,0,0,0,0,0,30,9,21,10,20,16,9.82581569391828,11.7362769946554,0.399520946305061,2020-04-27,2020,4
"5403","PI",2,"Nordeste",22009,"Floriano",125026,18505.3599090589,18,33,6,27,12,21,0,0,0,0,0,33,6,27,12,21,16,9.82581569391828,11.7362769946554,0.395403536445423,2020-05-04,2020,5
"5404","PI",2,"Nordeste",22009,"Floriano",125026,18505.3599090589,19,37,10,27,18,19,0,0,0,0,0,37,10,27,18,19,17,9.82581569391828,11.7362769946554,0.420542685147316,2020-05-11,2020,5
"5405","PI",2,"Nordeste",22009,"Floriano",125026,18505.3599090589,20,35,6,29,18,17,1,0,1,0,1,36,6,30,18,18,19,9.82581569391828,11.7362769946554,0.403121311763514,2020-05-18,2020,5
"5406","PI",2,"Nordeste",22009,"Floriano",125026,18505.3599090589,21,32,9,23,8,24,0,0,0,0,0,32,9,23,8,24,12,9.82581569391828,11.7362769946554,0.386519629163387,2020-05-25,2020,5
"5407","PI",2,"Nordeste",22010,"Alto Médio Gurguéia",93676,21852.8991704385,5,23,3,20,16,7,1,1,0,1,0,24,4,20,17,7,8,9.99208887686777,11.4475972988117,0.242627830679241,2020-02-03,2020,2
"5408","PI",2,"Nordeste",22010,"Alto Médio Gurguéia",93676,21852.8991704385,6,34,15,19,18,16,1,1,0,0,1,35,16,19,18,17,5,9.99208887686777,11.4475972988117,0.242614136925629,2020-02-10,2020,2
"5409","PI",2,"Nordeste",22010,"Alto Médio Gurguéia",93676,21852.8991704385,7,35,14,21,14,21,1,0,1,1,0,36,14,22,15,21,9,9.99208887686777,11.4475972988117,0.246429766327643,2020-02-17,2020,2
"5410","PI",2,"Nordeste",22010,"Alto Médio Gurguéia",93676,21852.8991704385,8,29,11,18,20,9,0,0,0,0,0,29,11,18,20,9,13,9.99208887686777,11.4475972988117,0.281813396107325,2020-02-24,2020,2
"5411","PI",2,"Nordeste",22010,"Alto Médio Gurguéia",93676,21852.8991704385,9,25,9,16,11,14,0,0,0,0,0,25,9,16,11,14,8,9.99208887686777,11.4475972988117,0.254340211794635,2020-03-02,2020,3
"5412","PI",2,"Nordeste",22010,"Alto Médio Gurguéia",93676,21852.8991704385,10,35,14,21,18,17,0,0,0,0,0,35,14,21,18,17,8,9.99208887686777,11.4475972988117,0.285393684747782,2020-03-09,2020,3
"5413","PI",2,"Nordeste",22010,"Alto Médio Gurguéia",93676,21852.8991704385,11,30,10,20,15,15,0,0,0,0,0,30,10,20,15,15,11,9.99208887686777,11.4475972988117,0.363489441420506,2020-03-16,2020,3
"5414","PI",2,"Nordeste",22010,"Alto Médio Gurguéia",93676,21852.8991704385,12,21,10,11,11,10,0,0,0,0,0,21,10,11,11,10,11,9.99208887686777,11.4475972988117,0.420843350335191,2020-03-23,2020,3
"5415","PI",2,"Nordeste",22010,"Alto Médio Gurguéia",93676,21852.8991704385,13,34,15,19,16,18,1,1,0,0,1,35,16,19,16,19,7,9.99208887686777,11.4475972988117,0.384260383195347,2020-03-30,2020,3
"5416","PI",2,"Nordeste",22010,"Alto Médio Gurguéia",93676,21852.8991704385,14,22,8,14,10,12,1,0,1,0,1,23,8,15,10,13,3,9.99208887686777,11.4475972988117,0.391641241329767,2020-04-06,2020,4
"5417","PI",2,"Nordeste",22010,"Alto Médio Gurguéia",93676,21852.8991704385,15,26,10,16,10,16,0,0,0,0,0,26,10,16,10,16,5,9.99208887686777,11.4475972988117,0.341139186320441,2020-04-13,2020,4
"5418","PI",2,"Nordeste",22010,"Alto Médio Gurguéia",93676,21852.8991704385,16,18,7,11,6,12,1,0,1,1,0,19,7,12,7,12,9,9.99208887686777,11.4475972988117,0.34073974257563,2020-04-20,2020,4
"5419","PI",2,"Nordeste",22010,"Alto Médio Gurguéia",93676,21852.8991704385,17,26,10,16,15,11,0,0,0,0,0,26,10,16,15,11,9,9.99208887686777,11.4475972988117,0.336725257270447,2020-04-27,2020,4
"5420","PI",2,"Nordeste",22010,"Alto Médio Gurguéia",93676,21852.8991704385,18,22,13,9,14,8,1,1,0,0,1,23,14,9,14,9,6,9.99208887686777,11.4475972988117,0.363417816573634,2020-05-04,2020,5
"5421","PI",2,"Nordeste",22010,"Alto Médio Gurguéia",93676,21852.8991704385,19,32,12,20,17,15,2,1,1,2,0,34,13,21,19,15,11,9.99208887686777,11.4475972988117,0.395548512822002,2020-05-11,2020,5
"5422","PI",2,"Nordeste",22010,"Alto Médio Gurguéia",93676,21852.8991704385,20,27,11,16,15,12,0,0,0,0,0,27,11,16,15,12,8,9.99208887686777,11.4475972988117,0.368850020723013,2020-05-18,2020,5
"5423","PI",2,"Nordeste",22010,"Alto Médio Gurguéia",93676,21852.8991704385,21,20,11,9,15,5,1,0,1,0,1,21,11,10,15,6,8,9.99208887686777,11.4475972988117,0.364700661113159,2020-05-25,2020,5
"5424","PI",2,"Nordeste",22011,"São Raimundo Nonato",142812,9292.20920181777,5,38,19,19,19,19,0,0,0,0,0,38,19,19,19,19,19,9.13693160782302,11.8692843589704,0.240928168438584,2020-02-03,2020,2
"5425","PI",2,"Nordeste",22011,"São Raimundo Nonato",142812,9292.20920181777,6,30,11,19,20,10,0,0,0,0,0,30,11,19,20,10,13,9.13693160782302,11.8692843589704,0.230291628855039,2020-02-10,2020,2
"5426","PI",2,"Nordeste",22011,"São Raimundo Nonato",142812,9292.20920181777,7,41,18,23,22,19,0,0,0,0,0,41,18,23,22,19,13,9.13693160782302,11.8692843589704,0.231139052717119,2020-02-17,2020,2
"5427","PI",2,"Nordeste",22011,"São Raimundo Nonato",142812,9292.20920181777,8,32,10,22,15,17,0,0,0,0,0,32,10,22,15,17,11,9.13693160782302,11.8692843589704,0.254187683823146,2020-02-24,2020,2
"5428","PI",2,"Nordeste",22011,"São Raimundo Nonato",142812,9292.20920181777,9,22,7,15,9,13,0,0,0,0,0,22,7,15,9,13,14,9.13693160782302,11.8692843589704,0.2584239582118,2020-03-02,2020,3
"5429","PI",2,"Nordeste",22011,"São Raimundo Nonato",142812,9292.20920181777,10,29,17,12,18,11,0,0,0,0,0,29,17,12,18,11,15,9.13693160782302,11.8692843589704,0.287872445684345,2020-03-09,2020,3
"5430","PI",2,"Nordeste",22011,"São Raimundo Nonato",142812,9292.20920181777,11,40,18,22,17,23,0,0,0,0,0,40,18,22,17,23,21,9.13693160782302,11.8692843589704,0.352808626543681,2020-03-16,2020,3
"5431","PI",2,"Nordeste",22011,"São Raimundo Nonato",142812,9292.20920181777,12,35,18,17,14,21,0,0,0,0,0,35,18,17,14,21,22,9.13693160782302,11.8692843589704,0.454088309777395,2020-03-23,2020,3
"5432","PI",2,"Nordeste",22011,"São Raimundo Nonato",142812,9292.20920181777,13,28,16,12,9,19,0,0,0,0,0,28,16,12,9,19,13,9.13693160782302,11.8692843589704,0.385868099899931,2020-03-30,2020,3
"5433","PI",2,"Nordeste",22011,"São Raimundo Nonato",142812,9292.20920181777,14,22,12,10,13,9,0,0,0,0,0,22,12,10,13,9,16,9.13693160782302,11.8692843589704,0.391750587809987,2020-04-06,2020,4
"5434","PI",2,"Nordeste",22011,"São Raimundo Nonato",142812,9292.20920181777,15,47,22,25,27,20,0,0,0,0,0,47,22,25,27,20,18,9.13693160782302,11.8692843589704,0.382954323267217,2020-04-13,2020,4
"5435","PI",2,"Nordeste",22011,"São Raimundo Nonato",142812,9292.20920181777,16,34,14,20,19,15,0,0,0,0,0,34,14,20,19,15,9,9.13693160782302,11.8692843589704,0.396308945013971,2020-04-20,2020,4
"5436","PI",2,"Nordeste",22011,"São Raimundo Nonato",142812,9292.20920181777,17,22,11,11,8,14,0,0,0,0,0,22,11,11,8,14,16,9.13693160782302,11.8692843589704,0.391143199170068,2020-04-27,2020,4
"5437","PI",2,"Nordeste",22011,"São Raimundo Nonato",142812,9292.20920181777,18,22,8,14,9,13,0,0,0,0,0,22,8,14,9,13,23,9.13693160782302,11.8692843589704,0.379632514656179,2020-05-04,2020,5
"5438","PI",2,"Nordeste",22011,"São Raimundo Nonato",142812,9292.20920181777,19,48,20,28,34,14,0,0,0,0,0,48,20,28,34,14,11,9.13693160782302,11.8692843589704,0.382717219545388,2020-05-11,2020,5
"5439","PI",2,"Nordeste",22011,"São Raimundo Nonato",142812,9292.20920181777,20,29,14,15,22,7,1,0,1,0,1,30,14,16,22,8,16,9.13693160782302,11.8692843589704,0.361851492112838,2020-05-18,2020,5
"5440","PI",2,"Nordeste",22011,"São Raimundo Nonato",142812,9292.20920181777,21,32,11,21,12,20,0,0,0,0,0,32,11,21,12,20,21,9.13693160782302,11.8692843589704,0.357989159687626,2020-05-25,2020,5
"5441","PI",2,"Nordeste",22012,"Chapadas do Extremo Sul Piauiense",86533,10820.7596283499,5,20,7,13,11,9,1,0,1,0,1,21,7,14,11,10,8,9.28922175588346,11.3682811230564,0.244781934720268,2020-02-03,2020,2
"5442","PI",2,"Nordeste",22012,"Chapadas do Extremo Sul Piauiense",86533,10820.7596283499,6,25,7,18,12,13,0,0,0,0,0,25,7,18,12,13,7,9.28922175588346,11.3682811230564,0.249469152597777,2020-02-10,2020,2
"5443","PI",2,"Nordeste",22012,"Chapadas do Extremo Sul Piauiense",86533,10820.7596283499,7,26,8,18,15,11,0,0,0,0,0,26,8,18,15,11,9,9.28922175588346,11.3682811230564,0.249694291355166,2020-02-17,2020,2
"5444","PI",2,"Nordeste",22012,"Chapadas do Extremo Sul Piauiense",86533,10820.7596283499,8,28,12,16,7,21,0,0,0,0,0,28,12,16,7,21,9,9.28922175588346,11.3682811230564,0.279548890792315,2020-02-24,2020,2
"5445","PI",2,"Nordeste",22012,"Chapadas do Extremo Sul Piauiense",86533,10820.7596283499,9,23,8,15,11,12,1,1,0,1,0,24,9,15,12,12,9,9.28922175588346,11.3682811230564,0.272786806727572,2020-03-02,2020,3
"5446","PI",2,"Nordeste",22012,"Chapadas do Extremo Sul Piauiense",86533,10820.7596283499,10,31,11,20,18,13,0,0,0,0,0,31,11,20,18,13,11,9.28922175588346,11.3682811230564,0.263919885680238,2020-03-09,2020,3
"5447","PI",2,"Nordeste",22012,"Chapadas do Extremo Sul Piauiense",86533,10820.7596283499,11,24,8,16,15,9,0,0,0,0,0,24,8,16,15,9,10,9.28922175588346,11.3682811230564,0.336204137048527,2020-03-16,2020,3
"5448","PI",2,"Nordeste",22012,"Chapadas do Extremo Sul Piauiense",86533,10820.7596283499,12,24,10,14,14,10,0,0,0,0,0,24,10,14,14,10,6,9.28922175588346,11.3682811230564,0.451393822771291,2020-03-23,2020,3
"5449","PI",2,"Nordeste",22012,"Chapadas do Extremo Sul Piauiense",86533,10820.7596283499,13,27,16,11,17,10,0,0,0,0,0,27,16,11,17,10,10,9.28922175588346,11.3682811230564,0.396589513484756,2020-03-30,2020,3
"5450","PI",2,"Nordeste",22012,"Chapadas do Extremo Sul Piauiense",86533,10820.7596283499,14,16,9,7,4,12,0,0,0,0,0,16,9,7,4,12,11,9.28922175588346,11.3682811230564,0.382817230335503,2020-04-06,2020,4
"5451","PI",2,"Nordeste",22012,"Chapadas do Extremo Sul Piauiense",86533,10820.7596283499,15,17,12,5,7,10,0,0,0,0,0,17,12,5,7,10,11,9.28922175588346,11.3682811230564,0.34373728402109,2020-04-13,2020,4
"5452","PI",2,"Nordeste",22012,"Chapadas do Extremo Sul Piauiense",86533,10820.7596283499,16,27,14,13,13,14,0,0,0,0,0,27,14,13,13,14,9,9.28922175588346,11.3682811230564,0.327474016770315,2020-04-20,2020,4
"5453","PI",2,"Nordeste",22012,"Chapadas do Extremo Sul Piauiense",86533,10820.7596283499,17,27,10,17,12,15,0,0,0,0,0,27,10,17,12,15,9,9.28922175588346,11.3682811230564,0.319509953699482,2020-04-27,2020,4
"5454","PI",2,"Nordeste",22012,"Chapadas do Extremo Sul Piauiense",86533,10820.7596283499,18,25,17,8,13,12,1,1,0,0,1,26,18,8,13,13,5,9.28922175588346,11.3682811230564,0.342621318485264,2020-05-04,2020,5
"5455","PI",2,"Nordeste",22012,"Chapadas do Extremo Sul Piauiense",86533,10820.7596283499,19,25,10,15,18,7,0,0,0,0,0,25,10,15,18,7,8,9.28922175588346,11.3682811230564,0.391339407156298,2020-05-11,2020,5
"5456","PI",2,"Nordeste",22012,"Chapadas do Extremo Sul Piauiense",86533,10820.7596283499,20,31,17,14,17,14,0,0,0,0,0,31,17,14,17,14,12,9.28922175588346,11.3682811230564,0.363252760046622,2020-05-18,2020,5
"5457","PI",2,"Nordeste",22012,"Chapadas do Extremo Sul Piauiense",86533,10820.7596283499,21,26,6,20,13,13,0,0,0,0,0,26,6,20,13,13,10,9.28922175588346,11.3682811230564,0.347460513359876,2020-05-25,2020,5
"5458","PI",2,"Nordeste",22013,"Picos",208926,13075.855120569,5,57,18,39,26,31,0,0,0,0,0,57,18,39,26,31,32,9.47852268798531,12.2497354012648,0.252494586931778,2020-02-03,2020,2
"5459","PI",2,"Nordeste",22013,"Picos",208926,13075.855120569,6,50,16,34,27,23,1,0,1,0,1,51,16,35,27,24,28,9.47852268798531,12.2497354012648,0.25322726268299,2020-02-10,2020,2
"5460","PI",2,"Nordeste",22013,"Picos",208926,13075.855120569,7,39,11,28,18,21,0,0,0,0,0,39,11,28,18,21,19,9.47852268798531,12.2497354012648,0.272884747061906,2020-02-17,2020,2
"5461","PI",2,"Nordeste",22013,"Picos",208926,13075.855120569,8,44,13,31,18,26,0,0,0,0,0,44,13,31,18,26,37,9.47852268798531,12.2497354012648,0.31393436857656,2020-02-24,2020,2
"5462","PI",2,"Nordeste",22013,"Picos",208926,13075.855120569,9,38,6,32,15,23,0,0,0,0,0,38,6,32,15,23,36,9.47852268798531,12.2497354012648,0.280725465178881,2020-03-02,2020,3
"5463","PI",2,"Nordeste",22013,"Picos",208926,13075.855120569,10,42,13,29,19,23,0,0,0,0,0,42,13,29,19,23,44,9.47852268798531,12.2497354012648,0.309283839738948,2020-03-09,2020,3
"5464","PI",2,"Nordeste",22013,"Picos",208926,13075.855120569,11,30,7,23,14,16,0,0,0,0,0,30,7,23,14,16,44,9.47852268798531,12.2497354012648,0.384747776869322,2020-03-16,2020,3
"5465","PI",2,"Nordeste",22013,"Picos",208926,13075.855120569,12,42,14,28,20,22,1,0,1,0,1,43,14,29,20,23,27,9.47852268798531,12.2497354012648,0.495303283340954,2020-03-23,2020,3
"5466","PI",2,"Nordeste",22013,"Picos",208926,13075.855120569,13,18,4,14,5,13,0,0,0,0,0,18,4,14,5,13,30,9.47852268798531,12.2497354012648,0.455792322183532,2020-03-30,2020,3
"5467","PI",2,"Nordeste",22013,"Picos",208926,13075.855120569,14,26,8,18,12,14,0,0,0,0,0,26,8,18,12,14,29,9.47852268798531,12.2497354012648,0.422000080550479,2020-04-06,2020,4
"5468","PI",2,"Nordeste",22013,"Picos",208926,13075.855120569,15,26,4,22,9,17,0,0,0,0,0,26,4,22,9,17,29,9.47852268798531,12.2497354012648,0.409922660757632,2020-04-13,2020,4
"5469","PI",2,"Nordeste",22013,"Picos",208926,13075.855120569,16,19,5,14,12,7,0,0,0,0,0,19,5,14,12,7,19,9.47852268798531,12.2497354012648,0.405367344204634,2020-04-20,2020,4
"5470","PI",2,"Nordeste",22013,"Picos",208926,13075.855120569,17,21,3,18,9,12,0,0,0,0,0,21,3,18,9,12,27,9.47852268798531,12.2497354012648,0.398608263035038,2020-04-27,2020,4
"5471","PI",2,"Nordeste",22013,"Picos",208926,13075.855120569,18,14,2,12,4,10,1,0,1,1,0,15,2,13,5,10,32,9.47852268798531,12.2497354012648,0.404842137292985,2020-05-04,2020,5
"5472","PI",2,"Nordeste",22013,"Picos",208926,13075.855120569,19,23,7,16,6,17,0,0,0,0,0,23,7,16,6,17,21,9.47852268798531,12.2497354012648,0.436735439884035,2020-05-11,2020,5
"5473","PI",2,"Nordeste",22013,"Picos",208926,13075.855120569,20,16,1,15,6,10,1,1,0,0,1,17,2,15,6,11,23,9.47852268798531,12.2497354012648,0.407443937926051,2020-05-18,2020,5
"5474","PI",2,"Nordeste",22013,"Picos",208926,13075.855120569,21,21,6,15,11,10,0,0,0,0,0,21,6,15,11,10,21,9.47852268798531,12.2497354012648,0.390636719415924,2020-05-25,2020,5
"5475","PI",2,"Nordeste",22014,"Pio IX",60993,8352.16012017773,5,17,8,9,12,5,0,0,0,0,0,17,8,9,12,5,8,9.03027548141587,11.0185143824723,0.262873934148165,2020-02-03,2020,2
"5476","PI",2,"Nordeste",22014,"Pio IX",60993,8352.16012017773,6,10,3,7,3,7,1,1,0,1,0,11,4,7,4,7,5,9.03027548141587,11.0185143824723,0.261391168833935,2020-02-10,2020,2
"5477","PI",2,"Nordeste",22014,"Pio IX",60993,8352.16012017773,7,7,2,5,3,4,0,0,0,0,0,7,2,5,3,4,4,9.03027548141587,11.0185143824723,0.252945874036666,2020-02-17,2020,2
"5478","PI",2,"Nordeste",22014,"Pio IX",60993,8352.16012017773,8,7,2,5,3,4,0,0,0,0,0,7,2,5,3,4,7,9.03027548141587,11.0185143824723,0.287005012975233,2020-02-24,2020,2
"5479","PI",2,"Nordeste",22014,"Pio IX",60993,8352.16012017773,9,14,6,8,6,8,0,0,0,0,0,14,6,8,6,8,9,9.03027548141587,11.0185143824723,0.278914102783456,2020-03-02,2020,3
"5480","PI",2,"Nordeste",22014,"Pio IX",60993,8352.16012017773,10,18,10,8,5,13,0,0,0,0,0,18,10,8,5,13,2,9.03027548141587,11.0185143824723,0.315330776532092,2020-03-09,2020,3
"5481","PI",2,"Nordeste",22014,"Pio IX",60993,8352.16012017773,11,6,4,2,4,2,0,0,0,0,0,6,4,2,4,2,8,9.03027548141587,11.0185143824723,0.343229099661495,2020-03-16,2020,3
"5482","PI",2,"Nordeste",22014,"Pio IX",60993,8352.16012017773,12,12,2,10,6,6,0,0,0,0,0,12,2,10,6,6,9,9.03027548141587,11.0185143824723,0.465788670287425,2020-03-23,2020,3
"5483","PI",2,"Nordeste",22014,"Pio IX",60993,8352.16012017773,13,8,4,4,3,5,0,0,0,0,0,8,4,4,3,5,9,9.03027548141587,11.0185143824723,0.392042406816946,2020-03-30,2020,3
"5484","PI",2,"Nordeste",22014,"Pio IX",60993,8352.16012017773,14,6,1,5,2,4,1,1,0,0,1,7,2,5,2,5,7,9.03027548141587,11.0185143824723,0.387871789248847,2020-04-06,2020,4
"5485","PI",2,"Nordeste",22014,"Pio IX",60993,8352.16012017773,15,3,0,3,0,3,0,0,0,0,0,3,0,3,0,3,8,9.03027548141587,11.0185143824723,0.357534169898708,2020-04-13,2020,4
"5486","PI",2,"Nordeste",22014,"Pio IX",60993,8352.16012017773,16,0,0,0,0,0,0,0,0,0,0,0,0,0,0,0,10,9.03027548141587,11.0185143824723,0.33899220694121,2020-04-20,2020,4
"5487","PI",2,"Nordeste",22014,"Pio IX",60993,8352.16012017773,17,3,2,1,0,3,0,0,0,0,0,3,2,1,0,3,9,9.03027548141587,11.0185143824723,0.385558008290707,2020-04-27,2020,4
"5488","PI",2,"Nordeste",22014,"Pio IX",60993,8352.16012017773,18,1,0,1,1,0,0,0,0,0,0,1,0,1,1,0,12,9.03027548141587,11.0185143824723,0.417786643952911,2020-05-04,2020,5
"5489","PI",2,"Nordeste",22014,"Pio IX",60993,8352.16012017773,19,3,1,2,1,2,0,0,0,0,0,3,1,2,1,2,6,9.03027548141587,11.0185143824723,0.438531057214144,2020-05-11,2020,5
"5490","PI",2,"Nordeste",22014,"Pio IX",60993,8352.16012017773,20,2,1,1,1,1,0,0,0,0,0,2,1,1,1,1,9,9.03027548141587,11.0185143824723,0.398209441538929,2020-05-18,2020,5
"5491","PI",2,"Nordeste",22014,"Pio IX",60993,8352.16012017773,21,2,1,1,2,0,0,0,0,0,0,2,1,1,2,0,4,9.03027548141587,11.0185143824723,0.386730645105971,2020-05-25,2020,5
"5492","PI",2,"Nordeste",22015,"Alto Médio Canindé",274450,10828.696547495,5,64,26,38,34,30,1,1,0,1,0,65,27,38,35,30,26,9.2899549770264,12.522524373978,0.246386549702114,2020-02-03,2020,2
"5493","PI",2,"Nordeste",22015,"Alto Médio Canindé",274450,10828.696547495,6,83,40,43,43,40,1,1,0,0,1,84,41,43,43,41,36,9.2899549770264,12.522524373978,0.238616773063237,2020-02-10,2020,2
"5494","PI",2,"Nordeste",22015,"Alto Médio Canindé",274450,10828.696547495,7,49,16,33,17,32,0,0,0,0,0,49,16,33,17,32,29,9.2899549770264,12.522524373978,0.240030046356995,2020-02-17,2020,2
"5495","PI",2,"Nordeste",22015,"Alto Médio Canindé",274450,10828.696547495,8,77,24,53,37,40,1,1,0,1,0,78,25,53,38,40,25,9.2899549770264,12.522524373978,0.276979465602972,2020-02-24,2020,2
"5496","PI",2,"Nordeste",22015,"Alto Médio Canindé",274450,10828.696547495,9,57,20,37,31,26,0,0,0,0,0,57,20,37,31,26,32,9.2899549770264,12.522524373978,0.24998813575943,2020-03-02,2020,3
"5497","PI",2,"Nordeste",22015,"Alto Médio Canindé",274450,10828.696547495,10,47,17,30,15,32,1,0,1,1,0,48,17,31,16,32,39,9.2899549770264,12.522524373978,0.275769385314557,2020-03-09,2020,3
"5498","PI",2,"Nordeste",22015,"Alto Médio Canindé",274450,10828.696547495,11,41,19,22,21,20,0,0,0,0,0,41,19,22,21,20,39,9.2899549770264,12.522524373978,0.351729658435393,2020-03-16,2020,3
"5499","PI",2,"Nordeste",22015,"Alto Médio Canindé",274450,10828.696547495,12,45,18,27,25,20,1,0,1,1,0,46,18,28,26,20,38,9.2899549770264,12.522524373978,0.447329081394851,2020-03-23,2020,3
"5500","PI",2,"Nordeste",22015,"Alto Médio Canindé",274450,10828.696547495,13,46,16,30,23,23,0,0,0,0,0,46,16,30,23,23,57,9.2899549770264,12.522524373978,0.390958565295189,2020-03-30,2020,3
"5501","PI",2,"Nordeste",22015,"Alto Médio Canindé",274450,10828.696547495,14,49,18,31,21,28,0,0,0,0,0,49,18,31,21,28,38,9.2899549770264,12.522524373978,0.391051431419295,2020-04-06,2020,4
"5502","PI",2,"Nordeste",22015,"Alto Médio Canindé",274450,10828.696547495,15,51,24,27,28,23,1,0,1,0,1,52,24,28,28,24,23,9.2899549770264,12.522524373978,0.367259612685422,2020-04-13,2020,4
"5503","PI",2,"Nordeste",22015,"Alto Médio Canindé",274450,10828.696547495,16,40,13,27,26,14,1,1,0,1,0,41,14,27,27,14,40,9.2899549770264,12.522524373978,0.359538337510784,2020-04-20,2020,4
"5504","PI",2,"Nordeste",22015,"Alto Médio Canindé",274450,10828.696547495,17,47,16,31,25,22,1,1,0,0,1,48,17,31,25,23,34,9.2899549770264,12.522524373978,0.356608397285027,2020-04-27,2020,4
"5505","PI",2,"Nordeste",22015,"Alto Médio Canindé",274450,10828.696547495,18,37,11,26,14,23,0,0,0,0,0,37,11,26,14,23,37,9.2899549770264,12.522524373978,0.371057572485193,2020-05-04,2020,5
"5506","PI",2,"Nordeste",22015,"Alto Médio Canindé",274450,10828.696547495,19,48,15,33,20,28,0,0,0,0,0,48,15,33,20,28,30,9.2899549770264,12.522524373978,0.418824815850085,2020-05-11,2020,5
"5507","PI",2,"Nordeste",22015,"Alto Médio Canindé",274450,10828.696547495,20,40,14,26,19,21,1,0,1,1,0,41,14,27,20,21,31,9.2899549770264,12.522524373978,0.387578155363859,2020-05-18,2020,5
"5508","PI",2,"Nordeste",22015,"Alto Médio Canindé",274450,10828.696547495,21,40,18,22,20,20,1,1,0,1,0,41,19,22,21,20,37,9.2899549770264,12.522524373978,0.382168399207132,2020-05-25,2020,5
"5509","PR",4,"Sul",41001,"Paranavaí",288640,27686.7042695399,5,65,17,48,21,44,0,0,0,0,0,65,17,48,21,44,41,10.2287075866739,12.5729355158564,0.29251072155457,2020-02-03,2020,2
"5510","PR",4,"Sul",41001,"Paranavaí",288640,27686.7042695399,6,69,16,53,34,35,1,0,1,1,0,70,16,54,35,35,48,10.2287075866739,12.5729355158564,0.287625306789256,2020-02-10,2020,2
"5511","PR",4,"Sul",41001,"Paranavaí",288640,27686.7042695399,7,49,6,43,17,32,0,0,0,0,0,49,6,43,17,32,45,10.2287075866739,12.5729355158564,0.293365765478635,2020-02-17,2020,2
"5512","PR",4,"Sul",41001,"Paranavaí",288640,27686.7042695399,8,55,13,42,18,37,0,0,0,0,0,55,13,42,18,37,40,10.2287075866739,12.5729355158564,0.330307706248558,2020-02-24,2020,2
"5513","PR",4,"Sul",41001,"Paranavaí",288640,27686.7042695399,9,58,13,45,22,36,1,1,0,0,1,59,14,45,22,37,41,10.2287075866739,12.5729355158564,0.304997627272789,2020-03-02,2020,3
"5514","PR",4,"Sul",41001,"Paranavaí",288640,27686.7042695399,10,60,13,47,24,36,1,0,1,0,1,61,13,48,24,37,48,10.2287075866739,12.5729355158564,0.308992966572021,2020-03-09,2020,3
"5515","PR",4,"Sul",41001,"Paranavaí",288640,27686.7042695399,11,64,9,55,18,46,0,0,0,0,0,64,9,55,18,46,47,10.2287075866739,12.5729355158564,0.399161880758601,2020-03-16,2020,3
"5516","PR",4,"Sul",41001,"Paranavaí",288640,27686.7042695399,12,55,13,42,16,39,0,0,0,0,0,55,13,42,16,39,42,10.2287075866739,12.5729355158564,0.517466276259538,2020-03-23,2020,3
"5517","PR",4,"Sul",41001,"Paranavaí",288640,27686.7042695399,13,78,13,65,21,57,0,0,0,0,0,78,13,65,21,57,42,10.2287075866739,12.5729355158564,0.4481088383741,2020-03-30,2020,3
"5518","PR",4,"Sul",41001,"Paranavaí",288640,27686.7042695399,14,69,14,55,22,47,0,0,0,0,0,69,14,55,22,47,41,10.2287075866739,12.5729355158564,0.425407870184444,2020-04-06,2020,4
"5519","PR",4,"Sul",41001,"Paranavaí",288640,27686.7042695399,15,54,12,42,19,35,0,0,0,0,0,54,12,42,19,35,38,10.2287075866739,12.5729355158564,0.404308165268707,2020-04-13,2020,4
"5520","PR",4,"Sul",41001,"Paranavaí",288640,27686.7042695399,16,63,13,50,22,41,0,0,0,0,0,63,13,50,22,41,37,10.2287075866739,12.5729355158564,0.412930149479664,2020-04-20,2020,4
"5521","PR",4,"Sul",41001,"Paranavaí",288640,27686.7042695399,17,64,14,50,23,41,0,0,0,0,0,64,14,50,23,41,48,10.2287075866739,12.5729355158564,0.401597661736648,2020-04-27,2020,4
"5522","PR",4,"Sul",41001,"Paranavaí",288640,27686.7042695399,18,53,12,41,19,34,0,0,0,0,0,53,12,41,19,34,38,10.2287075866739,12.5729355158564,0.374516855083435,2020-05-04,2020,5
"5523","PR",4,"Sul",41001,"Paranavaí",288640,27686.7042695399,19,74,19,55,25,49,0,0,0,0,0,74,19,55,25,49,38,10.2287075866739,12.5729355158564,0.376479561182333,2020-05-11,2020,5
"5524","PR",4,"Sul",41001,"Paranavaí",288640,27686.7042695399,20,66,16,50,34,32,1,0,1,0,1,67,16,51,34,33,55,10.2287075866739,12.5729355158564,0.381342673350237,2020-05-18,2020,5
"5525","PR",4,"Sul",41001,"Paranavaí",288640,27686.7042695399,21,71,17,54,29,42,0,0,0,0,0,71,17,54,29,42,47,10.2287075866739,12.5729355158564,0.367553261751154,2020-05-25,2020,5
"5526","PR",4,"Sul",41002,"Umuarama",277003,29805.2577603131,5,85,16,69,32,53,0,0,0,0,0,85,16,69,32,53,47,10.3024400918405,12.5317836154357,0.282818080806408,2020-02-03,2020,2
"5527","PR",4,"Sul",41002,"Umuarama",277003,29805.2577603131,6,64,9,55,18,46,1,0,1,1,0,65,9,56,19,46,56,10.3024400918405,12.5317836154357,0.285805829369199,2020-02-10,2020,2
"5528","PR",4,"Sul",41002,"Umuarama",277003,29805.2577603131,7,50,8,42,15,35,0,0,0,0,0,50,8,42,15,35,41,10.3024400918405,12.5317836154357,0.29308092018953,2020-02-17,2020,2
"5529","PR",4,"Sul",41002,"Umuarama",277003,29805.2577603131,8,70,13,57,20,50,0,0,0,0,0,70,13,57,20,50,48,10.3024400918405,12.5317836154357,0.336554231349967,2020-02-24,2020,2
"5530","PR",4,"Sul",41002,"Umuarama",277003,29805.2577603131,9,75,6,69,20,55,0,0,0,0,0,75,6,69,20,55,44,10.3024400918405,12.5317836154357,0.319164770501664,2020-03-02,2020,3
"5531","PR",4,"Sul",41002,"Umuarama",277003,29805.2577603131,10,67,16,51,31,36,1,0,1,1,0,68,16,52,32,36,50,10.3024400918405,12.5317836154357,0.31977921621611,2020-03-09,2020,3
"5532","PR",4,"Sul",41002,"Umuarama",277003,29805.2577603131,11,60,8,52,22,38,0,0,0,0,0,60,8,52,22,38,45,10.3024400918405,12.5317836154357,0.405380178729829,2020-03-16,2020,3
"5533","PR",4,"Sul",41002,"Umuarama",277003,29805.2577603131,12,67,14,53,25,42,4,1,3,2,2,71,15,56,27,44,40,10.3024400918405,12.5317836154357,0.5321884849666,2020-03-23,2020,3
"5534","PR",4,"Sul",41002,"Umuarama",277003,29805.2577603131,13,69,14,55,27,42,2,1,1,2,0,71,15,56,29,42,27,10.3024400918405,12.5317836154357,0.466494431873352,2020-03-30,2020,3
"5535","PR",4,"Sul",41002,"Umuarama",277003,29805.2577603131,14,67,15,52,29,38,0,0,0,0,0,67,15,52,29,38,38,10.3024400918405,12.5317836154357,0.420173571139907,2020-04-06,2020,4
"5536","PR",4,"Sul",41002,"Umuarama",277003,29805.2577603131,15,67,12,55,21,46,0,0,0,0,0,67,12,55,21,46,50,10.3024400918405,12.5317836154357,0.40305505509998,2020-04-13,2020,4
"5537","PR",4,"Sul",41002,"Umuarama",277003,29805.2577603131,16,76,18,58,31,45,1,0,1,1,0,77,18,59,32,45,38,10.3024400918405,12.5317836154357,0.401667606405383,2020-04-20,2020,4
"5538","PR",4,"Sul",41002,"Umuarama",277003,29805.2577603131,17,72,9,63,19,53,2,1,1,0,2,74,10,64,19,55,44,10.3024400918405,12.5317836154357,0.39012232983042,2020-04-27,2020,4
"5539","PR",4,"Sul",41002,"Umuarama",277003,29805.2577603131,18,62,6,56,20,42,0,0,0,0,0,62,6,56,20,42,45,10.3024400918405,12.5317836154357,0.369483286950016,2020-05-04,2020,5
"5540","PR",4,"Sul",41002,"Umuarama",277003,29805.2577603131,19,76,14,62,31,45,2,0,2,2,0,78,14,64,33,45,51,10.3024400918405,12.5317836154357,0.376315621176569,2020-05-11,2020,5
"5541","PR",4,"Sul",41002,"Umuarama",277003,29805.2577603131,20,78,9,69,23,55,0,0,0,0,0,78,9,69,23,55,51,10.3024400918405,12.5317836154357,0.381938357276481,2020-05-18,2020,5
"5542","PR",4,"Sul",41002,"Umuarama",277003,29805.2577603131,21,90,15,75,34,56,0,0,0,0,0,90,15,75,34,56,50,10.3024400918405,12.5317836154357,0.364497960344279,2020-05-25,2020,5
"5543","PR",4,"Sul",41003,"Cianorte",162273,32867.455502086,5,24,7,17,8,16,0,0,0,0,0,24,7,17,8,16,21,10.4002382527123,11.9970353810684,0.288481464636914,2020-02-03,2020,2
"5544","PR",4,"Sul",41003,"Cianorte",162273,32867.455502086,6,21,4,17,11,10,0,0,0,0,0,21,4,17,11,10,24,10.4002382527123,11.9970353810684,0.293416006161141,2020-02-10,2020,2
"5545","PR",4,"Sul",41003,"Cianorte",162273,32867.455502086,7,29,9,20,5,24,1,0,1,1,0,30,9,21,6,24,28,10.4002382527123,11.9970353810684,0.29805463518497,2020-02-17,2020,2
"5546","PR",4,"Sul",41003,"Cianorte",162273,32867.455502086,8,33,11,22,8,25,0,0,0,0,0,33,11,22,8,25,12,10.4002382527123,11.9970353810684,0.32780456504779,2020-02-24,2020,2
"5547","PR",4,"Sul",41003,"Cianorte",162273,32867.455502086,9,37,3,34,13,24,0,0,0,0,0,37,3,34,13,24,28,10.4002382527123,11.9970353810684,0.321224797936175,2020-03-02,2020,3
"5548","PR",4,"Sul",41003,"Cianorte",162273,32867.455502086,10,31,5,26,13,18,0,0,0,0,0,31,5,26,13,18,22,10.4002382527123,11.9970353810684,0.327632396111294,2020-03-09,2020,3
"5549","PR",4,"Sul",41003,"Cianorte",162273,32867.455502086,11,31,4,27,9,22,0,0,0,0,0,31,4,27,9,22,25,10.4002382527123,11.9970353810684,0.398100241259195,2020-03-16,2020,3
"5550","PR",4,"Sul",41003,"Cianorte",162273,32867.455502086,12,38,9,29,15,23,0,0,0,0,0,38,9,29,15,23,24,10.4002382527123,11.9970353810684,0.524443179251822,2020-03-23,2020,3
"5551","PR",4,"Sul",41003,"Cianorte",162273,32867.455502086,13,33,10,23,15,18,0,0,0,0,0,33,10,23,15,18,23,10.4002382527123,11.9970353810684,0.453239675744434,2020-03-30,2020,3
"5552","PR",4,"Sul",41003,"Cianorte",162273,32867.455502086,14,42,14,28,18,24,0,0,0,0,0,42,14,28,18,24,18,10.4002382527123,11.9970353810684,0.428393775824649,2020-04-06,2020,4
"5553","PR",4,"Sul",41003,"Cianorte",162273,32867.455502086,15,37,9,28,12,25,0,0,0,0,0,37,9,28,12,25,18,10.4002382527123,11.9970353810684,0.391632815548022,2020-04-13,2020,4
"5554","PR",4,"Sul",41003,"Cianorte",162273,32867.455502086,16,42,13,29,15,27,0,0,0,0,0,42,13,29,15,27,22,10.4002382527123,11.9970353810684,0.410430715411444,2020-04-20,2020,4
"5555","PR",4,"Sul",41003,"Cianorte",162273,32867.455502086,17,42,9,33,16,26,0,0,0,0,0,42,9,33,16,26,21,10.4002382527123,11.9970353810684,0.40124415666512,2020-04-27,2020,4
"5556","PR",4,"Sul",41003,"Cianorte",162273,32867.455502086,18,28,5,23,6,22,0,0,0,0,0,28,5,23,6,22,21,10.4002382527123,11.9970353810684,0.374384061007158,2020-05-04,2020,5
"5557","PR",4,"Sul",41003,"Cianorte",162273,32867.455502086,19,47,12,35,20,27,0,0,0,0,0,47,12,35,20,27,18,10.4002382527123,11.9970353810684,0.386803143844776,2020-05-11,2020,5
"5558","PR",4,"Sul",41003,"Cianorte",162273,32867.455502086,20,39,6,33,15,24,0,0,0,0,0,39,6,33,15,24,20,10.4002382527123,11.9970353810684,0.39049149785841,2020-05-18,2020,5
"5559","PR",4,"Sul",41003,"Cianorte",162273,32867.455502086,21,33,4,29,7,26,0,0,0,0,0,33,4,29,7,26,24,10.4002382527123,11.9970353810684,0.38330672647433,2020-05-25,2020,5
"5560","PR",4,"Sul",41004,"Goioerê",106072,36108.8267960442,5,30,6,24,13,17,0,0,0,0,0,30,6,24,13,17,19,10.4942926240191,11.5718733877946,0.310161837600572,2020-02-03,2020,2
"5561","PR",4,"Sul",41004,"Goioerê",106072,36108.8267960442,6,23,4,19,11,12,0,0,0,0,0,23,4,19,11,12,19,10.4942926240191,11.5718733877946,0.289979975396657,2020-02-10,2020,2
"5562","PR",4,"Sul",41004,"Goioerê",106072,36108.8267960442,7,24,4,20,10,14,0,0,0,0,0,24,4,20,10,14,19,10.4942926240191,11.5718733877946,0.300029917148862,2020-02-17,2020,2
"5563","PR",4,"Sul",41004,"Goioerê",106072,36108.8267960442,8,12,0,12,3,9,0,0,0,0,0,12,0,12,3,9,20,10.4942926240191,11.5718733877946,0.333743326197676,2020-02-24,2020,2
"5564","PR",4,"Sul",41004,"Goioerê",106072,36108.8267960442,9,24,5,19,10,14,0,0,0,0,0,24,5,19,10,14,18,10.4942926240191,11.5718733877946,0.307324324087637,2020-03-02,2020,3
"5565","PR",4,"Sul",41004,"Goioerê",106072,36108.8267960442,10,18,2,16,4,14,0,0,0,0,0,18,2,16,4,14,25,10.4942926240191,11.5718733877946,0.312289679224338,2020-03-09,2020,3
"5566","PR",4,"Sul",41004,"Goioerê",106072,36108.8267960442,11,30,5,25,11,19,0,0,0,0,0,30,5,25,11,19,20,10.4942926240191,11.5718733877946,0.393088504745071,2020-03-16,2020,3
"5567","PR",4,"Sul",41004,"Goioerê",106072,36108.8267960442,12,20,7,13,6,14,0,0,0,0,0,20,7,13,6,14,19,10.4942926240191,11.5718733877946,0.534096650889727,2020-03-23,2020,3
"5568","PR",4,"Sul",41004,"Goioerê",106072,36108.8267960442,13,29,5,24,15,14,0,0,0,0,0,29,5,24,15,14,16,10.4942926240191,11.5718733877946,0.451589322348735,2020-03-30,2020,3
"5569","PR",4,"Sul",41004,"Goioerê",106072,36108.8267960442,14,14,1,13,7,7,0,0,0,0,0,14,1,13,7,7,23,10.4942926240191,11.5718733877946,0.437167610313681,2020-04-06,2020,4
"5570","PR",4,"Sul",41004,"Goioerê",106072,36108.8267960442,15,23,3,20,11,12,1,0,1,1,0,24,3,21,12,12,17,10.4942926240191,11.5718733877946,0.420961696553734,2020-04-13,2020,4
"5571","PR",4,"Sul",41004,"Goioerê",106072,36108.8267960442,16,43,9,34,17,26,0,0,0,0,0,43,9,34,17,26,23,10.4942926240191,11.5718733877946,0.418577393523974,2020-04-20,2020,4
"5572","PR",4,"Sul",41004,"Goioerê",106072,36108.8267960442,17,30,6,24,12,18,2,0,2,0,2,32,6,26,12,20,20,10.4942926240191,11.5718733877946,0.406113969955977,2020-04-27,2020,4
"5573","PR",4,"Sul",41004,"Goioerê",106072,36108.8267960442,18,31,4,27,5,26,0,0,0,0,0,31,4,27,5,26,20,10.4942926240191,11.5718733877946,0.374515805105262,2020-05-04,2020,5
"5574","PR",4,"Sul",41004,"Goioerê",106072,36108.8267960442,19,19,2,17,12,7,0,0,0,0,0,19,2,17,12,7,20,10.4942926240191,11.5718733877946,0.378769994257232,2020-05-11,2020,5
"5575","PR",4,"Sul",41004,"Goioerê",106072,36108.8267960442,20,26,7,19,5,21,0,0,0,0,0,26,7,19,5,21,14,10.4942926240191,11.5718733877946,0.39561089230979,2020-05-18,2020,5
"5576","PR",4,"Sul",41004,"Goioerê",106072,36108.8267960442,21,22,3,19,7,15,1,0,1,0,1,23,3,20,7,16,12,10.4942926240191,11.5718733877946,0.391063759590542,2020-05-25,2020,5
"5577","PR",4,"Sul",41005,"Campo Mourão",221523,36426.6500548024,5,53,10,43,21,32,0,0,0,0,0,53,10,43,21,32,34,10.5030559301006,12.3082817005484,0.306196843017127,2020-02-03,2020,2
"5578","PR",4,"Sul",41005,"Campo Mourão",221523,36426.6500548024,6,45,8,37,20,25,0,0,0,0,0,45,8,37,20,25,33,10.5030559301006,12.3082817005484,0.303176597665879,2020-02-10,2020,2
"5579","PR",4,"Sul",41005,"Campo Mourão",221523,36426.6500548024,7,55,12,43,19,36,0,0,0,0,0,55,12,43,19,36,39,10.5030559301006,12.3082817005484,0.30335413202431,2020-02-17,2020,2
"5580","PR",4,"Sul",41005,"Campo Mourão",221523,36426.6500548024,8,47,11,36,17,30,2,0,2,0,2,49,11,38,17,32,29,10.5030559301006,12.3082817005484,0.344187522364874,2020-02-24,2020,2
"5581","PR",4,"Sul",41005,"Campo Mourão",221523,36426.6500548024,9,58,14,44,23,35,0,0,0,0,0,58,14,44,23,35,28,10.5030559301006,12.3082817005484,0.328085616412438,2020-03-02,2020,3
"5582","PR",4,"Sul",41005,"Campo Mourão",221523,36426.6500548024,10,50,8,42,15,35,0,0,0,0,0,50,8,42,15,35,33,10.5030559301006,12.3082817005484,0.330551899969043,2020-03-09,2020,3
"5583","PR",4,"Sul",41005,"Campo Mourão",221523,36426.6500548024,11,46,7,39,13,33,1,1,0,0,1,47,8,39,13,34,34,10.5030559301006,12.3082817005484,0.431310859392149,2020-03-16,2020,3
"5584","PR",4,"Sul",41005,"Campo Mourão",221523,36426.6500548024,12,49,11,38,13,36,1,0,1,0,1,50,11,39,13,37,30,10.5030559301006,12.3082817005484,0.537823629691232,2020-03-23,2020,3
"5585","PR",4,"Sul",41005,"Campo Mourão",221523,36426.6500548024,13,52,9,43,15,37,1,0,1,1,0,53,9,44,16,37,26,10.5030559301006,12.3082817005484,0.495533889719771,2020-03-30,2020,3
"5586","PR",4,"Sul",41005,"Campo Mourão",221523,36426.6500548024,14,65,17,48,26,39,1,0,1,0,1,66,17,49,26,40,36,10.5030559301006,12.3082817005484,0.490931905447072,2020-04-06,2020,4
"5587","PR",4,"Sul",41005,"Campo Mourão",221523,36426.6500548024,15,44,8,36,19,25,0,0,0,0,0,44,8,36,19,25,33,10.5030559301006,12.3082817005484,0.449920193741578,2020-04-13,2020,4
"5588","PR",4,"Sul",41005,"Campo Mourão",221523,36426.6500548024,16,59,14,45,25,34,0,0,0,0,0,59,14,45,25,34,36,10.5030559301006,12.3082817005484,0.444951578519173,2020-04-20,2020,4
"5589","PR",4,"Sul",41005,"Campo Mourão",221523,36426.6500548024,17,55,13,42,17,38,0,0,0,0,0,55,13,42,17,38,36,10.5030559301006,12.3082817005484,0.422548170144619,2020-04-27,2020,4
"5590","PR",4,"Sul",41005,"Campo Mourão",221523,36426.6500548024,18,51,7,44,17,34,0,0,0,0,0,51,7,44,17,34,34,10.5030559301006,12.3082817005484,0.394475037750003,2020-05-04,2020,5
"5591","PR",4,"Sul",41005,"Campo Mourão",221523,36426.6500548024,19,68,14,54,34,34,0,0,0,0,0,68,14,54,34,34,34,10.5030559301006,12.3082817005484,0.394671275182722,2020-05-11,2020,5
"5592","PR",4,"Sul",41005,"Campo Mourão",221523,36426.6500548024,20,61,12,49,18,43,0,0,0,0,0,61,12,49,18,43,30,10.5030559301006,12.3082817005484,0.404371142667684,2020-05-18,2020,5
"5593","PR",4,"Sul",41005,"Campo Mourão",221523,36426.6500548024,21,59,14,45,32,27,1,0,1,0,1,60,14,46,32,28,35,10.5030559301006,12.3082817005484,0.386048520278653,2020-05-25,2020,5
"5594","PR",4,"Sul",41006,"Astorga",197766,28926.0576424664,5,43,11,32,14,29,0,0,0,0,0,43,11,32,14,29,24,10.2724981163879,12.194839792597,0.285192111755871,2020-02-03,2020,2
"5595","PR",4,"Sul",41006,"Astorga",197766,28926.0576424664,6,40,6,34,9,31,1,0,1,0,1,41,6,35,9,32,33,10.2724981163879,12.194839792597,0.283888334255035,2020-02-10,2020,2
"5596","PR",4,"Sul",41006,"Astorga",197766,28926.0576424664,7,38,9,29,12,26,1,1,0,0,1,39,10,29,12,27,32,10.2724981163879,12.194839792597,0.291547776116473,2020-02-17,2020,2
"5597","PR",4,"Sul",41006,"Astorga",197766,28926.0576424664,8,44,6,38,12,32,0,0,0,0,0,44,6,38,12,32,20,10.2724981163879,12.194839792597,0.339585654145071,2020-02-24,2020,2
"5598","PR",4,"Sul",41006,"Astorga",197766,28926.0576424664,9,50,10,40,21,29,1,0,1,1,0,51,10,41,22,29,38,10.2724981163879,12.194839792597,0.316915192759284,2020-03-02,2020,3
"5599","PR",4,"Sul",41006,"Astorga",197766,28926.0576424664,10,35,9,26,11,24,0,0,0,0,0,35,9,26,11,24,33,10.2724981163879,12.194839792597,0.314194876792901,2020-03-09,2020,3
"5600","PR",4,"Sul",41006,"Astorga",197766,28926.0576424664,11,58,15,43,22,36,0,0,0,0,0,58,15,43,22,36,45,10.2724981163879,12.194839792597,0.398736524650468,2020-03-16,2020,3
"5601","PR",4,"Sul",41006,"Astorga",197766,28926.0576424664,12,44,13,31,16,28,1,0,1,0,1,45,13,32,16,29,36,10.2724981163879,12.194839792597,0.518006604949364,2020-03-23,2020,3
"5602","PR",4,"Sul",41006,"Astorga",197766,28926.0576424664,13,53,11,42,23,30,0,0,0,0,0,53,11,42,23,30,35,10.2724981163879,12.194839792597,0.453213213724383,2020-03-30,2020,3
"5603","PR",4,"Sul",41006,"Astorga",197766,28926.0576424664,14,34,9,25,13,21,0,0,0,0,0,34,9,25,13,21,19,10.2724981163879,12.194839792597,0.425666451129645,2020-04-06,2020,4
"5604","PR",4,"Sul",41006,"Astorga",197766,28926.0576424664,15,39,6,33,9,30,0,0,0,0,0,39,6,33,9,30,29,10.2724981163879,12.194839792597,0.404586345253746,2020-04-13,2020,4
"5605","PR",4,"Sul",41006,"Astorga",197766,28926.0576424664,16,41,10,31,13,28,0,0,0,0,0,41,10,31,13,28,30,10.2724981163879,12.194839792597,0.4063359374268,2020-04-20,2020,4
"5606","PR",4,"Sul",41006,"Astorga",197766,28926.0576424664,17,46,13,33,18,28,0,0,0,0,0,46,13,33,18,28,26,10.2724981163879,12.194839792597,0.399457929998047,2020-04-27,2020,4
"5607","PR",4,"Sul",41006,"Astorga",197766,28926.0576424664,18,42,8,34,18,24,0,0,0,0,0,42,8,34,18,24,28,10.2724981163879,12.194839792597,0.363954564225347,2020-05-04,2020,5
"5608","PR",4,"Sul",41006,"Astorga",197766,28926.0576424664,19,49,13,36,18,31,0,0,0,0,0,49,13,36,18,31,36,10.2724981163879,12.194839792597,0.367216190706535,2020-05-11,2020,5
"5609","PR",4,"Sul",41006,"Astorga",197766,28926.0576424664,20,46,16,30,22,24,0,0,0,0,0,46,16,30,22,24,27,10.2724981163879,12.194839792597,0.373430672693426,2020-05-18,2020,5
"5610","PR",4,"Sul",41006,"Astorga",197766,28926.0576424664,21,60,18,42,22,38,0,0,0,0,0,60,18,42,22,38,42,10.2724981163879,12.194839792597,0.365290010344627,2020-05-25,2020,5
"5611","PR",4,"Sul",41007,"Porecatu",83222,32139.1840849775,5,16,8,8,7,9,0,0,0,0,0,16,8,8,7,9,14,10.3778312526898,11.3292670149326,0.289659904110024,2020-02-03,2020,2
"5612","PR",4,"Sul",41007,"Porecatu",83222,32139.1840849775,6,17,2,15,4,13,0,0,0,0,0,17,2,15,4,13,12,10.3778312526898,11.3292670149326,0.276284415152504,2020-02-10,2020,2
"5613","PR",4,"Sul",41007,"Porecatu",83222,32139.1840849775,7,12,4,8,5,7,0,0,0,0,0,12,4,8,5,7,23,10.3778312526898,11.3292670149326,0.300327719730811,2020-02-17,2020,2
"5614","PR",4,"Sul",41007,"Porecatu",83222,32139.1840849775,8,12,2,10,3,9,0,0,0,0,0,12,2,10,3,9,17,10.3778312526898,11.3292670149326,0.346117226686702,2020-02-24,2020,2
"5615","PR",4,"Sul",41007,"Porecatu",83222,32139.1840849775,9,10,1,9,5,5,0,0,0,0,0,10,1,9,5,5,19,10.3778312526898,11.3292670149326,0.307501252739422,2020-03-02,2020,3
"5616","PR",4,"Sul",41007,"Porecatu",83222,32139.1840849775,10,26,6,20,8,18,0,0,0,0,0,26,6,20,8,18,12,10.3778312526898,11.3292670149326,0.319662044831584,2020-03-09,2020,3
"5617","PR",4,"Sul",41007,"Porecatu",83222,32139.1840849775,11,9,3,6,5,4,0,0,0,0,0,9,3,6,5,4,22,10.3778312526898,11.3292670149326,0.380330844663392,2020-03-16,2020,3
"5618","PR",4,"Sul",41007,"Porecatu",83222,32139.1840849775,12,11,1,10,5,6,0,0,0,0,0,11,1,10,5,6,17,10.3778312526898,11.3292670149326,0.471455116632783,2020-03-23,2020,3
"5619","PR",4,"Sul",41007,"Porecatu",83222,32139.1840849775,13,21,4,17,6,15,0,0,0,0,0,21,4,17,6,15,24,10.3778312526898,11.3292670149326,0.430140902848064,2020-03-30,2020,3
"5620","PR",4,"Sul",41007,"Porecatu",83222,32139.1840849775,14,18,2,16,6,12,0,0,0,0,0,18,2,16,6,12,15,10.3778312526898,11.3292670149326,0.410635751462417,2020-04-06,2020,4
"5621","PR",4,"Sul",41007,"Porecatu",83222,32139.1840849775,15,20,5,15,7,13,0,0,0,0,0,20,5,15,7,13,12,10.3778312526898,11.3292670149326,0.380409562593076,2020-04-13,2020,4
"5622","PR",4,"Sul",41007,"Porecatu",83222,32139.1840849775,16,16,5,11,5,11,0,0,0,0,0,16,5,11,5,11,4,10.3778312526898,11.3292670149326,0.391396236848807,2020-04-20,2020,4
"5623","PR",4,"Sul",41007,"Porecatu",83222,32139.1840849775,17,25,8,17,9,16,0,0,0,0,0,25,8,17,9,16,17,10.3778312526898,11.3292670149326,0.373595818223215,2020-04-27,2020,4
"5624","PR",4,"Sul",41007,"Porecatu",83222,32139.1840849775,18,18,5,13,4,14,0,0,0,0,0,18,5,13,4,14,16,10.3778312526898,11.3292670149326,0.354924917073605,2020-05-04,2020,5
"5625","PR",4,"Sul",41007,"Porecatu",83222,32139.1840849775,19,18,7,11,7,11,0,0,0,0,0,18,7,11,7,11,10,10.3778312526898,11.3292670149326,0.355279535080133,2020-05-11,2020,5
"5626","PR",4,"Sul",41007,"Porecatu",83222,32139.1840849775,20,15,4,11,7,8,0,0,0,0,0,15,4,11,7,8,10,10.3778312526898,11.3292670149326,0.362575668411626,2020-05-18,2020,5
"5627","PR",4,"Sul",41007,"Porecatu",83222,32139.1840849775,21,21,3,18,8,13,0,0,0,0,0,21,3,18,8,13,14,10.3778312526898,11.3292670149326,0.352704620542375,2020-05-25,2020,5
"5628","PR",4,"Sul",41008,"Floraí",36096,34013.8199171653,5,7,0,7,0,7,0,0,0,0,0,7,0,7,0,7,3,10.4345221891644,10.4939373348577,0.286963436894383,2020-02-03,2020,2
"5629","PR",4,"Sul",41008,"Floraí",36096,34013.8199171653,6,5,1,4,2,3,0,0,0,0,0,5,1,4,2,3,5,10.4345221891644,10.4939373348577,0.27797377389791,2020-02-10,2020,2
"5630","PR",4,"Sul",41008,"Floraí",36096,34013.8199171653,7,5,0,5,2,3,0,0,0,0,0,5,0,5,2,3,3,10.4345221891644,10.4939373348577,0.288875829603252,2020-02-17,2020,2
"5631","PR",4,"Sul",41008,"Floraí",36096,34013.8199171653,8,5,1,4,3,2,0,0,0,0,0,5,1,4,3,2,3,10.4345221891644,10.4939373348577,0.32446936858073,2020-02-24,2020,2
"5632","PR",4,"Sul",41008,"Floraí",36096,34013.8199171653,9,8,0,8,4,4,0,0,0,0,0,8,0,8,4,4,7,10.4345221891644,10.4939373348577,0.303125196902169,2020-03-02,2020,3
"5633","PR",4,"Sul",41008,"Floraí",36096,34013.8199171653,10,4,2,2,0,4,0,0,0,0,0,4,2,2,0,4,9,10.4345221891644,10.4939373348577,0.309739350292761,2020-03-09,2020,3
"5634","PR",4,"Sul",41008,"Floraí",36096,34013.8199171653,11,8,1,7,3,5,0,0,0,0,0,8,1,7,3,5,9,10.4345221891644,10.4939373348577,0.371621543568265,2020-03-16,2020,3
"5635","PR",4,"Sul",41008,"Floraí",36096,34013.8199171653,12,6,1,5,3,3,0,0,0,0,0,6,1,5,3,3,7,10.4345221891644,10.4939373348577,0.514635306972288,2020-03-23,2020,3
"5636","PR",4,"Sul",41008,"Floraí",36096,34013.8199171653,13,5,1,4,2,3,0,0,0,0,0,5,1,4,2,3,14,10.4345221891644,10.4939373348577,0.455675566711653,2020-03-30,2020,3
"5637","PR",4,"Sul",41008,"Floraí",36096,34013.8199171653,14,8,0,8,3,5,0,0,0,0,0,8,0,8,3,5,4,10.4345221891644,10.4939373348577,0.438257720391486,2020-04-06,2020,4
"5638","PR",4,"Sul",41008,"Floraí",36096,34013.8199171653,15,4,0,4,1,3,0,0,0,0,0,4,0,4,1,3,8,10.4345221891644,10.4939373348577,0.40923298304175,2020-04-13,2020,4
"5639","PR",4,"Sul",41008,"Floraí",36096,34013.8199171653,16,10,2,8,6,4,0,0,0,0,0,10,2,8,6,4,6,10.4345221891644,10.4939373348577,0.401835394634643,2020-04-20,2020,4
"5640","PR",4,"Sul",41008,"Floraí",36096,34013.8199171653,17,9,4,5,4,5,0,0,0,0,0,9,4,5,4,5,4,10.4345221891644,10.4939373348577,0.403470779915436,2020-04-27,2020,4
"5641","PR",4,"Sul",41008,"Floraí",36096,34013.8199171653,18,7,2,5,2,5,0,0,0,0,0,7,2,5,2,5,13,10.4345221891644,10.4939373348577,0.356513663612041,2020-05-04,2020,5
"5642","PR",4,"Sul",41008,"Floraí",36096,34013.8199171653,19,12,2,10,4,8,1,0,1,0,1,13,2,11,4,9,4,10.4345221891644,10.4939373348577,0.3644641255322,2020-05-11,2020,5
"5643","PR",4,"Sul",41008,"Floraí",36096,34013.8199171653,20,7,0,7,3,4,0,0,0,0,0,7,0,7,3,4,4,10.4345221891644,10.4939373348577,0.376211401019001,2020-05-18,2020,5
"5644","PR",4,"Sul",41008,"Floraí",36096,34013.8199171653,21,11,2,9,2,9,0,0,0,0,0,11,2,9,2,9,5,10.4345221891644,10.4939373348577,0.359158693484234,2020-05-25,2020,5
"5645","PR",4,"Sul",41009,"Maringá",640052,38564.4424929693,5,135,19,116,38,97,0,0,0,0,0,135,19,116,38,97,75,10.5600859519682,13.3693047020353,0.275890083892517,2020-02-03,2020,2
"5646","PR",4,"Sul",41009,"Maringá",640052,38564.4424929693,6,139,22,117,40,99,0,0,0,0,0,139,22,117,40,99,67,10.5600859519682,13.3693047020353,0.273866807013181,2020-02-10,2020,2
"5647","PR",4,"Sul",41009,"Maringá",640052,38564.4424929693,7,149,27,122,36,113,0,0,0,0,0,149,27,122,36,113,74,10.5600859519682,13.3693047020353,0.285353814662153,2020-02-17,2020,2
"5648","PR",4,"Sul",41009,"Maringá",640052,38564.4424929693,8,127,13,114,25,102,4,1,3,0,4,131,14,117,25,106,65,10.5600859519682,13.3693047020353,0.333640421344834,2020-02-24,2020,2
"5649","PR",4,"Sul",41009,"Maringá",640052,38564.4424929693,9,149,24,125,39,110,1,0,1,0,1,150,24,126,39,111,82,10.5600859519682,13.3693047020353,0.308565574207991,2020-03-02,2020,3
"5650","PR",4,"Sul",41009,"Maringá",640052,38564.4424929693,10,149,29,120,45,104,0,0,0,0,0,149,29,120,45,104,85,10.5600859519682,13.3693047020353,0.315816595747883,2020-03-09,2020,3
"5651","PR",4,"Sul",41009,"Maringá",640052,38564.4424929693,11,144,28,116,36,108,0,0,0,0,0,144,28,116,36,108,87,10.5600859519682,13.3693047020353,0.426948217246436,2020-03-16,2020,3
"5652","PR",4,"Sul",41009,"Maringá",640052,38564.4424929693,12,129,20,109,35,94,0,0,0,0,0,129,20,109,35,94,83,10.5600859519682,13.3693047020353,0.592383230309839,2020-03-23,2020,3
"5653","PR",4,"Sul",41009,"Maringá",640052,38564.4424929693,13,132,28,104,48,84,2,0,2,0,2,134,28,106,48,86,72,10.5600859519682,13.3693047020353,0.53148221210662,2020-03-30,2020,3
"5654","PR",4,"Sul",41009,"Maringá",640052,38564.4424929693,14,159,28,131,54,105,1,0,1,0,1,160,28,132,54,106,62,10.5600859519682,13.3693047020353,0.497139063110459,2020-04-06,2020,4
"5655","PR",4,"Sul",41009,"Maringá",640052,38564.4424929693,15,140,23,117,38,102,1,1,0,1,0,141,24,117,39,102,67,10.5600859519682,13.3693047020353,0.457897093839821,2020-04-13,2020,4
"5656","PR",4,"Sul",41009,"Maringá",640052,38564.4424929693,16,149,28,121,45,104,1,0,1,0,1,150,28,122,45,105,70,10.5600859519682,13.3693047020353,0.440243567590834,2020-04-20,2020,4
"5657","PR",4,"Sul",41009,"Maringá",640052,38564.4424929693,17,160,30,130,44,116,2,0,2,1,1,162,30,132,45,117,67,10.5600859519682,13.3693047020353,0.421296793526913,2020-04-27,2020,4
"5658","PR",4,"Sul",41009,"Maringá",640052,38564.4424929693,18,166,25,141,40,126,2,0,2,2,0,168,25,143,42,126,86,10.5600859519682,13.3693047020353,0.388678547376173,2020-05-04,2020,5
"5659","PR",4,"Sul",41009,"Maringá",640052,38564.4424929693,19,161,28,133,50,111,1,1,0,1,0,162,29,133,51,111,62,10.5600859519682,13.3693047020353,0.389107719282248,2020-05-11,2020,5
"5660","PR",4,"Sul",41009,"Maringá",640052,38564.4424929693,20,159,24,135,34,125,0,0,0,0,0,159,24,135,34,125,90,10.5600859519682,13.3693047020353,0.39539121040943,2020-05-18,2020,5
"5661","PR",4,"Sul",41009,"Maringá",640052,38564.4424929693,21,161,26,135,42,119,0,0,0,0,0,161,26,135,42,119,87,10.5600859519682,13.3693047020353,0.378381136949278,2020-05-25,2020,5
"5662","PR",4,"Sul",41010,"Apucarana",328142,30227.4997979229,5,80,14,66,22,58,0,0,0,0,0,80,14,66,22,58,35,10.3165073783632,12.7012017205098,0.290397743184188,2020-02-03,2020,2
"5663","PR",4,"Sul",41010,"Apucarana",328142,30227.4997979229,6,71,15,56,28,43,0,0,0,0,0,71,15,56,28,43,38,10.3165073783632,12.7012017205098,0.294657663832609,2020-02-10,2020,2
"5664","PR",4,"Sul",41010,"Apucarana",328142,30227.4997979229,7,60,10,50,23,37,1,1,0,0,1,61,11,50,23,38,36,10.3165073783632,12.7012017205098,0.295362014510507,2020-02-17,2020,2
"5665","PR",4,"Sul",41010,"Apucarana",328142,30227.4997979229,8,76,12,64,31,45,1,0,1,1,0,77,12,65,32,45,46,10.3165073783632,12.7012017205098,0.344471508638897,2020-02-24,2020,2
"5666","PR",4,"Sul",41010,"Apucarana",328142,30227.4997979229,9,75,11,64,25,50,0,0,0,0,0,75,11,64,25,50,44,10.3165073783632,12.7012017205098,0.309532810021964,2020-03-02,2020,3
"5667","PR",4,"Sul",41010,"Apucarana",328142,30227.4997979229,10,77,12,65,22,55,2,1,1,0,2,79,13,66,22,57,38,10.3165073783632,12.7012017205098,0.319539245859844,2020-03-09,2020,3
"5668","PR",4,"Sul",41010,"Apucarana",328142,30227.4997979229,11,66,11,55,23,43,1,0,1,1,0,67,11,56,24,43,43,10.3165073783632,12.7012017205098,0.390067980770059,2020-03-16,2020,3
"5669","PR",4,"Sul",41010,"Apucarana",328142,30227.4997979229,12,74,20,54,27,47,0,0,0,0,0,74,20,54,27,47,41,10.3165073783632,12.7012017205098,0.522879813665649,2020-03-23,2020,3
"5670","PR",4,"Sul",41010,"Apucarana",328142,30227.4997979229,13,61,18,43,21,40,0,0,0,0,0,61,18,43,21,40,52,10.3165073783632,12.7012017205098,0.47881783416577,2020-03-30,2020,3
"5671","PR",4,"Sul",41010,"Apucarana",328142,30227.4997979229,14,81,20,61,30,51,0,0,0,0,0,81,20,61,30,51,33,10.3165073783632,12.7012017205098,0.455224272697967,2020-04-06,2020,4
"5672","PR",4,"Sul",41010,"Apucarana",328142,30227.4997979229,15,74,17,57,24,50,0,0,0,0,0,74,17,57,24,50,39,10.3165073783632,12.7012017205098,0.422298571087831,2020-04-13,2020,4
"5673","PR",4,"Sul",41010,"Apucarana",328142,30227.4997979229,16,84,12,72,32,52,0,0,0,0,0,84,12,72,32,52,42,10.3165073783632,12.7012017205098,0.423762464588773,2020-04-20,2020,4
"5674","PR",4,"Sul",41010,"Apucarana",328142,30227.4997979229,17,80,24,56,26,54,0,0,0,0,0,80,24,56,26,54,36,10.3165073783632,12.7012017205098,0.408053761044098,2020-04-27,2020,4
"5675","PR",4,"Sul",41010,"Apucarana",328142,30227.4997979229,18,77,15,62,25,52,0,0,0,0,0,77,15,62,25,52,29,10.3165073783632,12.7012017205098,0.379884285020213,2020-05-04,2020,5
"5676","PR",4,"Sul",41010,"Apucarana",328142,30227.4997979229,19,58,21,37,16,42,0,0,0,0,0,58,21,37,16,42,49,10.3165073783632,12.7012017205098,0.3751684816066,2020-05-11,2020,5
"5677","PR",4,"Sul",41010,"Apucarana",328142,30227.4997979229,20,72,8,64,20,52,0,0,0,0,0,72,8,64,20,52,43,10.3165073783632,12.7012017205098,0.381606985572963,2020-05-18,2020,5
"5678","PR",4,"Sul",41010,"Apucarana",328142,30227.4997979229,21,76,19,57,18,58,1,0,1,0,1,77,19,58,18,59,36,10.3165073783632,12.7012017205098,0.365607411376589,2020-05-25,2020,5
"5679","PR",4,"Sul",41011,"Londrina",823534,36290.6486142892,5,182,26,156,48,134,1,0,1,0,1,183,26,157,48,135,96,10.4993153731333,13.6213601149364,0.27537579715081,2020-02-03,2020,2
"5680","PR",4,"Sul",41011,"Londrina",823534,36290.6486142892,6,171,39,132,62,109,1,0,1,0,1,172,39,133,62,110,121,10.4993153731333,13.6213601149364,0.273194868024731,2020-02-10,2020,2
"5681","PR",4,"Sul",41011,"Londrina",823534,36290.6486142892,7,147,29,118,48,99,2,0,2,0,2,149,29,120,48,101,94,10.4993153731333,13.6213601149364,0.284898464428896,2020-02-17,2020,2
"5682","PR",4,"Sul",41011,"Londrina",823534,36290.6486142892,8,158,26,132,49,109,2,0,2,0,2,160,26,134,49,111,129,10.4993153731333,13.6213601149364,0.339372535262535,2020-02-24,2020,2
"5683","PR",4,"Sul",41011,"Londrina",823534,36290.6486142892,9,154,24,130,46,108,2,0,2,0,2,156,24,132,46,110,102,10.4993153731333,13.6213601149364,0.306475230219007,2020-03-02,2020,3
"5684","PR",4,"Sul",41011,"Londrina",823534,36290.6486142892,10,135,35,100,50,85,2,2,0,1,1,137,37,100,51,86,118,10.4993153731333,13.6213601149364,0.316209811553481,2020-03-09,2020,3
"5685","PR",4,"Sul",41011,"Londrina",823534,36290.6486142892,11,167,31,136,58,109,1,0,1,1,0,168,31,137,59,109,108,10.4993153731333,13.6213601149364,0.405822758993102,2020-03-16,2020,3
"5686","PR",4,"Sul",41011,"Londrina",823534,36290.6486142892,12,183,29,154,65,118,1,0,1,1,0,184,29,155,66,118,101,10.4993153731333,13.6213601149364,0.547075827881469,2020-03-23,2020,3
"5687","PR",4,"Sul",41011,"Londrina",823534,36290.6486142892,13,165,36,129,51,114,2,1,1,0,2,167,37,130,51,116,98,10.4993153731333,13.6213601149364,0.50846852759637,2020-03-30,2020,3
"5688","PR",4,"Sul",41011,"Londrina",823534,36290.6486142892,14,164,26,138,57,107,0,0,0,0,0,164,26,138,57,107,104,10.4993153731333,13.6213601149364,0.486864037541727,2020-04-06,2020,4
"5689","PR",4,"Sul",41011,"Londrina",823534,36290.6486142892,15,177,35,142,58,119,0,0,0,0,0,177,35,142,58,119,98,10.4993153731333,13.6213601149364,0.456720711026948,2020-04-13,2020,4
"5690","PR",4,"Sul",41011,"Londrina",823534,36290.6486142892,16,184,34,150,53,131,2,0,2,1,1,186,34,152,54,132,94,10.4993153731333,13.6213601149364,0.43609916662503,2020-04-20,2020,4
"5691","PR",4,"Sul",41011,"Londrina",823534,36290.6486142892,17,183,42,141,59,124,3,2,1,1,2,186,44,142,60,126,117,10.4993153731333,13.6213601149364,0.422073362027647,2020-04-27,2020,4
"5692","PR",4,"Sul",41011,"Londrina",823534,36290.6486142892,18,191,35,156,69,122,1,0,1,0,1,192,35,157,69,123,120,10.4993153731333,13.6213601149364,0.388142802877867,2020-05-04,2020,5
"5693","PR",4,"Sul",41011,"Londrina",823534,36290.6486142892,19,191,39,152,60,131,0,0,0,0,0,191,39,152,60,131,100,10.4993153731333,13.6213601149364,0.388493326560667,2020-05-11,2020,5
"5694","PR",4,"Sul",41011,"Londrina",823534,36290.6486142892,20,171,38,133,58,113,2,1,1,0,2,173,39,134,58,115,102,10.4993153731333,13.6213601149364,0.392303377515147,2020-05-18,2020,5
"5695","PR",4,"Sul",41011,"Londrina",823534,36290.6486142892,21,178,40,138,45,133,1,0,1,0,1,179,40,139,45,134,99,10.4993153731333,13.6213601149364,0.3793570553361,2020-05-25,2020,5
"5696","PR",4,"Sul",41012,"Faxinal",45650,24378.789377218,5,7,3,4,3,4,0,0,0,0,0,7,3,4,3,4,5,10.1014687454126,10.7287588860231,0.291335433004759,2020-02-03,2020,2
"5697","PR",4,"Sul",41012,"Faxinal",45650,24378.789377218,6,7,4,3,3,4,0,0,0,0,0,7,4,3,3,4,7,10.1014687454126,10.7287588860231,0.294352545327965,2020-02-10,2020,2
"5698","PR",4,"Sul",41012,"Faxinal",45650,24378.789377218,7,5,1,4,2,3,0,0,0,0,0,5,1,4,2,3,9,10.1014687454126,10.7287588860231,0.300139744308427,2020-02-17,2020,2
"5699","PR",4,"Sul",41012,"Faxinal",45650,24378.789377218,8,7,2,5,4,3,0,0,0,0,0,7,2,5,4,3,5,10.1014687454126,10.7287588860231,0.331617352718831,2020-02-24,2020,2
"5700","PR",4,"Sul",41012,"Faxinal",45650,24378.789377218,9,8,0,8,3,5,0,0,0,0,0,8,0,8,3,5,11,10.1014687454126,10.7287588860231,0.298640648040205,2020-03-02,2020,3
"5701","PR",4,"Sul",41012,"Faxinal",45650,24378.789377218,10,10,0,10,3,7,0,0,0,0,0,10,0,10,3,7,7,10.1014687454126,10.7287588860231,0.305691114358964,2020-03-09,2020,3
"5702","PR",4,"Sul",41012,"Faxinal",45650,24378.789377218,11,14,7,7,2,12,0,0,0,0,0,14,7,7,2,12,7,10.1014687454126,10.7287588860231,0.393568971099527,2020-03-16,2020,3
"5703","PR",4,"Sul",41012,"Faxinal",45650,24378.789377218,12,7,2,5,6,1,0,0,0,0,0,7,2,5,6,1,9,10.1014687454126,10.7287588860231,0.488732362694204,2020-03-23,2020,3
"5704","PR",4,"Sul",41012,"Faxinal",45650,24378.789377218,13,13,1,12,5,8,0,0,0,0,0,13,1,12,5,8,8,10.1014687454126,10.7287588860231,0.421347295523343,2020-03-30,2020,3
"5705","PR",4,"Sul",41012,"Faxinal",45650,24378.789377218,14,8,1,7,4,4,0,0,0,0,0,8,1,7,4,4,8,10.1014687454126,10.7287588860231,0.404551964870744,2020-04-06,2020,4
"5706","PR",4,"Sul",41012,"Faxinal",45650,24378.789377218,15,14,2,12,7,7,0,0,0,0,0,14,2,12,7,7,6,10.1014687454126,10.7287588860231,0.397783599487954,2020-04-13,2020,4
"5707","PR",4,"Sul",41012,"Faxinal",45650,24378.789377218,16,15,5,10,6,9,0,0,0,0,0,15,5,10,6,9,8,10.1014687454126,10.7287588860231,0.417112895439149,2020-04-20,2020,4
"5708","PR",4,"Sul",41012,"Faxinal",45650,24378.789377218,17,8,1,7,5,3,0,0,0,0,0,8,1,7,5,3,6,10.1014687454126,10.7287588860231,0.388143899468341,2020-04-27,2020,4
"5709","PR",4,"Sul",41012,"Faxinal",45650,24378.789377218,18,13,4,9,3,10,0,0,0,0,0,13,4,9,3,10,6,10.1014687454126,10.7287588860231,0.365561608788441,2020-05-04,2020,5
"5710","PR",4,"Sul",41012,"Faxinal",45650,24378.789377218,19,3,2,1,2,1,0,0,0,0,0,3,2,1,2,1,14,10.1014687454126,10.7287588860231,0.367349743845343,2020-05-11,2020,5
"5711","PR",4,"Sul",41012,"Faxinal",45650,24378.789377218,20,14,4,10,6,8,0,0,0,0,0,14,4,10,6,8,6,10.1014687454126,10.7287588860231,0.37897052672277,2020-05-18,2020,5
"5712","PR",4,"Sul",41012,"Faxinal",45650,24378.789377218,21,8,1,7,3,5,0,0,0,0,0,8,1,7,3,5,8,10.1014687454126,10.7287588860231,0.370478551380323,2020-05-25,2020,5
"5713","PR",4,"Sul",41013,"Ivaiporã",128243,24419.8500194163,5,23,4,19,2,21,0,0,0,0,0,23,4,19,2,21,25,10.1031516059348,11.7616821806467,0.301109264915411,2020-02-03,2020,2
"5714","PR",4,"Sul",41013,"Ivaiporã",128243,24419.8500194163,6,17,2,15,7,10,0,0,0,0,0,17,2,15,7,10,20,10.1031516059348,11.7616821806467,0.29766306845866,2020-02-10,2020,2
"5715","PR",4,"Sul",41013,"Ivaiporã",128243,24419.8500194163,7,19,4,15,9,10,0,0,0,0,0,19,4,15,9,10,30,10.1031516059348,11.7616821806467,0.291409616316032,2020-02-17,2020,2
"5716","PR",4,"Sul",41013,"Ivaiporã",128243,24419.8500194163,8,25,7,18,5,20,0,0,0,0,0,25,7,18,5,20,22,10.1031516059348,11.7616821806467,0.325007049818364,2020-02-24,2020,2
"5717","PR",4,"Sul",41013,"Ivaiporã",128243,24419.8500194163,9,24,2,22,8,16,1,1,0,1,0,25,3,22,9,16,17,10.1031516059348,11.7616821806467,0.305885160005407,2020-03-02,2020,3
"5718","PR",4,"Sul",41013,"Ivaiporã",128243,24419.8500194163,10,28,8,20,9,19,0,0,0,0,0,28,8,20,9,19,27,10.1031516059348,11.7616821806467,0.318871630419044,2020-03-09,2020,3
"5719","PR",4,"Sul",41013,"Ivaiporã",128243,24419.8500194163,11,23,6,17,10,13,0,0,0,0,0,23,6,17,10,13,19,10.1031516059348,11.7616821806467,0.375622947369578,2020-03-16,2020,3
"5720","PR",4,"Sul",41013,"Ivaiporã",128243,24419.8500194163,12,28,11,17,8,20,0,0,0,0,0,28,11,17,8,20,31,10.1031516059348,11.7616821806467,0.511274101130824,2020-03-23,2020,3
"5721","PR",4,"Sul",41013,"Ivaiporã",128243,24419.8500194163,13,20,5,15,10,10,0,0,0,0,0,20,5,15,10,10,18,10.1031516059348,11.7616821806467,0.436824700787161,2020-03-30,2020,3
"5722","PR",4,"Sul",41013,"Ivaiporã",128243,24419.8500194163,14,25,5,20,7,18,0,0,0,0,0,25,5,20,7,18,30,10.1031516059348,11.7616821806467,0.431161135656017,2020-04-06,2020,4
"5723","PR",4,"Sul",41013,"Ivaiporã",128243,24419.8500194163,15,29,5,24,11,18,0,0,0,0,0,29,5,24,11,18,18,10.1031516059348,11.7616821806467,0.417313780979284,2020-04-13,2020,4
"5724","PR",4,"Sul",41013,"Ivaiporã",128243,24419.8500194163,16,35,10,25,13,22,1,0,1,0,1,36,10,26,13,23,18,10.1031516059348,11.7616821806467,0.426246768548962,2020-04-20,2020,4
"5725","PR",4,"Sul",41013,"Ivaiporã",128243,24419.8500194163,17,22,8,14,9,13,1,0,1,1,0,23,8,15,10,13,32,10.1031516059348,11.7616821806467,0.406205906836951,2020-04-27,2020,4
"5726","PR",4,"Sul",41013,"Ivaiporã",128243,24419.8500194163,18,35,6,29,13,22,0,0,0,0,0,35,6,29,13,22,25,10.1031516059348,11.7616821806467,0.382962478703761,2020-05-04,2020,5
"5727","PR",4,"Sul",41013,"Ivaiporã",128243,24419.8500194163,19,26,4,22,9,17,0,0,0,0,0,26,4,22,9,17,19,10.1031516059348,11.7616821806467,0.378331358991405,2020-05-11,2020,5
"5728","PR",4,"Sul",41013,"Ivaiporã",128243,24419.8500194163,20,38,12,26,18,20,0,0,0,0,0,38,12,26,18,20,22,10.1031516059348,11.7616821806467,0.388381923727827,2020-05-18,2020,5
"5729","PR",4,"Sul",41013,"Ivaiporã",128243,24419.8500194163,21,33,8,25,12,21,0,0,0,0,0,33,8,25,12,21,21,10.1031516059348,11.7616821806467,0.3699510608483,2020-05-25,2020,5
"5730","PR",4,"Sul",41014,"Assaí",70206,22752.5502194969,5,7,5,2,5,2,0,0,0,0,0,7,5,2,5,2,15,10.0324325156569,11.159189056447,0.310065613319148,2020-02-03,2020,2
"5731","PR",4,"Sul",41014,"Assaí",70206,22752.5502194969,6,17,3,14,8,9,0,0,0,0,0,17,3,14,8,9,9,10.0324325156569,11.159189056447,0.290768398119932,2020-02-10,2020,2
"5732","PR",4,"Sul",41014,"Assaí",70206,22752.5502194969,7,10,2,8,4,6,0,0,0,0,0,10,2,8,4,6,12,10.0324325156569,11.159189056447,0.316444732471901,2020-02-17,2020,2
"5733","PR",4,"Sul",41014,"Assaí",70206,22752.5502194969,8,12,3,9,2,10,0,0,0,0,0,12,3,9,2,10,9,10.0324325156569,11.159189056447,0.363319038793721,2020-02-24,2020,2
"5734","PR",4,"Sul",41014,"Assaí",70206,22752.5502194969,9,14,4,10,6,8,0,0,0,0,0,14,4,10,6,8,9,10.0324325156569,11.159189056447,0.332794353134213,2020-03-02,2020,3
"5735","PR",4,"Sul",41014,"Assaí",70206,22752.5502194969,10,11,1,10,7,4,0,0,0,0,0,11,1,10,7,4,11,10.0324325156569,11.159189056447,0.339946716890886,2020-03-09,2020,3
"5736","PR",4,"Sul",41014,"Assaí",70206,22752.5502194969,11,10,1,9,6,4,0,0,0,0,0,10,1,9,6,4,10,10.0324325156569,11.159189056447,0.407829051998994,2020-03-16,2020,3
"5737","PR",4,"Sul",41014,"Assaí",70206,22752.5502194969,12,11,0,11,6,5,0,0,0,0,0,11,0,11,6,5,10,10.0324325156569,11.159189056447,0.519742620518473,2020-03-23,2020,3
"5738","PR",4,"Sul",41014,"Assaí",70206,22752.5502194969,13,15,3,12,6,9,2,1,1,0,2,17,4,13,6,11,9,10.0324325156569,11.159189056447,0.460798324824859,2020-03-30,2020,3
"5739","PR",4,"Sul",41014,"Assaí",70206,22752.5502194969,14,16,4,12,9,7,0,0,0,0,0,16,4,12,9,7,5,10.0324325156569,11.159189056447,0.442841469234188,2020-04-06,2020,4
"5740","PR",4,"Sul",41014,"Assaí",70206,22752.5502194969,15,26,7,19,12,14,0,0,0,0,0,26,7,19,12,14,14,10.0324325156569,11.159189056447,0.424612351675166,2020-04-13,2020,4
"5741","PR",4,"Sul",41014,"Assaí",70206,22752.5502194969,16,11,2,9,6,5,0,0,0,0,0,11,2,9,6,5,9,10.0324325156569,11.159189056447,0.409036723502352,2020-04-20,2020,4
"5742","PR",4,"Sul",41014,"Assaí",70206,22752.5502194969,17,15,4,11,2,13,0,0,0,0,0,15,4,11,2,13,5,10.0324325156569,11.159189056447,0.420928668238347,2020-04-27,2020,4
"5743","PR",4,"Sul",41014,"Assaí",70206,22752.5502194969,18,9,3,6,5,4,0,0,0,0,0,9,3,6,5,4,10,10.0324325156569,11.159189056447,0.39894520321006,2020-05-04,2020,5
"5744","PR",4,"Sul",41014,"Assaí",70206,22752.5502194969,19,17,4,13,8,9,0,0,0,0,0,17,4,13,8,9,10,10.0324325156569,11.159189056447,0.39373030739353,2020-05-11,2020,5
"5745","PR",4,"Sul",41014,"Assaí",70206,22752.5502194969,20,14,1,13,6,8,0,0,0,0,0,14,1,13,6,8,12,10.0324325156569,11.159189056447,0.406347557072363,2020-05-18,2020,5
"5746","PR",4,"Sul",41014,"Assaí",70206,22752.5502194969,21,16,3,13,7,9,0,0,0,0,0,16,3,13,7,9,9,10.0324325156569,11.159189056447,0.385503234235891,2020-05-25,2020,5
"5747","PR",4,"Sul",41015,"Cornélio Procópio",172408,29322.5952760313,5,34,6,28,8,26,1,0,1,0,1,35,6,29,8,27,27,10.2861136676369,12.0576190398474,0.288925800203235,2020-02-03,2020,2
"5748","PR",4,"Sul",41015,"Cornélio Procópio",172408,29322.5952760313,6,19,1,18,8,11,0,0,0,0,0,19,1,18,8,11,18,10.2861136676369,12.0576190398474,0.287001974618336,2020-02-10,2020,2
"5749","PR",4,"Sul",41015,"Cornélio Procópio",172408,29322.5952760313,7,30,8,22,14,16,0,0,0,0,0,30,8,22,14,16,28,10.2861136676369,12.0576190398474,0.291412086870427,2020-02-17,2020,2
"5750","PR",4,"Sul",41015,"Cornélio Procópio",172408,29322.5952760313,8,32,7,25,8,24,0,0,0,0,0,32,7,25,8,24,21,10.2861136676369,12.0576190398474,0.339968959128281,2020-02-24,2020,2
"5751","PR",4,"Sul",41015,"Cornélio Procópio",172408,29322.5952760313,9,33,9,24,8,25,0,0,0,0,0,33,9,24,8,25,26,10.2861136676369,12.0576190398474,0.315766819588617,2020-03-02,2020,3
"5752","PR",4,"Sul",41015,"Cornélio Procópio",172408,29322.5952760313,10,39,8,31,14,25,0,0,0,0,0,39,8,31,14,25,30,10.2861136676369,12.0576190398474,0.325562530839537,2020-03-09,2020,3
"5753","PR",4,"Sul",41015,"Cornélio Procópio",172408,29322.5952760313,11,36,9,27,14,22,0,0,0,0,0,36,9,27,14,22,25,10.2861136676369,12.0576190398474,0.399442662837715,2020-03-16,2020,3
"5754","PR",4,"Sul",41015,"Cornélio Procópio",172408,29322.5952760313,12,30,4,26,10,20,1,0,1,1,0,31,4,27,11,20,40,10.2861136676369,12.0576190398474,0.511803301395074,2020-03-23,2020,3
"5755","PR",4,"Sul",41015,"Cornélio Procópio",172408,29322.5952760313,13,29,6,23,10,19,0,0,0,0,0,29,6,23,10,19,28,10.2861136676369,12.0576190398474,0.463291142732615,2020-03-30,2020,3
"5756","PR",4,"Sul",41015,"Cornélio Procópio",172408,29322.5952760313,14,37,11,26,17,20,0,0,0,0,0,37,11,26,17,20,29,10.2861136676369,12.0576190398474,0.454603081858214,2020-04-06,2020,4
"5757","PR",4,"Sul",41015,"Cornélio Procópio",172408,29322.5952760313,15,26,2,24,9,17,0,0,0,0,0,26,2,24,9,17,27,10.2861136676369,12.0576190398474,0.417629794950741,2020-04-13,2020,4
"5758","PR",4,"Sul",41015,"Cornélio Procópio",172408,29322.5952760313,16,37,7,30,12,25,0,0,0,0,0,37,7,30,12,25,27,10.2861136676369,12.0576190398474,0.422981960585517,2020-04-20,2020,4
"5759","PR",4,"Sul",41015,"Cornélio Procópio",172408,29322.5952760313,17,25,4,21,9,16,0,0,0,0,0,25,4,21,9,16,41,10.2861136676369,12.0576190398474,0.406292303966231,2020-04-27,2020,4
"5760","PR",4,"Sul",41015,"Cornélio Procópio",172408,29322.5952760313,18,25,3,22,8,17,0,0,0,0,0,25,3,22,8,17,25,10.2861136676369,12.0576190398474,0.393498532920001,2020-05-04,2020,5
"5761","PR",4,"Sul",41015,"Cornélio Procópio",172408,29322.5952760313,19,37,9,28,15,22,0,0,0,0,0,37,9,28,15,22,28,10.2861136676369,12.0576190398474,0.390166704762468,2020-05-11,2020,5
"5762","PR",4,"Sul",41015,"Cornélio Procópio",172408,29322.5952760313,20,46,7,39,19,27,0,0,0,0,0,46,7,39,19,27,22,10.2861136676369,12.0576190398474,0.412337550815603,2020-05-18,2020,5
"5763","PR",4,"Sul",41015,"Cornélio Procópio",172408,29322.5952760313,21,38,5,33,15,23,0,0,0,0,0,38,5,33,15,23,33,10.2861136676369,12.0576190398474,0.388619910388998,2020-05-25,2020,5
"5764","PR",4,"Sul",41016,"Jacarezinho",127734,30833.9036653514,5,33,8,25,13,20,0,0,0,0,0,33,8,25,13,20,12,10.336370131916,11.7577052556038,0.30539170658442,2020-02-03,2020,2
"5765","PR",4,"Sul",41016,"Jacarezinho",127734,30833.9036653514,6,26,10,16,12,14,0,0,0,0,0,26,10,16,12,14,25,10.336370131916,11.7577052556038,0.296725189024842,2020-02-10,2020,2
"5766","PR",4,"Sul",41016,"Jacarezinho",127734,30833.9036653514,7,29,7,22,10,19,1,0,1,0,1,30,7,23,10,20,22,10.336370131916,11.7577052556038,0.31282579867678,2020-02-17,2020,2
"5767","PR",4,"Sul",41016,"Jacarezinho",127734,30833.9036653514,8,28,7,21,13,15,0,0,0,0,0,28,7,21,13,15,18,10.336370131916,11.7577052556038,0.362098772147652,2020-02-24,2020,2
"5768","PR",4,"Sul",41016,"Jacarezinho",127734,30833.9036653514,9,30,3,27,8,22,0,0,0,0,0,30,3,27,8,22,16,10.336370131916,11.7577052556038,0.325696423327103,2020-03-02,2020,3
"5769","PR",4,"Sul",41016,"Jacarezinho",127734,30833.9036653514,10,25,5,20,8,17,1,1,0,0,1,26,6,20,8,18,17,10.336370131916,11.7577052556038,0.335078243636636,2020-03-09,2020,3
"5770","PR",4,"Sul",41016,"Jacarezinho",127734,30833.9036653514,11,33,4,29,9,24,0,0,0,0,0,33,4,29,9,24,16,10.336370131916,11.7577052556038,0.413383667156379,2020-03-16,2020,3
"5771","PR",4,"Sul",41016,"Jacarezinho",127734,30833.9036653514,12,28,9,19,13,15,0,0,0,0,0,28,9,19,13,15,22,10.336370131916,11.7577052556038,0.513649319271419,2020-03-23,2020,3
"5772","PR",4,"Sul",41016,"Jacarezinho",127734,30833.9036653514,13,29,10,19,10,19,0,0,0,0,0,29,10,19,10,19,24,10.336370131916,11.7577052556038,0.477328679515966,2020-03-30,2020,3
"5773","PR",4,"Sul",41016,"Jacarezinho",127734,30833.9036653514,14,22,3,19,7,15,1,0,1,1,0,23,3,20,8,15,21,10.336370131916,11.7577052556038,0.454519734712733,2020-04-06,2020,4
"5774","PR",4,"Sul",41016,"Jacarezinho",127734,30833.9036653514,15,27,10,17,6,21,0,0,0,0,0,27,10,17,6,21,16,10.336370131916,11.7577052556038,0.439778738671843,2020-04-13,2020,4
"5775","PR",4,"Sul",41016,"Jacarezinho",127734,30833.9036653514,16,37,12,25,15,22,0,0,0,0,0,37,12,25,15,22,25,10.336370131916,11.7577052556038,0.444025741182342,2020-04-20,2020,4
"5776","PR",4,"Sul",41016,"Jacarezinho",127734,30833.9036653514,17,33,6,27,16,17,0,0,0,0,0,33,6,27,16,17,31,10.336370131916,11.7577052556038,0.425111992541629,2020-04-27,2020,4
"5777","PR",4,"Sul",41016,"Jacarezinho",127734,30833.9036653514,18,42,9,33,10,32,0,0,0,0,0,42,9,33,10,32,15,10.336370131916,11.7577052556038,0.397848841045154,2020-05-04,2020,5
"5778","PR",4,"Sul",41016,"Jacarezinho",127734,30833.9036653514,19,41,15,26,23,18,0,0,0,0,0,41,15,26,23,18,18,10.336370131916,11.7577052556038,0.406066506033949,2020-05-11,2020,5
"5779","PR",4,"Sul",41016,"Jacarezinho",127734,30833.9036653514,20,36,10,26,20,16,0,0,0,0,0,36,10,26,20,16,18,10.336370131916,11.7577052556038,0.413435404974196,2020-05-18,2020,5
"5780","PR",4,"Sul",41016,"Jacarezinho",127734,30833.9036653514,21,33,10,23,14,19,0,0,0,0,0,33,10,23,14,19,26,10.336370131916,11.7577052556038,0.406477407397667,2020-05-25,2020,5
"5781","PR",4,"Sul",41017,"Ibaiti",81691,20092.3197194305,5,22,6,16,9,13,0,0,0,0,0,22,6,16,9,13,12,9.9080929175161,11.3106991156614,0.279582414857279,2020-02-03,2020,2
"5782","PR",4,"Sul",41017,"Ibaiti",81691,20092.3197194305,6,15,7,8,5,10,1,0,1,1,0,16,7,9,6,10,11,9.9080929175161,11.3106991156614,0.279071856497371,2020-02-10,2020,2
"5783","PR",4,"Sul",41017,"Ibaiti",81691,20092.3197194305,7,8,3,5,3,5,0,0,0,0,0,8,3,5,3,5,9,9.9080929175161,11.3106991156614,0.297817769894495,2020-02-17,2020,2
"5784","PR",4,"Sul",41017,"Ibaiti",81691,20092.3197194305,8,13,5,8,4,9,0,0,0,0,0,13,5,8,4,9,13,9.9080929175161,11.3106991156614,0.337729521087528,2020-02-24,2020,2
"5785","PR",4,"Sul",41017,"Ibaiti",81691,20092.3197194305,9,17,3,14,13,4,0,0,0,0,0,17,3,14,13,4,9,9.9080929175161,11.3106991156614,0.305358620453773,2020-03-02,2020,3
"5786","PR",4,"Sul",41017,"Ibaiti",81691,20092.3197194305,10,17,7,10,8,9,0,0,0,0,0,17,7,10,8,9,12,9.9080929175161,11.3106991156614,0.314927281118108,2020-03-09,2020,3
"5787","PR",4,"Sul",41017,"Ibaiti",81691,20092.3197194305,11,13,3,10,5,8,0,0,0,0,0,13,3,10,5,8,15,9.9080929175161,11.3106991156614,0.393055223634081,2020-03-16,2020,3
"5788","PR",4,"Sul",41017,"Ibaiti",81691,20092.3197194305,12,18,7,11,9,9,0,0,0,0,0,18,7,11,9,9,10,9.9080929175161,11.3106991156614,0.485720560042831,2020-03-23,2020,3
"5789","PR",4,"Sul",41017,"Ibaiti",81691,20092.3197194305,13,12,4,8,5,7,0,0,0,0,0,12,4,8,5,7,10,9.9080929175161,11.3106991156614,0.449890043789622,2020-03-30,2020,3
"5790","PR",4,"Sul",41017,"Ibaiti",81691,20092.3197194305,14,14,7,7,10,4,0,0,0,0,0,14,7,7,10,4,15,9.9080929175161,11.3106991156614,0.403934647689803,2020-04-06,2020,4
"5791","PR",4,"Sul",41017,"Ibaiti",81691,20092.3197194305,15,28,4,24,15,13,0,0,0,0,0,28,4,24,15,13,10,9.9080929175161,11.3106991156614,0.392010410964815,2020-04-13,2020,4
"5792","PR",4,"Sul",41017,"Ibaiti",81691,20092.3197194305,16,21,3,18,10,11,0,0,0,0,0,21,3,18,10,11,15,9.9080929175161,11.3106991156614,0.385725215448829,2020-04-20,2020,4
"5793","PR",4,"Sul",41017,"Ibaiti",81691,20092.3197194305,17,19,4,15,5,14,0,0,0,0,0,19,4,15,5,14,13,9.9080929175161,11.3106991156614,0.404261146261544,2020-04-27,2020,4
"5794","PR",4,"Sul",41017,"Ibaiti",81691,20092.3197194305,18,22,7,15,8,14,0,0,0,0,0,22,7,15,8,14,11,9.9080929175161,11.3106991156614,0.359707749825945,2020-05-04,2020,5
"5795","PR",4,"Sul",41017,"Ibaiti",81691,20092.3197194305,19,14,7,7,7,7,0,0,0,0,0,14,7,7,7,7,14,9.9080929175161,11.3106991156614,0.377037680399185,2020-05-11,2020,5
"5796","PR",4,"Sul",41017,"Ibaiti",81691,20092.3197194305,20,21,2,19,10,11,0,0,0,0,0,21,2,19,10,11,15,9.9080929175161,11.3106991156614,0.386544177825643,2020-05-18,2020,5
"5797","PR",4,"Sul",41017,"Ibaiti",81691,20092.3197194305,21,23,8,15,8,15,1,1,0,0,1,24,9,15,8,16,22,9.9080929175161,11.3106991156614,0.376185548799417,2020-05-25,2020,5
"5798","PR",4,"Sul",41018,"Wenceslau Braz",102080,27936.2974078174,5,23,4,19,9,14,0,0,0,0,0,23,4,19,9,14,17,10.2376821046242,11.5335120985786,0.308280206330287,2020-02-03,2020,2
"5799","PR",4,"Sul",41018,"Wenceslau Braz",102080,27936.2974078174,6,22,9,13,6,16,0,0,0,0,0,22,9,13,6,16,18,10.2376821046242,11.5335120985786,0.305400124828769,2020-02-10,2020,2
"5800","PR",4,"Sul",41018,"Wenceslau Braz",102080,27936.2974078174,7,14,2,12,7,7,0,0,0,0,0,14,2,12,7,7,17,10.2376821046242,11.5335120985786,0.320819694383182,2020-02-17,2020,2
"5801","PR",4,"Sul",41018,"Wenceslau Braz",102080,27936.2974078174,8,26,10,16,4,22,0,0,0,0,0,26,10,16,4,22,27,10.2376821046242,11.5335120985786,0.356192316139248,2020-02-24,2020,2
"5802","PR",4,"Sul",41018,"Wenceslau Braz",102080,27936.2974078174,9,24,12,12,11,13,0,0,0,0,0,24,12,12,11,13,19,10.2376821046242,11.5335120985786,0.339351186733822,2020-03-02,2020,3
"5803","PR",4,"Sul",41018,"Wenceslau Braz",102080,27936.2974078174,10,13,1,12,4,9,0,0,0,0,0,13,1,12,4,9,14,10.2376821046242,11.5335120985786,0.352308656544846,2020-03-09,2020,3
"5804","PR",4,"Sul",41018,"Wenceslau Braz",102080,27936.2974078174,11,23,5,18,14,9,0,0,0,0,0,23,5,18,14,9,18,10.2376821046242,11.5335120985786,0.412811396809135,2020-03-16,2020,3
"5805","PR",4,"Sul",41018,"Wenceslau Braz",102080,27936.2974078174,12,23,5,18,7,16,0,0,0,0,0,23,5,18,7,16,17,10.2376821046242,11.5335120985786,0.510272213463442,2020-03-23,2020,3
"5806","PR",4,"Sul",41018,"Wenceslau Braz",102080,27936.2974078174,13,15,1,14,4,11,0,0,0,0,0,15,1,14,4,11,14,10.2376821046242,11.5335120985786,0.478632367396203,2020-03-30,2020,3
"5807","PR",4,"Sul",41018,"Wenceslau Braz",102080,27936.2974078174,14,26,10,16,11,15,0,0,0,0,0,26,10,16,11,15,19,10.2376821046242,11.5335120985786,0.439184604881694,2020-04-06,2020,4
"5808","PR",4,"Sul",41018,"Wenceslau Braz",102080,27936.2974078174,15,30,7,23,10,20,0,0,0,0,0,30,7,23,10,20,17,10.2376821046242,11.5335120985786,0.412427875348722,2020-04-13,2020,4
"5809","PR",4,"Sul",41018,"Wenceslau Braz",102080,27936.2974078174,16,23,3,20,10,13,0,0,0,0,0,23,3,20,10,13,18,10.2376821046242,11.5335120985786,0.425195207850547,2020-04-20,2020,4
"5810","PR",4,"Sul",41018,"Wenceslau Braz",102080,27936.2974078174,17,35,7,28,11,24,1,1,0,0,1,36,8,28,11,25,15,10.2376821046242,11.5335120985786,0.418165573909205,2020-04-27,2020,4
"5811","PR",4,"Sul",41018,"Wenceslau Braz",102080,27936.2974078174,18,22,3,19,7,15,0,0,0,0,0,22,3,19,7,15,14,10.2376821046242,11.5335120985786,0.39337630323762,2020-05-04,2020,5
"5812","PR",4,"Sul",41018,"Wenceslau Braz",102080,27936.2974078174,19,29,9,20,10,19,1,0,1,0,1,30,9,21,10,20,14,10.2376821046242,11.5335120985786,0.398151213640119,2020-05-11,2020,5
"5813","PR",4,"Sul",41018,"Wenceslau Braz",102080,27936.2974078174,20,28,9,19,7,21,0,0,0,0,0,28,9,19,7,21,19,10.2376821046242,11.5335120985786,0.408564724057214,2020-05-18,2020,5
"5814","PR",4,"Sul",41018,"Wenceslau Braz",102080,27936.2974078174,21,28,6,22,13,15,0,0,0,0,0,28,6,22,13,15,19,10.2376821046242,11.5335120985786,0.38302680164487,2020-05-25,2020,5
"5815","PR",4,"Sul",41019,"Telêmaco Borba",174554,43765.027641704,5,49,11,38,21,28,0,0,0,0,0,49,11,38,21,28,27,10.6865903217602,12.0699894283405,0.299986539160741,2020-02-03,2020,2
"5816","PR",4,"Sul",41019,"Telêmaco Borba",174554,43765.027641704,6,42,15,27,24,18,0,0,0,0,0,42,15,27,24,18,19,10.6865903217602,12.0699894283405,0.300141754102122,2020-02-10,2020,2
"5817","PR",4,"Sul",41019,"Telêmaco Borba",174554,43765.027641704,7,42,11,31,16,26,0,0,0,0,0,42,11,31,16,26,26,10.6865903217602,12.0699894283405,0.298587246861203,2020-02-17,2020,2
"5818","PR",4,"Sul",41019,"Telêmaco Borba",174554,43765.027641704,8,30,11,19,14,16,0,0,0,0,0,30,11,19,14,16,22,10.6865903217602,12.0699894283405,0.344219678512046,2020-02-24,2020,2
"5819","PR",4,"Sul",41019,"Telêmaco Borba",174554,43765.027641704,9,53,20,33,26,27,0,0,0,0,0,53,20,33,26,27,24,10.6865903217602,12.0699894283405,0.328883703363817,2020-03-02,2020,3
"5820","PR",4,"Sul",41019,"Telêmaco Borba",174554,43765.027641704,10,49,16,33,24,25,0,0,0,0,0,49,16,33,24,25,22,10.6865903217602,12.0699894283405,0.32787713355552,2020-03-09,2020,3
"5821","PR",4,"Sul",41019,"Telêmaco Borba",174554,43765.027641704,11,42,18,24,17,25,1,1,0,0,1,43,19,24,17,26,14,10.6865903217602,12.0699894283405,0.400748727788386,2020-03-16,2020,3
"5822","PR",4,"Sul",41019,"Telêmaco Borba",174554,43765.027641704,12,37,10,27,14,23,0,0,0,0,0,37,10,27,14,23,20,10.6865903217602,12.0699894283405,0.51741987913173,2020-03-23,2020,3
"5823","PR",4,"Sul",41019,"Telêmaco Borba",174554,43765.027641704,13,40,11,29,21,19,0,0,0,0,0,40,11,29,21,19,21,10.6865903217602,12.0699894283405,0.475876026134971,2020-03-30,2020,3
"5824","PR",4,"Sul",41019,"Telêmaco Borba",174554,43765.027641704,14,39,16,23,15,24,1,0,1,0,1,40,16,24,15,25,22,10.6865903217602,12.0699894283405,0.459676689099214,2020-04-06,2020,4
"5825","PR",4,"Sul",41019,"Telêmaco Borba",174554,43765.027641704,15,53,20,33,23,30,1,1,0,0,1,54,21,33,23,31,18,10.6865903217602,12.0699894283405,0.434913781984284,2020-04-13,2020,4
"5826","PR",4,"Sul",41019,"Telêmaco Borba",174554,43765.027641704,16,43,11,32,18,25,0,0,0,0,0,43,11,32,18,25,23,10.6865903217602,12.0699894283405,0.431699290300965,2020-04-20,2020,4
"5827","PR",4,"Sul",41019,"Telêmaco Borba",174554,43765.027641704,17,48,15,33,26,22,0,0,0,0,0,48,15,33,26,22,26,10.6865903217602,12.0699894283405,0.428059370301545,2020-04-27,2020,4
"5828","PR",4,"Sul",41019,"Telêmaco Borba",174554,43765.027641704,18,52,13,39,21,31,1,1,0,1,0,53,14,39,22,31,25,10.6865903217602,12.0699894283405,0.401306858105811,2020-05-04,2020,5
"5829","PR",4,"Sul",41019,"Telêmaco Borba",174554,43765.027641704,19,52,15,37,25,27,0,0,0,0,0,52,15,37,25,27,26,10.6865903217602,12.0699894283405,0.407731716688474,2020-05-11,2020,5
"5830","PR",4,"Sul",41019,"Telêmaco Borba",174554,43765.027641704,20,41,11,30,20,21,1,1,0,1,0,42,12,30,21,21,20,10.6865903217602,12.0699894283405,0.407488411666207,2020-05-18,2020,5
"5831","PR",4,"Sul",41019,"Telêmaco Borba",174554,43765.027641704,21,41,14,27,13,28,0,0,0,0,0,41,14,27,13,28,22,10.6865903217602,12.0699894283405,0.393346661800644,2020-05-25,2020,5
"5832","PR",4,"Sul",41020,"Jaguariaíva",108329,36245.7292267075,5,23,9,14,10,13,1,0,1,1,0,24,9,15,11,13,15,10.4980768389065,11.5929281718437,0.332000663460613,2020-02-03,2020,2
"5833","PR",4,"Sul",41020,"Jaguariaíva",108329,36245.7292267075,6,32,7,25,12,20,0,0,0,0,0,32,7,25,12,20,11,10.4980768389065,11.5929281718437,0.325244533799469,2020-02-10,2020,2
"5834","PR",4,"Sul",41020,"Jaguariaíva",108329,36245.7292267075,7,27,12,15,8,19,0,0,0,0,0,27,12,15,8,19,11,10.4980768389065,11.5929281718437,0.33286995901423,2020-02-17,2020,2
"5835","PR",4,"Sul",41020,"Jaguariaíva",108329,36245.7292267075,8,25,7,18,12,13,0,0,0,0,0,25,7,18,12,13,17,10.4980768389065,11.5929281718437,0.38362006580004,2020-02-24,2020,2
"5836","PR",4,"Sul",41020,"Jaguariaíva",108329,36245.7292267075,9,30,6,24,17,13,0,0,0,0,0,30,6,24,17,13,9,10.4980768389065,11.5929281718437,0.353406587253244,2020-03-02,2020,3
"5837","PR",4,"Sul",41020,"Jaguariaíva",108329,36245.7292267075,10,21,4,17,11,10,0,0,0,0,0,21,4,17,11,10,19,10.4980768389065,11.5929281718437,0.370516808577525,2020-03-09,2020,3
"5838","PR",4,"Sul",41020,"Jaguariaíva",108329,36245.7292267075,11,25,8,17,14,11,0,0,0,0,0,25,8,17,14,11,10,10.4980768389065,11.5929281718437,0.436075909005734,2020-03-16,2020,3
"5839","PR",4,"Sul",41020,"Jaguariaíva",108329,36245.7292267075,12,16,3,13,4,12,0,0,0,0,0,16,3,13,4,12,15,10.4980768389065,11.5929281718437,0.52689099444185,2020-03-23,2020,3
"5840","PR",4,"Sul",41020,"Jaguariaíva",108329,36245.7292267075,13,30,9,21,16,14,1,0,1,1,0,31,9,22,17,14,11,10.4980768389065,11.5929281718437,0.480358211168281,2020-03-30,2020,3
"5841","PR",4,"Sul",41020,"Jaguariaíva",108329,36245.7292267075,14,27,5,22,14,13,0,0,0,0,0,27,5,22,14,13,12,10.4980768389065,11.5929281718437,0.45898936470536,2020-04-06,2020,4
"5842","PR",4,"Sul",41020,"Jaguariaíva",108329,36245.7292267075,15,29,9,20,13,16,0,0,0,0,0,29,9,20,13,16,9,10.4980768389065,11.5929281718437,0.438135506593368,2020-04-13,2020,4
"5843","PR",4,"Sul",41020,"Jaguariaíva",108329,36245.7292267075,16,31,9,22,15,16,0,0,0,0,0,31,9,22,15,16,13,10.4980768389065,11.5929281718437,0.445196611964174,2020-04-20,2020,4
"5844","PR",4,"Sul",41020,"Jaguariaíva",108329,36245.7292267075,17,27,8,19,14,13,0,0,0,0,0,27,8,19,14,13,11,10.4980768389065,11.5929281718437,0.441414806799058,2020-04-27,2020,4
"5845","PR",4,"Sul",41020,"Jaguariaíva",108329,36245.7292267075,18,25,8,17,13,12,1,0,1,1,0,26,8,18,14,12,10,10.4980768389065,11.5929281718437,0.428044781878428,2020-05-04,2020,5
"5846","PR",4,"Sul",41020,"Jaguariaíva",108329,36245.7292267075,19,27,13,14,14,13,1,0,1,0,1,28,13,15,14,14,19,10.4980768389065,11.5929281718437,0.434244203807988,2020-05-11,2020,5
"5847","PR",4,"Sul",41020,"Jaguariaíva",108329,36245.7292267075,20,34,11,23,15,19,0,0,0,0,0,34,11,23,15,19,14,10.4980768389065,11.5929281718437,0.437512627308465,2020-05-18,2020,5
"5848","PR",4,"Sul",41020,"Jaguariaíva",108329,36245.7292267075,21,28,7,21,12,16,0,0,0,0,0,28,7,21,12,16,16,10.4980768389065,11.5929281718437,0.425742383914206,2020-05-25,2020,5
"5849","PR",4,"Sul",41021,"Ponta Grossa",484964,43320.5401561972,5,112,37,75,42,70,1,0,1,0,1,113,37,76,42,71,50,10.6763821700168,13.0918299403606,0.287794213545797,2020-02-03,2020,2
"5850","PR",4,"Sul",41021,"Ponta Grossa",484964,43320.5401561972,6,122,28,94,49,73,2,2,0,0,2,124,30,94,49,75,53,10.6763821700168,13.0918299403606,0.283715161922389,2020-02-10,2020,2
"5851","PR",4,"Sul",41021,"Ponta Grossa",484964,43320.5401561972,7,132,34,98,51,81,2,1,1,2,0,134,35,99,53,81,61,10.6763821700168,13.0918299403606,0.297262001473815,2020-02-17,2020,2
"5852","PR",4,"Sul",41021,"Ponta Grossa",484964,43320.5401561972,8,120,27,93,54,66,0,0,0,0,0,120,27,93,54,66,40,10.6763821700168,13.0918299403606,0.343937698757503,2020-02-24,2020,2
"5853","PR",4,"Sul",41021,"Ponta Grossa",484964,43320.5401561972,9,125,33,92,50,75,0,0,0,0,0,125,33,92,50,75,49,10.6763821700168,13.0918299403606,0.316388284606852,2020-03-02,2020,3
"5854","PR",4,"Sul",41021,"Ponta Grossa",484964,43320.5401561972,10,114,24,90,43,71,2,0,2,1,1,116,24,92,44,72,62,10.6763821700168,13.0918299403606,0.328535817785144,2020-03-09,2020,3
"5855","PR",4,"Sul",41021,"Ponta Grossa",484964,43320.5401561972,11,131,41,90,54,77,0,0,0,0,0,131,41,90,54,77,54,10.6763821700168,13.0918299403606,0.409347204940106,2020-03-16,2020,3
"5856","PR",4,"Sul",41021,"Ponta Grossa",484964,43320.5401561972,12,102,25,77,43,59,1,0,1,1,0,103,25,78,44,59,59,10.6763821700168,13.0918299403606,0.528112520728565,2020-03-23,2020,3
"5857","PR",4,"Sul",41021,"Ponta Grossa",484964,43320.5401561972,13,135,42,93,49,86,1,0,1,0,1,136,42,94,49,87,57,10.6763821700168,13.0918299403606,0.477527756104273,2020-03-30,2020,3
"5858","PR",4,"Sul",41021,"Ponta Grossa",484964,43320.5401561972,14,115,14,101,49,66,1,1,0,0,1,116,15,101,49,67,51,10.6763821700168,13.0918299403606,0.4570102672648,2020-04-06,2020,4
"5859","PR",4,"Sul",41021,"Ponta Grossa",484964,43320.5401561972,15,133,30,103,54,79,1,0,1,0,1,134,30,104,54,80,47,10.6763821700168,13.0918299403606,0.428591838393775,2020-04-13,2020,4
"5860","PR",4,"Sul",41021,"Ponta Grossa",484964,43320.5401561972,16,153,32,121,62,91,1,1,0,1,0,154,33,121,63,91,59,10.6763821700168,13.0918299403606,0.431952622825818,2020-04-20,2020,4
"5861","PR",4,"Sul",41021,"Ponta Grossa",484964,43320.5401561972,17,124,25,99,49,75,1,1,0,1,0,125,26,99,50,75,44,10.6763821700168,13.0918299403606,0.425568166268228,2020-04-27,2020,4
"5862","PR",4,"Sul",41021,"Ponta Grossa",484964,43320.5401561972,18,120,29,91,41,79,2,1,1,1,1,122,30,92,42,80,62,10.6763821700168,13.0918299403606,0.396008496900103,2020-05-04,2020,5
"5863","PR",4,"Sul",41021,"Ponta Grossa",484964,43320.5401561972,19,144,38,106,41,103,2,0,2,1,1,146,38,108,42,104,50,10.6763821700168,13.0918299403606,0.397921665778789,2020-05-11,2020,5
"5864","PR",4,"Sul",41021,"Ponta Grossa",484964,43320.5401561972,20,151,32,119,63,88,2,0,2,1,1,153,32,121,64,89,49,10.6763821700168,13.0918299403606,0.398119982682699,2020-05-18,2020,5
"5865","PR",4,"Sul",41021,"Ponta Grossa",484964,43320.5401561972,21,161,33,128,56,105,1,0,1,0,1,162,33,129,56,106,64,10.6763821700168,13.0918299403606,0.384166521972437,2020-05-25,2020,5
"5866","PR",4,"Sul",41022,"Toledo",418813,42490.3466496503,5,87,25,62,33,54,1,0,1,1,0,88,25,63,34,54,55,10.6570321914576,12.9451797985665,0.307777116027737,2020-02-03,2020,2
"5867","PR",4,"Sul",41022,"Toledo",418813,42490.3466496503,6,109,23,86,31,78,0,0,0,0,0,109,23,86,31,78,63,10.6570321914576,12.9451797985665,0.306235219187807,2020-02-10,2020,2
"5868","PR",4,"Sul",41022,"Toledo",418813,42490.3466496503,7,105,22,83,41,64,0,0,0,0,0,105,22,83,41,64,49,10.6570321914576,12.9451797985665,0.317751317593482,2020-02-17,2020,2
"5869","PR",4,"Sul",41022,"Toledo",418813,42490.3466496503,8,102,25,77,36,66,0,0,0,0,0,102,25,77,36,66,64,10.6570321914576,12.9451797985665,0.35779113824464,2020-02-24,2020,2
"5870","PR",4,"Sul",41022,"Toledo",418813,42490.3466496503,9,98,21,77,39,59,3,1,2,2,1,101,22,79,41,60,58,10.6570321914576,12.9451797985665,0.339200947556969,2020-03-02,2020,3
"5871","PR",4,"Sul",41022,"Toledo",418813,42490.3466496503,10,93,24,69,27,66,2,0,2,2,0,95,24,71,29,66,62,10.6570321914576,12.9451797985665,0.34299554207057,2020-03-09,2020,3
"5872","PR",4,"Sul",41022,"Toledo",418813,42490.3466496503,11,99,24,75,38,61,1,0,1,0,1,100,24,76,38,62,64,10.6570321914576,12.9451797985665,0.422519099692287,2020-03-16,2020,3
"5873","PR",4,"Sul",41022,"Toledo",418813,42490.3466496503,12,86,17,69,26,60,1,0,1,0,1,87,17,70,26,61,59,10.6570321914576,12.9451797985665,0.541020342470516,2020-03-23,2020,3
"5874","PR",4,"Sul",41022,"Toledo",418813,42490.3466496503,13,102,19,83,30,72,1,0,1,1,0,103,19,84,31,72,52,10.6570321914576,12.9451797985665,0.473993446030275,2020-03-30,2020,3
"5875","PR",4,"Sul",41022,"Toledo",418813,42490.3466496503,14,112,28,84,36,76,0,0,0,0,0,112,28,84,36,76,57,10.6570321914576,12.9451797985665,0.453385959735544,2020-04-06,2020,4
"5876","PR",4,"Sul",41022,"Toledo",418813,42490.3466496503,15,104,33,71,28,76,0,0,0,0,0,104,33,71,28,76,48,10.6570321914576,12.9451797985665,0.425238080185878,2020-04-13,2020,4
"5877","PR",4,"Sul",41022,"Toledo",418813,42490.3466496503,16,131,21,110,42,89,1,1,0,0,1,132,22,110,42,90,50,10.6570321914576,12.9451797985665,0.434925104034274,2020-04-20,2020,4
"5878","PR",4,"Sul",41022,"Toledo",418813,42490.3466496503,17,101,20,81,28,73,2,1,1,0,2,103,21,82,28,75,60,10.6570321914576,12.9451797985665,0.422711482499992,2020-04-27,2020,4
"5879","PR",4,"Sul",41022,"Toledo",418813,42490.3466496503,18,116,21,95,34,82,0,0,0,0,0,116,21,95,34,82,54,10.6570321914576,12.9451797985665,0.395989033018841,2020-05-04,2020,5
"5880","PR",4,"Sul",41022,"Toledo",418813,42490.3466496503,19,125,21,104,42,83,1,0,1,0,1,126,21,105,42,84,35,10.6570321914576,12.9451797985665,0.400186431204635,2020-05-11,2020,5
"5881","PR",4,"Sul",41022,"Toledo",418813,42490.3466496503,20,110,26,84,36,74,0,0,0,0,0,110,26,84,36,74,55,10.6570321914576,12.9451797985665,0.411476200583534,2020-05-18,2020,5
"5882","PR",4,"Sul",41022,"Toledo",418813,42490.3466496503,21,108,33,75,38,70,0,0,0,0,0,108,33,75,38,70,81,10.6570321914576,12.9451797985665,0.396669844413496,2020-05-25,2020,5
"5883","PR",4,"Sul",41023,"Cascavel",478462,39216.3115320966,5,112,26,86,41,71,1,0,1,1,0,113,26,87,42,71,54,10.5768480497413,13.0783320718836,0.285768150628463,2020-02-03,2020,2
"5884","PR",4,"Sul",41023,"Cascavel",478462,39216.3115320966,6,132,24,108,49,83,2,2,0,0,2,134,26,108,49,85,62,10.5768480497413,13.0783320718836,0.284581709621575,2020-02-10,2020,2
"5885","PR",4,"Sul",41023,"Cascavel",478462,39216.3115320966,7,119,20,99,35,84,2,0,2,1,1,121,20,101,36,85,37,10.5768480497413,13.0783320718836,0.297641280917606,2020-02-17,2020,2
"5886","PR",4,"Sul",41023,"Cascavel",478462,39216.3115320966,8,148,22,126,56,92,0,0,0,0,0,148,22,126,56,92,42,10.5768480497413,13.0783320718836,0.342677541415382,2020-02-24,2020,2
"5887","PR",4,"Sul",41023,"Cascavel",478462,39216.3115320966,9,123,27,96,44,79,0,0,0,0,0,123,27,96,44,79,53,10.5768480497413,13.0783320718836,0.315352468573701,2020-03-02,2020,3
"5888","PR",4,"Sul",41023,"Cascavel",478462,39216.3115320966,10,120,22,98,43,77,1,0,1,0,1,121,22,99,43,78,65,10.5768480497413,13.0783320718836,0.325619284038672,2020-03-09,2020,3
"5889","PR",4,"Sul",41023,"Cascavel",478462,39216.3115320966,11,122,32,90,40,82,0,0,0,0,0,122,32,90,40,82,52,10.5768480497413,13.0783320718836,0.409824763081052,2020-03-16,2020,3
"5890","PR",4,"Sul",41023,"Cascavel",478462,39216.3115320966,12,110,24,86,36,74,0,0,0,0,0,110,24,86,36,74,48,10.5768480497413,13.0783320718836,0.538662965481802,2020-03-23,2020,3
"5891","PR",4,"Sul",41023,"Cascavel",478462,39216.3115320966,13,100,25,75,39,61,1,0,1,0,1,101,25,76,39,62,56,10.5768480497413,13.0783320718836,0.488223318483986,2020-03-30,2020,3
"5892","PR",4,"Sul",41023,"Cascavel",478462,39216.3115320966,14,113,20,93,37,76,0,0,0,0,0,113,20,93,37,76,59,10.5768480497413,13.0783320718836,0.454581111799342,2020-04-06,2020,4
"5893","PR",4,"Sul",41023,"Cascavel",478462,39216.3115320966,15,126,28,98,47,79,1,1,0,1,0,127,29,98,48,79,55,10.5768480497413,13.0783320718836,0.430459915377901,2020-04-13,2020,4
"5894","PR",4,"Sul",41023,"Cascavel",478462,39216.3115320966,16,127,28,99,34,93,2,0,2,0,2,129,28,101,34,95,61,10.5768480497413,13.0783320718836,0.426163902636677,2020-04-20,2020,4
"5895","PR",4,"Sul",41023,"Cascavel",478462,39216.3115320966,17,152,31,121,57,95,1,1,0,1,0,153,32,121,58,95,57,10.5768480497413,13.0783320718836,0.41716710962677,2020-04-27,2020,4
"5896","PR",4,"Sul",41023,"Cascavel",478462,39216.3115320966,18,124,20,104,37,87,3,2,1,1,2,127,22,105,38,89,36,10.5768480497413,13.0783320718836,0.386203301930156,2020-05-04,2020,5
"5897","PR",4,"Sul",41023,"Cascavel",478462,39216.3115320966,19,151,32,119,60,91,3,1,2,1,2,154,33,121,61,93,48,10.5768480497413,13.0783320718836,0.392685285839671,2020-05-11,2020,5
"5898","PR",4,"Sul",41023,"Cascavel",478462,39216.3115320966,20,155,22,133,48,107,2,0,2,0,2,157,22,135,48,109,62,10.5768480497413,13.0783320718836,0.398607953336849,2020-05-18,2020,5
"5899","PR",4,"Sul",41023,"Cascavel",478462,39216.3115320966,21,157,32,125,53,104,0,0,0,0,0,157,32,125,53,104,52,10.5768480497413,13.0783320718836,0.379295532494062,2020-05-25,2020,5
"5900","PR",4,"Sul",41024,"Foz do Iguaçu",425519,49305.9232653771,5,101,21,80,33,68,0,0,0,0,0,101,21,80,33,68,43,10.8057995001844,12.9610648793476,0.312764558501973,2020-02-03,2020,2
"5901","PR",4,"Sul",41024,"Foz do Iguaçu",425519,49305.9232653771,6,106,25,81,34,72,0,0,0,0,0,106,25,81,34,72,46,10.8057995001844,12.9610648793476,0.311001597765553,2020-02-10,2020,2
"5902","PR",4,"Sul",41024,"Foz do Iguaçu",425519,49305.9232653771,7,114,35,79,41,73,0,0,0,0,0,114,35,79,41,73,62,10.8057995001844,12.9610648793476,0.322341889505389,2020-02-17,2020,2
"5903","PR",4,"Sul",41024,"Foz do Iguaçu",425519,49305.9232653771,8,123,35,88,38,85,0,0,0,0,0,123,35,88,38,85,51,10.8057995001844,12.9610648793476,0.365780226105026,2020-02-24,2020,2
"5904","PR",4,"Sul",41024,"Foz do Iguaçu",425519,49305.9232653771,9,144,39,105,59,85,1,1,0,1,0,145,40,105,60,85,58,10.8057995001844,12.9610648793476,0.344145808325274,2020-03-02,2020,3
"5905","PR",4,"Sul",41024,"Foz do Iguaçu",425519,49305.9232653771,10,113,26,87,37,76,1,0,1,0,1,114,26,88,37,77,54,10.8057995001844,12.9610648793476,0.351651864336707,2020-03-09,2020,3
"5906","PR",4,"Sul",41024,"Foz do Iguaçu",425519,49305.9232653771,11,93,13,80,28,65,0,0,0,0,0,93,13,80,28,65,57,10.8057995001844,12.9610648793476,0.467073525802219,2020-03-16,2020,3
"5907","PR",4,"Sul",41024,"Foz do Iguaçu",425519,49305.9232653771,12,107,31,76,33,74,0,0,0,0,0,107,31,76,33,74,42,10.8057995001844,12.9610648793476,0.592202582262869,2020-03-23,2020,3
"5908","PR",4,"Sul",41024,"Foz do Iguaçu",425519,49305.9232653771,13,114,36,78,43,71,0,0,0,0,0,114,36,78,43,71,46,10.8057995001844,12.9610648793476,0.53274305275661,2020-03-30,2020,3
"5909","PR",4,"Sul",41024,"Foz do Iguaçu",425519,49305.9232653771,14,96,27,69,26,70,1,1,0,0,1,97,28,69,26,71,43,10.8057995001844,12.9610648793476,0.520038524953674,2020-04-06,2020,4
"5910","PR",4,"Sul",41024,"Foz do Iguaçu",425519,49305.9232653771,15,142,40,102,58,84,2,2,0,2,0,144,42,102,60,84,64,10.8057995001844,12.9610648793476,0.49205501171667,2020-04-13,2020,4
"5911","PR",4,"Sul",41024,"Foz do Iguaçu",425519,49305.9232653771,16,128,42,86,53,75,2,1,1,0,2,130,43,87,53,77,65,10.8057995001844,12.9610648793476,0.482872280808953,2020-04-20,2020,4
"5912","PR",4,"Sul",41024,"Foz do Iguaçu",425519,49305.9232653771,17,131,31,100,46,85,0,0,0,0,0,131,31,100,46,85,56,10.8057995001844,12.9610648793476,0.470733147523022,2020-04-27,2020,4
"5913","PR",4,"Sul",41024,"Foz do Iguaçu",425519,49305.9232653771,18,130,29,101,46,84,2,2,0,0,2,132,31,101,46,86,52,10.8057995001844,12.9610648793476,0.429760131998131,2020-05-04,2020,5
"5914","PR",4,"Sul",41024,"Foz do Iguaçu",425519,49305.9232653771,19,143,31,112,42,101,0,0,0,0,0,143,31,112,42,101,47,10.8057995001844,12.9610648793476,0.448968304889277,2020-05-11,2020,5
"5915","PR",4,"Sul",41024,"Foz do Iguaçu",425519,49305.9232653771,20,126,33,93,42,84,3,0,3,3,0,129,33,96,45,84,46,10.8057995001844,12.9610648793476,0.445786414537873,2020-05-18,2020,5
"5916","PR",4,"Sul",41024,"Foz do Iguaçu",425519,49305.9232653771,21,108,27,81,44,64,1,0,1,0,1,109,27,82,44,65,32,10.8057995001844,12.9610648793476,0.433037438398809,2020-05-25,2020,5
"5917","PR",4,"Sul",41025,"Capanema",98474,29597.2041809005,5,18,5,13,4,14,1,0,1,1,0,19,5,14,5,14,16,10.2954351825032,11.4975478329259,0.291026232996855,2020-02-03,2020,2
"5918","PR",4,"Sul",41025,"Capanema",98474,29597.2041809005,6,28,7,21,9,19,0,0,0,0,0,28,7,21,9,19,13,10.2954351825032,11.4975478329259,0.288328601677534,2020-02-10,2020,2
"5919","PR",4,"Sul",41025,"Capanema",98474,29597.2041809005,7,18,3,15,6,12,0,0,0,0,0,18,3,15,6,12,9,10.2954351825032,11.4975478329259,0.291590375710128,2020-02-17,2020,2
"5920","PR",4,"Sul",41025,"Capanema",98474,29597.2041809005,8,21,5,16,6,15,0,0,0,0,0,21,5,16,6,15,9,10.2954351825032,11.4975478329259,0.329029635323889,2020-02-24,2020,2
"5921","PR",4,"Sul",41025,"Capanema",98474,29597.2041809005,9,19,7,12,6,13,0,0,0,0,0,19,7,12,6,13,12,10.2954351825032,11.4975478329259,0.308933948982906,2020-03-02,2020,3
"5922","PR",4,"Sul",41025,"Capanema",98474,29597.2041809005,10,17,4,13,5,12,0,0,0,0,0,17,4,13,5,12,11,10.2954351825032,11.4975478329259,0.30793619415735,2020-03-09,2020,3
"5923","PR",4,"Sul",41025,"Capanema",98474,29597.2041809005,11,26,7,19,10,16,0,0,0,0,0,26,7,19,10,16,19,10.2954351825032,11.4975478329259,0.408783563194812,2020-03-16,2020,3
"5924","PR",4,"Sul",41025,"Capanema",98474,29597.2041809005,12,24,3,21,6,18,0,0,0,0,0,24,3,21,6,18,12,10.2954351825032,11.4975478329259,0.528242637697891,2020-03-23,2020,3
"5925","PR",4,"Sul",41025,"Capanema",98474,29597.2041809005,13,19,5,14,5,14,0,0,0,0,0,19,5,14,5,14,16,10.2954351825032,11.4975478329259,0.440985595874421,2020-03-30,2020,3
"5926","PR",4,"Sul",41025,"Capanema",98474,29597.2041809005,14,21,3,18,9,12,0,0,0,0,0,21,3,18,9,12,6,10.2954351825032,11.4975478329259,0.411214521847601,2020-04-06,2020,4
"5927","PR",4,"Sul",41025,"Capanema",98474,29597.2041809005,15,31,8,23,9,22,0,0,0,0,0,31,8,23,9,22,20,10.2954351825032,11.4975478329259,0.378943435961774,2020-04-13,2020,4
"5928","PR",4,"Sul",41025,"Capanema",98474,29597.2041809005,16,26,6,20,8,18,0,0,0,0,0,26,6,20,8,18,13,10.2954351825032,11.4975478329259,0.401987048386623,2020-04-20,2020,4
"5929","PR",4,"Sul",41025,"Capanema",98474,29597.2041809005,17,22,4,18,8,14,0,0,0,0,0,22,4,18,8,14,9,10.2954351825032,11.4975478329259,0.399304298242568,2020-04-27,2020,4
"5930","PR",4,"Sul",41025,"Capanema",98474,29597.2041809005,18,21,3,18,8,13,0,0,0,0,0,21,3,18,8,13,12,10.2954351825032,11.4975478329259,0.390105274535346,2020-05-04,2020,5
"5931","PR",4,"Sul",41025,"Capanema",98474,29597.2041809005,19,20,4,16,8,12,0,0,0,0,0,20,4,16,8,12,12,10.2954351825032,11.4975478329259,0.41148630539944,2020-05-11,2020,5
"5932","PR",4,"Sul",41025,"Capanema",98474,29597.2041809005,20,17,4,13,5,12,0,0,0,0,0,17,4,13,5,12,9,10.2954351825032,11.4975478329259,0.411113928129833,2020-05-18,2020,5
"5933","PR",4,"Sul",41025,"Capanema",98474,29597.2041809005,21,21,7,14,6,15,0,0,0,0,0,21,7,14,6,15,13,10.2954351825032,11.4975478329259,0.39253875066135,2020-05-25,2020,5
"5934","PR",4,"Sul",41026,"Francisco Beltrão",261127,32706.7255891961,5,79,16,63,29,50,0,0,0,0,0,79,16,63,29,50,27,10.3953360112476,12.4727621579966,0.302450866528393,2020-02-03,2020,2
"5935","PR",4,"Sul",41026,"Francisco Beltrão",261127,32706.7255891961,6,68,16,52,22,46,0,0,0,0,0,68,16,52,22,46,20,10.3953360112476,12.4727621579966,0.297861873439147,2020-02-10,2020,2
"5936","PR",4,"Sul",41026,"Francisco Beltrão",261127,32706.7255891961,7,55,12,43,25,30,0,0,0,0,0,55,12,43,25,30,17,10.3953360112476,12.4727621579966,0.30303836765178,2020-02-17,2020,2
"5937","PR",4,"Sul",41026,"Francisco Beltrão",261127,32706.7255891961,8,70,14,56,18,52,1,1,0,0,1,71,15,56,18,53,27,10.3953360112476,12.4727621579966,0.347183001332013,2020-02-24,2020,2
"5938","PR",4,"Sul",41026,"Francisco Beltrão",261127,32706.7255891961,9,68,12,56,19,49,1,0,1,0,1,69,12,57,19,50,23,10.3953360112476,12.4727621579966,0.321130166738297,2020-03-02,2020,3
"5939","PR",4,"Sul",41026,"Francisco Beltrão",261127,32706.7255891961,10,63,18,45,24,39,0,0,0,0,0,63,18,45,24,39,30,10.3953360112476,12.4727621579966,0.332178098001701,2020-03-09,2020,3
"5940","PR",4,"Sul",41026,"Francisco Beltrão",261127,32706.7255891961,11,62,10,52,17,45,0,0,0,0,0,62,10,52,17,45,45,10.3953360112476,12.4727621579966,0.431321384115135,2020-03-16,2020,3
"5941","PR",4,"Sul",41026,"Francisco Beltrão",261127,32706.7255891961,12,53,15,38,16,37,0,0,0,0,0,53,15,38,16,37,31,10.3953360112476,12.4727621579966,0.566630333152124,2020-03-23,2020,3
"5942","PR",4,"Sul",41026,"Francisco Beltrão",261127,32706.7255891961,13,63,10,53,26,37,0,0,0,0,0,63,10,53,26,37,25,10.3953360112476,12.4727621579966,0.468921089649092,2020-03-30,2020,3
"5943","PR",4,"Sul",41026,"Francisco Beltrão",261127,32706.7255891961,14,65,22,43,26,39,0,0,0,0,0,65,22,43,26,39,32,10.3953360112476,12.4727621579966,0.457170989555691,2020-04-06,2020,4
"5944","PR",4,"Sul",41026,"Francisco Beltrão",261127,32706.7255891961,15,75,15,60,21,54,0,0,0,0,0,75,15,60,21,54,23,10.3953360112476,12.4727621579966,0.413685658253952,2020-04-13,2020,4
"5945","PR",4,"Sul",41026,"Francisco Beltrão",261127,32706.7255891961,16,61,14,47,20,41,0,0,0,0,0,61,14,47,20,41,28,10.3953360112476,12.4727621579966,0.424863428830061,2020-04-20,2020,4
"5946","PR",4,"Sul",41026,"Francisco Beltrão",261127,32706.7255891961,17,63,18,45,29,34,0,0,0,0,0,63,18,45,29,34,23,10.3953360112476,12.4727621579966,0.414945655302847,2020-04-27,2020,4
"5947","PR",4,"Sul",41026,"Francisco Beltrão",261127,32706.7255891961,18,60,17,43,27,33,0,0,0,0,0,60,17,43,27,33,27,10.3953360112476,12.4727621579966,0.384722511271228,2020-05-04,2020,5
"5948","PR",4,"Sul",41026,"Francisco Beltrão",261127,32706.7255891961,19,62,15,47,26,36,1,0,1,0,1,63,15,48,26,37,25,10.3953360112476,12.4727621579966,0.395285097270508,2020-05-11,2020,5
"5949","PR",4,"Sul",41026,"Francisco Beltrão",261127,32706.7255891961,20,52,8,44,15,37,0,0,0,0,0,52,8,44,15,37,30,10.3953360112476,12.4727621579966,0.399771085681878,2020-05-18,2020,5
"5950","PR",4,"Sul",41026,"Francisco Beltrão",261127,32706.7255891961,21,28,4,24,12,16,0,0,0,0,0,28,4,24,12,16,32,10.3953360112476,12.4727621579966,0.378902385411502,2020-05-25,2020,5
"5951","PR",4,"Sul",41027,"Pato Branco",171079,48871.8184120202,5,60,9,51,14,46,0,0,0,0,0,60,9,51,14,46,20,10.7969561987395,12.0498807171052,0.305590009296617,2020-02-03,2020,2
"5952","PR",4,"Sul",41027,"Pato Branco",171079,48871.8184120202,6,42,11,31,13,29,0,0,0,0,0,42,11,31,13,29,23,10.7969561987395,12.0498807171052,0.290915772292704,2020-02-10,2020,2
"5953","PR",4,"Sul",41027,"Pato Branco",171079,48871.8184120202,7,50,16,34,23,27,0,0,0,0,0,50,16,34,23,27,23,10.7969561987395,12.0498807171052,0.299247060531556,2020-02-17,2020,2
"5954","PR",4,"Sul",41027,"Pato Branco",171079,48871.8184120202,8,57,13,44,18,39,0,0,0,0,0,57,13,44,18,39,24,10.7969561987395,12.0498807171052,0.343020128176264,2020-02-24,2020,2
"5955","PR",4,"Sul",41027,"Pato Branco",171079,48871.8184120202,9,56,11,45,14,42,0,0,0,0,0,56,11,45,14,42,20,10.7969561987395,12.0498807171052,0.316359802298054,2020-03-02,2020,3
"5956","PR",4,"Sul",41027,"Pato Branco",171079,48871.8184120202,10,48,12,36,16,32,0,0,0,0,0,48,12,36,16,32,26,10.7969561987395,12.0498807171052,0.329043000169597,2020-03-09,2020,3
"5957","PR",4,"Sul",41027,"Pato Branco",171079,48871.8184120202,11,49,15,34,17,32,0,0,0,0,0,49,15,34,17,32,27,10.7969561987395,12.0498807171052,0.436129984322749,2020-03-16,2020,3
"5958","PR",4,"Sul",41027,"Pato Branco",171079,48871.8184120202,12,32,6,26,11,21,1,1,0,0,1,33,7,26,11,22,14,10.7969561987395,12.0498807171052,0.561216778991053,2020-03-23,2020,3
"5959","PR",4,"Sul",41027,"Pato Branco",171079,48871.8184120202,13,41,5,36,15,26,0,0,0,0,0,41,5,36,15,26,26,10.7969561987395,12.0498807171052,0.487645190344678,2020-03-30,2020,3
"5960","PR",4,"Sul",41027,"Pato Branco",171079,48871.8184120202,14,58,17,41,19,39,1,0,1,0,1,59,17,42,19,40,24,10.7969561987395,12.0498807171052,0.455553809971201,2020-04-06,2020,4
"5961","PR",4,"Sul",41027,"Pato Branco",171079,48871.8184120202,15,47,7,40,11,36,0,0,0,0,0,47,7,40,11,36,21,10.7969561987395,12.0498807171052,0.420530686074809,2020-04-13,2020,4
"5962","PR",4,"Sul",41027,"Pato Branco",171079,48871.8184120202,16,44,7,37,12,32,2,1,1,0,2,46,8,38,12,34,24,10.7969561987395,12.0498807171052,0.425504618341607,2020-04-20,2020,4
"5963","PR",4,"Sul",41027,"Pato Branco",171079,48871.8184120202,17,61,11,50,19,42,0,0,0,0,0,61,11,50,19,42,19,10.7969561987395,12.0498807171052,0.421048389890859,2020-04-27,2020,4
"5964","PR",4,"Sul",41027,"Pato Branco",171079,48871.8184120202,18,61,11,50,22,39,0,0,0,0,0,61,11,50,22,39,25,10.7969561987395,12.0498807171052,0.38634946305381,2020-05-04,2020,5
"5965","PR",4,"Sul",41027,"Pato Branco",171079,48871.8184120202,19,50,6,44,14,36,0,0,0,0,0,50,6,44,14,36,19,10.7969561987395,12.0498807171052,0.392098239577207,2020-05-11,2020,5
"5966","PR",4,"Sul",41027,"Pato Branco",171079,48871.8184120202,20,45,9,36,19,26,1,1,0,1,0,46,10,36,20,26,24,10.7969561987395,12.0498807171052,0.407666455622077,2020-05-18,2020,5
"5967","PR",4,"Sul",41027,"Pato Branco",171079,48871.8184120202,21,50,14,36,19,31,1,0,1,0,1,51,14,37,19,32,31,10.7969561987395,12.0498807171052,0.391669718144435,2020-05-25,2020,5
"5968","PR",4,"Sul",41028,"Pitanga",67719,24820.4605949586,5,17,5,12,7,10,0,0,0,0,0,17,5,12,7,10,12,10.1194236159981,11.1231220694517,0.286306688858619,2020-02-03,2020,2
"5969","PR",4,"Sul",41028,"Pitanga",67719,24820.4605949586,6,18,5,13,10,8,0,0,0,0,0,18,5,13,10,8,7,10.1194236159981,11.1231220694517,0.276776404687386,2020-02-10,2020,2
"5970","PR",4,"Sul",41028,"Pitanga",67719,24820.4605949586,7,13,3,10,6,7,1,0,1,1,0,14,3,11,7,7,13,10.1194236159981,11.1231220694517,0.300942538119066,2020-02-17,2020,2
"5971","PR",4,"Sul",41028,"Pitanga",67719,24820.4605949586,8,15,7,8,7,8,0,0,0,0,0,15,7,8,7,8,7,10.1194236159981,11.1231220694517,0.322916097087216,2020-02-24,2020,2
"5972","PR",4,"Sul",41028,"Pitanga",67719,24820.4605949586,9,14,4,10,9,5,0,0,0,0,0,14,4,10,9,5,9,10.1194236159981,11.1231220694517,0.302276817201027,2020-03-02,2020,3
"5973","PR",4,"Sul",41028,"Pitanga",67719,24820.4605949586,10,18,4,14,8,10,0,0,0,0,0,18,4,14,8,10,8,10.1194236159981,11.1231220694517,0.296311129168291,2020-03-09,2020,3
"5974","PR",4,"Sul",41028,"Pitanga",67719,24820.4605949586,11,14,3,11,8,6,0,0,0,0,0,14,3,11,8,6,6,10.1194236159981,11.1231220694517,0.392938133638355,2020-03-16,2020,3
"5975","PR",4,"Sul",41028,"Pitanga",67719,24820.4605949586,12,22,9,13,5,17,0,0,0,0,0,22,9,13,5,17,5,10.1194236159981,11.1231220694517,0.506260605671112,2020-03-23,2020,3
"5976","PR",4,"Sul",41028,"Pitanga",67719,24820.4605949586,13,12,5,7,5,7,1,0,1,0,1,13,5,8,5,8,4,10.1194236159981,11.1231220694517,0.455984700203012,2020-03-30,2020,3
"5977","PR",4,"Sul",41028,"Pitanga",67719,24820.4605949586,14,23,6,17,13,10,0,0,0,0,0,23,6,17,13,10,7,10.1194236159981,11.1231220694517,0.42877898921914,2020-04-06,2020,4
"5978","PR",4,"Sul",41028,"Pitanga",67719,24820.4605949586,15,18,1,17,10,8,0,0,0,0,0,18,1,17,10,8,13,10.1194236159981,11.1231220694517,0.395918217717272,2020-04-13,2020,4
"5979","PR",4,"Sul",41028,"Pitanga",67719,24820.4605949586,16,22,8,14,7,15,0,0,0,0,0,22,8,14,7,15,12,10.1194236159981,11.1231220694517,0.383313841074219,2020-04-20,2020,4
"5980","PR",4,"Sul",41028,"Pitanga",67719,24820.4605949586,17,18,6,12,7,11,0,0,0,0,0,18,6,12,7,11,14,10.1194236159981,11.1231220694517,0.381440023554555,2020-04-27,2020,4
"5981","PR",4,"Sul",41028,"Pitanga",67719,24820.4605949586,18,21,5,16,6,15,0,0,0,0,0,21,5,16,6,15,3,10.1194236159981,11.1231220694517,0.364914801684038,2020-05-04,2020,5
"5982","PR",4,"Sul",41028,"Pitanga",67719,24820.4605949586,19,14,7,7,6,8,0,0,0,0,0,14,7,7,6,8,6,10.1194236159981,11.1231220694517,0.365710078271271,2020-05-11,2020,5
"5983","PR",4,"Sul",41028,"Pitanga",67719,24820.4605949586,20,14,4,10,9,5,0,0,0,0,0,14,4,10,9,5,10,10.1194236159981,11.1231220694517,0.373496029888933,2020-05-18,2020,5
"5984","PR",4,"Sul",41028,"Pitanga",67719,24820.4605949586,21,8,3,5,3,5,0,0,0,0,0,8,3,5,3,5,18,10.1194236159981,11.1231220694517,0.352790116163159,2020-05-25,2020,5
"5985","PR",4,"Sul",41029,"Guarapuava",399242,31623.7272066065,5,115,43,72,52,63,1,1,0,0,1,116,44,72,52,64,55,10.3616629787885,12.8973230283061,0.301774713865958,2020-02-03,2020,2
"5986","PR",4,"Sul",41029,"Guarapuava",399242,31623.7272066065,6,122,34,88,52,70,0,0,0,0,0,122,34,88,52,70,45,10.3616629787885,12.8973230283061,0.301461388691746,2020-02-10,2020,2
"5987","PR",4,"Sul",41029,"Guarapuava",399242,31623.7272066065,7,130,37,93,44,86,0,0,0,0,0,130,37,93,44,86,48,10.3616629787885,12.8973230283061,0.309368441609076,2020-02-17,2020,2
"5988","PR",4,"Sul",41029,"Guarapuava",399242,31623.7272066065,8,106,42,64,46,60,0,0,0,0,0,106,42,64,46,60,50,10.3616629787885,12.8973230283061,0.357478338714252,2020-02-24,2020,2
"5989","PR",4,"Sul",41029,"Guarapuava",399242,31623.7272066065,9,123,42,81,59,64,1,0,1,0,1,124,42,82,59,65,62,10.3616629787885,12.8973230283061,0.334134263523663,2020-03-02,2020,3
"5990","PR",4,"Sul",41029,"Guarapuava",399242,31623.7272066065,10,114,35,79,52,62,1,1,0,0,1,115,36,79,52,63,36,10.3616629787885,12.8973230283061,0.333390454466456,2020-03-09,2020,3
"5991","PR",4,"Sul",41029,"Guarapuava",399242,31623.7272066065,11,119,45,74,48,71,1,0,1,0,1,120,45,75,48,72,54,10.3616629787885,12.8973230283061,0.411274388601213,2020-03-16,2020,3
"5992","PR",4,"Sul",41029,"Guarapuava",399242,31623.7272066065,12,100,32,68,44,56,0,0,0,0,0,100,32,68,44,56,53,10.3616629787885,12.8973230283061,0.539644348242708,2020-03-23,2020,3
"5993","PR",4,"Sul",41029,"Guarapuava",399242,31623.7272066065,13,106,30,76,41,65,0,0,0,0,0,106,30,76,41,65,57,10.3616629787885,12.8973230283061,0.491495401577131,2020-03-30,2020,3
"5994","PR",4,"Sul",41029,"Guarapuava",399242,31623.7272066065,14,123,44,79,63,60,0,0,0,0,0,123,44,79,63,60,53,10.3616629787885,12.8973230283061,0.472736264569958,2020-04-06,2020,4
"5995","PR",4,"Sul",41029,"Guarapuava",399242,31623.7272066065,15,116,45,71,56,60,1,0,1,0,1,117,45,72,56,61,55,10.3616629787885,12.8973230283061,0.439928619583123,2020-04-13,2020,4
"5996","PR",4,"Sul",41029,"Guarapuava",399242,31623.7272066065,16,121,42,79,60,61,1,1,0,0,1,122,43,79,60,62,44,10.3616629787885,12.8973230283061,0.43935118578823,2020-04-20,2020,4
"5997","PR",4,"Sul",41029,"Guarapuava",399242,31623.7272066065,17,120,37,83,52,68,2,0,2,1,1,122,37,85,53,69,36,10.3616629787885,12.8973230283061,0.434244838721796,2020-04-27,2020,4
"5998","PR",4,"Sul",41029,"Guarapuava",399242,31623.7272066065,18,126,36,90,50,76,1,1,0,0,1,127,37,90,50,77,40,10.3616629787885,12.8973230283061,0.411158354142684,2020-05-04,2020,5
"5999","PR",4,"Sul",41029,"Guarapuava",399242,31623.7272066065,19,120,29,91,49,71,1,1,0,1,0,121,30,91,50,71,31,10.3616629787885,12.8973230283061,0.419741670380478,2020-05-11,2020,5
"6000","PR",4,"Sul",41029,"Guarapuava",399242,31623.7272066065,20,106,31,75,49,57,1,1,0,0,1,107,32,75,49,58,56,10.3616629787885,12.8973230283061,0.4331037852609,2020-05-18,2020,5
"6001","PR",4,"Sul",41029,"Guarapuava",399242,31623.7272066065,21,116,42,74,53,63,1,0,1,1,0,117,42,75,54,63,42,10.3616629787885,12.8973230283061,0.407699081349281,2020-05-25,2020,5
"6002","PR",4,"Sul",41030,"Palmas",97484,35068.4584677486,5,16,4,12,6,10,0,0,0,0,0,16,4,12,6,10,10,10.4650573863013,11.4874435409555,0.317709100297391,2020-02-03,2020,2
"6003","PR",4,"Sul",41030,"Palmas",97484,35068.4584677486,6,18,8,10,6,12,0,0,0,0,0,18,8,10,6,12,15,10.4650573863013,11.4874435409555,0.304826446958303,2020-02-10,2020,2
"6004","PR",4,"Sul",41030,"Palmas",97484,35068.4584677486,7,24,10,14,13,11,0,0,0,0,0,24,10,14,13,11,11,10.4650573863013,11.4874435409555,0.327547426898225,2020-02-17,2020,2
"6005","PR",4,"Sul",41030,"Palmas",97484,35068.4584677486,8,30,13,17,16,14,0,0,0,0,0,30,13,17,16,14,12,10.4650573863013,11.4874435409555,0.359426092664792,2020-02-24,2020,2
"6006","PR",4,"Sul",41030,"Palmas",97484,35068.4584677486,9,36,11,25,16,20,0,0,0,0,0,36,11,25,16,20,18,10.4650573863013,11.4874435409555,0.328263716935432,2020-03-02,2020,3
"6007","PR",4,"Sul",41030,"Palmas",97484,35068.4584677486,10,41,15,26,19,22,0,0,0,0,0,41,15,26,19,22,8,10.4650573863013,11.4874435409555,0.330191798415593,2020-03-09,2020,3
"6008","PR",4,"Sul",41030,"Palmas",97484,35068.4584677486,11,21,9,12,10,11,1,1,0,1,0,22,10,12,11,11,15,10.4650573863013,11.4874435409555,0.419184689409509,2020-03-16,2020,3
"6009","PR",4,"Sul",41030,"Palmas",97484,35068.4584677486,12,32,13,19,17,15,0,0,0,0,0,32,13,19,17,15,10,10.4650573863013,11.4874435409555,0.510150022729089,2020-03-23,2020,3
"6010","PR",4,"Sul",41030,"Palmas",97484,35068.4584677486,13,30,6,24,10,20,0,0,0,0,0,30,6,24,10,20,14,10.4650573863013,11.4874435409555,0.458665361614852,2020-03-30,2020,3
"6011","PR",4,"Sul",41030,"Palmas",97484,35068.4584677486,14,32,11,21,13,19,0,0,0,0,0,32,11,21,13,19,11,10.4650573863013,11.4874435409555,0.441125928507432,2020-04-06,2020,4
"6012","PR",4,"Sul",41030,"Palmas",97484,35068.4584677486,15,34,9,25,20,14,0,0,0,0,0,34,9,25,20,14,13,10.4650573863013,11.4874435409555,0.416746354611183,2020-04-13,2020,4
"6013","PR",4,"Sul",41030,"Palmas",97484,35068.4584677486,16,31,12,19,16,15,0,0,0,0,0,31,12,19,16,15,12,10.4650573863013,11.4874435409555,0.419767859704335,2020-04-20,2020,4
"6014","PR",4,"Sul",41030,"Palmas",97484,35068.4584677486,17,26,10,16,14,12,0,0,0,0,0,26,10,16,14,12,8,10.4650573863013,11.4874435409555,0.406576938903939,2020-04-27,2020,4
"6015","PR",4,"Sul",41030,"Palmas",97484,35068.4584677486,18,35,5,30,19,16,0,0,0,0,0,35,5,30,19,16,13,10.4650573863013,11.4874435409555,0.396342666784181,2020-05-04,2020,5
"6016","PR",4,"Sul",41030,"Palmas",97484,35068.4584677486,19,26,9,17,13,13,0,0,0,0,0,26,9,17,13,13,11,10.4650573863013,11.4874435409555,0.405189477744855,2020-05-11,2020,5
"6017","PR",4,"Sul",41030,"Palmas",97484,35068.4584677486,20,21,11,10,8,13,0,0,0,0,0,21,11,10,8,13,12,10.4650573863013,11.4874435409555,0.403346408038306,2020-05-18,2020,5
"6018","PR",4,"Sul",41030,"Palmas",97484,35068.4584677486,21,32,10,22,16,16,0,0,0,0,0,32,10,22,16,16,8,10.4650573863013,11.4874435409555,0.391723925796442,2020-05-25,2020,5
"6019","PR",4,"Sul",41031,"Prudentópolis",141649,27023.1873396212,5,33,9,24,17,16,0,0,0,0,0,33,9,24,17,16,21,10.2044505667934,11.8611074455797,0.289790715418658,2020-02-03,2020,2
"6020","PR",4,"Sul",41031,"Prudentópolis",141649,27023.1873396212,6,23,14,9,11,12,0,0,0,0,0,23,14,9,11,12,22,10.2044505667934,11.8611074455797,0.296881476304366,2020-02-10,2020,2
"6021","PR",4,"Sul",41031,"Prudentópolis",141649,27023.1873396212,7,28,16,12,14,14,0,0,0,0,0,28,16,12,14,14,21,10.2044505667934,11.8611074455797,0.316537418151041,2020-02-17,2020,2
"6022","PR",4,"Sul",41031,"Prudentópolis",141649,27023.1873396212,8,17,5,12,7,10,2,1,1,0,2,19,6,13,7,12,17,10.2044505667934,11.8611074455797,0.342321517379228,2020-02-24,2020,2
"6023","PR",4,"Sul",41031,"Prudentópolis",141649,27023.1873396212,9,35,11,24,11,24,0,0,0,0,0,35,11,24,11,24,15,10.2044505667934,11.8611074455797,0.335145264799975,2020-03-02,2020,3
"6024","PR",4,"Sul",41031,"Prudentópolis",141649,27023.1873396212,10,29,10,19,13,16,0,0,0,0,0,29,10,19,13,16,13,10.2044505667934,11.8611074455797,0.337801824847949,2020-03-09,2020,3
"6025","PR",4,"Sul",41031,"Prudentópolis",141649,27023.1873396212,11,25,6,19,8,17,2,0,2,0,2,27,6,21,8,19,23,10.2044505667934,11.8611074455797,0.398216546456558,2020-03-16,2020,3
"6026","PR",4,"Sul",41031,"Prudentópolis",141649,27023.1873396212,12,22,5,17,13,9,0,0,0,0,0,22,5,17,13,9,19,10.2044505667934,11.8611074455797,0.500663560498384,2020-03-23,2020,3
"6027","PR",4,"Sul",41031,"Prudentópolis",141649,27023.1873396212,13,25,9,16,9,16,0,0,0,0,0,25,9,16,9,16,15,10.2044505667934,11.8611074455797,0.450589259281761,2020-03-30,2020,3
"6028","PR",4,"Sul",41031,"Prudentópolis",141649,27023.1873396212,14,28,10,18,14,14,0,0,0,0,0,28,10,18,14,14,16,10.2044505667934,11.8611074455797,0.429453517366392,2020-04-06,2020,4
"6029","PR",4,"Sul",41031,"Prudentópolis",141649,27023.1873396212,15,29,8,21,15,14,0,0,0,0,0,29,8,21,15,14,12,10.2044505667934,11.8611074455797,0.391549285653876,2020-04-13,2020,4
"6030","PR",4,"Sul",41031,"Prudentópolis",141649,27023.1873396212,16,27,10,17,9,18,0,0,0,0,0,27,10,17,9,18,15,10.2044505667934,11.8611074455797,0.398776894093799,2020-04-20,2020,4
"6031","PR",4,"Sul",41031,"Prudentópolis",141649,27023.1873396212,17,30,5,25,10,20,0,0,0,0,0,30,5,25,10,20,18,10.2044505667934,11.8611074455797,0.424355973900463,2020-04-27,2020,4
"6032","PR",4,"Sul",41031,"Prudentópolis",141649,27023.1873396212,18,36,12,24,20,16,0,0,0,0,0,36,12,24,20,16,22,10.2044505667934,11.8611074455797,0.406391790323111,2020-05-04,2020,5
"6033","PR",4,"Sul",41031,"Prudentópolis",141649,27023.1873396212,19,35,5,30,11,24,1,0,1,0,1,36,5,31,11,25,19,10.2044505667934,11.8611074455797,0.420304633929633,2020-05-11,2020,5
"6034","PR",4,"Sul",41031,"Prudentópolis",141649,27023.1873396212,20,35,11,24,10,25,1,1,0,0,1,36,12,24,10,26,11,10.2044505667934,11.8611074455797,0.425408774867608,2020-05-18,2020,5
"6035","PR",4,"Sul",41031,"Prudentópolis",141649,27023.1873396212,21,32,12,20,14,18,0,0,0,0,0,32,12,20,14,18,20,10.2044505667934,11.8611074455797,0.409133398026735,2020-05-25,2020,5
"6036","PR",4,"Sul",41032,"Irati",105033,33908.5319541477,5,29,5,24,10,19,0,0,0,0,0,29,5,24,10,19,19,10.4314219417658,11.5620298654765,0.314942240436837,2020-02-03,2020,2
"6037","PR",4,"Sul",41032,"Irati",105033,33908.5319541477,6,26,5,21,11,15,0,0,0,0,0,26,5,21,11,15,12,10.4314219417658,11.5620298654765,0.310946670775753,2020-02-10,2020,2
"6038","PR",4,"Sul",41032,"Irati",105033,33908.5319541477,7,20,9,11,5,15,0,0,0,0,0,20,9,11,5,15,14,10.4314219417658,11.5620298654765,0.331087187906056,2020-02-17,2020,2
"6039","PR",4,"Sul",41032,"Irati",105033,33908.5319541477,8,32,11,21,11,21,0,0,0,0,0,32,11,21,11,21,14,10.4314219417658,11.5620298654765,0.367579722144851,2020-02-24,2020,2
"6040","PR",4,"Sul",41032,"Irati",105033,33908.5319541477,9,23,6,17,8,15,0,0,0,0,0,23,6,17,8,15,10,10.4314219417658,11.5620298654765,0.337474838889461,2020-03-02,2020,3
"6041","PR",4,"Sul",41032,"Irati",105033,33908.5319541477,10,27,3,24,10,17,0,0,0,0,0,27,3,24,10,17,13,10.4314219417658,11.5620298654765,0.352327720854214,2020-03-09,2020,3
"6042","PR",4,"Sul",41032,"Irati",105033,33908.5319541477,11,14,1,13,8,6,0,0,0,0,0,14,1,13,8,6,9,10.4314219417658,11.5620298654765,0.420650267877856,2020-03-16,2020,3
"6043","PR",4,"Sul",41032,"Irati",105033,33908.5319541477,12,14,2,12,6,8,0,0,0,0,0,14,2,12,6,8,21,10.4314219417658,11.5620298654765,0.567800325225368,2020-03-23,2020,3
"6044","PR",4,"Sul",41032,"Irati",105033,33908.5319541477,13,10,2,8,2,8,0,0,0,0,0,10,2,8,2,8,12,10.4314219417658,11.5620298654765,0.486069909060302,2020-03-30,2020,3
"6045","PR",4,"Sul",41032,"Irati",105033,33908.5319541477,14,18,4,14,8,10,0,0,0,0,0,18,4,14,8,10,9,10.4314219417658,11.5620298654765,0.472599607130191,2020-04-06,2020,4
"6046","PR",4,"Sul",41032,"Irati",105033,33908.5319541477,15,15,4,11,7,8,1,1,0,0,1,16,5,11,7,9,11,10.4314219417658,11.5620298654765,0.44965039534343,2020-04-13,2020,4
"6047","PR",4,"Sul",41032,"Irati",105033,33908.5319541477,16,24,4,20,10,14,0,0,0,0,0,24,4,20,10,14,11,10.4314219417658,11.5620298654765,0.458441302166374,2020-04-20,2020,4
"6048","PR",4,"Sul",41032,"Irati",105033,33908.5319541477,17,22,3,19,8,14,0,0,0,0,0,22,3,19,8,14,25,10.4314219417658,11.5620298654765,0.438320757301976,2020-04-27,2020,4
"6049","PR",4,"Sul",41032,"Irati",105033,33908.5319541477,18,22,6,16,10,12,0,0,0,0,0,22,6,16,10,12,14,10.4314219417658,11.5620298654765,0.422588380532778,2020-05-04,2020,5
"6050","PR",4,"Sul",41032,"Irati",105033,33908.5319541477,19,28,8,20,8,20,0,0,0,0,0,28,8,20,8,20,17,10.4314219417658,11.5620298654765,0.4392550488698,2020-05-11,2020,5
"6051","PR",4,"Sul",41032,"Irati",105033,33908.5319541477,20,20,4,16,8,12,0,0,0,0,0,20,4,16,8,12,11,10.4314219417658,11.5620298654765,0.438142979680522,2020-05-18,2020,5
"6052","PR",4,"Sul",41032,"Irati",105033,33908.5319541477,21,20,2,18,5,15,0,0,0,0,0,20,2,18,5,15,18,10.4314219417658,11.5620298654765,0.419182780410278,2020-05-25,2020,5
"6053","PR",4,"Sul",41033,"União da Vitória",124095,26572.6663333736,5,22,11,11,11,11,0,0,0,0,0,22,11,11,11,11,17,10.1876383849939,11.7288026802924,0.323896487974624,2020-02-03,2020,2
"6054","PR",4,"Sul",41033,"União da Vitória",124095,26572.6663333736,6,20,9,11,11,9,1,0,1,1,0,21,9,12,12,9,18,10.1876383849939,11.7288026802924,0.323001033964606,2020-02-10,2020,2
"6055","PR",4,"Sul",41033,"União da Vitória",124095,26572.6663333736,7,33,11,22,10,23,0,0,0,0,0,33,11,22,10,23,13,10.1876383849939,11.7288026802924,0.333901037294729,2020-02-17,2020,2
"6056","PR",4,"Sul",41033,"União da Vitória",124095,26572.6663333736,8,29,7,22,14,15,0,0,0,0,0,29,7,22,14,15,15,10.1876383849939,11.7288026802924,0.365266420728393,2020-02-24,2020,2
"6057","PR",4,"Sul",41033,"União da Vitória",124095,26572.6663333736,9,29,11,18,15,14,0,0,0,0,0,29,11,18,15,14,6,10.1876383849939,11.7288026802924,0.340277327902064,2020-03-02,2020,3
"6058","PR",4,"Sul",41033,"União da Vitória",124095,26572.6663333736,10,35,9,26,14,21,0,0,0,0,0,35,9,26,14,21,18,10.1876383849939,11.7288026802924,0.342705342074969,2020-03-09,2020,3
"6059","PR",4,"Sul",41033,"União da Vitória",124095,26572.6663333736,11,25,3,22,13,12,0,0,0,0,0,25,3,22,13,12,11,10.1876383849939,11.7288026802924,0.444085381007675,2020-03-16,2020,3
"6060","PR",4,"Sul",41033,"União da Vitória",124095,26572.6663333736,12,29,6,23,10,19,0,0,0,0,0,29,6,23,10,19,13,10.1876383849939,11.7288026802924,0.559877118306493,2020-03-23,2020,3
"6061","PR",4,"Sul",41033,"União da Vitória",124095,26572.6663333736,13,27,11,16,13,14,0,0,0,0,0,27,11,16,13,14,15,10.1876383849939,11.7288026802924,0.483644447434392,2020-03-30,2020,3
"6062","PR",4,"Sul",41033,"União da Vitória",124095,26572.6663333736,14,16,3,13,11,5,1,0,1,0,1,17,3,14,11,6,20,10.1876383849939,11.7288026802924,0.464847552790486,2020-04-06,2020,4
"6063","PR",4,"Sul",41033,"União da Vitória",124095,26572.6663333736,15,26,4,22,7,19,0,0,0,0,0,26,4,22,7,19,16,10.1876383849939,11.7288026802924,0.443913693591262,2020-04-13,2020,4
"6064","PR",4,"Sul",41033,"União da Vitória",124095,26572.6663333736,16,16,3,13,7,9,0,0,0,0,0,16,3,13,7,9,8,10.1876383849939,11.7288026802924,0.449958760491341,2020-04-20,2020,4
"6065","PR",4,"Sul",41033,"União da Vitória",124095,26572.6663333736,17,18,5,13,8,10,0,0,0,0,0,18,5,13,8,10,17,10.1876383849939,11.7288026802924,0.447520220643092,2020-04-27,2020,4
"6066","PR",4,"Sul",41033,"União da Vitória",124095,26572.6663333736,18,10,3,7,5,5,2,0,2,2,0,12,3,9,7,5,18,10.1876383849939,11.7288026802924,0.416580316747035,2020-05-04,2020,5
"6067","PR",4,"Sul",41033,"União da Vitória",124095,26572.6663333736,19,9,1,8,5,4,0,0,0,0,0,9,1,8,5,4,25,10.1876383849939,11.7288026802924,0.425430441238948,2020-05-11,2020,5
"6068","PR",4,"Sul",41033,"União da Vitória",124095,26572.6663333736,20,10,3,7,6,4,1,1,0,1,0,11,4,7,7,4,17,10.1876383849939,11.7288026802924,0.420251418041035,2020-05-18,2020,5
"6069","PR",4,"Sul",41033,"União da Vitória",124095,26572.6663333736,21,10,3,7,5,5,0,0,0,0,0,10,3,7,5,5,23,10.1876383849939,11.7288026802924,0.405835957360342,2020-05-25,2020,5
"6070","PR",4,"Sul",41034,"São Mateus do Sul",69373,29154.1082948698,5,17,4,13,5,12,0,0,0,0,0,17,4,13,5,12,3,10.2803511182072,11.1472530218043,0.30225569566502,2020-02-03,2020,2
"6071","PR",4,"Sul",41034,"São Mateus do Sul",69373,29154.1082948698,6,22,6,16,8,14,0,0,0,0,0,22,6,16,8,14,10,10.2803511182072,11.1472530218043,0.292236614278132,2020-02-10,2020,2
"6072","PR",4,"Sul",41034,"São Mateus do Sul",69373,29154.1082948698,7,14,0,14,9,5,0,0,0,0,0,14,0,14,9,5,2,10.2803511182072,11.1472530218043,0.288613999381784,2020-02-17,2020,2
"6073","PR",4,"Sul",41034,"São Mateus do Sul",69373,29154.1082948698,8,15,4,11,7,8,0,0,0,0,0,15,4,11,7,8,8,10.2803511182072,11.1472530218043,0.348169137921546,2020-02-24,2020,2
"6074","PR",4,"Sul",41034,"São Mateus do Sul",69373,29154.1082948698,9,22,4,18,8,14,0,0,0,0,0,22,4,18,8,14,4,10.2803511182072,11.1472530218043,0.304977433530347,2020-03-02,2020,3
"6075","PR",4,"Sul",41034,"São Mateus do Sul",69373,29154.1082948698,10,7,1,6,3,4,0,0,0,0,0,7,1,6,3,4,7,10.2803511182072,11.1472530218043,0.332211847236031,2020-03-09,2020,3
"6076","PR",4,"Sul",41034,"São Mateus do Sul",69373,29154.1082948698,11,15,3,12,3,12,0,0,0,0,0,15,3,12,3,12,6,10.2803511182072,11.1472530218043,0.407543520101341,2020-03-16,2020,3
"6077","PR",4,"Sul",41034,"São Mateus do Sul",69373,29154.1082948698,12,20,4,16,7,13,0,0,0,0,0,20,4,16,7,13,10,10.2803511182072,11.1472530218043,0.545217241379932,2020-03-23,2020,3
"6078","PR",4,"Sul",41034,"São Mateus do Sul",69373,29154.1082948698,13,9,0,9,3,6,0,0,0,0,0,9,0,9,3,6,4,10.2803511182072,11.1472530218043,0.476750856909404,2020-03-30,2020,3
"6079","PR",4,"Sul",41034,"São Mateus do Sul",69373,29154.1082948698,14,18,7,11,9,9,0,0,0,0,0,18,7,11,9,9,9,10.2803511182072,11.1472530218043,0.437521273641459,2020-04-06,2020,4
"6080","PR",4,"Sul",41034,"São Mateus do Sul",69373,29154.1082948698,15,14,3,11,7,7,0,0,0,0,0,14,3,11,7,7,3,10.2803511182072,11.1472530218043,0.420667168460636,2020-04-13,2020,4
"6081","PR",4,"Sul",41034,"São Mateus do Sul",69373,29154.1082948698,16,15,4,11,4,11,0,0,0,0,0,15,4,11,4,11,9,10.2803511182072,11.1472530218043,0.43439770105129,2020-04-20,2020,4
"6082","PR",4,"Sul",41034,"São Mateus do Sul",69373,29154.1082948698,17,18,2,16,8,10,0,0,0,0,0,18,2,16,8,10,3,10.2803511182072,11.1472530218043,0.443047687757025,2020-04-27,2020,4
"6083","PR",4,"Sul",41034,"São Mateus do Sul",69373,29154.1082948698,18,21,8,13,3,18,0,0,0,0,0,21,8,13,3,18,9,10.2803511182072,11.1472530218043,0.419347770126526,2020-05-04,2020,5
"6084","PR",4,"Sul",41034,"São Mateus do Sul",69373,29154.1082948698,19,15,2,13,8,7,0,0,0,0,0,15,2,13,8,7,7,10.2803511182072,11.1472530218043,0.434549194411465,2020-05-11,2020,5
"6085","PR",4,"Sul",41034,"São Mateus do Sul",69373,29154.1082948698,20,14,8,6,8,6,0,0,0,0,0,14,8,6,8,6,8,10.2803511182072,11.1472530218043,0.436263360338139,2020-05-18,2020,5
"6086","PR",4,"Sul",41034,"São Mateus do Sul",69373,29154.1082948698,21,15,3,12,4,11,0,0,0,0,0,15,3,12,4,11,10,10.2803511182072,11.1472530218043,0.422852861566864,2020-05-25,2020,5
"6087","PR",4,"Sul",41036,"Lapa",53284,33439.3665269124,5,9,1,8,6,3,0,0,0,0,0,9,1,8,6,3,10,10.417489123446,10.8833913774714,0.299156083925844,2020-02-03,2020,2
"6088","PR",4,"Sul",41036,"Lapa",53284,33439.3665269124,6,7,2,5,1,6,0,0,0,0,0,7,2,5,1,6,5,10.417489123446,10.8833913774714,0.306542673983953,2020-02-10,2020,2
"6089","PR",4,"Sul",41036,"Lapa",53284,33439.3665269124,7,6,1,5,1,5,0,0,0,0,0,6,1,5,1,5,7,10.417489123446,10.8833913774714,0.308093982545236,2020-02-17,2020,2
"6090","PR",4,"Sul",41036,"Lapa",53284,33439.3665269124,8,8,1,7,2,6,0,0,0,0,0,8,1,7,2,6,3,10.417489123446,10.8833913774714,0.347236743228655,2020-02-24,2020,2
"6091","PR",4,"Sul",41036,"Lapa",53284,33439.3665269124,9,9,3,6,5,4,0,0,0,0,0,9,3,6,5,4,9,10.417489123446,10.8833913774714,0.327033824624327,2020-03-02,2020,3
"6092","PR",4,"Sul",41036,"Lapa",53284,33439.3665269124,10,8,4,4,3,5,0,0,0,0,0,8,4,4,3,5,3,10.417489123446,10.8833913774714,0.357259416690123,2020-03-09,2020,3
"6093","PR",4,"Sul",41036,"Lapa",53284,33439.3665269124,11,3,0,3,1,2,0,0,0,0,0,3,0,3,1,2,7,10.417489123446,10.8833913774714,0.424985889804518,2020-03-16,2020,3
"6094","PR",4,"Sul",41036,"Lapa",53284,33439.3665269124,12,5,1,4,1,4,0,0,0,0,0,5,1,4,1,4,6,10.417489123446,10.8833913774714,0.520227291248362,2020-03-23,2020,3
"6095","PR",4,"Sul",41036,"Lapa",53284,33439.3665269124,13,2,2,0,1,1,0,0,0,0,0,2,2,0,1,1,8,10.417489123446,10.8833913774714,0.481150438075107,2020-03-30,2020,3
"6096","PR",4,"Sul",41036,"Lapa",53284,33439.3665269124,14,8,4,4,2,6,0,0,0,0,0,8,4,4,2,6,4,10.417489123446,10.8833913774714,0.445439597325709,2020-04-06,2020,4
"6097","PR",4,"Sul",41036,"Lapa",53284,33439.3665269124,15,5,1,4,3,2,0,0,0,0,0,5,1,4,3,2,8,10.417489123446,10.8833913774714,0.433401222394459,2020-04-13,2020,4
"6098","PR",4,"Sul",41036,"Lapa",53284,33439.3665269124,16,4,2,2,1,3,0,0,0,0,0,4,2,2,1,3,4,10.417489123446,10.8833913774714,0.440437893254248,2020-04-20,2020,4
"6099","PR",4,"Sul",41036,"Lapa",53284,33439.3665269124,17,7,1,6,0,7,0,0,0,0,0,7,1,6,0,7,3,10.417489123446,10.8833913774714,0.423460464247693,2020-04-27,2020,4
"6100","PR",4,"Sul",41036,"Lapa",53284,33439.3665269124,18,12,5,7,4,8,0,0,0,0,0,12,5,7,4,8,3,10.417489123446,10.8833913774714,0.401982183403594,2020-05-04,2020,5
"6101","PR",4,"Sul",41036,"Lapa",53284,33439.3665269124,19,3,0,3,2,1,0,0,0,0,0,3,0,3,2,1,7,10.417489123446,10.8833913774714,0.412167877240422,2020-05-11,2020,5
"6102","PR",4,"Sul",41036,"Lapa",53284,33439.3665269124,20,7,2,5,3,4,0,0,0,0,0,7,2,5,3,4,12,10.417489123446,10.8833913774714,0.415717425645739,2020-05-18,2020,5
"6103","PR",4,"Sul",41036,"Lapa",53284,33439.3665269124,21,17,0,17,4,13,0,0,0,0,0,17,0,17,4,13,5,10.417489123446,10.8833913774714,0.404877321098718,2020-05-25,2020,5
"6104","PR",4,"Sul",41037,"Curitiba",3515126,45289.7544807441,5,681,123,558,227,454,6,0,6,3,3,687,123,564,230,457,361,10.7208361154877,15.0725859289571,0.279330126438624,2020-02-03,2020,2
"6105","PR",4,"Sul",41037,"Curitiba",3515126,45289.7544807441,6,811,141,670,271,540,5,2,3,2,3,816,143,673,273,543,349,10.7208361154877,15.0725859289571,0.276579849034906,2020-02-10,2020,2
"6106","PR",4,"Sul",41037,"Curitiba",3515126,45289.7544807441,7,772,145,627,259,513,5,1,4,3,2,777,146,631,262,515,338,10.7208361154877,15.0725859289571,0.291726516738599,2020-02-17,2020,2
"6107","PR",4,"Sul",41037,"Curitiba",3515126,45289.7544807441,8,716,131,585,247,469,4,2,2,2,2,720,133,587,249,471,326,10.7208361154877,15.0725859289571,0.34764056442348,2020-02-24,2020,2
"6108","PR",4,"Sul",41037,"Curitiba",3515126,45289.7544807441,9,732,150,582,247,485,5,2,3,0,5,737,152,585,247,490,379,10.7208361154877,15.0725859289571,0.310200534319631,2020-03-02,2020,3
"6109","PR",4,"Sul",41037,"Curitiba",3515126,45289.7544807441,10,743,151,592,266,477,1,1,0,1,0,744,152,592,267,477,315,10.7208361154877,15.0725859289571,0.320016843711473,2020-03-09,2020,3
"6110","PR",4,"Sul",41037,"Curitiba",3515126,45289.7544807441,11,717,139,578,232,485,10,3,7,5,5,727,142,585,237,490,365,10.7208361154877,15.0725859289571,0.417768541612801,2020-03-16,2020,3
"6111","PR",4,"Sul",41037,"Curitiba",3515126,45289.7544807441,12,689,126,563,242,447,5,0,5,4,1,694,126,568,246,448,343,10.7208361154877,15.0725859289571,0.547847303058893,2020-03-23,2020,3
"6112","PR",4,"Sul",41037,"Curitiba",3515126,45289.7544807441,13,720,137,583,238,482,4,1,3,1,3,724,138,586,239,485,377,10.7208361154877,15.0725859289571,0.497638295402811,2020-03-30,2020,3
"6113","PR",4,"Sul",41037,"Curitiba",3515126,45289.7544807441,14,732,158,574,247,485,8,1,7,2,6,740,159,581,249,491,370,10.7208361154877,15.0725859289571,0.483770921986673,2020-04-06,2020,4
"6114","PR",4,"Sul",41037,"Curitiba",3515126,45289.7544807441,15,696,141,555,229,467,5,0,5,2,3,701,141,560,231,470,352,10.7208361154877,15.0725859289571,0.460987153463101,2020-04-13,2020,4
"6115","PR",4,"Sul",41037,"Curitiba",3515126,45289.7544807441,16,653,117,536,226,427,4,1,3,1,3,657,118,539,227,430,327,10.7208361154877,15.0725859289571,0.455362209286755,2020-04-20,2020,4
"6116","PR",4,"Sul",41037,"Curitiba",3515126,45289.7544807441,17,622,139,483,211,411,2,0,2,0,2,624,139,485,211,413,329,10.7208361154877,15.0725859289571,0.442083753337548,2020-04-27,2020,4
"6117","PR",4,"Sul",41037,"Curitiba",3515126,45289.7544807441,18,686,151,535,227,459,8,3,5,1,7,694,154,540,228,466,342,10.7208361154877,15.0725859289571,0.412726151547886,2020-05-04,2020,5
"6118","PR",4,"Sul",41037,"Curitiba",3515126,45289.7544807441,19,718,139,579,255,463,5,3,2,1,4,723,142,581,256,467,387,10.7208361154877,15.0725859289571,0.415637859277294,2020-05-11,2020,5
"6119","PR",4,"Sul",41037,"Curitiba",3515126,45289.7544807441,20,682,130,552,214,468,6,0,6,2,4,688,130,558,216,472,348,10.7208361154877,15.0725859289571,0.41270749441543,2020-05-18,2020,5
"6120","PR",4,"Sul",41037,"Curitiba",3515126,45289.7544807441,21,701,128,573,220,481,1,0,1,0,1,702,128,574,220,482,388,10.7208361154877,15.0725859289571,0.398283223390085,2020-05-25,2020,5
"6121","PR",4,"Sul",41038,"Paranaguá",299824,50231.5127776963,5,59,17,42,27,32,0,0,0,0,0,59,17,42,27,32,49,10.8243978533062,12.6109509148154,0.315669914478947,2020-02-03,2020,2
"6122","PR",4,"Sul",41038,"Paranaguá",299824,50231.5127776963,6,61,25,36,23,38,1,1,0,0,1,62,26,36,23,39,43,10.8243978533062,12.6109509148154,0.298522030471573,2020-02-10,2020,2
"6123","PR",4,"Sul",41038,"Paranaguá",299824,50231.5127776963,7,87,23,64,38,49,0,0,0,0,0,87,23,64,38,49,29,10.8243978533062,12.6109509148154,0.320841699935175,2020-02-17,2020,2
"6124","PR",4,"Sul",41038,"Paranaguá",299824,50231.5127776963,8,63,20,43,27,36,0,0,0,0,0,63,20,43,27,36,38,10.8243978533062,12.6109509148154,0.36187306291506,2020-02-24,2020,2
"6125","PR",4,"Sul",41038,"Paranaguá",299824,50231.5127776963,9,97,28,69,40,57,0,0,0,0,0,97,28,69,40,57,35,10.8243978533062,12.6109509148154,0.350337437057672,2020-03-02,2020,3
"6126","PR",4,"Sul",41038,"Paranaguá",299824,50231.5127776963,10,59,21,38,31,28,2,2,0,2,0,61,23,38,33,28,32,10.8243978533062,12.6109509148154,0.356175456390373,2020-03-09,2020,3
"6127","PR",4,"Sul",41038,"Paranaguá",299824,50231.5127776963,11,87,25,62,37,50,1,0,1,0,1,88,25,63,37,51,35,10.8243978533062,12.6109509148154,0.430906529962466,2020-03-16,2020,3
"6128","PR",4,"Sul",41038,"Paranaguá",299824,50231.5127776963,12,78,20,58,31,47,1,0,1,1,0,79,20,59,32,47,36,10.8243978533062,12.6109509148154,0.534093882658286,2020-03-23,2020,3
"6129","PR",4,"Sul",41038,"Paranaguá",299824,50231.5127776963,13,66,20,46,26,40,0,0,0,0,0,66,20,46,26,40,44,10.8243978533062,12.6109509148154,0.490503324907643,2020-03-30,2020,3
"6130","PR",4,"Sul",41038,"Paranaguá",299824,50231.5127776963,14,70,22,48,23,47,0,0,0,0,0,70,22,48,23,47,37,10.8243978533062,12.6109509148154,0.483907882797082,2020-04-06,2020,4
"6131","PR",4,"Sul",41038,"Paranaguá",299824,50231.5127776963,15,80,26,54,23,57,0,0,0,0,0,80,26,54,23,57,36,10.8243978533062,12.6109509148154,0.463594886502934,2020-04-13,2020,4
"6132","PR",4,"Sul",41038,"Paranaguá",299824,50231.5127776963,16,75,26,49,29,46,0,0,0,0,0,75,26,49,29,46,48,10.8243978533062,12.6109509148154,0.460766889773864,2020-04-20,2020,4
"6133","PR",4,"Sul",41038,"Paranaguá",299824,50231.5127776963,17,75,29,46,34,41,2,2,0,2,0,77,31,46,36,41,35,10.8243978533062,12.6109509148154,0.449350797702367,2020-04-27,2020,4
"6134","PR",4,"Sul",41038,"Paranaguá",299824,50231.5127776963,18,55,11,44,29,26,0,0,0,0,0,55,11,44,29,26,40,10.8243978533062,12.6109509148154,0.425639971733379,2020-05-04,2020,5
"6135","PR",4,"Sul",41038,"Paranaguá",299824,50231.5127776963,19,97,29,68,35,62,0,0,0,0,0,97,29,68,35,62,43,10.8243978533062,12.6109509148154,0.435439880718348,2020-05-11,2020,5
"6136","PR",4,"Sul",41038,"Paranaguá",299824,50231.5127776963,20,90,44,46,46,44,1,0,1,0,1,91,44,47,46,45,38,10.8243978533062,12.6109509148154,0.433723977698921,2020-05-18,2020,5
"6137","PR",4,"Sul",41038,"Paranaguá",299824,50231.5127776963,21,91,29,62,42,49,0,0,0,0,0,91,29,62,42,49,36,10.8243978533062,12.6109509148154,0.418727964852111,2020-05-25,2020,5
"6138","PR",4,"Sul",41039,"Rio Negro",101113,31733.5642376351,5,25,9,16,14,11,0,0,0,0,0,25,9,16,14,11,11,10.3651302084809,11.523993982301,0.30631124339969,2020-02-03,2020,2
"6139","PR",4,"Sul",41039,"Rio Negro",101113,31733.5642376351,6,21,5,16,4,17,0,0,0,0,0,21,5,16,4,17,6,10.3651302084809,11.523993982301,0.298176634774494,2020-02-10,2020,2
"6140","PR",4,"Sul",41039,"Rio Negro",101113,31733.5642376351,7,31,10,21,5,26,0,0,0,0,0,31,10,21,5,26,10,10.3651302084809,11.523993982301,0.321320622584943,2020-02-17,2020,2
"6141","PR",4,"Sul",41039,"Rio Negro",101113,31733.5642376351,8,20,7,13,10,10,0,0,0,0,0,20,7,13,10,10,12,10.3651302084809,11.523993982301,0.345853849813964,2020-02-24,2020,2
"6142","PR",4,"Sul",41039,"Rio Negro",101113,31733.5642376351,9,19,6,13,8,11,0,0,0,0,0,19,6,13,8,11,20,10.3651302084809,11.523993982301,0.335295169707203,2020-03-02,2020,3
"6143","PR",4,"Sul",41039,"Rio Negro",101113,31733.5642376351,10,19,7,12,6,13,0,0,0,0,0,19,7,12,6,13,9,10.3651302084809,11.523993982301,0.349427858009685,2020-03-09,2020,3
"6144","PR",4,"Sul",41039,"Rio Negro",101113,31733.5642376351,11,13,1,12,5,8,0,0,0,0,0,13,1,12,5,8,12,10.3651302084809,11.523993982301,0.429702905111341,2020-03-16,2020,3
"6145","PR",4,"Sul",41039,"Rio Negro",101113,31733.5642376351,12,14,1,13,6,8,0,0,0,0,0,14,1,13,6,8,15,10.3651302084809,11.523993982301,0.540969498073125,2020-03-23,2020,3
"6146","PR",4,"Sul",41039,"Rio Negro",101113,31733.5642376351,13,13,3,10,7,6,0,0,0,0,0,13,3,10,7,6,13,10.3651302084809,11.523993982301,0.470613639359882,2020-03-30,2020,3
"6147","PR",4,"Sul",41039,"Rio Negro",101113,31733.5642376351,14,18,5,13,8,10,0,0,0,0,0,18,5,13,8,10,12,10.3651302084809,11.523993982301,0.453237405138133,2020-04-06,2020,4
"6148","PR",4,"Sul",41039,"Rio Negro",101113,31733.5642376351,15,27,12,15,10,17,0,0,0,0,0,27,12,15,10,17,8,10.3651302084809,11.523993982301,0.429685520125432,2020-04-13,2020,4
"6149","PR",4,"Sul",41039,"Rio Negro",101113,31733.5642376351,16,30,6,24,12,18,0,0,0,0,0,30,6,24,12,18,16,10.3651302084809,11.523993982301,0.426610020973688,2020-04-20,2020,4
"6150","PR",4,"Sul",41039,"Rio Negro",101113,31733.5642376351,17,27,10,17,10,17,0,0,0,0,0,27,10,17,10,17,13,10.3651302084809,11.523993982301,0.423726470712057,2020-04-27,2020,4
"6151","PR",4,"Sul",41039,"Rio Negro",101113,31733.5642376351,18,12,3,9,5,7,0,0,0,0,0,12,3,9,5,7,10,10.3651302084809,11.523993982301,0.403477470778551,2020-05-04,2020,5
"6152","PR",4,"Sul",41039,"Rio Negro",101113,31733.5642376351,19,29,13,16,16,13,0,0,0,0,0,29,13,16,16,13,7,10.3651302084809,11.523993982301,0.416963747712351,2020-05-11,2020,5
"6153","PR",4,"Sul",41039,"Rio Negro",101113,31733.5642376351,20,19,5,14,8,11,0,0,0,0,0,19,5,14,8,11,13,10.3651302084809,11.523993982301,0.423124662052244,2020-05-18,2020,5
"6154","PR",4,"Sul",41039,"Rio Negro",101113,31733.5642376351,21,25,7,18,13,12,0,0,0,0,0,25,7,18,13,12,16,10.3651302084809,11.523993982301,0.40654328990073,2020-05-25,2020,5
"6155","RJ",3,"Sudeste",33001,"Itaperuna",209005,23234.147944786,5,38,9,29,14,24,2,0,2,1,1,40,9,31,15,25,36,10.0533783696518,12.2501134541058,0.310984839869093,2020-02-03,2020,2
"6156","RJ",3,"Sudeste",33001,"Itaperuna",209005,23234.147944786,6,40,6,34,17,23,0,0,0,0,0,40,6,34,17,23,38,10.0533783696518,12.2501134541058,0.319092806788312,2020-02-10,2020,2
"6157","RJ",3,"Sudeste",33001,"Itaperuna",209005,23234.147944786,7,32,9,23,13,19,0,0,0,0,0,32,9,23,13,19,35,10.0533783696518,12.2501134541058,0.322869100765921,2020-02-17,2020,2
"6158","RJ",3,"Sudeste",33001,"Itaperuna",209005,23234.147944786,8,43,5,38,17,26,0,0,0,0,0,43,5,38,17,26,39,10.0533783696518,12.2501134541058,0.401883610683033,2020-02-24,2020,2
"6159","RJ",3,"Sudeste",33001,"Itaperuna",209005,23234.147944786,9,36,7,29,18,18,2,1,1,1,1,38,8,30,19,19,45,10.0533783696518,12.2501134541058,0.341537491044784,2020-03-02,2020,3
"6160","RJ",3,"Sudeste",33001,"Itaperuna",209005,23234.147944786,10,39,5,34,14,25,0,0,0,0,0,39,5,34,14,25,38,10.0533783696518,12.2501134541058,0.329330023422581,2020-03-09,2020,3
"6161","RJ",3,"Sudeste",33001,"Itaperuna",209005,23234.147944786,11,40,11,29,17,23,1,1,0,0,1,41,12,29,17,24,36,10.0533783696518,12.2501134541058,0.479139617087098,2020-03-16,2020,3
"6162","RJ",3,"Sudeste",33001,"Itaperuna",209005,23234.147944786,12,30,7,23,11,19,1,0,1,0,1,31,7,24,11,20,33,10.0533783696518,12.2501134541058,0.570842117706188,2020-03-23,2020,3
"6163","RJ",3,"Sudeste",33001,"Itaperuna",209005,23234.147944786,13,37,5,32,13,24,2,1,1,1,1,39,6,33,14,25,37,10.0533783696518,12.2501134541058,0.519788196275399,2020-03-30,2020,3
"6164","RJ",3,"Sudeste",33001,"Itaperuna",209005,23234.147944786,14,42,11,31,27,15,1,1,0,0,1,43,12,31,27,16,42,10.0533783696518,12.2501134541058,0.52355596754615,2020-04-06,2020,4
"6165","RJ",3,"Sudeste",33001,"Itaperuna",209005,23234.147944786,15,36,11,25,14,22,0,0,0,0,0,36,11,25,14,22,32,10.0533783696518,12.2501134541058,0.486415395886211,2020-04-13,2020,4
"6166","RJ",3,"Sudeste",33001,"Itaperuna",209005,23234.147944786,16,55,9,46,25,30,0,0,0,0,0,55,9,46,25,30,27,10.0533783696518,12.2501134541058,0.494382595697967,2020-04-20,2020,4
"6167","RJ",3,"Sudeste",33001,"Itaperuna",209005,23234.147944786,17,39,7,32,18,21,0,0,0,0,0,39,7,32,18,21,22,10.0533783696518,12.2501134541058,0.481066621923523,2020-04-27,2020,4
"6168","RJ",3,"Sudeste",33001,"Itaperuna",209005,23234.147944786,18,45,11,34,17,28,0,0,0,0,0,45,11,34,17,28,36,10.0533783696518,12.2501134541058,0.45838372842227,2020-05-04,2020,5
"6169","RJ",3,"Sudeste",33001,"Itaperuna",209005,23234.147944786,19,52,14,38,19,33,0,0,0,0,0,52,14,38,19,33,41,10.0533783696518,12.2501134541058,0.480446140109755,2020-05-11,2020,5
"6170","RJ",3,"Sudeste",33001,"Itaperuna",209005,23234.147944786,20,59,15,44,30,29,0,0,0,0,0,59,15,44,30,29,45,10.0533783696518,12.2501134541058,0.463555616347918,2020-05-18,2020,5
"6171","RJ",3,"Sudeste",33001,"Itaperuna",209005,23234.147944786,21,49,9,40,23,26,0,0,0,0,0,49,9,40,23,26,37,10.0533783696518,12.2501134541058,0.459437923017736,2020-05-25,2020,5
"6172","RJ",3,"Sudeste",33002,"Santo Antônio de Pádua",127591,22677.2345662312,5,28,4,24,7,21,0,0,0,0,0,28,4,24,7,21,19,10.0291168177014,11.7565851144899,0.329160525389734,2020-02-03,2020,2
"6173","RJ",3,"Sudeste",33002,"Santo Antônio de Pádua",127591,22677.2345662312,6,18,4,14,5,13,1,1,0,1,0,19,5,14,6,13,23,10.0291168177014,11.7565851144899,0.329449665491872,2020-02-10,2020,2
"6174","RJ",3,"Sudeste",33002,"Santo Antônio de Pádua",127591,22677.2345662312,7,29,4,25,15,14,0,0,0,0,0,29,4,25,15,14,25,10.0291168177014,11.7565851144899,0.319241667325732,2020-02-17,2020,2
"6175","RJ",3,"Sudeste",33002,"Santo Antônio de Pádua",127591,22677.2345662312,8,18,2,16,7,11,0,0,0,0,0,18,2,16,7,11,25,10.0291168177014,11.7565851144899,0.384467979925721,2020-02-24,2020,2
"6176","RJ",3,"Sudeste",33002,"Santo Antônio de Pádua",127591,22677.2345662312,9,29,9,20,14,15,1,0,1,0,1,30,9,21,14,16,21,10.0291168177014,11.7565851144899,0.355347939115602,2020-03-02,2020,3
"6177","RJ",3,"Sudeste",33002,"Santo Antônio de Pádua",127591,22677.2345662312,10,25,5,20,12,13,1,0,1,1,0,26,5,21,13,13,23,10.0291168177014,11.7565851144899,0.346466129075074,2020-03-09,2020,3
"6178","RJ",3,"Sudeste",33002,"Santo Antônio de Pádua",127591,22677.2345662312,11,19,6,13,9,10,0,0,0,0,0,19,6,13,9,10,22,10.0291168177014,11.7565851144899,0.472078453439634,2020-03-16,2020,3
"6179","RJ",3,"Sudeste",33002,"Santo Antônio de Pádua",127591,22677.2345662312,12,18,3,15,7,11,0,0,0,0,0,18,3,15,7,11,19,10.0291168177014,11.7565851144899,0.554545077931185,2020-03-23,2020,3
"6180","RJ",3,"Sudeste",33002,"Santo Antônio de Pádua",127591,22677.2345662312,13,24,3,21,8,16,0,0,0,0,0,24,3,21,8,16,22,10.0291168177014,11.7565851144899,0.510128897327153,2020-03-30,2020,3
"6181","RJ",3,"Sudeste",33002,"Santo Antônio de Pádua",127591,22677.2345662312,14,25,4,21,11,14,0,0,0,0,0,25,4,21,11,14,19,10.0291168177014,11.7565851144899,0.485578237533385,2020-04-06,2020,4
"6182","RJ",3,"Sudeste",33002,"Santo Antônio de Pádua",127591,22677.2345662312,15,17,4,13,9,8,0,0,0,0,0,17,4,13,9,8,17,10.0291168177014,11.7565851144899,0.479146613249118,2020-04-13,2020,4
"6183","RJ",3,"Sudeste",33002,"Santo Antônio de Pádua",127591,22677.2345662312,16,29,10,19,15,14,0,0,0,0,0,29,10,19,15,14,14,10.0291168177014,11.7565851144899,0.476056148697578,2020-04-20,2020,4
"6184","RJ",3,"Sudeste",33002,"Santo Antônio de Pádua",127591,22677.2345662312,17,34,5,29,18,16,0,0,0,0,0,34,5,29,18,16,21,10.0291168177014,11.7565851144899,0.483219606006885,2020-04-27,2020,4
"6185","RJ",3,"Sudeste",33002,"Santo Antônio de Pádua",127591,22677.2345662312,18,21,2,19,9,12,0,0,0,0,0,21,2,19,9,12,31,10.0291168177014,11.7565851144899,0.445273786278049,2020-05-04,2020,5
"6186","RJ",3,"Sudeste",33002,"Santo Antônio de Pádua",127591,22677.2345662312,19,30,4,26,14,16,0,0,0,0,0,30,4,26,14,16,14,10.0291168177014,11.7565851144899,0.470925141994667,2020-05-11,2020,5
"6187","RJ",3,"Sudeste",33002,"Santo Antônio de Pádua",127591,22677.2345662312,20,29,6,23,14,15,0,0,0,0,0,29,6,23,14,15,24,10.0291168177014,11.7565851144899,0.442463065417522,2020-05-18,2020,5
"6188","RJ",3,"Sudeste",33002,"Santo Antônio de Pádua",127591,22677.2345662312,21,40,9,31,18,22,0,0,0,0,0,40,9,31,18,22,36,10.0291168177014,11.7565851144899,0.448456886903552,2020-05-25,2020,5
"6189","RJ",3,"Sudeste",33003,"Campos dos Goytacazes",641332,65598.1849077857,5,145,36,109,63,82,0,0,0,0,0,145,36,109,63,82,107,11.0913033054608,13.3713025425354,0.293330437285333,2020-02-03,2020,2
"6190","RJ",3,"Sudeste",33003,"Campos dos Goytacazes",641332,65598.1849077857,6,147,40,107,62,85,2,2,0,1,1,149,42,107,63,86,91,11.0913033054608,13.3713025425354,0.29039453569191,2020-02-10,2020,2
"6191","RJ",3,"Sudeste",33003,"Campos dos Goytacazes",641332,65598.1849077857,7,144,47,97,61,83,2,1,1,1,1,146,48,98,62,84,112,11.0913033054608,13.3713025425354,0.303059855734929,2020-02-17,2020,2
"6192","RJ",3,"Sudeste",33003,"Campos dos Goytacazes",641332,65598.1849077857,8,142,57,85,68,74,2,1,1,1,1,144,58,86,69,75,91,11.0913033054608,13.3713025425354,0.370863747562685,2020-02-24,2020,2
"6193","RJ",3,"Sudeste",33003,"Campos dos Goytacazes",641332,65598.1849077857,9,134,40,94,52,82,2,2,0,2,0,136,42,94,54,82,86,11.0913033054608,13.3713025425354,0.324903096587516,2020-03-02,2020,3
"6194","RJ",3,"Sudeste",33003,"Campos dos Goytacazes",641332,65598.1849077857,10,163,50,113,66,97,2,1,1,1,1,165,51,114,67,98,105,11.0913033054608,13.3713025425354,0.328438645343178,2020-03-09,2020,3
"6195","RJ",3,"Sudeste",33003,"Campos dos Goytacazes",641332,65598.1849077857,11,151,46,105,53,98,0,0,0,0,0,151,46,105,53,98,96,11.0913033054608,13.3713025425354,0.430925677667083,2020-03-16,2020,3
"6196","RJ",3,"Sudeste",33003,"Campos dos Goytacazes",641332,65598.1849077857,12,146,54,92,58,88,0,0,0,0,0,146,54,92,58,88,102,11.0913033054608,13.3713025425354,0.521172125283077,2020-03-23,2020,3
"6197","RJ",3,"Sudeste",33003,"Campos dos Goytacazes",641332,65598.1849077857,13,154,57,97,68,86,0,0,0,0,0,154,57,97,68,86,95,11.0913033054608,13.3713025425354,0.490034785196767,2020-03-30,2020,3
"6198","RJ",3,"Sudeste",33003,"Campos dos Goytacazes",641332,65598.1849077857,14,133,40,93,58,75,3,1,2,1,2,136,41,95,59,77,69,11.0913033054608,13.3713025425354,0.476632245533093,2020-04-06,2020,4
"6199","RJ",3,"Sudeste",33003,"Campos dos Goytacazes",641332,65598.1849077857,15,145,41,104,53,92,2,1,1,1,1,147,42,105,54,93,109,11.0913033054608,13.3713025425354,0.455064308088056,2020-04-13,2020,4
"6200","RJ",3,"Sudeste",33003,"Campos dos Goytacazes",641332,65598.1849077857,16,194,59,135,86,108,1,0,1,1,0,195,59,136,87,108,98,11.0913033054608,13.3713025425354,0.461478931621697,2020-04-20,2020,4
"6201","RJ",3,"Sudeste",33003,"Campos dos Goytacazes",641332,65598.1849077857,17,151,47,104,66,85,2,0,2,1,1,153,47,106,67,86,85,11.0913033054608,13.3713025425354,0.450109429911735,2020-04-27,2020,4
"6202","RJ",3,"Sudeste",33003,"Campos dos Goytacazes",641332,65598.1849077857,18,160,58,102,65,95,2,1,1,1,1,162,59,103,66,96,119,11.0913033054608,13.3713025425354,0.434685674793449,2020-05-04,2020,5
"6203","RJ",3,"Sudeste",33003,"Campos dos Goytacazes",641332,65598.1849077857,19,146,43,103,61,85,0,0,0,0,0,146,43,103,61,85,118,11.0913033054608,13.3713025425354,0.441356263739511,2020-05-11,2020,5
"6204","RJ",3,"Sudeste",33003,"Campos dos Goytacazes",641332,65598.1849077857,20,173,59,114,68,105,2,0,2,1,1,175,59,116,69,106,118,11.0913033054608,13.3713025425354,0.478117894425187,2020-05-18,2020,5
"6205","RJ",3,"Sudeste",33003,"Campos dos Goytacazes",641332,65598.1849077857,21,170,60,110,83,87,6,3,3,2,4,176,63,113,85,91,152,11.0913033054608,13.3713025425354,0.437969686612312,2020-05-25,2020,5
"6206","RJ",3,"Sudeste",33004,"Macaé",326611,59615.1060709835,5,74,20,54,35,39,0,0,0,0,0,74,20,54,35,39,34,10.9956642785053,12.6965251392943,0.280654723203388,2020-02-03,2020,2
"6207","RJ",3,"Sudeste",33004,"Macaé",326611,59615.1060709835,6,86,24,62,40,46,1,0,1,0,1,87,24,63,40,47,32,10.9956642785053,12.6965251392943,0.279826087581987,2020-02-10,2020,2
"6208","RJ",3,"Sudeste",33004,"Macaé",326611,59615.1060709835,7,82,14,68,30,52,1,1,0,0,1,83,15,68,30,53,26,10.9956642785053,12.6965251392943,0.294363373751478,2020-02-17,2020,2
"6209","RJ",3,"Sudeste",33004,"Macaé",326611,59615.1060709835,8,67,14,53,31,36,0,0,0,0,0,67,14,53,31,36,35,10.9956642785053,12.6965251392943,0.373495709988457,2020-02-24,2020,2
"6210","RJ",3,"Sudeste",33004,"Macaé",326611,59615.1060709835,9,78,19,59,33,45,0,0,0,0,0,78,19,59,33,45,35,10.9956642785053,12.6965251392943,0.313624031088943,2020-03-02,2020,3
"6211","RJ",3,"Sudeste",33004,"Macaé",326611,59615.1060709835,10,61,15,46,28,33,0,0,0,0,0,61,15,46,28,33,51,10.9956642785053,12.6965251392943,0.319127672697075,2020-03-09,2020,3
"6212","RJ",3,"Sudeste",33004,"Macaé",326611,59615.1060709835,11,69,14,55,28,41,1,1,0,1,0,70,15,55,29,41,42,10.9956642785053,12.6965251392943,0.431690351047468,2020-03-16,2020,3
"6213","RJ",3,"Sudeste",33004,"Macaé",326611,59615.1060709835,12,48,8,40,21,27,1,0,1,0,1,49,8,41,21,28,42,10.9956642785053,12.6965251392943,0.573974193465245,2020-03-23,2020,3
"6214","RJ",3,"Sudeste",33004,"Macaé",326611,59615.1060709835,13,72,27,45,30,42,1,0,1,0,1,73,27,46,30,43,32,10.9956642785053,12.6965251392943,0.530849146229012,2020-03-30,2020,3
"6215","RJ",3,"Sudeste",33004,"Macaé",326611,59615.1060709835,14,57,13,44,25,32,0,0,0,0,0,57,13,44,25,32,38,10.9956642785053,12.6965251392943,0.511906107331521,2020-04-06,2020,4
"6216","RJ",3,"Sudeste",33004,"Macaé",326611,59615.1060709835,15,73,21,52,31,42,1,1,0,1,0,74,22,52,32,42,40,10.9956642785053,12.6965251392943,0.487841827204957,2020-04-13,2020,4
"6217","RJ",3,"Sudeste",33004,"Macaé",326611,59615.1060709835,16,73,19,54,25,48,1,0,1,0,1,74,19,55,25,49,34,10.9956642785053,12.6965251392943,0.489757339048437,2020-04-20,2020,4
"6218","RJ",3,"Sudeste",33004,"Macaé",326611,59615.1060709835,17,91,17,74,29,62,0,0,0,0,0,91,17,74,29,62,34,10.9956642785053,12.6965251392943,0.467955786775207,2020-04-27,2020,4
"6219","RJ",3,"Sudeste",33004,"Macaé",326611,59615.1060709835,18,65,15,50,24,41,1,0,1,0,1,66,15,51,24,42,30,10.9956642785053,12.6965251392943,0.448000542865055,2020-05-04,2020,5
"6220","RJ",3,"Sudeste",33004,"Macaé",326611,59615.1060709835,19,68,18,50,17,51,0,0,0,0,0,68,18,50,17,51,37,10.9956642785053,12.6965251392943,0.464464855345236,2020-05-11,2020,5
"6221","RJ",3,"Sudeste",33004,"Macaé",326611,59615.1060709835,20,71,16,55,28,43,1,0,1,0,1,72,16,56,28,44,50,10.9956642785053,12.6965251392943,0.454127566752948,2020-05-18,2020,5
"6222","RJ",3,"Sudeste",33004,"Macaé",326611,59615.1060709835,21,73,24,49,33,40,1,0,1,0,1,74,24,50,33,41,51,10.9956642785053,12.6965251392943,0.436908637542799,2020-05-25,2020,5
"6223","RJ",3,"Sudeste",33005,"Três Rios",166154,38775.7149195927,5,30,8,22,15,15,0,0,0,0,0,30,8,22,15,15,37,10.5655494255174,12.0206703481243,0.302210560674842,2020-02-03,2020,2
"6224","RJ",3,"Sudeste",33005,"Três Rios",166154,38775.7149195927,6,28,6,22,13,15,1,0,1,1,0,29,6,23,14,15,26,10.5655494255174,12.0206703481243,0.293731780401596,2020-02-10,2020,2
"6225","RJ",3,"Sudeste",33005,"Três Rios",166154,38775.7149195927,7,26,6,20,6,20,0,0,0,0,0,26,6,20,6,20,25,10.5655494255174,12.0206703481243,0.317723593847989,2020-02-17,2020,2
"6226","RJ",3,"Sudeste",33005,"Três Rios",166154,38775.7149195927,8,41,12,29,14,27,0,0,0,0,0,41,12,29,14,27,28,10.5655494255174,12.0206703481243,0.381011220302302,2020-02-24,2020,2
"6227","RJ",3,"Sudeste",33005,"Três Rios",166154,38775.7149195927,9,29,6,23,14,15,1,0,1,0,1,30,6,24,14,16,30,10.5655494255174,12.0206703481243,0.34038171756335,2020-03-02,2020,3
"6228","RJ",3,"Sudeste",33005,"Três Rios",166154,38775.7149195927,10,42,10,32,18,24,2,0,2,0,2,44,10,34,18,26,21,10.5655494255174,12.0206703481243,0.334086757460846,2020-03-09,2020,3
"6229","RJ",3,"Sudeste",33005,"Três Rios",166154,38775.7149195927,11,32,7,25,15,17,0,0,0,0,0,32,7,25,15,17,31,10.5655494255174,12.0206703481243,0.453830243603271,2020-03-16,2020,3
"6230","RJ",3,"Sudeste",33005,"Três Rios",166154,38775.7149195927,12,28,8,20,9,19,1,1,0,1,0,29,9,20,10,19,30,10.5655494255174,12.0206703481243,0.548855106103845,2020-03-23,2020,3
"6231","RJ",3,"Sudeste",33005,"Três Rios",166154,38775.7149195927,13,41,14,27,21,20,1,0,1,1,0,42,14,28,22,20,26,10.5655494255174,12.0206703481243,0.507581017372531,2020-03-30,2020,3
"6232","RJ",3,"Sudeste",33005,"Três Rios",166154,38775.7149195927,14,41,13,28,13,28,1,1,0,1,0,42,14,28,14,28,14,10.5655494255174,12.0206703481243,0.488508185672774,2020-04-06,2020,4
"6233","RJ",3,"Sudeste",33005,"Três Rios",166154,38775.7149195927,15,33,12,21,17,16,1,1,0,1,0,34,13,21,18,16,27,10.5655494255174,12.0206703481243,0.465792559316855,2020-04-13,2020,4
"6234","RJ",3,"Sudeste",33005,"Três Rios",166154,38775.7149195927,16,36,10,26,11,25,1,0,1,1,0,37,10,27,12,25,27,10.5655494255174,12.0206703481243,0.479716025421862,2020-04-20,2020,4
"6235","RJ",3,"Sudeste",33005,"Três Rios",166154,38775.7149195927,17,35,10,25,9,26,0,0,0,0,0,35,10,25,9,26,29,10.5655494255174,12.0206703481243,0.467359099371241,2020-04-27,2020,4
"6236","RJ",3,"Sudeste",33005,"Três Rios",166154,38775.7149195927,18,38,10,28,13,25,0,0,0,0,0,38,10,28,13,25,29,10.5655494255174,12.0206703481243,0.446828750823425,2020-05-04,2020,5
"6237","RJ",3,"Sudeste",33005,"Três Rios",166154,38775.7149195927,19,42,15,27,22,20,0,0,0,0,0,42,15,27,22,20,31,10.5655494255174,12.0206703481243,0.464561767372877,2020-05-11,2020,5
"6238","RJ",3,"Sudeste",33005,"Três Rios",166154,38775.7149195927,20,33,13,20,13,20,1,1,0,1,0,34,14,20,14,20,24,10.5655494255174,12.0206703481243,0.451723194517114,2020-05-18,2020,5
"6239","RJ",3,"Sudeste",33005,"Três Rios",166154,38775.7149195927,21,40,12,28,18,22,0,0,0,0,0,40,12,28,18,22,33,10.5655494255174,12.0206703481243,0.443352032097154,2020-05-25,2020,5
"6240","RJ",3,"Sudeste",33006,"Cantagalo-Cordeiro",66862,27927.4142599683,5,14,6,8,5,9,0,0,0,0,0,14,6,8,5,9,13,10.237364075347,11.1103860727783,0.33037659970215,2020-02-03,2020,2
"6241","RJ",3,"Sudeste",33006,"Cantagalo-Cordeiro",66862,27927.4142599683,6,17,5,12,5,12,0,0,0,0,0,17,5,12,5,12,7,10.237364075347,11.1103860727783,0.316925472482817,2020-02-10,2020,2
"6242","RJ",3,"Sudeste",33006,"Cantagalo-Cordeiro",66862,27927.4142599683,7,11,5,6,5,6,1,0,1,0,1,12,5,7,5,7,8,10.237364075347,11.1103860727783,0.315204247639724,2020-02-17,2020,2
"6243","RJ",3,"Sudeste",33006,"Cantagalo-Cordeiro",66862,27927.4142599683,8,22,5,17,11,11,0,0,0,0,0,22,5,17,11,11,17,10.237364075347,11.1103860727783,0.390154990327854,2020-02-24,2020,2
"6244","RJ",3,"Sudeste",33006,"Cantagalo-Cordeiro",66862,27927.4142599683,9,13,3,10,4,9,0,0,0,0,0,13,3,10,4,9,12,10.237364075347,11.1103860727783,0.365357562682207,2020-03-02,2020,3
"6245","RJ",3,"Sudeste",33006,"Cantagalo-Cordeiro",66862,27927.4142599683,10,10,5,5,3,7,0,0,0,0,0,10,5,5,3,7,11,10.237364075347,11.1103860727783,0.346346372236069,2020-03-09,2020,3
"6246","RJ",3,"Sudeste",33006,"Cantagalo-Cordeiro",66862,27927.4142599683,11,14,2,12,7,7,0,0,0,0,0,14,2,12,7,7,12,10.237364075347,11.1103860727783,0.465995211869466,2020-03-16,2020,3
"6247","RJ",3,"Sudeste",33006,"Cantagalo-Cordeiro",66862,27927.4142599683,12,11,3,8,5,6,0,0,0,0,0,11,3,8,5,6,8,10.237364075347,11.1103860727783,0.555495347826408,2020-03-23,2020,3
"6248","RJ",3,"Sudeste",33006,"Cantagalo-Cordeiro",66862,27927.4142599683,13,13,3,10,4,9,0,0,0,0,0,13,3,10,4,9,7,10.237364075347,11.1103860727783,0.511118095337927,2020-03-30,2020,3
"6249","RJ",3,"Sudeste",33006,"Cantagalo-Cordeiro",66862,27927.4142599683,14,19,3,16,5,14,0,0,0,0,0,19,3,16,5,14,2,10.237364075347,11.1103860727783,0.509497221865321,2020-04-06,2020,4
"6250","RJ",3,"Sudeste",33006,"Cantagalo-Cordeiro",66862,27927.4142599683,15,12,2,10,2,10,1,0,1,0,1,13,2,11,2,11,6,10.237364075347,11.1103860727783,0.471262933606173,2020-04-13,2020,4
"6251","RJ",3,"Sudeste",33006,"Cantagalo-Cordeiro",66862,27927.4142599683,16,15,3,12,5,10,0,0,0,0,0,15,3,12,5,10,5,10.237364075347,11.1103860727783,0.500336408724248,2020-04-20,2020,4
"6252","RJ",3,"Sudeste",33006,"Cantagalo-Cordeiro",66862,27927.4142599683,17,17,2,15,8,9,0,0,0,0,0,17,2,15,8,9,4,10.237364075347,11.1103860727783,0.485775188045579,2020-04-27,2020,4
"6253","RJ",3,"Sudeste",33006,"Cantagalo-Cordeiro",66862,27927.4142599683,18,17,7,10,10,7,0,0,0,0,0,17,7,10,10,7,5,10.237364075347,11.1103860727783,0.468669037068336,2020-05-04,2020,5
"6254","RJ",3,"Sudeste",33006,"Cantagalo-Cordeiro",66862,27927.4142599683,19,16,3,13,7,9,0,0,0,0,0,16,3,13,7,9,16,10.237364075347,11.1103860727783,0.476832860315449,2020-05-11,2020,5
"6255","RJ",3,"Sudeste",33006,"Cantagalo-Cordeiro",66862,27927.4142599683,20,12,2,10,5,7,0,0,0,0,0,12,2,10,5,7,12,10.237364075347,11.1103860727783,0.468260307746401,2020-05-18,2020,5
"6256","RJ",3,"Sudeste",33006,"Cantagalo-Cordeiro",66862,27927.4142599683,21,14,1,13,4,10,0,0,0,0,0,14,1,13,4,10,8,10.237364075347,11.1103860727783,0.477221468333967,2020-05-25,2020,5
"6257","RJ",3,"Sudeste",33007,"Nova Friburgo",245969,26777.280999191,5,39,13,26,11,28,1,1,0,0,1,40,14,26,11,29,34,10.1953090830671,12.4129607907136,0.302544610874479,2020-02-03,2020,2
"6258","RJ",3,"Sudeste",33007,"Nova Friburgo",245969,26777.280999191,6,36,19,17,17,19,1,1,0,0,1,37,20,17,17,20,37,10.1953090830671,12.4129607907136,0.302809573201515,2020-02-10,2020,2
"6259","RJ",3,"Sudeste",33007,"Nova Friburgo",245969,26777.280999191,7,27,8,19,9,18,1,0,1,1,0,28,8,20,10,18,42,10.1953090830671,12.4129607907136,0.297884154432622,2020-02-17,2020,2
"6260","RJ",3,"Sudeste",33007,"Nova Friburgo",245969,26777.280999191,8,38,19,19,8,30,1,1,0,0,1,39,20,19,8,31,33,10.1953090830671,12.4129607907136,0.380476643782659,2020-02-24,2020,2
"6261","RJ",3,"Sudeste",33007,"Nova Friburgo",245969,26777.280999191,9,50,17,33,24,26,0,0,0,0,0,50,17,33,24,26,54,10.1953090830671,12.4129607907136,0.337681065588993,2020-03-02,2020,3
"6262","RJ",3,"Sudeste",33007,"Nova Friburgo",245969,26777.280999191,10,53,19,34,21,32,1,1,0,0,1,54,20,34,21,33,39,10.1953090830671,12.4129607907136,0.333249418758864,2020-03-09,2020,3
"6263","RJ",3,"Sudeste",33007,"Nova Friburgo",245969,26777.280999191,11,34,11,23,17,17,0,0,0,0,0,34,11,23,17,17,36,10.1953090830671,12.4129607907136,0.455387666009403,2020-03-16,2020,3
"6264","RJ",3,"Sudeste",33007,"Nova Friburgo",245969,26777.280999191,12,44,12,32,11,33,0,0,0,0,0,44,12,32,11,33,32,10.1953090830671,12.4129607907136,0.585418317133216,2020-03-23,2020,3
"6265","RJ",3,"Sudeste",33007,"Nova Friburgo",245969,26777.280999191,13,39,22,17,15,24,0,0,0,0,0,39,22,17,15,24,45,10.1953090830671,12.4129607907136,0.540241685563503,2020-03-30,2020,3
"6266","RJ",3,"Sudeste",33007,"Nova Friburgo",245969,26777.280999191,14,34,15,19,14,20,1,0,1,1,0,35,15,20,15,20,34,10.1953090830671,12.4129607907136,0.527183097806903,2020-04-06,2020,4
"6267","RJ",3,"Sudeste",33007,"Nova Friburgo",245969,26777.280999191,15,44,22,22,12,32,1,1,0,0,1,45,23,22,12,33,47,10.1953090830671,12.4129607907136,0.486834239137963,2020-04-13,2020,4
"6268","RJ",3,"Sudeste",33007,"Nova Friburgo",245969,26777.280999191,16,49,21,28,18,31,0,0,0,0,0,49,21,28,18,31,43,10.1953090830671,12.4129607907136,0.493484180946685,2020-04-20,2020,4
"6269","RJ",3,"Sudeste",33007,"Nova Friburgo",245969,26777.280999191,17,34,10,24,11,23,0,0,0,0,0,34,10,24,11,23,43,10.1953090830671,12.4129607907136,0.488812448871425,2020-04-27,2020,4
"6270","RJ",3,"Sudeste",33007,"Nova Friburgo",245969,26777.280999191,18,28,9,19,10,18,1,1,0,0,1,29,10,19,10,19,42,10.1953090830671,12.4129607907136,0.461920234098771,2020-05-04,2020,5
"6271","RJ",3,"Sudeste",33007,"Nova Friburgo",245969,26777.280999191,19,26,9,17,10,16,0,0,0,0,0,26,9,17,10,16,43,10.1953090830671,12.4129607907136,0.475994947921644,2020-05-11,2020,5
"6272","RJ",3,"Sudeste",33007,"Nova Friburgo",245969,26777.280999191,20,35,15,20,11,24,0,0,0,0,0,35,15,20,11,24,41,10.1953090830671,12.4129607907136,0.465044135507028,2020-05-18,2020,5
"6273","RJ",3,"Sudeste",33007,"Nova Friburgo",245969,26777.280999191,21,30,13,17,12,18,0,0,0,0,0,30,13,17,12,18,57,10.1953090830671,12.4129607907136,0.444215782403689,2020-05-25,2020,5
"6274","RJ",3,"Sudeste",33008,"Santa Maria Madalena",30419,19131.8568184358,5,4,1,3,1,3,0,0,0,0,0,4,1,3,1,3,1,9.85911012089365,10.3228226921632,0.291443261040525,2020-02-03,2020,2
"6275","RJ",3,"Sudeste",33008,"Santa Maria Madalena",30419,19131.8568184358,6,3,1,2,1,2,0,0,0,0,0,3,1,2,1,2,1,9.85911012089365,10.3228226921632,0.280669029427912,2020-02-10,2020,2
"6276","RJ",3,"Sudeste",33008,"Santa Maria Madalena",30419,19131.8568184358,7,2,0,2,1,1,0,0,0,0,0,2,0,2,1,1,6,9.85911012089365,10.3228226921632,0.310684334422873,2020-02-17,2020,2
"6277","RJ",3,"Sudeste",33008,"Santa Maria Madalena",30419,19131.8568184358,8,3,0,3,0,3,0,0,0,0,0,3,0,3,0,3,9,9.85911012089365,10.3228226921632,0.35030677764691,2020-02-24,2020,2
"6278","RJ",3,"Sudeste",33008,"Santa Maria Madalena",30419,19131.8568184358,9,6,2,4,2,4,0,0,0,0,0,6,2,4,2,4,6,9.85911012089365,10.3228226921632,0.313946203357483,2020-03-02,2020,3
"6279","RJ",3,"Sudeste",33008,"Santa Maria Madalena",30419,19131.8568184358,10,3,0,3,2,1,0,0,0,0,0,3,0,3,2,1,2,9.85911012089365,10.3228226921632,0.311602685188554,2020-03-09,2020,3
"6280","RJ",3,"Sudeste",33008,"Santa Maria Madalena",30419,19131.8568184358,11,6,3,3,3,3,0,0,0,0,0,6,3,3,3,3,4,9.85911012089365,10.3228226921632,0.422832464916666,2020-03-16,2020,3
"6281","RJ",3,"Sudeste",33008,"Santa Maria Madalena",30419,19131.8568184358,12,6,2,4,2,4,0,0,0,0,0,6,2,4,2,4,7,9.85911012089365,10.3228226921632,0.520607804116001,2020-03-23,2020,3
"6282","RJ",3,"Sudeste",33008,"Santa Maria Madalena",30419,19131.8568184358,13,1,0,1,1,0,0,0,0,0,0,1,0,1,1,0,1,9.85911012089365,10.3228226921632,0.477106102033869,2020-03-30,2020,3
"6283","RJ",3,"Sudeste",33008,"Santa Maria Madalena",30419,19131.8568184358,14,4,2,2,3,1,0,0,0,0,0,4,2,2,3,1,2,9.85911012089365,10.3228226921632,0.457169733880163,2020-04-06,2020,4
"6284","RJ",3,"Sudeste",33008,"Santa Maria Madalena",30419,19131.8568184358,15,4,1,3,2,2,0,0,0,0,0,4,1,3,2,2,2,9.85911012089365,10.3228226921632,0.439406784907519,2020-04-13,2020,4
"6285","RJ",3,"Sudeste",33008,"Santa Maria Madalena",30419,19131.8568184358,16,2,1,1,0,2,0,0,0,0,0,2,1,1,0,2,1,9.85911012089365,10.3228226921632,0.449853125511938,2020-04-20,2020,4
"6286","RJ",3,"Sudeste",33008,"Santa Maria Madalena",30419,19131.8568184358,17,3,1,2,2,1,0,0,0,0,0,3,1,2,2,1,3,9.85911012089365,10.3228226921632,0.470071343041447,2020-04-27,2020,4
"6287","RJ",3,"Sudeste",33008,"Santa Maria Madalena",30419,19131.8568184358,18,6,1,5,4,2,0,0,0,0,0,6,1,5,4,2,6,9.85911012089365,10.3228226921632,0.424187628297394,2020-05-04,2020,5
"6288","RJ",3,"Sudeste",33008,"Santa Maria Madalena",30419,19131.8568184358,19,4,0,4,2,2,0,0,0,0,0,4,0,4,2,2,7,9.85911012089365,10.3228226921632,0.433671950469045,2020-05-11,2020,5
"6289","RJ",3,"Sudeste",33008,"Santa Maria Madalena",30419,19131.8568184358,20,4,1,3,2,2,0,0,0,0,0,4,1,3,2,2,3,9.85911012089365,10.3228226921632,0.413401005893708,2020-05-18,2020,5
"6290","RJ",3,"Sudeste",33008,"Santa Maria Madalena",30419,19131.8568184358,21,5,2,3,1,4,0,0,0,0,0,5,2,3,1,4,7,9.85911012089365,10.3228226921632,0.414031385139833,2020-05-25,2020,5
"6291","RJ",3,"Sudeste",33009,"Bacia de São João",222008,53445.9288615726,5,34,9,25,14,20,0,0,0,0,0,34,9,25,14,20,33,10.8864257463226,12.3104686962412,0.295435180874134,2020-02-03,2020,2
"6292","RJ",3,"Sudeste",33009,"Bacia de São João",222008,53445.9288615726,6,32,7,25,8,24,1,0,1,0,1,33,7,26,8,25,28,10.8864257463226,12.3104686962412,0.288002925785943,2020-02-10,2020,2
"6293","RJ",3,"Sudeste",33009,"Bacia de São João",222008,53445.9288615726,7,52,12,40,17,35,0,0,0,0,0,52,12,40,17,35,26,10.8864257463226,12.3104686962412,0.306585864091152,2020-02-17,2020,2
"6294","RJ",3,"Sudeste",33009,"Bacia de São João",222008,53445.9288615726,8,30,7,23,11,19,1,0,1,1,0,31,7,24,12,19,22,10.8864257463226,12.3104686962412,0.384530964542845,2020-02-24,2020,2
"6295","RJ",3,"Sudeste",33009,"Bacia de São João",222008,53445.9288615726,9,36,7,29,9,27,0,0,0,0,0,36,7,29,9,27,26,10.8864257463226,12.3104686962412,0.3311362700901,2020-03-02,2020,3
"6296","RJ",3,"Sudeste",33009,"Bacia de São João",222008,53445.9288615726,10,24,3,21,5,19,1,1,0,0,1,25,4,21,5,20,25,10.8864257463226,12.3104686962412,0.329598083210885,2020-03-09,2020,3
"6297","RJ",3,"Sudeste",33009,"Bacia de São João",222008,53445.9288615726,11,29,4,25,10,19,0,0,0,0,0,29,4,25,10,19,25,10.8864257463226,12.3104686962412,0.450809722509114,2020-03-16,2020,3
"6298","RJ",3,"Sudeste",33009,"Bacia de São João",222008,53445.9288615726,12,32,10,22,11,21,0,0,0,0,0,32,10,22,11,21,33,10.8864257463226,12.3104686962412,0.567833167581431,2020-03-23,2020,3
"6299","RJ",3,"Sudeste",33009,"Bacia de São João",222008,53445.9288615726,13,27,4,23,11,16,0,0,0,0,0,27,4,23,11,16,32,10.8864257463226,12.3104686962412,0.532070794117589,2020-03-30,2020,3
"6300","RJ",3,"Sudeste",33009,"Bacia de São João",222008,53445.9288615726,14,33,6,27,10,23,0,0,0,0,0,33,6,27,10,23,27,10.8864257463226,12.3104686962412,0.5145313048855,2020-04-06,2020,4
"6301","RJ",3,"Sudeste",33009,"Bacia de São João",222008,53445.9288615726,15,41,5,36,10,31,0,0,0,0,0,41,5,36,10,31,34,10.8864257463226,12.3104686962412,0.495928370837935,2020-04-13,2020,4
"6302","RJ",3,"Sudeste",33009,"Bacia de São João",222008,53445.9288615726,16,46,7,39,9,37,0,0,0,0,0,46,7,39,9,37,18,10.8864257463226,12.3104686962412,0.495836357368256,2020-04-20,2020,4
"6303","RJ",3,"Sudeste",33009,"Bacia de São João",222008,53445.9288615726,17,36,8,28,13,23,0,0,0,0,0,36,8,28,13,23,42,10.8864257463226,12.3104686962412,0.481325023000233,2020-04-27,2020,4
"6304","RJ",3,"Sudeste",33009,"Bacia de São João",222008,53445.9288615726,18,36,8,28,15,21,0,0,0,0,0,36,8,28,15,21,38,10.8864257463226,12.3104686962412,0.466322994394617,2020-05-04,2020,5
"6305","RJ",3,"Sudeste",33009,"Bacia de São João",222008,53445.9288615726,19,29,8,21,11,18,1,1,0,0,1,30,9,21,11,19,29,10.8864257463226,12.3104686962412,0.473516723476982,2020-05-11,2020,5
"6306","RJ",3,"Sudeste",33009,"Bacia de São João",222008,53445.9288615726,20,28,7,21,12,16,1,0,1,0,1,29,7,22,12,17,27,10.8864257463226,12.3104686962412,0.45807741470402,2020-05-18,2020,5
"6307","RJ",3,"Sudeste",33009,"Bacia de São João",222008,53445.9288615726,21,51,7,44,22,29,0,0,0,0,0,51,7,44,22,29,32,10.8864257463226,12.3104686962412,0.446869915869695,2020-05-25,2020,5
"6308","RJ",3,"Sudeste",33010,"Lagos",655210,36823.6268814579,5,136,37,99,52,84,2,2,0,1,1,138,39,99,53,85,87,10.5138949529631,13.3927110739198,0.293382025396461,2020-02-03,2020,2
"6309","RJ",3,"Sudeste",33010,"Lagos",655210,36823.6268814579,6,159,38,121,59,100,3,1,2,1,2,162,39,123,60,102,97,10.5138949529631,13.3927110739198,0.29857688264816,2020-02-10,2020,2
"6310","RJ",3,"Sudeste",33010,"Lagos",655210,36823.6268814579,7,144,34,110,56,88,1,1,0,0,1,145,35,110,56,89,99,10.5138949529631,13.3927110739198,0.309367658794189,2020-02-17,2020,2
"6311","RJ",3,"Sudeste",33010,"Lagos",655210,36823.6268814579,8,145,44,101,62,83,1,0,1,0,1,146,44,102,62,84,77,10.5138949529631,13.3927110739198,0.378288250016509,2020-02-24,2020,2
"6312","RJ",3,"Sudeste",33010,"Lagos",655210,36823.6268814579,9,156,51,105,71,85,4,2,2,1,3,160,53,107,72,88,101,10.5138949529631,13.3927110739198,0.338735751541557,2020-03-02,2020,3
"6313","RJ",3,"Sudeste",33010,"Lagos",655210,36823.6268814579,10,167,44,123,65,102,0,0,0,0,0,167,44,123,65,102,91,10.5138949529631,13.3927110739198,0.334873510375102,2020-03-09,2020,3
"6314","RJ",3,"Sudeste",33010,"Lagos",655210,36823.6268814579,11,150,48,102,57,93,2,1,1,0,2,152,49,103,57,95,98,10.5138949529631,13.3927110739198,0.453103942901495,2020-03-16,2020,3
"6315","RJ",3,"Sudeste",33010,"Lagos",655210,36823.6268814579,12,127,32,95,42,85,0,0,0,0,0,127,32,95,42,85,98,10.5138949529631,13.3927110739198,0.551892116539071,2020-03-23,2020,3
"6316","RJ",3,"Sudeste",33010,"Lagos",655210,36823.6268814579,13,157,49,108,72,85,3,1,2,2,1,160,50,110,74,86,86,10.5138949529631,13.3927110739198,0.512963589383401,2020-03-30,2020,3
"6317","RJ",3,"Sudeste",33010,"Lagos",655210,36823.6268814579,14,145,40,105,52,93,0,0,0,0,0,145,40,105,52,93,99,10.5138949529631,13.3927110739198,0.505575745744669,2020-04-06,2020,4
"6318","RJ",3,"Sudeste",33010,"Lagos",655210,36823.6268814579,15,131,38,93,58,73,2,2,0,1,1,133,40,93,59,74,96,10.5138949529631,13.3927110739198,0.485507500748792,2020-04-13,2020,4
"6319","RJ",3,"Sudeste",33010,"Lagos",655210,36823.6268814579,16,123,36,87,49,74,1,1,0,1,0,124,37,87,50,74,99,10.5138949529631,13.3927110739198,0.489576617397767,2020-04-20,2020,4
"6320","RJ",3,"Sudeste",33010,"Lagos",655210,36823.6268814579,17,168,59,109,67,101,1,0,1,1,0,169,59,110,68,101,125,10.5138949529631,13.3927110739198,0.476743778207399,2020-04-27,2020,4
"6321","RJ",3,"Sudeste",33010,"Lagos",655210,36823.6268814579,18,133,43,90,52,81,1,1,0,1,0,134,44,90,53,81,142,10.5138949529631,13.3927110739198,0.460573633568528,2020-05-04,2020,5
"6322","RJ",3,"Sudeste",33010,"Lagos",655210,36823.6268814579,19,154,42,112,55,99,3,1,2,0,3,157,43,114,55,102,141,10.5138949529631,13.3927110739198,0.476489414759716,2020-05-11,2020,5
"6323","RJ",3,"Sudeste",33010,"Lagos",655210,36823.6268814579,20,152,38,114,59,93,0,0,0,0,0,152,38,114,59,93,133,10.5138949529631,13.3927110739198,0.46252994752228,2020-05-18,2020,5
"6324","RJ",3,"Sudeste",33010,"Lagos",655210,36823.6268814579,21,163,40,123,63,100,3,1,2,0,3,166,41,125,63,103,107,10.5138949529631,13.3927110739198,0.445194583870755,2020-05-25,2020,5
"6325","RJ",3,"Sudeste",33011,"Vale do Paraíba Fluminense",731120,52903.4399758726,5,139,25,114,42,97,1,0,1,1,0,140,25,115,43,97,106,10.8762236436315,13.5023328839461,0.281621045205615,2020-02-03,2020,2
"6326","RJ",3,"Sudeste",33011,"Vale do Paraíba Fluminense",731120,52903.4399758726,6,161,34,127,51,110,1,1,0,0,1,162,35,127,51,111,96,10.8762236436315,13.5023328839461,0.285520765452435,2020-02-10,2020,2
"6327","RJ",3,"Sudeste",33011,"Vale do Paraíba Fluminense",731120,52903.4399758726,7,138,27,111,38,100,1,0,1,0,1,139,27,112,38,101,132,10.8762236436315,13.5023328839461,0.299268763157355,2020-02-17,2020,2
"6328","RJ",3,"Sudeste",33011,"Vale do Paraíba Fluminense",731120,52903.4399758726,8,133,23,110,46,87,0,0,0,0,0,133,23,110,46,87,114,10.8762236436315,13.5023328839461,0.377163064836793,2020-02-24,2020,2
"6329","RJ",3,"Sudeste",33011,"Vale do Paraíba Fluminense",731120,52903.4399758726,9,146,37,109,49,97,1,0,1,0,1,147,37,110,49,98,133,10.8762236436315,13.5023328839461,0.311106815445521,2020-03-02,2020,3
"6330","RJ",3,"Sudeste",33011,"Vale do Paraíba Fluminense",731120,52903.4399758726,10,158,35,123,50,108,0,0,0,0,0,158,35,123,50,108,125,10.8762236436315,13.5023328839461,0.325406714725632,2020-03-09,2020,3
"6331","RJ",3,"Sudeste",33011,"Vale do Paraíba Fluminense",731120,52903.4399758726,11,133,26,107,39,94,2,0,2,1,1,135,26,109,40,95,113,10.8762236436315,13.5023328839461,0.445097521954578,2020-03-16,2020,3
"6332","RJ",3,"Sudeste",33011,"Vale do Paraíba Fluminense",731120,52903.4399758726,12,144,29,115,49,95,3,0,3,2,1,147,29,118,51,96,120,10.8762236436315,13.5023328839461,0.557429877310289,2020-03-23,2020,3
"6333","RJ",3,"Sudeste",33011,"Vale do Paraíba Fluminense",731120,52903.4399758726,13,132,42,90,64,68,2,0,2,1,1,134,42,92,65,69,107,10.8762236436315,13.5023328839461,0.517395740496137,2020-03-30,2020,3
"6334","RJ",3,"Sudeste",33011,"Vale do Paraíba Fluminense",731120,52903.4399758726,14,128,20,108,48,80,1,0,1,0,1,129,20,109,48,81,89,10.8762236436315,13.5023328839461,0.509182952371216,2020-04-06,2020,4
"6335","RJ",3,"Sudeste",33011,"Vale do Paraíba Fluminense",731120,52903.4399758726,15,137,32,105,53,84,1,0,1,1,0,138,32,106,54,84,123,10.8762236436315,13.5023328839461,0.48626809798929,2020-04-13,2020,4
"6336","RJ",3,"Sudeste",33011,"Vale do Paraíba Fluminense",731120,52903.4399758726,16,143,27,116,48,95,1,0,1,0,1,144,27,117,48,96,101,10.8762236436315,13.5023328839461,0.497235763717095,2020-04-20,2020,4
"6337","RJ",3,"Sudeste",33011,"Vale do Paraíba Fluminense",731120,52903.4399758726,17,153,29,124,55,98,2,1,1,1,1,155,30,125,56,99,107,10.8762236436315,13.5023328839461,0.469859132272439,2020-04-27,2020,4
"6338","RJ",3,"Sudeste",33011,"Vale do Paraíba Fluminense",731120,52903.4399758726,18,133,26,107,42,91,1,0,1,1,0,134,26,108,43,91,126,10.8762236436315,13.5023328839461,0.436411671366031,2020-05-04,2020,5
"6339","RJ",3,"Sudeste",33011,"Vale do Paraíba Fluminense",731120,52903.4399758726,19,143,21,122,47,96,0,0,0,0,0,143,21,122,47,96,141,10.8762236436315,13.5023328839461,0.448625824539507,2020-05-11,2020,5
"6340","RJ",3,"Sudeste",33011,"Vale do Paraíba Fluminense",731120,52903.4399758726,20,161,42,119,61,100,0,0,0,0,0,161,42,119,61,100,118,10.8762236436315,13.5023328839461,0.443144084479793,2020-05-18,2020,5
"6341","RJ",3,"Sudeste",33011,"Vale do Paraíba Fluminense",731120,52903.4399758726,21,164,47,117,62,102,0,0,0,0,0,164,47,117,62,102,152,10.8762236436315,13.5023328839461,0.429531148997455,2020-05-25,2020,5
"6342","RJ",3,"Sudeste",33012,"Barra do Piraí",186977,26059.9134659878,5,32,7,25,15,17,0,0,0,0,0,32,7,25,15,17,30,10.1681535301049,12.1387408936199,0.303464806310876,2020-02-03,2020,2
"6343","RJ",3,"Sudeste",33012,"Barra do Piraí",186977,26059.9134659878,6,34,13,21,18,16,0,0,0,0,0,34,13,21,18,16,40,10.1681535301049,12.1387408936199,0.295409240366503,2020-02-10,2020,2
"6344","RJ",3,"Sudeste",33012,"Barra do Piraí",186977,26059.9134659878,7,29,10,19,8,21,1,0,1,1,0,30,10,20,9,21,24,10.1681535301049,12.1387408936199,0.307157180196292,2020-02-17,2020,2
"6345","RJ",3,"Sudeste",33012,"Barra do Piraí",186977,26059.9134659878,8,39,16,23,22,17,0,0,0,0,0,39,16,23,22,17,34,10.1681535301049,12.1387408936199,0.382210603515173,2020-02-24,2020,2
"6346","RJ",3,"Sudeste",33012,"Barra do Piraí",186977,26059.9134659878,9,24,3,21,7,17,0,0,0,0,0,24,3,21,7,17,39,10.1681535301049,12.1387408936199,0.334336936709627,2020-03-02,2020,3
"6347","RJ",3,"Sudeste",33012,"Barra do Piraí",186977,26059.9134659878,10,44,9,35,17,27,0,0,0,0,0,44,9,35,17,27,29,10.1681535301049,12.1387408936199,0.349451034531977,2020-03-09,2020,3
"6348","RJ",3,"Sudeste",33012,"Barra do Piraí",186977,26059.9134659878,11,19,3,16,4,15,0,0,0,0,0,19,3,16,4,15,28,10.1681535301049,12.1387408936199,0.451857723350636,2020-03-16,2020,3
"6349","RJ",3,"Sudeste",33012,"Barra do Piraí",186977,26059.9134659878,12,24,4,20,12,12,1,0,1,1,0,25,4,21,13,12,33,10.1681535301049,12.1387408936199,0.555250059117933,2020-03-23,2020,3
"6350","RJ",3,"Sudeste",33012,"Barra do Piraí",186977,26059.9134659878,13,35,11,24,17,18,0,0,0,0,0,35,11,24,17,18,26,10.1681535301049,12.1387408936199,0.505231721121023,2020-03-30,2020,3
"6351","RJ",3,"Sudeste",33012,"Barra do Piraí",186977,26059.9134659878,14,43,13,30,18,25,0,0,0,0,0,43,13,30,18,25,25,10.1681535301049,12.1387408936199,0.504383023513108,2020-04-06,2020,4
"6352","RJ",3,"Sudeste",33012,"Barra do Piraí",186977,26059.9134659878,15,33,5,28,12,21,0,0,0,0,0,33,5,28,12,21,29,10.1681535301049,12.1387408936199,0.486519407578043,2020-04-13,2020,4
"6353","RJ",3,"Sudeste",33012,"Barra do Piraí",186977,26059.9134659878,16,38,9,29,16,22,0,0,0,0,0,38,9,29,16,22,29,10.1681535301049,12.1387408936199,0.488203291046114,2020-04-20,2020,4
"6354","RJ",3,"Sudeste",33012,"Barra do Piraí",186977,26059.9134659878,17,43,12,31,26,17,1,0,1,0,1,44,12,32,26,18,22,10.1681535301049,12.1387408936199,0.468983323158847,2020-04-27,2020,4
"6355","RJ",3,"Sudeste",33012,"Barra do Piraí",186977,26059.9134659878,18,39,11,28,19,20,0,0,0,0,0,39,11,28,19,20,31,10.1681535301049,12.1387408936199,0.451627390005143,2020-05-04,2020,5
"6356","RJ",3,"Sudeste",33012,"Barra do Piraí",186977,26059.9134659878,19,37,9,28,14,23,0,0,0,0,0,37,9,28,14,23,36,10.1681535301049,12.1387408936199,0.467748397550452,2020-05-11,2020,5
"6357","RJ",3,"Sudeste",33012,"Barra do Piraí",186977,26059.9134659878,20,41,6,35,13,28,0,0,0,0,0,41,6,35,13,28,41,10.1681535301049,12.1387408936199,0.455202465903288,2020-05-18,2020,5
"6358","RJ",3,"Sudeste",33012,"Barra do Piraí",186977,26059.9134659878,21,46,12,34,19,27,1,1,0,1,0,47,13,34,20,27,30,10.1681535301049,12.1387408936199,0.435937629815784,2020-05-25,2020,5
"6359","RJ",3,"Sudeste",33013,"Baía da Ilha Grande",250724,47527.6075633765,5,52,18,34,19,33,1,1,0,0,1,53,19,34,19,34,20,10.7690660330451,12.4321080115149,0.305232144280889,2020-02-03,2020,2
"6360","RJ",3,"Sudeste",33013,"Baía da Ilha Grande",250724,47527.6075633765,6,49,16,33,25,24,3,1,2,1,2,52,17,35,26,26,25,10.7690660330451,12.4321080115149,0.299940676990392,2020-02-10,2020,2
"6361","RJ",3,"Sudeste",33013,"Baía da Ilha Grande",250724,47527.6075633765,7,46,17,29,17,29,1,0,1,0,1,47,17,30,17,30,27,10.7690660330451,12.4321080115149,0.303018666089462,2020-02-17,2020,2
"6362","RJ",3,"Sudeste",33013,"Baía da Ilha Grande",250724,47527.6075633765,8,59,21,38,28,31,0,0,0,0,0,59,21,38,28,31,31,10.7690660330451,12.4321080115149,0.375967702190626,2020-02-24,2020,2
"6363","RJ",3,"Sudeste",33013,"Baía da Ilha Grande",250724,47527.6075633765,9,43,13,30,20,23,0,0,0,0,0,43,13,30,20,23,24,10.7690660330451,12.4321080115149,0.332956409141826,2020-03-02,2020,3
"6364","RJ",3,"Sudeste",33013,"Baía da Ilha Grande",250724,47527.6075633765,10,47,15,32,16,31,0,0,0,0,0,47,15,32,16,31,30,10.7690660330451,12.4321080115149,0.335934110779959,2020-03-09,2020,3
"6365","RJ",3,"Sudeste",33013,"Baía da Ilha Grande",250724,47527.6075633765,11,46,16,30,17,29,0,0,0,0,0,46,16,30,17,29,24,10.7690660330451,12.4321080115149,0.457608906596291,2020-03-16,2020,3
"6366","RJ",3,"Sudeste",33013,"Baía da Ilha Grande",250724,47527.6075633765,12,43,8,35,17,26,3,1,2,1,2,46,9,37,18,28,25,10.7690660330451,12.4321080115149,0.544541147526508,2020-03-23,2020,3
"6367","RJ",3,"Sudeste",33013,"Baía da Ilha Grande",250724,47527.6075633765,13,53,18,35,17,36,0,0,0,0,0,53,18,35,17,36,33,10.7690660330451,12.4321080115149,0.512871515253231,2020-03-30,2020,3
"6368","RJ",3,"Sudeste",33013,"Baía da Ilha Grande",250724,47527.6075633765,14,43,7,36,16,27,0,0,0,0,0,43,7,36,16,27,19,10.7690660330451,12.4321080115149,0.505908517595427,2020-04-06,2020,4
"6369","RJ",3,"Sudeste",33013,"Baía da Ilha Grande",250724,47527.6075633765,15,48,16,32,21,27,2,1,1,1,1,50,17,33,22,28,37,10.7690660330451,12.4321080115149,0.49042924148697,2020-04-13,2020,4
"6370","RJ",3,"Sudeste",33013,"Baía da Ilha Grande",250724,47527.6075633765,16,41,11,30,16,25,2,1,1,0,2,43,12,31,16,27,26,10.7690660330451,12.4321080115149,0.487616331039392,2020-04-20,2020,4
"6371","RJ",3,"Sudeste",33013,"Baía da Ilha Grande",250724,47527.6075633765,17,46,17,29,19,27,0,0,0,0,0,46,17,29,19,27,24,10.7690660330451,12.4321080115149,0.476037340727426,2020-04-27,2020,4
"6372","RJ",3,"Sudeste",33013,"Baía da Ilha Grande",250724,47527.6075633765,18,50,19,31,28,22,1,1,0,0,1,51,20,31,28,23,31,10.7690660330451,12.4321080115149,0.45266090132432,2020-05-04,2020,5
"6373","RJ",3,"Sudeste",33013,"Baía da Ilha Grande",250724,47527.6075633765,19,60,19,41,20,40,1,1,0,1,0,61,20,41,21,40,32,10.7690660330451,12.4321080115149,0.465329127597043,2020-05-11,2020,5
"6374","RJ",3,"Sudeste",33013,"Baía da Ilha Grande",250724,47527.6075633765,20,58,20,38,24,34,2,1,1,1,1,60,21,39,25,35,29,10.7690660330451,12.4321080115149,0.462406094210578,2020-05-18,2020,5
"6375","RJ",3,"Sudeste",33013,"Baía da Ilha Grande",250724,47527.6075633765,21,58,16,42,22,36,0,0,0,0,0,58,16,42,22,36,44,10.7690660330451,12.4321080115149,0.464126310319535,2020-05-25,2020,5
"6376","RJ",3,"Sudeste",33014,"Vassouras",175924,21041.0392444465,5,23,6,17,12,11,0,0,0,0,0,23,6,17,12,11,24,9.95423005937927,12.0778073625782,0.308911555665301,2020-02-03,2020,2
"6377","RJ",3,"Sudeste",33014,"Vassouras",175924,21041.0392444465,6,29,10,19,10,19,0,0,0,0,0,29,10,19,10,19,30,9.95423005937927,12.0778073625782,0.300494319588129,2020-02-10,2020,2
"6378","RJ",3,"Sudeste",33014,"Vassouras",175924,21041.0392444465,7,37,10,27,15,22,0,0,0,0,0,37,10,27,15,22,29,9.95423005937927,12.0778073625782,0.315908652023903,2020-02-17,2020,2
"6379","RJ",3,"Sudeste",33014,"Vassouras",175924,21041.0392444465,8,39,10,29,16,23,0,0,0,0,0,39,10,29,16,23,27,9.95423005937927,12.0778073625782,0.386013958831329,2020-02-24,2020,2
"6380","RJ",3,"Sudeste",33014,"Vassouras",175924,21041.0392444465,9,32,10,22,14,18,2,0,2,0,2,34,10,24,14,20,27,9.95423005937927,12.0778073625782,0.346030622257447,2020-03-02,2020,3
"6381","RJ",3,"Sudeste",33014,"Vassouras",175924,21041.0392444465,10,32,7,25,14,18,1,0,1,0,1,33,7,26,14,19,25,9.95423005937927,12.0778073625782,0.345093085042123,2020-03-09,2020,3
"6382","RJ",3,"Sudeste",33014,"Vassouras",175924,21041.0392444465,11,28,5,23,12,16,0,0,0,0,0,28,5,23,12,16,26,9.95423005937927,12.0778073625782,0.467445167846176,2020-03-16,2020,3
"6383","RJ",3,"Sudeste",33014,"Vassouras",175924,21041.0392444465,12,35,8,27,14,21,0,0,0,0,0,35,8,27,14,21,31,9.95423005937927,12.0778073625782,0.554277316033056,2020-03-23,2020,3
"6384","RJ",3,"Sudeste",33014,"Vassouras",175924,21041.0392444465,13,35,7,28,14,21,0,0,0,0,0,35,7,28,14,21,24,9.95423005937927,12.0778073625782,0.509078294799513,2020-03-30,2020,3
"6385","RJ",3,"Sudeste",33014,"Vassouras",175924,21041.0392444465,14,27,6,21,11,16,0,0,0,0,0,27,6,21,11,16,17,9.95423005937927,12.0778073625782,0.501743988547055,2020-04-06,2020,4
"6386","RJ",3,"Sudeste",33014,"Vassouras",175924,21041.0392444465,15,35,7,28,13,22,0,0,0,0,0,35,7,28,13,22,31,9.95423005937927,12.0778073625782,0.474820030968537,2020-04-13,2020,4
"6387","RJ",3,"Sudeste",33014,"Vassouras",175924,21041.0392444465,16,40,6,34,17,23,0,0,0,0,0,40,6,34,17,23,43,9.95423005937927,12.0778073625782,0.487703175482341,2020-04-20,2020,4
"6388","RJ",3,"Sudeste",33014,"Vassouras",175924,21041.0392444465,17,50,19,31,27,23,1,1,0,0,1,51,20,31,27,24,31,9.95423005937927,12.0778073625782,0.476141646219296,2020-04-27,2020,4
"6389","RJ",3,"Sudeste",33014,"Vassouras",175924,21041.0392444465,18,45,16,29,21,24,0,0,0,0,0,45,16,29,21,24,39,9.95423005937927,12.0778073625782,0.46206667065166,2020-05-04,2020,5
"6390","RJ",3,"Sudeste",33014,"Vassouras",175924,21041.0392444465,19,35,10,25,16,19,0,0,0,0,0,35,10,25,16,19,48,9.95423005937927,12.0778073625782,0.475942847666142,2020-05-11,2020,5
"6391","RJ",3,"Sudeste",33014,"Vassouras",175924,21041.0392444465,20,31,9,22,9,22,1,1,0,0,1,32,10,22,9,23,42,9.95423005937927,12.0778073625782,0.463436466509539,2020-05-18,2020,5
"6392","RJ",3,"Sudeste",33014,"Vassouras",175924,21041.0392444465,21,36,14,22,12,24,1,0,1,0,1,37,14,23,12,25,31,9.95423005937927,12.0778073625782,0.443303752632221,2020-05-25,2020,5
"6393","RJ",3,"Sudeste",33015,"Serrana",512834,36080.6430968695,5,102,20,82,38,64,1,1,0,0,1,103,21,82,38,65,77,10.4935117982103,13.1477074850428,0.299540248481912,2020-02-03,2020,2
"6394","RJ",3,"Sudeste",33015,"Serrana",512834,36080.6430968695,6,110,24,86,29,81,0,0,0,0,0,110,24,86,29,81,76,10.4935117982103,13.1477074850428,0.297814206735948,2020-02-10,2020,2
"6395","RJ",3,"Sudeste",33015,"Serrana",512834,36080.6430968695,7,102,30,72,29,73,1,0,1,0,1,103,30,73,29,74,49,10.4935117982103,13.1477074850428,0.305240445226882,2020-02-17,2020,2
"6396","RJ",3,"Sudeste",33015,"Serrana",512834,36080.6430968695,8,107,28,79,40,67,0,0,0,0,0,107,28,79,40,67,87,10.4935117982103,13.1477074850428,0.378811824679487,2020-02-24,2020,2
"6397","RJ",3,"Sudeste",33015,"Serrana",512834,36080.6430968695,9,103,27,76,29,74,1,0,1,0,1,104,27,77,29,75,79,10.4935117982103,13.1477074850428,0.327547994157793,2020-03-02,2020,3
"6398","RJ",3,"Sudeste",33015,"Serrana",512834,36080.6430968695,10,96,27,69,28,68,0,0,0,0,0,96,27,69,28,68,82,10.4935117982103,13.1477074850428,0.331281037677573,2020-03-09,2020,3
"6399","RJ",3,"Sudeste",33015,"Serrana",512834,36080.6430968695,11,106,30,76,34,72,1,1,0,1,0,107,31,76,35,72,89,10.4935117982103,13.1477074850428,0.460949244021594,2020-03-16,2020,3
"6400","RJ",3,"Sudeste",33015,"Serrana",512834,36080.6430968695,12,102,29,73,33,69,0,0,0,0,0,102,29,73,33,69,66,10.4935117982103,13.1477074850428,0.560680526404446,2020-03-23,2020,3
"6401","RJ",3,"Sudeste",33015,"Serrana",512834,36080.6430968695,13,99,37,62,39,60,1,1,0,1,0,100,38,62,40,60,77,10.4935117982103,13.1477074850428,0.518181948834688,2020-03-30,2020,3
"6402","RJ",3,"Sudeste",33015,"Serrana",512834,36080.6430968695,14,92,28,64,41,51,2,1,1,0,2,94,29,65,41,53,72,10.4935117982103,13.1477074850428,0.520888163450341,2020-04-06,2020,4
"6403","RJ",3,"Sudeste",33015,"Serrana",512834,36080.6430968695,15,94,32,62,35,59,1,0,1,0,1,95,32,63,35,60,71,10.4935117982103,13.1477074850428,0.496665927060181,2020-04-13,2020,4
"6404","RJ",3,"Sudeste",33015,"Serrana",512834,36080.6430968695,16,105,35,70,39,66,2,1,1,1,1,107,36,71,40,67,86,10.4935117982103,13.1477074850428,0.498081376588861,2020-04-20,2020,4
"6405","RJ",3,"Sudeste",33015,"Serrana",512834,36080.6430968695,17,122,27,95,38,84,2,2,0,2,0,124,29,95,40,84,95,10.4935117982103,13.1477074850428,0.486868075612793,2020-04-27,2020,4
"6406","RJ",3,"Sudeste",33015,"Serrana",512834,36080.6430968695,18,118,33,85,31,87,1,1,0,0,1,119,34,85,31,88,101,10.4935117982103,13.1477074850428,0.46597251748744,2020-05-04,2020,5
"6407","RJ",3,"Sudeste",33015,"Serrana",512834,36080.6430968695,19,118,32,86,46,72,0,0,0,0,0,118,32,86,46,72,110,10.4935117982103,13.1477074850428,0.478409570064492,2020-05-11,2020,5
"6408","RJ",3,"Sudeste",33015,"Serrana",512834,36080.6430968695,20,85,22,63,34,51,0,0,0,0,0,85,22,63,34,51,98,10.4935117982103,13.1477074850428,0.489034805848982,2020-05-18,2020,5
"6409","RJ",3,"Sudeste",33015,"Serrana",512834,36080.6430968695,21,76,19,57,31,45,0,0,0,0,0,76,19,57,31,45,115,10.4935117982103,13.1477074850428,0.458735482765342,2020-05-25,2020,5
"6410","RJ",3,"Sudeste",33016,"Macacu-Caceribu",119876,22750.9175994361,5,26,9,17,11,15,0,0,0,0,0,26,9,17,11,15,17,10.0323607576068,11.6942131541739,0.304688765482436,2020-02-03,2020,2
"6411","RJ",3,"Sudeste",33016,"Macacu-Caceribu",119876,22750.9175994361,6,24,6,18,9,15,0,0,0,0,0,24,6,18,9,15,10,10.0323607576068,11.6942131541739,0.293757927699,2020-02-10,2020,2
"6412","RJ",3,"Sudeste",33016,"Macacu-Caceribu",119876,22750.9175994361,7,34,7,27,12,22,0,0,0,0,0,34,7,27,12,22,13,10.0323607576068,11.6942131541739,0.302489262791142,2020-02-17,2020,2
"6413","RJ",3,"Sudeste",33016,"Macacu-Caceribu",119876,22750.9175994361,8,24,8,16,10,14,0,0,0,0,0,24,8,16,10,14,18,10.0323607576068,11.6942131541739,0.370630748694411,2020-02-24,2020,2
"6414","RJ",3,"Sudeste",33016,"Macacu-Caceribu",119876,22750.9175994361,9,16,5,11,10,6,0,0,0,0,0,16,5,11,10,6,16,10.0323607576068,11.6942131541739,0.323917965062049,2020-03-02,2020,3
"6415","RJ",3,"Sudeste",33016,"Macacu-Caceribu",119876,22750.9175994361,10,19,11,8,11,8,0,0,0,0,0,19,11,8,11,8,21,10.0323607576068,11.6942131541739,0.32940264312594,2020-03-09,2020,3
"6416","RJ",3,"Sudeste",33016,"Macacu-Caceribu",119876,22750.9175994361,11,26,11,15,10,16,0,0,0,0,0,26,11,15,10,16,19,10.0323607576068,11.6942131541739,0.437249771479618,2020-03-16,2020,3
"6417","RJ",3,"Sudeste",33016,"Macacu-Caceribu",119876,22750.9175994361,12,32,11,21,15,17,0,0,0,0,0,32,11,21,15,17,13,10.0323607576068,11.6942131541739,0.525708958941136,2020-03-23,2020,3
"6418","RJ",3,"Sudeste",33016,"Macacu-Caceribu",119876,22750.9175994361,13,31,10,21,11,20,1,0,1,0,1,32,10,22,11,21,16,10.0323607576068,11.6942131541739,0.491432688874184,2020-03-30,2020,3
"6419","RJ",3,"Sudeste",33016,"Macacu-Caceribu",119876,22750.9175994361,14,18,6,12,7,11,1,1,0,0,1,19,7,12,7,12,16,10.0323607576068,11.6942131541739,0.496975150891783,2020-04-06,2020,4
"6420","RJ",3,"Sudeste",33016,"Macacu-Caceribu",119876,22750.9175994361,15,22,12,10,10,12,1,1,0,1,0,23,13,10,11,12,20,10.0323607576068,11.6942131541739,0.464816447052085,2020-04-13,2020,4
"6421","RJ",3,"Sudeste",33016,"Macacu-Caceribu",119876,22750.9175994361,16,21,3,18,9,12,1,0,1,0,1,22,3,19,9,13,20,10.0323607576068,11.6942131541739,0.476562948866869,2020-04-20,2020,4
"6422","RJ",3,"Sudeste",33016,"Macacu-Caceribu",119876,22750.9175994361,17,31,9,22,15,16,0,0,0,0,0,31,9,22,15,16,14,10.0323607576068,11.6942131541739,0.465466560876676,2020-04-27,2020,4
"6423","RJ",3,"Sudeste",33016,"Macacu-Caceribu",119876,22750.9175994361,18,23,1,22,8,15,0,0,0,0,0,23,1,22,8,15,28,10.0323607576068,11.6942131541739,0.44629909861873,2020-05-04,2020,5
"6424","RJ",3,"Sudeste",33016,"Macacu-Caceribu",119876,22750.9175994361,19,24,7,17,7,17,0,0,0,0,0,24,7,17,7,17,20,10.0323607576068,11.6942131541739,0.455800753006276,2020-05-11,2020,5
"6425","RJ",3,"Sudeste",33016,"Macacu-Caceribu",119876,22750.9175994361,20,24,7,17,10,14,0,0,0,0,0,24,7,17,10,14,28,10.0323607576068,11.6942131541739,0.452177801542566,2020-05-18,2020,5
"6426","RJ",3,"Sudeste",33016,"Macacu-Caceribu",119876,22750.9175994361,21,21,6,15,4,17,1,0,1,1,0,22,6,16,5,17,29,10.0323607576068,11.6942131541739,0.437490124979598,2020-05-25,2020,5
"6427","RJ",3,"Sudeste",33017,"Itaguaí",263131,63148.5836958777,5,49,14,35,25,24,5,0,5,4,1,54,14,40,29,25,39,11.0532456999084,12.4804072860092,0.304332872579871,2020-02-03,2020,2
"6428","RJ",3,"Sudeste",33017,"Itaguaí",263131,63148.5836958777,6,49,14,35,17,32,0,0,0,0,0,49,14,35,17,32,24,11.0532456999084,12.4804072860092,0.295850221037716,2020-02-10,2020,2
"6429","RJ",3,"Sudeste",33017,"Itaguaí",263131,63148.5836958777,7,53,12,41,15,38,0,0,0,0,0,53,12,41,15,38,34,11.0532456999084,12.4804072860092,0.316847453355467,2020-02-17,2020,2
"6430","RJ",3,"Sudeste",33017,"Itaguaí",263131,63148.5836958777,8,57,10,47,25,32,0,0,0,0,0,57,10,47,25,32,35,11.0532456999084,12.4804072860092,0.392779346993524,2020-02-24,2020,2
"6431","RJ",3,"Sudeste",33017,"Itaguaí",263131,63148.5836958777,9,56,21,35,23,33,2,1,1,0,2,58,22,36,23,35,35,11.0532456999084,12.4804072860092,0.336835612943721,2020-03-02,2020,3
"6432","RJ",3,"Sudeste",33017,"Itaguaí",263131,63148.5836958777,10,50,18,32,21,29,0,0,0,0,0,50,18,32,21,29,44,11.0532456999084,12.4804072860092,0.332895204280305,2020-03-09,2020,3
"6433","RJ",3,"Sudeste",33017,"Itaguaí",263131,63148.5836958777,11,70,24,46,42,28,0,0,0,0,0,70,24,46,42,28,47,11.0532456999084,12.4804072860092,0.44731301622761,2020-03-16,2020,3
"6434","RJ",3,"Sudeste",33017,"Itaguaí",263131,63148.5836958777,12,55,22,33,27,28,1,0,1,0,1,56,22,34,27,29,37,11.0532456999084,12.4804072860092,0.51113132762168,2020-03-23,2020,3
"6435","RJ",3,"Sudeste",33017,"Itaguaí",263131,63148.5836958777,13,45,14,31,26,19,1,1,0,0,1,46,15,31,26,20,39,11.0532456999084,12.4804072860092,0.484615234761612,2020-03-30,2020,3
"6436","RJ",3,"Sudeste",33017,"Itaguaí",263131,63148.5836958777,14,61,15,46,27,34,0,0,0,0,0,61,15,46,27,34,36,11.0532456999084,12.4804072860092,0.479575535092884,2020-04-06,2020,4
"6437","RJ",3,"Sudeste",33017,"Itaguaí",263131,63148.5836958777,15,68,15,53,33,35,0,0,0,0,0,68,15,53,33,35,36,11.0532456999084,12.4804072860092,0.462253018254841,2020-04-13,2020,4
"6438","RJ",3,"Sudeste",33017,"Itaguaí",263131,63148.5836958777,16,70,25,45,28,42,0,0,0,0,0,70,25,45,28,42,60,11.0532456999084,12.4804072860092,0.473174930863537,2020-04-20,2020,4
"6439","RJ",3,"Sudeste",33017,"Itaguaí",263131,63148.5836958777,17,74,20,54,29,45,0,0,0,0,0,74,20,54,29,45,67,11.0532456999084,12.4804072860092,0.463676434903998,2020-04-27,2020,4
"6440","RJ",3,"Sudeste",33017,"Itaguaí",263131,63148.5836958777,18,63,13,50,30,33,1,0,1,1,0,64,13,51,31,33,63,11.0532456999084,12.4804072860092,0.446519423242116,2020-05-04,2020,5
"6441","RJ",3,"Sudeste",33017,"Itaguaí",263131,63148.5836958777,19,44,11,33,25,19,0,0,0,0,0,44,11,33,25,19,76,11.0532456999084,12.4804072860092,0.458537470534637,2020-05-11,2020,5
"6442","RJ",3,"Sudeste",33017,"Itaguaí",263131,63148.5836958777,20,70,16,54,31,39,1,1,0,1,0,71,17,54,32,39,52,11.0532456999084,12.4804072860092,0.441865911009118,2020-05-18,2020,5
"6443","RJ",3,"Sudeste",33017,"Itaguaí",263131,63148.5836958777,21,58,13,45,23,35,0,0,0,0,0,58,13,45,23,35,66,11.0532456999084,12.4804072860092,0.421294240050909,2020-05-25,2020,5
"6444","RJ",3,"Sudeste",33018,"Rio de Janeiro",12434442,44335.8633179679,5,2367,533,1834,932,1435,25,13,12,10,15,2392,546,1846,942,1450,1939,10.6995491842301,16.3359807608714,0.291078853892376,2020-02-03,2020,2
"6445","RJ",3,"Sudeste",33018,"Rio de Janeiro",12434442,44335.8633179679,6,2411,560,1851,877,1534,24,4,20,10,14,2435,564,1871,887,1548,1921,10.6995491842301,16.3359807608714,0.291228249150865,2020-02-10,2020,2
"6446","RJ",3,"Sudeste",33018,"Rio de Janeiro",12434442,44335.8633179679,7,2384,543,1841,915,1469,28,12,16,11,17,2412,555,1857,926,1486,1979,10.6995491842301,16.3359807608714,0.309393800801954,2020-02-17,2020,2
"6447","RJ",3,"Sudeste",33018,"Rio de Janeiro",12434442,44335.8633179679,8,2453,543,1910,939,1514,29,13,16,9,20,2482,556,1926,948,1534,1856,10.6995491842301,16.3359807608714,0.38559278354443,2020-02-24,2020,2
"6448","RJ",3,"Sudeste",33018,"Rio de Janeiro",12434442,44335.8633179679,9,2433,544,1889,978,1455,30,10,20,10,20,2463,554,1909,988,1475,2016,10.6995491842301,16.3359807608714,0.326915743283068,2020-03-02,2020,3
"6449","RJ",3,"Sudeste",33018,"Rio de Janeiro",12434442,44335.8633179679,10,2313,531,1782,930,1383,23,12,11,6,17,2336,543,1793,936,1400,1999,10.6995491842301,16.3359807608714,0.333631343860124,2020-03-09,2020,3
"6450","RJ",3,"Sudeste",33018,"Rio de Janeiro",12434442,44335.8633179679,11,2354,558,1796,890,1464,21,8,13,9,12,2375,566,1809,899,1476,2075,10.6995491842301,16.3359807608714,0.461924673760364,2020-03-16,2020,3
"6451","RJ",3,"Sudeste",33018,"Rio de Janeiro",12434442,44335.8633179679,12,2283,550,1733,893,1390,29,16,13,15,14,2312,566,1746,908,1404,1965,10.6995491842301,16.3359807608714,0.553279142246882,2020-03-23,2020,3
"6452","RJ",3,"Sudeste",33018,"Rio de Janeiro",12434442,44335.8633179679,13,2183,490,1693,872,1311,20,7,13,7,13,2203,497,1706,879,1324,2188,10.6995491842301,16.3359807608714,0.519364759737452,2020-03-30,2020,3
"6453","RJ",3,"Sudeste",33018,"Rio de Janeiro",12434442,44335.8633179679,14,2396,558,1838,941,1455,34,14,20,18,16,2430,572,1858,959,1471,2419,10.6995491842301,16.3359807608714,0.51423197709518,2020-04-06,2020,4
"6454","RJ",3,"Sudeste",33018,"Rio de Janeiro",12434442,44335.8633179679,15,2417,567,1850,934,1483,27,10,17,11,16,2444,577,1867,945,1499,2937,10.6995491842301,16.3359807608714,0.500647932066608,2020-04-13,2020,4
"6455","RJ",3,"Sudeste",33018,"Rio de Janeiro",12434442,44335.8633179679,16,2380,572,1808,956,1424,31,9,22,10,21,2411,581,1830,966,1445,3751,10.6995491842301,16.3359807608714,0.511567957426882,2020-04-20,2020,4
"6456","RJ",3,"Sudeste",33018,"Rio de Janeiro",12434442,44335.8633179679,17,2449,566,1883,991,1458,29,9,20,15,14,2478,575,1903,1006,1472,4275,10.6995491842301,16.3359807608714,0.502312973404355,2020-04-27,2020,4
"6457","RJ",3,"Sudeste",33018,"Rio de Janeiro",12434442,44335.8633179679,18,2493,621,1872,972,1521,35,14,21,15,20,2528,635,1893,987,1541,4392,10.6995491842301,16.3359807608714,0.476797276533767,2020-05-04,2020,5
"6458","RJ",3,"Sudeste",33018,"Rio de Janeiro",12434442,44335.8633179679,19,2583,573,2010,972,1611,34,13,21,13,21,2617,586,2031,985,1632,3857,10.6995491842301,16.3359807608714,0.492149274441117,2020-05-11,2020,5
"6459","RJ",3,"Sudeste",33018,"Rio de Janeiro",12434442,44335.8633179679,20,2559,609,1950,984,1575,26,9,17,10,16,2585,618,1967,994,1591,3310,10.6995491842301,16.3359807608714,0.470967956170649,2020-05-18,2020,5
"6460","RJ",3,"Sudeste",33018,"Rio de Janeiro",12434442,44335.8633179679,21,2653,579,2074,976,1677,36,19,17,20,16,2689,598,2091,996,1693,3047,10.6995491842301,16.3359807608714,0.44857008446716,2020-05-25,2020,5
"6461","RN",2,"Nordeste",24001,"Mossoró",384018,22177.8808933956,5,90,20,70,30,60,2,1,1,1,1,92,21,71,31,61,41,10.0068507150143,12.8584447054713,0.278349253312086,2020-02-03,2020,2
"6462","RN",2,"Nordeste",24001,"Mossoró",384018,22177.8808933956,6,81,16,65,32,49,1,1,0,1,0,82,17,65,33,49,46,10.0068507150143,12.8584447054713,0.273979315406344,2020-02-10,2020,2
"6463","RN",2,"Nordeste",24001,"Mossoró",384018,22177.8808933956,7,88,21,67,36,52,2,0,2,0,2,90,21,69,36,54,49,10.0068507150143,12.8584447054713,0.281594847731076,2020-02-17,2020,2
"6464","RN",2,"Nordeste",24001,"Mossoró",384018,22177.8808933956,8,84,21,63,33,51,3,0,3,2,1,87,21,66,35,52,47,10.0068507150143,12.8584447054713,0.340183831429319,2020-02-24,2020,2
"6465","RN",2,"Nordeste",24001,"Mossoró",384018,22177.8808933956,9,94,21,73,36,58,3,0,3,1,2,97,21,76,37,60,33,10.0068507150143,12.8584447054713,0.305297090587772,2020-03-02,2020,3
"6466","RN",2,"Nordeste",24001,"Mossoró",384018,22177.8808933956,10,76,21,55,20,56,0,0,0,0,0,76,21,55,20,56,48,10.0068507150143,12.8584447054713,0.331158727193786,2020-03-09,2020,3
"6467","RN",2,"Nordeste",24001,"Mossoró",384018,22177.8808933956,11,84,22,62,34,50,0,0,0,0,0,84,22,62,34,50,49,10.0068507150143,12.8584447054713,0.399342126462256,2020-03-16,2020,3
"6468","RN",2,"Nordeste",24001,"Mossoró",384018,22177.8808933956,12,63,17,46,20,43,1,0,1,1,0,64,17,47,21,43,53,10.0068507150143,12.8584447054713,0.524796098447508,2020-03-23,2020,3
"6469","RN",2,"Nordeste",24001,"Mossoró",384018,22177.8808933956,13,56,12,44,17,39,0,0,0,0,0,56,12,44,17,39,69,10.0068507150143,12.8584447054713,0.481144722727675,2020-03-30,2020,3
"6470","RN",2,"Nordeste",24001,"Mossoró",384018,22177.8808933956,14,62,17,45,23,39,0,0,0,0,0,62,17,45,23,39,61,10.0068507150143,12.8584447054713,0.458320203386992,2020-04-06,2020,4
"6471","RN",2,"Nordeste",24001,"Mossoró",384018,22177.8808933956,15,80,15,65,31,49,1,1,0,1,0,81,16,65,32,49,44,10.0068507150143,12.8584447054713,0.435763835741891,2020-04-13,2020,4
"6472","RN",2,"Nordeste",24001,"Mossoró",384018,22177.8808933956,16,67,13,54,35,32,0,0,0,0,0,67,13,54,35,32,53,10.0068507150143,12.8584447054713,0.432596834813822,2020-04-20,2020,4
"6473","RN",2,"Nordeste",24001,"Mossoró",384018,22177.8808933956,17,80,26,54,34,46,1,0,1,1,0,81,26,55,35,46,53,10.0068507150143,12.8584447054713,0.411109071074047,2020-04-27,2020,4
"6474","RN",2,"Nordeste",24001,"Mossoró",384018,22177.8808933956,18,82,18,64,33,49,0,0,0,0,0,82,18,64,33,49,70,10.0068507150143,12.8584447054713,0.419066093508289,2020-05-04,2020,5
"6475","RN",2,"Nordeste",24001,"Mossoró",384018,22177.8808933956,19,69,19,50,21,48,2,0,2,1,1,71,19,52,22,49,67,10.0068507150143,12.8584447054713,0.45070819740527,2020-05-11,2020,5
"6476","RN",2,"Nordeste",24001,"Mossoró",384018,22177.8808933956,20,71,23,48,26,45,0,0,0,0,0,71,23,48,26,45,64,10.0068507150143,12.8584447054713,0.442262425067332,2020-05-18,2020,5
"6477","RN",2,"Nordeste",24001,"Mossoró",384018,22177.8808933956,21,105,24,81,39,66,1,0,1,0,1,106,24,82,39,67,73,10.0068507150143,12.8584447054713,0.429097062367855,2020-05-25,2020,5
"6478","RN",2,"Nordeste",24002,"Chapada do Apodi",75488,16082.9307572064,5,13,7,6,4,9,0,0,0,0,0,13,7,6,4,9,9,9.68551378714574,11.2317289822074,0.263898425956959,2020-02-03,2020,2
"6479","RN",2,"Nordeste",24002,"Chapada do Apodi",75488,16082.9307572064,6,11,3,8,5,6,0,0,0,0,0,11,3,8,5,6,10,9.68551378714574,11.2317289822074,0.258264641741601,2020-02-10,2020,2
"6480","RN",2,"Nordeste",24002,"Chapada do Apodi",75488,16082.9307572064,7,19,8,11,9,10,0,0,0,0,0,19,8,11,9,10,12,9.68551378714574,11.2317289822074,0.271846082676899,2020-02-17,2020,2
"6481","RN",2,"Nordeste",24002,"Chapada do Apodi",75488,16082.9307572064,8,12,3,9,4,8,0,0,0,0,0,12,3,9,4,8,10,9.68551378714574,11.2317289822074,0.31245862079778,2020-02-24,2020,2
"6482","RN",2,"Nordeste",24002,"Chapada do Apodi",75488,16082.9307572064,9,14,6,8,5,9,0,0,0,0,0,14,6,8,5,9,15,9.68551378714574,11.2317289822074,0.295021018734592,2020-03-02,2020,3
"6483","RN",2,"Nordeste",24002,"Chapada do Apodi",75488,16082.9307572064,10,12,2,10,3,9,0,0,0,0,0,12,2,10,3,9,12,9.68551378714574,11.2317289822074,0.33171304495749,2020-03-09,2020,3
"6484","RN",2,"Nordeste",24002,"Chapada do Apodi",75488,16082.9307572064,11,12,4,8,2,10,0,0,0,0,0,12,4,8,2,10,6,9.68551378714574,11.2317289822074,0.377570948669559,2020-03-16,2020,3
"6485","RN",2,"Nordeste",24002,"Chapada do Apodi",75488,16082.9307572064,12,20,7,13,9,11,0,0,0,0,0,20,7,13,9,11,12,9.68551378714574,11.2317289822074,0.486841211959401,2020-03-23,2020,3
"6486","RN",2,"Nordeste",24002,"Chapada do Apodi",75488,16082.9307572064,13,9,1,8,4,5,0,0,0,0,0,9,1,8,4,5,12,9.68551378714574,11.2317289822074,0.456402111521866,2020-03-30,2020,3
"6487","RN",2,"Nordeste",24002,"Chapada do Apodi",75488,16082.9307572064,14,9,2,7,2,7,0,0,0,0,0,9,2,7,2,7,9,9.68551378714574,11.2317289822074,0.428134291400519,2020-04-06,2020,4
"6488","RN",2,"Nordeste",24002,"Chapada do Apodi",75488,16082.9307572064,15,14,5,9,6,8,0,0,0,0,0,14,5,9,6,8,14,9.68551378714574,11.2317289822074,0.406303099605403,2020-04-13,2020,4
"6489","RN",2,"Nordeste",24002,"Chapada do Apodi",75488,16082.9307572064,16,16,4,12,7,9,0,0,0,0,0,16,4,12,7,9,13,9.68551378714574,11.2317289822074,0.400165118139372,2020-04-20,2020,4
"6490","RN",2,"Nordeste",24002,"Chapada do Apodi",75488,16082.9307572064,17,16,3,13,10,6,0,0,0,0,0,16,3,13,10,6,5,9.68551378714574,11.2317289822074,0.384895947875957,2020-04-27,2020,4
"6491","RN",2,"Nordeste",24002,"Chapada do Apodi",75488,16082.9307572064,18,17,3,14,8,9,0,0,0,0,0,17,3,14,8,9,10,9.68551378714574,11.2317289822074,0.406610660449467,2020-05-04,2020,5
"6492","RN",2,"Nordeste",24002,"Chapada do Apodi",75488,16082.9307572064,19,15,4,11,5,10,0,0,0,0,0,15,4,11,5,10,7,9.68551378714574,11.2317289822074,0.440713585699993,2020-05-11,2020,5
"6493","RN",2,"Nordeste",24002,"Chapada do Apodi",75488,16082.9307572064,20,16,8,8,8,8,0,0,0,0,0,16,8,8,8,8,11,9.68551378714574,11.2317289822074,0.444544230679837,2020-05-18,2020,5
"6494","RN",2,"Nordeste",24002,"Chapada do Apodi",75488,16082.9307572064,21,15,6,9,6,9,0,0,0,0,0,15,6,9,6,9,15,9.68551378714574,11.2317289822074,0.432782192603889,2020-05-25,2020,5
"6495","RN",2,"Nordeste",24003,"Médio Oeste",41318,11967.220833535,5,7,3,4,2,5,0,0,0,0,0,7,3,4,2,5,7,9.38992659394508,10.6290535193516,0.251092132802554,2020-02-03,2020,2
"6496","RN",2,"Nordeste",24003,"Médio Oeste",41318,11967.220833535,6,6,3,3,3,3,1,1,0,0,1,7,4,3,3,4,7,9.38992659394508,10.6290535193516,0.264852181732587,2020-02-10,2020,2
"6497","RN",2,"Nordeste",24003,"Médio Oeste",41318,11967.220833535,7,10,4,6,2,8,0,0,0,0,0,10,4,6,2,8,5,9.38992659394508,10.6290535193516,0.265697600877863,2020-02-17,2020,2
"6498","RN",2,"Nordeste",24003,"Médio Oeste",41318,11967.220833535,8,11,6,5,4,7,0,0,0,0,0,11,6,5,4,7,8,9.38992659394508,10.6290535193516,0.308346488223468,2020-02-24,2020,2
"6499","RN",2,"Nordeste",24003,"Médio Oeste",41318,11967.220833535,9,3,1,2,2,1,0,0,0,0,0,3,1,2,2,1,3,9.38992659394508,10.6290535193516,0.296049698905083,2020-03-02,2020,3
"6500","RN",2,"Nordeste",24003,"Médio Oeste",41318,11967.220833535,10,8,1,7,2,6,0,0,0,0,0,8,1,7,2,6,6,9.38992659394508,10.6290535193516,0.320190449919852,2020-03-09,2020,3
"6501","RN",2,"Nordeste",24003,"Médio Oeste",41318,11967.220833535,11,10,5,5,4,6,0,0,0,0,0,10,5,5,4,6,4,9.38992659394508,10.6290535193516,0.344947049715782,2020-03-16,2020,3
"6502","RN",2,"Nordeste",24003,"Médio Oeste",41318,11967.220833535,12,10,4,6,4,6,0,0,0,0,0,10,4,6,4,6,3,9.38992659394508,10.6290535193516,0.428821787390499,2020-03-23,2020,3
"6503","RN",2,"Nordeste",24003,"Médio Oeste",41318,11967.220833535,13,6,3,3,1,5,0,0,0,0,0,6,3,3,1,5,6,9.38992659394508,10.6290535193516,0.383882977065586,2020-03-30,2020,3
"6504","RN",2,"Nordeste",24003,"Médio Oeste",41318,11967.220833535,14,5,3,2,1,4,1,0,1,1,0,6,3,3,2,4,14,9.38992659394508,10.6290535193516,0.368268791923296,2020-04-06,2020,4
"6505","RN",2,"Nordeste",24003,"Médio Oeste",41318,11967.220833535,15,10,2,8,4,6,0,0,0,0,0,10,2,8,4,6,4,9.38992659394508,10.6290535193516,0.365353117396598,2020-04-13,2020,4
"6506","RN",2,"Nordeste",24003,"Médio Oeste",41318,11967.220833535,16,8,1,7,2,6,0,0,0,0,0,8,1,7,2,6,3,9.38992659394508,10.6290535193516,0.338909810771412,2020-04-20,2020,4
"6507","RN",2,"Nordeste",24003,"Médio Oeste",41318,11967.220833535,17,8,4,4,3,5,0,0,0,0,0,8,4,4,3,5,9,9.38992659394508,10.6290535193516,0.340579194551353,2020-04-27,2020,4
"6508","RN",2,"Nordeste",24003,"Médio Oeste",41318,11967.220833535,18,9,2,7,6,3,0,0,0,0,0,9,2,7,6,3,2,9.38992659394508,10.6290535193516,0.375228784690103,2020-05-04,2020,5
"6509","RN",2,"Nordeste",24003,"Médio Oeste",41318,11967.220833535,19,9,5,4,4,5,0,0,0,0,0,9,5,4,4,5,6,9.38992659394508,10.6290535193516,0.406488405627702,2020-05-11,2020,5
"6510","RN",2,"Nordeste",24003,"Médio Oeste",41318,11967.220833535,20,7,2,5,1,6,0,0,0,0,0,7,2,5,1,6,4,9.38992659394508,10.6290535193516,0.416787365662455,2020-05-18,2020,5
"6511","RN",2,"Nordeste",24003,"Médio Oeste",41318,11967.220833535,21,6,4,2,0,6,0,0,0,0,0,6,4,2,0,6,4,9.38992659394508,10.6290535193516,0.380164619797517,2020-05-25,2020,5
"6512","RN",2,"Nordeste",24004,"Vale do Açu",155501,18854.4637656993,5,27,7,20,14,13,1,0,1,0,1,28,7,21,14,14,23,9.84450496938877,11.9544074414489,0.266035040355871,2020-02-03,2020,2
"6513","RN",2,"Nordeste",24004,"Vale do Açu",155501,18854.4637656993,6,30,11,19,9,21,0,0,0,0,0,30,11,19,9,21,19,9.84450496938877,11.9544074414489,0.25546109129531,2020-02-10,2020,2
"6514","RN",2,"Nordeste",24004,"Vale do Açu",155501,18854.4637656993,7,42,9,33,20,22,1,0,1,0,1,43,9,34,20,23,17,9.84450496938877,11.9544074414489,0.265392595228955,2020-02-17,2020,2
"6515","RN",2,"Nordeste",24004,"Vale do Açu",155501,18854.4637656993,8,36,13,23,13,23,0,0,0,0,0,36,13,23,13,23,17,9.84450496938877,11.9544074414489,0.319873425617634,2020-02-24,2020,2
"6516","RN",2,"Nordeste",24004,"Vale do Açu",155501,18854.4637656993,9,31,11,20,12,19,0,0,0,0,0,31,11,20,12,19,18,9.84450496938877,11.9544074414489,0.285050433966225,2020-03-02,2020,3
"6517","RN",2,"Nordeste",24004,"Vale do Açu",155501,18854.4637656993,10,38,11,27,14,24,0,0,0,0,0,38,11,27,14,24,24,9.84450496938877,11.9544074414489,0.323286471000237,2020-03-09,2020,3
"6518","RN",2,"Nordeste",24004,"Vale do Açu",155501,18854.4637656993,11,25,8,17,11,14,1,1,0,1,0,26,9,17,12,14,27,9.84450496938877,11.9544074414489,0.370636217677014,2020-03-16,2020,3
"6519","RN",2,"Nordeste",24004,"Vale do Açu",155501,18854.4637656993,12,19,6,13,10,9,0,0,0,0,0,19,6,13,10,9,17,9.84450496938877,11.9544074414489,0.454653912658863,2020-03-23,2020,3
"6520","RN",2,"Nordeste",24004,"Vale do Açu",155501,18854.4637656993,13,30,9,21,13,17,0,0,0,0,0,30,9,21,13,17,18,9.84450496938877,11.9544074414489,0.430497251435509,2020-03-30,2020,3
"6521","RN",2,"Nordeste",24004,"Vale do Açu",155501,18854.4637656993,14,21,9,12,9,12,0,0,0,0,0,21,9,12,9,12,21,9.84450496938877,11.9544074414489,0.406839946949742,2020-04-06,2020,4
"6522","RN",2,"Nordeste",24004,"Vale do Açu",155501,18854.4637656993,15,17,6,11,9,8,0,0,0,0,0,17,6,11,9,8,15,9.84450496938877,11.9544074414489,0.386591723670456,2020-04-13,2020,4
"6523","RN",2,"Nordeste",24004,"Vale do Açu",155501,18854.4637656993,16,31,20,11,14,17,0,0,0,0,0,31,20,11,14,17,23,9.84450496938877,11.9544074414489,0.38848888724613,2020-04-20,2020,4
"6524","RN",2,"Nordeste",24004,"Vale do Açu",155501,18854.4637656993,17,22,9,13,11,11,0,0,0,0,0,22,9,13,11,11,16,9.84450496938877,11.9544074414489,0.365165467801984,2020-04-27,2020,4
"6525","RN",2,"Nordeste",24004,"Vale do Açu",155501,18854.4637656993,18,28,12,16,11,17,0,0,0,0,0,28,12,16,11,17,19,9.84450496938877,11.9544074414489,0.37141933877059,2020-05-04,2020,5
"6526","RN",2,"Nordeste",24004,"Vale do Açu",155501,18854.4637656993,19,42,24,18,23,19,0,0,0,0,0,42,24,18,23,19,29,9.84450496938877,11.9544074414489,0.410793422576022,2020-05-11,2020,5
"6527","RN",2,"Nordeste",24004,"Vale do Açu",155501,18854.4637656993,20,40,11,29,18,22,0,0,0,0,0,40,11,29,18,22,18,9.84450496938877,11.9544074414489,0.391327840369248,2020-05-18,2020,5
"6528","RN",2,"Nordeste",24004,"Vale do Açu",155501,18854.4637656993,21,33,8,25,21,12,0,0,0,0,0,33,8,25,21,12,24,9.84450496938877,11.9544074414489,0.389420212123,2020-05-25,2020,5
"6529","RN",2,"Nordeste",24005,"Serra de São Miguel",67194,8614.46749144269,5,10,5,5,5,5,0,0,0,0,0,10,5,5,5,5,7,9.06119833526317,11.1153392368107,0.266690736356733,2020-02-03,2020,2
"6530","RN",2,"Nordeste",24005,"Serra de São Miguel",67194,8614.46749144269,6,14,4,10,9,5,0,0,0,0,0,14,4,10,9,5,13,9.06119833526317,11.1153392368107,0.260143387413457,2020-02-10,2020,2
"6531","RN",2,"Nordeste",24005,"Serra de São Miguel",67194,8614.46749144269,7,10,5,5,4,6,1,1,0,1,0,11,6,5,5,6,11,9.06119833526317,11.1153392368107,0.2806622340368,2020-02-17,2020,2
"6532","RN",2,"Nordeste",24005,"Serra de São Miguel",67194,8614.46749144269,8,14,7,7,4,10,0,0,0,0,0,14,7,7,4,10,9,9.06119833526317,11.1153392368107,0.304044497211236,2020-02-24,2020,2
"6533","RN",2,"Nordeste",24005,"Serra de São Miguel",67194,8614.46749144269,9,12,5,7,7,5,0,0,0,0,0,12,5,7,7,5,9,9.06119833526317,11.1153392368107,0.288710599041793,2020-03-02,2020,3
"6534","RN",2,"Nordeste",24005,"Serra de São Miguel",67194,8614.46749144269,10,17,8,9,6,11,0,0,0,0,0,17,8,9,6,11,7,9.06119833526317,11.1153392368107,0.313959050371639,2020-03-09,2020,3
"6535","RN",2,"Nordeste",24005,"Serra de São Miguel",67194,8614.46749144269,11,18,10,8,9,9,0,0,0,0,0,18,10,8,9,9,4,9.06119833526317,11.1153392368107,0.376513740957417,2020-03-16,2020,3
"6536","RN",2,"Nordeste",24005,"Serra de São Miguel",67194,8614.46749144269,12,17,8,9,8,9,0,0,0,0,0,17,8,9,8,9,15,9.06119833526317,11.1153392368107,0.474827404828783,2020-03-23,2020,3
"6537","RN",2,"Nordeste",24005,"Serra de São Miguel",67194,8614.46749144269,13,14,4,10,8,6,0,0,0,0,0,14,4,10,8,6,11,9.06119833526317,11.1153392368107,0.441004807419231,2020-03-30,2020,3
"6538","RN",2,"Nordeste",24005,"Serra de São Miguel",67194,8614.46749144269,14,15,8,7,10,5,1,0,1,1,0,16,8,8,11,5,6,9.06119833526317,11.1153392368107,0.429525068884631,2020-04-06,2020,4
"6539","RN",2,"Nordeste",24005,"Serra de São Miguel",67194,8614.46749144269,15,6,2,4,5,1,0,0,0,0,0,6,2,4,5,1,12,9.06119833526317,11.1153392368107,0.437990457472164,2020-04-13,2020,4
"6540","RN",2,"Nordeste",24005,"Serra de São Miguel",67194,8614.46749144269,16,12,10,2,6,6,0,0,0,0,0,12,10,2,6,6,6,9.06119833526317,11.1153392368107,0.426862138011306,2020-04-20,2020,4
"6541","RN",2,"Nordeste",24005,"Serra de São Miguel",67194,8614.46749144269,17,21,7,14,11,10,0,0,0,0,0,21,7,14,11,10,12,9.06119833526317,11.1153392368107,0.402324266390696,2020-04-27,2020,4
"6542","RN",2,"Nordeste",24005,"Serra de São Miguel",67194,8614.46749144269,18,14,7,7,8,6,0,0,0,0,0,14,7,7,8,6,11,9.06119833526317,11.1153392368107,0.425110513468324,2020-05-04,2020,5
"6543","RN",2,"Nordeste",24005,"Serra de São Miguel",67194,8614.46749144269,19,9,3,6,5,4,0,0,0,0,0,9,3,6,5,4,11,9.06119833526317,11.1153392368107,0.442254270188527,2020-05-11,2020,5
"6544","RN",2,"Nordeste",24005,"Serra de São Miguel",67194,8614.46749144269,20,14,9,5,8,6,0,0,0,0,0,14,9,5,8,6,9,9.06119833526317,11.1153392368107,0.405705966798346,2020-05-18,2020,5
"6545","RN",2,"Nordeste",24005,"Serra de São Miguel",67194,8614.46749144269,21,14,6,8,10,4,0,0,0,0,0,14,6,8,10,4,12,9.06119833526317,11.1153392368107,0.40852449197084,2020-05-25,2020,5
"6546","RN",2,"Nordeste",24006,"Pau dos Ferros",117909,10995.1681134604,5,24,8,16,12,12,0,0,0,0,0,24,8,16,12,12,17,9.30521119286382,11.6776684194899,0.260064803701546,2020-02-03,2020,2
"6547","RN",2,"Nordeste",24006,"Pau dos Ferros",117909,10995.1681134604,6,25,11,14,13,12,0,0,0,0,0,25,11,14,13,12,18,9.30521119286382,11.6776684194899,0.254645543442078,2020-02-10,2020,2
"6548","RN",2,"Nordeste",24006,"Pau dos Ferros",117909,10995.1681134604,7,23,12,11,12,11,0,0,0,0,0,23,12,11,12,11,13,9.30521119286382,11.6776684194899,0.26128064510875,2020-02-17,2020,2
"6549","RN",2,"Nordeste",24006,"Pau dos Ferros",117909,10995.1681134604,8,23,7,16,9,14,0,0,0,0,0,23,7,16,9,14,24,9.30521119286382,11.6776684194899,0.298857812768979,2020-02-24,2020,2
"6550","RN",2,"Nordeste",24006,"Pau dos Ferros",117909,10995.1681134604,9,34,14,20,15,19,1,0,1,0,1,35,14,21,15,20,16,9.30521119286382,11.6776684194899,0.281805283723209,2020-03-02,2020,3
"6551","RN",2,"Nordeste",24006,"Pau dos Ferros",117909,10995.1681134604,10,25,10,15,10,15,1,0,1,1,0,26,10,16,11,15,13,9.30521119286382,11.6776684194899,0.319870097788872,2020-03-09,2020,3
"6552","RN",2,"Nordeste",24006,"Pau dos Ferros",117909,10995.1681134604,11,23,9,14,12,11,0,0,0,0,0,23,9,14,12,11,12,9.30521119286382,11.6776684194899,0.358715113667976,2020-03-16,2020,3
"6553","RN",2,"Nordeste",24006,"Pau dos Ferros",117909,10995.1681134604,12,30,15,15,18,12,0,0,0,0,0,30,15,15,18,12,24,9.30521119286382,11.6776684194899,0.458329925135224,2020-03-23,2020,3
"6554","RN",2,"Nordeste",24006,"Pau dos Ferros",117909,10995.1681134604,13,24,13,11,9,15,0,0,0,0,0,24,13,11,9,15,24,9.30521119286382,11.6776684194899,0.430638176062374,2020-03-30,2020,3
"6555","RN",2,"Nordeste",24006,"Pau dos Ferros",117909,10995.1681134604,14,29,8,21,16,13,1,1,0,1,0,30,9,21,17,13,23,9.30521119286382,11.6776684194899,0.411938968956677,2020-04-06,2020,4
"6556","RN",2,"Nordeste",24006,"Pau dos Ferros",117909,10995.1681134604,15,13,2,11,3,10,0,0,0,0,0,13,2,11,3,10,19,9.30521119286382,11.6776684194899,0.389153434530036,2020-04-13,2020,4
"6557","RN",2,"Nordeste",24006,"Pau dos Ferros",117909,10995.1681134604,16,37,13,24,15,22,0,0,0,0,0,37,13,24,15,22,22,9.30521119286382,11.6776684194899,0.377160939549364,2020-04-20,2020,4
"6558","RN",2,"Nordeste",24006,"Pau dos Ferros",117909,10995.1681134604,17,34,10,24,16,18,0,0,0,0,0,34,10,24,16,18,23,9.30521119286382,11.6776684194899,0.358666885588788,2020-04-27,2020,4
"6559","RN",2,"Nordeste",24006,"Pau dos Ferros",117909,10995.1681134604,18,35,10,25,13,22,0,0,0,0,0,35,10,25,13,22,18,9.30521119286382,11.6776684194899,0.372601881211024,2020-05-04,2020,5
"6560","RN",2,"Nordeste",24006,"Pau dos Ferros",117909,10995.1681134604,19,21,8,13,11,10,0,0,0,0,0,21,8,13,11,10,18,9.30521119286382,11.6776684194899,0.418204726997905,2020-05-11,2020,5
"6561","RN",2,"Nordeste",24006,"Pau dos Ferros",117909,10995.1681134604,20,24,11,13,12,12,0,0,0,0,0,24,11,13,12,12,13,9.30521119286382,11.6776684194899,0.390201057779342,2020-05-18,2020,5
"6562","RN",2,"Nordeste",24006,"Pau dos Ferros",117909,10995.1681134604,21,38,16,22,17,21,0,0,0,0,0,38,16,22,17,21,19,9.30521119286382,11.6776684194899,0.380907945193534,2020-05-25,2020,5
"6563","RN",2,"Nordeste",24007,"Umarizal",66939,9753.84063221739,5,14,8,6,8,6,0,0,0,0,0,14,8,6,8,6,7,9.18541639742598,11.1115370359026,0.263798461647605,2020-02-03,2020,2
"6564","RN",2,"Nordeste",24007,"Umarizal",66939,9753.84063221739,6,13,5,8,4,9,0,0,0,0,0,13,5,8,4,9,9,9.18541639742598,11.1115370359026,0.255656533859655,2020-02-10,2020,2
"6565","RN",2,"Nordeste",24007,"Umarizal",66939,9753.84063221739,7,9,4,5,6,3,0,0,0,0,0,9,4,5,6,3,9,9.18541639742598,11.1115370359026,0.256249802996676,2020-02-17,2020,2
"6566","RN",2,"Nordeste",24007,"Umarizal",66939,9753.84063221739,8,16,2,14,6,10,1,0,1,1,0,17,2,15,7,10,7,9.18541639742598,11.1115370359026,0.308443460755351,2020-02-24,2020,2
"6567","RN",2,"Nordeste",24007,"Umarizal",66939,9753.84063221739,9,11,2,9,6,5,0,0,0,0,0,11,2,9,6,5,7,9.18541639742598,11.1115370359026,0.286880927399968,2020-03-02,2020,3
"6568","RN",2,"Nordeste",24007,"Umarizal",66939,9753.84063221739,10,11,3,8,5,6,0,0,0,0,0,11,3,8,5,6,19,9.18541639742598,11.1115370359026,0.315077461658335,2020-03-09,2020,3
"6569","RN",2,"Nordeste",24007,"Umarizal",66939,9753.84063221739,11,15,7,8,3,12,0,0,0,0,0,15,7,8,3,12,8,9.18541639742598,11.1115370359026,0.357871062363655,2020-03-16,2020,3
"6570","RN",2,"Nordeste",24007,"Umarizal",66939,9753.84063221739,12,3,1,2,2,1,0,0,0,0,0,3,1,2,2,1,7,9.18541639742598,11.1115370359026,0.457296244698072,2020-03-23,2020,3
"6571","RN",2,"Nordeste",24007,"Umarizal",66939,9753.84063221739,13,17,5,12,9,8,0,0,0,0,0,17,5,12,9,8,9,9.18541639742598,11.1115370359026,0.418745155507184,2020-03-30,2020,3
"6572","RN",2,"Nordeste",24007,"Umarizal",66939,9753.84063221739,14,7,3,4,3,4,1,0,1,0,1,8,3,5,3,5,9,9.18541639742598,11.1115370359026,0.394794025251983,2020-04-06,2020,4
"6573","RN",2,"Nordeste",24007,"Umarizal",66939,9753.84063221739,15,9,3,6,4,5,1,0,1,1,0,10,3,7,5,5,15,9.18541639742598,11.1115370359026,0.371784564633044,2020-04-13,2020,4
"6574","RN",2,"Nordeste",24007,"Umarizal",66939,9753.84063221739,16,8,3,5,2,6,0,0,0,0,0,8,3,5,2,6,8,9.18541639742598,11.1115370359026,0.36719529722895,2020-04-20,2020,4
"6575","RN",2,"Nordeste",24007,"Umarizal",66939,9753.84063221739,17,11,3,8,6,5,0,0,0,0,0,11,3,8,6,5,11,9.18541639742598,11.1115370359026,0.351573230404424,2020-04-27,2020,4
"6576","RN",2,"Nordeste",24007,"Umarizal",66939,9753.84063221739,18,16,6,10,5,11,0,0,0,0,0,16,6,10,5,11,9,9.18541639742598,11.1115370359026,0.371560008104343,2020-05-04,2020,5
"6577","RN",2,"Nordeste",24007,"Umarizal",66939,9753.84063221739,19,8,6,2,2,6,0,0,0,0,0,8,6,2,2,6,8,9.18541639742598,11.1115370359026,0.404181419263991,2020-05-11,2020,5
"6578","RN",2,"Nordeste",24007,"Umarizal",66939,9753.84063221739,20,12,6,6,6,6,1,0,1,0,1,13,6,7,6,7,8,9.18541639742598,11.1115370359026,0.39110862074597,2020-05-18,2020,5
"6579","RN",2,"Nordeste",24007,"Umarizal",66939,9753.84063221739,21,12,5,7,5,7,0,0,0,0,0,12,5,7,5,7,7,9.18541639742598,11.1115370359026,0.381261040526551,2020-05-25,2020,5
"6580","RN",2,"Nordeste",24008,"Macau",60125,42592.4601340541,5,15,7,8,5,10,0,0,0,0,0,15,7,8,5,10,8,10.6594325244341,11.0041810074081,0.281539628555194,2020-02-03,2020,2
"6581","RN",2,"Nordeste",24008,"Macau",60125,42592.4601340541,6,19,7,12,9,10,1,1,0,0,1,20,8,12,9,11,1,10.6594325244341,11.0041810074081,0.26989572285913,2020-02-10,2020,2
"6582","RN",2,"Nordeste",24008,"Macau",60125,42592.4601340541,7,11,5,6,4,7,1,0,1,0,1,12,5,7,4,8,3,10.6594325244341,11.0041810074081,0.281198026419327,2020-02-17,2020,2
"6583","RN",2,"Nordeste",24008,"Macau",60125,42592.4601340541,8,8,2,6,6,2,0,0,0,0,0,8,2,6,6,2,9,10.6594325244341,11.0041810074081,0.354155292418822,2020-02-24,2020,2
"6584","RN",2,"Nordeste",24008,"Macau",60125,42592.4601340541,9,22,8,14,11,11,0,0,0,0,0,22,8,14,11,11,11,10.6594325244341,11.0041810074081,0.307814590763415,2020-03-02,2020,3
"6585","RN",2,"Nordeste",24008,"Macau",60125,42592.4601340541,10,11,5,6,4,7,0,0,0,0,0,11,5,6,4,7,10,10.6594325244341,11.0041810074081,0.325109711925264,2020-03-09,2020,3
"6586","RN",2,"Nordeste",24008,"Macau",60125,42592.4601340541,11,9,6,3,7,2,0,0,0,0,0,9,6,3,7,2,7,10.6594325244341,11.0041810074081,0.375038536311084,2020-03-16,2020,3
"6587","RN",2,"Nordeste",24008,"Macau",60125,42592.4601340541,12,10,2,8,3,7,0,0,0,0,0,10,2,8,3,7,7,10.6594325244341,11.0041810074081,0.462134434712583,2020-03-23,2020,3
"6588","RN",2,"Nordeste",24008,"Macau",60125,42592.4601340541,13,14,7,7,4,10,0,0,0,0,0,14,7,7,4,10,7,10.6594325244341,11.0041810074081,0.435017930825539,2020-03-30,2020,3
"6589","RN",2,"Nordeste",24008,"Macau",60125,42592.4601340541,14,8,3,5,0,8,1,0,1,0,1,9,3,6,0,9,6,10.6594325244341,11.0041810074081,0.417477330559066,2020-04-06,2020,4
"6590","RN",2,"Nordeste",24008,"Macau",60125,42592.4601340541,15,11,4,7,4,7,0,0,0,0,0,11,4,7,4,7,10,10.6594325244341,11.0041810074081,0.388646071925419,2020-04-13,2020,4
"6591","RN",2,"Nordeste",24008,"Macau",60125,42592.4601340541,16,11,7,4,8,3,0,0,0,0,0,11,7,4,8,3,7,10.6594325244341,11.0041810074081,0.40615373834262,2020-04-20,2020,4
"6592","RN",2,"Nordeste",24008,"Macau",60125,42592.4601340541,17,7,3,4,3,4,0,0,0,0,0,7,3,4,3,4,8,10.6594325244341,11.0041810074081,0.376667723782836,2020-04-27,2020,4
"6593","RN",2,"Nordeste",24008,"Macau",60125,42592.4601340541,18,12,5,7,6,6,0,0,0,0,0,12,5,7,6,6,5,10.6594325244341,11.0041810074081,0.4011102520764,2020-05-04,2020,5
"6594","RN",2,"Nordeste",24008,"Macau",60125,42592.4601340541,19,11,6,5,3,8,0,0,0,0,0,11,6,5,3,8,4,10.6594325244341,11.0041810074081,0.429417896220424,2020-05-11,2020,5
"6595","RN",2,"Nordeste",24008,"Macau",60125,42592.4601340541,20,17,7,10,8,9,0,0,0,0,0,17,7,10,8,9,4,10.6594325244341,11.0041810074081,0.417542975387123,2020-05-18,2020,5
"6596","RN",2,"Nordeste",24008,"Macau",60125,42592.4601340541,21,11,4,7,5,6,0,0,0,0,0,11,4,7,5,6,6,10.6594325244341,11.0041810074081,0.414417626130508,2020-05-25,2020,5
"6597","RN",2,"Nordeste",24009,"Angicos",52557,10065.9962619632,5,13,2,11,2,11,0,0,0,0,0,13,2,11,2,11,6,9.21691831598348,10.8696535739039,0.270944935338464,2020-02-03,2020,2
"6598","RN",2,"Nordeste",24009,"Angicos",52557,10065.9962619632,6,11,4,7,3,8,0,0,0,0,0,11,4,7,3,8,7,9.21691831598348,10.8696535739039,0.265343707719049,2020-02-10,2020,2
"6599","RN",2,"Nordeste",24009,"Angicos",52557,10065.9962619632,7,13,6,7,4,9,0,0,0,0,0,13,6,7,4,9,6,9.21691831598348,10.8696535739039,0.26566380512189,2020-02-17,2020,2
"6600","RN",2,"Nordeste",24009,"Angicos",52557,10065.9962619632,8,11,6,5,6,5,1,1,0,0,1,12,7,5,6,6,5,9.21691831598348,10.8696535739039,0.330594271847001,2020-02-24,2020,2
"6601","RN",2,"Nordeste",24009,"Angicos",52557,10065.9962619632,9,8,3,5,1,7,0,0,0,0,0,8,3,5,1,7,4,9.21691831598348,10.8696535739039,0.296581997940551,2020-03-02,2020,3
"6602","RN",2,"Nordeste",24009,"Angicos",52557,10065.9962619632,10,8,3,5,4,4,0,0,0,0,0,8,3,5,4,4,5,9.21691831598348,10.8696535739039,0.310776026307719,2020-03-09,2020,3
"6603","RN",2,"Nordeste",24009,"Angicos",52557,10065.9962619632,11,7,3,4,4,3,0,0,0,0,0,7,3,4,4,3,9,9.21691831598348,10.8696535739039,0.364898736094956,2020-03-16,2020,3
"6604","RN",2,"Nordeste",24009,"Angicos",52557,10065.9962619632,12,9,4,5,3,6,0,0,0,0,0,9,4,5,3,6,10,9.21691831598348,10.8696535739039,0.452800233529853,2020-03-23,2020,3
"6605","RN",2,"Nordeste",24009,"Angicos",52557,10065.9962619632,13,4,2,2,2,2,0,0,0,0,0,4,2,2,2,2,4,9.21691831598348,10.8696535739039,0.418342239070323,2020-03-30,2020,3
"6606","RN",2,"Nordeste",24009,"Angicos",52557,10065.9962619632,14,10,3,7,7,3,1,1,0,0,1,11,4,7,7,4,7,9.21691831598348,10.8696535739039,0.402362597758087,2020-04-06,2020,4
"6607","RN",2,"Nordeste",24009,"Angicos",52557,10065.9962619632,15,7,3,4,3,4,0,0,0,0,0,7,3,4,3,4,6,9.21691831598348,10.8696535739039,0.382712507061217,2020-04-13,2020,4
"6608","RN",2,"Nordeste",24009,"Angicos",52557,10065.9962619632,16,13,5,8,9,4,0,0,0,0,0,13,5,8,9,4,6,9.21691831598348,10.8696535739039,0.375282686443831,2020-04-20,2020,4
"6609","RN",2,"Nordeste",24009,"Angicos",52557,10065.9962619632,17,11,3,8,3,8,0,0,0,0,0,11,3,8,3,8,8,9.21691831598348,10.8696535739039,0.357211967629189,2020-04-27,2020,4
"6610","RN",2,"Nordeste",24009,"Angicos",52557,10065.9962619632,18,11,6,5,3,8,0,0,0,0,0,11,6,5,3,8,3,9.21691831598348,10.8696535739039,0.372478773075047,2020-05-04,2020,5
"6611","RN",2,"Nordeste",24009,"Angicos",52557,10065.9962619632,19,10,2,8,4,6,0,0,0,0,0,10,2,8,4,6,6,9.21691831598348,10.8696535739039,0.405261809219317,2020-05-11,2020,5
"6612","RN",2,"Nordeste",24009,"Angicos",52557,10065.9962619632,20,11,3,8,2,9,0,0,0,0,0,11,3,8,2,9,8,9.21691831598348,10.8696535739039,0.392222798109879,2020-05-18,2020,5
"6613","RN",2,"Nordeste",24009,"Angicos",52557,10065.9962619632,21,12,5,7,6,6,0,0,0,0,0,12,5,7,6,6,3,9.21691831598348,10.8696535739039,0.393479017974639,2020-05-25,2020,5
"6614","RN",2,"Nordeste",24010,"Serra de Santana",63338,18493.065352553,5,16,4,12,7,9,0,0,0,0,0,16,4,12,7,9,5,9.82515109498622,11.0562407439705,0.269112766744793,2020-02-03,2020,2
"6615","RN",2,"Nordeste",24010,"Serra de Santana",63338,18493.065352553,6,17,3,14,5,12,0,0,0,0,0,17,3,14,5,12,14,9.82515109498622,11.0562407439705,0.266647660655426,2020-02-10,2020,2
"6616","RN",2,"Nordeste",24010,"Serra de Santana",63338,18493.065352553,7,14,4,10,3,11,0,0,0,0,0,14,4,10,3,11,5,9.82515109498622,11.0562407439705,0.272811954084213,2020-02-17,2020,2
"6617","RN",2,"Nordeste",24010,"Serra de Santana",63338,18493.065352553,8,15,11,4,6,9,0,0,0,0,0,15,11,4,6,9,7,9.82515109498622,11.0562407439705,0.315026727656055,2020-02-24,2020,2
"6618","RN",2,"Nordeste",24010,"Serra de Santana",63338,18493.065352553,9,10,4,6,7,3,0,0,0,0,0,10,4,6,7,3,6,9.82515109498622,11.0562407439705,0.285879785339242,2020-03-02,2020,3
"6619","RN",2,"Nordeste",24010,"Serra de Santana",63338,18493.065352553,10,16,10,6,7,9,0,0,0,0,0,16,10,6,7,9,8,9.82515109498622,11.0562407439705,0.324034957239716,2020-03-09,2020,3
"6620","RN",2,"Nordeste",24010,"Serra de Santana",63338,18493.065352553,11,16,6,10,6,10,0,0,0,0,0,16,6,10,6,10,6,9.82515109498622,11.0562407439705,0.371372268710434,2020-03-16,2020,3
"6621","RN",2,"Nordeste",24010,"Serra de Santana",63338,18493.065352553,12,14,4,10,7,7,0,0,0,0,0,14,4,10,7,7,6,9.82515109498622,11.0562407439705,0.45269425796333,2020-03-23,2020,3
"6622","RN",2,"Nordeste",24010,"Serra de Santana",63338,18493.065352553,13,5,2,3,1,4,0,0,0,0,0,5,2,3,1,4,9,9.82515109498622,11.0562407439705,0.413855283527437,2020-03-30,2020,3
"6623","RN",2,"Nordeste",24010,"Serra de Santana",63338,18493.065352553,14,15,6,9,8,7,0,0,0,0,0,15,6,9,8,7,12,9.82515109498622,11.0562407439705,0.388190468321873,2020-04-06,2020,4
"6624","RN",2,"Nordeste",24010,"Serra de Santana",63338,18493.065352553,15,10,2,8,2,8,0,0,0,0,0,10,2,8,2,8,12,9.82515109498622,11.0562407439705,0.371049669828638,2020-04-13,2020,4
"6625","RN",2,"Nordeste",24010,"Serra de Santana",63338,18493.065352553,16,18,2,16,12,6,0,0,0,0,0,18,2,16,12,6,11,9.82515109498622,11.0562407439705,0.355693734044953,2020-04-20,2020,4
"6626","RN",2,"Nordeste",24010,"Serra de Santana",63338,18493.065352553,17,7,2,5,4,3,0,0,0,0,0,7,2,5,4,3,9,9.82515109498622,11.0562407439705,0.354194288912614,2020-04-27,2020,4
"6627","RN",2,"Nordeste",24010,"Serra de Santana",63338,18493.065352553,18,16,5,11,7,9,1,1,0,1,0,17,6,11,8,9,7,9.82515109498622,11.0562407439705,0.368251722999195,2020-05-04,2020,5
"6628","RN",2,"Nordeste",24010,"Serra de Santana",63338,18493.065352553,19,16,7,9,5,11,1,1,0,1,0,17,8,9,6,11,11,9.82515109498622,11.0562407439705,0.403502066735109,2020-05-11,2020,5
"6629","RN",2,"Nordeste",24010,"Serra de Santana",63338,18493.065352553,20,20,10,10,7,13,0,0,0,0,0,20,10,10,7,13,7,9.82515109498622,11.0562407439705,0.413717955555708,2020-05-18,2020,5
"6630","RN",2,"Nordeste",24010,"Serra de Santana",63338,18493.065352553,21,11,2,9,4,7,0,0,0,0,0,11,2,9,4,7,8,9.82515109498622,11.0562407439705,0.398600319401165,2020-05-25,2020,5
"6631","RN",2,"Nordeste",24011,"Seridó Ocidental",105853,14907.6235979141,5,19,7,12,9,10,0,0,0,0,0,19,7,12,9,10,16,9.60962801195159,11.5698066181548,0.236960241399087,2020-02-03,2020,2
"6632","RN",2,"Nordeste",24011,"Seridó Ocidental",105853,14907.6235979141,6,18,8,10,6,12,0,0,0,0,0,18,8,10,6,12,17,9.60962801195159,11.5698066181548,0.242240705128133,2020-02-10,2020,2
"6633","RN",2,"Nordeste",24011,"Seridó Ocidental",105853,14907.6235979141,7,17,5,12,5,12,0,0,0,0,0,17,5,12,5,12,7,9.60962801195159,11.5698066181548,0.244749813796012,2020-02-17,2020,2
"6634","RN",2,"Nordeste",24011,"Seridó Ocidental",105853,14907.6235979141,8,13,4,9,4,9,0,0,0,0,0,13,4,9,4,9,13,9.60962801195159,11.5698066181548,0.299683230912015,2020-02-24,2020,2
"6635","RN",2,"Nordeste",24011,"Seridó Ocidental",105853,14907.6235979141,9,20,5,15,9,11,0,0,0,0,0,20,5,15,9,11,13,9.60962801195159,11.5698066181548,0.261396726056578,2020-03-02,2020,3
"6636","RN",2,"Nordeste",24011,"Seridó Ocidental",105853,14907.6235979141,10,22,8,14,9,13,1,0,1,1,0,23,8,15,10,13,17,9.60962801195159,11.5698066181548,0.29756679702259,2020-03-09,2020,3
"6637","RN",2,"Nordeste",24011,"Seridó Ocidental",105853,14907.6235979141,11,19,5,14,4,15,0,0,0,0,0,19,5,14,4,15,12,9.60962801195159,11.5698066181548,0.35120126045634,2020-03-16,2020,3
"6638","RN",2,"Nordeste",24011,"Seridó Ocidental",105853,14907.6235979141,12,23,8,15,4,19,0,0,0,0,0,23,8,15,4,19,19,9.60962801195159,11.5698066181548,0.451104453872809,2020-03-23,2020,3
"6639","RN",2,"Nordeste",24011,"Seridó Ocidental",105853,14907.6235979141,13,20,6,14,8,12,0,0,0,0,0,20,6,14,8,12,9,9.60962801195159,11.5698066181548,0.403295045042849,2020-03-30,2020,3
"6640","RN",2,"Nordeste",24011,"Seridó Ocidental",105853,14907.6235979141,14,17,9,8,6,11,1,0,1,0,1,18,9,9,6,12,16,9.60962801195159,11.5698066181548,0.37600304852284,2020-04-06,2020,4
"6641","RN",2,"Nordeste",24011,"Seridó Ocidental",105853,14907.6235979141,15,22,7,15,9,13,0,0,0,0,0,22,7,15,9,13,12,9.60962801195159,11.5698066181548,0.362807698962938,2020-04-13,2020,4
"6642","RN",2,"Nordeste",24011,"Seridó Ocidental",105853,14907.6235979141,16,13,4,9,5,8,2,0,2,1,1,15,4,11,6,9,9,9.60962801195159,11.5698066181548,0.369579060670148,2020-04-20,2020,4
"6643","RN",2,"Nordeste",24011,"Seridó Ocidental",105853,14907.6235979141,17,20,5,15,10,10,0,0,0,0,0,20,5,15,10,10,16,9.60962801195159,11.5698066181548,0.36080854243207,2020-04-27,2020,4
"6644","RN",2,"Nordeste",24011,"Seridó Ocidental",105853,14907.6235979141,18,22,7,15,10,12,0,0,0,0,0,22,7,15,10,12,17,9.60962801195159,11.5698066181548,0.378925753823714,2020-05-04,2020,5
"6645","RN",2,"Nordeste",24011,"Seridó Ocidental",105853,14907.6235979141,19,24,5,19,10,14,0,0,0,0,0,24,5,19,10,14,15,9.60962801195159,11.5698066181548,0.414270478298334,2020-05-11,2020,5
"6646","RN",2,"Nordeste",24011,"Seridó Ocidental",105853,14907.6235979141,20,20,5,15,5,15,0,0,0,0,0,20,5,15,5,15,16,9.60962801195159,11.5698066181548,0.399212711553707,2020-05-18,2020,5
"6647","RN",2,"Nordeste",24011,"Seridó Ocidental",105853,14907.6235979141,21,25,4,21,6,19,0,0,0,0,0,25,4,21,6,19,16,9.60962801195159,11.5698066181548,0.390460398779978,2020-05-25,2020,5
"6648","RN",2,"Nordeste",24012,"Seridó Oriental",124410,14052.2147640865,5,30,8,22,8,22,0,0,0,0,0,30,8,22,8,22,17,9.55053529679344,11.7313378419085,0.252894320889085,2020-02-03,2020,2
"6649","RN",2,"Nordeste",24012,"Seridó Oriental",124410,14052.2147640865,6,28,9,19,13,15,1,1,0,1,0,29,10,19,14,15,12,9.55053529679344,11.7313378419085,0.252787139487914,2020-02-10,2020,2
"6650","RN",2,"Nordeste",24012,"Seridó Oriental",124410,14052.2147640865,7,16,4,12,6,10,0,0,0,0,0,16,4,12,6,10,20,9.55053529679344,11.7313378419085,0.2573875669083,2020-02-17,2020,2
"6651","RN",2,"Nordeste",24012,"Seridó Oriental",124410,14052.2147640865,8,19,2,17,7,12,0,0,0,0,0,19,2,17,7,12,15,9.55053529679344,11.7313378419085,0.301883761663855,2020-02-24,2020,2
"6652","RN",2,"Nordeste",24012,"Seridó Oriental",124410,14052.2147640865,9,30,9,21,13,17,1,1,0,0,1,31,10,21,13,18,21,9.55053529679344,11.7313378419085,0.273121719997196,2020-03-02,2020,3
"6653","RN",2,"Nordeste",24012,"Seridó Oriental",124410,14052.2147640865,10,22,6,16,4,18,1,0,1,1,0,23,6,17,5,18,19,9.55053529679344,11.7313378419085,0.300405424162975,2020-03-09,2020,3
"6654","RN",2,"Nordeste",24012,"Seridó Oriental",124410,14052.2147640865,11,18,3,15,4,14,1,1,0,0,1,19,4,15,4,15,19,9.55053529679344,11.7313378419085,0.357628204869594,2020-03-16,2020,3
"6655","RN",2,"Nordeste",24012,"Seridó Oriental",124410,14052.2147640865,12,19,5,14,6,13,0,0,0,0,0,19,5,14,6,13,22,9.55053529679344,11.7313378419085,0.450584531493344,2020-03-23,2020,3
"6656","RN",2,"Nordeste",24012,"Seridó Oriental",124410,14052.2147640865,13,21,6,15,11,10,0,0,0,0,0,21,6,15,11,10,24,9.55053529679344,11.7313378419085,0.409295434733096,2020-03-30,2020,3
"6657","RN",2,"Nordeste",24012,"Seridó Oriental",124410,14052.2147640865,14,25,3,22,9,16,0,0,0,0,0,25,3,22,9,16,21,9.55053529679344,11.7313378419085,0.398633939100098,2020-04-06,2020,4
"6658","RN",2,"Nordeste",24012,"Seridó Oriental",124410,14052.2147640865,15,16,2,14,5,11,0,0,0,0,0,16,2,14,5,11,17,9.55053529679344,11.7313378419085,0.383638777780645,2020-04-13,2020,4
"6659","RN",2,"Nordeste",24012,"Seridó Oriental",124410,14052.2147640865,16,21,5,16,5,16,0,0,0,0,0,21,5,16,5,16,23,9.55053529679344,11.7313378419085,0.372301400974437,2020-04-20,2020,4
"6660","RN",2,"Nordeste",24012,"Seridó Oriental",124410,14052.2147640865,17,18,4,14,7,11,0,0,0,0,0,18,4,14,7,11,17,9.55053529679344,11.7313378419085,0.359625107367719,2020-04-27,2020,4
"6661","RN",2,"Nordeste",24012,"Seridó Oriental",124410,14052.2147640865,18,38,5,33,11,27,0,0,0,0,0,38,5,33,11,27,13,9.55053529679344,11.7313378419085,0.363589293434115,2020-05-04,2020,5
"6662","RN",2,"Nordeste",24012,"Seridó Oriental",124410,14052.2147640865,19,28,7,21,9,19,0,0,0,0,0,28,7,21,9,19,17,9.55053529679344,11.7313378419085,0.389545522976993,2020-05-11,2020,5
"6663","RN",2,"Nordeste",24012,"Seridó Oriental",124410,14052.2147640865,20,26,4,22,6,20,1,1,0,0,1,27,5,22,6,21,24,9.55053529679344,11.7313378419085,0.384544820136709,2020-05-18,2020,5
"6664","RN",2,"Nordeste",24012,"Seridó Oriental",124410,14052.2147640865,21,30,10,20,9,21,0,0,0,0,0,30,10,20,9,21,20,9.55053529679344,11.7313378419085,0.373728588036719,2020-05-25,2020,5
"6665","RN",2,"Nordeste",24013,"Baixa Verde",68381,25078.7927849841,5,22,11,11,10,12,0,0,0,0,0,22,11,11,10,12,9,10.1297778590183,11.1328502872455,0.272392140535451,2020-02-03,2020,2
"6666","RN",2,"Nordeste",24013,"Baixa Verde",68381,25078.7927849841,6,12,5,7,7,5,2,2,0,2,0,14,7,7,9,5,7,10.1297778590183,11.1328502872455,0.270258547889301,2020-02-10,2020,2
"6667","RN",2,"Nordeste",24013,"Baixa Verde",68381,25078.7927849841,7,12,8,4,6,6,0,0,0,0,0,12,8,4,6,6,8,10.1297778590183,11.1328502872455,0.281705558428507,2020-02-17,2020,2
"6668","RN",2,"Nordeste",24013,"Baixa Verde",68381,25078.7927849841,8,12,3,9,8,4,0,0,0,0,0,12,3,9,8,4,8,10.1297778590183,11.1328502872455,0.3347977243887,2020-02-24,2020,2
"6669","RN",2,"Nordeste",24013,"Baixa Verde",68381,25078.7927849841,9,16,5,11,8,8,0,0,0,0,0,16,5,11,8,8,8,10.1297778590183,11.1328502872455,0.314136675580847,2020-03-02,2020,3
"6670","RN",2,"Nordeste",24013,"Baixa Verde",68381,25078.7927849841,10,17,6,11,6,11,0,0,0,0,0,17,6,11,6,11,11,10.1297778590183,11.1328502872455,0.344037916483444,2020-03-09,2020,3
"6671","RN",2,"Nordeste",24013,"Baixa Verde",68381,25078.7927849841,11,19,6,13,6,13,0,0,0,0,0,19,6,13,6,13,4,10.1297778590183,11.1328502872455,0.392268181940407,2020-03-16,2020,3
"6672","RN",2,"Nordeste",24013,"Baixa Verde",68381,25078.7927849841,12,7,3,4,5,2,0,0,0,0,0,7,3,4,5,2,12,10.1297778590183,11.1328502872455,0.467973388420918,2020-03-23,2020,3
"6673","RN",2,"Nordeste",24013,"Baixa Verde",68381,25078.7927849841,13,9,3,6,4,5,0,0,0,0,0,9,3,6,4,5,10,10.1297778590183,11.1328502872455,0.429121916500474,2020-03-30,2020,3
"6674","RN",2,"Nordeste",24013,"Baixa Verde",68381,25078.7927849841,14,13,8,5,7,6,0,0,0,0,0,13,8,5,7,6,4,10.1297778590183,11.1328502872455,0.420556716605373,2020-04-06,2020,4
"6675","RN",2,"Nordeste",24013,"Baixa Verde",68381,25078.7927849841,15,8,6,2,3,5,0,0,0,0,0,8,6,2,3,5,9,10.1297778590183,11.1328502872455,0.401214126631137,2020-04-13,2020,4
"6676","RN",2,"Nordeste",24013,"Baixa Verde",68381,25078.7927849841,16,23,10,13,11,12,0,0,0,0,0,23,10,13,11,12,4,10.1297778590183,11.1328502872455,0.404901350181091,2020-04-20,2020,4
"6677","RN",2,"Nordeste",24013,"Baixa Verde",68381,25078.7927849841,17,9,4,5,3,6,0,0,0,0,0,9,4,5,3,6,5,10.1297778590183,11.1328502872455,0.388455205163862,2020-04-27,2020,4
"6678","RN",2,"Nordeste",24013,"Baixa Verde",68381,25078.7927849841,18,11,4,7,5,6,1,1,0,1,0,12,5,7,6,6,11,10.1297778590183,11.1328502872455,0.390890826384307,2020-05-04,2020,5
"6679","RN",2,"Nordeste",24013,"Baixa Verde",68381,25078.7927849841,19,17,11,6,11,6,0,0,0,0,0,17,11,6,11,6,5,10.1297778590183,11.1328502872455,0.431574509228908,2020-05-11,2020,5
"6680","RN",2,"Nordeste",24013,"Baixa Verde",68381,25078.7927849841,20,21,9,12,11,10,0,0,0,0,0,21,9,12,11,10,7,10.1297778590183,11.1328502872455,0.403450506779588,2020-05-18,2020,5
"6681","RN",2,"Nordeste",24013,"Baixa Verde",68381,25078.7927849841,21,17,5,12,4,13,1,0,1,0,1,18,5,13,4,14,11,10.1297778590183,11.1328502872455,0.406604509559988,2020-05-25,2020,5
"6682","RN",2,"Nordeste",24014,"Borborema Potiguar",143789,9969.26676247835,5,26,10,16,13,13,0,0,0,0,0,26,10,16,13,13,16,9.20726231586604,11.8761022262111,0.264675140736382,2020-02-03,2020,2
"6683","RN",2,"Nordeste",24014,"Borborema Potiguar",143789,9969.26676247835,6,35,16,19,16,19,0,0,0,0,0,35,16,19,16,19,15,9.20726231586604,11.8761022262111,0.263594107962319,2020-02-10,2020,2
"6684","RN",2,"Nordeste",24014,"Borborema Potiguar",143789,9969.26676247835,7,31,14,17,12,19,0,0,0,0,0,31,14,17,12,19,21,9.20726231586604,11.8761022262111,0.267966520513876,2020-02-17,2020,2
"6685","RN",2,"Nordeste",24014,"Borborema Potiguar",143789,9969.26676247835,8,24,9,15,13,11,0,0,0,0,0,24,9,15,13,11,21,9.20726231586604,11.8761022262111,0.311929783682162,2020-02-24,2020,2
"6686","RN",2,"Nordeste",24014,"Borborema Potiguar",143789,9969.26676247835,9,38,21,17,15,23,0,0,0,0,0,38,21,17,15,23,22,9.20726231586604,11.8761022262111,0.292014180553049,2020-03-02,2020,3
"6687","RN",2,"Nordeste",24014,"Borborema Potiguar",143789,9969.26676247835,10,25,11,14,10,15,2,0,2,0,2,27,11,16,10,17,19,9.20726231586604,11.8761022262111,0.318431025740007,2020-03-09,2020,3
"6688","RN",2,"Nordeste",24014,"Borborema Potiguar",143789,9969.26676247835,11,36,6,30,12,24,0,0,0,0,0,36,6,30,12,24,11,9.20726231586604,11.8761022262111,0.367936269178005,2020-03-16,2020,3
"6689","RN",2,"Nordeste",24014,"Borborema Potiguar",143789,9969.26676247835,12,33,12,21,16,17,0,0,0,0,0,33,12,21,16,17,14,9.20726231586604,11.8761022262111,0.449001052713397,2020-03-23,2020,3
"6690","RN",2,"Nordeste",24014,"Borborema Potiguar",143789,9969.26676247835,13,21,11,10,12,9,0,0,0,0,0,21,11,10,12,9,14,9.20726231586604,11.8761022262111,0.410893698043913,2020-03-30,2020,3
"6691","RN",2,"Nordeste",24014,"Borborema Potiguar",143789,9969.26676247835,14,30,9,21,11,19,1,1,0,1,0,31,10,21,12,19,17,9.20726231586604,11.8761022262111,0.391858712690766,2020-04-06,2020,4
"6692","RN",2,"Nordeste",24014,"Borborema Potiguar",143789,9969.26676247835,15,30,12,18,8,22,0,0,0,0,0,30,12,18,8,22,22,9.20726231586604,11.8761022262111,0.386848803729521,2020-04-13,2020,4
"6693","RN",2,"Nordeste",24014,"Borborema Potiguar",143789,9969.26676247835,16,26,4,22,13,13,0,0,0,0,0,26,4,22,13,13,18,9.20726231586604,11.8761022262111,0.388343593894179,2020-04-20,2020,4
"6694","RN",2,"Nordeste",24014,"Borborema Potiguar",143789,9969.26676247835,17,22,8,14,9,13,1,0,1,1,0,23,8,15,10,13,22,9.20726231586604,11.8761022262111,0.374092673102884,2020-04-27,2020,4
"6695","RN",2,"Nordeste",24014,"Borborema Potiguar",143789,9969.26676247835,18,29,13,16,11,18,1,0,1,1,0,30,13,17,12,18,15,9.20726231586604,11.8761022262111,0.370371789482892,2020-05-04,2020,5
"6696","RN",2,"Nordeste",24014,"Borborema Potiguar",143789,9969.26676247835,19,34,10,24,13,21,1,0,1,1,0,35,10,25,14,21,17,9.20726231586604,11.8761022262111,0.399228820850435,2020-05-11,2020,5
"6697","RN",2,"Nordeste",24014,"Borborema Potiguar",143789,9969.26676247835,20,24,10,14,5,19,0,0,0,0,0,24,10,14,5,19,14,9.20726231586604,11.8761022262111,0.402317186108308,2020-05-18,2020,5
"6698","RN",2,"Nordeste",24014,"Borborema Potiguar",143789,9969.26676247835,21,23,10,13,12,11,0,0,0,0,0,23,10,13,12,11,29,9.20726231586604,11.8761022262111,0.390790410069852,2020-05-25,2020,5
"6699","RN",2,"Nordeste",24015,"Agreste Potiguar",253196,9495.43478115768,5,57,23,34,24,33,1,0,1,0,1,58,23,35,24,34,25,9.15856641273596,12.4419191713391,0.270578342902152,2020-02-03,2020,2
"6700","RN",2,"Nordeste",24015,"Agreste Potiguar",253196,9495.43478115768,6,60,27,33,27,33,1,1,0,1,0,61,28,33,28,33,39,9.15856641273596,12.4419191713391,0.266236880422307,2020-02-10,2020,2
"6701","RN",2,"Nordeste",24015,"Agreste Potiguar",253196,9495.43478115768,7,53,23,30,24,29,1,1,0,0,1,54,24,30,24,30,23,9.15856641273596,12.4419191713391,0.279734854232279,2020-02-17,2020,2
"6702","RN",2,"Nordeste",24015,"Agreste Potiguar",253196,9495.43478115768,8,53,21,32,25,28,2,0,2,1,1,55,21,34,26,29,25,9.15856641273596,12.4419191713391,0.324161692029066,2020-02-24,2020,2
"6703","RN",2,"Nordeste",24015,"Agreste Potiguar",253196,9495.43478115768,9,57,24,33,25,32,1,1,0,0,1,58,25,33,25,33,31,9.15856641273596,12.4419191713391,0.292828086937499,2020-03-02,2020,3
"6704","RN",2,"Nordeste",24015,"Agreste Potiguar",253196,9495.43478115768,10,63,22,41,33,30,1,0,1,0,1,64,22,42,33,31,30,9.15856641273596,12.4419191713391,0.325810061088214,2020-03-09,2020,3
"6705","RN",2,"Nordeste",24015,"Agreste Potiguar",253196,9495.43478115768,11,57,26,31,18,39,1,1,0,0,1,58,27,31,18,40,31,9.15856641273596,12.4419191713391,0.372166265842706,2020-03-16,2020,3
"6706","RN",2,"Nordeste",24015,"Agreste Potiguar",253196,9495.43478115768,12,59,32,27,25,34,1,1,0,1,0,60,33,27,26,34,32,9.15856641273596,12.4419191713391,0.466374367593909,2020-03-23,2020,3
"6707","RN",2,"Nordeste",24015,"Agreste Potiguar",253196,9495.43478115768,13,44,24,20,20,24,0,0,0,0,0,44,24,20,20,24,32,9.15856641273596,12.4419191713391,0.421030618916831,2020-03-30,2020,3
"6708","RN",2,"Nordeste",24015,"Agreste Potiguar",253196,9495.43478115768,14,52,24,28,17,35,1,1,0,0,1,53,25,28,17,36,36,9.15856641273596,12.4419191713391,0.396421200178408,2020-04-06,2020,4
"6709","RN",2,"Nordeste",24015,"Agreste Potiguar",253196,9495.43478115768,15,55,22,33,20,35,1,1,0,0,1,56,23,33,20,36,29,9.15856641273596,12.4419191713391,0.385827152370698,2020-04-13,2020,4
"6710","RN",2,"Nordeste",24015,"Agreste Potiguar",253196,9495.43478115768,16,67,24,43,25,42,1,1,0,1,0,68,25,43,26,42,28,9.15856641273596,12.4419191713391,0.378608936582694,2020-04-20,2020,4
"6711","RN",2,"Nordeste",24015,"Agreste Potiguar",253196,9495.43478115768,17,64,28,36,28,36,0,0,0,0,0,64,28,36,28,36,22,9.15856641273596,12.4419191713391,0.36498487623635,2020-04-27,2020,4
"6712","RN",2,"Nordeste",24015,"Agreste Potiguar",253196,9495.43478115768,18,70,28,42,27,43,0,0,0,0,0,70,28,42,27,43,34,9.15856641273596,12.4419191713391,0.376598117367365,2020-05-04,2020,5
"6713","RN",2,"Nordeste",24015,"Agreste Potiguar",253196,9495.43478115768,19,61,33,28,27,34,2,1,1,1,1,63,34,29,28,35,28,9.15856641273596,12.4419191713391,0.411541912829913,2020-05-11,2020,5
"6714","RN",2,"Nordeste",24015,"Agreste Potiguar",253196,9495.43478115768,20,51,23,28,19,32,0,0,0,0,0,51,23,28,19,32,34,9.15856641273596,12.4419191713391,0.404071825771725,2020-05-18,2020,5
"6715","RN",2,"Nordeste",24015,"Agreste Potiguar",253196,9495.43478115768,21,61,26,35,27,34,1,0,1,0,1,62,26,36,27,35,28,9.15856641273596,12.4419191713391,0.394541927515915,2020-05-25,2020,5
"6716","RN",2,"Nordeste",24016,"Litoral Nordeste",92534,19974.7625009186,5,20,7,13,7,13,1,0,1,0,1,21,7,14,7,14,2,9.90222488074745,11.4353314235317,0.295107662840193,2020-02-03,2020,2
"6717","RN",2,"Nordeste",24016,"Litoral Nordeste",92534,19974.7625009186,6,25,10,15,9,16,0,0,0,0,0,25,10,15,9,16,5,9.90222488074745,11.4353314235317,0.290560270851399,2020-02-10,2020,2
"6718","RN",2,"Nordeste",24016,"Litoral Nordeste",92534,19974.7625009186,7,13,4,9,9,4,0,0,0,0,0,13,4,9,9,4,11,9.90222488074745,11.4353314235317,0.298074062336887,2020-02-17,2020,2
"6719","RN",2,"Nordeste",24016,"Litoral Nordeste",92534,19974.7625009186,8,16,7,9,4,12,0,0,0,0,0,16,7,9,4,12,11,9.90222488074745,11.4353314235317,0.338997174090958,2020-02-24,2020,2
"6720","RN",2,"Nordeste",24016,"Litoral Nordeste",92534,19974.7625009186,9,27,12,15,14,13,0,0,0,0,0,27,12,15,14,13,13,9.90222488074745,11.4353314235317,0.333723335396767,2020-03-02,2020,3
"6721","RN",2,"Nordeste",24016,"Litoral Nordeste",92534,19974.7625009186,10,17,11,6,5,12,0,0,0,0,0,17,11,6,5,12,4,9.90222488074745,11.4353314235317,0.361214273931382,2020-03-09,2020,3
"6722","RN",2,"Nordeste",24016,"Litoral Nordeste",92534,19974.7625009186,11,15,7,8,9,6,0,0,0,0,0,15,7,8,9,6,8,9.90222488074745,11.4353314235317,0.388287050980253,2020-03-16,2020,3
"6723","RN",2,"Nordeste",24016,"Litoral Nordeste",92534,19974.7625009186,12,9,3,6,5,4,0,0,0,0,0,9,3,6,5,4,12,9.90222488074745,11.4353314235317,0.466925370307257,2020-03-23,2020,3
"6724","RN",2,"Nordeste",24016,"Litoral Nordeste",92534,19974.7625009186,13,23,11,12,9,14,0,0,0,0,0,23,11,12,9,14,8,9.90222488074745,11.4353314235317,0.442423529880608,2020-03-30,2020,3
"6725","RN",2,"Nordeste",24016,"Litoral Nordeste",92534,19974.7625009186,14,14,5,9,7,7,0,0,0,0,0,14,5,9,7,7,8,9.90222488074745,11.4353314235317,0.429958329083097,2020-04-06,2020,4
"6726","RN",2,"Nordeste",24016,"Litoral Nordeste",92534,19974.7625009186,15,25,13,12,13,12,0,0,0,0,0,25,13,12,13,12,11,9.90222488074745,11.4353314235317,0.423917659448038,2020-04-13,2020,4
"6727","RN",2,"Nordeste",24016,"Litoral Nordeste",92534,19974.7625009186,16,20,10,10,12,8,0,0,0,0,0,20,10,10,12,8,9,9.90222488074745,11.4353314235317,0.412602413657097,2020-04-20,2020,4
"6728","RN",2,"Nordeste",24016,"Litoral Nordeste",92534,19974.7625009186,17,19,3,16,11,8,0,0,0,0,0,19,3,16,11,8,12,9.90222488074745,11.4353314235317,0.385621197579039,2020-04-27,2020,4
"6729","RN",2,"Nordeste",24016,"Litoral Nordeste",92534,19974.7625009186,18,20,8,12,11,9,1,0,1,0,1,21,8,13,11,10,13,9.90222488074745,11.4353314235317,0.416017442513957,2020-05-04,2020,5
"6730","RN",2,"Nordeste",24016,"Litoral Nordeste",92534,19974.7625009186,19,14,9,5,5,9,0,0,0,0,0,14,9,5,5,9,15,9.90222488074745,11.4353314235317,0.447195023490657,2020-05-11,2020,5
"6731","RN",2,"Nordeste",24016,"Litoral Nordeste",92534,19974.7625009186,20,22,14,8,8,14,0,0,0,0,0,22,14,8,8,14,16,9.90222488074745,11.4353314235317,0.439718089427479,2020-05-18,2020,5
"6732","RN",2,"Nordeste",24016,"Litoral Nordeste",92534,19974.7625009186,21,20,4,16,13,7,0,0,0,0,0,20,4,16,13,7,17,9.90222488074745,11.4353314235317,0.435962878162611,2020-05-25,2020,5
"6733","RN",2,"Nordeste",24017,"Macaíba",331553,15502.2167757191,5,76,29,47,19,57,1,0,1,1,0,77,29,48,20,57,44,9.6487383104696,12.7115429551651,0.253096504569258,2020-02-03,2020,2
"6734","RN",2,"Nordeste",24017,"Macaíba",331553,15502.2167757191,6,82,24,58,34,48,0,0,0,0,0,82,24,58,34,48,48,9.6487383104696,12.7115429551651,0.254225161534461,2020-02-10,2020,2
"6735","RN",2,"Nordeste",24017,"Macaíba",331553,15502.2167757191,7,78,26,52,26,52,2,0,2,1,1,80,26,54,27,53,34,9.6487383104696,12.7115429551651,0.26950651495249,2020-02-17,2020,2
"6736","RN",2,"Nordeste",24017,"Macaíba",331553,15502.2167757191,8,85,38,47,32,53,0,0,0,0,0,85,38,47,32,53,38,9.6487383104696,12.7115429551651,0.323856441882597,2020-02-24,2020,2
"6737","RN",2,"Nordeste",24017,"Macaíba",331553,15502.2167757191,9,73,26,47,26,47,3,3,0,1,2,76,29,47,27,49,39,9.6487383104696,12.7115429551651,0.289425281413301,2020-03-02,2020,3
"6738","RN",2,"Nordeste",24017,"Macaíba",331553,15502.2167757191,10,66,25,41,21,45,1,1,0,0,1,67,26,41,21,46,41,9.6487383104696,12.7115429551651,0.314166797293892,2020-03-09,2020,3
"6739","RN",2,"Nordeste",24017,"Macaíba",331553,15502.2167757191,11,83,29,54,35,48,1,0,1,1,0,84,29,55,36,48,32,9.6487383104696,12.7115429551651,0.369527070077281,2020-03-16,2020,3
"6740","RN",2,"Nordeste",24017,"Macaíba",331553,15502.2167757191,12,63,30,33,28,35,1,1,0,0,1,64,31,33,28,36,55,9.6487383104696,12.7115429551651,0.475239077593235,2020-03-23,2020,3
"6741","RN",2,"Nordeste",24017,"Macaíba",331553,15502.2167757191,13,64,27,37,27,37,0,0,0,0,0,64,27,37,27,37,50,9.6487383104696,12.7115429551651,0.440745700822131,2020-03-30,2020,3
"6742","RN",2,"Nordeste",24017,"Macaíba",331553,15502.2167757191,14,70,27,43,29,41,2,2,0,2,0,72,29,43,31,41,38,9.6487383104696,12.7115429551651,0.431396288520799,2020-04-06,2020,4
"6743","RN",2,"Nordeste",24017,"Macaíba",331553,15502.2167757191,15,75,26,49,24,51,2,1,1,0,2,77,27,50,24,53,42,9.6487383104696,12.7115429551651,0.418777922044794,2020-04-13,2020,4
"6744","RN",2,"Nordeste",24017,"Macaíba",331553,15502.2167757191,16,92,41,51,38,54,1,0,1,1,0,93,41,52,39,54,36,9.6487383104696,12.7115429551651,0.414310333657443,2020-04-20,2020,4
"6745","RN",2,"Nordeste",24017,"Macaíba",331553,15502.2167757191,17,77,30,47,31,46,0,0,0,0,0,77,30,47,31,46,34,9.6487383104696,12.7115429551651,0.395068421944171,2020-04-27,2020,4
"6746","RN",2,"Nordeste",24017,"Macaíba",331553,15502.2167757191,18,60,19,41,22,38,0,0,0,0,0,60,19,41,22,38,43,9.6487383104696,12.7115429551651,0.384094932783329,2020-05-04,2020,5
"6747","RN",2,"Nordeste",24017,"Macaíba",331553,15502.2167757191,19,95,32,63,34,61,0,0,0,0,0,95,32,63,34,61,48,9.6487383104696,12.7115429551651,0.421516335434025,2020-05-11,2020,5
"6748","RN",2,"Nordeste",24017,"Macaíba",331553,15502.2167757191,20,84,31,53,31,53,0,0,0,0,0,84,31,53,31,53,42,9.6487383104696,12.7115429551651,0.414027119545507,2020-05-18,2020,5
"6749","RN",2,"Nordeste",24017,"Macaíba",331553,15502.2167757191,21,88,25,63,31,57,1,0,1,0,1,89,25,64,31,58,62,9.6487383104696,12.7115429551651,0.402243428750171,2020-05-25,2020,5
"6750","RN",2,"Nordeste",24018,"Natal",1186452,25280.848401385,5,270,67,203,98,172,2,0,2,0,2,272,67,205,98,174,156,10.137802407879,13.9864778989195,0.264731853057974,2020-02-03,2020,2
"6751","RN",2,"Nordeste",24018,"Natal",1186452,25280.848401385,6,268,64,204,70,198,0,0,0,0,0,268,64,204,70,198,126,10.137802407879,13.9864778989195,0.266023965843237,2020-02-10,2020,2
"6752","RN",2,"Nordeste",24018,"Natal",1186452,25280.848401385,7,251,68,183,81,170,1,0,1,0,1,252,68,184,81,171,133,10.137802407879,13.9864778989195,0.2772525425002,2020-02-17,2020,2
"6753","RN",2,"Nordeste",24018,"Natal",1186452,25280.848401385,8,270,66,204,89,181,5,4,1,0,5,275,70,205,89,186,130,10.137802407879,13.9864778989195,0.337421845802607,2020-02-24,2020,2
"6754","RN",2,"Nordeste",24018,"Natal",1186452,25280.848401385,9,236,55,181,75,161,2,1,1,1,1,238,56,182,76,162,133,10.137802407879,13.9864778989195,0.295537654777164,2020-03-02,2020,3
"6755","RN",2,"Nordeste",24018,"Natal",1186452,25280.848401385,10,221,59,162,81,140,4,1,3,1,3,225,60,165,82,143,130,10.137802407879,13.9864778989195,0.3183084629243,2020-03-09,2020,3
"6756","RN",2,"Nordeste",24018,"Natal",1186452,25280.848401385,11,257,74,183,107,150,1,1,0,1,0,258,75,183,108,150,147,10.137802407879,13.9864778989195,0.399540076599843,2020-03-16,2020,3
"6757","RN",2,"Nordeste",24018,"Natal",1186452,25280.848401385,12,241,71,170,84,157,1,0,1,0,1,242,71,171,84,158,132,10.137802407879,13.9864778989195,0.530572315790033,2020-03-23,2020,3
"6758","RN",2,"Nordeste",24018,"Natal",1186452,25280.848401385,13,241,80,161,79,162,2,1,1,1,1,243,81,162,80,163,136,10.137802407879,13.9864778989195,0.48815502170026,2020-03-30,2020,3
"6759","RN",2,"Nordeste",24018,"Natal",1186452,25280.848401385,14,228,57,171,84,144,1,1,0,1,0,229,58,171,85,144,108,10.137802407879,13.9864778989195,0.481738736048969,2020-04-06,2020,4
"6760","RN",2,"Nordeste",24018,"Natal",1186452,25280.848401385,15,247,67,180,77,170,3,2,1,3,0,250,69,181,80,170,122,10.137802407879,13.9864778989195,0.464641571851609,2020-04-13,2020,4
"6761","RN",2,"Nordeste",24018,"Natal",1186452,25280.848401385,16,270,78,192,86,184,2,1,1,0,2,272,79,193,86,186,135,10.137802407879,13.9864778989195,0.465877550315346,2020-04-20,2020,4
"6762","RN",2,"Nordeste",24018,"Natal",1186452,25280.848401385,17,255,59,196,84,171,2,1,1,2,0,257,60,197,86,171,150,10.137802407879,13.9864778989195,0.445231846416337,2020-04-27,2020,4
"6763","RN",2,"Nordeste",24018,"Natal",1186452,25280.848401385,18,267,66,201,90,177,3,0,3,0,3,270,66,204,90,180,146,10.137802407879,13.9864778989195,0.426388670140764,2020-05-04,2020,5
"6764","RN",2,"Nordeste",24018,"Natal",1186452,25280.848401385,19,259,70,189,89,170,2,2,0,0,2,261,72,189,89,172,152,10.137802407879,13.9864778989195,0.458781946662742,2020-05-11,2020,5
"6765","RN",2,"Nordeste",24018,"Natal",1186452,25280.848401385,20,250,73,177,92,158,3,2,1,1,2,253,75,178,93,160,191,10.137802407879,13.9864778989195,0.449702754343296,2020-05-18,2020,5
"6766","RN",2,"Nordeste",24018,"Natal",1186452,25280.848401385,21,245,62,183,77,168,1,0,1,0,1,246,62,184,77,169,197,10.137802407879,13.9864778989195,0.435241902301801,2020-05-25,2020,5
"6767","RN",2,"Nordeste",24019,"Litoral Sul",143610,16257.5398523083,5,33,13,20,15,18,1,1,0,0,1,34,14,20,15,19,15,9.69631207105867,11.8748565710547,0.272095856113496,2020-02-03,2020,2
"6768","RN",2,"Nordeste",24019,"Litoral Sul",143610,16257.5398523083,6,34,14,20,12,22,0,0,0,0,0,34,14,20,12,22,18,9.69631207105867,11.8748565710547,0.268837273951621,2020-02-10,2020,2
"6769","RN",2,"Nordeste",24019,"Litoral Sul",143610,16257.5398523083,7,33,19,14,12,21,0,0,0,0,0,33,19,14,12,21,17,9.69631207105867,11.8748565710547,0.277669446636236,2020-02-17,2020,2
"6770","RN",2,"Nordeste",24019,"Litoral Sul",143610,16257.5398523083,8,33,17,16,15,18,2,2,0,2,0,35,19,16,17,18,17,9.69631207105867,11.8748565710547,0.322661150997595,2020-02-24,2020,2
"6771","RN",2,"Nordeste",24019,"Litoral Sul",143610,16257.5398523083,9,37,21,16,22,15,0,0,0,0,0,37,21,16,22,15,18,9.69631207105867,11.8748565710547,0.305069985352389,2020-03-02,2020,3
"6772","RN",2,"Nordeste",24019,"Litoral Sul",143610,16257.5398523083,10,41,23,18,26,15,0,0,0,0,0,41,23,18,26,15,21,9.69631207105867,11.8748565710547,0.346536856914141,2020-03-09,2020,3
"6773","RN",2,"Nordeste",24019,"Litoral Sul",143610,16257.5398523083,11,27,8,19,14,13,0,0,0,0,0,27,8,19,14,13,13,9.69631207105867,11.8748565710547,0.385595442679071,2020-03-16,2020,3
"6774","RN",2,"Nordeste",24019,"Litoral Sul",143610,16257.5398523083,12,49,25,24,25,24,1,0,1,0,1,50,25,25,25,25,18,9.69631207105867,11.8748565710547,0.488654285845405,2020-03-23,2020,3
"6775","RN",2,"Nordeste",24019,"Litoral Sul",143610,16257.5398523083,13,38,18,20,19,19,0,0,0,0,0,38,18,20,19,19,20,9.69631207105867,11.8748565710547,0.442002561986908,2020-03-30,2020,3
"6776","RN",2,"Nordeste",24019,"Litoral Sul",143610,16257.5398523083,14,33,17,16,15,18,0,0,0,0,0,33,17,16,15,18,14,9.69631207105867,11.8748565710547,0.421778594371376,2020-04-06,2020,4
"6777","RN",2,"Nordeste",24019,"Litoral Sul",143610,16257.5398523083,15,38,16,22,15,23,0,0,0,0,0,38,16,22,15,23,16,9.69631207105867,11.8748565710547,0.415148721557713,2020-04-13,2020,4
"6778","RN",2,"Nordeste",24019,"Litoral Sul",143610,16257.5398523083,16,30,10,20,9,21,0,0,0,0,0,30,10,20,9,21,13,9.69631207105867,11.8748565710547,0.414349185092387,2020-04-20,2020,4
"6779","RN",2,"Nordeste",24019,"Litoral Sul",143610,16257.5398523083,17,42,23,19,18,24,1,0,1,0,1,43,23,20,18,25,13,9.69631207105867,11.8748565710547,0.395226344198229,2020-04-27,2020,4
"6780","RN",2,"Nordeste",24019,"Litoral Sul",143610,16257.5398523083,18,41,20,21,23,18,0,0,0,0,0,41,20,21,23,18,24,9.69631207105867,11.8748565710547,0.403816268486519,2020-05-04,2020,5
"6781","RN",2,"Nordeste",24019,"Litoral Sul",143610,16257.5398523083,19,45,27,18,22,23,0,0,0,0,0,45,27,18,22,23,9,9.69631207105867,11.8748565710547,0.445449869157849,2020-05-11,2020,5
"6782","RN",2,"Nordeste",24019,"Litoral Sul",143610,16257.5398523083,20,34,18,16,14,20,1,0,1,1,0,35,18,17,15,20,16,9.69631207105867,11.8748565710547,0.423775968551384,2020-05-18,2020,5
"6783","RN",2,"Nordeste",24019,"Litoral Sul",143610,16257.5398523083,21,45,18,27,19,26,1,1,0,1,0,46,19,27,20,26,25,9.69631207105867,11.8748565710547,0.399613957670899,2020-05-25,2020,5
"6784","RO",1,"Norte",11001,"Porto Velho",689580,28976.4156223933,5,147,43,104,75,72,2,1,1,1,1,149,44,105,76,73,53,10.2742375236976,13.4438379955909,0.299377028757918,2020-02-03,2020,2
"6785","RO",1,"Norte",11001,"Porto Velho",689580,28976.4156223933,6,150,39,111,79,71,3,1,2,1,2,153,40,113,80,73,55,10.2742375236976,13.4438379955909,0.296470758262756,2020-02-10,2020,2
"6786","RO",1,"Norte",11001,"Porto Velho",689580,28976.4156223933,7,177,53,124,72,105,2,1,1,1,1,179,54,125,73,106,53,10.2742375236976,13.4438379955909,0.313485540591117,2020-02-17,2020,2
"6787","RO",1,"Norte",11001,"Porto Velho",689580,28976.4156223933,8,159,68,91,78,81,1,1,0,0,1,160,69,91,78,82,43,10.2742375236976,13.4438379955909,0.360670375021636,2020-02-24,2020,2
"6788","RO",1,"Norte",11001,"Porto Velho",689580,28976.4156223933,9,168,41,127,76,92,0,0,0,0,0,168,41,127,76,92,51,10.2742375236976,13.4438379955909,0.337876888175529,2020-03-02,2020,3
"6789","RO",1,"Norte",11001,"Porto Velho",689580,28976.4156223933,10,166,42,124,71,95,0,0,0,0,0,166,42,124,71,95,65,10.2742375236976,13.4438379955909,0.348769028134729,2020-03-09,2020,3
"6790","RO",1,"Norte",11001,"Porto Velho",689580,28976.4156223933,11,146,40,106,67,79,2,1,1,0,2,148,41,107,67,81,65,10.2742375236976,13.4438379955909,0.430085299430305,2020-03-16,2020,3
"6791","RO",1,"Norte",11001,"Porto Velho",689580,28976.4156223933,12,174,60,114,74,100,0,0,0,0,0,174,60,114,74,100,62,10.2742375236976,13.4438379955909,0.522208450315977,2020-03-23,2020,3
"6792","RO",1,"Norte",11001,"Porto Velho",689580,28976.4156223933,13,152,45,107,65,87,1,1,0,1,0,153,46,107,66,87,56,10.2742375236976,13.4438379955909,0.474090500654225,2020-03-30,2020,3
"6793","RO",1,"Norte",11001,"Porto Velho",689580,28976.4156223933,14,136,27,109,53,83,3,1,2,1,2,139,28,111,54,85,57,10.2742375236976,13.4438379955909,0.46884084119365,2020-04-06,2020,4
"6794","RO",1,"Norte",11001,"Porto Velho",689580,28976.4156223933,15,154,53,101,79,75,1,0,1,1,0,155,53,102,80,75,55,10.2742375236976,13.4438379955909,0.459163632963259,2020-04-13,2020,4
"6795","RO",1,"Norte",11001,"Porto Velho",689580,28976.4156223933,16,192,59,133,79,113,3,1,2,1,2,195,60,135,80,115,61,10.2742375236976,13.4438379955909,0.45840235681199,2020-04-20,2020,4
"6796","RO",1,"Norte",11001,"Porto Velho",689580,28976.4156223933,17,141,37,104,58,83,1,1,0,1,0,142,38,104,59,83,76,10.2742375236976,13.4438379955909,0.445967249902001,2020-04-27,2020,4
"6797","RO",1,"Norte",11001,"Porto Velho",689580,28976.4156223933,18,150,48,102,66,84,2,0,2,1,1,152,48,104,67,85,78,10.2742375236976,13.4438379955909,0.42993567678471,2020-05-04,2020,5
"6798","RO",1,"Norte",11001,"Porto Velho",689580,28976.4156223933,19,149,44,105,69,80,1,0,1,0,1,150,44,106,69,81,79,10.2742375236976,13.4438379955909,0.455902955427728,2020-05-11,2020,5
"6799","RO",1,"Norte",11001,"Porto Velho",689580,28976.4156223933,20,141,38,103,65,76,3,2,1,2,1,144,40,104,67,77,98,10.2742375236976,13.4438379955909,0.453305626527117,2020-05-18,2020,5
"6800","RO",1,"Norte",11001,"Porto Velho",689580,28976.4156223933,21,154,39,115,91,63,2,0,2,0,2,156,39,117,91,65,82,10.2742375236976,13.4438379955909,0.436890858752631,2020-05-25,2020,5
"6801","RO",1,"Norte",11002,"Guajará-Mirim",86035,16981.5701314581,5,27,8,19,10,17,0,0,0,0,0,27,8,19,10,17,4,9.73988392505191,11.3625094691873,0.314253881278876,2020-02-03,2020,2
"6802","RO",1,"Norte",11002,"Guajará-Mirim",86035,16981.5701314581,6,24,8,16,11,13,0,0,0,0,0,24,8,16,11,13,8,9.73988392505191,11.3625094691873,0.289407543117619,2020-02-10,2020,2
"6803","RO",1,"Norte",11002,"Guajará-Mirim",86035,16981.5701314581,7,19,12,7,9,10,0,0,0,0,0,19,12,7,9,10,7,9.73988392505191,11.3625094691873,0.326386138638157,2020-02-17,2020,2
"6804","RO",1,"Norte",11002,"Guajará-Mirim",86035,16981.5701314581,8,23,5,18,12,11,1,0,1,0,1,24,5,19,12,12,10,9.73988392505191,11.3625094691873,0.336326203630042,2020-02-24,2020,2
"6805","RO",1,"Norte",11002,"Guajará-Mirim",86035,16981.5701314581,9,24,13,11,12,12,0,0,0,0,0,24,13,11,12,12,6,9.73988392505191,11.3625094691873,0.33932639378612,2020-03-02,2020,3
"6806","RO",1,"Norte",11002,"Guajará-Mirim",86035,16981.5701314581,10,19,9,10,12,7,0,0,0,0,0,19,9,10,12,7,7,9.73988392505191,11.3625094691873,0.34570154486829,2020-03-09,2020,3
"6807","RO",1,"Norte",11002,"Guajará-Mirim",86035,16981.5701314581,11,15,7,8,6,9,0,0,0,0,0,15,7,8,6,9,10,9.73988392505191,11.3625094691873,0.41063269429176,2020-03-16,2020,3
"6808","RO",1,"Norte",11002,"Guajará-Mirim",86035,16981.5701314581,12,21,8,13,5,16,0,0,0,0,0,21,8,13,5,16,8,9.73988392505191,11.3625094691873,0.471453609017489,2020-03-23,2020,3
"6809","RO",1,"Norte",11002,"Guajará-Mirim",86035,16981.5701314581,13,19,10,9,12,7,0,0,0,0,0,19,10,9,12,7,2,9.73988392505191,11.3625094691873,0.427606634531889,2020-03-30,2020,3
"6810","RO",1,"Norte",11002,"Guajará-Mirim",86035,16981.5701314581,14,22,13,9,12,10,0,0,0,0,0,22,13,9,12,10,7,9.73988392505191,11.3625094691873,0.430511358581983,2020-04-06,2020,4
"6811","RO",1,"Norte",11002,"Guajará-Mirim",86035,16981.5701314581,15,22,8,14,8,14,1,1,0,1,0,23,9,14,9,14,4,9.73988392505191,11.3625094691873,0.426149150347033,2020-04-13,2020,4
"6812","RO",1,"Norte",11002,"Guajará-Mirim",86035,16981.5701314581,16,27,9,18,12,15,0,0,0,0,0,27,9,18,12,15,8,9.73988392505191,11.3625094691873,0.440456149573744,2020-04-20,2020,4
"6813","RO",1,"Norte",11002,"Guajará-Mirim",86035,16981.5701314581,17,20,9,11,10,10,0,0,0,0,0,20,9,11,10,10,12,9.73988392505191,11.3625094691873,0.427356090214721,2020-04-27,2020,4
"6814","RO",1,"Norte",11002,"Guajará-Mirim",86035,16981.5701314581,18,14,6,8,3,11,0,0,0,0,0,14,6,8,3,11,12,9.73988392505191,11.3625094691873,0.427470028951943,2020-05-04,2020,5
"6815","RO",1,"Norte",11002,"Guajará-Mirim",86035,16981.5701314581,19,22,8,14,8,14,0,0,0,0,0,22,8,14,8,14,18,9.73988392505191,11.3625094691873,0.453560505425057,2020-05-11,2020,5
"6816","RO",1,"Norte",11002,"Guajará-Mirim",86035,16981.5701314581,20,28,9,19,16,12,0,0,0,0,0,28,9,19,16,12,10,9.73988392505191,11.3625094691873,0.464665529361602,2020-05-18,2020,5
"6817","RO",1,"Norte",11002,"Guajará-Mirim",86035,16981.5701314581,21,21,7,14,9,12,0,0,0,0,0,21,7,14,9,12,14,9.73988392505191,11.3625094691873,0.44396735975748,2020-05-25,2020,5
"6818","RO",1,"Norte",11003,"Ariquemes",209694,20314.1101934247,5,65,22,43,36,29,0,0,0,0,0,65,22,43,36,29,16,9.91907100699122,12.2534046041774,0.289696280048098,2020-02-03,2020,2
"6819","RO",1,"Norte",11003,"Ariquemes",209694,20314.1101934247,6,37,8,29,15,22,0,0,0,0,0,37,8,29,15,22,12,9.91907100699122,12.2534046041774,0.293799220613929,2020-02-10,2020,2
"6820","RO",1,"Norte",11003,"Ariquemes",209694,20314.1101934247,7,48,16,32,26,22,0,0,0,0,0,48,16,32,26,22,15,9.91907100699122,12.2534046041774,0.307869287910069,2020-02-17,2020,2
"6821","RO",1,"Norte",11003,"Ariquemes",209694,20314.1101934247,8,42,6,36,17,25,0,0,0,0,0,42,6,36,17,25,18,9.91907100699122,12.2534046041774,0.337851901548499,2020-02-24,2020,2
"6822","RO",1,"Norte",11003,"Ariquemes",209694,20314.1101934247,9,55,16,39,29,26,1,0,1,1,0,56,16,40,30,26,17,9.91907100699122,12.2534046041774,0.337765364967141,2020-03-02,2020,3
"6823","RO",1,"Norte",11003,"Ariquemes",209694,20314.1101934247,10,52,15,37,29,23,1,1,0,0,1,53,16,37,29,24,26,9.91907100699122,12.2534046041774,0.340966441365543,2020-03-09,2020,3
"6824","RO",1,"Norte",11003,"Ariquemes",209694,20314.1101934247,11,59,14,45,28,31,0,0,0,0,0,59,14,45,28,31,19,9.91907100699122,12.2534046041774,0.39468195555073,2020-03-16,2020,3
"6825","RO",1,"Norte",11003,"Ariquemes",209694,20314.1101934247,12,45,16,29,17,28,2,0,2,1,1,47,16,31,18,29,19,9.91907100699122,12.2534046041774,0.48350887237431,2020-03-23,2020,3
"6826","RO",1,"Norte",11003,"Ariquemes",209694,20314.1101934247,13,44,18,26,17,27,0,0,0,0,0,44,18,26,17,27,22,9.91907100699122,12.2534046041774,0.426351613964095,2020-03-30,2020,3
"6827","RO",1,"Norte",11003,"Ariquemes",209694,20314.1101934247,14,37,11,26,14,23,1,0,1,0,1,38,11,27,14,24,21,9.91907100699122,12.2534046041774,0.43088966453297,2020-04-06,2020,4
"6828","RO",1,"Norte",11003,"Ariquemes",209694,20314.1101934247,15,46,12,34,19,27,0,0,0,0,0,46,12,34,19,27,11,9.91907100699122,12.2534046041774,0.416137968959443,2020-04-13,2020,4
"6829","RO",1,"Norte",11003,"Ariquemes",209694,20314.1101934247,16,37,11,26,21,16,0,0,0,0,0,37,11,26,21,16,14,9.91907100699122,12.2534046041774,0.428898017862396,2020-04-20,2020,4
"6830","RO",1,"Norte",11003,"Ariquemes",209694,20314.1101934247,17,50,10,40,29,21,1,0,1,0,1,51,10,41,29,22,17,9.91907100699122,12.2534046041774,0.41741368174573,2020-04-27,2020,4
"6831","RO",1,"Norte",11003,"Ariquemes",209694,20314.1101934247,18,48,18,30,26,22,0,0,0,0,0,48,18,30,26,22,16,9.91907100699122,12.2534046041774,0.401855161661149,2020-05-04,2020,5
"6832","RO",1,"Norte",11003,"Ariquemes",209694,20314.1101934247,19,46,16,30,16,30,1,1,0,0,1,47,17,30,16,31,17,9.91907100699122,12.2534046041774,0.416537570333067,2020-05-11,2020,5
"6833","RO",1,"Norte",11003,"Ariquemes",209694,20314.1101934247,20,55,11,44,21,34,1,0,1,1,0,56,11,45,22,34,14,9.91907100699122,12.2534046041774,0.40946911809582,2020-05-18,2020,5
"6834","RO",1,"Norte",11003,"Ariquemes",209694,20314.1101934247,21,56,17,39,26,30,0,0,0,0,0,56,17,39,26,30,19,9.91907100699122,12.2534046041774,0.393931794747226,2020-05-25,2020,5
"6835","RO",1,"Norte",11004,"Ji-Paraná",293651,24535.4651779834,5,84,22,62,33,51,0,0,0,0,0,84,22,62,33,51,40,10.1078749081153,12.5901472663595,0.306211518173065,2020-02-03,2020,2
"6836","RO",1,"Norte",11004,"Ji-Paraná",293651,24535.4651779834,6,79,24,55,31,48,0,0,0,0,0,79,24,55,31,48,35,10.1078749081153,12.5901472663595,0.297441249341463,2020-02-10,2020,2
"6837","RO",1,"Norte",11004,"Ji-Paraná",293651,24535.4651779834,7,74,19,55,32,42,2,1,1,2,0,76,20,56,34,42,20,10.1078749081153,12.5901472663595,0.312229690909566,2020-02-17,2020,2
"6838","RO",1,"Norte",11004,"Ji-Paraná",293651,24535.4651779834,8,70,13,57,29,41,0,0,0,0,0,70,13,57,29,41,33,10.1078749081153,12.5901472663595,0.341907753386937,2020-02-24,2020,2
"6839","RO",1,"Norte",11004,"Ji-Paraná",293651,24535.4651779834,9,87,31,56,42,45,0,0,0,0,0,87,31,56,42,45,30,10.1078749081153,12.5901472663595,0.32159498437089,2020-03-02,2020,3
"6840","RO",1,"Norte",11004,"Ji-Paraná",293651,24535.4651779834,10,64,17,47,26,38,0,0,0,0,0,64,17,47,26,38,32,10.1078749081153,12.5901472663595,0.336425327897081,2020-03-09,2020,3
"6841","RO",1,"Norte",11004,"Ji-Paraná",293651,24535.4651779834,11,68,12,56,20,48,2,0,2,1,1,70,12,58,21,49,29,10.1078749081153,12.5901472663595,0.407101313227477,2020-03-16,2020,3
"6842","RO",1,"Norte",11004,"Ji-Paraná",293651,24535.4651779834,12,67,15,52,27,40,0,0,0,0,0,67,15,52,27,40,24,10.1078749081153,12.5901472663595,0.495444475591973,2020-03-23,2020,3
"6843","RO",1,"Norte",11004,"Ji-Paraná",293651,24535.4651779834,13,64,13,51,28,36,0,0,0,0,0,64,13,51,28,36,34,10.1078749081153,12.5901472663595,0.434792004480474,2020-03-30,2020,3
"6844","RO",1,"Norte",11004,"Ji-Paraná",293651,24535.4651779834,14,57,12,45,24,33,0,0,0,0,0,57,12,45,24,33,38,10.1078749081153,12.5901472663595,0.424181537295722,2020-04-06,2020,4
"6845","RO",1,"Norte",11004,"Ji-Paraná",293651,24535.4651779834,15,60,18,42,27,33,0,0,0,0,0,60,18,42,27,33,22,10.1078749081153,12.5901472663595,0.405678248567452,2020-04-13,2020,4
"6846","RO",1,"Norte",11004,"Ji-Paraná",293651,24535.4651779834,16,75,18,57,34,41,1,0,1,1,0,76,18,58,35,41,18,10.1078749081153,12.5901472663595,0.41351025342336,2020-04-20,2020,4
"6847","RO",1,"Norte",11004,"Ji-Paraná",293651,24535.4651779834,17,80,15,65,28,52,0,0,0,0,0,80,15,65,28,52,45,10.1078749081153,12.5901472663595,0.406907778331225,2020-04-27,2020,4
"6848","RO",1,"Norte",11004,"Ji-Paraná",293651,24535.4651779834,18,62,12,50,25,37,0,0,0,0,0,62,12,50,25,37,33,10.1078749081153,12.5901472663595,0.396938928103052,2020-05-04,2020,5
"6849","RO",1,"Norte",11004,"Ji-Paraná",293651,24535.4651779834,19,78,20,58,31,47,0,0,0,0,0,78,20,58,31,47,28,10.1078749081153,12.5901472663595,0.409366032456553,2020-05-11,2020,5
"6850","RO",1,"Norte",11004,"Ji-Paraná",293651,24535.4651779834,20,54,17,37,22,32,1,0,1,1,0,55,17,38,23,32,31,10.1078749081153,12.5901472663595,0.402237740405493,2020-05-18,2020,5
"6851","RO",1,"Norte",11004,"Ji-Paraná",293651,24535.4651779834,21,68,14,54,28,40,0,0,0,0,0,68,14,54,28,40,25,10.1078749081153,12.5901472663595,0.391378097622007,2020-05-25,2020,5
"6852","RO",1,"Norte",11005,"Alvorada D'Oeste",69523,22541.1105366569,5,22,6,16,7,15,0,0,0,0,0,22,6,16,7,15,8,10.0230960559744,11.1494129120577,0.336732668955062,2020-02-03,2020,2
"6853","RO",1,"Norte",11005,"Alvorada D'Oeste",69523,22541.1105366569,6,17,2,15,7,10,0,0,0,0,0,17,2,15,7,10,9,10.0230960559744,11.1494129120577,0.319187178473139,2020-02-10,2020,2
"6854","RO",1,"Norte",11005,"Alvorada D'Oeste",69523,22541.1105366569,7,15,6,9,6,9,0,0,0,0,0,15,6,9,6,9,2,10.0230960559744,11.1494129120577,0.325703488781384,2020-02-17,2020,2
"6855","RO",1,"Norte",11005,"Alvorada D'Oeste",69523,22541.1105366569,8,24,5,19,14,10,0,0,0,0,0,24,5,19,14,10,16,10.0230960559744,11.1494129120577,0.352571625325378,2020-02-24,2020,2
"6856","RO",1,"Norte",11005,"Alvorada D'Oeste",69523,22541.1105366569,9,21,5,16,6,15,0,0,0,0,0,21,5,16,6,15,7,10.0230960559744,11.1494129120577,0.336770237730782,2020-03-02,2020,3
"6857","RO",1,"Norte",11005,"Alvorada D'Oeste",69523,22541.1105366569,10,30,6,24,12,18,0,0,0,0,0,30,6,24,12,18,5,10.0230960559744,11.1494129120577,0.363831744629084,2020-03-09,2020,3
"6858","RO",1,"Norte",11005,"Alvorada D'Oeste",69523,22541.1105366569,11,19,2,17,5,14,0,0,0,0,0,19,2,17,5,14,6,10.0230960559744,11.1494129120577,0.409005238708472,2020-03-16,2020,3
"6859","RO",1,"Norte",11005,"Alvorada D'Oeste",69523,22541.1105366569,12,8,6,2,3,5,0,0,0,0,0,8,6,2,3,5,2,10.0230960559744,11.1494129120577,0.472354368731054,2020-03-23,2020,3
"6860","RO",1,"Norte",11005,"Alvorada D'Oeste",69523,22541.1105366569,13,12,5,7,5,7,0,0,0,0,0,12,5,7,5,7,12,10.0230960559744,11.1494129120577,0.426975261858033,2020-03-30,2020,3
"6861","RO",1,"Norte",11005,"Alvorada D'Oeste",69523,22541.1105366569,14,4,3,1,3,1,0,0,0,0,0,4,3,1,3,1,4,10.0230960559744,11.1494129120577,0.432112106388427,2020-04-06,2020,4
"6862","RO",1,"Norte",11005,"Alvorada D'Oeste",69523,22541.1105366569,15,17,3,14,5,12,0,0,0,0,0,17,3,14,5,12,4,10.0230960559744,11.1494129120577,0.392786791490435,2020-04-13,2020,4
"6863","RO",1,"Norte",11005,"Alvorada D'Oeste",69523,22541.1105366569,16,17,6,11,9,8,0,0,0,0,0,17,6,11,9,8,6,10.0230960559744,11.1494129120577,0.423920669655575,2020-04-20,2020,4
"6864","RO",1,"Norte",11005,"Alvorada D'Oeste",69523,22541.1105366569,17,11,2,9,2,9,0,0,0,0,0,11,2,9,2,9,11,10.0230960559744,11.1494129120577,0.440858884858263,2020-04-27,2020,4
"6865","RO",1,"Norte",11005,"Alvorada D'Oeste",69523,22541.1105366569,18,24,7,17,10,14,0,0,0,0,0,24,7,17,10,14,7,10.0230960559744,11.1494129120577,0.444330235778868,2020-05-04,2020,5
"6866","RO",1,"Norte",11005,"Alvorada D'Oeste",69523,22541.1105366569,19,22,4,18,11,11,0,0,0,0,0,22,4,18,11,11,6,10.0230960559744,11.1494129120577,0.446141660665937,2020-05-11,2020,5
"6867","RO",1,"Norte",11005,"Alvorada D'Oeste",69523,22541.1105366569,20,24,5,19,8,16,0,0,0,0,0,24,5,19,8,16,7,10.0230960559744,11.1494129120577,0.443755325922683,2020-05-18,2020,5
"6868","RO",1,"Norte",11005,"Alvorada D'Oeste",69523,22541.1105366569,21,16,3,13,8,8,0,0,0,0,0,16,3,13,8,8,5,10.0230960559744,11.1494129120577,0.476594756415865,2020-05-25,2020,5
"6869","RO",1,"Norte",11006,"Cacoal",237069,23344.7486784016,5,62,13,49,27,35,0,0,0,0,0,62,13,49,27,35,22,10.0581273418042,12.376106516985,0.305963674466008,2020-02-03,2020,2
"6870","RO",1,"Norte",11006,"Cacoal",237069,23344.7486784016,6,61,14,47,24,37,0,0,0,0,0,61,14,47,24,37,16,10.0581273418042,12.376106516985,0.306426408635654,2020-02-10,2020,2
"6871","RO",1,"Norte",11006,"Cacoal",237069,23344.7486784016,7,66,16,50,27,39,0,0,0,0,0,66,16,50,27,39,27,10.0581273418042,12.376106516985,0.326753178697057,2020-02-17,2020,2
"6872","RO",1,"Norte",11006,"Cacoal",237069,23344.7486784016,8,61,12,49,20,41,0,0,0,0,0,61,12,49,20,41,27,10.0581273418042,12.376106516985,0.356287249284558,2020-02-24,2020,2
"6873","RO",1,"Norte",11006,"Cacoal",237069,23344.7486784016,9,81,13,68,29,52,0,0,0,0,0,81,13,68,29,52,28,10.0581273418042,12.376106516985,0.345027864567644,2020-03-02,2020,3
"6874","RO",1,"Norte",11006,"Cacoal",237069,23344.7486784016,10,65,17,48,26,39,0,0,0,0,0,65,17,48,26,39,27,10.0581273418042,12.376106516985,0.354427138152553,2020-03-09,2020,3
"6875","RO",1,"Norte",11006,"Cacoal",237069,23344.7486784016,11,41,8,33,20,21,0,0,0,0,0,41,8,33,20,21,30,10.0581273418042,12.376106516985,0.431201785731749,2020-03-16,2020,3
"6876","RO",1,"Norte",11006,"Cacoal",237069,23344.7486784016,12,57,16,41,28,29,0,0,0,0,0,57,16,41,28,29,25,10.0581273418042,12.376106516985,0.527784181965461,2020-03-23,2020,3
"6877","RO",1,"Norte",11006,"Cacoal",237069,23344.7486784016,13,38,8,30,19,19,1,0,1,1,0,39,8,31,20,19,12,10.0581273418042,12.376106516985,0.466395300649665,2020-03-30,2020,3
"6878","RO",1,"Norte",11006,"Cacoal",237069,23344.7486784016,14,72,17,55,20,52,1,0,1,0,1,73,17,56,20,53,21,10.0581273418042,12.376106516985,0.452849417850733,2020-04-06,2020,4
"6879","RO",1,"Norte",11006,"Cacoal",237069,23344.7486784016,15,68,13,55,30,38,0,0,0,0,0,68,13,55,30,38,22,10.0581273418042,12.376106516985,0.424535071325252,2020-04-13,2020,4
"6880","RO",1,"Norte",11006,"Cacoal",237069,23344.7486784016,16,64,19,45,22,42,0,0,0,0,0,64,19,45,22,42,25,10.0581273418042,12.376106516985,0.431548866893911,2020-04-20,2020,4
"6881","RO",1,"Norte",11006,"Cacoal",237069,23344.7486784016,17,70,17,53,35,35,3,1,2,1,2,73,18,55,36,37,23,10.0581273418042,12.376106516985,0.43258775430029,2020-04-27,2020,4
"6882","RO",1,"Norte",11006,"Cacoal",237069,23344.7486784016,18,56,15,41,25,31,1,1,0,0,1,57,16,41,25,32,16,10.0581273418042,12.376106516985,0.417179172900667,2020-05-04,2020,5
"6883","RO",1,"Norte",11006,"Cacoal",237069,23344.7486784016,19,62,15,47,29,33,0,0,0,0,0,62,15,47,29,33,23,10.0581273418042,12.376106516985,0.420728296715647,2020-05-11,2020,5
"6884","RO",1,"Norte",11006,"Cacoal",237069,23344.7486784016,20,68,18,50,22,46,0,0,0,0,0,68,18,50,22,46,24,10.0581273418042,12.376106516985,0.421673938003055,2020-05-18,2020,5
"6885","RO",1,"Norte",11006,"Cacoal",237069,23344.7486784016,21,69,22,47,29,40,1,0,1,0,1,70,22,48,29,41,29,10.0581273418042,12.376106516985,0.415326393115132,2020-05-25,2020,5
"6886","RO",1,"Norte",11007,"Vilhena",164604,28077.2862186217,5,39,6,33,17,22,1,0,1,1,0,40,6,34,18,22,8,10.2427162088334,12.0112978682664,0.319099288597786,2020-02-03,2020,2
"6887","RO",1,"Norte",11007,"Vilhena",164604,28077.2862186217,6,39,13,26,20,19,2,2,0,1,1,41,15,26,21,20,7,10.2427162088334,12.0112978682664,0.307507488022014,2020-02-10,2020,2
"6888","RO",1,"Norte",11007,"Vilhena",164604,28077.2862186217,7,44,12,32,14,30,0,0,0,0,0,44,12,32,14,30,15,10.2427162088334,12.0112978682664,0.32232343261078,2020-02-17,2020,2
"6889","RO",1,"Norte",11007,"Vilhena",164604,28077.2862186217,8,51,9,42,19,32,2,0,2,0,2,53,9,44,19,34,10,10.2427162088334,12.0112978682664,0.353909508443369,2020-02-24,2020,2
"6890","RO",1,"Norte",11007,"Vilhena",164604,28077.2862186217,9,51,7,44,20,31,0,0,0,0,0,51,7,44,20,31,19,10.2427162088334,12.0112978682664,0.329184549221716,2020-03-02,2020,3
"6891","RO",1,"Norte",11007,"Vilhena",164604,28077.2862186217,10,36,6,30,11,25,1,0,1,1,0,37,6,31,12,25,14,10.2427162088334,12.0112978682664,0.338249707517013,2020-03-09,2020,3
"6892","RO",1,"Norte",11007,"Vilhena",164604,28077.2862186217,11,38,11,27,13,25,1,1,0,0,1,39,12,27,13,26,12,10.2427162088334,12.0112978682664,0.413681743810186,2020-03-16,2020,3
"6893","RO",1,"Norte",11007,"Vilhena",164604,28077.2862186217,12,49,16,33,24,25,0,0,0,0,0,49,16,33,24,25,14,10.2427162088334,12.0112978682664,0.502858005263309,2020-03-23,2020,3
"6894","RO",1,"Norte",11007,"Vilhena",164604,28077.2862186217,13,41,11,30,15,26,0,0,0,0,0,41,11,30,15,26,16,10.2427162088334,12.0112978682664,0.451511553929458,2020-03-30,2020,3
"6895","RO",1,"Norte",11007,"Vilhena",164604,28077.2862186217,14,44,11,33,18,26,0,0,0,0,0,44,11,33,18,26,7,10.2427162088334,12.0112978682664,0.453749875182806,2020-04-06,2020,4
"6896","RO",1,"Norte",11007,"Vilhena",164604,28077.2862186217,15,46,13,33,16,30,0,0,0,0,0,46,13,33,16,30,16,10.2427162088334,12.0112978682664,0.418313941822535,2020-04-13,2020,4
"6897","RO",1,"Norte",11007,"Vilhena",164604,28077.2862186217,16,38,7,31,17,21,0,0,0,0,0,38,7,31,17,21,16,10.2427162088334,12.0112978682664,0.416611452009651,2020-04-20,2020,4
"6898","RO",1,"Norte",11007,"Vilhena",164604,28077.2862186217,17,47,11,36,19,28,0,0,0,0,0,47,11,36,19,28,17,10.2427162088334,12.0112978682664,0.410913908085031,2020-04-27,2020,4
"6899","RO",1,"Norte",11007,"Vilhena",164604,28077.2862186217,18,50,13,37,25,25,0,0,0,0,0,50,13,37,25,25,18,10.2427162088334,12.0112978682664,0.393035048275778,2020-05-04,2020,5
"6900","RO",1,"Norte",11007,"Vilhena",164604,28077.2862186217,19,46,10,36,21,25,1,0,1,1,0,47,10,37,22,25,20,10.2427162088334,12.0112978682664,0.419667389649746,2020-05-11,2020,5
"6901","RO",1,"Norte",11007,"Vilhena",164604,28077.2862186217,20,54,17,37,26,28,0,0,0,0,0,54,17,37,26,28,22,10.2427162088334,12.0112978682664,0.410534292180321,2020-05-18,2020,5
"6902","RO",1,"Norte",11007,"Vilhena",164604,28077.2862186217,21,63,8,55,30,33,0,0,0,0,0,63,8,55,30,33,19,10.2427162088334,12.0112978682664,0.402955464781937,2020-05-25,2020,5
"6903","RO",1,"Norte",11008,"Colorado do Oeste",46304,28600.1810841396,5,12,4,8,4,8,0,0,0,0,0,12,4,8,4,8,5,10.2611683284012,10.7429836294312,0.334978599245636,2020-02-03,2020,2
"6904","RO",1,"Norte",11008,"Colorado do Oeste",46304,28600.1810841396,6,17,7,10,8,9,0,0,0,0,0,17,7,10,8,9,4,10.2611683284012,10.7429836294312,0.298347523991791,2020-02-10,2020,2
"6905","RO",1,"Norte",11008,"Colorado do Oeste",46304,28600.1810841396,7,18,6,12,7,11,0,0,0,0,0,18,6,12,7,11,8,10.2611683284012,10.7429836294312,0.323009079733824,2020-02-17,2020,2
"6906","RO",1,"Norte",11008,"Colorado do Oeste",46304,28600.1810841396,8,17,5,12,4,13,0,0,0,0,0,17,5,12,4,13,4,10.2611683284012,10.7429836294312,0.32168872241778,2020-02-24,2020,2
"6907","RO",1,"Norte",11008,"Colorado do Oeste",46304,28600.1810841396,9,10,3,7,4,6,0,0,0,0,0,10,3,7,4,6,7,10.2611683284012,10.7429836294312,0.332904488484578,2020-03-02,2020,3
"6908","RO",1,"Norte",11008,"Colorado do Oeste",46304,28600.1810841396,10,15,4,11,6,9,0,0,0,0,0,15,4,11,6,9,7,10.2611683284012,10.7429836294312,0.344491797054191,2020-03-09,2020,3
"6909","RO",1,"Norte",11008,"Colorado do Oeste",46304,28600.1810841396,11,12,1,11,6,6,0,0,0,0,0,12,1,11,6,6,4,10.2611683284012,10.7429836294312,0.408790229801451,2020-03-16,2020,3
"6910","RO",1,"Norte",11008,"Colorado do Oeste",46304,28600.1810841396,12,9,5,4,3,6,0,0,0,0,0,9,5,4,3,6,3,10.2611683284012,10.7429836294312,0.503319426915628,2020-03-23,2020,3
"6911","RO",1,"Norte",11008,"Colorado do Oeste",46304,28600.1810841396,13,8,1,7,2,6,0,0,0,0,0,8,1,7,2,6,4,10.2611683284012,10.7429836294312,0.499237202505959,2020-03-30,2020,3
"6912","RO",1,"Norte",11008,"Colorado do Oeste",46304,28600.1810841396,14,8,2,6,4,4,0,0,0,0,0,8,2,6,4,4,6,10.2611683284012,10.7429836294312,0.459419314179595,2020-04-06,2020,4
"6913","RO",1,"Norte",11008,"Colorado do Oeste",46304,28600.1810841396,15,5,2,3,3,2,0,0,0,0,0,5,2,3,3,2,8,10.2611683284012,10.7429836294312,0.440329094969414,2020-04-13,2020,4
"6914","RO",1,"Norte",11008,"Colorado do Oeste",46304,28600.1810841396,16,9,1,8,3,6,1,0,1,0,1,10,1,9,3,7,4,10.2611683284012,10.7429836294312,0.428049089375943,2020-04-20,2020,4
"6915","RO",1,"Norte",11008,"Colorado do Oeste",46304,28600.1810841396,17,18,3,15,9,9,0,0,0,0,0,18,3,15,9,9,5,10.2611683284012,10.7429836294312,0.414373462577455,2020-04-27,2020,4
"6916","RO",1,"Norte",11008,"Colorado do Oeste",46304,28600.1810841396,18,10,4,6,4,6,0,0,0,0,0,10,4,6,4,6,3,10.2611683284012,10.7429836294312,0.428487317955226,2020-05-04,2020,5
"6917","RO",1,"Norte",11008,"Colorado do Oeste",46304,28600.1810841396,19,10,4,6,5,5,0,0,0,0,0,10,4,6,5,5,3,10.2611683284012,10.7429836294312,0.423083871424845,2020-05-11,2020,5
"6918","RO",1,"Norte",11008,"Colorado do Oeste",46304,28600.1810841396,20,12,2,10,4,8,0,0,0,0,0,12,2,10,4,8,4,10.2611683284012,10.7429836294312,0.395589050002812,2020-05-18,2020,5
"6919","RO",1,"Norte",11008,"Colorado do Oeste",46304,28600.1810841396,21,17,5,12,7,10,0,0,0,0,0,17,5,12,7,10,9,10.2611683284012,10.7429836294312,0.402730620503009,2020-05-25,2020,5
"6920","RR",1,"Norte",14001,"Boa Vista",467130,25541.1019471239,5,175,54,121,78,97,1,1,0,0,1,176,55,121,78,98,33,10.1480442745886,13.0543628705036,0.280878120216895,2020-02-03,2020,2
"6921","RR",1,"Norte",14001,"Boa Vista",467130,25541.1019471239,6,190,64,126,90,100,3,1,2,1,2,193,65,128,91,102,47,10.1480442745886,13.0543628705036,0.278795312189589,2020-02-10,2020,2
"6922","RR",1,"Norte",14001,"Boa Vista",467130,25541.1019471239,7,180,65,115,86,94,0,0,0,0,0,180,65,115,86,94,29,10.1480442745886,13.0543628705036,0.29402412821229,2020-02-17,2020,2
"6923","RR",1,"Norte",14001,"Boa Vista",467130,25541.1019471239,8,211,75,136,117,94,1,1,0,1,0,212,76,136,118,94,50,10.1480442745886,13.0543628705036,0.342511739572173,2020-02-24,2020,2
"6924","RR",1,"Norte",14001,"Boa Vista",467130,25541.1019471239,9,218,61,157,107,111,0,0,0,0,0,218,61,157,107,111,39,10.1480442745886,13.0543628705036,0.317043491427956,2020-03-02,2020,3
"6925","RR",1,"Norte",14001,"Boa Vista",467130,25541.1019471239,10,166,42,124,80,86,1,0,1,0,1,167,42,125,80,87,43,10.1480442745886,13.0543628705036,0.329515308321371,2020-03-09,2020,3
"6926","RR",1,"Norte",14001,"Boa Vista",467130,25541.1019471239,11,171,47,124,79,92,1,1,0,0,1,172,48,124,79,93,45,10.1480442745886,13.0543628705036,0.391753315596286,2020-03-16,2020,3
"6927","RR",1,"Norte",14001,"Boa Vista",467130,25541.1019471239,12,142,43,99,75,67,1,0,1,0,1,143,43,100,75,68,32,10.1480442745886,13.0543628705036,0.498726647951692,2020-03-23,2020,3
"6928","RR",1,"Norte",14001,"Boa Vista",467130,25541.1019471239,13,160,46,114,64,96,1,0,1,0,1,161,46,115,64,97,44,10.1480442745886,13.0543628705036,0.447202132661022,2020-03-30,2020,3
"6929","RR",1,"Norte",14001,"Boa Vista",467130,25541.1019471239,14,166,51,115,87,79,0,0,0,0,0,166,51,115,87,79,51,10.1480442745886,13.0543628705036,0.448992496861207,2020-04-06,2020,4
"6930","RR",1,"Norte",14001,"Boa Vista",467130,25541.1019471239,15,169,52,117,84,85,1,0,1,0,1,170,52,118,84,86,33,10.1480442745886,13.0543628705036,0.433000133617885,2020-04-13,2020,4
"6931","RR",1,"Norte",14001,"Boa Vista",467130,25541.1019471239,16,171,43,128,93,78,1,0,1,0,1,172,43,129,93,79,34,10.1480442745886,13.0543628705036,0.42815600910721,2020-04-20,2020,4
"6932","RR",1,"Norte",14001,"Boa Vista",467130,25541.1019471239,17,177,57,120,80,97,1,0,1,1,0,178,57,121,81,97,31,10.1480442745886,13.0543628705036,0.425547384433059,2020-04-27,2020,4
"6933","RR",1,"Norte",14001,"Boa Vista",467130,25541.1019471239,18,134,33,101,64,70,3,2,1,1,2,137,35,102,65,72,39,10.1480442745886,13.0543628705036,0.408940313313809,2020-05-04,2020,5
"6934","RR",1,"Norte",14001,"Boa Vista",467130,25541.1019471239,19,161,36,125,87,74,2,1,1,0,2,163,37,126,87,76,76,10.1480442745886,13.0543628705036,0.436848950773038,2020-05-11,2020,5
"6935","RR",1,"Norte",14001,"Boa Vista",467130,25541.1019471239,20,162,57,105,78,84,4,1,3,1,3,166,58,108,79,87,100,10.1480442745886,13.0543628705036,0.437621051662052,2020-05-18,2020,5
"6936","RR",1,"Norte",14001,"Boa Vista",467130,25541.1019471239,21,157,50,107,77,80,2,2,0,1,1,159,52,107,78,81,99,10.1480442745886,13.0543628705036,0.431348179958448,2020-05-25,2020,5
"6937","RR",1,"Norte",14002,"Nordeste de Roraima",53677,15779.3815906254,5,50,24,26,26,24,0,0,0,0,0,50,24,26,26,24,2,9.66645940419122,10.8907398833476,0.288867867971209,2020-02-03,2020,2
"6938","RR",1,"Norte",14002,"Nordeste de Roraima",53677,15779.3815906254,6,35,24,11,18,17,0,0,0,0,0,35,24,11,18,17,4,9.66645940419122,10.8907398833476,0.304882442897348,2020-02-10,2020,2
"6939","RR",1,"Norte",14002,"Nordeste de Roraima",53677,15779.3815906254,7,39,16,23,17,22,1,0,1,1,0,40,16,24,18,22,7,9.66645940419122,10.8907398833476,0.314829722771186,2020-02-17,2020,2
"6940","RR",1,"Norte",14002,"Nordeste de Roraima",53677,15779.3815906254,8,50,20,30,27,23,0,0,0,0,0,50,20,30,27,23,7,9.66645940419122,10.8907398833476,0.368686908346928,2020-02-24,2020,2
"6941","RR",1,"Norte",14002,"Nordeste de Roraima",53677,15779.3815906254,9,36,17,19,17,19,0,0,0,0,0,36,17,19,17,19,4,9.66645940419122,10.8907398833476,0.308094792574238,2020-03-02,2020,3
"6942","RR",1,"Norte",14002,"Nordeste de Roraima",53677,15779.3815906254,10,44,17,27,28,16,0,0,0,0,0,44,17,27,28,16,3,9.66645940419122,10.8907398833476,0.328989815046484,2020-03-09,2020,3
"6943","RR",1,"Norte",14002,"Nordeste de Roraima",53677,15779.3815906254,11,39,25,14,20,19,0,0,0,0,0,39,25,14,20,19,8,9.66645940419122,10.8907398833476,0.39485998840988,2020-03-16,2020,3
"6944","RR",1,"Norte",14002,"Nordeste de Roraima",53677,15779.3815906254,12,42,25,17,16,26,0,0,0,0,0,42,25,17,16,26,4,9.66645940419122,10.8907398833476,0.520965665389317,2020-03-23,2020,3
"6945","RR",1,"Norte",14002,"Nordeste de Roraima",53677,15779.3815906254,13,27,8,19,19,8,0,0,0,0,0,27,8,19,19,8,4,9.66645940419122,10.8907398833476,0.452893492132249,2020-03-30,2020,3
"6946","RR",1,"Norte",14002,"Nordeste de Roraima",53677,15779.3815906254,14,26,13,13,15,11,0,0,0,0,0,26,13,13,15,11,3,9.66645940419122,10.8907398833476,0.464236000864241,2020-04-06,2020,4
"6947","RR",1,"Norte",14002,"Nordeste de Roraima",53677,15779.3815906254,15,32,14,18,12,20,0,0,0,0,0,32,14,18,12,20,6,9.66645940419122,10.8907398833476,0.4417932550723,2020-04-13,2020,4
"6948","RR",1,"Norte",14002,"Nordeste de Roraima",53677,15779.3815906254,16,29,18,11,13,16,0,0,0,0,0,29,18,11,13,16,4,9.66645940419122,10.8907398833476,0.431047294027987,2020-04-20,2020,4
"6949","RR",1,"Norte",14002,"Nordeste de Roraima",53677,15779.3815906254,17,38,20,18,23,15,0,0,0,0,0,38,20,18,23,15,3,9.66645940419122,10.8907398833476,0.450169695288534,2020-04-27,2020,4
"6950","RR",1,"Norte",14002,"Nordeste de Roraima",53677,15779.3815906254,18,30,18,12,20,10,0,0,0,0,0,30,18,12,20,10,3,9.66645940419122,10.8907398833476,0.453666732632798,2020-05-04,2020,5
"6951","RR",1,"Norte",14002,"Nordeste de Roraima",53677,15779.3815906254,19,30,14,16,16,14,0,0,0,0,0,30,14,16,16,14,3,9.66645940419122,10.8907398833476,0.498708313333357,2020-05-11,2020,5
"6952","RR",1,"Norte",14002,"Nordeste de Roraima",53677,15779.3815906254,20,36,24,12,20,16,1,0,1,1,0,37,24,13,21,16,7,9.66645940419122,10.8907398833476,0.497095317249805,2020-05-18,2020,5
"6953","RR",1,"Norte",14002,"Nordeste de Roraima",53677,15779.3815906254,21,47,17,30,29,18,0,0,0,0,0,47,17,30,29,18,11,9.66645940419122,10.8907398833476,0.492585699189443,2020-05-25,2020,5
"6954","RR",1,"Norte",14003,"Caracaraí",52751,16095.2025518,5,13,6,7,6,7,1,0,1,1,0,14,6,8,7,7,3,9.68627652841917,10.8733380085046,0.292342218476201,2020-02-03,2020,2
"6955","RR",1,"Norte",14003,"Caracaraí",52751,16095.2025518,6,14,6,8,3,11,0,0,0,0,0,14,6,8,3,11,1,9.68627652841917,10.8733380085046,0.279191536389378,2020-02-10,2020,2
"6956","RR",1,"Norte",14003,"Caracaraí",52751,16095.2025518,7,21,10,11,11,10,0,0,0,0,0,21,10,11,11,10,4,9.68627652841917,10.8733380085046,0.310385207143588,2020-02-17,2020,2
"6957","RR",1,"Norte",14003,"Caracaraí",52751,16095.2025518,8,25,12,13,16,9,0,0,0,0,0,25,12,13,16,9,2,9.68627652841917,10.8733380085046,0.339594548246321,2020-02-24,2020,2
"6958","RR",1,"Norte",14003,"Caracaraí",52751,16095.2025518,9,22,11,11,18,4,0,0,0,0,0,22,11,11,18,4,5,9.68627652841917,10.8733380085046,0.328831030484871,2020-03-02,2020,3
"6959","RR",1,"Norte",14003,"Caracaraí",52751,16095.2025518,10,10,3,7,2,8,0,0,0,0,0,10,3,7,2,8,6,9.68627652841917,10.8733380085046,0.330961852578642,2020-03-09,2020,3
"6960","RR",1,"Norte",14003,"Caracaraí",52751,16095.2025518,11,16,7,9,9,7,0,0,0,0,0,16,7,9,9,7,4,9.68627652841917,10.8733380085046,0.370051001462481,2020-03-16,2020,3
"6961","RR",1,"Norte",14003,"Caracaraí",52751,16095.2025518,12,20,10,10,8,12,0,0,0,0,0,20,10,10,8,12,8,9.68627652841917,10.8733380085046,0.456530571106611,2020-03-23,2020,3
"6962","RR",1,"Norte",14003,"Caracaraí",52751,16095.2025518,13,19,9,10,10,9,0,0,0,0,0,19,9,10,10,9,6,9.68627652841917,10.8733380085046,0.430237979345657,2020-03-30,2020,3
"6963","RR",1,"Norte",14003,"Caracaraí",52751,16095.2025518,14,14,7,7,6,8,0,0,0,0,0,14,7,7,6,8,4,9.68627652841917,10.8733380085046,0.433326646438645,2020-04-06,2020,4
"6964","RR",1,"Norte",14003,"Caracaraí",52751,16095.2025518,15,11,5,6,6,5,0,0,0,0,0,11,5,6,6,5,5,9.68627652841917,10.8733380085046,0.404770468875356,2020-04-13,2020,4
"6965","RR",1,"Norte",14003,"Caracaraí",52751,16095.2025518,16,24,9,15,8,16,0,0,0,0,0,24,9,15,8,16,11,9.68627652841917,10.8733380085046,0.428403152450785,2020-04-20,2020,4
"6966","RR",1,"Norte",14003,"Caracaraí",52751,16095.2025518,17,11,4,7,2,9,0,0,0,0,0,11,4,7,2,9,2,9.68627652841917,10.8733380085046,0.422904369743533,2020-04-27,2020,4
"6967","RR",1,"Norte",14003,"Caracaraí",52751,16095.2025518,18,14,6,8,7,7,0,0,0,0,0,14,6,8,7,7,5,9.68627652841917,10.8733380085046,0.427233334868819,2020-05-04,2020,5
"6968","RR",1,"Norte",14003,"Caracaraí",52751,16095.2025518,19,11,4,7,6,5,0,0,0,0,0,11,4,7,6,5,4,9.68627652841917,10.8733380085046,0.462973801248655,2020-05-11,2020,5
"6969","RR",1,"Norte",14003,"Caracaraí",52751,16095.2025518,20,16,9,7,8,8,0,0,0,0,0,16,9,7,8,8,5,9.68627652841917,10.8733380085046,0.452373054816959,2020-05-18,2020,5
"6970","RR",1,"Norte",14003,"Caracaraí",52751,16095.2025518,21,11,2,9,6,5,1,0,1,0,1,12,2,10,6,6,6,9.68627652841917,10.8733380085046,0.429875909439978,2020-05-25,2020,5
"6971","RR",1,"Norte",14004,"Sudeste de Roraima",57623,18820.4585335717,5,24,7,17,12,12,0,0,0,0,0,24,7,17,12,12,3,9.84269977700684,10.9616770725383,0.298709637507597,2020-02-03,2020,2
"6972","RR",1,"Norte",14004,"Sudeste de Roraima",57623,18820.4585335717,6,22,8,14,10,12,0,0,0,0,0,22,8,14,10,12,0,9.84269977700684,10.9616770725383,0.29846399981972,2020-02-10,2020,2
"6973","RR",1,"Norte",14004,"Sudeste de Roraima",57623,18820.4585335717,7,23,8,15,17,6,0,0,0,0,0,23,8,15,17,6,3,9.84269977700684,10.9616770725383,0.325924022643952,2020-02-17,2020,2
"6974","RR",1,"Norte",14004,"Sudeste de Roraima",57623,18820.4585335717,8,16,9,7,8,8,0,0,0,0,0,16,9,7,8,8,3,9.84269977700684,10.9616770725383,0.337842406831126,2020-02-24,2020,2
"6975","RR",1,"Norte",14004,"Sudeste de Roraima",57623,18820.4585335717,9,14,6,8,5,9,0,0,0,0,0,14,6,8,5,9,10,9.84269977700684,10.9616770725383,0.332343560282682,2020-03-02,2020,3
"6976","RR",1,"Norte",14004,"Sudeste de Roraima",57623,18820.4585335717,10,18,9,9,8,10,1,0,1,1,0,19,9,10,9,10,4,9.84269977700684,10.9616770725383,0.33398819428628,2020-03-09,2020,3
"6977","RR",1,"Norte",14004,"Sudeste de Roraima",57623,18820.4585335717,11,12,3,9,6,6,0,0,0,0,0,12,3,9,6,6,9,9.84269977700684,10.9616770725383,0.364710638624567,2020-03-16,2020,3
"6978","RR",1,"Norte",14004,"Sudeste de Roraima",57623,18820.4585335717,12,13,3,10,1,12,0,0,0,0,0,13,3,10,1,12,0,9.84269977700684,10.9616770725383,0.462579370903184,2020-03-23,2020,3
"6979","RR",1,"Norte",14004,"Sudeste de Roraima",57623,18820.4585335717,13,19,7,12,12,7,0,0,0,0,0,19,7,12,12,7,6,9.84269977700684,10.9616770725383,0.424760333702533,2020-03-30,2020,3
"6980","RR",1,"Norte",14004,"Sudeste de Roraima",57623,18820.4585335717,14,15,6,9,10,5,1,0,1,1,0,16,6,10,11,5,2,9.84269977700684,10.9616770725383,0.421872379391458,2020-04-06,2020,4
"6981","RR",1,"Norte",14004,"Sudeste de Roraima",57623,18820.4585335717,15,20,6,14,12,8,0,0,0,0,0,20,6,14,12,8,2,9.84269977700684,10.9616770725383,0.400739370569036,2020-04-13,2020,4
"6982","RR",1,"Norte",14004,"Sudeste de Roraima",57623,18820.4585335717,16,13,3,10,8,5,0,0,0,0,0,13,3,10,8,5,3,9.84269977700684,10.9616770725383,0.40465716738932,2020-04-20,2020,4
"6983","RR",1,"Norte",14004,"Sudeste de Roraima",57623,18820.4585335717,17,19,6,13,8,11,0,0,0,0,0,19,6,13,8,11,4,9.84269977700684,10.9616770725383,0.410407590342649,2020-04-27,2020,4
"6984","RR",1,"Norte",14004,"Sudeste de Roraima",57623,18820.4585335717,18,14,2,12,5,9,0,0,0,0,0,14,2,12,5,9,3,9.84269977700684,10.9616770725383,0.417245420535819,2020-05-04,2020,5
"6985","RR",1,"Norte",14004,"Sudeste de Roraima",57623,18820.4585335717,19,15,4,11,8,7,0,0,0,0,0,15,4,11,8,7,8,9.84269977700684,10.9616770725383,0.428757852454226,2020-05-11,2020,5
"6986","RR",1,"Norte",14004,"Sudeste de Roraima",57623,18820.4585335717,20,18,4,14,9,9,0,0,0,0,0,18,4,14,9,9,9,9.84269977700684,10.9616770725383,0.422189609729405,2020-05-18,2020,5
"6987","RR",1,"Norte",14004,"Sudeste de Roraima",57623,18820.4585335717,21,23,10,13,10,13,0,0,0,0,0,23,10,13,10,13,5,9.84269977700684,10.9616770725383,0.40897162227022,2020-05-25,2020,5
"6988","RS",4,"Sul",43001,"Santa Rosa",156774,39527.5378453698,5,45,8,37,17,28,0,0,0,0,0,45,8,37,17,28,30,10.5847528686279,11.9625605568229,0.303346314905763,2020-02-03,2020,2
"6989","RS",4,"Sul",43001,"Santa Rosa",156774,39527.5378453698,6,34,4,30,8,26,0,0,0,0,0,34,4,30,8,26,33,10.5847528686279,11.9625605568229,0.304289054615276,2020-02-10,2020,2
"6990","RS",4,"Sul",43001,"Santa Rosa",156774,39527.5378453698,7,25,8,17,8,17,1,1,0,1,0,26,9,17,9,17,22,10.5847528686279,11.9625605568229,0.306513817819628,2020-02-17,2020,2
"6991","RS",4,"Sul",43001,"Santa Rosa",156774,39527.5378453698,8,46,9,37,12,34,0,0,0,0,0,46,9,37,12,34,27,10.5847528686279,11.9625605568229,0.339942522151099,2020-02-24,2020,2
"6992","RS",4,"Sul",43001,"Santa Rosa",156774,39527.5378453698,9,24,2,22,4,20,0,0,0,0,0,24,2,22,4,20,20,10.5847528686279,11.9625605568229,0.306627450670497,2020-03-02,2020,3
"6993","RS",4,"Sul",43001,"Santa Rosa",156774,39527.5378453698,10,29,7,22,8,21,0,0,0,0,0,29,7,22,8,21,28,10.5847528686279,11.9625605568229,0.316406394646802,2020-03-09,2020,3
"6994","RS",4,"Sul",43001,"Santa Rosa",156774,39527.5378453698,11,21,5,16,6,15,0,0,0,0,0,21,5,16,6,15,19,10.5847528686279,11.9625605568229,0.391077011350574,2020-03-16,2020,3
"6995","RS",4,"Sul",43001,"Santa Rosa",156774,39527.5378453698,12,30,3,27,7,23,1,0,1,1,0,31,3,28,8,23,23,10.5847528686279,11.9625605568229,0.494740381654431,2020-03-23,2020,3
"6996","RS",4,"Sul",43001,"Santa Rosa",156774,39527.5378453698,13,27,4,23,9,18,0,0,0,0,0,27,4,23,9,18,22,10.5847528686279,11.9625605568229,0.454270744586334,2020-03-30,2020,3
"6997","RS",4,"Sul",43001,"Santa Rosa",156774,39527.5378453698,14,33,4,29,13,20,0,0,0,0,0,33,4,29,13,20,21,10.5847528686279,11.9625605568229,0.424943870557875,2020-04-06,2020,4
"6998","RS",4,"Sul",43001,"Santa Rosa",156774,39527.5378453698,15,37,1,36,8,29,0,0,0,0,0,37,1,36,8,29,31,10.5847528686279,11.9625605568229,0.399956226113022,2020-04-13,2020,4
"6999","RS",4,"Sul",43001,"Santa Rosa",156774,39527.5378453698,16,43,9,34,10,33,0,0,0,0,0,43,9,34,10,33,29,10.5847528686279,11.9625605568229,0.402548071737022,2020-04-20,2020,4
"7000","RS",4,"Sul",43001,"Santa Rosa",156774,39527.5378453698,17,42,9,33,12,30,0,0,0,0,0,42,9,33,12,30,22,10.5847528686279,11.9625605568229,0.408563171851499,2020-04-27,2020,4
"7001","RS",4,"Sul",43001,"Santa Rosa",156774,39527.5378453698,18,56,1,55,18,38,1,0,1,0,1,57,1,56,18,39,23,10.5847528686279,11.9625605568229,0.382451347384241,2020-05-04,2020,5
"7002","RS",4,"Sul",43001,"Santa Rosa",156774,39527.5378453698,19,38,4,34,10,28,0,0,0,0,0,38,4,34,10,28,17,10.5847528686279,11.9625605568229,0.388961176172961,2020-05-11,2020,5
"7003","RS",4,"Sul",43001,"Santa Rosa",156774,39527.5378453698,20,42,9,33,17,25,0,0,0,0,0,42,9,33,17,25,22,10.5847528686279,11.9625605568229,0.403065062424036,2020-05-18,2020,5
"7004","RS",4,"Sul",43001,"Santa Rosa",156774,39527.5378453698,21,40,5,35,12,28,0,0,0,0,0,40,5,35,12,28,19,10.5847528686279,11.9625605568229,0.380833375408603,2020-05-25,2020,5
"7005","RS",4,"Sul",43002,"Três Passos",140441,37411.4363420226,5,34,10,24,14,20,0,0,0,0,0,34,10,24,14,20,24,10.5297317212061,11.8525427507355,0.294155185572187,2020-02-03,2020,2
"7006","RS",4,"Sul",43002,"Três Passos",140441,37411.4363420226,6,20,8,12,4,16,0,0,0,0,0,20,8,12,4,16,24,10.5297317212061,11.8525427507355,0.299099117961105,2020-02-10,2020,2
"7007","RS",4,"Sul",43002,"Três Passos",140441,37411.4363420226,7,34,6,28,9,25,0,0,0,0,0,34,6,28,9,25,16,10.5297317212061,11.8525427507355,0.288965883811767,2020-02-17,2020,2
"7008","RS",4,"Sul",43002,"Três Passos",140441,37411.4363420226,8,33,10,23,7,26,0,0,0,0,0,33,10,23,7,26,13,10.5297317212061,11.8525427507355,0.344206932983321,2020-02-24,2020,2
"7009","RS",4,"Sul",43002,"Três Passos",140441,37411.4363420226,9,42,14,28,15,27,0,0,0,0,0,42,14,28,15,27,28,10.5297317212061,11.8525427507355,0.291966474543289,2020-03-02,2020,3
"7010","RS",4,"Sul",43002,"Três Passos",140441,37411.4363420226,10,28,5,23,9,19,0,0,0,0,0,28,5,23,9,19,21,10.5297317212061,11.8525427507355,0.317158985764556,2020-03-09,2020,3
"7011","RS",4,"Sul",43002,"Três Passos",140441,37411.4363420226,11,29,12,17,13,16,0,0,0,0,0,29,12,17,13,16,24,10.5297317212061,11.8525427507355,0.407473938000165,2020-03-16,2020,3
"7012","RS",4,"Sul",43002,"Três Passos",140441,37411.4363420226,12,32,6,26,10,22,0,0,0,0,0,32,6,26,10,22,19,10.5297317212061,11.8525427507355,0.522794833870327,2020-03-23,2020,3
"7013","RS",4,"Sul",43002,"Três Passos",140441,37411.4363420226,13,44,14,30,18,26,0,0,0,0,0,44,14,30,18,26,16,10.5297317212061,11.8525427507355,0.442455018168522,2020-03-30,2020,3
"7014","RS",4,"Sul",43002,"Três Passos",140441,37411.4363420226,14,22,6,16,7,15,1,0,1,0,1,23,6,17,7,16,16,10.5297317212061,11.8525427507355,0.429196101503059,2020-04-06,2020,4
"7015","RS",4,"Sul",43002,"Três Passos",140441,37411.4363420226,15,33,10,23,14,19,0,0,0,0,0,33,10,23,14,19,15,10.5297317212061,11.8525427507355,0.412101613259077,2020-04-13,2020,4
"7016","RS",4,"Sul",43002,"Três Passos",140441,37411.4363420226,16,28,12,16,8,20,1,1,0,1,0,29,13,16,9,20,21,10.5297317212061,11.8525427507355,0.403478429445529,2020-04-20,2020,4
"7017","RS",4,"Sul",43002,"Três Passos",140441,37411.4363420226,17,39,7,32,14,25,0,0,0,0,0,39,7,32,14,25,29,10.5297317212061,11.8525427507355,0.414026013333352,2020-04-27,2020,4
"7018","RS",4,"Sul",43002,"Três Passos",140441,37411.4363420226,18,31,11,20,14,17,0,0,0,0,0,31,11,20,14,17,19,10.5297317212061,11.8525427507355,0.388580962686833,2020-05-04,2020,5
"7019","RS",4,"Sul",43002,"Três Passos",140441,37411.4363420226,19,35,7,28,9,26,0,0,0,0,0,35,7,28,9,26,29,10.5297317212061,11.8525427507355,0.396846273996244,2020-05-11,2020,5
"7020","RS",4,"Sul",43002,"Três Passos",140441,37411.4363420226,20,46,13,33,20,26,0,0,0,0,0,46,13,33,20,26,26,10.5297317212061,11.8525427507355,0.397697912537086,2020-05-18,2020,5
"7021","RS",4,"Sul",43002,"Três Passos",140441,37411.4363420226,21,35,5,30,13,22,0,0,0,0,0,35,5,30,13,22,28,10.5297317212061,11.8525427507355,0.408425688557722,2020-05-25,2020,5
"7022","RS",4,"Sul",43003,"Frederico Westphalen",168859,31568.8125219266,5,45,17,28,14,31,1,1,0,0,1,46,18,28,14,32,26,10.3599249667149,12.0368193261403,0.282993261264628,2020-02-03,2020,2
"7023","RS",4,"Sul",43003,"Frederico Westphalen",168859,31568.8125219266,6,41,12,29,14,27,0,0,0,0,0,41,12,29,14,27,26,10.3599249667149,12.0368193261403,0.292236932228621,2020-02-10,2020,2
"7024","RS",4,"Sul",43003,"Frederico Westphalen",168859,31568.8125219266,7,35,11,24,11,24,1,0,1,0,1,36,11,25,11,25,25,10.3599249667149,12.0368193261403,0.289675541386576,2020-02-17,2020,2
"7025","RS",4,"Sul",43003,"Frederico Westphalen",168859,31568.8125219266,8,30,8,22,11,19,0,0,0,0,0,30,8,22,11,19,26,10.3599249667149,12.0368193261403,0.32932533641173,2020-02-24,2020,2
"7026","RS",4,"Sul",43003,"Frederico Westphalen",168859,31568.8125219266,9,44,13,31,13,31,0,0,0,0,0,44,13,31,13,31,26,10.3599249667149,12.0368193261403,0.292238776393421,2020-03-02,2020,3
"7027","RS",4,"Sul",43003,"Frederico Westphalen",168859,31568.8125219266,10,46,18,28,13,33,1,0,1,0,1,47,18,29,13,34,20,10.3599249667149,12.0368193261403,0.296121046706882,2020-03-09,2020,3
"7028","RS",4,"Sul",43003,"Frederico Westphalen",168859,31568.8125219266,11,40,16,24,15,25,0,0,0,0,0,40,16,24,15,25,27,10.3599249667149,12.0368193261403,0.421548485134484,2020-03-16,2020,3
"7029","RS",4,"Sul",43003,"Frederico Westphalen",168859,31568.8125219266,12,36,13,23,10,26,0,0,0,0,0,36,13,23,10,26,27,10.3599249667149,12.0368193261403,0.532089138295087,2020-03-23,2020,3
"7030","RS",4,"Sul",43003,"Frederico Westphalen",168859,31568.8125219266,13,41,14,27,15,26,0,0,0,0,0,41,14,27,15,26,23,10.3599249667149,12.0368193261403,0.454626317790487,2020-03-30,2020,3
"7031","RS",4,"Sul",43003,"Frederico Westphalen",168859,31568.8125219266,14,32,9,23,8,24,1,0,1,1,0,33,9,24,9,24,23,10.3599249667149,12.0368193261403,0.436131817722279,2020-04-06,2020,4
"7032","RS",4,"Sul",43003,"Frederico Westphalen",168859,31568.8125219266,15,35,13,22,12,23,0,0,0,0,0,35,13,22,12,23,23,10.3599249667149,12.0368193261403,0.388248707642151,2020-04-13,2020,4
"7033","RS",4,"Sul",43003,"Frederico Westphalen",168859,31568.8125219266,16,47,7,40,16,31,0,0,0,0,0,47,7,40,16,31,29,10.3599249667149,12.0368193261403,0.400538094377403,2020-04-20,2020,4
"7034","RS",4,"Sul",43003,"Frederico Westphalen",168859,31568.8125219266,17,41,12,29,18,23,0,0,0,0,0,41,12,29,18,23,21,10.3599249667149,12.0368193261403,0.422323225173559,2020-04-27,2020,4
"7035","RS",4,"Sul",43003,"Frederico Westphalen",168859,31568.8125219266,18,51,11,40,18,33,0,0,0,0,0,51,11,40,18,33,26,10.3599249667149,12.0368193261403,0.411414643582893,2020-05-04,2020,5
"7036","RS",4,"Sul",43003,"Frederico Westphalen",168859,31568.8125219266,19,35,12,23,13,22,0,0,0,0,0,35,12,23,13,22,26,10.3599249667149,12.0368193261403,0.393512561917706,2020-05-11,2020,5
"7037","RS",4,"Sul",43003,"Frederico Westphalen",168859,31568.8125219266,20,49,10,39,19,30,0,0,0,0,0,49,10,39,19,30,27,10.3599249667149,12.0368193261403,0.414915469861116,2020-05-18,2020,5
"7038","RS",4,"Sul",43003,"Frederico Westphalen",168859,31568.8125219266,21,44,6,38,15,29,0,0,0,0,0,44,6,38,15,29,31,10.3599249667149,12.0368193261403,0.386298562697296,2020-05-25,2020,5
"7039","RS",4,"Sul",43004,"Erechim",215135,43776.8976596556,5,37,6,31,9,28,0,0,0,0,0,37,6,31,9,28,28,10.6868615065207,12.2790210170354,0.306846149021461,2020-02-03,2020,2
"7040","RS",4,"Sul",43004,"Erechim",215135,43776.8976596556,6,44,8,36,14,30,0,0,0,0,0,44,8,36,14,30,29,10.6868615065207,12.2790210170354,0.301905018729761,2020-02-10,2020,2
"7041","RS",4,"Sul",43004,"Erechim",215135,43776.8976596556,7,43,13,30,7,36,0,0,0,0,0,43,13,30,7,36,27,10.6868615065207,12.2790210170354,0.304698928873993,2020-02-17,2020,2
"7042","RS",4,"Sul",43004,"Erechim",215135,43776.8976596556,8,43,10,33,9,34,0,0,0,0,0,43,10,33,9,34,32,10.6868615065207,12.2790210170354,0.33850980090009,2020-02-24,2020,2
"7043","RS",4,"Sul",43004,"Erechim",215135,43776.8976596556,9,34,5,29,8,26,1,0,1,0,1,35,5,30,8,27,34,10.6868615065207,12.2790210170354,0.313021100000122,2020-03-02,2020,3
"7044","RS",4,"Sul",43004,"Erechim",215135,43776.8976596556,10,54,9,45,14,40,0,0,0,0,0,54,9,45,14,40,37,10.6868615065207,12.2790210170354,0.331457946100622,2020-03-09,2020,3
"7045","RS",4,"Sul",43004,"Erechim",215135,43776.8976596556,11,51,7,44,12,39,1,1,0,0,1,52,8,44,12,40,25,10.6868615065207,12.2790210170354,0.46449880277027,2020-03-16,2020,3
"7046","RS",4,"Sul",43004,"Erechim",215135,43776.8976596556,12,36,13,23,8,28,1,1,0,0,1,37,14,23,8,29,26,10.6868615065207,12.2790210170354,0.577272435608218,2020-03-23,2020,3
"7047","RS",4,"Sul",43004,"Erechim",215135,43776.8976596556,13,37,10,27,8,29,0,0,0,0,0,37,10,27,8,29,26,10.6868615065207,12.2790210170354,0.499689651261076,2020-03-30,2020,3
"7048","RS",4,"Sul",43004,"Erechim",215135,43776.8976596556,14,44,7,37,13,31,0,0,0,0,0,44,7,37,13,31,28,10.6868615065207,12.2790210170354,0.477424657061393,2020-04-06,2020,4
"7049","RS",4,"Sul",43004,"Erechim",215135,43776.8976596556,15,55,8,47,15,40,0,0,0,0,0,55,8,47,15,40,31,10.6868615065207,12.2790210170354,0.425162625923911,2020-04-13,2020,4
"7050","RS",4,"Sul",43004,"Erechim",215135,43776.8976596556,16,43,10,33,11,32,2,2,0,1,1,45,12,33,12,33,27,10.6868615065207,12.2790210170354,0.429420355468586,2020-04-20,2020,4
"7051","RS",4,"Sul",43004,"Erechim",215135,43776.8976596556,17,49,9,40,12,37,0,0,0,0,0,49,9,40,12,37,28,10.6868615065207,12.2790210170354,0.431040886600971,2020-04-27,2020,4
"7052","RS",4,"Sul",43004,"Erechim",215135,43776.8976596556,18,42,8,34,3,39,0,0,0,0,0,42,8,34,3,39,31,10.6868615065207,12.2790210170354,0.399152860771403,2020-05-04,2020,5
"7053","RS",4,"Sul",43004,"Erechim",215135,43776.8976596556,19,42,11,31,12,30,0,0,0,0,0,42,11,31,12,30,25,10.6868615065207,12.2790210170354,0.407018601775822,2020-05-11,2020,5
"7054","RS",4,"Sul",43004,"Erechim",215135,43776.8976596556,20,32,10,22,4,28,1,1,0,1,0,33,11,22,5,28,29,10.6868615065207,12.2790210170354,0.428102816283917,2020-05-18,2020,5
"7055","RS",4,"Sul",43004,"Erechim",215135,43776.8976596556,21,45,12,33,17,28,0,0,0,0,0,45,12,33,17,28,29,10.6868615065207,12.2790210170354,0.41627763031263,2020-05-25,2020,5
"7056","RS",4,"Sul",43005,"Sananduva",60203,34875.5783974221,5,8,1,7,5,3,0,0,0,0,0,8,1,7,5,3,13,10.4595421038585,11.0054774639423,0.250233029989673,2020-02-03,2020,2
"7057","RS",4,"Sul",43005,"Sananduva",60203,34875.5783974221,6,11,1,10,3,8,0,0,0,0,0,11,1,10,3,8,8,10.4595421038585,11.0054774639423,0.280480135829661,2020-02-10,2020,2
"7058","RS",4,"Sul",43005,"Sananduva",60203,34875.5783974221,7,13,1,12,3,10,0,0,0,0,0,13,1,12,3,10,5,10.4595421038585,11.0054774639423,0.283101852881713,2020-02-17,2020,2
"7059","RS",4,"Sul",43005,"Sananduva",60203,34875.5783974221,8,13,1,12,2,11,0,0,0,0,0,13,1,12,2,11,12,10.4595421038585,11.0054774639423,0.360913148816519,2020-02-24,2020,2
"7060","RS",4,"Sul",43005,"Sananduva",60203,34875.5783974221,9,8,3,5,2,6,0,0,0,0,0,8,3,5,2,6,7,10.4595421038585,11.0054774639423,0.293397388548939,2020-03-02,2020,3
"7061","RS",4,"Sul",43005,"Sananduva",60203,34875.5783974221,10,7,3,4,3,4,0,0,0,0,0,7,3,4,3,4,13,10.4595421038585,11.0054774639423,0.290720813914727,2020-03-09,2020,3
"7062","RS",4,"Sul",43005,"Sananduva",60203,34875.5783974221,11,6,3,3,1,5,0,0,0,0,0,6,3,3,1,5,11,10.4595421038585,11.0054774639423,0.381197788864105,2020-03-16,2020,3
"7063","RS",4,"Sul",43005,"Sananduva",60203,34875.5783974221,12,8,3,5,3,5,0,0,0,0,0,8,3,5,3,5,6,10.4595421038585,11.0054774639423,0.510502007167049,2020-03-23,2020,3
"7064","RS",4,"Sul",43005,"Sananduva",60203,34875.5783974221,13,10,3,7,5,5,0,0,0,0,0,10,3,7,5,5,5,10.4595421038585,11.0054774639423,0.38454517851131,2020-03-30,2020,3
"7065","RS",4,"Sul",43005,"Sananduva",60203,34875.5783974221,14,12,3,9,3,9,0,0,0,0,0,12,3,9,3,9,8,10.4595421038585,11.0054774639423,0.427439418791264,2020-04-06,2020,4
"7066","RS",4,"Sul",43005,"Sananduva",60203,34875.5783974221,15,10,4,6,5,5,0,0,0,0,0,10,4,6,5,5,8,10.4595421038585,11.0054774639423,0.411863819378835,2020-04-13,2020,4
"7067","RS",4,"Sul",43005,"Sananduva",60203,34875.5783974221,16,13,7,6,6,7,0,0,0,0,0,13,7,6,6,7,12,10.4595421038585,11.0054774639423,0.413894955992926,2020-04-20,2020,4
"7068","RS",4,"Sul",43005,"Sananduva",60203,34875.5783974221,17,12,4,8,5,7,0,0,0,0,0,12,4,8,5,7,8,10.4595421038585,11.0054774639423,0.406832159722972,2020-04-27,2020,4
"7069","RS",4,"Sul",43005,"Sananduva",60203,34875.5783974221,18,17,5,12,4,13,0,0,0,0,0,17,5,12,4,13,7,10.4595421038585,11.0054774639423,0.354672820864408,2020-05-04,2020,5
"7070","RS",4,"Sul",43005,"Sananduva",60203,34875.5783974221,19,9,4,5,3,6,0,0,0,0,0,9,4,5,3,6,9,10.4595421038585,11.0054774639423,0.343799431216267,2020-05-11,2020,5
"7071","RS",4,"Sul",43005,"Sananduva",60203,34875.5783974221,20,17,5,12,4,13,0,0,0,0,0,17,5,12,4,13,11,10.4595421038585,11.0054774639423,0.343390066132024,2020-05-18,2020,5
"7072","RS",4,"Sul",43005,"Sananduva",60203,34875.5783974221,21,17,4,13,1,16,0,0,0,0,0,17,4,13,1,16,5,10.4595421038585,11.0054774639423,0.364465449798843,2020-05-25,2020,5
"7073","RS",4,"Sul",43006,"Cerro Largo",63845,45249.7443423917,5,6,2,4,2,4,0,0,0,0,0,6,2,4,2,4,13,10.7199522992202,11.0642135498588,0.296795626477391,2020-02-03,2020,2
"7074","RS",4,"Sul",43006,"Cerro Largo",63845,45249.7443423917,6,10,3,7,4,6,0,0,0,0,0,10,3,7,4,6,9,10.7199522992202,11.0642135498588,0.321585913243373,2020-02-10,2020,2
"7075","RS",4,"Sul",43006,"Cerro Largo",63845,45249.7443423917,7,12,2,10,3,9,0,0,0,0,0,12,2,10,3,9,6,10.7199522992202,11.0642135498588,0.303861057008816,2020-02-17,2020,2
"7076","RS",4,"Sul",43006,"Cerro Largo",63845,45249.7443423917,8,11,2,9,4,7,0,0,0,0,0,11,2,9,4,7,10,10.7199522992202,11.0642135498588,0.341498383672593,2020-02-24,2020,2
"7077","RS",4,"Sul",43006,"Cerro Largo",63845,45249.7443423917,9,20,5,15,8,12,0,0,0,0,0,20,5,15,8,12,15,10.7199522992202,11.0642135498588,0.329898037589538,2020-03-02,2020,3
"7078","RS",4,"Sul",43006,"Cerro Largo",63845,45249.7443423917,10,9,0,9,1,8,0,0,0,0,0,9,0,9,1,8,9,10.7199522992202,11.0642135498588,0.336011795830811,2020-03-09,2020,3
"7079","RS",4,"Sul",43006,"Cerro Largo",63845,45249.7443423917,11,12,2,10,3,9,0,0,0,0,0,12,2,10,3,9,18,10.7199522992202,11.0642135498588,0.371479393841015,2020-03-16,2020,3
"7080","RS",4,"Sul",43006,"Cerro Largo",63845,45249.7443423917,12,14,3,11,7,7,0,0,0,0,0,14,3,11,7,7,14,10.7199522992202,11.0642135498588,0.513276545634324,2020-03-23,2020,3
"7081","RS",4,"Sul",43006,"Cerro Largo",63845,45249.7443423917,13,10,2,8,4,6,0,0,0,0,0,10,2,8,4,6,14,10.7199522992202,11.0642135498588,0.413675867926798,2020-03-30,2020,3
"7082","RS",4,"Sul",43006,"Cerro Largo",63845,45249.7443423917,14,13,2,11,6,7,0,0,0,0,0,13,2,11,6,7,13,10.7199522992202,11.0642135498588,0.432842597269274,2020-04-06,2020,4
"7083","RS",4,"Sul",43006,"Cerro Largo",63845,45249.7443423917,15,10,4,6,2,8,0,0,0,0,0,10,4,6,2,8,8,10.7199522992202,11.0642135498588,0.414155596142149,2020-04-13,2020,4
"7084","RS",4,"Sul",43006,"Cerro Largo",63845,45249.7443423917,16,12,4,8,1,11,0,0,0,0,0,12,4,8,1,11,15,10.7199522992202,11.0642135498588,0.384084467258492,2020-04-20,2020,4
"7085","RS",4,"Sul",43006,"Cerro Largo",63845,45249.7443423917,17,9,2,7,3,6,0,0,0,0,0,9,2,7,3,6,9,10.7199522992202,11.0642135498588,0.404269612458317,2020-04-27,2020,4
"7086","RS",4,"Sul",43006,"Cerro Largo",63845,45249.7443423917,18,7,4,3,1,6,0,0,0,0,0,7,4,3,1,6,15,10.7199522992202,11.0642135498588,0.379807136818062,2020-05-04,2020,5
"7087","RS",4,"Sul",43006,"Cerro Largo",63845,45249.7443423917,19,13,3,10,3,10,0,0,0,0,0,13,3,10,3,10,11,10.7199522992202,11.0642135498588,0.371254187617456,2020-05-11,2020,5
"7088","RS",4,"Sul",43006,"Cerro Largo",63845,45249.7443423917,20,17,3,14,5,12,0,0,0,0,0,17,3,14,5,12,10,10.7199522992202,11.0642135498588,0.394952017780371,2020-05-18,2020,5
"7089","RS",4,"Sul",43006,"Cerro Largo",63845,45249.7443423917,21,14,3,11,1,13,0,0,0,0,0,14,3,11,1,13,11,10.7199522992202,11.0642135498588,0.365012933093591,2020-05-25,2020,5
"7090","RS",4,"Sul",43007,"Santo Ângelo",190107,39615.5957038931,5,38,12,26,10,28,0,0,0,0,0,38,12,26,10,28,30,10.5869781506179,12.1553423505235,0.304731031689057,2020-02-03,2020,2
"7091","RS",4,"Sul",43007,"Santo Ângelo",190107,39615.5957038931,6,42,15,27,21,21,0,0,0,0,0,42,15,27,21,21,22,10.5869781506179,12.1553423505235,0.304568026334452,2020-02-10,2020,2
"7092","RS",4,"Sul",43007,"Santo Ângelo",190107,39615.5957038931,7,40,9,31,16,24,0,0,0,0,0,40,9,31,16,24,25,10.5869781506179,12.1553423505235,0.299021476181905,2020-02-17,2020,2
"7093","RS",4,"Sul",43007,"Santo Ângelo",190107,39615.5957038931,8,54,13,41,22,32,0,0,0,0,0,54,13,41,22,32,40,10.5869781506179,12.1553423505235,0.340331462889152,2020-02-24,2020,2
"7094","RS",4,"Sul",43007,"Santo Ângelo",190107,39615.5957038931,9,46,12,34,18,28,0,0,0,0,0,46,12,34,18,28,20,10.5869781506179,12.1553423505235,0.320557609990223,2020-03-02,2020,3
"7095","RS",4,"Sul",43007,"Santo Ângelo",190107,39615.5957038931,10,39,10,29,13,26,0,0,0,0,0,39,10,29,13,26,25,10.5869781506179,12.1553423505235,0.328036533715711,2020-03-09,2020,3
"7096","RS",4,"Sul",43007,"Santo Ângelo",190107,39615.5957038931,11,41,17,24,15,26,1,0,1,1,0,42,17,25,16,26,29,10.5869781506179,12.1553423505235,0.39333742956304,2020-03-16,2020,3
"7097","RS",4,"Sul",43007,"Santo Ângelo",190107,39615.5957038931,12,44,9,35,14,30,0,0,0,0,0,44,9,35,14,30,43,10.5869781506179,12.1553423505235,0.518354790466453,2020-03-23,2020,3
"7098","RS",4,"Sul",43007,"Santo Ângelo",190107,39615.5957038931,13,39,6,33,17,22,0,0,0,0,0,39,6,33,17,22,34,10.5869781506179,12.1553423505235,0.461802067103314,2020-03-30,2020,3
"7099","RS",4,"Sul",43007,"Santo Ângelo",190107,39615.5957038931,14,43,12,31,17,26,0,0,0,0,0,43,12,31,17,26,26,10.5869781506179,12.1553423505235,0.442812900325378,2020-04-06,2020,4
"7100","RS",4,"Sul",43007,"Santo Ângelo",190107,39615.5957038931,15,41,7,34,11,30,0,0,0,0,0,41,7,34,11,30,29,10.5869781506179,12.1553423505235,0.409737831735575,2020-04-13,2020,4
"7101","RS",4,"Sul",43007,"Santo Ângelo",190107,39615.5957038931,16,40,14,26,9,31,1,0,1,0,1,41,14,27,9,32,24,10.5869781506179,12.1553423505235,0.410823874367661,2020-04-20,2020,4
"7102","RS",4,"Sul",43007,"Santo Ângelo",190107,39615.5957038931,17,52,18,34,22,30,0,0,0,0,0,52,18,34,22,30,39,10.5869781506179,12.1553423505235,0.418187676193573,2020-04-27,2020,4
"7103","RS",4,"Sul",43007,"Santo Ângelo",190107,39615.5957038931,18,41,13,28,11,30,0,0,0,0,0,41,13,28,11,30,31,10.5869781506179,12.1553423505235,0.406640049461031,2020-05-04,2020,5
"7104","RS",4,"Sul",43007,"Santo Ângelo",190107,39615.5957038931,19,46,19,27,12,34,1,1,0,0,1,47,20,27,12,35,24,10.5869781506179,12.1553423505235,0.405171066443285,2020-05-11,2020,5
"7105","RS",4,"Sul",43007,"Santo Ângelo",190107,39615.5957038931,20,28,10,18,9,19,0,0,0,0,0,28,10,18,9,19,38,10.5869781506179,12.1553423505235,0.417962256706478,2020-05-18,2020,5
"7106","RS",4,"Sul",43007,"Santo Ângelo",190107,39615.5957038931,21,39,9,30,12,27,0,0,0,0,0,39,9,30,12,27,33,10.5869781506179,12.1553423505235,0.407871635864301,2020-05-25,2020,5
"7107","RS",4,"Sul",43008,"Ijuí",192099,45437.2480000416,5,50,8,42,17,33,0,0,0,0,0,50,8,42,17,33,25,10.7240874881816,12.165766143121,0.300089623172767,2020-02-03,2020,2
"7108","RS",4,"Sul",43008,"Ijuí",192099,45437.2480000416,6,41,5,36,18,23,1,1,0,0,1,42,6,36,18,24,17,10.7240874881816,12.165766143121,0.296316278103752,2020-02-10,2020,2
"7109","RS",4,"Sul",43008,"Ijuí",192099,45437.2480000416,7,48,9,39,18,30,0,0,0,0,0,48,9,39,18,30,23,10.7240874881816,12.165766143121,0.301590393924491,2020-02-17,2020,2
"7110","RS",4,"Sul",43008,"Ijuí",192099,45437.2480000416,8,34,7,27,10,24,2,1,1,2,0,36,8,28,12,24,27,10.7240874881816,12.165766143121,0.333751521895326,2020-02-24,2020,2
"7111","RS",4,"Sul",43008,"Ijuí",192099,45437.2480000416,9,54,11,43,14,40,0,0,0,0,0,54,11,43,14,40,28,10.7240874881816,12.165766143121,0.31771025153136,2020-03-02,2020,3
"7112","RS",4,"Sul",43008,"Ijuí",192099,45437.2480000416,10,41,5,36,14,27,0,0,0,0,0,41,5,36,14,27,28,10.7240874881816,12.165766143121,0.319920844527941,2020-03-09,2020,3
"7113","RS",4,"Sul",43008,"Ijuí",192099,45437.2480000416,11,32,2,30,6,26,0,0,0,0,0,32,2,30,6,26,29,10.7240874881816,12.165766143121,0.424529137845146,2020-03-16,2020,3
"7114","RS",4,"Sul",43008,"Ijuí",192099,45437.2480000416,12,31,7,24,9,22,0,0,0,0,0,31,7,24,9,22,22,10.7240874881816,12.165766143121,0.549620950770314,2020-03-23,2020,3
"7115","RS",4,"Sul",43008,"Ijuí",192099,45437.2480000416,13,43,6,37,12,31,1,0,1,0,1,44,6,38,12,32,23,10.7240874881816,12.165766143121,0.482286281218299,2020-03-30,2020,3
"7116","RS",4,"Sul",43008,"Ijuí",192099,45437.2480000416,14,46,9,37,16,30,0,0,0,0,0,46,9,37,16,30,35,10.7240874881816,12.165766143121,0.467169458608703,2020-04-06,2020,4
"7117","RS",4,"Sul",43008,"Ijuí",192099,45437.2480000416,15,31,4,27,13,18,0,0,0,0,0,31,4,27,13,18,24,10.7240874881816,12.165766143121,0.422159090230667,2020-04-13,2020,4
"7118","RS",4,"Sul",43008,"Ijuí",192099,45437.2480000416,16,40,8,32,13,27,0,0,0,0,0,40,8,32,13,27,27,10.7240874881816,12.165766143121,0.434440298556929,2020-04-20,2020,4
"7119","RS",4,"Sul",43008,"Ijuí",192099,45437.2480000416,17,53,7,46,18,35,0,0,0,0,0,53,7,46,18,35,33,10.7240874881816,12.165766143121,0.423920389476703,2020-04-27,2020,4
"7120","RS",4,"Sul",43008,"Ijuí",192099,45437.2480000416,18,42,9,33,13,29,1,1,0,0,1,43,10,33,13,30,21,10.7240874881816,12.165766143121,0.40529751293849,2020-05-04,2020,5
"7121","RS",4,"Sul",43008,"Ijuí",192099,45437.2480000416,19,47,12,35,14,33,0,0,0,0,0,47,12,35,14,33,33,10.7240874881816,12.165766143121,0.405514668718559,2020-05-11,2020,5
"7122","RS",4,"Sul",43008,"Ijuí",192099,45437.2480000416,20,55,10,45,20,35,1,1,0,0,1,56,11,45,20,36,20,10.7240874881816,12.165766143121,0.413563076505324,2020-05-18,2020,5
"7123","RS",4,"Sul",43008,"Ijuí",192099,45437.2480000416,21,47,8,39,12,35,0,0,0,0,0,47,8,39,12,35,31,10.7240874881816,12.165766143121,0.397658578633492,2020-05-25,2020,5
"7124","RS",4,"Sul",43009,"Carazinho",164574,43738.7892664698,5,36,11,25,11,25,0,0,0,0,0,36,11,25,11,25,22,10.6859906136115,12.0111155960606,0.303492705890126,2020-02-03,2020,2
"7125","RS",4,"Sul",43009,"Carazinho",164574,43738.7892664698,6,38,6,32,10,28,0,0,0,0,0,38,6,32,10,28,20,10.6859906136115,12.0111155960606,0.300986303596132,2020-02-10,2020,2
"7126","RS",4,"Sul",43009,"Carazinho",164574,43738.7892664698,7,31,6,25,7,24,0,0,0,0,0,31,6,25,7,24,23,10.6859906136115,12.0111155960606,0.304636069614517,2020-02-17,2020,2
"7127","RS",4,"Sul",43009,"Carazinho",164574,43738.7892664698,8,34,8,26,14,20,0,0,0,0,0,34,8,26,14,20,23,10.6859906136115,12.0111155960606,0.334835746104082,2020-02-24,2020,2
"7128","RS",4,"Sul",43009,"Carazinho",164574,43738.7892664698,9,38,10,28,13,25,0,0,0,0,0,38,10,28,13,25,28,10.6859906136115,12.0111155960606,0.315000864968966,2020-03-02,2020,3
"7129","RS",4,"Sul",43009,"Carazinho",164574,43738.7892664698,10,37,8,29,13,24,0,0,0,0,0,37,8,29,13,24,23,10.6859906136115,12.0111155960606,0.330985685110205,2020-03-09,2020,3
"7130","RS",4,"Sul",43009,"Carazinho",164574,43738.7892664698,11,35,5,30,13,22,0,0,0,0,0,35,5,30,13,22,28,10.6859906136115,12.0111155960606,0.432723714967383,2020-03-16,2020,3
"7131","RS",4,"Sul",43009,"Carazinho",164574,43738.7892664698,12,30,10,20,14,16,0,0,0,0,0,30,10,20,14,16,25,10.6859906136115,12.0111155960606,0.557427218620137,2020-03-23,2020,3
"7132","RS",4,"Sul",43009,"Carazinho",164574,43738.7892664698,13,35,9,26,11,24,0,0,0,0,0,35,9,26,11,24,22,10.6859906136115,12.0111155960606,0.487853726865096,2020-03-30,2020,3
"7133","RS",4,"Sul",43009,"Carazinho",164574,43738.7892664698,14,46,11,35,14,32,1,1,0,0,1,47,12,35,14,33,16,10.6859906136115,12.0111155960606,0.468678957355546,2020-04-06,2020,4
"7134","RS",4,"Sul",43009,"Carazinho",164574,43738.7892664698,15,37,6,31,11,26,0,0,0,0,0,37,6,31,11,26,23,10.6859906136115,12.0111155960606,0.432183195269716,2020-04-13,2020,4
"7135","RS",4,"Sul",43009,"Carazinho",164574,43738.7892664698,16,47,13,34,15,32,0,0,0,0,0,47,13,34,15,32,25,10.6859906136115,12.0111155960606,0.43688104519869,2020-04-20,2020,4
"7136","RS",4,"Sul",43009,"Carazinho",164574,43738.7892664698,17,41,6,35,14,27,2,0,2,0,2,43,6,37,14,29,24,10.6859906136115,12.0111155960606,0.431646380205129,2020-04-27,2020,4
"7137","RS",4,"Sul",43009,"Carazinho",164574,43738.7892664698,18,40,9,31,15,25,0,0,0,0,0,40,9,31,15,25,27,10.6859906136115,12.0111155960606,0.408697481439044,2020-05-04,2020,5
"7138","RS",4,"Sul",43009,"Carazinho",164574,43738.7892664698,19,42,7,35,17,25,1,1,0,1,0,43,8,35,18,25,32,10.6859906136115,12.0111155960606,0.403552352707532,2020-05-11,2020,5
"7139","RS",4,"Sul",43009,"Carazinho",164574,43738.7892664698,20,44,18,26,17,27,0,0,0,0,0,44,18,26,17,27,15,10.6859906136115,12.0111155960606,0.412367710118433,2020-05-18,2020,5
"7140","RS",4,"Sul",43009,"Carazinho",164574,43738.7892664698,21,50,7,43,12,38,0,0,0,0,0,50,7,43,12,38,30,10.6859906136115,12.0111155960606,0.395330044902857,2020-05-25,2020,5
"7141","RS",4,"Sul",43010,"Passo Fundo",361746,45538.5342895844,5,87,17,70,26,61,0,0,0,0,0,87,17,70,26,61,48,10.7263141539787,12.7986975870725,0.315308851768588,2020-02-03,2020,2
"7142","RS",4,"Sul",43010,"Passo Fundo",361746,45538.5342895844,6,72,21,51,34,38,0,0,0,0,0,72,21,51,34,38,38,10.7263141539787,12.7986975870725,0.31396920358758,2020-02-10,2020,2
"7143","RS",4,"Sul",43010,"Passo Fundo",361746,45538.5342895844,7,78,15,63,23,55,0,0,0,0,0,78,15,63,23,55,45,10.7263141539787,12.7986975870725,0.31904374806258,2020-02-17,2020,2
"7144","RS",4,"Sul",43010,"Passo Fundo",361746,45538.5342895844,8,90,18,72,23,67,0,0,0,0,0,90,18,72,23,67,48,10.7263141539787,12.7986975870725,0.360387755042137,2020-02-24,2020,2
"7145","RS",4,"Sul",43010,"Passo Fundo",361746,45538.5342895844,9,99,19,80,30,69,0,0,0,0,0,99,19,80,30,69,42,10.7263141539787,12.7986975870725,0.33399697399264,2020-03-02,2020,3
"7146","RS",4,"Sul",43010,"Passo Fundo",361746,45538.5342895844,10,84,25,59,25,59,1,0,1,1,0,85,25,60,26,59,41,10.7263141539787,12.7986975870725,0.342539859355379,2020-03-09,2020,3
"7147","RS",4,"Sul",43010,"Passo Fundo",361746,45538.5342895844,11,85,18,67,29,56,1,0,1,1,0,86,18,68,30,56,35,10.7263141539787,12.7986975870725,0.452142118766632,2020-03-16,2020,3
"7148","RS",4,"Sul",43010,"Passo Fundo",361746,45538.5342895844,12,65,23,42,17,48,0,0,0,0,0,65,23,42,17,48,43,10.7263141539787,12.7986975870725,0.578896969446916,2020-03-23,2020,3
"7149","RS",4,"Sul",43010,"Passo Fundo",361746,45538.5342895844,13,77,20,57,27,50,0,0,0,0,0,77,20,57,27,50,42,10.7263141539787,12.7986975870725,0.521162525342636,2020-03-30,2020,3
"7150","RS",4,"Sul",43010,"Passo Fundo",361746,45538.5342895844,14,86,16,70,32,54,0,0,0,0,0,86,16,70,32,54,46,10.7263141539787,12.7986975870725,0.504782297309875,2020-04-06,2020,4
"7151","RS",4,"Sul",43010,"Passo Fundo",361746,45538.5342895844,15,82,17,65,28,54,0,0,0,0,0,82,17,65,28,54,48,10.7263141539787,12.7986975870725,0.461113075505088,2020-04-13,2020,4
"7152","RS",4,"Sul",43010,"Passo Fundo",361746,45538.5342895844,16,76,20,56,27,49,0,0,0,0,0,76,20,56,27,49,47,10.7263141539787,12.7986975870725,0.471414152755128,2020-04-20,2020,4
"7153","RS",4,"Sul",43010,"Passo Fundo",361746,45538.5342895844,17,86,20,66,23,63,0,0,0,0,0,86,20,66,23,63,39,10.7263141539787,12.7986975870725,0.47476875569208,2020-04-27,2020,4
"7154","RS",4,"Sul",43010,"Passo Fundo",361746,45538.5342895844,18,100,21,79,33,67,2,1,1,1,1,102,22,80,34,68,61,10.7263141539787,12.7986975870725,0.438987328760402,2020-05-04,2020,5
"7155","RS",4,"Sul",43010,"Passo Fundo",361746,45538.5342895844,19,97,23,74,32,65,0,0,0,0,0,97,23,74,32,65,51,10.7263141539787,12.7986975870725,0.43362192301972,2020-05-11,2020,5
"7156","RS",4,"Sul",43010,"Passo Fundo",361746,45538.5342895844,20,102,22,80,38,64,1,1,0,1,0,103,23,80,39,64,60,10.7263141539787,12.7986975870725,0.440967367062605,2020-05-18,2020,5
"7157","RS",4,"Sul",43010,"Passo Fundo",361746,45538.5342895844,21,88,22,66,26,62,0,0,0,0,0,88,22,66,26,62,56,10.7263141539787,12.7986975870725,0.42164745527688,2020-05-25,2020,5
"7158","RS",4,"Sul",43011,"Cruz Alta",148290,62311.570682986,5,34,10,24,10,24,0,0,0,0,0,34,10,24,10,24,20,11.0399024127793,11.9069250949691,0.30643997704729,2020-02-03,2020,2
"7159","RS",4,"Sul",43011,"Cruz Alta",148290,62311.570682986,6,23,4,19,10,13,0,0,0,0,0,23,4,19,10,13,21,11.0399024127793,11.9069250949691,0.297192783681663,2020-02-10,2020,2
"7160","RS",4,"Sul",43011,"Cruz Alta",148290,62311.570682986,7,30,5,25,11,19,1,0,1,0,1,31,5,26,11,20,14,11.0399024127793,11.9069250949691,0.308216691048737,2020-02-17,2020,2
"7161","RS",4,"Sul",43011,"Cruz Alta",148290,62311.570682986,8,30,6,24,11,19,0,0,0,0,0,30,6,24,11,19,23,11.0399024127793,11.9069250949691,0.343862091743422,2020-02-24,2020,2
"7162","RS",4,"Sul",43011,"Cruz Alta",148290,62311.570682986,9,29,8,21,13,16,0,0,0,0,0,29,8,21,13,16,26,11.0399024127793,11.9069250949691,0.324936787116318,2020-03-02,2020,3
"7163","RS",4,"Sul",43011,"Cruz Alta",148290,62311.570682986,10,34,7,27,13,21,0,0,0,0,0,34,7,27,13,21,19,11.0399024127793,11.9069250949691,0.326767381473755,2020-03-09,2020,3
"7164","RS",4,"Sul",43011,"Cruz Alta",148290,62311.570682986,11,19,6,13,9,10,0,0,0,0,0,19,6,13,9,10,31,11.0399024127793,11.9069250949691,0.422676315019113,2020-03-16,2020,3
"7165","RS",4,"Sul",43011,"Cruz Alta",148290,62311.570682986,12,32,6,26,13,19,0,0,0,0,0,32,6,26,13,19,24,11.0399024127793,11.9069250949691,0.531480932289287,2020-03-23,2020,3
"7166","RS",4,"Sul",43011,"Cruz Alta",148290,62311.570682986,13,36,8,28,9,27,0,0,0,0,0,36,8,28,9,27,19,11.0399024127793,11.9069250949691,0.469218065432584,2020-03-30,2020,3
"7167","RS",4,"Sul",43011,"Cruz Alta",148290,62311.570682986,14,29,7,22,7,22,0,0,0,0,0,29,7,22,7,22,23,11.0399024127793,11.9069250949691,0.458952773340219,2020-04-06,2020,4
"7168","RS",4,"Sul",43011,"Cruz Alta",148290,62311.570682986,15,36,9,27,12,24,1,0,1,0,1,37,9,28,12,25,33,11.0399024127793,11.9069250949691,0.431335449903898,2020-04-13,2020,4
"7169","RS",4,"Sul",43011,"Cruz Alta",148290,62311.570682986,16,42,14,28,14,28,0,0,0,0,0,42,14,28,14,28,18,11.0399024127793,11.9069250949691,0.426435607596158,2020-04-20,2020,4
"7170","RS",4,"Sul",43011,"Cruz Alta",148290,62311.570682986,17,29,6,23,10,19,0,0,0,0,0,29,6,23,10,19,23,11.0399024127793,11.9069250949691,0.423333167218496,2020-04-27,2020,4
"7171","RS",4,"Sul",43011,"Cruz Alta",148290,62311.570682986,18,31,5,26,7,24,0,0,0,0,0,31,5,26,7,24,17,11.0399024127793,11.9069250949691,0.408795992918597,2020-05-04,2020,5
"7172","RS",4,"Sul",43011,"Cruz Alta",148290,62311.570682986,19,24,5,19,9,15,0,0,0,0,0,24,5,19,9,15,27,11.0399024127793,11.9069250949691,0.402300318939246,2020-05-11,2020,5
"7173","RS",4,"Sul",43011,"Cruz Alta",148290,62311.570682986,20,35,10,25,11,24,1,0,1,1,0,36,10,26,12,24,23,11.0399024127793,11.9069250949691,0.422128646189017,2020-05-18,2020,5
"7174","RS",4,"Sul",43011,"Cruz Alta",148290,62311.570682986,21,41,11,30,15,26,0,0,0,0,0,41,11,30,15,26,20,11.0399024127793,11.9069250949691,0.404178202605569,2020-05-25,2020,5
"7175","RS",4,"Sul",43012,"Não-Me-Toque",44094,58637.9526273416,5,9,1,8,3,6,0,0,0,0,0,9,1,8,3,6,2,10.9791374216833,10.6940789977569,0.33713202377835,2020-02-03,2020,2
"7176","RS",4,"Sul",43012,"Não-Me-Toque",44094,58637.9526273416,6,7,0,7,3,4,0,0,0,0,0,7,0,7,3,4,5,10.9791374216833,10.6940789977569,0.315557762329036,2020-02-10,2020,2
"7177","RS",4,"Sul",43012,"Não-Me-Toque",44094,58637.9526273416,7,11,2,9,3,8,0,0,0,0,0,11,2,9,3,8,7,10.9791374216833,10.6940789977569,0.320029893189783,2020-02-17,2020,2
"7178","RS",4,"Sul",43012,"Não-Me-Toque",44094,58637.9526273416,8,5,2,3,1,4,0,0,0,0,0,5,2,3,1,4,6,10.9791374216833,10.6940789977569,0.352397882477325,2020-02-24,2020,2
"7179","RS",4,"Sul",43012,"Não-Me-Toque",44094,58637.9526273416,9,12,2,10,3,9,0,0,0,0,0,12,2,10,3,9,7,10.9791374216833,10.6940789977569,0.339201271064547,2020-03-02,2020,3
"7180","RS",4,"Sul",43012,"Não-Me-Toque",44094,58637.9526273416,10,6,1,5,2,4,0,0,0,0,0,6,1,5,2,4,11,10.9791374216833,10.6940789977569,0.335058169992923,2020-03-09,2020,3
"7181","RS",4,"Sul",43012,"Não-Me-Toque",44094,58637.9526273416,11,5,1,4,1,4,0,0,0,0,0,5,1,4,1,4,10,10.9791374216833,10.6940789977569,0.465515898317461,2020-03-16,2020,3
"7182","RS",4,"Sul",43012,"Não-Me-Toque",44094,58637.9526273416,12,11,5,6,3,8,0,0,0,0,0,11,5,6,3,8,11,10.9791374216833,10.6940789977569,0.60451556187077,2020-03-23,2020,3
"7183","RS",4,"Sul",43012,"Não-Me-Toque",44094,58637.9526273416,13,4,0,4,1,3,0,0,0,0,0,4,0,4,1,3,7,10.9791374216833,10.6940789977569,0.510492373080287,2020-03-30,2020,3
"7184","RS",4,"Sul",43012,"Não-Me-Toque",44094,58637.9526273416,14,10,2,8,3,7,0,0,0,0,0,10,2,8,3,7,12,10.9791374216833,10.6940789977569,0.488689026029616,2020-04-06,2020,4
"7185","RS",4,"Sul",43012,"Não-Me-Toque",44094,58637.9526273416,15,12,0,12,2,10,0,0,0,0,0,12,0,12,2,10,6,10.9791374216833,10.6940789977569,0.465668632520606,2020-04-13,2020,4
"7186","RS",4,"Sul",43012,"Não-Me-Toque",44094,58637.9526273416,16,9,3,6,5,4,0,0,0,0,0,9,3,6,5,4,12,10.9791374216833,10.6940789977569,0.472626884479458,2020-04-20,2020,4
"7187","RS",4,"Sul",43012,"Não-Me-Toque",44094,58637.9526273416,17,4,1,3,0,4,0,0,0,0,0,4,1,3,0,4,3,10.9791374216833,10.6940789977569,0.429204626294864,2020-04-27,2020,4
"7188","RS",4,"Sul",43012,"Não-Me-Toque",44094,58637.9526273416,18,9,1,8,4,5,2,0,2,2,0,11,1,10,6,5,4,10.9791374216833,10.6940789977569,0.387883129367192,2020-05-04,2020,5
"7189","RS",4,"Sul",43012,"Não-Me-Toque",44094,58637.9526273416,19,12,0,12,4,8,0,0,0,0,0,12,0,12,4,8,4,10.9791374216833,10.6940789977569,0.403474666439066,2020-05-11,2020,5
"7190","RS",4,"Sul",43012,"Não-Me-Toque",44094,58637.9526273416,20,14,3,11,2,12,0,0,0,0,0,14,3,11,2,12,6,10.9791374216833,10.6940789977569,0.422544410301948,2020-05-18,2020,5
"7191","RS",4,"Sul",43012,"Não-Me-Toque",44094,58637.9526273416,21,8,1,7,2,6,0,0,0,0,0,8,1,7,2,6,11,10.9791374216833,10.6940789977569,0.386829371515145,2020-05-25,2020,5
"7192","RS",4,"Sul",43013,"Soledade",72552,25406.7962358033,5,8,2,6,1,7,0,0,0,0,0,8,2,6,1,7,15,10.1427719855553,11.1920588251274,0.306403302030666,2020-02-03,2020,2
"7193","RS",4,"Sul",43013,"Soledade",72552,25406.7962358033,6,9,7,2,3,6,0,0,0,0,0,9,7,2,3,6,7,10.1427719855553,11.1920588251274,0.29304409631551,2020-02-10,2020,2
"7194","RS",4,"Sul",43013,"Soledade",72552,25406.7962358033,7,10,2,8,1,9,0,0,0,0,0,10,2,8,1,9,8,10.1427719855553,11.1920588251274,0.30896821450624,2020-02-17,2020,2
"7195","RS",4,"Sul",43013,"Soledade",72552,25406.7962358033,8,12,3,9,3,9,0,0,0,0,0,12,3,9,3,9,10,10.1427719855553,11.1920588251274,0.362043915504997,2020-02-24,2020,2
"7196","RS",4,"Sul",43013,"Soledade",72552,25406.7962358033,9,13,2,11,6,7,0,0,0,0,0,13,2,11,6,7,14,10.1427719855553,11.1920588251274,0.311225457505834,2020-03-02,2020,3
"7197","RS",4,"Sul",43013,"Soledade",72552,25406.7962358033,10,10,2,8,3,7,0,0,0,0,0,10,2,8,3,7,13,10.1427719855553,11.1920588251274,0.34328272381389,2020-03-09,2020,3
"7198","RS",4,"Sul",43013,"Soledade",72552,25406.7962358033,11,12,5,7,8,4,0,0,0,0,0,12,5,7,8,4,11,10.1427719855553,11.1920588251274,0.419007342088502,2020-03-16,2020,3
"7199","RS",4,"Sul",43013,"Soledade",72552,25406.7962358033,12,13,5,8,5,8,0,0,0,0,0,13,5,8,5,8,9,10.1427719855553,11.1920588251274,0.572130955706144,2020-03-23,2020,3
"7200","RS",4,"Sul",43013,"Soledade",72552,25406.7962358033,13,13,5,8,4,9,0,0,0,0,0,13,5,8,4,9,8,10.1427719855553,11.1920588251274,0.504952699862191,2020-03-30,2020,3
"7201","RS",4,"Sul",43013,"Soledade",72552,25406.7962358033,14,15,5,10,7,8,0,0,0,0,0,15,5,10,7,8,10,10.1427719855553,11.1920588251274,0.467737041209362,2020-04-06,2020,4
"7202","RS",4,"Sul",43013,"Soledade",72552,25406.7962358033,15,22,5,17,9,13,0,0,0,0,0,22,5,17,9,13,8,10.1427719855553,11.1920588251274,0.428586706507318,2020-04-13,2020,4
"7203","RS",4,"Sul",43013,"Soledade",72552,25406.7962358033,16,18,2,16,7,11,0,0,0,0,0,18,2,16,7,11,13,10.1427719855553,11.1920588251274,0.429122615978219,2020-04-20,2020,4
"7204","RS",4,"Sul",43013,"Soledade",72552,25406.7962358033,17,12,5,7,3,9,0,0,0,0,0,12,5,7,3,9,10,10.1427719855553,11.1920588251274,0.435595062765609,2020-04-27,2020,4
"7205","RS",4,"Sul",43013,"Soledade",72552,25406.7962358033,18,21,6,15,6,15,1,0,1,1,0,22,6,16,7,15,13,10.1427719855553,11.1920588251274,0.389111082609671,2020-05-04,2020,5
"7206","RS",4,"Sul",43013,"Soledade",72552,25406.7962358033,19,11,5,6,4,7,0,0,0,0,0,11,5,6,4,7,9,10.1427719855553,11.1920588251274,0.411936445054137,2020-05-11,2020,5
"7207","RS",4,"Sul",43013,"Soledade",72552,25406.7962358033,20,16,4,12,5,11,0,0,0,0,0,16,4,12,5,11,11,10.1427719855553,11.1920588251274,0.398861920137127,2020-05-18,2020,5
"7208","RS",4,"Sul",43013,"Soledade",72552,25406.7962358033,21,14,6,8,5,9,0,0,0,0,0,14,6,8,5,9,12,10.1427719855553,11.1920588251274,0.392131208662967,2020-05-25,2020,5
"7209","RS",4,"Sul",43014,"Guaporé",141389,40866.6116535233,5,31,6,25,10,21,0,0,0,0,0,31,6,25,10,21,17,10.6180686676535,11.8592702359249,0.29552633300221,2020-02-03,2020,2
"7210","RS",4,"Sul",43014,"Guaporé",141389,40866.6116535233,6,24,4,20,6,18,0,0,0,0,0,24,4,20,6,18,15,10.6180686676535,11.8592702359249,0.29374482226929,2020-02-10,2020,2
"7211","RS",4,"Sul",43014,"Guaporé",141389,40866.6116535233,7,30,8,22,6,24,1,0,1,0,1,31,8,23,6,25,19,10.6180686676535,11.8592702359249,0.303212478021259,2020-02-17,2020,2
"7212","RS",4,"Sul",43014,"Guaporé",141389,40866.6116535233,8,29,5,24,8,21,0,0,0,0,0,29,5,24,8,21,13,10.6180686676535,11.8592702359249,0.318643626882204,2020-02-24,2020,2
"7213","RS",4,"Sul",43014,"Guaporé",141389,40866.6116535233,9,39,6,33,10,29,0,0,0,0,0,39,6,33,10,29,19,10.6180686676535,11.8592702359249,0.310366763465201,2020-03-02,2020,3
"7214","RS",4,"Sul",43014,"Guaporé",141389,40866.6116535233,10,26,6,20,7,19,0,0,0,0,0,26,6,20,7,19,28,10.6180686676535,11.8592702359249,0.317015533023234,2020-03-09,2020,3
"7215","RS",4,"Sul",43014,"Guaporé",141389,40866.6116535233,11,39,12,27,8,31,0,0,0,0,0,39,12,27,8,31,10,10.6180686676535,11.8592702359249,0.419255767385342,2020-03-16,2020,3
"7216","RS",4,"Sul",43014,"Guaporé",141389,40866.6116535233,12,21,4,17,6,15,0,0,0,0,0,21,4,17,6,15,21,10.6180686676535,11.8592702359249,0.549373448498865,2020-03-23,2020,3
"7217","RS",4,"Sul",43014,"Guaporé",141389,40866.6116535233,13,18,2,16,4,14,0,0,0,0,0,18,2,16,4,14,17,10.6180686676535,11.8592702359249,0.47571144713956,2020-03-30,2020,3
"7218","RS",4,"Sul",43014,"Guaporé",141389,40866.6116535233,14,28,5,23,4,24,0,0,0,0,0,28,5,23,4,24,10,10.6180686676535,11.8592702359249,0.437491870277428,2020-04-06,2020,4
"7219","RS",4,"Sul",43014,"Guaporé",141389,40866.6116535233,15,30,3,27,5,25,1,0,1,1,0,31,3,28,6,25,18,10.6180686676535,11.8592702359249,0.380901632693399,2020-04-13,2020,4
"7220","RS",4,"Sul",43014,"Guaporé",141389,40866.6116535233,16,33,9,24,17,16,0,0,0,0,0,33,9,24,17,16,21,10.6180686676535,11.8592702359249,0.392020631593081,2020-04-20,2020,4
"7221","RS",4,"Sul",43014,"Guaporé",141389,40866.6116535233,17,35,3,32,11,24,0,0,0,0,0,35,3,32,11,24,15,10.6180686676535,11.8592702359249,0.396164251562355,2020-04-27,2020,4
"7222","RS",4,"Sul",43014,"Guaporé",141389,40866.6116535233,18,30,8,22,13,17,0,0,0,0,0,30,8,22,13,17,25,10.6180686676535,11.8592702359249,0.379798491546118,2020-05-04,2020,5
"7223","RS",4,"Sul",43014,"Guaporé",141389,40866.6116535233,19,22,8,14,7,15,0,0,0,0,0,22,8,14,7,15,20,10.6180686676535,11.8592702359249,0.385388665627946,2020-05-11,2020,5
"7224","RS",4,"Sul",43014,"Guaporé",141389,40866.6116535233,20,25,4,21,7,18,2,1,1,0,2,27,5,22,7,20,12,10.6180686676535,11.8592702359249,0.380812275598285,2020-05-18,2020,5
"7225","RS",4,"Sul",43014,"Guaporé",141389,40866.6116535233,21,42,12,30,11,31,0,0,0,0,0,42,12,30,11,31,23,10.6180686676535,11.8592702359249,0.381785449732079,2020-05-25,2020,5
"7226","RS",4,"Sul",43015,"Vacaria",164409,38097.5147092921,5,39,7,32,18,21,0,0,0,0,0,39,7,32,18,21,23,10.5479043282599,12.0101125046313,0.324677606872454,2020-02-03,2020,2
"7227","RS",4,"Sul",43015,"Vacaria",164409,38097.5147092921,6,43,17,26,14,29,0,0,0,0,0,43,17,26,14,29,22,10.5479043282599,12.0101125046313,0.329446908823568,2020-02-10,2020,2
"7228","RS",4,"Sul",43015,"Vacaria",164409,38097.5147092921,7,47,25,22,19,28,0,0,0,0,0,47,25,22,19,28,30,10.5479043282599,12.0101125046313,0.326127397605218,2020-02-17,2020,2
"7229","RS",4,"Sul",43015,"Vacaria",164409,38097.5147092921,8,29,12,17,13,16,0,0,0,0,0,29,12,17,13,16,32,10.5479043282599,12.0101125046313,0.360265048240052,2020-02-24,2020,2
"7230","RS",4,"Sul",43015,"Vacaria",164409,38097.5147092921,9,50,18,32,22,28,1,1,0,1,0,51,19,32,23,28,33,10.5479043282599,12.0101125046313,0.335294234025701,2020-03-02,2020,3
"7231","RS",4,"Sul",43015,"Vacaria",164409,38097.5147092921,10,40,15,25,18,22,0,0,0,0,0,40,15,25,18,22,21,10.5479043282599,12.0101125046313,0.342457684039319,2020-03-09,2020,3
"7232","RS",4,"Sul",43015,"Vacaria",164409,38097.5147092921,11,33,12,21,16,17,0,0,0,0,0,33,12,21,16,17,17,10.5479043282599,12.0101125046313,0.437309045096538,2020-03-16,2020,3
"7233","RS",4,"Sul",43015,"Vacaria",164409,38097.5147092921,12,34,12,22,13,21,0,0,0,0,0,34,12,22,13,21,25,10.5479043282599,12.0101125046313,0.52708383940698,2020-03-23,2020,3
"7234","RS",4,"Sul",43015,"Vacaria",164409,38097.5147092921,13,40,15,25,16,24,0,0,0,0,0,40,15,25,16,24,26,10.5479043282599,12.0101125046313,0.472597912563276,2020-03-30,2020,3
"7235","RS",4,"Sul",43015,"Vacaria",164409,38097.5147092921,14,50,12,38,23,27,0,0,0,0,0,50,12,38,23,27,28,10.5479043282599,12.0101125046313,0.450873561762878,2020-04-06,2020,4
"7236","RS",4,"Sul",43015,"Vacaria",164409,38097.5147092921,15,53,22,31,24,29,1,1,0,0,1,54,23,31,24,30,22,10.5479043282599,12.0101125046313,0.415404665620507,2020-04-13,2020,4
"7237","RS",4,"Sul",43015,"Vacaria",164409,38097.5147092921,16,44,20,24,20,24,1,0,1,1,0,45,20,25,21,24,22,10.5479043282599,12.0101125046313,0.420786776190384,2020-04-20,2020,4
"7238","RS",4,"Sul",43015,"Vacaria",164409,38097.5147092921,17,44,9,35,19,25,0,0,0,0,0,44,9,35,19,25,23,10.5479043282599,12.0101125046313,0.420237286267115,2020-04-27,2020,4
"7239","RS",4,"Sul",43015,"Vacaria",164409,38097.5147092921,18,42,15,27,17,25,0,0,0,0,0,42,15,27,17,25,22,10.5479043282599,12.0101125046313,0.401835059230251,2020-05-04,2020,5
"7240","RS",4,"Sul",43015,"Vacaria",164409,38097.5147092921,19,37,13,24,13,24,0,0,0,0,0,37,13,24,13,24,28,10.5479043282599,12.0101125046313,0.409875999391497,2020-05-11,2020,5
"7241","RS",4,"Sul",43015,"Vacaria",164409,38097.5147092921,20,45,20,25,18,27,0,0,0,0,0,45,20,25,18,27,32,10.5479043282599,12.0101125046313,0.425274057945937,2020-05-18,2020,5
"7242","RS",4,"Sul",43015,"Vacaria",164409,38097.5147092921,21,42,13,29,18,24,0,0,0,0,0,42,13,29,18,24,25,10.5479043282599,12.0101125046313,0.404327520435084,2020-05-25,2020,5
"7243","RS",4,"Sul",43016,"Caxias do Sul",898229,50474.0584350093,5,176,26,150,38,138,1,0,1,0,1,177,26,151,38,139,104,10.8292147889211,13.7081803259104,0.291174005681852,2020-02-03,2020,2
"7244","RS",4,"Sul",43016,"Caxias do Sul",898229,50474.0584350093,6,192,29,163,48,144,1,0,1,1,0,193,29,164,49,144,103,10.8292147889211,13.7081803259104,0.287218757911172,2020-02-10,2020,2
"7245","RS",4,"Sul",43016,"Caxias do Sul",898229,50474.0584350093,7,166,34,132,40,126,5,2,3,0,5,171,36,135,40,131,88,10.8292147889211,13.7081803259104,0.296290420546761,2020-02-17,2020,2
"7246","RS",4,"Sul",43016,"Caxias do Sul",898229,50474.0584350093,8,192,48,144,61,131,0,0,0,0,0,192,48,144,61,131,87,10.8292147889211,13.7081803259104,0.318226186061688,2020-02-24,2020,2
"7247","RS",4,"Sul",43016,"Caxias do Sul",898229,50474.0584350093,9,176,28,148,45,131,0,0,0,0,0,176,28,148,45,131,102,10.8292147889211,13.7081803259104,0.305293088930458,2020-03-02,2020,3
"7248","RS",4,"Sul",43016,"Caxias do Sul",898229,50474.0584350093,10,194,44,150,60,134,3,1,2,1,2,197,45,152,61,136,96,10.8292147889211,13.7081803259104,0.317962709213786,2020-03-09,2020,3
"7249","RS",4,"Sul",43016,"Caxias do Sul",898229,50474.0584350093,11,193,41,152,48,145,0,0,0,0,0,193,41,152,48,145,88,10.8292147889211,13.7081803259104,0.432128542194322,2020-03-16,2020,3
"7250","RS",4,"Sul",43016,"Caxias do Sul",898229,50474.0584350093,12,155,31,124,49,106,2,0,2,0,2,157,31,126,49,108,96,10.8292147889211,13.7081803259104,0.602260857571275,2020-03-23,2020,3
"7251","RS",4,"Sul",43016,"Caxias do Sul",898229,50474.0584350093,13,137,36,101,46,91,3,1,2,0,3,140,37,103,46,94,78,10.8292147889211,13.7081803259104,0.529179520374477,2020-03-30,2020,3
"7252","RS",4,"Sul",43016,"Caxias do Sul",898229,50474.0584350093,14,178,27,151,50,128,0,0,0,0,0,178,27,151,50,128,100,10.8292147889211,13.7081803259104,0.484976239239711,2020-04-06,2020,4
"7253","RS",4,"Sul",43016,"Caxias do Sul",898229,50474.0584350093,15,186,27,159,51,135,0,0,0,0,0,186,27,159,51,135,91,10.8292147889211,13.7081803259104,0.431341862387243,2020-04-13,2020,4
"7254","RS",4,"Sul",43016,"Caxias do Sul",898229,50474.0584350093,16,170,41,129,49,121,0,0,0,0,0,170,41,129,49,121,93,10.8292147889211,13.7081803259104,0.430459475628281,2020-04-20,2020,4
"7255","RS",4,"Sul",43016,"Caxias do Sul",898229,50474.0584350093,17,163,31,132,42,121,0,0,0,0,0,163,31,132,42,121,102,10.8292147889211,13.7081803259104,0.426134823358519,2020-04-27,2020,4
"7256","RS",4,"Sul",43016,"Caxias do Sul",898229,50474.0584350093,18,197,50,147,61,136,0,0,0,0,0,197,50,147,61,136,109,10.8292147889211,13.7081803259104,0.387759036305397,2020-05-04,2020,5
"7257","RS",4,"Sul",43016,"Caxias do Sul",898229,50474.0584350093,19,192,37,155,58,134,1,1,0,0,1,193,38,155,58,135,99,10.8292147889211,13.7081803259104,0.396457295949991,2020-05-11,2020,5
"7258","RS",4,"Sul",43016,"Caxias do Sul",898229,50474.0584350093,20,208,37,171,53,155,1,1,0,1,0,209,38,171,54,155,115,10.8292147889211,13.7081803259104,0.400473603695805,2020-05-18,2020,5
"7259","RS",4,"Sul",43016,"Caxias do Sul",898229,50474.0584350093,21,185,32,153,54,131,1,1,0,0,1,186,33,153,54,132,97,10.8292147889211,13.7081803259104,0.39508706481911,2020-05-25,2020,5
"7260","RS",4,"Sul",43017,"Santiago",112737,49660.2254006227,5,19,0,19,8,11,1,0,1,0,1,20,0,20,8,12,19,10.8129595979287,11.6328129513826,0.289868294630827,2020-02-03,2020,2
"7261","RS",4,"Sul",43017,"Santiago",112737,49660.2254006227,6,17,7,10,6,11,0,0,0,0,0,17,7,10,6,11,14,10.8129595979287,11.6328129513826,0.28296886815252,2020-02-10,2020,2
"7262","RS",4,"Sul",43017,"Santiago",112737,49660.2254006227,7,25,4,21,7,18,0,0,0,0,0,25,4,21,7,18,11,10.8129595979287,11.6328129513826,0.292348472799497,2020-02-17,2020,2
"7263","RS",4,"Sul",43017,"Santiago",112737,49660.2254006227,8,22,6,16,8,14,0,0,0,0,0,22,6,16,8,14,14,10.8129595979287,11.6328129513826,0.322468561026419,2020-02-24,2020,2
"7264","RS",4,"Sul",43017,"Santiago",112737,49660.2254006227,9,25,3,22,9,16,0,0,0,0,0,25,3,22,9,16,17,10.8129595979287,11.6328129513826,0.309431928387232,2020-03-02,2020,3
"7265","RS",4,"Sul",43017,"Santiago",112737,49660.2254006227,10,19,6,13,9,10,0,0,0,0,0,19,6,13,9,10,8,10.8129595979287,11.6328129513826,0.310627791143774,2020-03-09,2020,3
"7266","RS",4,"Sul",43017,"Santiago",112737,49660.2254006227,11,20,5,15,7,13,0,0,0,0,0,20,5,15,7,13,18,10.8129595979287,11.6328129513826,0.402422797825084,2020-03-16,2020,3
"7267","RS",4,"Sul",43017,"Santiago",112737,49660.2254006227,12,17,6,11,3,14,0,0,0,0,0,17,6,11,3,14,13,10.8129595979287,11.6328129513826,0.53179563835483,2020-03-23,2020,3
"7268","RS",4,"Sul",43017,"Santiago",112737,49660.2254006227,13,19,4,15,8,11,0,0,0,0,0,19,4,15,8,11,19,10.8129595979287,11.6328129513826,0.482806446232322,2020-03-30,2020,3
"7269","RS",4,"Sul",43017,"Santiago",112737,49660.2254006227,14,15,6,9,7,8,2,1,1,1,1,17,7,10,8,9,13,10.8129595979287,11.6328129513826,0.437426867840797,2020-04-06,2020,4
"7270","RS",4,"Sul",43017,"Santiago",112737,49660.2254006227,15,20,10,10,8,12,0,0,0,0,0,20,10,10,8,12,22,10.8129595979287,11.6328129513826,0.400355961326442,2020-04-13,2020,4
"7271","RS",4,"Sul",43017,"Santiago",112737,49660.2254006227,16,14,2,12,4,10,0,0,0,0,0,14,2,12,4,10,17,10.8129595979287,11.6328129513826,0.406080971431968,2020-04-20,2020,4
"7272","RS",4,"Sul",43017,"Santiago",112737,49660.2254006227,17,19,7,12,7,12,0,0,0,0,0,19,7,12,7,12,13,10.8129595979287,11.6328129513826,0.400024962921483,2020-04-27,2020,4
"7273","RS",4,"Sul",43017,"Santiago",112737,49660.2254006227,18,15,4,11,3,12,0,0,0,0,0,15,4,11,3,12,22,10.8129595979287,11.6328129513826,0.371597546785645,2020-05-04,2020,5
"7274","RS",4,"Sul",43017,"Santiago",112737,49660.2254006227,19,26,5,21,6,20,0,0,0,0,0,26,5,21,6,20,20,10.8129595979287,11.6328129513826,0.380890060491905,2020-05-11,2020,5
"7275","RS",4,"Sul",43017,"Santiago",112737,49660.2254006227,20,21,6,15,6,15,0,0,0,0,0,21,6,15,6,15,14,10.8129595979287,11.6328129513826,0.402306863011664,2020-05-18,2020,5
"7276","RS",4,"Sul",43017,"Santiago",112737,49660.2254006227,21,23,3,20,5,18,0,0,0,0,0,23,3,20,5,18,23,10.8129595979287,11.6328129513826,0.379704326983651,2020-05-25,2020,5
"7277","RS",4,"Sul",43018,"Santa Maria",384326,28227.4402138029,5,78,21,57,22,56,1,1,0,1,0,79,22,57,23,56,61,10.24804984104,12.8592464297419,0.305923939135518,2020-02-03,2020,2
"7278","RS",4,"Sul",43018,"Santa Maria",384326,28227.4402138029,6,70,18,52,21,49,0,0,0,0,0,70,18,52,21,49,41,10.24804984104,12.8592464297419,0.298342611397505,2020-02-10,2020,2
"7279","RS",4,"Sul",43018,"Santa Maria",384326,28227.4402138029,7,67,12,55,19,48,1,0,1,1,0,68,12,56,20,48,44,10.24804984104,12.8592464297419,0.310690431146528,2020-02-17,2020,2
"7280","RS",4,"Sul",43018,"Santa Maria",384326,28227.4402138029,8,79,17,62,22,57,0,0,0,0,0,79,17,62,22,57,55,10.24804984104,12.8592464297419,0.340352422975004,2020-02-24,2020,2
"7281","RS",4,"Sul",43018,"Santa Maria",384326,28227.4402138029,9,100,20,80,33,67,0,0,0,0,0,100,20,80,33,67,55,10.24804984104,12.8592464297419,0.327393399803342,2020-03-02,2020,3
"7282","RS",4,"Sul",43018,"Santa Maria",384326,28227.4402138029,10,66,16,50,20,46,0,0,0,0,0,66,16,50,20,46,55,10.24804984104,12.8592464297419,0.335553521719835,2020-03-09,2020,3
"7283","RS",4,"Sul",43018,"Santa Maria",384326,28227.4402138029,11,64,13,51,18,46,0,0,0,0,0,64,13,51,18,46,52,10.24804984104,12.8592464297419,0.439465454360449,2020-03-16,2020,3
"7284","RS",4,"Sul",43018,"Santa Maria",384326,28227.4402138029,12,78,21,57,28,50,0,0,0,0,0,78,21,57,28,50,59,10.24804984104,12.8592464297419,0.592734045718967,2020-03-23,2020,3
"7285","RS",4,"Sul",43018,"Santa Maria",384326,28227.4402138029,13,80,18,62,32,48,0,0,0,0,0,80,18,62,32,48,50,10.24804984104,12.8592464297419,0.531136209275631,2020-03-30,2020,3
"7286","RS",4,"Sul",43018,"Santa Maria",384326,28227.4402138029,14,74,16,58,26,48,0,0,0,0,0,74,16,58,26,48,54,10.24804984104,12.8592464297419,0.49693669417111,2020-04-06,2020,4
"7287","RS",4,"Sul",43018,"Santa Maria",384326,28227.4402138029,15,73,16,57,22,51,0,0,0,0,0,73,16,57,22,51,60,10.24804984104,12.8592464297419,0.460804875021654,2020-04-13,2020,4
"7288","RS",4,"Sul",43018,"Santa Maria",384326,28227.4402138029,16,66,14,52,27,39,0,0,0,0,0,66,14,52,27,39,52,10.24804984104,12.8592464297419,0.467875749257858,2020-04-20,2020,4
"7289","RS",4,"Sul",43018,"Santa Maria",384326,28227.4402138029,17,82,12,70,17,65,0,0,0,0,0,82,12,70,17,65,50,10.24804984104,12.8592464297419,0.450035757867223,2020-04-27,2020,4
"7290","RS",4,"Sul",43018,"Santa Maria",384326,28227.4402138029,18,77,24,53,29,48,0,0,0,0,0,77,24,53,29,48,61,10.24804984104,12.8592464297419,0.414089493086973,2020-05-04,2020,5
"7291","RS",4,"Sul",43018,"Santa Maria",384326,28227.4402138029,19,82,25,57,21,61,1,1,0,1,0,83,26,57,22,61,67,10.24804984104,12.8592464297419,0.428069198217689,2020-05-11,2020,5
"7292","RS",4,"Sul",43018,"Santa Maria",384326,28227.4402138029,20,95,26,69,35,60,1,1,0,0,1,96,27,69,35,61,62,10.24804984104,12.8592464297419,0.436456651275563,2020-05-18,2020,5
"7293","RS",4,"Sul",43018,"Santa Maria",384326,28227.4402138029,21,69,15,54,26,43,1,0,1,0,1,70,15,55,26,44,54,10.24804984104,12.8592464297419,0.414079374428196,2020-05-25,2020,5
"7294","RS",4,"Sul",43019,"Restinga Seca",61736,30914.4788515615,5,7,0,7,1,6,0,0,0,0,0,7,0,7,1,6,6,10.3389799243886,11.0306225081374,0.29126157208698,2020-02-03,2020,2
"7295","RS",4,"Sul",43019,"Restinga Seca",61736,30914.4788515615,6,4,2,2,2,2,0,0,0,0,0,4,2,2,2,2,3,10.3389799243886,11.0306225081374,0.302951749329247,2020-02-10,2020,2
"7296","RS",4,"Sul",43019,"Restinga Seca",61736,30914.4788515615,7,12,3,9,3,9,0,0,0,0,0,12,3,9,3,9,12,10.3389799243886,11.0306225081374,0.281915653644723,2020-02-17,2020,2
"7297","RS",4,"Sul",43019,"Restinga Seca",61736,30914.4788515615,8,10,4,6,5,5,0,0,0,0,0,10,4,6,5,5,5,10.3389799243886,11.0306225081374,0.333395635182351,2020-02-24,2020,2
"7298","RS",4,"Sul",43019,"Restinga Seca",61736,30914.4788515615,9,11,0,11,3,8,1,0,1,0,1,12,0,12,3,9,10,10.3389799243886,11.0306225081374,0.299011881584458,2020-03-02,2020,3
"7299","RS",4,"Sul",43019,"Restinga Seca",61736,30914.4788515615,10,13,4,9,4,9,0,0,0,0,0,13,4,9,4,9,14,10.3389799243886,11.0306225081374,0.322330246306396,2020-03-09,2020,3
"7300","RS",4,"Sul",43019,"Restinga Seca",61736,30914.4788515615,11,5,0,5,2,3,0,0,0,0,0,5,0,5,2,3,15,10.3389799243886,11.0306225081374,0.384754262256016,2020-03-16,2020,3
"7301","RS",4,"Sul",43019,"Restinga Seca",61736,30914.4788515615,12,16,8,8,5,11,0,0,0,0,0,16,8,8,5,11,7,10.3389799243886,11.0306225081374,0.536936054392405,2020-03-23,2020,3
"7302","RS",4,"Sul",43019,"Restinga Seca",61736,30914.4788515615,13,17,5,12,5,12,0,0,0,0,0,17,5,12,5,12,8,10.3389799243886,11.0306225081374,0.453259694703507,2020-03-30,2020,3
"7303","RS",4,"Sul",43019,"Restinga Seca",61736,30914.4788515615,14,8,1,7,0,8,0,0,0,0,0,8,1,7,0,8,2,10.3389799243886,11.0306225081374,0.416236711315456,2020-04-06,2020,4
"7304","RS",4,"Sul",43019,"Restinga Seca",61736,30914.4788515615,15,10,2,8,2,8,0,0,0,0,0,10,2,8,2,8,9,10.3389799243886,11.0306225081374,0.387472651559465,2020-04-13,2020,4
"7305","RS",4,"Sul",43019,"Restinga Seca",61736,30914.4788515615,16,11,5,6,4,7,0,0,0,0,0,11,5,6,4,7,11,10.3389799243886,11.0306225081374,0.415886871402494,2020-04-20,2020,4
"7306","RS",4,"Sul",43019,"Restinga Seca",61736,30914.4788515615,17,6,1,5,0,6,0,0,0,0,0,6,1,5,0,6,7,10.3389799243886,11.0306225081374,0.402843253503656,2020-04-27,2020,4
"7307","RS",4,"Sul",43019,"Restinga Seca",61736,30914.4788515615,18,15,5,10,4,11,0,0,0,0,0,15,5,10,4,11,10,10.3389799243886,11.0306225081374,0.403083775395634,2020-05-04,2020,5
"7308","RS",4,"Sul",43019,"Restinga Seca",61736,30914.4788515615,19,12,2,10,6,6,0,0,0,0,0,12,2,10,6,6,14,10.3389799243886,11.0306225081374,0.424056147852361,2020-05-11,2020,5
"7309","RS",4,"Sul",43019,"Restinga Seca",61736,30914.4788515615,20,10,5,5,3,7,0,0,0,0,0,10,5,5,3,7,10,10.3389799243886,11.0306225081374,0.451997693431649,2020-05-18,2020,5
"7310","RS",4,"Sul",43019,"Restinga Seca",61736,30914.4788515615,21,15,6,9,5,10,0,0,0,0,0,15,6,9,5,10,13,10.3389799243886,11.0306225081374,0.424681334020762,2020-05-25,2020,5
"7311","RS",4,"Sul",43020,"Santa Cruz do Sul",348371,47700.7412318477,5,59,11,48,17,42,1,0,1,1,0,60,11,49,18,42,33,10.7727022162074,12.7610232828382,0.298211261983138,2020-02-03,2020,2
"7312","RS",4,"Sul",43020,"Santa Cruz do Sul",348371,47700.7412318477,6,68,15,53,16,52,1,0,1,0,1,69,15,54,16,53,58,10.7727022162074,12.7610232828382,0.28268611113159,2020-02-10,2020,2
"7313","RS",4,"Sul",43020,"Santa Cruz do Sul",348371,47700.7412318477,7,64,23,41,15,49,3,0,3,0,3,67,23,44,15,52,45,10.7727022162074,12.7610232828382,0.291150174008956,2020-02-17,2020,2
"7314","RS",4,"Sul",43020,"Santa Cruz do Sul",348371,47700.7412318477,8,82,23,59,23,59,0,0,0,0,0,82,23,59,23,59,41,10.7727022162074,12.7610232828382,0.332093137094505,2020-02-24,2020,2
"7315","RS",4,"Sul",43020,"Santa Cruz do Sul",348371,47700.7412318477,9,81,24,57,25,56,0,0,0,0,0,81,24,57,25,56,36,10.7727022162074,12.7610232828382,0.307771001883225,2020-03-02,2020,3
"7316","RS",4,"Sul",43020,"Santa Cruz do Sul",348371,47700.7412318477,10,65,19,46,25,40,1,0,1,0,1,66,19,47,25,41,53,10.7727022162074,12.7610232828382,0.309682846481035,2020-03-09,2020,3
"7317","RS",4,"Sul",43020,"Santa Cruz do Sul",348371,47700.7412318477,11,65,15,50,19,46,1,1,0,0,1,66,16,50,19,47,50,10.7727022162074,12.7610232828382,0.404980714813096,2020-03-16,2020,3
"7318","RS",4,"Sul",43020,"Santa Cruz do Sul",348371,47700.7412318477,12,51,15,36,15,36,2,1,1,0,2,53,16,37,15,38,43,10.7727022162074,12.7610232828382,0.563299372434871,2020-03-23,2020,3
"7319","RS",4,"Sul",43020,"Santa Cruz do Sul",348371,47700.7412318477,13,50,18,32,18,32,0,0,0,0,0,50,18,32,18,32,42,10.7727022162074,12.7610232828382,0.502753800200031,2020-03-30,2020,3
"7320","RS",4,"Sul",43020,"Santa Cruz do Sul",348371,47700.7412318477,14,73,22,51,20,53,1,0,1,0,1,74,22,52,20,54,39,10.7727022162074,12.7610232828382,0.464981832759026,2020-04-06,2020,4
"7321","RS",4,"Sul",43020,"Santa Cruz do Sul",348371,47700.7412318477,15,64,15,49,21,43,1,0,1,0,1,65,15,50,21,44,52,10.7727022162074,12.7610232828382,0.423603602469108,2020-04-13,2020,4
"7322","RS",4,"Sul",43020,"Santa Cruz do Sul",348371,47700.7412318477,16,67,18,49,18,49,1,1,0,0,1,68,19,49,18,50,41,10.7727022162074,12.7610232828382,0.42749955598428,2020-04-20,2020,4
"7323","RS",4,"Sul",43020,"Santa Cruz do Sul",348371,47700.7412318477,17,58,17,41,16,42,1,0,1,0,1,59,17,42,16,43,54,10.7727022162074,12.7610232828382,0.4275438534446,2020-04-27,2020,4
"7324","RS",4,"Sul",43020,"Santa Cruz do Sul",348371,47700.7412318477,18,63,21,42,23,40,1,1,0,1,0,64,22,42,24,40,58,10.7727022162074,12.7610232828382,0.398121596678264,2020-05-04,2020,5
"7325","RS",4,"Sul",43020,"Santa Cruz do Sul",348371,47700.7412318477,19,61,19,42,21,40,0,0,0,0,0,61,19,42,21,40,58,10.7727022162074,12.7610232828382,0.414032036943957,2020-05-11,2020,5
"7326","RS",4,"Sul",43020,"Santa Cruz do Sul",348371,47700.7412318477,20,73,27,46,16,57,0,0,0,0,0,73,27,46,16,57,68,10.7727022162074,12.7610232828382,0.410409394209869,2020-05-18,2020,5
"7327","RS",4,"Sul",43020,"Santa Cruz do Sul",348371,47700.7412318477,21,75,16,59,15,60,1,0,1,0,1,76,16,60,15,61,49,10.7727022162074,12.7610232828382,0.389603628273246,2020-05-25,2020,5
"7328","RS",4,"Sul",43021,"Lajeado-Estrela",339682,40183.1558513257,5,83,14,69,26,57,1,0,1,1,0,84,14,70,27,57,54,10.601203178125,12.7357651648142,0.285502685798954,2020-02-03,2020,2
"7329","RS",4,"Sul",43021,"Lajeado-Estrela",339682,40183.1558513257,6,63,20,43,19,44,1,0,1,0,1,64,20,44,19,45,45,10.601203178125,12.7357651648142,0.284948496271872,2020-02-10,2020,2
"7330","RS",4,"Sul",43021,"Lajeado-Estrela",339682,40183.1558513257,7,82,25,57,18,64,0,0,0,0,0,82,25,57,18,64,53,10.601203178125,12.7357651648142,0.288454327464056,2020-02-17,2020,2
"7331","RS",4,"Sul",43021,"Lajeado-Estrela",339682,40183.1558513257,8,84,25,59,28,56,0,0,0,0,0,84,25,59,28,56,49,10.601203178125,12.7357651648142,0.315803747798435,2020-02-24,2020,2
"7332","RS",4,"Sul",43021,"Lajeado-Estrela",339682,40183.1558513257,9,78,16,62,22,56,1,0,1,0,1,79,16,63,22,57,45,10.601203178125,12.7357651648142,0.30003334394053,2020-03-02,2020,3
"7333","RS",4,"Sul",43021,"Lajeado-Estrela",339682,40183.1558513257,10,71,22,49,20,51,0,0,0,0,0,71,22,49,20,51,47,10.601203178125,12.7357651648142,0.315760512712192,2020-03-09,2020,3
"7334","RS",4,"Sul",43021,"Lajeado-Estrela",339682,40183.1558513257,11,62,16,46,19,43,0,0,0,0,0,62,16,46,19,43,40,10.601203178125,12.7357651648142,0.406259519909011,2020-03-16,2020,3
"7335","RS",4,"Sul",43021,"Lajeado-Estrela",339682,40183.1558513257,12,60,10,50,22,38,1,0,1,0,1,61,10,51,22,39,41,10.601203178125,12.7357651648142,0.566298821442538,2020-03-23,2020,3
"7336","RS",4,"Sul",43021,"Lajeado-Estrela",339682,40183.1558513257,13,66,19,47,19,47,1,1,0,0,1,67,20,47,19,48,46,10.601203178125,12.7357651648142,0.484804403491467,2020-03-30,2020,3
"7337","RS",4,"Sul",43021,"Lajeado-Estrela",339682,40183.1558513257,14,64,13,51,15,49,0,0,0,0,0,64,13,51,15,49,45,10.601203178125,12.7357651648142,0.467973711084529,2020-04-06,2020,4
"7338","RS",4,"Sul",43021,"Lajeado-Estrela",339682,40183.1558513257,15,73,23,50,26,47,0,0,0,0,0,73,23,50,26,47,34,10.601203178125,12.7357651648142,0.418432840287243,2020-04-13,2020,4
"7339","RS",4,"Sul",43021,"Lajeado-Estrela",339682,40183.1558513257,16,80,11,69,21,59,0,0,0,0,0,80,11,69,21,59,44,10.601203178125,12.7357651648142,0.434535185270233,2020-04-20,2020,4
"7340","RS",4,"Sul",43021,"Lajeado-Estrela",339682,40183.1558513257,17,67,15,52,15,52,0,0,0,0,0,67,15,52,15,52,55,10.601203178125,12.7357651648142,0.445920380867152,2020-04-27,2020,4
"7341","RS",4,"Sul",43021,"Lajeado-Estrela",339682,40183.1558513257,18,67,11,56,17,50,0,0,0,0,0,67,11,56,17,50,44,10.601203178125,12.7357651648142,0.405423585741241,2020-05-04,2020,5
"7342","RS",4,"Sul",43021,"Lajeado-Estrela",339682,40183.1558513257,19,84,20,64,23,61,0,0,0,0,0,84,20,64,23,61,53,10.601203178125,12.7357651648142,0.4161761493292,2020-05-11,2020,5
"7343","RS",4,"Sul",43021,"Lajeado-Estrela",339682,40183.1558513257,20,82,16,66,11,71,0,0,0,0,0,82,16,66,11,71,47,10.601203178125,12.7357651648142,0.39923719398844,2020-05-18,2020,5
"7344","RS",4,"Sul",43021,"Lajeado-Estrela",339682,40183.1558513257,21,83,18,65,18,65,0,0,0,0,0,83,18,65,18,65,53,10.601203178125,12.7357651648142,0.38249588059994,2020-05-25,2020,5
"7345","RS",4,"Sul",43022,"Cachoeira do Sul",152342,26911.6884675927,5,30,7,23,9,21,0,0,0,0,0,30,7,23,9,21,31,10.2003159867393,11.9338832723689,0.299825617184066,2020-02-03,2020,2
"7346","RS",4,"Sul",43022,"Cachoeira do Sul",152342,26911.6884675927,6,24,6,18,6,18,0,0,0,0,0,24,6,18,6,18,27,10.2003159867393,11.9338832723689,0.301351059195855,2020-02-10,2020,2
"7347","RS",4,"Sul",43022,"Cachoeira do Sul",152342,26911.6884675927,7,29,7,22,4,25,0,0,0,0,0,29,7,22,4,25,27,10.2003159867393,11.9338832723689,0.303907955153309,2020-02-17,2020,2
"7348","RS",4,"Sul",43022,"Cachoeira do Sul",152342,26911.6884675927,8,31,7,24,17,14,0,0,0,0,0,31,7,24,17,14,28,10.2003159867393,11.9338832723689,0.349345766176901,2020-02-24,2020,2
"7349","RS",4,"Sul",43022,"Cachoeira do Sul",152342,26911.6884675927,9,34,10,24,11,23,0,0,0,0,0,34,10,24,11,23,27,10.2003159867393,11.9338832723689,0.316047691718336,2020-03-02,2020,3
"7350","RS",4,"Sul",43022,"Cachoeira do Sul",152342,26911.6884675927,10,29,13,16,11,18,1,1,0,0,1,30,14,16,11,19,23,10.2003159867393,11.9338832723689,0.334919210239573,2020-03-09,2020,3
"7351","RS",4,"Sul",43022,"Cachoeira do Sul",152342,26911.6884675927,11,38,6,32,12,26,1,1,0,1,0,39,7,32,13,26,23,10.2003159867393,11.9338832723689,0.418509851717285,2020-03-16,2020,3
"7352","RS",4,"Sul",43022,"Cachoeira do Sul",152342,26911.6884675927,12,25,8,17,4,21,0,0,0,0,0,25,8,17,4,21,23,10.2003159867393,11.9338832723689,0.540223215434151,2020-03-23,2020,3
"7353","RS",4,"Sul",43022,"Cachoeira do Sul",152342,26911.6884675927,13,35,10,25,14,21,0,0,0,0,0,35,10,25,14,21,21,10.2003159867393,11.9338832723689,0.475143964136951,2020-03-30,2020,3
"7354","RS",4,"Sul",43022,"Cachoeira do Sul",152342,26911.6884675927,14,35,14,21,11,24,0,0,0,0,0,35,14,21,11,24,30,10.2003159867393,11.9338832723689,0.461474237617693,2020-04-06,2020,4
"7355","RS",4,"Sul",43022,"Cachoeira do Sul",152342,26911.6884675927,15,30,8,22,10,20,0,0,0,0,0,30,8,22,10,20,27,10.2003159867393,11.9338832723689,0.429667068458968,2020-04-13,2020,4
"7356","RS",4,"Sul",43022,"Cachoeira do Sul",152342,26911.6884675927,16,35,8,27,10,25,1,1,0,0,1,36,9,27,10,26,21,10.2003159867393,11.9338832723689,0.415362637804692,2020-04-20,2020,4
"7357","RS",4,"Sul",43022,"Cachoeira do Sul",152342,26911.6884675927,17,24,6,18,13,11,0,0,0,0,0,24,6,18,13,11,22,10.2003159867393,11.9338832723689,0.415947223004575,2020-04-27,2020,4
"7358","RS",4,"Sul",43022,"Cachoeira do Sul",152342,26911.6884675927,18,27,12,15,11,16,0,0,0,0,0,27,12,15,11,16,29,10.2003159867393,11.9338832723689,0.408698938624732,2020-05-04,2020,5
"7359","RS",4,"Sul",43022,"Cachoeira do Sul",152342,26911.6884675927,19,33,9,24,10,23,0,0,0,0,0,33,9,24,10,23,30,10.2003159867393,11.9338832723689,0.413456683006174,2020-05-11,2020,5
"7360","RS",4,"Sul",43022,"Cachoeira do Sul",152342,26911.6884675927,20,30,8,22,12,18,0,0,0,0,0,30,8,22,12,18,28,10.2003159867393,11.9338832723689,0.419835585384657,2020-05-18,2020,5
"7361","RS",4,"Sul",43022,"Cachoeira do Sul",152342,26911.6884675927,21,31,7,24,12,19,1,0,1,0,1,32,7,25,12,20,32,10.2003159867393,11.9338832723689,0.393507498200235,2020-05-25,2020,5
"7362","RS",4,"Sul",43023,"Montenegro",231062,39825.5759508703,5,41,11,30,12,29,0,0,0,0,0,41,11,30,12,29,23,10.5922645967169,12.35044135176,0.3000777937806,2020-02-03,2020,2
"7363","RS",4,"Sul",43023,"Montenegro",231062,39825.5759508703,6,31,11,20,9,22,0,0,0,0,0,31,11,20,9,22,31,10.5922645967169,12.35044135176,0.300513191934175,2020-02-10,2020,2
"7364","RS",4,"Sul",43023,"Montenegro",231062,39825.5759508703,7,37,10,27,7,30,0,0,0,0,0,37,10,27,7,30,30,10.5922645967169,12.35044135176,0.305338063985946,2020-02-17,2020,2
"7365","RS",4,"Sul",43023,"Montenegro",231062,39825.5759508703,8,54,9,45,20,34,0,0,0,0,0,54,9,45,20,34,35,10.5922645967169,12.35044135176,0.340373050532104,2020-02-24,2020,2
"7366","RS",4,"Sul",43023,"Montenegro",231062,39825.5759508703,9,46,10,36,17,29,1,0,1,0,1,47,10,37,17,30,16,10.5922645967169,12.35044135176,0.314852351744406,2020-03-02,2020,3
"7367","RS",4,"Sul",43023,"Montenegro",231062,39825.5759508703,10,42,14,28,13,29,0,0,0,0,0,42,14,28,13,29,33,10.5922645967169,12.35044135176,0.323509416508866,2020-03-09,2020,3
"7368","RS",4,"Sul",43023,"Montenegro",231062,39825.5759508703,11,46,10,36,11,35,0,0,0,0,0,46,10,36,11,35,22,10.5922645967169,12.35044135176,0.414712369947539,2020-03-16,2020,3
"7369","RS",4,"Sul",43023,"Montenegro",231062,39825.5759508703,12,42,12,30,16,26,0,0,0,0,0,42,12,30,16,26,33,10.5922645967169,12.35044135176,0.557368952391268,2020-03-23,2020,3
"7370","RS",4,"Sul",43023,"Montenegro",231062,39825.5759508703,13,49,10,39,21,28,0,0,0,0,0,49,10,39,21,28,31,10.5922645967169,12.35044135176,0.496233864943526,2020-03-30,2020,3
"7371","RS",4,"Sul",43023,"Montenegro",231062,39825.5759508703,14,57,15,42,16,41,0,0,0,0,0,57,15,42,16,41,29,10.5922645967169,12.35044135176,0.470406434839381,2020-04-06,2020,4
"7372","RS",4,"Sul",43023,"Montenegro",231062,39825.5759508703,15,49,14,35,20,29,0,0,0,0,0,49,14,35,20,29,21,10.5922645967169,12.35044135176,0.432464978687144,2020-04-13,2020,4
"7373","RS",4,"Sul",43023,"Montenegro",231062,39825.5759508703,16,48,10,38,7,41,0,0,0,0,0,48,10,38,7,41,23,10.5922645967169,12.35044135176,0.434417491906694,2020-04-20,2020,4
"7374","RS",4,"Sul",43023,"Montenegro",231062,39825.5759508703,17,56,15,41,16,40,0,0,0,0,0,56,15,41,16,40,30,10.5922645967169,12.35044135176,0.430636787838687,2020-04-27,2020,4
"7375","RS",4,"Sul",43023,"Montenegro",231062,39825.5759508703,18,38,13,25,7,31,0,0,0,0,0,38,13,25,7,31,23,10.5922645967169,12.35044135176,0.39287842340834,2020-05-04,2020,5
"7376","RS",4,"Sul",43023,"Montenegro",231062,39825.5759508703,19,46,18,28,21,25,0,0,0,0,0,46,18,28,21,25,34,10.5922645967169,12.35044135176,0.408111253967572,2020-05-11,2020,5
"7377","RS",4,"Sul",43023,"Montenegro",231062,39825.5759508703,20,51,16,35,19,32,0,0,0,0,0,51,16,35,19,32,29,10.5922645967169,12.35044135176,0.401814545624068,2020-05-18,2020,5
"7378","RS",4,"Sul",43023,"Montenegro",231062,39825.5759508703,21,63,26,37,17,46,0,0,0,0,0,63,26,37,17,46,34,10.5922645967169,12.35044135176,0.388454659360183,2020-05-25,2020,5
"7379","RS",4,"Sul",43024,"Gramado-Canela",338699,38798.400163449,5,60,15,45,24,36,0,0,0,0,0,60,15,45,24,36,41,10.5661342918605,12.7328670863362,0.300991751851727,2020-02-03,2020,2
"7380","RS",4,"Sul",43024,"Gramado-Canela",338699,38798.400163449,6,75,19,56,14,61,1,1,0,1,0,76,20,56,15,61,37,10.5661342918605,12.7328670863362,0.29664975221439,2020-02-10,2020,2
"7381","RS",4,"Sul",43024,"Gramado-Canela",338699,38798.400163449,7,60,15,45,21,39,2,1,1,1,1,62,16,46,22,40,36,10.5661342918605,12.7328670863362,0.298146502952595,2020-02-17,2020,2
"7382","RS",4,"Sul",43024,"Gramado-Canela",338699,38798.400163449,8,87,29,58,28,59,0,0,0,0,0,87,29,58,28,59,33,10.5661342918605,12.7328670863362,0.32442122856793,2020-02-24,2020,2
"7383","RS",4,"Sul",43024,"Gramado-Canela",338699,38798.400163449,9,67,15,52,21,46,1,0,1,0,1,68,15,53,21,47,42,10.5661342918605,12.7328670863362,0.310766137912581,2020-03-02,2020,3
"7384","RS",4,"Sul",43024,"Gramado-Canela",338699,38798.400163449,10,96,27,69,28,68,0,0,0,0,0,96,27,69,28,68,31,10.5661342918605,12.7328670863362,0.318358555624342,2020-03-09,2020,3
"7385","RS",4,"Sul",43024,"Gramado-Canela",338699,38798.400163449,11,79,23,56,18,61,0,0,0,0,0,79,23,56,18,61,36,10.5661342918605,12.7328670863362,0.4196395121181,2020-03-16,2020,3
"7386","RS",4,"Sul",43024,"Gramado-Canela",338699,38798.400163449,12,68,24,44,22,46,0,0,0,0,0,68,24,44,22,46,30,10.5661342918605,12.7328670863362,0.601215430466728,2020-03-23,2020,3
"7387","RS",4,"Sul",43024,"Gramado-Canela",338699,38798.400163449,13,60,17,43,24,36,0,0,0,0,0,60,17,43,24,36,37,10.5661342918605,12.7328670863362,0.525393396686619,2020-03-30,2020,3
"7388","RS",4,"Sul",43024,"Gramado-Canela",338699,38798.400163449,14,80,24,56,29,51,0,0,0,0,0,80,24,56,29,51,38,10.5661342918605,12.7328670863362,0.48256812680002,2020-04-06,2020,4
"7389","RS",4,"Sul",43024,"Gramado-Canela",338699,38798.400163449,15,64,27,37,20,44,0,0,0,0,0,64,27,37,20,44,24,10.5661342918605,12.7328670863362,0.444399334307265,2020-04-13,2020,4
"7390","RS",4,"Sul",43024,"Gramado-Canela",338699,38798.400163449,16,88,24,64,24,64,0,0,0,0,0,88,24,64,24,64,41,10.5661342918605,12.7328670863362,0.432211054727155,2020-04-20,2020,4
"7391","RS",4,"Sul",43024,"Gramado-Canela",338699,38798.400163449,17,66,25,41,23,43,0,0,0,0,0,66,25,41,23,43,33,10.5661342918605,12.7328670863362,0.426403084837451,2020-04-27,2020,4
"7392","RS",4,"Sul",43024,"Gramado-Canela",338699,38798.400163449,18,77,17,60,19,58,1,0,1,0,1,78,17,61,19,59,47,10.5661342918605,12.7328670863362,0.396412825045167,2020-05-04,2020,5
"7393","RS",4,"Sul",43024,"Gramado-Canela",338699,38798.400163449,19,86,22,64,32,54,1,0,1,0,1,87,22,65,32,55,37,10.5661342918605,12.7328670863362,0.408673071351785,2020-05-11,2020,5
"7394","RS",4,"Sul",43024,"Gramado-Canela",338699,38798.400163449,20,73,18,55,26,47,0,0,0,0,0,73,18,55,26,47,41,10.5661342918605,12.7328670863362,0.413547227605591,2020-05-18,2020,5
"7395","RS",4,"Sul",43024,"Gramado-Canela",338699,38798.400163449,21,82,26,56,30,52,2,2,0,1,1,84,28,56,31,53,43,10.5661342918605,12.7328670863362,0.395421913375966,2020-05-25,2020,5
"7396","RS",4,"Sul",43025,"São Jerônimo",158153,80028.2082049029,5,29,10,19,11,18,0,0,0,0,0,29,10,19,11,18,17,11.2901344540676,11.9713181978868,0.297631054617886,2020-02-03,2020,2
"7397","RS",4,"Sul",43025,"São Jerônimo",158153,80028.2082049029,6,22,8,14,9,13,0,0,0,0,0,22,8,14,9,13,19,11.2901344540676,11.9713181978868,0.294046929225884,2020-02-10,2020,2
"7398","RS",4,"Sul",43025,"São Jerônimo",158153,80028.2082049029,7,33,14,19,12,21,0,0,0,0,0,33,14,19,12,21,22,11.2901344540676,11.9713181978868,0.30458773909933,2020-02-17,2020,2
"7399","RS",4,"Sul",43025,"São Jerônimo",158153,80028.2082049029,8,23,8,15,14,9,0,0,0,0,0,23,8,15,14,9,18,11.2901344540676,11.9713181978868,0.338977981509028,2020-02-24,2020,2
"7400","RS",4,"Sul",43025,"São Jerônimo",158153,80028.2082049029,9,26,9,17,7,19,0,0,0,0,0,26,9,17,7,19,25,11.2901344540676,11.9713181978868,0.319836443558457,2020-03-02,2020,3
"7401","RS",4,"Sul",43025,"São Jerônimo",158153,80028.2082049029,10,29,10,19,7,22,0,0,0,0,0,29,10,19,7,22,17,11.2901344540676,11.9713181978868,0.340972678286226,2020-03-09,2020,3
"7402","RS",4,"Sul",43025,"São Jerônimo",158153,80028.2082049029,11,31,5,26,14,17,0,0,0,0,0,31,5,26,14,17,17,11.2901344540676,11.9713181978868,0.438758400167606,2020-03-16,2020,3
"7403","RS",4,"Sul",43025,"São Jerônimo",158153,80028.2082049029,12,20,7,13,5,15,0,0,0,0,0,20,7,13,5,15,20,11.2901344540676,11.9713181978868,0.539849426769151,2020-03-23,2020,3
"7404","RS",4,"Sul",43025,"São Jerônimo",158153,80028.2082049029,13,29,9,20,10,19,0,0,0,0,0,29,9,20,10,19,21,11.2901344540676,11.9713181978868,0.493535621749489,2020-03-30,2020,3
"7405","RS",4,"Sul",43025,"São Jerônimo",158153,80028.2082049029,14,18,7,11,10,8,1,0,1,0,1,19,7,12,10,9,21,11.2901344540676,11.9713181978868,0.475903953306938,2020-04-06,2020,4
"7406","RS",4,"Sul",43025,"São Jerônimo",158153,80028.2082049029,15,26,10,16,10,16,0,0,0,0,0,26,10,16,10,16,26,11.2901344540676,11.9713181978868,0.457318724706169,2020-04-13,2020,4
"7407","RS",4,"Sul",43025,"São Jerônimo",158153,80028.2082049029,16,28,9,19,14,14,0,0,0,0,0,28,9,19,14,14,18,11.2901344540676,11.9713181978868,0.447053760097386,2020-04-20,2020,4
"7408","RS",4,"Sul",43025,"São Jerônimo",158153,80028.2082049029,17,27,6,21,10,17,0,0,0,0,0,27,6,21,10,17,17,11.2901344540676,11.9713181978868,0.439702551374031,2020-04-27,2020,4
"7409","RS",4,"Sul",43025,"São Jerônimo",158153,80028.2082049029,18,27,8,19,11,16,0,0,0,0,0,27,8,19,11,16,25,11.2901344540676,11.9713181978868,0.401446918984815,2020-05-04,2020,5
"7410","RS",4,"Sul",43025,"São Jerônimo",158153,80028.2082049029,19,39,11,28,16,23,0,0,0,0,0,39,11,28,16,23,19,11.2901344540676,11.9713181978868,0.418462284638145,2020-05-11,2020,5
"7411","RS",4,"Sul",43025,"São Jerônimo",158153,80028.2082049029,20,27,9,18,7,20,0,0,0,0,0,27,9,18,7,20,22,11.2901344540676,11.9713181978868,0.42437630436341,2020-05-18,2020,5
"7412","RS",4,"Sul",43025,"São Jerônimo",158153,80028.2082049029,21,43,12,31,25,18,0,0,0,0,0,43,12,31,25,18,14,11.2901344540676,11.9713181978868,0.401745831840227,2020-05-25,2020,5
"7413","RS",4,"Sul",43026,"Porto Alegre",3905087,42777.0057749648,5,773,201,572,281,492,3,1,2,1,2,776,202,574,282,494,526,10.6637559889519,15.1777906201371,0.28535420117477,2020-02-03,2020,2
"7414","RS",4,"Sul",43026,"Porto Alegre",3905087,42777.0057749648,6,744,201,543,246,498,7,0,7,3,4,751,201,550,249,502,510,10.6637559889519,15.1777906201371,0.285952758417853,2020-02-10,2020,2
"7415","RS",4,"Sul",43026,"Porto Alegre",3905087,42777.0057749648,7,744,204,540,245,499,8,3,5,3,5,752,207,545,248,504,517,10.6637559889519,15.1777906201371,0.29648896887762,2020-02-17,2020,2
"7416","RS",4,"Sul",43026,"Porto Alegre",3905087,42777.0057749648,8,804,236,568,262,542,7,1,6,3,4,811,237,574,265,546,497,10.6637559889519,15.1777906201371,0.347566770259438,2020-02-24,2020,2
"7417","RS",4,"Sul",43026,"Porto Alegre",3905087,42777.0057749648,9,827,242,585,296,531,7,1,6,2,5,834,243,591,298,536,502,10.6637559889519,15.1777906201371,0.308327835547937,2020-03-02,2020,3
"7418","RS",4,"Sul",43026,"Porto Alegre",3905087,42777.0057749648,10,775,226,549,265,510,4,0,4,1,3,779,226,553,266,513,506,10.6637559889519,15.1777906201371,0.321632713433554,2020-03-09,2020,3
"7419","RS",4,"Sul",43026,"Porto Alegre",3905087,42777.0057749648,11,741,211,530,258,483,10,5,5,6,4,751,216,535,264,487,535,10.6637559889519,15.1777906201371,0.440584699434977,2020-03-16,2020,3
"7420","RS",4,"Sul",43026,"Porto Alegre",3905087,42777.0057749648,12,731,218,513,241,490,9,2,7,6,3,740,220,520,247,493,486,10.6637559889519,15.1777906201371,0.589926698488171,2020-03-23,2020,3
"7421","RS",4,"Sul",43026,"Porto Alegre",3905087,42777.0057749648,13,695,189,506,247,448,8,5,3,3,5,703,194,509,250,453,456,10.6637559889519,15.1777906201371,0.536965922869775,2020-03-30,2020,3
"7422","RS",4,"Sul",43026,"Porto Alegre",3905087,42777.0057749648,14,815,250,565,255,560,10,4,6,6,4,825,254,571,261,564,484,10.6637559889519,15.1777906201371,0.513204131484632,2020-04-06,2020,4
"7423","RS",4,"Sul",43026,"Porto Alegre",3905087,42777.0057749648,15,812,238,574,301,511,3,1,2,0,3,815,239,576,301,514,491,10.6637559889519,15.1777906201371,0.486772248414876,2020-04-13,2020,4
"7424","RS",4,"Sul",43026,"Porto Alegre",3905087,42777.0057749648,16,842,235,607,299,543,2,1,1,1,1,844,236,608,300,544,498,10.6637559889519,15.1777906201371,0.481950549484109,2020-04-20,2020,4
"7425","RS",4,"Sul",43026,"Porto Alegre",3905087,42777.0057749648,17,833,266,567,270,563,7,3,4,4,3,840,269,571,274,566,453,10.6637559889519,15.1777906201371,0.462640635995924,2020-04-27,2020,4
"7426","RS",4,"Sul",43026,"Porto Alegre",3905087,42777.0057749648,18,830,233,597,291,539,11,5,6,7,4,841,238,603,298,543,492,10.6637559889519,15.1777906201371,0.42220701103435,2020-05-04,2020,5
"7427","RS",4,"Sul",43026,"Porto Alegre",3905087,42777.0057749648,19,818,243,575,256,562,4,2,2,0,4,822,245,577,256,566,556,10.6637559889519,15.1777906201371,0.441205711403813,2020-05-11,2020,5
"7428","RS",4,"Sul",43026,"Porto Alegre",3905087,42777.0057749648,20,845,223,622,288,557,5,4,1,3,2,850,227,623,291,559,528,10.6637559889519,15.1777906201371,0.431724212178669,2020-05-18,2020,5
"7429","RS",4,"Sul",43026,"Porto Alegre",3905087,42777.0057749648,21,874,235,639,306,568,3,0,3,1,2,877,235,642,307,570,485,10.6637559889519,15.1777906201371,0.412028388899387,2020-05-25,2020,5
"7430","RS",4,"Sul",43027,"Osório",401937,26046.4064958688,5,95,35,60,25,70,1,0,1,0,1,96,35,61,25,71,41,10.1676350912502,12.9040506389019,0.304976387108738,2020-02-03,2020,2
"7431","RS",4,"Sul",43027,"Osório",401937,26046.4064958688,6,91,29,62,35,56,0,0,0,0,0,91,29,62,35,56,60,10.1676350912502,12.9040506389019,0.302640983118315,2020-02-10,2020,2
"7432","RS",4,"Sul",43027,"Osório",401937,26046.4064958688,7,85,31,54,29,56,1,0,1,0,1,86,31,55,29,57,60,10.1676350912502,12.9040506389019,0.31453007142165,2020-02-17,2020,2
"7433","RS",4,"Sul",43027,"Osório",401937,26046.4064958688,8,88,34,54,35,53,1,0,1,0,1,89,34,55,35,54,55,10.1676350912502,12.9040506389019,0.345413868556609,2020-02-24,2020,2
"7434","RS",4,"Sul",43027,"Osório",401937,26046.4064958688,9,110,35,75,44,66,0,0,0,0,0,110,35,75,44,66,52,10.1676350912502,12.9040506389019,0.338210024991848,2020-03-02,2020,3
"7435","RS",4,"Sul",43027,"Osório",401937,26046.4064958688,10,106,37,69,46,60,0,0,0,0,0,106,37,69,46,60,49,10.1676350912502,12.9040506389019,0.343168247664143,2020-03-09,2020,3
"7436","RS",4,"Sul",43027,"Osório",401937,26046.4064958688,11,93,34,59,40,53,1,0,1,0,1,94,34,60,40,54,56,10.1676350912502,12.9040506389019,0.458414125462295,2020-03-16,2020,3
"7437","RS",4,"Sul",43027,"Osório",401937,26046.4064958688,12,92,36,56,42,50,1,0,1,0,1,93,36,57,42,51,60,10.1676350912502,12.9040506389019,0.596193952924001,2020-03-23,2020,3
"7438","RS",4,"Sul",43027,"Osório",401937,26046.4064958688,13,92,41,51,43,49,1,1,0,0,1,93,42,51,43,50,40,10.1676350912502,12.9040506389019,0.529939909374823,2020-03-30,2020,3
"7439","RS",4,"Sul",43027,"Osório",401937,26046.4064958688,14,95,37,58,39,56,0,0,0,0,0,95,37,58,39,56,57,10.1676350912502,12.9040506389019,0.496222366618515,2020-04-06,2020,4
"7440","RS",4,"Sul",43027,"Osório",401937,26046.4064958688,15,87,37,50,34,53,0,0,0,0,0,87,37,50,34,53,46,10.1676350912502,12.9040506389019,0.461872220891976,2020-04-13,2020,4
"7441","RS",4,"Sul",43027,"Osório",401937,26046.4064958688,16,98,44,54,39,59,2,0,2,2,0,100,44,56,41,59,53,10.1676350912502,12.9040506389019,0.453178143332054,2020-04-20,2020,4
"7442","RS",4,"Sul",43027,"Osório",401937,26046.4064958688,17,90,31,59,37,53,0,0,0,0,0,90,31,59,37,53,58,10.1676350912502,12.9040506389019,0.445724549759749,2020-04-27,2020,4
"7443","RS",4,"Sul",43027,"Osório",401937,26046.4064958688,18,110,43,67,35,75,0,0,0,0,0,110,43,67,35,75,59,10.1676350912502,12.9040506389019,0.415636467202371,2020-05-04,2020,5
"7444","RS",4,"Sul",43027,"Osório",401937,26046.4064958688,19,92,24,68,36,56,0,0,0,0,0,92,24,68,36,56,55,10.1676350912502,12.9040506389019,0.43101808148663,2020-05-11,2020,5
"7445","RS",4,"Sul",43027,"Osório",401937,26046.4064958688,20,94,29,65,41,53,1,1,0,0,1,95,30,65,41,54,61,10.1676350912502,12.9040506389019,0.431054130377964,2020-05-18,2020,5
"7446","RS",4,"Sul",43027,"Osório",401937,26046.4064958688,21,88,24,64,34,54,1,0,1,1,0,89,24,65,35,54,64,10.1676350912502,12.9040506389019,0.414836008761155,2020-05-25,2020,5
"7447","RS",4,"Sul",43028,"Camaquã",139917,24415.9039062444,5,28,9,19,12,16,1,0,1,1,0,29,9,20,13,16,18,10.1029899983885,11.8488046686393,0.293010259104779,2020-02-03,2020,2
"7448","RS",4,"Sul",43028,"Camaquã",139917,24415.9039062444,6,35,11,24,14,21,0,0,0,0,0,35,11,24,14,21,33,10.1029899983885,11.8488046686393,0.294965923215046,2020-02-10,2020,2
"7449","RS",4,"Sul",43028,"Camaquã",139917,24415.9039062444,7,22,4,18,12,10,0,0,0,0,0,22,4,18,12,10,16,10.1029899983885,11.8488046686393,0.298006580344288,2020-02-17,2020,2
"7450","RS",4,"Sul",43028,"Camaquã",139917,24415.9039062444,8,19,6,13,11,8,0,0,0,0,0,19,6,13,11,8,13,10.1029899983885,11.8488046686393,0.337375928167842,2020-02-24,2020,2
"7451","RS",4,"Sul",43028,"Camaquã",139917,24415.9039062444,9,32,16,16,11,21,0,0,0,0,0,32,16,16,11,21,28,10.1029899983885,11.8488046686393,0.325117992166492,2020-03-02,2020,3
"7452","RS",4,"Sul",43028,"Camaquã",139917,24415.9039062444,10,21,6,15,8,13,0,0,0,0,0,21,6,15,8,13,20,10.1029899983885,11.8488046686393,0.332678622039408,2020-03-09,2020,3
"7453","RS",4,"Sul",43028,"Camaquã",139917,24415.9039062444,11,24,5,19,8,16,0,0,0,0,0,24,5,19,8,16,20,10.1029899983885,11.8488046686393,0.410812723865825,2020-03-16,2020,3
"7454","RS",4,"Sul",43028,"Camaquã",139917,24415.9039062444,12,22,7,15,8,14,0,0,0,0,0,22,7,15,8,14,22,10.1029899983885,11.8488046686393,0.521482083392919,2020-03-23,2020,3
"7455","RS",4,"Sul",43028,"Camaquã",139917,24415.9039062444,13,29,8,21,12,17,0,0,0,0,0,29,8,21,12,17,23,10.1029899983885,11.8488046686393,0.476819978978952,2020-03-30,2020,3
"7456","RS",4,"Sul",43028,"Camaquã",139917,24415.9039062444,14,34,16,18,12,22,0,0,0,0,0,34,16,18,12,22,18,10.1029899983885,11.8488046686393,0.458088641303737,2020-04-06,2020,4
"7457","RS",4,"Sul",43028,"Camaquã",139917,24415.9039062444,15,26,10,16,11,15,0,0,0,0,0,26,10,16,11,15,18,10.1029899983885,11.8488046686393,0.424047080049502,2020-04-13,2020,4
"7458","RS",4,"Sul",43028,"Camaquã",139917,24415.9039062444,16,33,15,18,16,17,0,0,0,0,0,33,15,18,16,17,16,10.1029899983885,11.8488046686393,0.421719165825963,2020-04-20,2020,4
"7459","RS",4,"Sul",43028,"Camaquã",139917,24415.9039062444,17,39,11,28,11,28,0,0,0,0,0,39,11,28,11,28,23,10.1029899983885,11.8488046686393,0.409764758210407,2020-04-27,2020,4
"7460","RS",4,"Sul",43028,"Camaquã",139917,24415.9039062444,18,24,6,18,9,15,0,0,0,0,0,24,6,18,9,15,17,10.1029899983885,11.8488046686393,0.379162114516551,2020-05-04,2020,5
"7461","RS",4,"Sul",43028,"Camaquã",139917,24415.9039062444,19,27,12,15,11,16,1,1,0,0,1,28,13,15,11,17,21,10.1029899983885,11.8488046686393,0.407913728244812,2020-05-11,2020,5
"7462","RS",4,"Sul",43028,"Camaquã",139917,24415.9039062444,20,24,11,13,11,13,0,0,0,0,0,24,11,13,11,13,20,10.1029899983885,11.8488046686393,0.412437378782823,2020-05-18,2020,5
"7463","RS",4,"Sul",43028,"Camaquã",139917,24415.9039062444,21,25,13,12,12,13,0,0,0,0,0,25,13,12,12,13,20,10.1029899983885,11.8488046686393,0.391669105369791,2020-05-25,2020,5
"7464","RS",4,"Sul",43029,"Campanha Ocidental",357196,27815.3117100975,5,85,18,67,30,55,0,0,0,0,0,85,18,67,30,55,56,10.2333419289933,12.7860399297135,0.301092907292225,2020-02-03,2020,2
"7465","RS",4,"Sul",43029,"Campanha Ocidental",357196,27815.3117100975,6,82,24,58,41,41,0,0,0,0,0,82,24,58,41,41,57,10.2333419289933,12.7860399297135,0.296949830794126,2020-02-10,2020,2
"7466","RS",4,"Sul",43029,"Campanha Ocidental",357196,27815.3117100975,7,81,30,51,28,53,0,0,0,0,0,81,30,51,28,53,47,10.2333419289933,12.7860399297135,0.302084135564095,2020-02-17,2020,2
"7467","RS",4,"Sul",43029,"Campanha Ocidental",357196,27815.3117100975,8,71,10,61,34,37,2,0,2,2,0,73,10,63,36,37,55,10.2333419289933,12.7860399297135,0.326208622774189,2020-02-24,2020,2
"7468","RS",4,"Sul",43029,"Campanha Ocidental",357196,27815.3117100975,9,86,17,69,32,54,0,0,0,0,0,86,17,69,32,54,48,10.2333419289933,12.7860399297135,0.31380104632958,2020-03-02,2020,3
"7469","RS",4,"Sul",43029,"Campanha Ocidental",357196,27815.3117100975,10,67,20,47,30,37,0,0,0,0,0,67,20,47,30,37,64,10.2333419289933,12.7860399297135,0.323825098838776,2020-03-09,2020,3
"7470","RS",4,"Sul",43029,"Campanha Ocidental",357196,27815.3117100975,11,76,21,55,25,51,1,0,1,0,1,77,21,56,25,52,51,10.2333419289933,12.7860399297135,0.411977787033786,2020-03-16,2020,3
"7471","RS",4,"Sul",43029,"Campanha Ocidental",357196,27815.3117100975,12,56,14,42,24,32,2,2,0,1,1,58,16,42,25,33,41,10.2333419289933,12.7860399297135,0.517961114133522,2020-03-23,2020,3
"7472","RS",4,"Sul",43029,"Campanha Ocidental",357196,27815.3117100975,13,58,11,47,19,39,1,0,1,0,1,59,11,48,19,40,43,10.2333419289933,12.7860399297135,0.46475508798694,2020-03-30,2020,3
"7473","RS",4,"Sul",43029,"Campanha Ocidental",357196,27815.3117100975,14,72,15,57,36,36,1,1,0,1,0,73,16,57,37,36,59,10.2333419289933,12.7860399297135,0.455411248836631,2020-04-06,2020,4
"7474","RS",4,"Sul",43029,"Campanha Ocidental",357196,27815.3117100975,15,83,17,66,40,43,1,1,0,0,1,84,18,66,40,44,48,10.2333419289933,12.7860399297135,0.417098876196254,2020-04-13,2020,4
"7475","RS",4,"Sul",43029,"Campanha Ocidental",357196,27815.3117100975,16,77,21,56,33,44,1,0,1,0,1,78,21,57,33,45,50,10.2333419289933,12.7860399297135,0.426630294188451,2020-04-20,2020,4
"7476","RS",4,"Sul",43029,"Campanha Ocidental",357196,27815.3117100975,17,105,34,71,40,65,1,0,1,1,0,106,34,72,41,65,44,10.2333419289933,12.7860399297135,0.419146780128503,2020-04-27,2020,4
"7477","RS",4,"Sul",43029,"Campanha Ocidental",357196,27815.3117100975,18,97,18,79,31,66,1,0,1,1,0,98,18,80,32,66,52,10.2333419289933,12.7860399297135,0.389178549723084,2020-05-04,2020,5
"7478","RS",4,"Sul",43029,"Campanha Ocidental",357196,27815.3117100975,19,83,20,63,33,50,2,1,1,1,1,85,21,64,34,51,49,10.2333419289933,12.7860399297135,0.409433193427041,2020-05-11,2020,5
"7479","RS",4,"Sul",43029,"Campanha Ocidental",357196,27815.3117100975,20,96,33,63,36,60,1,1,0,0,1,97,34,63,36,61,44,10.2333419289933,12.7860399297135,0.424552478485046,2020-05-18,2020,5
"7480","RS",4,"Sul",43029,"Campanha Ocidental",357196,27815.3117100975,21,89,18,71,37,52,0,0,0,0,0,89,18,71,37,52,65,10.2333419289933,12.7860399297135,0.399815260666288,2020-05-25,2020,5
"7481","RS",4,"Sul",43030,"Campanha Central",180360,30812.5884989466,5,49,12,37,14,35,0,0,0,0,0,49,12,37,14,35,27,10.3356786029577,12.102710132535,0.303703085430094,2020-02-03,2020,2
"7482","RS",4,"Sul",43030,"Campanha Central",180360,30812.5884989466,6,41,8,33,14,27,0,0,0,0,0,41,8,33,14,27,33,10.3356786029577,12.102710132535,0.298045892052874,2020-02-10,2020,2
"7483","RS",4,"Sul",43030,"Campanha Central",180360,30812.5884989466,7,35,10,25,20,15,0,0,0,0,0,35,10,25,20,15,14,10.3356786029577,12.102710132535,0.314256248091685,2020-02-17,2020,2
"7484","RS",4,"Sul",43030,"Campanha Central",180360,30812.5884989466,8,33,8,25,13,20,0,0,0,0,0,33,8,25,13,20,37,10.3356786029577,12.102710132535,0.344500865943244,2020-02-24,2020,2
"7485","RS",4,"Sul",43030,"Campanha Central",180360,30812.5884989466,9,49,21,28,16,33,2,2,0,1,1,51,23,28,17,34,30,10.3356786029577,12.102710132535,0.328280093621527,2020-03-02,2020,3
"7486","RS",4,"Sul",43030,"Campanha Central",180360,30812.5884989466,10,31,11,20,6,25,0,0,0,0,0,31,11,20,6,25,26,10.3356786029577,12.102710132535,0.33541281690686,2020-03-09,2020,3
"7487","RS",4,"Sul",43030,"Campanha Central",180360,30812.5884989466,11,28,5,23,5,23,2,0,2,1,1,30,5,25,6,24,31,10.3356786029577,12.102710132535,0.410510457287059,2020-03-16,2020,3
"7488","RS",4,"Sul",43030,"Campanha Central",180360,30812.5884989466,12,25,7,18,12,13,0,0,0,0,0,25,7,18,12,13,28,10.3356786029577,12.102710132535,0.538751365473736,2020-03-23,2020,3
"7489","RS",4,"Sul",43030,"Campanha Central",180360,30812.5884989466,13,36,12,24,17,19,0,0,0,0,0,36,12,24,17,19,37,10.3356786029577,12.102710132535,0.479311030976721,2020-03-30,2020,3
"7490","RS",4,"Sul",43030,"Campanha Central",180360,30812.5884989466,14,45,15,30,16,29,1,0,1,1,0,46,15,31,17,29,30,10.3356786029577,12.102710132535,0.455410636018897,2020-04-06,2020,4
"7491","RS",4,"Sul",43030,"Campanha Central",180360,30812.5884989466,15,40,10,30,13,27,0,0,0,0,0,40,10,30,13,27,26,10.3356786029577,12.102710132535,0.42863093107507,2020-04-13,2020,4
"7492","RS",4,"Sul",43030,"Campanha Central",180360,30812.5884989466,16,46,11,35,17,29,0,0,0,0,0,46,11,35,17,29,28,10.3356786029577,12.102710132535,0.417738715311089,2020-04-20,2020,4
"7493","RS",4,"Sul",43030,"Campanha Central",180360,30812.5884989466,17,48,19,29,13,35,2,0,2,2,0,50,19,31,15,35,25,10.3356786029577,12.102710132535,0.405947964253645,2020-04-27,2020,4
"7494","RS",4,"Sul",43030,"Campanha Central",180360,30812.5884989466,18,40,11,29,11,29,1,0,1,0,1,41,11,30,11,30,39,10.3356786029577,12.102710132535,0.377221349762195,2020-05-04,2020,5
"7495","RS",4,"Sul",43030,"Campanha Central",180360,30812.5884989466,19,53,15,38,22,31,0,0,0,0,0,53,15,38,22,31,29,10.3356786029577,12.102710132535,0.400056674704267,2020-05-11,2020,5
"7496","RS",4,"Sul",43030,"Campanha Central",180360,30812.5884989466,20,53,20,33,17,36,1,0,1,1,0,54,20,34,18,36,34,10.3356786029577,12.102710132535,0.407971459866464,2020-05-18,2020,5
"7497","RS",4,"Sul",43030,"Campanha Central",180360,30812.5884989466,21,50,14,36,23,27,3,3,0,2,1,53,17,36,25,28,35,10.3356786029577,12.102710132535,0.389412784710648,2020-05-25,2020,5
"7498","RS",4,"Sul",43031,"Campanha Meridional",178896,28015.484963163,5,50,12,38,19,31,0,0,0,0,0,50,12,38,19,31,28,10.2405126706889,12.0945599103871,0.297420003075547,2020-02-03,2020,2
"7499","RS",4,"Sul",43031,"Campanha Meridional",178896,28015.484963163,6,35,9,26,16,19,1,1,0,0,1,36,10,26,16,20,33,10.2405126706889,12.0945599103871,0.295384226734028,2020-02-10,2020,2
"7500","RS",4,"Sul",43031,"Campanha Meridional",178896,28015.484963163,7,38,11,27,13,25,1,0,1,0,1,39,11,28,13,26,26,10.2405126706889,12.0945599103871,0.30570389276683,2020-02-17,2020,2
"7501","RS",4,"Sul",43031,"Campanha Meridional",178896,28015.484963163,8,29,8,21,11,18,1,0,1,0,1,30,8,22,11,19,33,10.2405126706889,12.0945599103871,0.337209685480475,2020-02-24,2020,2
"7502","RS",4,"Sul",43031,"Campanha Meridional",178896,28015.484963163,9,47,11,36,22,25,0,0,0,0,0,47,11,36,22,25,19,10.2405126706889,12.0945599103871,0.305833267416205,2020-03-02,2020,3
"7503","RS",4,"Sul",43031,"Campanha Meridional",178896,28015.484963163,10,32,8,24,14,18,0,0,0,0,0,32,8,24,14,18,29,10.2405126706889,12.0945599103871,0.324182961670749,2020-03-09,2020,3
"7504","RS",4,"Sul",43031,"Campanha Meridional",178896,28015.484963163,11,39,8,31,19,20,0,0,0,0,0,39,8,31,19,20,30,10.2405126706889,12.0945599103871,0.431564389938064,2020-03-16,2020,3
"7505","RS",4,"Sul",43031,"Campanha Meridional",178896,28015.484963163,12,36,14,22,11,25,0,0,0,0,0,36,14,22,11,25,26,10.2405126706889,12.0945599103871,0.566618626338208,2020-03-23,2020,3
"7506","RS",4,"Sul",43031,"Campanha Meridional",178896,28015.484963163,13,52,18,34,22,30,0,0,0,0,0,52,18,34,22,30,23,10.2405126706889,12.0945599103871,0.509337396675446,2020-03-30,2020,3
"7507","RS",4,"Sul",43031,"Campanha Meridional",178896,28015.484963163,14,36,10,26,12,24,1,0,1,0,1,37,10,27,12,25,31,10.2405126706889,12.0945599103871,0.474227820989914,2020-04-06,2020,4
"7508","RS",4,"Sul",43031,"Campanha Meridional",178896,28015.484963163,15,40,15,25,14,26,0,0,0,0,0,40,15,25,14,26,28,10.2405126706889,12.0945599103871,0.435600450035333,2020-04-13,2020,4
"7509","RS",4,"Sul",43031,"Campanha Meridional",178896,28015.484963163,16,47,10,37,16,31,0,0,0,0,0,47,10,37,16,31,26,10.2405126706889,12.0945599103871,0.431530195489587,2020-04-20,2020,4
"7510","RS",4,"Sul",43031,"Campanha Meridional",178896,28015.484963163,17,29,11,18,14,15,0,0,0,0,0,29,11,18,14,15,33,10.2405126706889,12.0945599103871,0.419861925611793,2020-04-27,2020,4
"7511","RS",4,"Sul",43031,"Campanha Meridional",178896,28015.484963163,18,44,13,31,19,25,0,0,0,0,0,44,13,31,19,25,30,10.2405126706889,12.0945599103871,0.385830141474096,2020-05-04,2020,5
"7512","RS",4,"Sul",43031,"Campanha Meridional",178896,28015.484963163,19,35,8,27,13,22,0,0,0,0,0,35,8,27,13,22,28,10.2405126706889,12.0945599103871,0.404227698234446,2020-05-11,2020,5
"7513","RS",4,"Sul",43031,"Campanha Meridional",178896,28015.484963163,20,44,7,37,16,28,0,0,0,0,0,44,7,37,16,28,34,10.2405126706889,12.0945599103871,0.411408408239632,2020-05-18,2020,5
"7514","RS",4,"Sul",43031,"Campanha Meridional",178896,28015.484963163,21,48,15,33,16,32,1,0,1,1,0,49,15,34,17,32,28,10.2405126706889,12.0945599103871,0.38087354670816,2020-05-25,2020,5
"7515","RS",4,"Sul",43032,"Serras de Sudeste",119160,25898.5598547331,5,22,9,13,6,16,1,0,1,0,1,23,9,14,6,17,22,10.1619426420773,11.6882224068272,0.307192392661663,2020-02-03,2020,2
"7516","RS",4,"Sul",43032,"Serras de Sudeste",119160,25898.5598547331,6,19,6,13,11,8,0,0,0,0,0,19,6,13,11,8,17,10.1619426420773,11.6882224068272,0.298660576434405,2020-02-10,2020,2
"7517","RS",4,"Sul",43032,"Serras de Sudeste",119160,25898.5598547331,7,28,11,17,8,20,0,0,0,0,0,28,11,17,8,20,17,10.1619426420773,11.6882224068272,0.302073766056697,2020-02-17,2020,2
"7518","RS",4,"Sul",43032,"Serras de Sudeste",119160,25898.5598547331,8,19,7,12,10,9,0,0,0,0,0,19,7,12,10,9,9,10.1619426420773,11.6882224068272,0.338496118448059,2020-02-24,2020,2
"7519","RS",4,"Sul",43032,"Serras de Sudeste",119160,25898.5598547331,9,15,5,10,6,9,0,0,0,0,0,15,5,10,6,9,13,10.1619426420773,11.6882224068272,0.315078342844145,2020-03-02,2020,3
"7520","RS",4,"Sul",43032,"Serras de Sudeste",119160,25898.5598547331,10,19,5,14,3,16,0,0,0,0,0,19,5,14,3,16,22,10.1619426420773,11.6882224068272,0.326898641870286,2020-03-09,2020,3
"7521","RS",4,"Sul",43032,"Serras de Sudeste",119160,25898.5598547331,11,16,5,11,6,10,0,0,0,0,0,16,5,11,6,10,27,10.1619426420773,11.6882224068272,0.402414566962198,2020-03-16,2020,3
"7522","RS",4,"Sul",43032,"Serras de Sudeste",119160,25898.5598547331,12,11,6,5,4,7,1,0,1,0,1,12,6,6,4,8,17,10.1619426420773,11.6882224068272,0.515316375786434,2020-03-23,2020,3
"7523","RS",4,"Sul",43032,"Serras de Sudeste",119160,25898.5598547331,13,21,8,13,8,13,0,0,0,0,0,21,8,13,8,13,26,10.1619426420773,11.6882224068272,0.469439603131935,2020-03-30,2020,3
"7524","RS",4,"Sul",43032,"Serras de Sudeste",119160,25898.5598547331,14,22,6,16,5,17,1,0,1,1,0,23,6,17,6,17,16,10.1619426420773,11.6882224068272,0.453615998572265,2020-04-06,2020,4
"7525","RS",4,"Sul",43032,"Serras de Sudeste",119160,25898.5598547331,15,23,9,14,8,15,0,0,0,0,0,23,9,14,8,15,17,10.1619426420773,11.6882224068272,0.426135292670597,2020-04-13,2020,4
"7526","RS",4,"Sul",43032,"Serras de Sudeste",119160,25898.5598547331,16,19,5,14,8,11,1,1,0,1,0,20,6,14,9,11,17,10.1619426420773,11.6882224068272,0.420418096098765,2020-04-20,2020,4
"7527","RS",4,"Sul",43032,"Serras de Sudeste",119160,25898.5598547331,17,17,3,14,8,9,0,0,0,0,0,17,3,14,8,9,25,10.1619426420773,11.6882224068272,0.407579337307815,2020-04-27,2020,4
"7528","RS",4,"Sul",43032,"Serras de Sudeste",119160,25898.5598547331,18,22,11,11,8,14,0,0,0,0,0,22,11,11,8,14,10,10.1619426420773,11.6882224068272,0.391181048507952,2020-05-04,2020,5
"7529","RS",4,"Sul",43032,"Serras de Sudeste",119160,25898.5598547331,19,16,5,11,9,7,0,0,0,0,0,16,5,11,9,7,21,10.1619426420773,11.6882224068272,0.412385604273498,2020-05-11,2020,5
"7530","RS",4,"Sul",43032,"Serras de Sudeste",119160,25898.5598547331,20,22,9,13,12,10,0,0,0,0,0,22,9,13,12,10,19,10.1619426420773,11.6882224068272,0.415330061220549,2020-05-18,2020,5
"7531","RS",4,"Sul",43032,"Serras de Sudeste",119160,25898.5598547331,21,20,6,14,7,13,0,0,0,0,0,20,6,14,7,13,19,10.1619426420773,11.6882224068272,0.385959801680513,2020-05-25,2020,5
"7532","RS",4,"Sul",43033,"Pelotas",503075,24312.8151073299,5,96,33,63,27,69,0,0,0,0,0,96,33,63,27,69,83,10.0987588609896,13.1284945433346,0.300902917681113,2020-02-03,2020,2
"7533","RS",4,"Sul",43033,"Pelotas",503075,24312.8151073299,6,88,22,66,25,63,0,0,0,0,0,88,22,66,25,63,69,10.0987588609896,13.1284945433346,0.304339766881018,2020-02-10,2020,2
"7534","RS",4,"Sul",43033,"Pelotas",503075,24312.8151073299,7,105,29,76,35,70,0,0,0,0,0,105,29,76,35,70,69,10.0987588609896,13.1284945433346,0.315082089150161,2020-02-17,2020,2
"7535","RS",4,"Sul",43033,"Pelotas",503075,24312.8151073299,8,77,26,51,25,52,0,0,0,0,0,77,26,51,25,52,64,10.0987588609896,13.1284945433346,0.352261876770831,2020-02-24,2020,2
"7536","RS",4,"Sul",43033,"Pelotas",503075,24312.8151073299,9,94,37,57,26,68,0,0,0,0,0,94,37,57,26,68,76,10.0987588609896,13.1284945433346,0.327450639000193,2020-03-02,2020,3
"7537","RS",4,"Sul",43033,"Pelotas",503075,24312.8151073299,10,99,37,62,31,68,1,1,0,0,1,100,38,62,31,69,74,10.0987588609896,13.1284945433346,0.330689222916467,2020-03-09,2020,3
"7538","RS",4,"Sul",43033,"Pelotas",503075,24312.8151073299,11,89,31,58,24,65,0,0,0,0,0,89,31,58,24,65,84,10.0987588609896,13.1284945433346,0.460938263851271,2020-03-16,2020,3
"7539","RS",4,"Sul",43033,"Pelotas",503075,24312.8151073299,12,78,29,49,27,51,1,0,1,0,1,79,29,50,27,52,69,10.0987588609896,13.1284945433346,0.600499671299126,2020-03-23,2020,3
"7540","RS",4,"Sul",43033,"Pelotas",503075,24312.8151073299,13,95,42,53,35,60,0,0,0,0,0,95,42,53,35,60,72,10.0987588609896,13.1284945433346,0.548969237933663,2020-03-30,2020,3
"7541","RS",4,"Sul",43033,"Pelotas",503075,24312.8151073299,14,93,36,57,37,56,0,0,0,0,0,93,36,57,37,56,75,10.0987588609896,13.1284945433346,0.527741098676101,2020-04-06,2020,4
"7542","RS",4,"Sul",43033,"Pelotas",503075,24312.8151073299,15,89,28,61,21,68,1,1,0,0,1,90,29,61,21,69,80,10.0987588609896,13.1284945433346,0.498506716684113,2020-04-13,2020,4
"7543","RS",4,"Sul",43033,"Pelotas",503075,24312.8151073299,16,102,28,74,25,77,0,0,0,0,0,102,28,74,25,77,82,10.0987588609896,13.1284945433346,0.495171417020271,2020-04-20,2020,4
"7544","RS",4,"Sul",43033,"Pelotas",503075,24312.8151073299,17,89,26,63,31,58,0,0,0,0,0,89,26,63,31,58,61,10.0987588609896,13.1284945433346,0.478702833962686,2020-04-27,2020,4
"7545","RS",4,"Sul",43033,"Pelotas",503075,24312.8151073299,18,93,31,62,33,60,1,0,1,1,0,94,31,63,34,60,71,10.0987588609896,13.1284945433346,0.436335329864387,2020-05-04,2020,5
"7546","RS",4,"Sul",43033,"Pelotas",503075,24312.8151073299,19,94,30,64,34,60,0,0,0,0,0,94,30,64,34,60,96,10.0987588609896,13.1284945433346,0.45898987026721,2020-05-11,2020,5
"7547","RS",4,"Sul",43033,"Pelotas",503075,24312.8151073299,20,120,48,72,38,82,0,0,0,0,0,120,48,72,38,82,97,10.0987588609896,13.1284945433346,0.468285156302662,2020-05-18,2020,5
"7548","RS",4,"Sul",43033,"Pelotas",503075,24312.8151073299,21,129,41,88,47,82,1,0,1,0,1,130,41,89,47,83,88,10.0987588609896,13.1284945433346,0.438738374905958,2020-05-25,2020,5
"7549","RS",4,"Sul",43034,"Jaguarão",51552,25898.3695332868,5,12,4,8,6,6,0,0,0,0,0,12,4,8,6,6,8,10.1619352933233,10.8503462859767,0.303946568416123,2020-02-03,2020,2
"7550","RS",4,"Sul",43034,"Jaguarão",51552,25898.3695332868,6,9,3,6,2,7,0,0,0,0,0,9,3,6,2,7,4,10.1619352933233,10.8503462859767,0.320577281162097,2020-02-10,2020,2
"7551","RS",4,"Sul",43034,"Jaguarão",51552,25898.3695332868,7,7,0,7,4,3,0,0,0,0,0,7,0,7,4,3,9,10.1619352933233,10.8503462859767,0.307006159178622,2020-02-17,2020,2
"7552","RS",4,"Sul",43034,"Jaguarão",51552,25898.3695332868,8,6,1,5,2,4,0,0,0,0,0,6,1,5,2,4,7,10.1619352933233,10.8503462859767,0.336559553467758,2020-02-24,2020,2
"7553","RS",4,"Sul",43034,"Jaguarão",51552,25898.3695332868,9,8,2,6,3,5,0,0,0,0,0,8,2,6,3,5,10,10.1619352933233,10.8503462859767,0.363837720126104,2020-03-02,2020,3
"7554","RS",4,"Sul",43034,"Jaguarão",51552,25898.3695332868,10,9,2,7,5,4,0,0,0,0,0,9,2,7,5,4,10,10.1619352933233,10.8503462859767,0.360805113432947,2020-03-09,2020,3
"7555","RS",4,"Sul",43034,"Jaguarão",51552,25898.3695332868,11,12,6,6,3,9,0,0,0,0,0,12,6,6,3,9,6,10.1619352933233,10.8503462859767,0.437514845952377,2020-03-16,2020,3
"7556","RS",4,"Sul",43034,"Jaguarão",51552,25898.3695332868,12,6,1,5,4,2,0,0,0,0,0,6,1,5,4,2,13,10.1619352933233,10.8503462859767,0.521161922315175,2020-03-23,2020,3
"7557","RS",4,"Sul",43034,"Jaguarão",51552,25898.3695332868,13,12,4,8,3,9,1,0,1,0,1,13,4,9,3,10,6,10.1619352933233,10.8503462859767,0.489643888156325,2020-03-30,2020,3
"7558","RS",4,"Sul",43034,"Jaguarão",51552,25898.3695332868,14,8,6,2,5,3,0,0,0,0,0,8,6,2,5,3,5,10.1619352933233,10.8503462859767,0.478583889584695,2020-04-06,2020,4
"7559","RS",4,"Sul",43034,"Jaguarão",51552,25898.3695332868,15,12,5,7,2,10,0,0,0,0,0,12,5,7,2,10,11,10.1619352933233,10.8503462859767,0.460755589320388,2020-04-13,2020,4
"7560","RS",4,"Sul",43034,"Jaguarão",51552,25898.3695332868,16,6,0,6,3,3,0,0,0,0,0,6,0,6,3,3,14,10.1619352933233,10.8503462859767,0.459658017337795,2020-04-20,2020,4
"7561","RS",4,"Sul",43034,"Jaguarão",51552,25898.3695332868,17,14,4,10,9,5,0,0,0,0,0,14,4,10,9,5,6,10.1619352933233,10.8503462859767,0.457916115778002,2020-04-27,2020,4
"7562","RS",4,"Sul",43034,"Jaguarão",51552,25898.3695332868,18,12,4,8,5,7,0,0,0,0,0,12,4,8,5,7,8,10.1619352933233,10.8503462859767,0.422258612400855,2020-05-04,2020,5
"7563","RS",4,"Sul",43034,"Jaguarão",51552,25898.3695332868,19,12,1,11,4,8,0,0,0,0,0,12,1,11,4,8,7,10.1619352933233,10.8503462859767,0.441227602003617,2020-05-11,2020,5
"7564","RS",4,"Sul",43034,"Jaguarão",51552,25898.3695332868,20,7,3,4,4,3,0,0,0,0,0,7,3,4,4,3,7,10.1619352933233,10.8503462859767,0.46941948910945,2020-05-18,2020,5
"7565","RS",4,"Sul",43034,"Jaguarão",51552,25898.3695332868,21,11,4,7,2,9,0,0,0,0,0,11,4,7,2,9,12,10.1619352933233,10.8503462859767,0.407189495975461,2020-05-25,2020,5
"7566","RS",4,"Sul",43035,"Litoral Lagunar",275939,48889.2418186266,5,47,8,39,17,30,1,1,0,1,0,48,9,39,18,30,67,10.7973126475495,12.5279351057792,0.313051335584704,2020-02-03,2020,2
"7567","RS",4,"Sul",43035,"Litoral Lagunar",275939,48889.2418186266,6,62,22,40,21,41,1,1,0,1,0,63,23,40,22,41,41,10.7973126475495,12.5279351057792,0.325185614252717,2020-02-10,2020,2
"7568","RS",4,"Sul",43035,"Litoral Lagunar",275939,48889.2418186266,7,57,18,39,22,35,0,0,0,0,0,57,18,39,22,35,56,10.7973126475495,12.5279351057792,0.330413084352383,2020-02-17,2020,2
"7569","RS",4,"Sul",43035,"Litoral Lagunar",275939,48889.2418186266,8,55,17,38,16,39,0,0,0,0,0,55,17,38,16,39,40,10.7973126475495,12.5279351057792,0.358204861678248,2020-02-24,2020,2
"7570","RS",4,"Sul",43035,"Litoral Lagunar",275939,48889.2418186266,9,52,16,36,20,32,1,1,0,1,0,53,17,36,21,32,52,10.7973126475495,12.5279351057792,0.345962728831474,2020-03-02,2020,3
"7571","RS",4,"Sul",43035,"Litoral Lagunar",275939,48889.2418186266,10,48,19,29,19,29,2,1,1,0,2,50,20,30,19,31,50,10.7973126475495,12.5279351057792,0.346798328463286,2020-03-09,2020,3
"7572","RS",4,"Sul",43035,"Litoral Lagunar",275939,48889.2418186266,11,40,12,28,15,25,0,0,0,0,0,40,12,28,15,25,30,10.7973126475495,12.5279351057792,0.473837116247888,2020-03-16,2020,3
"7573","RS",4,"Sul",43035,"Litoral Lagunar",275939,48889.2418186266,12,45,15,30,19,26,0,0,0,0,0,45,15,30,19,26,33,10.7973126475495,12.5279351057792,0.588818544676911,2020-03-23,2020,3
"7574","RS",4,"Sul",43035,"Litoral Lagunar",275939,48889.2418186266,13,63,23,40,21,42,0,0,0,0,0,63,23,40,21,42,37,10.7973126475495,12.5279351057792,0.550098335810709,2020-03-30,2020,3
"7575","RS",4,"Sul",43035,"Litoral Lagunar",275939,48889.2418186266,14,56,17,39,27,29,0,0,0,0,0,56,17,39,27,29,44,10.7973126475495,12.5279351057792,0.521403096719247,2020-04-06,2020,4
"7576","RS",4,"Sul",43035,"Litoral Lagunar",275939,48889.2418186266,15,46,17,29,18,28,0,0,0,0,0,46,17,29,18,28,30,10.7973126475495,12.5279351057792,0.512552807182466,2020-04-13,2020,4
"7577","RS",4,"Sul",43035,"Litoral Lagunar",275939,48889.2418186266,16,65,20,45,30,35,1,1,0,0,1,66,21,45,30,36,41,10.7973126475495,12.5279351057792,0.504219586856306,2020-04-20,2020,4
"7578","RS",4,"Sul",43035,"Litoral Lagunar",275939,48889.2418186266,17,72,26,46,29,43,1,0,1,0,1,73,26,47,29,44,46,10.7973126475495,12.5279351057792,0.497479332874784,2020-04-27,2020,4
"7579","RS",4,"Sul",43035,"Litoral Lagunar",275939,48889.2418186266,18,60,24,36,26,34,0,0,0,0,0,60,24,36,26,34,47,10.7973126475495,12.5279351057792,0.453242367783959,2020-05-04,2020,5
"7580","RS",4,"Sul",43035,"Litoral Lagunar",275939,48889.2418186266,19,69,23,46,26,43,1,1,0,0,1,70,24,46,26,44,41,10.7973126475495,12.5279351057792,0.469810274588646,2020-05-11,2020,5
"7581","RS",4,"Sul",43035,"Litoral Lagunar",275939,48889.2418186266,20,73,23,50,26,47,0,0,0,0,0,73,23,50,26,47,46,10.7973126475495,12.5279351057792,0.484351084838209,2020-05-18,2020,5
"7582","RS",4,"Sul",43035,"Litoral Lagunar",275939,48889.2418186266,21,61,18,43,25,36,0,0,0,0,0,61,18,43,25,36,37,10.7973126475495,12.5279351057792,0.455659454121289,2020-05-25,2020,5
"7583","SC",4,"Sul",42001,"São Miguel do Oeste",180176,33629.5928476046,5,43,14,29,9,34,0,0,0,0,0,43,14,29,9,34,22,10.4231616978399,12.1016894299368,0.32938664326036,2020-02-03,2020,2
"7584","SC",4,"Sul",42001,"São Miguel do Oeste",180176,33629.5928476046,6,41,7,34,8,33,1,0,1,0,1,42,7,35,8,34,12,10.4231616978399,12.1016894299368,0.310325086755492,2020-02-10,2020,2
"7585","SC",4,"Sul",42001,"São Miguel do Oeste",180176,33629.5928476046,7,34,9,25,8,26,0,0,0,0,0,34,9,25,8,26,21,10.4231616978399,12.1016894299368,0.328531681978911,2020-02-17,2020,2
"7586","SC",4,"Sul",42001,"São Miguel do Oeste",180176,33629.5928476046,8,36,5,31,10,26,0,0,0,0,0,36,5,31,10,26,20,10.4231616978399,12.1016894299368,0.348324958551759,2020-02-24,2020,2
"7587","SC",4,"Sul",42001,"São Miguel do Oeste",180176,33629.5928476046,9,42,7,35,13,29,0,0,0,0,0,42,7,35,13,29,23,10.4231616978399,12.1016894299368,0.329504908645073,2020-03-02,2020,3
"7588","SC",4,"Sul",42001,"São Miguel do Oeste",180176,33629.5928476046,10,42,4,38,10,32,3,0,3,0,3,45,4,41,10,35,30,10.4231616978399,12.1016894299368,0.340375841678549,2020-03-09,2020,3
"7589","SC",4,"Sul",42001,"São Miguel do Oeste",180176,33629.5928476046,11,33,5,28,8,25,0,0,0,0,0,33,5,28,8,25,26,10.4231616978399,12.1016894299368,0.470860463205056,2020-03-16,2020,3
"7590","SC",4,"Sul",42001,"São Miguel do Oeste",180176,33629.5928476046,12,34,8,26,8,26,0,0,0,0,0,34,8,26,8,26,17,10.4231616978399,12.1016894299368,0.575669435810007,2020-03-23,2020,3
"7591","SC",4,"Sul",42001,"São Miguel do Oeste",180176,33629.5928476046,13,45,8,37,13,32,1,0,1,0,1,46,8,38,13,33,18,10.4231616978399,12.1016894299368,0.495676220561398,2020-03-30,2020,3
"7592","SC",4,"Sul",42001,"São Miguel do Oeste",180176,33629.5928476046,14,51,13,38,15,36,1,1,0,1,0,52,14,38,16,36,16,10.4231616978399,12.1016894299368,0.45347129198973,2020-04-06,2020,4
"7593","SC",4,"Sul",42001,"São Miguel do Oeste",180176,33629.5928476046,15,46,8,38,12,34,0,0,0,0,0,46,8,38,12,34,21,10.4231616978399,12.1016894299368,0.403986969725382,2020-04-13,2020,4
"7594","SC",4,"Sul",42001,"São Miguel do Oeste",180176,33629.5928476046,16,47,13,34,16,31,1,1,0,0,1,48,14,34,16,32,22,10.4231616978399,12.1016894299368,0.423865871688809,2020-04-20,2020,4
"7595","SC",4,"Sul",42001,"São Miguel do Oeste",180176,33629.5928476046,17,39,7,32,10,29,1,0,1,1,0,40,7,33,11,29,23,10.4231616978399,12.1016894299368,0.413843045692854,2020-04-27,2020,4
"7596","SC",4,"Sul",42001,"São Miguel do Oeste",180176,33629.5928476046,18,45,7,38,14,31,0,0,0,0,0,45,7,38,14,31,21,10.4231616978399,12.1016894299368,0.401869048398249,2020-05-04,2020,5
"7597","SC",4,"Sul",42001,"São Miguel do Oeste",180176,33629.5928476046,19,45,12,33,17,28,0,0,0,0,0,45,12,33,17,28,19,10.4231616978399,12.1016894299368,0.399379925191657,2020-05-11,2020,5
"7598","SC",4,"Sul",42001,"São Miguel do Oeste",180176,33629.5928476046,20,40,11,29,16,24,0,0,0,0,0,40,11,29,16,24,20,10.4231616978399,12.1016894299368,0.426009144836748,2020-05-18,2020,5
"7599","SC",4,"Sul",42001,"São Miguel do Oeste",180176,33629.5928476046,21,50,11,39,18,32,1,1,0,0,1,51,12,39,18,33,22,10.4231616978399,12.1016894299368,0.403546357314081,2020-05-25,2020,5
"7600","SC",4,"Sul",42002,"Chapecó",455210,40992.4545583138,5,139,31,108,41,98,2,0,2,1,1,141,31,110,42,99,41,10.6211432935868,13.0285141299185,0.304251316839002,2020-02-03,2020,2
"7601","SC",4,"Sul",42002,"Chapecó",455210,40992.4545583138,6,107,26,81,34,73,6,1,5,3,3,113,27,86,37,76,38,10.6211432935868,13.0285141299185,0.3025414142963,2020-02-10,2020,2
"7602","SC",4,"Sul",42002,"Chapecó",455210,40992.4545583138,7,117,35,82,41,76,2,2,0,0,2,119,37,82,41,78,33,10.6211432935868,13.0285141299185,0.304513692354751,2020-02-17,2020,2
"7603","SC",4,"Sul",42002,"Chapecó",455210,40992.4545583138,8,120,39,81,38,82,1,0,1,0,1,121,39,82,38,83,47,10.6211432935868,13.0285141299185,0.343879679921995,2020-02-24,2020,2
"7604","SC",4,"Sul",42002,"Chapecó",455210,40992.4545583138,9,139,34,105,49,90,2,1,1,1,1,141,35,106,50,91,50,10.6211432935868,13.0285141299185,0.322163876695114,2020-03-02,2020,3
"7605","SC",4,"Sul",42002,"Chapecó",455210,40992.4545583138,10,115,23,92,35,80,0,0,0,0,0,115,23,92,35,80,49,10.6211432935868,13.0285141299185,0.329697137960549,2020-03-09,2020,3
"7606","SC",4,"Sul",42002,"Chapecó",455210,40992.4545583138,11,117,25,92,31,86,1,0,1,0,1,118,25,93,31,87,57,10.6211432935868,13.0285141299185,0.479528711526571,2020-03-16,2020,3
"7607","SC",4,"Sul",42002,"Chapecó",455210,40992.4545583138,12,122,40,82,37,85,0,0,0,0,0,122,40,82,37,85,35,10.6211432935868,13.0285141299185,0.587358046693234,2020-03-23,2020,3
"7608","SC",4,"Sul",42002,"Chapecó",455210,40992.4545583138,13,106,22,84,34,72,2,2,0,1,1,108,24,84,35,73,38,10.6211432935868,13.0285141299185,0.498425414269274,2020-03-30,2020,3
"7609","SC",4,"Sul",42002,"Chapecó",455210,40992.4545583138,14,131,27,104,44,87,2,0,2,0,2,133,27,106,44,89,43,10.6211432935868,13.0285141299185,0.460047661321474,2020-04-06,2020,4
"7610","SC",4,"Sul",42002,"Chapecó",455210,40992.4545583138,15,112,22,90,30,82,0,0,0,0,0,112,22,90,30,82,35,10.6211432935868,13.0285141299185,0.417027222577406,2020-04-13,2020,4
"7611","SC",4,"Sul",42002,"Chapecó",455210,40992.4545583138,16,127,29,98,41,86,1,1,0,1,0,128,30,98,42,86,42,10.6211432935868,13.0285141299185,0.419286014132511,2020-04-20,2020,4
"7612","SC",4,"Sul",42002,"Chapecó",455210,40992.4545583138,17,135,39,96,45,90,3,0,3,2,1,138,39,99,47,91,44,10.6211432935868,13.0285141299185,0.431138858351912,2020-04-27,2020,4
"7613","SC",4,"Sul",42002,"Chapecó",455210,40992.4545583138,18,135,29,106,41,94,0,0,0,0,0,135,29,106,41,94,48,10.6211432935868,13.0285141299185,0.406607539660141,2020-05-04,2020,5
"7614","SC",4,"Sul",42002,"Chapecó",455210,40992.4545583138,19,125,26,99,34,91,1,1,0,1,0,126,27,99,35,91,47,10.6211432935868,13.0285141299185,0.415451923685165,2020-05-11,2020,5
"7615","SC",4,"Sul",42002,"Chapecó",455210,40992.4545583138,20,163,41,122,59,104,1,1,0,1,0,164,42,122,60,104,47,10.6211432935868,13.0285141299185,0.422450416406545,2020-05-18,2020,5
"7616","SC",4,"Sul",42002,"Chapecó",455210,40992.4545583138,21,145,32,113,46,99,1,0,1,0,1,146,32,114,46,100,50,10.6211432935868,13.0285141299185,0.404924543034801,2020-05-25,2020,5
"7617","SC",4,"Sul",42003,"Xanxerê",164649,32910.7426071826,5,44,7,37,14,30,0,0,0,0,0,44,7,37,14,30,21,10.4015544064711,12.0115712142968,0.302989303862025,2020-02-03,2020,2
"7618","SC",4,"Sul",42003,"Xanxerê",164649,32910.7426071826,6,50,23,27,24,26,0,0,0,0,0,50,23,27,24,26,28,10.4015544064711,12.0115712142968,0.29266047988809,2020-02-10,2020,2
"7619","SC",4,"Sul",42003,"Xanxerê",164649,32910.7426071826,7,45,11,34,19,26,0,0,0,0,0,45,11,34,19,26,17,10.4015544064711,12.0115712142968,0.307527746328807,2020-02-17,2020,2
"7620","SC",4,"Sul",42003,"Xanxerê",164649,32910.7426071826,8,36,9,27,17,19,0,0,0,0,0,36,9,27,17,19,18,10.4015544064711,12.0115712142968,0.337754812121097,2020-02-24,2020,2
"7621","SC",4,"Sul",42003,"Xanxerê",164649,32910.7426071826,9,45,8,37,18,27,1,1,0,0,1,46,9,37,18,28,29,10.4015544064711,12.0115712142968,0.314357757371494,2020-03-02,2020,3
"7622","SC",4,"Sul",42003,"Xanxerê",164649,32910.7426071826,10,54,17,37,18,36,0,0,0,0,0,54,17,37,18,36,12,10.4015544064711,12.0115712142968,0.327920750123363,2020-03-09,2020,3
"7623","SC",4,"Sul",42003,"Xanxerê",164649,32910.7426071826,11,37,11,26,15,22,0,0,0,0,0,37,11,26,15,22,14,10.4015544064711,12.0115712142968,0.461430184008617,2020-03-16,2020,3
"7624","SC",4,"Sul",42003,"Xanxerê",164649,32910.7426071826,12,47,12,35,18,29,1,1,0,0,1,48,13,35,18,30,17,10.4015544064711,12.0115712142968,0.523407312497203,2020-03-23,2020,3
"7625","SC",4,"Sul",42003,"Xanxerê",164649,32910.7426071826,13,53,14,39,18,35,1,1,0,0,1,54,15,39,18,36,17,10.4015544064711,12.0115712142968,0.44240903228678,2020-03-30,2020,3
"7626","SC",4,"Sul",42003,"Xanxerê",164649,32910.7426071826,14,32,7,25,11,21,1,0,1,0,1,33,7,26,11,22,20,10.4015544064711,12.0115712142968,0.42556774097319,2020-04-06,2020,4
"7627","SC",4,"Sul",42003,"Xanxerê",164649,32910.7426071826,15,49,10,39,20,29,0,0,0,0,0,49,10,39,20,29,11,10.4015544064711,12.0115712142968,0.388089243320925,2020-04-13,2020,4
"7628","SC",4,"Sul",42003,"Xanxerê",164649,32910.7426071826,16,46,12,34,7,39,1,0,1,0,1,47,12,35,7,40,22,10.4015544064711,12.0115712142968,0.405018450142806,2020-04-20,2020,4
"7629","SC",4,"Sul",42003,"Xanxerê",164649,32910.7426071826,17,52,17,35,19,33,1,1,0,1,0,53,18,35,20,33,17,10.4015544064711,12.0115712142968,0.405610451672729,2020-04-27,2020,4
"7630","SC",4,"Sul",42003,"Xanxerê",164649,32910.7426071826,18,44,9,35,13,31,2,1,1,0,2,46,10,36,13,33,18,10.4015544064711,12.0115712142968,0.386656405540957,2020-05-04,2020,5
"7631","SC",4,"Sul",42003,"Xanxerê",164649,32910.7426071826,19,53,11,42,16,37,0,0,0,0,0,53,11,42,16,37,15,10.4015544064711,12.0115712142968,0.393747773185513,2020-05-11,2020,5
"7632","SC",4,"Sul",42003,"Xanxerê",164649,32910.7426071826,20,39,14,25,11,28,1,1,0,1,0,40,15,25,12,28,19,10.4015544064711,12.0115712142968,0.401317476605392,2020-05-18,2020,5
"7633","SC",4,"Sul",42003,"Xanxerê",164649,32910.7426071826,21,57,25,32,19,38,0,0,0,0,0,57,25,32,19,38,22,10.4015544064711,12.0115712142968,0.39091238228523,2020-05-25,2020,5
"7634","SC",4,"Sul",42004,"Joaçaba",354332,40166.5713761105,5,95,28,67,34,61,0,0,0,0,0,95,28,67,34,61,45,10.6007903708629,12.7779896057138,0.306884030335341,2020-02-03,2020,2
"7635","SC",4,"Sul",42004,"Joaçaba",354332,40166.5713761105,6,78,17,61,32,46,2,0,2,2,0,80,17,63,34,46,49,10.6007903708629,12.7779896057138,0.309538317578464,2020-02-10,2020,2
"7636","SC",4,"Sul",42004,"Joaçaba",354332,40166.5713761105,7,92,25,67,32,60,1,0,1,1,0,93,25,68,33,60,48,10.6007903708629,12.7779896057138,0.3141567894735,2020-02-17,2020,2
"7637","SC",4,"Sul",42004,"Joaçaba",354332,40166.5713761105,8,60,11,49,19,41,0,0,0,0,0,60,11,49,19,41,41,10.6007903708629,12.7779896057138,0.352816013821771,2020-02-24,2020,2
"7638","SC",4,"Sul",42004,"Joaçaba",354332,40166.5713761105,9,81,26,55,30,51,0,0,0,0,0,81,26,55,30,51,54,10.6007903708629,12.7779896057138,0.331467788551726,2020-03-02,2020,3
"7639","SC",4,"Sul",42004,"Joaçaba",354332,40166.5713761105,10,84,15,69,28,56,0,0,0,0,0,84,15,69,28,56,33,10.6007903708629,12.7779896057138,0.338343621694479,2020-03-09,2020,3
"7640","SC",4,"Sul",42004,"Joaçaba",354332,40166.5713761105,11,81,19,62,38,43,0,0,0,0,0,81,19,62,38,43,43,10.6007903708629,12.7779896057138,0.476662605256342,2020-03-16,2020,3
"7641","SC",4,"Sul",42004,"Joaçaba",354332,40166.5713761105,12,83,15,68,30,53,1,1,0,0,1,84,16,68,30,54,39,10.6007903708629,12.7779896057138,0.559373389281968,2020-03-23,2020,3
"7642","SC",4,"Sul",42004,"Joaçaba",354332,40166.5713761105,13,69,20,49,28,41,0,0,0,0,0,69,20,49,28,41,43,10.6007903708629,12.7779896057138,0.480968084756079,2020-03-30,2020,3
"7643","SC",4,"Sul",42004,"Joaçaba",354332,40166.5713761105,14,91,30,61,31,60,1,1,0,1,0,92,31,61,32,60,35,10.6007903708629,12.7779896057138,0.46883320795094,2020-04-06,2020,4
"7644","SC",4,"Sul",42004,"Joaçaba",354332,40166.5713761105,15,89,19,70,26,63,0,0,0,0,0,89,19,70,26,63,41,10.6007903708629,12.7779896057138,0.422727549388959,2020-04-13,2020,4
"7645","SC",4,"Sul",42004,"Joaçaba",354332,40166.5713761105,16,106,32,74,47,59,1,0,1,1,0,107,32,75,48,59,35,10.6007903708629,12.7779896057138,0.426799714854216,2020-04-20,2020,4
"7646","SC",4,"Sul",42004,"Joaçaba",354332,40166.5713761105,17,67,17,50,28,39,0,0,0,0,0,67,17,50,28,39,30,10.6007903708629,12.7779896057138,0.434642583799021,2020-04-27,2020,4
"7647","SC",4,"Sul",42004,"Joaçaba",354332,40166.5713761105,18,90,26,64,41,49,0,0,0,0,0,90,26,64,41,49,48,10.6007903708629,12.7779896057138,0.401858462863513,2020-05-04,2020,5
"7648","SC",4,"Sul",42004,"Joaçaba",354332,40166.5713761105,19,71,16,55,29,42,0,0,0,0,0,71,16,55,29,42,35,10.6007903708629,12.7779896057138,0.411981277491105,2020-05-11,2020,5
"7649","SC",4,"Sul",42004,"Joaçaba",354332,40166.5713761105,20,83,30,53,31,52,1,1,0,1,0,84,31,53,32,52,28,10.6007903708629,12.7779896057138,0.407026753883455,2020-05-18,2020,5
"7650","SC",4,"Sul",42004,"Joaçaba",354332,40166.5713761105,21,77,17,60,37,40,0,0,0,0,0,77,17,60,37,40,45,10.6007903708629,12.7779896057138,0.394309915624189,2020-05-25,2020,5
"7651","SC",4,"Sul",42005,"Concórdia",147798,43860.6462586097,5,37,6,31,9,28,0,0,0,0,0,37,6,31,9,28,15,10.6887727564418,11.903601755605,0.318468818291215,2020-02-03,2020,2
"7652","SC",4,"Sul",42005,"Concórdia",147798,43860.6462586097,6,29,1,28,8,21,0,0,0,0,0,29,1,28,8,21,19,10.6887727564418,11.903601755605,0.31084094958534,2020-02-10,2020,2
"7653","SC",4,"Sul",42005,"Concórdia",147798,43860.6462586097,7,41,6,35,12,29,0,0,0,0,0,41,6,35,12,29,19,10.6887727564418,11.903601755605,0.317404994179774,2020-02-17,2020,2
"7654","SC",4,"Sul",42005,"Concórdia",147798,43860.6462586097,8,39,5,34,10,29,0,0,0,0,0,39,5,34,10,29,18,10.6887727564418,11.903601755605,0.33740072784176,2020-02-24,2020,2
"7655","SC",4,"Sul",42005,"Concórdia",147798,43860.6462586097,9,47,6,41,12,35,1,1,0,0,1,48,7,41,12,36,21,10.6887727564418,11.903601755605,0.333097925177702,2020-03-02,2020,3
"7656","SC",4,"Sul",42005,"Concórdia",147798,43860.6462586097,10,42,12,30,11,31,0,0,0,0,0,42,12,30,11,31,22,10.6887727564418,11.903601755605,0.341263026609922,2020-03-09,2020,3
"7657","SC",4,"Sul",42005,"Concórdia",147798,43860.6462586097,11,27,3,24,8,19,1,0,1,0,1,28,3,25,8,20,21,10.6887727564418,11.903601755605,0.478627338255549,2020-03-16,2020,3
"7658","SC",4,"Sul",42005,"Concórdia",147798,43860.6462586097,12,37,3,34,14,23,0,0,0,0,0,37,3,34,14,23,17,10.6887727564418,11.903601755605,0.546737830937886,2020-03-23,2020,3
"7659","SC",4,"Sul",42005,"Concórdia",147798,43860.6462586097,13,38,6,32,13,25,0,0,0,0,0,38,6,32,13,25,16,10.6887727564418,11.903601755605,0.480509466083315,2020-03-30,2020,3
"7660","SC",4,"Sul",42005,"Concórdia",147798,43860.6462586097,14,30,5,25,6,24,0,0,0,0,0,30,5,25,6,24,18,10.6887727564418,11.903601755605,0.452592432398083,2020-04-06,2020,4
"7661","SC",4,"Sul",42005,"Concórdia",147798,43860.6462586097,15,46,3,43,17,29,0,0,0,0,0,46,3,43,17,29,20,10.6887727564418,11.903601755605,0.422077262271553,2020-04-13,2020,4
"7662","SC",4,"Sul",42005,"Concórdia",147798,43860.6462586097,16,32,7,25,10,22,0,0,0,0,0,32,7,25,10,22,23,10.6887727564418,11.903601755605,0.438592657304502,2020-04-20,2020,4
"7663","SC",4,"Sul",42005,"Concórdia",147798,43860.6462586097,17,35,4,31,14,21,0,0,0,0,0,35,4,31,14,21,25,10.6887727564418,11.903601755605,0.453175966854761,2020-04-27,2020,4
"7664","SC",4,"Sul",42005,"Concórdia",147798,43860.6462586097,18,24,7,17,7,17,1,0,1,0,1,25,7,18,7,18,13,10.6887727564418,11.903601755605,0.421407008040189,2020-05-04,2020,5
"7665","SC",4,"Sul",42005,"Concórdia",147798,43860.6462586097,19,43,11,32,9,34,0,0,0,0,0,43,11,32,9,34,18,10.6887727564418,11.903601755605,0.424063078198405,2020-05-11,2020,5
"7666","SC",4,"Sul",42005,"Concórdia",147798,43860.6462586097,20,36,7,29,11,25,1,1,0,0,1,37,8,29,11,26,23,10.6887727564418,11.903601755605,0.426344950502088,2020-05-18,2020,5
"7667","SC",4,"Sul",42005,"Concórdia",147798,43860.6462586097,21,34,2,32,8,26,0,0,0,0,0,34,2,32,8,26,20,10.6887727564418,11.903601755605,0.404173708664189,2020-05-25,2020,5
"7668","SC",4,"Sul",42006,"Canoinhas",257942,31824.4620422421,5,64,17,47,18,46,0,0,0,0,0,64,17,47,18,46,26,10.3679905196611,12.4604900324295,0.30555511740549,2020-02-03,2020,2
"7669","SC",4,"Sul",42006,"Canoinhas",257942,31824.4620422421,6,57,16,41,20,37,0,0,0,0,0,57,16,41,20,37,31,10.3679905196611,12.4604900324295,0.298083067382667,2020-02-10,2020,2
"7670","SC",4,"Sul",42006,"Canoinhas",257942,31824.4620422421,7,53,10,43,25,28,1,0,1,0,1,54,10,44,25,29,28,10.3679905196611,12.4604900324295,0.311051415424985,2020-02-17,2020,2
"7671","SC",4,"Sul",42006,"Canoinhas",257942,31824.4620422421,8,72,21,51,31,41,1,0,1,1,0,73,21,52,32,41,40,10.3679905196611,12.4604900324295,0.343469240200705,2020-02-24,2020,2
"7672","SC",4,"Sul",42006,"Canoinhas",257942,31824.4620422421,9,68,16,52,18,50,1,1,0,1,0,69,17,52,19,50,29,10.3679905196611,12.4604900324295,0.324056231046989,2020-03-02,2020,3
"7673","SC",4,"Sul",42006,"Canoinhas",257942,31824.4620422421,10,53,24,29,22,31,0,0,0,0,0,53,24,29,22,31,33,10.3679905196611,12.4604900324295,0.336782960085147,2020-03-09,2020,3
"7674","SC",4,"Sul",42006,"Canoinhas",257942,31824.4620422421,11,59,17,42,27,32,1,0,1,0,1,60,17,43,27,33,33,10.3679905196611,12.4604900324295,0.463429609954511,2020-03-16,2020,3
"7675","SC",4,"Sul",42006,"Canoinhas",257942,31824.4620422421,12,51,16,35,16,35,2,1,1,1,1,53,17,36,17,36,34,10.3679905196611,12.4604900324295,0.570753068279264,2020-03-23,2020,3
"7676","SC",4,"Sul",42006,"Canoinhas",257942,31824.4620422421,13,40,14,26,17,23,1,0,1,0,1,41,14,27,17,24,33,10.3679905196611,12.4604900324295,0.498290366609501,2020-03-30,2020,3
"7677","SC",4,"Sul",42006,"Canoinhas",257942,31824.4620422421,14,48,11,37,13,35,0,0,0,0,0,48,11,37,13,35,31,10.3679905196611,12.4604900324295,0.458609408346195,2020-04-06,2020,4
"7678","SC",4,"Sul",42006,"Canoinhas",257942,31824.4620422421,15,66,23,43,25,41,0,0,0,0,0,66,23,43,25,41,34,10.3679905196611,12.4604900324295,0.431961380199803,2020-04-13,2020,4
"7679","SC",4,"Sul",42006,"Canoinhas",257942,31824.4620422421,16,73,20,53,39,34,0,0,0,0,0,73,20,53,39,34,25,10.3679905196611,12.4604900324295,0.426158987282642,2020-04-20,2020,4
"7680","SC",4,"Sul",42006,"Canoinhas",257942,31824.4620422421,17,53,12,41,21,32,1,0,1,0,1,54,12,42,21,33,41,10.3679905196611,12.4604900324295,0.423040277579371,2020-04-27,2020,4
"7681","SC",4,"Sul",42006,"Canoinhas",257942,31824.4620422421,18,54,16,38,29,25,0,0,0,0,0,54,16,38,29,25,30,10.3679905196611,12.4604900324295,0.393183099630788,2020-05-04,2020,5
"7682","SC",4,"Sul",42006,"Canoinhas",257942,31824.4620422421,19,64,20,44,25,39,0,0,0,0,0,64,20,44,25,39,34,10.3679905196611,12.4604900324295,0.402408882317214,2020-05-11,2020,5
"7683","SC",4,"Sul",42006,"Canoinhas",257942,31824.4620422421,20,63,14,49,29,34,2,0,2,1,1,65,14,51,30,35,38,10.3679905196611,12.4604900324295,0.413830221169281,2020-05-18,2020,5
"7684","SC",4,"Sul",42006,"Canoinhas",257942,31824.4620422421,21,79,23,56,29,50,0,0,0,0,0,79,23,56,29,50,34,10.3679905196611,12.4604900324295,0.402590671431062,2020-05-25,2020,5
"7685","SC",4,"Sul",42007,"São Bento do Sul",139897,35231.5336486844,5,32,13,19,8,24,1,0,1,1,0,33,13,20,9,24,15,10.4696968028511,11.8486617165352,0.303401337886455,2020-02-03,2020,2
"7686","SC",4,"Sul",42007,"São Bento do Sul",139897,35231.5336486844,6,26,6,20,7,19,0,0,0,0,0,26,6,20,7,19,20,10.4696968028511,11.8486617165352,0.294255576294387,2020-02-10,2020,2
"7687","SC",4,"Sul",42007,"São Bento do Sul",139897,35231.5336486844,7,26,9,17,9,17,0,0,0,0,0,26,9,17,9,17,17,10.4696968028511,11.8486617165352,0.30656785793999,2020-02-17,2020,2
"7688","SC",4,"Sul",42007,"São Bento do Sul",139897,35231.5336486844,8,33,9,24,5,28,1,0,1,0,1,34,9,25,5,29,9,10.4696968028511,11.8486617165352,0.330285927655035,2020-02-24,2020,2
"7689","SC",4,"Sul",42007,"São Bento do Sul",139897,35231.5336486844,9,25,3,22,9,16,0,0,0,0,0,25,3,22,9,16,12,10.4696968028511,11.8486617165352,0.331058180122022,2020-03-02,2020,3
"7690","SC",4,"Sul",42007,"São Bento do Sul",139897,35231.5336486844,10,24,5,19,10,14,1,0,1,0,1,25,5,20,10,15,20,10.4696968028511,11.8486617165352,0.333030321946875,2020-03-09,2020,3
"7691","SC",4,"Sul",42007,"São Bento do Sul",139897,35231.5336486844,11,36,7,29,12,24,0,0,0,0,0,36,7,29,12,24,14,10.4696968028511,11.8486617165352,0.462474005021535,2020-03-16,2020,3
"7692","SC",4,"Sul",42007,"São Bento do Sul",139897,35231.5336486844,12,35,6,29,12,23,0,0,0,0,0,35,6,29,12,23,11,10.4696968028511,11.8486617165352,0.574372527782049,2020-03-23,2020,3
"7693","SC",4,"Sul",42007,"São Bento do Sul",139897,35231.5336486844,13,33,9,24,14,19,0,0,0,0,0,33,9,24,14,19,21,10.4696968028511,11.8486617165352,0.504173650392666,2020-03-30,2020,3
"7694","SC",4,"Sul",42007,"São Bento do Sul",139897,35231.5336486844,14,38,8,30,15,23,0,0,0,0,0,38,8,30,15,23,19,10.4696968028511,11.8486617165352,0.464744805323866,2020-04-06,2020,4
"7695","SC",4,"Sul",42007,"São Bento do Sul",139897,35231.5336486844,15,38,6,32,17,21,0,0,0,0,0,38,6,32,17,21,22,10.4696968028511,11.8486617165352,0.433467267660318,2020-04-13,2020,4
"7696","SC",4,"Sul",42007,"São Bento do Sul",139897,35231.5336486844,16,30,9,21,11,19,0,0,0,0,0,30,9,21,11,19,8,10.4696968028511,11.8486617165352,0.435734772606219,2020-04-20,2020,4
"7697","SC",4,"Sul",42007,"São Bento do Sul",139897,35231.5336486844,17,35,7,28,13,22,0,0,0,0,0,35,7,28,13,22,13,10.4696968028511,11.8486617165352,0.423879392937243,2020-04-27,2020,4
"7698","SC",4,"Sul",42007,"São Bento do Sul",139897,35231.5336486844,18,22,4,18,11,11,0,0,0,0,0,22,4,18,11,11,14,10.4696968028511,11.8486617165352,0.393928599194765,2020-05-04,2020,5
"7699","SC",4,"Sul",42007,"São Bento do Sul",139897,35231.5336486844,19,46,7,39,13,33,1,1,0,1,0,47,8,39,14,33,10,10.4696968028511,11.8486617165352,0.396485035908119,2020-05-11,2020,5
"7700","SC",4,"Sul",42007,"São Bento do Sul",139897,35231.5336486844,20,31,6,25,13,18,0,0,0,0,0,31,6,25,13,18,11,10.4696968028511,11.8486617165352,0.397329688444774,2020-05-18,2020,5
"7701","SC",4,"Sul",42007,"São Bento do Sul",139897,35231.5336486844,21,38,10,28,14,24,0,0,0,0,0,38,10,28,14,24,13,10.4696968028511,11.8486617165352,0.387577182975538,2020-05-25,2020,5
"7702","SC",4,"Sul",42008,"Joinville",1023817,53870.8783959536,5,220,42,178,64,156,0,0,0,0,0,220,42,178,64,156,100,10.8943453213882,13.8390483576734,0.29960879792564,2020-02-03,2020,2
"7703","SC",4,"Sul",42008,"Joinville",1023817,53870.8783959536,6,240,30,210,62,178,1,0,1,0,1,241,30,211,62,179,97,10.8943453213882,13.8390483576734,0.286737281420543,2020-02-10,2020,2
"7704","SC",4,"Sul",42008,"Joinville",1023817,53870.8783959536,7,228,43,185,69,159,1,0,1,0,1,229,43,186,69,160,124,10.8943453213882,13.8390483576734,0.300512729559627,2020-02-17,2020,2
"7705","SC",4,"Sul",42008,"Joinville",1023817,53870.8783959536,8,255,41,214,80,175,2,0,2,1,1,257,41,216,81,176,95,10.8943453213882,13.8390483576734,0.33506823037327,2020-02-24,2020,2
"7706","SC",4,"Sul",42008,"Joinville",1023817,53870.8783959536,9,265,53,212,87,178,1,0,1,0,1,266,53,213,87,179,85,10.8943453213882,13.8390483576734,0.3203306673188,2020-03-02,2020,3
"7707","SC",4,"Sul",42008,"Joinville",1023817,53870.8783959536,10,282,58,224,96,186,0,0,0,0,0,282,58,224,96,186,89,10.8943453213882,13.8390483576734,0.340005091377926,2020-03-09,2020,3
"7708","SC",4,"Sul",42008,"Joinville",1023817,53870.8783959536,11,244,41,203,84,160,1,0,1,0,1,245,41,204,84,161,105,10.8943453213882,13.8390483576734,0.479668183218638,2020-03-16,2020,3
"7709","SC",4,"Sul",42008,"Joinville",1023817,53870.8783959536,12,210,43,167,62,148,1,0,1,0,1,211,43,168,62,149,96,10.8943453213882,13.8390483576734,0.59630035529961,2020-03-23,2020,3
"7710","SC",4,"Sul",42008,"Joinville",1023817,53870.8783959536,13,203,30,173,71,132,1,0,1,1,0,204,30,174,72,132,107,10.8943453213882,13.8390483576734,0.515861218646153,2020-03-30,2020,3
"7711","SC",4,"Sul",42008,"Joinville",1023817,53870.8783959536,14,227,45,182,68,159,2,0,2,1,1,229,45,184,69,160,88,10.8943453213882,13.8390483576734,0.478584778413958,2020-04-06,2020,4
"7712","SC",4,"Sul",42008,"Joinville",1023817,53870.8783959536,15,235,42,193,68,167,0,0,0,0,0,235,42,193,68,167,86,10.8943453213882,13.8390483576734,0.448930376318082,2020-04-13,2020,4
"7713","SC",4,"Sul",42008,"Joinville",1023817,53870.8783959536,16,254,50,204,79,175,0,0,0,0,0,254,50,204,79,175,95,10.8943453213882,13.8390483576734,0.443341887032461,2020-04-20,2020,4
"7714","SC",4,"Sul",42008,"Joinville",1023817,53870.8783959536,17,245,43,202,71,174,1,0,1,0,1,246,43,203,71,175,100,10.8943453213882,13.8390483576734,0.434382953625123,2020-04-27,2020,4
"7715","SC",4,"Sul",42008,"Joinville",1023817,53870.8783959536,18,258,44,214,76,182,2,0,2,1,1,260,44,216,77,183,71,10.8943453213882,13.8390483576734,0.395818233057647,2020-05-04,2020,5
"7716","SC",4,"Sul",42008,"Joinville",1023817,53870.8783959536,19,248,56,192,88,160,4,0,4,1,3,252,56,196,89,163,98,10.8943453213882,13.8390483576734,0.405399768418635,2020-05-11,2020,5
"7717","SC",4,"Sul",42008,"Joinville",1023817,53870.8783959536,20,273,59,214,79,194,1,1,0,1,0,274,60,214,80,194,98,10.8943453213882,13.8390483576734,0.40002350682158,2020-05-18,2020,5
"7718","SC",4,"Sul",42008,"Joinville",1023817,53870.8783959536,21,286,45,241,89,197,4,0,4,0,4,290,45,245,89,201,87,10.8943453213882,13.8390483576734,0.392933718758453,2020-05-25,2020,5
"7719","SC",4,"Sul",42009,"Curitibanos",129657,36736.3033720509,5,41,13,28,16,25,0,0,0,0,0,41,13,28,16,25,21,10.5115207378129,11.7726477810249,0.297860323214714,2020-02-03,2020,2
"7720","SC",4,"Sul",42009,"Curitibanos",129657,36736.3033720509,6,47,13,34,20,27,2,2,0,1,1,49,15,34,21,28,8,10.5115207378129,11.7726477810249,0.305660786752109,2020-02-10,2020,2
"7721","SC",4,"Sul",42009,"Curitibanos",129657,36736.3033720509,7,27,7,20,16,11,0,0,0,0,0,27,7,20,16,11,20,10.5115207378129,11.7726477810249,0.315462374629544,2020-02-17,2020,2
"7722","SC",4,"Sul",42009,"Curitibanos",129657,36736.3033720509,8,40,16,24,22,18,0,0,0,0,0,40,16,24,22,18,24,10.5115207378129,11.7726477810249,0.353849308792886,2020-02-24,2020,2
"7723","SC",4,"Sul",42009,"Curitibanos",129657,36736.3033720509,9,38,9,29,14,24,0,0,0,0,0,38,9,29,14,24,9,10.5115207378129,11.7726477810249,0.325924628341342,2020-03-02,2020,3
"7724","SC",4,"Sul",42009,"Curitibanos",129657,36736.3033720509,10,42,15,27,23,19,1,1,0,0,1,43,16,27,23,20,19,10.5115207378129,11.7726477810249,0.333915798076297,2020-03-09,2020,3
"7725","SC",4,"Sul",42009,"Curitibanos",129657,36736.3033720509,11,30,13,17,12,18,0,0,0,0,0,30,13,17,12,18,10,10.5115207378129,11.7726477810249,0.478199908776241,2020-03-16,2020,3
"7726","SC",4,"Sul",42009,"Curitibanos",129657,36736.3033720509,12,41,20,21,21,20,0,0,0,0,0,41,20,21,21,20,21,10.5115207378129,11.7726477810249,0.559798887457246,2020-03-23,2020,3
"7727","SC",4,"Sul",42009,"Curitibanos",129657,36736.3033720509,13,30,10,20,11,19,1,0,1,1,0,31,10,21,12,19,15,10.5115207378129,11.7726477810249,0.491606420601956,2020-03-30,2020,3
"7728","SC",4,"Sul",42009,"Curitibanos",129657,36736.3033720509,14,44,15,29,23,21,0,0,0,0,0,44,15,29,23,21,17,10.5115207378129,11.7726477810249,0.455049829260367,2020-04-06,2020,4
"7729","SC",4,"Sul",42009,"Curitibanos",129657,36736.3033720509,15,32,10,22,16,16,1,0,1,1,0,33,10,23,17,16,19,10.5115207378129,11.7726477810249,0.416532908990429,2020-04-13,2020,4
"7730","SC",4,"Sul",42009,"Curitibanos",129657,36736.3033720509,16,25,8,17,11,14,0,0,0,0,0,25,8,17,11,14,11,10.5115207378129,11.7726477810249,0.417529669374316,2020-04-20,2020,4
"7731","SC",4,"Sul",42009,"Curitibanos",129657,36736.3033720509,17,42,13,29,21,21,0,0,0,0,0,42,13,29,21,21,18,10.5115207378129,11.7726477810249,0.419550750633656,2020-04-27,2020,4
"7732","SC",4,"Sul",42009,"Curitibanos",129657,36736.3033720509,18,39,16,23,17,22,1,1,0,0,1,40,17,23,17,23,19,10.5115207378129,11.7726477810249,0.394056754706579,2020-05-04,2020,5
"7733","SC",4,"Sul",42009,"Curitibanos",129657,36736.3033720509,19,31,9,22,13,18,0,0,0,0,0,31,9,22,13,18,16,10.5115207378129,11.7726477810249,0.396156551187252,2020-05-11,2020,5
"7734","SC",4,"Sul",42009,"Curitibanos",129657,36736.3033720509,20,43,7,36,21,22,0,0,0,0,0,43,7,36,21,22,22,10.5115207378129,11.7726477810249,0.415765429586834,2020-05-18,2020,5
"7735","SC",4,"Sul",42009,"Curitibanos",129657,36736.3033720509,21,36,9,27,17,19,0,0,0,0,0,36,9,27,17,19,11,10.5115207378129,11.7726477810249,0.395308625592678,2020-05-25,2020,5
"7736","SC",4,"Sul",42010,"Campos de Lages",285922,31469.4834176454,5,67,14,53,23,44,2,0,2,0,2,69,14,55,23,46,32,10.3567735748505,12.5634743253324,0.307730130125838,2020-02-03,2020,2
"7737","SC",4,"Sul",42010,"Campos de Lages",285922,31469.4834176454,6,79,21,58,33,46,0,0,0,0,0,79,21,58,33,46,48,10.3567735748505,12.5634743253324,0.301949335039461,2020-02-10,2020,2
"7738","SC",4,"Sul",42010,"Campos de Lages",285922,31469.4834176454,7,76,21,55,22,54,0,0,0,0,0,76,21,55,22,54,51,10.3567735748505,12.5634743253324,0.306263218721419,2020-02-17,2020,2
"7739","SC",4,"Sul",42010,"Campos de Lages",285922,31469.4834176454,8,72,12,60,29,43,0,0,0,0,0,72,12,60,29,43,31,10.3567735748505,12.5634743253324,0.35455446022272,2020-02-24,2020,2
"7740","SC",4,"Sul",42010,"Campos de Lages",285922,31469.4834176454,9,86,26,60,32,54,1,1,0,1,0,87,27,60,33,54,45,10.3567735748505,12.5634743253324,0.329045283322361,2020-03-02,2020,3
"7741","SC",4,"Sul",42010,"Campos de Lages",285922,31469.4834176454,10,60,21,39,37,23,2,2,0,0,2,62,23,39,37,25,52,10.3567735748505,12.5634743253324,0.338301103402387,2020-03-09,2020,3
"7742","SC",4,"Sul",42010,"Campos de Lages",285922,31469.4834176454,11,64,13,51,21,43,1,1,0,0,1,65,14,51,21,44,47,10.3567735748505,12.5634743253324,0.48131437716591,2020-03-16,2020,3
"7743","SC",4,"Sul",42010,"Campos de Lages",285922,31469.4834176454,12,77,23,54,36,41,0,0,0,0,0,77,23,54,36,41,37,10.3567735748505,12.5634743253324,0.575694204428134,2020-03-23,2020,3
"7744","SC",4,"Sul",42010,"Campos de Lages",285922,31469.4834176454,13,66,17,49,25,41,0,0,0,0,0,66,17,49,25,41,43,10.3567735748505,12.5634743253324,0.4981657721697,2020-03-30,2020,3
"7745","SC",4,"Sul",42010,"Campos de Lages",285922,31469.4834176454,14,86,28,58,31,55,2,1,1,2,0,88,29,59,33,55,42,10.3567735748505,12.5634743253324,0.474566181833987,2020-04-06,2020,4
"7746","SC",4,"Sul",42010,"Campos de Lages",285922,31469.4834176454,15,57,14,43,24,33,0,0,0,0,0,57,14,43,24,33,29,10.3567735748505,12.5634743253324,0.439082061874921,2020-04-13,2020,4
"7747","SC",4,"Sul",42010,"Campos de Lages",285922,31469.4834176454,16,71,18,53,28,43,0,0,0,0,0,71,18,53,28,43,42,10.3567735748505,12.5634743253324,0.435351362456431,2020-04-20,2020,4
"7748","SC",4,"Sul",42010,"Campos de Lages",285922,31469.4834176454,17,69,19,50,28,41,0,0,0,0,0,69,19,50,28,41,40,10.3567735748505,12.5634743253324,0.420592112576535,2020-04-27,2020,4
"7749","SC",4,"Sul",42010,"Campos de Lages",285922,31469.4834176454,18,62,12,50,17,45,0,0,0,0,0,62,12,50,17,45,37,10.3567735748505,12.5634743253324,0.393404150103407,2020-05-04,2020,5
"7750","SC",4,"Sul",42010,"Campos de Lages",285922,31469.4834176454,19,77,18,59,31,46,1,0,1,1,0,78,18,60,32,46,40,10.3567735748505,12.5634743253324,0.402213963083324,2020-05-11,2020,5
"7751","SC",4,"Sul",42010,"Campos de Lages",285922,31469.4834176454,20,84,33,51,41,43,0,0,0,0,0,84,33,51,41,43,41,10.3567735748505,12.5634743253324,0.410666032179302,2020-05-18,2020,5
"7752","SC",4,"Sul",42010,"Campos de Lages",285922,31469.4834176454,21,90,30,60,31,59,1,1,0,0,1,91,31,60,31,60,53,10.3567735748505,12.5634743253324,0.396397421258846,2020-05-25,2020,5
"7753","SC",4,"Sul",42011,"Rio do Sul",230580,32890.0302050915,5,45,9,36,19,26,0,0,0,0,0,45,9,36,19,26,24,10.4009248575497,12.3483531527869,0.291297952540059,2020-02-03,2020,2
"7754","SC",4,"Sul",42011,"Rio do Sul",230580,32890.0302050915,6,56,15,41,17,39,0,0,0,0,0,56,15,41,17,39,28,10.4009248575497,12.3483531527869,0.284204033164056,2020-02-10,2020,2
"7755","SC",4,"Sul",42011,"Rio do Sul",230580,32890.0302050915,7,43,12,31,18,25,0,0,0,0,0,43,12,31,18,25,26,10.4009248575497,12.3483531527869,0.286263498412949,2020-02-17,2020,2
"7756","SC",4,"Sul",42011,"Rio do Sul",230580,32890.0302050915,8,47,17,30,16,31,0,0,0,0,0,47,17,30,16,31,36,10.4009248575497,12.3483531527869,0.324838483267954,2020-02-24,2020,2
"7757","SC",4,"Sul",42011,"Rio do Sul",230580,32890.0302050915,9,47,11,36,11,36,1,0,1,0,1,48,11,37,11,37,24,10.4009248575497,12.3483531527869,0.308638344849779,2020-03-02,2020,3
"7758","SC",4,"Sul",42011,"Rio do Sul",230580,32890.0302050915,10,54,14,40,21,33,2,1,1,1,1,56,15,41,22,34,19,10.4009248575497,12.3483531527869,0.327945296741524,2020-03-09,2020,3
"7759","SC",4,"Sul",42011,"Rio do Sul",230580,32890.0302050915,11,42,11,31,17,25,0,0,0,0,0,42,11,31,17,25,20,10.4009248575497,12.3483531527869,0.473449101955119,2020-03-16,2020,3
"7760","SC",4,"Sul",42011,"Rio do Sul",230580,32890.0302050915,12,35,7,28,14,21,0,0,0,0,0,35,7,28,14,21,28,10.4009248575497,12.3483531527869,0.571874752260772,2020-03-23,2020,3
"7761","SC",4,"Sul",42011,"Rio do Sul",230580,32890.0302050915,13,55,15,40,15,40,2,0,2,0,2,57,15,42,15,42,26,10.4009248575497,12.3483531527869,0.473548541621743,2020-03-30,2020,3
"7762","SC",4,"Sul",42011,"Rio do Sul",230580,32890.0302050915,14,53,19,34,17,36,1,1,0,0,1,54,20,34,17,37,19,10.4009248575497,12.3483531527869,0.444701205814808,2020-04-06,2020,4
"7763","SC",4,"Sul",42011,"Rio do Sul",230580,32890.0302050915,15,46,13,33,21,25,1,0,1,0,1,47,13,34,21,26,25,10.4009248575497,12.3483531527869,0.407459321494384,2020-04-13,2020,4
"7764","SC",4,"Sul",42011,"Rio do Sul",230580,32890.0302050915,16,42,7,35,13,29,0,0,0,0,0,42,7,35,13,29,32,10.4009248575497,12.3483531527869,0.41215250195952,2020-04-20,2020,4
"7765","SC",4,"Sul",42011,"Rio do Sul",230580,32890.0302050915,17,65,16,49,18,47,0,0,0,0,0,65,16,49,18,47,21,10.4009248575497,12.3483531527869,0.410675470373931,2020-04-27,2020,4
"7766","SC",4,"Sul",42011,"Rio do Sul",230580,32890.0302050915,18,46,9,37,17,29,0,0,0,0,0,46,9,37,17,29,24,10.4009248575497,12.3483531527869,0.370925162406863,2020-05-04,2020,5
"7767","SC",4,"Sul",42011,"Rio do Sul",230580,32890.0302050915,19,58,17,41,21,37,0,0,0,0,0,58,17,41,21,37,25,10.4009248575497,12.3483531527869,0.385905908704953,2020-05-11,2020,5
"7768","SC",4,"Sul",42011,"Rio do Sul",230580,32890.0302050915,20,50,12,38,13,37,0,0,0,0,0,50,12,38,13,37,35,10.4009248575497,12.3483531527869,0.384036679231693,2020-05-18,2020,5
"7769","SC",4,"Sul",42011,"Rio do Sul",230580,32890.0302050915,21,60,13,47,26,34,0,0,0,0,0,60,13,47,26,34,24,10.4009248575497,12.3483531527869,0.379968066769122,2020-05-25,2020,5
"7770","SC",4,"Sul",42012,"Blumenau",821159,45682.139477592,5,162,32,130,45,117,3,1,2,2,1,165,33,132,47,118,76,10.7294626794326,13.6184720359443,0.301047922231372,2020-02-03,2020,2
"7771","SC",4,"Sul",42012,"Blumenau",821159,45682.139477592,6,191,35,156,67,124,0,0,0,0,0,191,35,156,67,124,61,10.7294626794326,13.6184720359443,0.291427827832826,2020-02-10,2020,2
"7772","SC",4,"Sul",42012,"Blumenau",821159,45682.139477592,7,164,37,127,47,117,4,0,4,3,1,168,37,131,50,118,86,10.7294626794326,13.6184720359443,0.305384273601049,2020-02-17,2020,2
"7773","SC",4,"Sul",42012,"Blumenau",821159,45682.139477592,8,164,28,136,47,117,2,1,1,0,2,166,29,137,47,119,72,10.7294626794326,13.6184720359443,0.338390540758009,2020-02-24,2020,2
"7774","SC",4,"Sul",42012,"Blumenau",821159,45682.139477592,9,182,42,140,58,124,0,0,0,0,0,182,42,140,58,124,77,10.7294626794326,13.6184720359443,0.322340552855214,2020-03-02,2020,3
"7775","SC",4,"Sul",42012,"Blumenau",821159,45682.139477592,10,188,35,153,61,127,1,0,1,0,1,189,35,154,61,128,74,10.7294626794326,13.6184720359443,0.331321813737061,2020-03-09,2020,3
"7776","SC",4,"Sul",42012,"Blumenau",821159,45682.139477592,11,156,33,123,51,105,2,2,0,1,1,158,35,123,52,106,85,10.7294626794326,13.6184720359443,0.49172273494742,2020-03-16,2020,3
"7777","SC",4,"Sul",42012,"Blumenau",821159,45682.139477592,12,158,26,132,57,101,1,1,0,0,1,159,27,132,57,102,81,10.7294626794326,13.6184720359443,0.628895650961853,2020-03-23,2020,3
"7778","SC",4,"Sul",42012,"Blumenau",821159,45682.139477592,13,163,29,134,56,107,2,0,2,1,1,165,29,136,57,108,75,10.7294626794326,13.6184720359443,0.53378126388767,2020-03-30,2020,3
"7779","SC",4,"Sul",42012,"Blumenau",821159,45682.139477592,14,157,26,131,46,111,0,0,0,0,0,157,26,131,46,111,56,10.7294626794326,13.6184720359443,0.485744465852616,2020-04-06,2020,4
"7780","SC",4,"Sul",42012,"Blumenau",821159,45682.139477592,15,172,29,143,51,121,2,1,1,2,0,174,30,144,53,121,70,10.7294626794326,13.6184720359443,0.450138596737278,2020-04-13,2020,4
"7781","SC",4,"Sul",42012,"Blumenau",821159,45682.139477592,16,183,41,142,56,127,2,1,1,0,2,185,42,143,56,129,76,10.7294626794326,13.6184720359443,0.447835078858057,2020-04-20,2020,4
"7782","SC",4,"Sul",42012,"Blumenau",821159,45682.139477592,17,158,27,131,44,114,1,0,1,0,1,159,27,132,44,115,69,10.7294626794326,13.6184720359443,0.439032253103317,2020-04-27,2020,4
"7783","SC",4,"Sul",42012,"Blumenau",821159,45682.139477592,18,161,33,128,44,117,3,1,2,2,1,164,34,130,46,118,91,10.7294626794326,13.6184720359443,0.401989462126636,2020-05-04,2020,5
"7784","SC",4,"Sul",42012,"Blumenau",821159,45682.139477592,19,148,30,118,45,103,3,2,1,1,2,151,32,119,46,105,82,10.7294626794326,13.6184720359443,0.407737875128934,2020-05-11,2020,5
"7785","SC",4,"Sul",42012,"Blumenau",821159,45682.139477592,20,146,28,118,49,97,3,2,1,2,1,149,30,119,51,98,61,10.7294626794326,13.6184720359443,0.403298276358727,2020-05-18,2020,5
"7786","SC",4,"Sul",42012,"Blumenau",821159,45682.139477592,21,157,28,129,53,104,4,1,3,2,2,161,29,132,55,106,71,10.7294626794326,13.6184720359443,0.395470924616518,2020-05-25,2020,5
"7787","SC",4,"Sul",42013,"Itajaí",752278,60836.476351947,5,211,55,156,66,145,3,0,3,1,2,214,55,159,67,147,76,11.0159448280613,13.5308612154679,0.298628278521986,2020-02-03,2020,2
"7788","SC",4,"Sul",42013,"Itajaí",752278,60836.476351947,6,193,45,148,61,132,0,0,0,0,0,193,45,148,61,132,89,11.0159448280613,13.5308612154679,0.286045378124804,2020-02-10,2020,2
"7789","SC",4,"Sul",42013,"Itajaí",752278,60836.476351947,7,215,48,167,89,126,6,0,6,1,5,221,48,173,90,131,77,11.0159448280613,13.5308612154679,0.29737663825644,2020-02-17,2020,2
"7790","SC",4,"Sul",42013,"Itajaí",752278,60836.476351947,8,225,58,167,95,130,2,1,1,1,1,227,59,168,96,131,66,11.0159448280613,13.5308612154679,0.341793172137301,2020-02-24,2020,2
"7791","SC",4,"Sul",42013,"Itajaí",752278,60836.476351947,9,227,51,176,84,143,1,0,1,0,1,228,51,177,84,144,77,11.0159448280613,13.5308612154679,0.323606892149803,2020-03-02,2020,3
"7792","SC",4,"Sul",42013,"Itajaí",752278,60836.476351947,10,229,45,184,86,143,2,2,0,0,2,231,47,184,86,145,69,11.0159448280613,13.5308612154679,0.3323111130345,2020-03-09,2020,3
"7793","SC",4,"Sul",42013,"Itajaí",752278,60836.476351947,11,213,38,175,78,135,0,0,0,0,0,213,38,175,78,135,87,11.0159448280613,13.5308612154679,0.499221883863311,2020-03-16,2020,3
"7794","SC",4,"Sul",42013,"Itajaí",752278,60836.476351947,12,175,30,145,56,119,0,0,0,0,0,175,30,145,56,119,84,11.0159448280613,13.5308612154679,0.619547103998243,2020-03-23,2020,3
"7795","SC",4,"Sul",42013,"Itajaí",752278,60836.476351947,13,178,36,142,65,113,2,1,1,0,2,180,37,143,65,115,84,11.0159448280613,13.5308612154679,0.530891100610812,2020-03-30,2020,3
"7796","SC",4,"Sul",42013,"Itajaí",752278,60836.476351947,14,201,48,153,73,128,3,0,3,0,3,204,48,156,73,131,70,11.0159448280613,13.5308612154679,0.482744011820201,2020-04-06,2020,4
"7797","SC",4,"Sul",42013,"Itajaí",752278,60836.476351947,15,219,41,178,66,153,7,2,5,2,5,226,43,183,68,158,70,11.0159448280613,13.5308612154679,0.445222824822627,2020-04-13,2020,4
"7798","SC",4,"Sul",42013,"Itajaí",752278,60836.476351947,16,193,32,161,61,132,1,0,1,0,1,194,32,162,61,133,87,11.0159448280613,13.5308612154679,0.440024804815316,2020-04-20,2020,4
"7799","SC",4,"Sul",42013,"Itajaí",752278,60836.476351947,17,180,40,140,55,125,3,1,2,1,2,183,41,142,56,127,71,11.0159448280613,13.5308612154679,0.431652195977839,2020-04-27,2020,4
"7800","SC",4,"Sul",42013,"Itajaí",752278,60836.476351947,18,198,42,156,55,143,1,0,1,0,1,199,42,157,55,144,56,11.0159448280613,13.5308612154679,0.401085205952252,2020-05-04,2020,5
"7801","SC",4,"Sul",42013,"Itajaí",752278,60836.476351947,19,183,34,149,60,123,1,1,0,1,0,184,35,149,61,123,90,11.0159448280613,13.5308612154679,0.406349924815276,2020-05-11,2020,5
"7802","SC",4,"Sul",42013,"Itajaí",752278,60836.476351947,20,195,42,153,66,129,1,0,1,0,1,196,42,154,66,130,72,11.0159448280613,13.5308612154679,0.398539850512885,2020-05-18,2020,5
"7803","SC",4,"Sul",42013,"Itajaí",752278,60836.476351947,21,203,35,168,65,138,2,0,2,1,1,205,35,170,66,139,89,11.0159448280613,13.5308612154679,0.392554237808054,2020-05-25,2020,5
"7804","SC",4,"Sul",42014,"Ituporanga",61044,33286.0649262827,5,18,4,14,7,11,0,0,0,0,0,18,4,14,7,11,11,10.412894117703,11.0193501946108,0.302706790621168,2020-02-03,2020,2
"7805","SC",4,"Sul",42014,"Ituporanga",61044,33286.0649262827,6,16,3,13,5,11,0,0,0,0,0,16,3,13,5,11,8,10.412894117703,11.0193501946108,0.299487706493353,2020-02-10,2020,2
"7806","SC",4,"Sul",42014,"Ituporanga",61044,33286.0649262827,7,15,3,12,7,8,0,0,0,0,0,15,3,12,7,8,4,10.412894117703,11.0193501946108,0.300998630054772,2020-02-17,2020,2
"7807","SC",4,"Sul",42014,"Ituporanga",61044,33286.0649262827,8,15,5,10,6,9,0,0,0,0,0,15,5,10,6,9,6,10.412894117703,11.0193501946108,0.341837420156645,2020-02-24,2020,2
"7808","SC",4,"Sul",42014,"Ituporanga",61044,33286.0649262827,9,10,0,10,1,9,0,0,0,0,0,10,0,10,1,9,7,10.412894117703,11.0193501946108,0.308572392058708,2020-03-02,2020,3
"7809","SC",4,"Sul",42014,"Ituporanga",61044,33286.0649262827,10,9,5,4,3,6,0,0,0,0,0,9,5,4,3,6,8,10.412894117703,11.0193501946108,0.317550051421099,2020-03-09,2020,3
"7810","SC",4,"Sul",42014,"Ituporanga",61044,33286.0649262827,11,9,3,6,5,4,0,0,0,0,0,9,3,6,5,4,13,10.412894117703,11.0193501946108,0.44900750842196,2020-03-16,2020,3
"7811","SC",4,"Sul",42014,"Ituporanga",61044,33286.0649262827,12,6,2,4,1,5,0,0,0,0,0,6,2,4,1,5,13,10.412894117703,11.0193501946108,0.548533855514181,2020-03-23,2020,3
"7812","SC",4,"Sul",42014,"Ituporanga",61044,33286.0649262827,13,13,3,10,6,7,1,1,0,0,1,14,4,10,6,8,8,10.412894117703,11.0193501946108,0.451649055253401,2020-03-30,2020,3
"7813","SC",4,"Sul",42014,"Ituporanga",61044,33286.0649262827,14,16,4,12,8,8,0,0,0,0,0,16,4,12,8,8,10,10.412894117703,11.0193501946108,0.429935876261973,2020-04-06,2020,4
"7814","SC",4,"Sul",42014,"Ituporanga",61044,33286.0649262827,15,9,2,7,2,7,0,0,0,0,0,9,2,7,2,7,12,10.412894117703,11.0193501946108,0.400844906067773,2020-04-13,2020,4
"7815","SC",4,"Sul",42014,"Ituporanga",61044,33286.0649262827,16,9,5,4,4,5,0,0,0,0,0,9,5,4,4,5,7,10.412894117703,11.0193501946108,0.386290455210853,2020-04-20,2020,4
"7816","SC",4,"Sul",42014,"Ituporanga",61044,33286.0649262827,17,15,3,12,4,11,0,0,0,0,0,15,3,12,4,11,6,10.412894117703,11.0193501946108,0.414758237248515,2020-04-27,2020,4
"7817","SC",4,"Sul",42014,"Ituporanga",61044,33286.0649262827,18,13,5,8,5,8,0,0,0,0,0,13,5,8,5,8,7,10.412894117703,11.0193501946108,0.381014685288627,2020-05-04,2020,5
"7818","SC",4,"Sul",42014,"Ituporanga",61044,33286.0649262827,19,14,5,9,6,8,0,0,0,0,0,14,5,9,6,8,11,10.412894117703,11.0193501946108,0.379010289281478,2020-05-11,2020,5
"7819","SC",4,"Sul",42014,"Ituporanga",61044,33286.0649262827,20,13,4,9,3,10,1,0,1,0,1,14,4,10,3,11,7,10.412894117703,11.0193501946108,0.388607573049952,2020-05-18,2020,5
"7820","SC",4,"Sul",42014,"Ituporanga",61044,33286.0649262827,21,22,6,16,9,13,0,0,0,0,0,22,6,16,9,13,6,10.412894117703,11.0193501946108,0.375071429472471,2020-05-25,2020,5
"7821","SC",4,"Sul",42015,"Tijucas",116115,31132.1864186367,5,20,6,14,8,12,0,0,0,0,0,20,6,14,8,12,11,10.3459974960684,11.6623363583069,0.30972004567638,2020-02-03,2020,2
"7822","SC",4,"Sul",42015,"Tijucas",116115,31132.1864186367,6,27,8,19,6,21,1,0,1,0,1,28,8,20,6,22,2,10.3459974960684,11.6623363583069,0.296266245082928,2020-02-10,2020,2
"7823","SC",4,"Sul",42015,"Tijucas",116115,31132.1864186367,7,33,11,22,11,22,0,0,0,0,0,33,11,22,11,22,12,10.3459974960684,11.6623363583069,0.308801652625511,2020-02-17,2020,2
"7824","SC",4,"Sul",42015,"Tijucas",116115,31132.1864186367,8,24,8,16,5,19,0,0,0,0,0,24,8,16,5,19,10,10.3459974960684,11.6623363583069,0.331950757370575,2020-02-24,2020,2
"7825","SC",4,"Sul",42015,"Tijucas",116115,31132.1864186367,9,28,9,19,9,19,2,0,2,0,2,30,9,21,9,21,11,10.3459974960684,11.6623363583069,0.314321012177882,2020-03-02,2020,3
"7826","SC",4,"Sul",42015,"Tijucas",116115,31132.1864186367,10,33,9,24,16,17,0,0,0,0,0,33,9,24,16,17,8,10.3459974960684,11.6623363583069,0.323824814725741,2020-03-09,2020,3
"7827","SC",4,"Sul",42015,"Tijucas",116115,31132.1864186367,11,33,7,26,8,25,0,0,0,0,0,33,7,26,8,25,9,10.3459974960684,11.6623363583069,0.4685059841294,2020-03-16,2020,3
"7828","SC",4,"Sul",42015,"Tijucas",116115,31132.1864186367,12,26,8,18,11,15,0,0,0,0,0,26,8,18,11,15,15,10.3459974960684,11.6623363583069,0.592346118923876,2020-03-23,2020,3
"7829","SC",4,"Sul",42015,"Tijucas",116115,31132.1864186367,13,22,9,13,7,15,0,0,0,0,0,22,9,13,7,15,12,10.3459974960684,11.6623363583069,0.490857182719278,2020-03-30,2020,3
"7830","SC",4,"Sul",42015,"Tijucas",116115,31132.1864186367,14,38,9,29,15,23,0,0,0,0,0,38,9,29,15,23,11,10.3459974960684,11.6623363583069,0.448517165868982,2020-04-06,2020,4
"7831","SC",4,"Sul",42015,"Tijucas",116115,31132.1864186367,15,25,10,15,12,13,0,0,0,0,0,25,10,15,12,13,15,10.3459974960684,11.6623363583069,0.423498758798451,2020-04-13,2020,4
"7832","SC",4,"Sul",42015,"Tijucas",116115,31132.1864186367,16,32,8,24,15,17,0,0,0,0,0,32,8,24,15,17,16,10.3459974960684,11.6623363583069,0.417307199634428,2020-04-20,2020,4
"7833","SC",4,"Sul",42015,"Tijucas",116115,31132.1864186367,17,27,7,20,5,22,0,0,0,0,0,27,7,20,5,22,11,10.3459974960684,11.6623363583069,0.416146025931373,2020-04-27,2020,4
"7834","SC",4,"Sul",42015,"Tijucas",116115,31132.1864186367,18,26,10,16,13,13,1,0,1,1,0,27,10,17,14,13,11,10.3459974960684,11.6623363583069,0.382105429728669,2020-05-04,2020,5
"7835","SC",4,"Sul",42015,"Tijucas",116115,31132.1864186367,19,30,11,19,8,22,1,1,0,0,1,31,12,19,8,23,12,10.3459974960684,11.6623363583069,0.392058175274416,2020-05-11,2020,5
"7836","SC",4,"Sul",42015,"Tijucas",116115,31132.1864186367,20,22,2,20,12,10,1,0,1,0,1,23,2,21,12,11,9,10.3459974960684,11.6623363583069,0.383221365914032,2020-05-18,2020,5
"7837","SC",4,"Sul",42015,"Tijucas",116115,31132.1864186367,21,33,8,25,16,17,0,0,0,0,0,33,8,25,16,17,15,10.3459974960684,11.6623363583069,0.383543010111517,2020-05-25,2020,5
"7838","SC",4,"Sul",42016,"Florianópolis",1064067,39890.8405217341,5,228,40,188,61,167,5,1,4,1,4,233,41,192,62,171,96,10.593902015666,13.877608916826,0.288739342780587,2020-02-03,2020,2
"7839","SC",4,"Sul",42016,"Florianópolis",1064067,39890.8405217341,6,238,27,211,52,186,2,0,2,1,1,240,27,213,53,187,101,10.593902015666,13.877608916826,0.274695316529001,2020-02-10,2020,2
"7840","SC",4,"Sul",42016,"Florianópolis",1064067,39890.8405217341,7,242,38,204,67,175,3,1,2,0,3,245,39,206,67,178,101,10.593902015666,13.877608916826,0.290066399934976,2020-02-17,2020,2
"7841","SC",4,"Sul",42016,"Florianópolis",1064067,39890.8405217341,8,234,44,190,56,178,0,0,0,0,0,234,44,190,56,178,91,10.593902015666,13.877608916826,0.337427762084389,2020-02-24,2020,2
"7842","SC",4,"Sul",42016,"Florianópolis",1064067,39890.8405217341,9,222,44,178,60,162,1,0,1,0,1,223,44,179,60,163,95,10.593902015666,13.877608916826,0.312264956499821,2020-03-02,2020,3
"7843","SC",4,"Sul",42016,"Florianópolis",1064067,39890.8405217341,10,249,55,194,85,164,1,1,0,0,1,250,56,194,85,165,103,10.593902015666,13.877608916826,0.324100654751444,2020-03-09,2020,3
"7844","SC",4,"Sul",42016,"Florianópolis",1064067,39890.8405217341,11,201,40,161,67,134,0,0,0,0,0,201,40,161,67,134,133,10.593902015666,13.877608916826,0.507656495239356,2020-03-16,2020,3
"7845","SC",4,"Sul",42016,"Florianópolis",1064067,39890.8405217341,12,216,44,172,68,148,2,1,1,1,1,218,45,173,69,149,107,10.593902015666,13.877608916826,0.638496214987429,2020-03-23,2020,3
"7846","SC",4,"Sul",42016,"Florianópolis",1064067,39890.8405217341,13,223,36,187,50,173,2,0,2,0,2,225,36,189,50,175,90,10.593902015666,13.877608916826,0.55453715088874,2020-03-30,2020,3
"7847","SC",4,"Sul",42016,"Florianópolis",1064067,39890.8405217341,14,237,47,190,75,162,1,0,1,1,0,238,47,191,76,162,113,10.593902015666,13.877608916826,0.518040862234485,2020-04-06,2020,4
"7848","SC",4,"Sul",42016,"Florianópolis",1064067,39890.8405217341,15,218,46,172,71,147,1,0,1,1,0,219,46,173,72,147,116,10.593902015666,13.877608916826,0.485874231841153,2020-04-13,2020,4
"7849","SC",4,"Sul",42016,"Florianópolis",1064067,39890.8405217341,16,259,52,207,70,189,1,0,1,0,1,260,52,208,70,190,106,10.593902015666,13.877608916826,0.475759065696175,2020-04-20,2020,4
"7850","SC",4,"Sul",42016,"Florianópolis",1064067,39890.8405217341,17,270,51,219,68,202,4,0,4,1,3,274,51,223,69,205,102,10.593902015666,13.877608916826,0.457400445068962,2020-04-27,2020,4
"7851","SC",4,"Sul",42016,"Florianópolis",1064067,39890.8405217341,18,243,44,199,78,165,1,0,1,1,0,244,44,200,79,165,101,10.593902015666,13.877608916826,0.422547990919806,2020-05-04,2020,5
"7852","SC",4,"Sul",42016,"Florianópolis",1064067,39890.8405217341,19,279,40,239,75,204,1,0,1,0,1,280,40,240,75,205,88,10.593902015666,13.877608916826,0.426103859380677,2020-05-11,2020,5
"7853","SC",4,"Sul",42016,"Florianópolis",1064067,39890.8405217341,20,262,49,213,73,189,2,0,2,2,0,264,49,215,75,189,98,10.593902015666,13.877608916826,0.420339612257725,2020-05-18,2020,5
"7854","SC",4,"Sul",42016,"Florianópolis",1064067,39890.8405217341,21,290,57,233,93,197,2,0,2,1,1,292,57,235,94,198,95,10.593902015666,13.877608916826,0.409141208313811,2020-05-25,2020,5
"7855","SC",4,"Sul",42017,"Tabuleiro",25574,26467.3180761711,5,4,1,3,2,2,0,0,0,0,0,4,1,3,2,2,5,10.183665970714,10.1493314893711,0.318301698048158,2020-02-03,2020,2
"7856","SC",4,"Sul",42017,"Tabuleiro",25574,26467.3180761711,6,4,1,3,0,4,0,0,0,0,0,4,1,3,0,4,4,10.183665970714,10.1493314893711,0.301355503711,2020-02-10,2020,2
"7857","SC",4,"Sul",42017,"Tabuleiro",25574,26467.3180761711,7,11,1,10,2,9,0,0,0,0,0,11,1,10,2,9,2,10.183665970714,10.1493314893711,0.29793847365026,2020-02-17,2020,2
"7858","SC",4,"Sul",42017,"Tabuleiro",25574,26467.3180761711,8,2,1,1,2,0,0,0,0,0,0,2,1,1,2,0,2,10.183665970714,10.1493314893711,0.365089405239565,2020-02-24,2020,2
"7859","SC",4,"Sul",42017,"Tabuleiro",25574,26467.3180761711,9,7,5,2,1,6,0,0,0,0,0,7,5,2,1,6,3,10.183665970714,10.1493314893711,0.326899104401912,2020-03-02,2020,3
"7860","SC",4,"Sul",42017,"Tabuleiro",25574,26467.3180761711,10,8,4,4,0,8,0,0,0,0,0,8,4,4,0,8,6,10.183665970714,10.1493314893711,0.342611581265558,2020-03-09,2020,3
"7861","SC",4,"Sul",42017,"Tabuleiro",25574,26467.3180761711,11,1,1,0,0,1,0,0,0,0,0,1,1,0,0,1,2,10.183665970714,10.1493314893711,0.490744399145907,2020-03-16,2020,3
"7862","SC",4,"Sul",42017,"Tabuleiro",25574,26467.3180761711,12,7,3,4,1,6,0,0,0,0,0,7,3,4,1,6,3,10.183665970714,10.1493314893711,0.58026964866859,2020-03-23,2020,3
"7863","SC",4,"Sul",42017,"Tabuleiro",25574,26467.3180761711,13,7,1,6,3,4,0,0,0,0,0,7,1,6,3,4,4,10.183665970714,10.1493314893711,0.499710803937868,2020-03-30,2020,3
"7864","SC",4,"Sul",42017,"Tabuleiro",25574,26467.3180761711,14,4,1,3,2,2,0,0,0,0,0,4,1,3,2,2,4,10.183665970714,10.1493314893711,0.479100292621188,2020-04-06,2020,4
"7865","SC",4,"Sul",42017,"Tabuleiro",25574,26467.3180761711,15,4,2,2,0,4,0,0,0,0,0,4,2,2,0,4,4,10.183665970714,10.1493314893711,0.477376038289718,2020-04-13,2020,4
"7866","SC",4,"Sul",42017,"Tabuleiro",25574,26467.3180761711,16,4,3,1,3,1,0,0,0,0,0,4,3,1,3,1,1,10.183665970714,10.1493314893711,0.456439771456187,2020-04-20,2020,4
"7867","SC",4,"Sul",42017,"Tabuleiro",25574,26467.3180761711,17,7,1,6,2,5,0,0,0,0,0,7,1,6,2,5,5,10.183665970714,10.1493314893711,0.436391122206478,2020-04-27,2020,4
"7868","SC",4,"Sul",42017,"Tabuleiro",25574,26467.3180761711,18,1,1,0,0,1,0,0,0,0,0,1,1,0,0,1,4,10.183665970714,10.1493314893711,0.427992223801093,2020-05-04,2020,5
"7869","SC",4,"Sul",42017,"Tabuleiro",25574,26467.3180761711,19,3,1,2,0,3,0,0,0,0,0,3,1,2,0,3,5,10.183665970714,10.1493314893711,0.422402575132343,2020-05-11,2020,5
"7870","SC",4,"Sul",42017,"Tabuleiro",25574,26467.3180761711,20,3,1,2,1,2,0,0,0,0,0,3,1,2,1,2,3,10.183665970714,10.1493314893711,0.409104974184644,2020-05-18,2020,5
"7871","SC",4,"Sul",42017,"Tabuleiro",25574,26467.3180761711,21,6,1,5,2,4,0,0,0,0,0,6,1,5,2,4,2,10.183665970714,10.1493314893711,0.418248625577776,2020-05-25,2020,5
"7872","SC",4,"Sul",42018,"Tubarão",418365,31375.0868321681,5,92,16,76,25,67,0,0,0,0,0,92,16,76,25,67,63,10.3537694439894,12.9441095362262,0.300698849160808,2020-02-03,2020,2
"7873","SC",4,"Sul",42018,"Tubarão",418365,31375.0868321681,6,98,17,81,22,76,0,0,0,0,0,98,17,81,22,76,55,10.3537694439894,12.9441095362262,0.28948461211045,2020-02-10,2020,2
"7874","SC",4,"Sul",42018,"Tubarão",418365,31375.0868321681,7,98,13,85,29,69,1,1,0,1,0,99,14,85,30,69,49,10.3537694439894,12.9441095362262,0.304568368324567,2020-02-17,2020,2
"7875","SC",4,"Sul",42018,"Tubarão",418365,31375.0868321681,8,89,14,75,21,68,0,0,0,0,0,89,14,75,21,68,48,10.3537694439894,12.9441095362262,0.350850210759111,2020-02-24,2020,2
"7876","SC",4,"Sul",42018,"Tubarão",418365,31375.0868321681,9,106,26,80,26,80,0,0,0,0,0,106,26,80,26,80,56,10.3537694439894,12.9441095362262,0.32413154063768,2020-03-02,2020,3
"7877","SC",4,"Sul",42018,"Tubarão",418365,31375.0868321681,10,122,24,98,36,86,3,1,2,2,1,125,25,100,38,87,51,10.3537694439894,12.9441095362262,0.330952761683783,2020-03-09,2020,3
"7878","SC",4,"Sul",42018,"Tubarão",418365,31375.0868321681,11,90,21,69,27,63,1,0,1,0,1,91,21,70,27,64,56,10.3537694439894,12.9441095362262,0.502252950084225,2020-03-16,2020,3
"7879","SC",4,"Sul",42018,"Tubarão",418365,31375.0868321681,12,74,20,54,22,52,0,0,0,0,0,74,20,54,22,52,54,10.3537694439894,12.9441095362262,0.6028979458623,2020-03-23,2020,3
"7880","SC",4,"Sul",42018,"Tubarão",418365,31375.0868321681,13,73,14,59,29,44,0,0,0,0,0,73,14,59,29,44,54,10.3537694439894,12.9441095362262,0.51933437853394,2020-03-30,2020,3
"7881","SC",4,"Sul",42018,"Tubarão",418365,31375.0868321681,14,93,20,73,32,61,0,0,0,0,0,93,20,73,32,61,51,10.3537694439894,12.9441095362262,0.485082371545059,2020-04-06,2020,4
"7882","SC",4,"Sul",42018,"Tubarão",418365,31375.0868321681,15,88,21,67,24,64,0,0,0,0,0,88,21,67,24,64,40,10.3537694439894,12.9441095362262,0.442426894052685,2020-04-13,2020,4
"7883","SC",4,"Sul",42018,"Tubarão",418365,31375.0868321681,16,90,18,72,20,70,4,0,4,2,2,94,18,76,22,72,43,10.3537694439894,12.9441095362262,0.434428648001536,2020-04-20,2020,4
"7884","SC",4,"Sul",42018,"Tubarão",418365,31375.0868321681,17,111,19,92,28,83,0,0,0,0,0,111,19,92,28,83,43,10.3537694439894,12.9441095362262,0.432341030914982,2020-04-27,2020,4
"7885","SC",4,"Sul",42018,"Tubarão",418365,31375.0868321681,18,107,31,76,39,68,0,0,0,0,0,107,31,76,39,68,45,10.3537694439894,12.9441095362262,0.399758018490079,2020-05-04,2020,5
"7886","SC",4,"Sul",42018,"Tubarão",418365,31375.0868321681,19,109,25,84,30,79,2,1,1,1,1,111,26,85,31,80,46,10.3537694439894,12.9441095362262,0.395118091561709,2020-05-11,2020,5
"7887","SC",4,"Sul",42018,"Tubarão",418365,31375.0868321681,20,107,24,83,36,71,0,0,0,0,0,107,24,83,36,71,46,10.3537694439894,12.9441095362262,0.395289517414163,2020-05-18,2020,5
"7888","SC",4,"Sul",42018,"Tubarão",418365,31375.0868321681,21,133,26,107,42,91,2,0,2,2,0,135,26,109,44,91,43,10.3537694439894,12.9441095362262,0.385263149985117,2020-05-25,2020,5
"7889","SC",4,"Sul",42019,"Criciúma",419540,36513.9384188397,5,107,22,85,31,76,0,0,0,0,0,107,22,85,31,76,39,10.5054493411638,12.9469141519528,0.297141639558742,2020-02-03,2020,2
"7890","SC",4,"Sul",42019,"Criciúma",419540,36513.9384188397,6,94,19,75,29,65,2,0,2,0,2,96,19,77,29,67,41,10.5054493411638,12.9469141519528,0.289618533042178,2020-02-10,2020,2
"7891","SC",4,"Sul",42019,"Criciúma",419540,36513.9384188397,7,76,23,53,24,52,1,1,0,0,1,77,24,53,24,53,44,10.5054493411638,12.9469141519528,0.304315343654177,2020-02-17,2020,2
"7892","SC",4,"Sul",42019,"Criciúma",419540,36513.9384188397,8,97,15,82,31,66,2,0,2,0,2,99,15,84,31,68,37,10.5054493411638,12.9469141519528,0.339095059910188,2020-02-24,2020,2
"7893","SC",4,"Sul",42019,"Criciúma",419540,36513.9384188397,9,108,21,87,29,79,1,0,1,0,1,109,21,88,29,80,53,10.5054493411638,12.9469141519528,0.316776539648862,2020-03-02,2020,3
"7894","SC",4,"Sul",42019,"Criciúma",419540,36513.9384188397,10,101,22,79,37,64,0,0,0,0,0,101,22,79,37,64,61,10.5054493411638,12.9469141519528,0.330460211950695,2020-03-09,2020,3
"7895","SC",4,"Sul",42019,"Criciúma",419540,36513.9384188397,11,104,23,81,32,72,0,0,0,0,0,104,23,81,32,72,50,10.5054493411638,12.9469141519528,0.499385290489171,2020-03-16,2020,3
"7896","SC",4,"Sul",42019,"Criciúma",419540,36513.9384188397,12,95,30,65,33,62,1,0,1,0,1,96,30,66,33,63,43,10.5054493411638,12.9469141519528,0.613756099127072,2020-03-23,2020,3
"7897","SC",4,"Sul",42019,"Criciúma",419540,36513.9384188397,13,93,25,68,34,59,0,0,0,0,0,93,25,68,34,59,32,10.5054493411638,12.9469141519528,0.528780630009721,2020-03-30,2020,3
"7898","SC",4,"Sul",42019,"Criciúma",419540,36513.9384188397,14,92,24,68,26,66,1,0,1,0,1,93,24,69,26,67,45,10.5054493411638,12.9469141519528,0.490112631367141,2020-04-06,2020,4
"7899","SC",4,"Sul",42019,"Criciúma",419540,36513.9384188397,15,83,22,61,27,56,0,0,0,0,0,83,22,61,27,56,45,10.5054493411638,12.9469141519528,0.439748820411794,2020-04-13,2020,4
"7900","SC",4,"Sul",42019,"Criciúma",419540,36513.9384188397,16,105,27,78,31,74,1,1,0,0,1,106,28,78,31,75,40,10.5054493411638,12.9469141519528,0.437023998061714,2020-04-20,2020,4
"7901","SC",4,"Sul",42019,"Criciúma",419540,36513.9384188397,17,106,33,73,36,70,0,0,0,0,0,106,33,73,36,70,42,10.5054493411638,12.9469141519528,0.426305985569608,2020-04-27,2020,4
"7902","SC",4,"Sul",42019,"Criciúma",419540,36513.9384188397,18,115,21,94,35,80,1,0,1,1,0,116,21,95,36,80,44,10.5054493411638,12.9469141519528,0.392139386651638,2020-05-04,2020,5
"7903","SC",4,"Sul",42019,"Criciúma",419540,36513.9384188397,19,131,30,101,35,96,0,0,0,0,0,131,30,101,35,96,51,10.5054493411638,12.9469141519528,0.398883157591812,2020-05-11,2020,5
"7904","SC",4,"Sul",42019,"Criciúma",419540,36513.9384188397,20,124,28,96,42,82,0,0,0,0,0,124,28,96,42,82,45,10.5054493411638,12.9469141519528,0.393069599699913,2020-05-18,2020,5
"7905","SC",4,"Sul",42019,"Criciúma",419540,36513.9384188397,21,110,23,87,29,81,0,0,0,0,0,110,23,87,29,81,44,10.5054493411638,12.9469141519528,0.383415595658096,2020-05-25,2020,5
"7906","SC",4,"Sul",42020,"Araranguá",204380,25967.6005696741,5,43,6,37,14,29,0,0,0,0,0,43,6,37,14,29,26,10.164604908,12.2277362851662,0.307173507339003,2020-02-03,2020,2
"7907","SC",4,"Sul",42020,"Araranguá",204380,25967.6005696741,6,51,11,40,13,38,0,0,0,0,0,51,11,40,13,38,24,10.164604908,12.2277362851662,0.288985008149442,2020-02-10,2020,2
"7908","SC",4,"Sul",42020,"Araranguá",204380,25967.6005696741,7,38,10,28,15,23,0,0,0,0,0,38,10,28,15,23,21,10.164604908,12.2277362851662,0.30544648440417,2020-02-17,2020,2
"7909","SC",4,"Sul",42020,"Araranguá",204380,25967.6005696741,8,55,11,44,20,35,0,0,0,0,0,55,11,44,20,35,18,10.164604908,12.2277362851662,0.341589161063157,2020-02-24,2020,2
"7910","SC",4,"Sul",42020,"Araranguá",204380,25967.6005696741,9,44,9,35,14,30,0,0,0,0,0,44,9,35,14,30,20,10.164604908,12.2277362851662,0.319454334737234,2020-03-02,2020,3
"7911","SC",4,"Sul",42020,"Araranguá",204380,25967.6005696741,10,46,11,35,17,29,0,0,0,0,0,46,11,35,17,29,26,10.164604908,12.2277362851662,0.327865424601769,2020-03-09,2020,3
"7912","SC",4,"Sul",42020,"Araranguá",204380,25967.6005696741,11,57,17,40,20,37,0,0,0,0,0,57,17,40,20,37,31,10.164604908,12.2277362851662,0.495147093595886,2020-03-16,2020,3
"7913","SC",4,"Sul",42020,"Araranguá",204380,25967.6005696741,12,42,12,30,12,30,0,0,0,0,0,42,12,30,12,30,19,10.164604908,12.2277362851662,0.595477066941909,2020-03-23,2020,3
"7914","SC",4,"Sul",42020,"Araranguá",204380,25967.6005696741,13,39,17,22,16,23,0,0,0,0,0,39,17,22,16,23,27,10.164604908,12.2277362851662,0.511127499022513,2020-03-30,2020,3
"7915","SC",4,"Sul",42020,"Araranguá",204380,25967.6005696741,14,51,12,39,15,36,1,0,1,0,1,52,12,40,15,37,21,10.164604908,12.2277362851662,0.475942789691683,2020-04-06,2020,4
"7916","SC",4,"Sul",42020,"Araranguá",204380,25967.6005696741,15,47,11,36,13,34,0,0,0,0,0,47,11,36,13,34,23,10.164604908,12.2277362851662,0.436757598776296,2020-04-13,2020,4
"7917","SC",4,"Sul",42020,"Araranguá",204380,25967.6005696741,16,50,12,38,19,31,0,0,0,0,0,50,12,38,19,31,24,10.164604908,12.2277362851662,0.427325183013389,2020-04-20,2020,4
"7918","SC",4,"Sul",42020,"Araranguá",204380,25967.6005696741,17,56,13,43,26,30,0,0,0,0,0,56,13,43,26,30,22,10.164604908,12.2277362851662,0.426042927262833,2020-04-27,2020,4
"7919","SC",4,"Sul",42020,"Araranguá",204380,25967.6005696741,18,52,12,40,16,36,0,0,0,0,0,52,12,40,16,36,27,10.164604908,12.2277362851662,0.392315812388811,2020-05-04,2020,5
"7920","SC",4,"Sul",42020,"Araranguá",204380,25967.6005696741,19,63,17,46,16,47,0,0,0,0,0,63,17,46,16,47,25,10.164604908,12.2277362851662,0.399929945564365,2020-05-11,2020,5
"7921","SC",4,"Sul",42020,"Araranguá",204380,25967.6005696741,20,63,6,57,14,49,1,1,0,0,1,64,7,57,14,50,27,10.164604908,12.2277362851662,0.405867651596267,2020-05-18,2020,5
"7922","SC",4,"Sul",42020,"Araranguá",204380,25967.6005696741,21,49,10,39,17,32,2,1,1,0,2,51,11,40,17,34,19,10.164604908,12.2277362851662,0.395228175877855,2020-05-25,2020,5
"7923","SE",2,"Nordeste",28001,"Sergipana do Sertão do São Francisco",174628,21612.5976993953,5,49,32,17,23,26,0,0,0,0,0,49,32,17,23,26,21,9.98103165048545,12.0704132760824,0.270301346414957,2020-02-03,2020,2
"7924","SE",2,"Nordeste",28001,"Sergipana do Sertão do São Francisco",174628,21612.5976993953,6,44,17,27,18,26,0,0,0,0,0,44,17,27,18,26,17,9.98103165048545,12.0704132760824,0.261240665054682,2020-02-10,2020,2
"7925","SE",2,"Nordeste",28001,"Sergipana do Sertão do São Francisco",174628,21612.5976993953,7,40,16,24,14,26,0,0,0,0,0,40,16,24,14,26,20,9.98103165048545,12.0704132760824,0.273561268387764,2020-02-17,2020,2
"7926","SE",2,"Nordeste",28001,"Sergipana do Sertão do São Francisco",174628,21612.5976993953,8,37,20,17,17,20,0,0,0,0,0,37,20,17,17,20,23,9.98103165048545,12.0704132760824,0.308921748402264,2020-02-24,2020,2
"7927","SE",2,"Nordeste",28001,"Sergipana do Sertão do São Francisco",174628,21612.5976993953,9,44,21,23,23,21,0,0,0,0,0,44,21,23,23,21,16,9.98103165048545,12.0704132760824,0.303136149676598,2020-03-02,2020,3
"7928","SE",2,"Nordeste",28001,"Sergipana do Sertão do São Francisco",174628,21612.5976993953,10,44,19,25,25,19,0,0,0,0,0,44,19,25,25,19,16,9.98103165048545,12.0704132760824,0.326008651576422,2020-03-09,2020,3
"7929","SE",2,"Nordeste",28001,"Sergipana do Sertão do São Francisco",174628,21612.5976993953,11,54,31,23,29,25,0,0,0,0,0,54,31,23,29,25,16,9.98103165048545,12.0704132760824,0.37936035282862,2020-03-16,2020,3
"7930","SE",2,"Nordeste",28001,"Sergipana do Sertão do São Francisco",174628,21612.5976993953,12,47,20,27,26,21,0,0,0,0,0,47,20,27,26,21,18,9.98103165048545,12.0704132760824,0.466329538836236,2020-03-23,2020,3
"7931","SE",2,"Nordeste",28001,"Sergipana do Sertão do São Francisco",174628,21612.5976993953,13,48,27,21,17,31,2,2,0,1,1,50,29,21,18,32,29,9.98103165048545,12.0704132760824,0.411318452715336,2020-03-30,2020,3
"7932","SE",2,"Nordeste",28001,"Sergipana do Sertão do São Francisco",174628,21612.5976993953,14,46,22,24,27,19,0,0,0,0,0,46,22,24,27,19,19,9.98103165048545,12.0704132760824,0.393022103986311,2020-04-06,2020,4
"7933","SE",2,"Nordeste",28001,"Sergipana do Sertão do São Francisco",174628,21612.5976993953,15,43,21,22,23,20,1,1,0,1,0,44,22,22,24,20,13,9.98103165048545,12.0704132760824,0.380852842595004,2020-04-13,2020,4
"7934","SE",2,"Nordeste",28001,"Sergipana do Sertão do São Francisco",174628,21612.5976993953,16,59,32,27,29,30,0,0,0,0,0,59,32,27,29,30,15,9.98103165048545,12.0704132760824,0.376320153994662,2020-04-20,2020,4
"7935","SE",2,"Nordeste",28001,"Sergipana do Sertão do São Francisco",174628,21612.5976993953,17,39,21,18,16,23,3,2,1,0,3,42,23,19,16,26,19,9.98103165048545,12.0704132760824,0.363713425572003,2020-04-27,2020,4
"7936","SE",2,"Nordeste",28001,"Sergipana do Sertão do São Francisco",174628,21612.5976993953,18,48,23,25,22,26,1,0,1,1,0,49,23,26,23,26,22,9.98103165048545,12.0704132760824,0.393479148753495,2020-05-04,2020,5
"7937","SE",2,"Nordeste",28001,"Sergipana do Sertão do São Francisco",174628,21612.5976993953,19,42,23,19,21,21,3,1,2,1,2,45,24,21,22,23,25,9.98103165048545,12.0704132760824,0.408520430174951,2020-05-11,2020,5
"7938","SE",2,"Nordeste",28001,"Sergipana do Sertão do São Francisco",174628,21612.5976993953,20,45,24,21,24,21,2,0,2,0,2,47,24,23,24,23,20,9.98103165048545,12.0704132760824,0.404153318787265,2020-05-18,2020,5
"7939","SE",2,"Nordeste",28001,"Sergipana do Sertão do São Francisco",174628,21612.5976993953,21,50,26,24,21,29,0,0,0,0,0,50,26,24,21,29,14,9.98103165048545,12.0704132760824,0.395270203346444,2020-05-25,2020,5
"7940","SE",2,"Nordeste",28002,"Carira",75289,12271.0013810782,5,21,12,9,9,12,0,0,0,0,0,21,12,9,9,12,7,9.41499414652468,11.2290893207796,0.286745104607442,2020-02-03,2020,2
"7941","SE",2,"Nordeste",28002,"Carira",75289,12271.0013810782,6,9,2,7,4,5,0,0,0,0,0,9,2,7,4,5,7,9.41499414652468,11.2290893207796,0.271018519911034,2020-02-10,2020,2
"7942","SE",2,"Nordeste",28002,"Carira",75289,12271.0013810782,7,10,7,3,7,3,0,0,0,0,0,10,7,3,7,3,9,9.41499414652468,11.2290893207796,0.288794066393862,2020-02-17,2020,2
"7943","SE",2,"Nordeste",28002,"Carira",75289,12271.0013810782,8,13,6,7,5,8,0,0,0,0,0,13,6,7,5,8,15,9.41499414652468,11.2290893207796,0.321434576345474,2020-02-24,2020,2
"7944","SE",2,"Nordeste",28002,"Carira",75289,12271.0013810782,9,16,9,7,8,8,0,0,0,0,0,16,9,7,8,8,7,9.41499414652468,11.2290893207796,0.308007443256731,2020-03-02,2020,3
"7945","SE",2,"Nordeste",28002,"Carira",75289,12271.0013810782,10,16,9,7,6,10,0,0,0,0,0,16,9,7,6,10,11,9.41499414652468,11.2290893207796,0.325451420741194,2020-03-09,2020,3
"7946","SE",2,"Nordeste",28002,"Carira",75289,12271.0013810782,11,16,6,10,5,11,1,0,1,0,1,17,6,11,5,12,16,9.41499414652468,11.2290893207796,0.378934624097798,2020-03-16,2020,3
"7947","SE",2,"Nordeste",28002,"Carira",75289,12271.0013810782,12,14,9,5,6,8,0,0,0,0,0,14,9,5,6,8,10,9.41499414652468,11.2290893207796,0.470780577882953,2020-03-23,2020,3
"7948","SE",2,"Nordeste",28002,"Carira",75289,12271.0013810782,13,12,3,9,3,9,0,0,0,0,0,12,3,9,3,9,12,9.41499414652468,11.2290893207796,0.404807552206261,2020-03-30,2020,3
"7949","SE",2,"Nordeste",28002,"Carira",75289,12271.0013810782,14,15,8,7,2,13,0,0,0,0,0,15,8,7,2,13,14,9.41499414652468,11.2290893207796,0.393743076581024,2020-04-06,2020,4
"7950","SE",2,"Nordeste",28002,"Carira",75289,12271.0013810782,15,16,8,8,9,7,0,0,0,0,0,16,8,8,9,7,11,9.41499414652468,11.2290893207796,0.380872979484538,2020-04-13,2020,4
"7951","SE",2,"Nordeste",28002,"Carira",75289,12271.0013810782,16,11,6,5,7,4,1,1,0,1,0,12,7,5,8,4,9,9.41499414652468,11.2290893207796,0.371626928692465,2020-04-20,2020,4
"7952","SE",2,"Nordeste",28002,"Carira",75289,12271.0013810782,17,13,8,5,6,7,0,0,0,0,0,13,8,5,6,7,11,9.41499414652468,11.2290893207796,0.369611178023402,2020-04-27,2020,4
"7953","SE",2,"Nordeste",28002,"Carira",75289,12271.0013810782,18,12,8,4,8,4,0,0,0,0,0,12,8,4,8,4,15,9.41499414652468,11.2290893207796,0.38575473436735,2020-05-04,2020,5
"7954","SE",2,"Nordeste",28002,"Carira",75289,12271.0013810782,19,22,12,10,10,12,0,0,0,0,0,22,12,10,10,12,9,9.41499414652468,11.2290893207796,0.408500246376332,2020-05-11,2020,5
"7955","SE",2,"Nordeste",28002,"Carira",75289,12271.0013810782,20,9,5,4,7,2,0,0,0,0,0,9,5,4,7,2,8,9.41499414652468,11.2290893207796,0.39986598865149,2020-05-18,2020,5
"7956","SE",2,"Nordeste",28002,"Carira",75289,12271.0013810782,21,15,5,10,6,9,0,0,0,0,0,15,5,10,6,9,8,9.41499414652468,11.2290893207796,0.386102262879096,2020-05-25,2020,5
"7957","SE",2,"Nordeste",28003,"Nossa Senhora das Dores",67759,10932.2727572721,5,14,5,9,6,8,0,0,0,0,0,14,5,9,6,8,10,9.2994744970909,11.1237125712477,0.255506069202971,2020-02-03,2020,2
"7958","SE",2,"Nordeste",28003,"Nossa Senhora das Dores",67759,10932.2727572721,6,9,4,5,5,4,0,0,0,0,0,9,4,5,5,4,9,9.2994744970909,11.1237125712477,0.257585352291312,2020-02-10,2020,2
"7959","SE",2,"Nordeste",28003,"Nossa Senhora das Dores",67759,10932.2727572721,7,22,8,14,9,13,0,0,0,0,0,22,8,14,9,13,8,9.2994744970909,11.1237125712477,0.264255734257583,2020-02-17,2020,2
"7960","SE",2,"Nordeste",28003,"Nossa Senhora das Dores",67759,10932.2727572721,8,7,4,3,1,6,0,0,0,0,0,7,4,3,1,6,12,9.2994744970909,11.1237125712477,0.31465705584623,2020-02-24,2020,2
"7961","SE",2,"Nordeste",28003,"Nossa Senhora das Dores",67759,10932.2727572721,9,15,3,12,7,8,1,1,0,0,1,16,4,12,7,9,5,9.2994744970909,11.1237125712477,0.284192995444077,2020-03-02,2020,3
"7962","SE",2,"Nordeste",28003,"Nossa Senhora das Dores",67759,10932.2727572721,10,17,9,8,4,13,1,0,1,0,1,18,9,9,4,14,16,9.2994744970909,11.1237125712477,0.298439738077768,2020-03-09,2020,3
"7963","SE",2,"Nordeste",28003,"Nossa Senhora das Dores",67759,10932.2727572721,11,8,5,3,4,4,0,0,0,0,0,8,5,3,4,4,6,9.2994744970909,11.1237125712477,0.363577190830989,2020-03-16,2020,3
"7964","SE",2,"Nordeste",28003,"Nossa Senhora das Dores",67759,10932.2727572721,12,14,8,6,5,9,0,0,0,0,0,14,8,6,5,9,12,9.2994744970909,11.1237125712477,0.463834041651781,2020-03-23,2020,3
"7965","SE",2,"Nordeste",28003,"Nossa Senhora das Dores",67759,10932.2727572721,13,12,8,4,10,2,0,0,0,0,0,12,8,4,10,2,12,9.2994744970909,11.1237125712477,0.401490050592655,2020-03-30,2020,3
"7966","SE",2,"Nordeste",28003,"Nossa Senhora das Dores",67759,10932.2727572721,14,11,3,8,4,7,1,0,1,1,0,12,3,9,5,7,14,9.2994744970909,11.1237125712477,0.384396779637826,2020-04-06,2020,4
"7967","SE",2,"Nordeste",28003,"Nossa Senhora das Dores",67759,10932.2727572721,15,8,4,4,4,4,0,0,0,0,0,8,4,4,4,4,10,9.2994744970909,11.1237125712477,0.378113466563089,2020-04-13,2020,4
"7968","SE",2,"Nordeste",28003,"Nossa Senhora das Dores",67759,10932.2727572721,16,20,12,8,8,12,0,0,0,0,0,20,12,8,8,12,7,9.2994744970909,11.1237125712477,0.366600930292326,2020-04-20,2020,4
"7969","SE",2,"Nordeste",28003,"Nossa Senhora das Dores",67759,10932.2727572721,17,16,10,6,6,10,0,0,0,0,0,16,10,6,6,10,10,9.2994744970909,11.1237125712477,0.355142125166442,2020-04-27,2020,4
"7970","SE",2,"Nordeste",28003,"Nossa Senhora das Dores",67759,10932.2727572721,18,14,5,9,5,9,0,0,0,0,0,14,5,9,5,9,5,9.2994744970909,11.1237125712477,0.363320967045096,2020-05-04,2020,5
"7971","SE",2,"Nordeste",28003,"Nossa Senhora das Dores",67759,10932.2727572721,19,13,5,8,3,10,0,0,0,0,0,13,5,8,3,10,11,9.2994744970909,11.1237125712477,0.387213695280175,2020-05-11,2020,5
"7972","SE",2,"Nordeste",28003,"Nossa Senhora das Dores",67759,10932.2727572721,20,13,6,7,5,8,1,0,1,0,1,14,6,8,5,9,9,9.2994744970909,11.1237125712477,0.390980863198858,2020-05-18,2020,5
"7973","SE",2,"Nordeste",28003,"Nossa Senhora das Dores",67759,10932.2727572721,21,15,5,10,6,9,0,0,0,0,0,15,5,10,6,9,5,9.2994744970909,11.1237125712477,0.368420217936833,2020-05-25,2020,5
"7974","SE",2,"Nordeste",28004,"Agreste de Itabaiana",175215,15102.3111711326,5,40,14,26,16,24,0,0,0,0,0,40,14,26,16,24,24,9.62260306878178,12.0737690702579,0.26120989708961,2020-02-03,2020,2
"7975","SE",2,"Nordeste",28004,"Agreste de Itabaiana",175215,15102.3111711326,6,38,16,22,10,28,0,0,0,0,0,38,16,22,10,28,26,9.62260306878178,12.0737690702579,0.254666865631642,2020-02-10,2020,2
"7976","SE",2,"Nordeste",28004,"Agreste de Itabaiana",175215,15102.3111711326,7,45,18,27,15,30,1,0,1,0,1,46,18,28,15,31,21,9.62260306878178,12.0737690702579,0.270134549512593,2020-02-17,2020,2
"7977","SE",2,"Nordeste",28004,"Agreste de Itabaiana",175215,15102.3111711326,8,32,16,16,13,19,0,0,0,0,0,32,16,16,13,19,17,9.62260306878178,12.0737690702579,0.309815867597032,2020-02-24,2020,2
"7978","SE",2,"Nordeste",28004,"Agreste de Itabaiana",175215,15102.3111711326,9,35,15,20,14,21,2,1,1,2,0,37,16,21,16,21,33,9.62260306878178,12.0737690702579,0.286366443399589,2020-03-02,2020,3
"7979","SE",2,"Nordeste",28004,"Agreste de Itabaiana",175215,15102.3111711326,10,42,21,21,14,28,0,0,0,0,0,42,21,21,14,28,22,9.62260306878178,12.0737690702579,0.311653655855782,2020-03-09,2020,3
"7980","SE",2,"Nordeste",28004,"Agreste de Itabaiana",175215,15102.3111711326,11,35,11,24,13,22,0,0,0,0,0,35,11,24,13,22,33,9.62260306878178,12.0737690702579,0.365386075345163,2020-03-16,2020,3
"7981","SE",2,"Nordeste",28004,"Agreste de Itabaiana",175215,15102.3111711326,12,50,25,25,24,26,1,1,0,1,0,51,26,25,25,26,24,9.62260306878178,12.0737690702579,0.468023593237301,2020-03-23,2020,3
"7982","SE",2,"Nordeste",28004,"Agreste de Itabaiana",175215,15102.3111711326,13,44,21,23,18,26,1,0,1,0,1,45,21,24,18,27,20,9.62260306878178,12.0737690702579,0.403661828302686,2020-03-30,2020,3
"7983","SE",2,"Nordeste",28004,"Agreste de Itabaiana",175215,15102.3111711326,14,33,18,15,16,17,0,0,0,0,0,33,18,15,16,17,21,9.62260306878178,12.0737690702579,0.39357762697147,2020-04-06,2020,4
"7984","SE",2,"Nordeste",28004,"Agreste de Itabaiana",175215,15102.3111711326,15,35,15,20,18,17,1,0,1,0,1,36,15,21,18,18,31,9.62260306878178,12.0737690702579,0.380979697532702,2020-04-13,2020,4
"7985","SE",2,"Nordeste",28004,"Agreste de Itabaiana",175215,15102.3111711326,16,50,21,29,22,28,0,0,0,0,0,50,21,29,22,28,21,9.62260306878178,12.0737690702579,0.378125085897032,2020-04-20,2020,4
"7986","SE",2,"Nordeste",28004,"Agreste de Itabaiana",175215,15102.3111711326,17,57,26,31,26,31,0,0,0,0,0,57,26,31,26,31,25,9.62260306878178,12.0737690702579,0.357388639996028,2020-04-27,2020,4
"7987","SE",2,"Nordeste",28004,"Agreste de Itabaiana",175215,15102.3111711326,18,53,26,27,25,28,0,0,0,0,0,53,26,27,25,28,23,9.62260306878178,12.0737690702579,0.366054567551063,2020-05-04,2020,5
"7988","SE",2,"Nordeste",28004,"Agreste de Itabaiana",175215,15102.3111711326,19,43,22,21,18,25,0,0,0,0,0,43,22,21,18,25,31,9.62260306878178,12.0737690702579,0.387862539001742,2020-05-11,2020,5
"7989","SE",2,"Nordeste",28004,"Agreste de Itabaiana",175215,15102.3111711326,20,49,24,25,23,26,0,0,0,0,0,49,24,25,23,26,27,9.62260306878178,12.0737690702579,0.395089023911018,2020-05-18,2020,5
"7990","SE",2,"Nordeste",28004,"Agreste de Itabaiana",175215,15102.3111711326,21,43,18,25,15,28,1,0,1,0,1,44,18,26,15,29,33,9.62260306878178,12.0737690702579,0.370012354965679,2020-05-25,2020,5
"7991","SE",2,"Nordeste",28005,"Tobias Barreto",117003,11405.917312633,5,29,10,19,6,23,0,0,0,0,0,29,10,19,6,23,18,9.34188756222791,11.6699548544768,0.261244058435863,2020-02-03,2020,2
"7992","SE",2,"Nordeste",28005,"Tobias Barreto",117003,11405.917312633,6,30,17,13,9,21,1,1,0,0,1,31,18,13,9,22,17,9.34188756222791,11.6699548544768,0.25218613516346,2020-02-10,2020,2
"7993","SE",2,"Nordeste",28005,"Tobias Barreto",117003,11405.917312633,7,27,13,14,6,21,1,1,0,0,1,28,14,14,6,22,15,9.34188756222791,11.6699548544768,0.273233484054067,2020-02-17,2020,2
"7994","SE",2,"Nordeste",28005,"Tobias Barreto",117003,11405.917312633,8,18,12,6,10,8,1,0,1,1,0,19,12,7,11,8,6,9.34188756222791,11.6699548544768,0.311006211465857,2020-02-24,2020,2
"7995","SE",2,"Nordeste",28005,"Tobias Barreto",117003,11405.917312633,9,36,18,18,15,21,1,1,0,0,1,37,19,18,15,22,18,9.34188756222791,11.6699548544768,0.297029899826434,2020-03-02,2020,3
"7996","SE",2,"Nordeste",28005,"Tobias Barreto",117003,11405.917312633,10,22,15,7,12,10,0,0,0,0,0,22,15,7,12,10,16,9.34188756222791,11.6699548544768,0.316455313672922,2020-03-09,2020,3
"7997","SE",2,"Nordeste",28005,"Tobias Barreto",117003,11405.917312633,11,18,7,11,6,12,1,0,1,1,0,19,7,12,7,12,13,9.34188756222791,11.6699548544768,0.365465383781982,2020-03-16,2020,3
"7998","SE",2,"Nordeste",28005,"Tobias Barreto",117003,11405.917312633,12,23,15,8,16,7,0,0,0,0,0,23,15,8,16,7,14,9.34188756222791,11.6699548544768,0.474169222513728,2020-03-23,2020,3
"7999","SE",2,"Nordeste",28005,"Tobias Barreto",117003,11405.917312633,13,24,13,11,7,17,0,0,0,0,0,24,13,11,7,17,11,9.34188756222791,11.6699548544768,0.411425752745779,2020-03-30,2020,3
"8000","SE",2,"Nordeste",28005,"Tobias Barreto",117003,11405.917312633,14,26,11,15,14,12,1,1,0,1,0,27,12,15,15,12,16,9.34188756222791,11.6699548544768,0.402909124698921,2020-04-06,2020,4
"8001","SE",2,"Nordeste",28005,"Tobias Barreto",117003,11405.917312633,15,29,15,14,16,13,0,0,0,0,0,29,15,14,16,13,20,9.34188756222791,11.6699548544768,0.388552805268716,2020-04-13,2020,4
"8002","SE",2,"Nordeste",28005,"Tobias Barreto",117003,11405.917312633,16,25,14,11,12,13,0,0,0,0,0,25,14,11,12,13,10,9.34188756222791,11.6699548544768,0.376120214127764,2020-04-20,2020,4
"8003","SE",2,"Nordeste",28005,"Tobias Barreto",117003,11405.917312633,17,25,12,13,14,11,0,0,0,0,0,25,12,13,14,11,9,9.34188756222791,11.6699548544768,0.362657536373913,2020-04-27,2020,4
"8004","SE",2,"Nordeste",28005,"Tobias Barreto",117003,11405.917312633,18,24,16,8,7,17,0,0,0,0,0,24,16,8,7,17,17,9.34188756222791,11.6699548544768,0.392897689651841,2020-05-04,2020,5
"8005","SE",2,"Nordeste",28005,"Tobias Barreto",117003,11405.917312633,19,32,20,12,13,19,0,0,0,0,0,32,20,12,13,19,17,9.34188756222791,11.6699548544768,0.400884304123285,2020-05-11,2020,5
"8006","SE",2,"Nordeste",28005,"Tobias Barreto",117003,11405.917312633,20,22,7,15,5,17,0,0,0,0,0,22,7,15,5,17,18,9.34188756222791,11.6699548544768,0.411153446209236,2020-05-18,2020,5
"8007","SE",2,"Nordeste",28005,"Tobias Barreto",117003,11405.917312633,21,28,19,9,12,16,0,0,0,0,0,28,19,9,12,16,18,9.34188756222791,11.6699548544768,0.379234500965369,2020-05-25,2020,5
"8008","SE",2,"Nordeste",28006,"Agreste de Lagarto",125030,14118.12233336,5,31,13,18,11,20,0,0,0,0,0,31,13,18,11,20,11,9.55521452298092,11.736308987489,0.268704597092669,2020-02-03,2020,2
"8009","SE",2,"Nordeste",28006,"Agreste de Lagarto",125030,14118.12233336,6,30,16,14,16,14,0,0,0,0,0,30,16,14,16,14,13,9.55521452298092,11.736308987489,0.266499590659008,2020-02-10,2020,2
"8010","SE",2,"Nordeste",28006,"Agreste de Lagarto",125030,14118.12233336,7,21,11,10,7,14,0,0,0,0,0,21,11,10,7,14,12,9.55521452298092,11.736308987489,0.281262571604652,2020-02-17,2020,2
"8011","SE",2,"Nordeste",28006,"Agreste de Lagarto",125030,14118.12233336,8,39,18,21,17,22,0,0,0,0,0,39,18,21,17,22,10,9.55521452298092,11.736308987489,0.320674861392418,2020-02-24,2020,2
"8012","SE",2,"Nordeste",28006,"Agreste de Lagarto",125030,14118.12233336,9,35,15,20,16,19,0,0,0,0,0,35,15,20,16,19,17,9.55521452298092,11.736308987489,0.300818873028029,2020-03-02,2020,3
"8013","SE",2,"Nordeste",28006,"Agreste de Lagarto",125030,14118.12233336,10,23,11,12,10,13,0,0,0,0,0,23,11,12,10,13,12,9.55521452298092,11.736308987489,0.319806406786056,2020-03-09,2020,3
"8014","SE",2,"Nordeste",28006,"Agreste de Lagarto",125030,14118.12233336,11,23,9,14,13,10,0,0,0,0,0,23,9,14,13,10,17,9.55521452298092,11.736308987489,0.375256444085071,2020-03-16,2020,3
"8015","SE",2,"Nordeste",28006,"Agreste de Lagarto",125030,14118.12233336,12,24,13,11,12,12,1,0,1,0,1,25,13,12,12,13,12,9.55521452298092,11.736308987489,0.480878126502472,2020-03-23,2020,3
"8016","SE",2,"Nordeste",28006,"Agreste de Lagarto",125030,14118.12233336,13,20,8,12,10,10,1,1,0,0,1,21,9,12,10,11,17,9.55521452298092,11.736308987489,0.41576643004395,2020-03-30,2020,3
"8017","SE",2,"Nordeste",28006,"Agreste de Lagarto",125030,14118.12233336,14,38,17,21,16,22,0,0,0,0,0,38,17,21,16,22,17,9.55521452298092,11.736308987489,0.413385308115206,2020-04-06,2020,4
"8018","SE",2,"Nordeste",28006,"Agreste de Lagarto",125030,14118.12233336,15,26,9,17,4,22,0,0,0,0,0,26,9,17,4,22,11,9.55521452298092,11.736308987489,0.397582252931876,2020-04-13,2020,4
"8019","SE",2,"Nordeste",28006,"Agreste de Lagarto",125030,14118.12233336,16,28,14,14,8,20,0,0,0,0,0,28,14,14,8,20,13,9.55521452298092,11.736308987489,0.401362371811529,2020-04-20,2020,4
"8020","SE",2,"Nordeste",28006,"Agreste de Lagarto",125030,14118.12233336,17,36,12,24,13,23,0,0,0,0,0,36,12,24,13,23,16,9.55521452298092,11.736308987489,0.378777314842783,2020-04-27,2020,4
"8021","SE",2,"Nordeste",28006,"Agreste de Lagarto",125030,14118.12233336,18,33,13,20,12,21,0,0,0,0,0,33,13,20,12,21,18,9.55521452298092,11.736308987489,0.396836549470134,2020-05-04,2020,5
"8022","SE",2,"Nordeste",28006,"Agreste de Lagarto",125030,14118.12233336,19,30,13,17,16,14,0,0,0,0,0,30,13,17,16,14,19,9.55521452298092,11.736308987489,0.403589223001223,2020-05-11,2020,5
"8023","SE",2,"Nordeste",28006,"Agreste de Lagarto",125030,14118.12233336,20,34,14,20,11,23,0,0,0,0,0,34,14,20,11,23,11,9.55521452298092,11.736308987489,0.413375757350765,2020-05-18,2020,5
"8024","SE",2,"Nordeste",28006,"Agreste de Lagarto",125030,14118.12233336,21,33,11,22,13,20,1,1,0,0,1,34,12,22,13,21,11,9.55521452298092,11.736308987489,0.390334322937819,2020-05-25,2020,5
"8025","SE",2,"Nordeste",28007,"Propriá",95157,12682.8341345356,5,24,12,12,10,14,0,0,0,0,0,24,12,12,10,14,17,9.44800471520344,11.4632834380687,0.264887939080294,2020-02-03,2020,2
"8026","SE",2,"Nordeste",28007,"Propriá",95157,12682.8341345356,6,32,16,16,16,16,1,0,1,1,0,33,16,17,17,16,11,9.44800471520344,11.4632834380687,0.257562492515417,2020-02-10,2020,2
"8027","SE",2,"Nordeste",28007,"Propriá",95157,12682.8341345356,7,18,8,10,9,9,1,1,0,0,1,19,9,10,9,10,13,9.44800471520344,11.4632834380687,0.273903645787636,2020-02-17,2020,2
"8028","SE",2,"Nordeste",28007,"Propriá",95157,12682.8341345356,8,15,6,9,7,8,0,0,0,0,0,15,6,9,7,8,8,9.44800471520344,11.4632834380687,0.327555948504406,2020-02-24,2020,2
"8029","SE",2,"Nordeste",28007,"Propriá",95157,12682.8341345356,9,31,7,24,16,15,1,0,1,0,1,32,7,25,16,16,11,9.44800471520344,11.4632834380687,0.298067391882531,2020-03-02,2020,3
"8030","SE",2,"Nordeste",28007,"Propriá",95157,12682.8341345356,10,15,5,10,8,7,0,0,0,0,0,15,5,10,8,7,12,9.44800471520344,11.4632834380687,0.31481644137924,2020-03-09,2020,3
"8031","SE",2,"Nordeste",28007,"Propriá",95157,12682.8341345356,11,17,7,10,12,5,0,0,0,0,0,17,7,10,12,5,20,9.44800471520344,11.4632834380687,0.383966867648511,2020-03-16,2020,3
"8032","SE",2,"Nordeste",28007,"Propriá",95157,12682.8341345356,12,15,8,7,9,6,0,0,0,0,0,15,8,7,9,6,12,9.44800471520344,11.4632834380687,0.473118000579334,2020-03-23,2020,3
"8033","SE",2,"Nordeste",28007,"Propriá",95157,12682.8341345356,13,20,6,14,11,9,0,0,0,0,0,20,6,14,11,9,23,9.44800471520344,11.4632834380687,0.406317390580834,2020-03-30,2020,3
"8034","SE",2,"Nordeste",28007,"Propriá",95157,12682.8341345356,14,22,4,18,8,14,1,0,1,0,1,23,4,19,8,15,8,9.44800471520344,11.4632834380687,0.396473999117668,2020-04-06,2020,4
"8035","SE",2,"Nordeste",28007,"Propriá",95157,12682.8341345356,15,16,8,8,11,5,0,0,0,0,0,16,8,8,11,5,8,9.44800471520344,11.4632834380687,0.378950162838372,2020-04-13,2020,4
"8036","SE",2,"Nordeste",28007,"Propriá",95157,12682.8341345356,16,24,11,13,11,13,1,1,0,0,1,25,12,13,11,14,17,9.44800471520344,11.4632834380687,0.378714159195253,2020-04-20,2020,4
"8037","SE",2,"Nordeste",28007,"Propriá",95157,12682.8341345356,17,25,9,16,12,13,0,0,0,0,0,25,9,16,12,13,8,9.44800471520344,11.4632834380687,0.362985395117969,2020-04-27,2020,4
"8038","SE",2,"Nordeste",28007,"Propriá",95157,12682.8341345356,18,21,11,10,10,11,1,1,0,0,1,22,12,10,10,12,9,9.44800471520344,11.4632834380687,0.37253386205502,2020-05-04,2020,5
"8039","SE",2,"Nordeste",28007,"Propriá",95157,12682.8341345356,19,23,9,14,8,15,0,0,0,0,0,23,9,14,8,15,16,9.44800471520344,11.4632834380687,0.390559915066725,2020-05-11,2020,5
"8040","SE",2,"Nordeste",28007,"Propriá",95157,12682.8341345356,20,25,13,12,13,12,1,0,1,0,1,26,13,13,13,13,8,9.44800471520344,11.4632834380687,0.400920794567449,2020-05-18,2020,5
"8041","SE",2,"Nordeste",28007,"Propriá",95157,12682.8341345356,21,29,12,17,17,12,0,0,0,0,0,29,12,17,17,12,14,9.44800471520344,11.4632834380687,0.384035854886719,2020-05-25,2020,5
"8042","SE",2,"Nordeste",28008,"Cotinguiba",52622,13833.0054133252,5,18,8,10,11,7,0,0,0,0,0,18,8,10,11,7,13,9.53481271220888,10.8708895622338,0.272394353962562,2020-02-03,2020,2
"8043","SE",2,"Nordeste",28008,"Cotinguiba",52622,13833.0054133252,6,15,7,8,10,5,0,0,0,0,0,15,7,8,10,5,4,9.53481271220888,10.8708895622338,0.27727681097118,2020-02-10,2020,2
"8044","SE",2,"Nordeste",28008,"Cotinguiba",52622,13833.0054133252,7,14,6,8,6,8,0,0,0,0,0,14,6,8,6,8,4,9.53481271220888,10.8708895622338,0.279513132194317,2020-02-17,2020,2
"8045","SE",2,"Nordeste",28008,"Cotinguiba",52622,13833.0054133252,8,16,12,4,7,9,0,0,0,0,0,16,12,4,7,9,4,9.53481271220888,10.8708895622338,0.321830779845814,2020-02-24,2020,2
"8046","SE",2,"Nordeste",28008,"Cotinguiba",52622,13833.0054133252,9,20,9,11,8,12,0,0,0,0,0,20,9,11,8,12,5,9.53481271220888,10.8708895622338,0.306064401835091,2020-03-02,2020,3
"8047","SE",2,"Nordeste",28008,"Cotinguiba",52622,13833.0054133252,10,13,8,5,9,4,0,0,0,0,0,13,8,5,9,4,7,9.53481271220888,10.8708895622338,0.321068793802429,2020-03-09,2020,3
"8048","SE",2,"Nordeste",28008,"Cotinguiba",52622,13833.0054133252,11,17,9,8,8,9,0,0,0,0,0,17,9,8,8,9,7,9.53481271220888,10.8708895622338,0.385244253375651,2020-03-16,2020,3
"8049","SE",2,"Nordeste",28008,"Cotinguiba",52622,13833.0054133252,12,12,6,6,7,5,0,0,0,0,0,12,6,6,7,5,8,9.53481271220888,10.8708895622338,0.481463332784593,2020-03-23,2020,3
"8050","SE",2,"Nordeste",28008,"Cotinguiba",52622,13833.0054133252,13,14,12,2,6,8,1,0,1,0,1,15,12,3,6,9,3,9.53481271220888,10.8708895622338,0.430685013186801,2020-03-30,2020,3
"8051","SE",2,"Nordeste",28008,"Cotinguiba",52622,13833.0054133252,14,16,10,6,5,11,1,1,0,0,1,17,11,6,5,12,4,9.53481271220888,10.8708895622338,0.409844084955528,2020-04-06,2020,4
"8052","SE",2,"Nordeste",28008,"Cotinguiba",52622,13833.0054133252,15,8,3,5,5,3,0,0,0,0,0,8,3,5,5,3,5,9.53481271220888,10.8708895622338,0.405285804140227,2020-04-13,2020,4
"8053","SE",2,"Nordeste",28008,"Cotinguiba",52622,13833.0054133252,16,16,7,9,8,8,0,0,0,0,0,16,7,9,8,8,4,9.53481271220888,10.8708895622338,0.403902685273107,2020-04-20,2020,4
"8054","SE",2,"Nordeste",28008,"Cotinguiba",52622,13833.0054133252,17,11,4,7,4,7,0,0,0,0,0,11,4,7,4,7,5,9.53481271220888,10.8708895622338,0.382828320479799,2020-04-27,2020,4
"8055","SE",2,"Nordeste",28008,"Cotinguiba",52622,13833.0054133252,18,25,14,11,12,13,0,0,0,0,0,25,14,11,12,13,4,9.53481271220888,10.8708895622338,0.389456429746556,2020-05-04,2020,5
"8056","SE",2,"Nordeste",28008,"Cotinguiba",52622,13833.0054133252,19,19,10,9,8,11,0,0,0,0,0,19,10,9,8,11,7,9.53481271220888,10.8708895622338,0.408669584134447,2020-05-11,2020,5
"8057","SE",2,"Nordeste",28008,"Cotinguiba",52622,13833.0054133252,20,20,15,5,15,5,0,0,0,0,0,20,15,5,15,5,5,9.53481271220888,10.8708895622338,0.417908662178322,2020-05-18,2020,5
"8058","SE",2,"Nordeste",28008,"Cotinguiba",52622,13833.0054133252,21,17,11,6,5,12,0,0,0,0,0,17,11,6,5,12,4,9.53481271220888,10.8708895622338,0.394100809889614,2020-05-25,2020,5
"8059","SE",2,"Nordeste",28009,"Japaratuba",60016,14918.7843196814,5,12,1,11,7,5,0,0,0,0,0,12,1,11,7,5,3,9.61037639052397,11.0023664723217,0.261737979896768,2020-02-03,2020,2
"8060","SE",2,"Nordeste",28009,"Japaratuba",60016,14918.7843196814,6,17,7,10,7,10,2,2,0,1,1,19,9,10,8,11,12,9.61037639052397,11.0023664723217,0.25383932720691,2020-02-10,2020,2
"8061","SE",2,"Nordeste",28009,"Japaratuba",60016,14918.7843196814,7,13,7,6,7,6,0,0,0,0,0,13,7,6,7,6,3,9.61037639052397,11.0023664723217,0.268701961809636,2020-02-17,2020,2
"8062","SE",2,"Nordeste",28009,"Japaratuba",60016,14918.7843196814,8,11,7,4,7,4,1,0,1,0,1,12,7,5,7,5,8,9.61037639052397,11.0023664723217,0.316684640699337,2020-02-24,2020,2
"8063","SE",2,"Nordeste",28009,"Japaratuba",60016,14918.7843196814,9,11,6,5,8,3,0,0,0,0,0,11,6,5,8,3,5,9.61037639052397,11.0023664723217,0.284755203831558,2020-03-02,2020,3
"8064","SE",2,"Nordeste",28009,"Japaratuba",60016,14918.7843196814,10,16,11,5,6,10,0,0,0,0,0,16,11,5,6,10,9,9.61037639052397,11.0023664723217,0.31256641495253,2020-03-09,2020,3
"8065","SE",2,"Nordeste",28009,"Japaratuba",60016,14918.7843196814,11,11,5,6,6,5,0,0,0,0,0,11,5,6,6,5,11,9.61037639052397,11.0023664723217,0.376729077075103,2020-03-16,2020,3
"8066","SE",2,"Nordeste",28009,"Japaratuba",60016,14918.7843196814,12,18,8,10,11,7,0,0,0,0,0,18,8,10,11,7,6,9.61037639052397,11.0023664723217,0.463725108572741,2020-03-23,2020,3
"8067","SE",2,"Nordeste",28009,"Japaratuba",60016,14918.7843196814,13,15,6,9,7,8,0,0,0,0,0,15,6,9,7,8,13,9.61037639052397,11.0023664723217,0.409724829926375,2020-03-30,2020,3
"8068","SE",2,"Nordeste",28009,"Japaratuba",60016,14918.7843196814,14,12,5,7,4,8,0,0,0,0,0,12,5,7,4,8,4,9.61037639052397,11.0023664723217,0.399042567277939,2020-04-06,2020,4
"8069","SE",2,"Nordeste",28009,"Japaratuba",60016,14918.7843196814,15,17,5,12,4,13,0,0,0,0,0,17,5,12,4,13,4,9.61037639052397,11.0023664723217,0.397787148896664,2020-04-13,2020,4
"8070","SE",2,"Nordeste",28009,"Japaratuba",60016,14918.7843196814,16,22,12,10,15,7,0,0,0,0,0,22,12,10,15,7,10,9.61037639052397,11.0023664723217,0.388476760122699,2020-04-20,2020,4
"8071","SE",2,"Nordeste",28009,"Japaratuba",60016,14918.7843196814,17,13,3,10,3,10,0,0,0,0,0,13,3,10,3,10,4,9.61037639052397,11.0023664723217,0.369618350040586,2020-04-27,2020,4
"8072","SE",2,"Nordeste",28009,"Japaratuba",60016,14918.7843196814,18,15,9,6,10,5,0,0,0,0,0,15,9,6,10,5,6,9.61037639052397,11.0023664723217,0.380636980130507,2020-05-04,2020,5
"8073","SE",2,"Nordeste",28009,"Japaratuba",60016,14918.7843196814,19,16,7,9,5,11,0,0,0,0,0,16,7,9,5,11,14,9.61037639052397,11.0023664723217,0.395310968525551,2020-05-11,2020,5
"8074","SE",2,"Nordeste",28009,"Japaratuba",60016,14918.7843196814,20,20,8,12,8,12,0,0,0,0,0,20,8,12,8,12,11,9.61037639052397,11.0023664723217,0.420321188097611,2020-05-18,2020,5
"8075","SE",2,"Nordeste",28009,"Japaratuba",60016,14918.7843196814,21,20,10,10,8,12,0,0,0,0,0,20,10,10,8,12,8,9.61037639052397,11.0023664723217,0.400700739385246,2020-05-25,2020,5
"8076","SE",2,"Nordeste",28010,"Baixo Cotinguiba",101115,23182.7916375414,5,19,7,12,9,10,0,0,0,0,0,19,7,12,9,10,14,10.0511655426682,11.5240137619556,0.270927852079052,2020-02-03,2020,2
"8077","SE",2,"Nordeste",28010,"Baixo Cotinguiba",101115,23182.7916375414,6,25,7,18,12,13,0,0,0,0,0,25,7,18,12,13,10,10.0511655426682,11.5240137619556,0.266615069331177,2020-02-10,2020,2
"8078","SE",2,"Nordeste",28010,"Baixo Cotinguiba",101115,23182.7916375414,7,23,7,16,12,11,0,0,0,0,0,23,7,16,12,11,14,10.0511655426682,11.5240137619556,0.285566436344804,2020-02-17,2020,2
"8079","SE",2,"Nordeste",28010,"Baixo Cotinguiba",101115,23182.7916375414,8,23,11,12,13,10,0,0,0,0,0,23,11,12,13,10,11,10.0511655426682,11.5240137619556,0.338091341336155,2020-02-24,2020,2
"8080","SE",2,"Nordeste",28010,"Baixo Cotinguiba",101115,23182.7916375414,9,23,8,15,8,15,0,0,0,0,0,23,8,15,8,15,3,10.0511655426682,11.5240137619556,0.311419061889412,2020-03-02,2020,3
"8081","SE",2,"Nordeste",28010,"Baixo Cotinguiba",101115,23182.7916375414,10,22,10,12,9,13,0,0,0,0,0,22,10,12,9,13,7,10.0511655426682,11.5240137619556,0.328481252199142,2020-03-09,2020,3
"8082","SE",2,"Nordeste",28010,"Baixo Cotinguiba",101115,23182.7916375414,11,27,10,17,15,12,0,0,0,0,0,27,10,17,15,12,14,10.0511655426682,11.5240137619556,0.390625458424304,2020-03-16,2020,3
"8083","SE",2,"Nordeste",28010,"Baixo Cotinguiba",101115,23182.7916375414,12,30,12,18,11,19,0,0,0,0,0,30,12,18,11,19,10,10.0511655426682,11.5240137619556,0.470680530275141,2020-03-23,2020,3
"8084","SE",2,"Nordeste",28010,"Baixo Cotinguiba",101115,23182.7916375414,13,23,14,9,13,10,0,0,0,0,0,23,14,9,13,10,12,10.0511655426682,11.5240137619556,0.428998788687447,2020-03-30,2020,3
"8085","SE",2,"Nordeste",28010,"Baixo Cotinguiba",101115,23182.7916375414,14,24,11,13,11,13,0,0,0,0,0,24,11,13,11,13,11,10.0511655426682,11.5240137619556,0.407099436929709,2020-04-06,2020,4
"8086","SE",2,"Nordeste",28010,"Baixo Cotinguiba",101115,23182.7916375414,15,30,14,16,12,18,0,0,0,0,0,30,14,16,12,18,16,10.0511655426682,11.5240137619556,0.407503162038967,2020-04-13,2020,4
"8087","SE",2,"Nordeste",28010,"Baixo Cotinguiba",101115,23182.7916375414,16,20,7,13,11,9,0,0,0,0,0,20,7,13,11,9,9,10.0511655426682,11.5240137619556,0.396385556825474,2020-04-20,2020,4
"8088","SE",2,"Nordeste",28010,"Baixo Cotinguiba",101115,23182.7916375414,17,26,13,13,14,12,0,0,0,0,0,26,13,13,14,12,6,10.0511655426682,11.5240137619556,0.373754113772343,2020-04-27,2020,4
"8089","SE",2,"Nordeste",28010,"Baixo Cotinguiba",101115,23182.7916375414,18,34,12,22,17,17,0,0,0,0,0,34,12,22,17,17,10,10.0511655426682,11.5240137619556,0.393610267044037,2020-05-04,2020,5
"8090","SE",2,"Nordeste",28010,"Baixo Cotinguiba",101115,23182.7916375414,19,25,15,10,13,12,0,0,0,0,0,25,15,10,13,12,10,10.0511655426682,11.5240137619556,0.405862972194175,2020-05-11,2020,5
"8091","SE",2,"Nordeste",28010,"Baixo Cotinguiba",101115,23182.7916375414,20,26,9,17,15,11,0,0,0,0,0,26,9,17,15,11,15,10.0511655426682,11.5240137619556,0.41624438467478,2020-05-18,2020,5
"8092","SE",2,"Nordeste",28010,"Baixo Cotinguiba",101115,23182.7916375414,21,25,7,18,9,16,2,1,1,1,1,27,8,19,10,17,8,10.0511655426682,11.5240137619556,0.396814530810166,2020-05-25,2020,5
"8093","SE",2,"Nordeste",28011,"Aracaju",972637,22354.867457407,5,234,68,166,93,141,2,1,1,1,1,236,69,167,94,142,99,10.0147993596595,13.7877662185889,0.260301623591597,2020-02-03,2020,2
"8094","SE",2,"Nordeste",28011,"Aracaju",972637,22354.867457407,6,226,61,165,67,159,0,0,0,0,0,226,61,165,67,159,111,10.0147993596595,13.7877662185889,0.256160057478666,2020-02-10,2020,2
"8095","SE",2,"Nordeste",28011,"Aracaju",972637,22354.867457407,7,236,75,161,73,163,1,0,1,0,1,237,75,162,73,164,95,10.0147993596595,13.7877662185889,0.27504930234092,2020-02-17,2020,2
"8096","SE",2,"Nordeste",28011,"Aracaju",972637,22354.867457407,8,198,53,145,87,111,3,1,2,0,3,201,54,147,87,114,104,10.0147993596595,13.7877662185889,0.330509050735521,2020-02-24,2020,2
"8097","SE",2,"Nordeste",28011,"Aracaju",972637,22354.867457407,9,205,61,144,87,118,1,1,0,1,0,206,62,144,88,118,98,10.0147993596595,13.7877662185889,0.294008399391226,2020-03-02,2020,3
"8098","SE",2,"Nordeste",28011,"Aracaju",972637,22354.867457407,10,188,47,141,65,123,2,2,0,1,1,190,49,141,66,124,127,10.0147993596595,13.7877662185889,0.310413813111329,2020-03-09,2020,3
"8099","SE",2,"Nordeste",28011,"Aracaju",972637,22354.867457407,11,195,61,134,76,119,0,0,0,0,0,195,61,134,76,119,131,10.0147993596595,13.7877662185889,0.40891937247771,2020-03-16,2020,3
"8100","SE",2,"Nordeste",28011,"Aracaju",972637,22354.867457407,12,196,57,139,72,124,4,1,3,1,3,200,58,142,73,127,116,10.0147993596595,13.7877662185889,0.536350694773658,2020-03-23,2020,3
"8101","SE",2,"Nordeste",28011,"Aracaju",972637,22354.867457407,13,223,69,154,85,138,5,1,4,0,5,228,70,158,85,143,120,10.0147993596595,13.7877662185889,0.470027512656821,2020-03-30,2020,3
"8102","SE",2,"Nordeste",28011,"Aracaju",972637,22354.867457407,14,234,60,174,75,159,8,1,7,1,7,242,61,181,76,166,113,10.0147993596595,13.7877662185889,0.462584194335866,2020-04-06,2020,4
"8103","SE",2,"Nordeste",28011,"Aracaju",972637,22354.867457407,15,212,55,157,75,137,1,1,0,0,1,213,56,157,75,138,108,10.0147993596595,13.7877662185889,0.447816933356286,2020-04-13,2020,4
"8104","SE",2,"Nordeste",28011,"Aracaju",972637,22354.867457407,16,220,67,153,98,122,2,0,2,0,2,222,67,155,98,124,104,10.0147993596595,13.7877662185889,0.449274761955975,2020-04-20,2020,4
"8105","SE",2,"Nordeste",28011,"Aracaju",972637,22354.867457407,17,217,59,158,76,141,1,0,1,0,1,218,59,159,76,142,90,10.0147993596595,13.7877662185889,0.420122162804685,2020-04-27,2020,4
"8106","SE",2,"Nordeste",28011,"Aracaju",972637,22354.867457407,18,210,52,158,72,138,0,0,0,0,0,210,52,158,72,138,99,10.0147993596595,13.7877662185889,0.421197490457334,2020-05-04,2020,5
"8107","SE",2,"Nordeste",28011,"Aracaju",972637,22354.867457407,19,206,64,142,76,130,4,2,2,2,2,210,66,144,78,132,118,10.0147993596595,13.7877662185889,0.435534292620782,2020-05-11,2020,5
"8108","SE",2,"Nordeste",28011,"Aracaju",972637,22354.867457407,20,234,60,174,73,161,4,0,4,0,4,238,60,178,73,165,124,10.0147993596595,13.7877662185889,0.447315475871511,2020-05-18,2020,5
"8109","SE",2,"Nordeste",28011,"Aracaju",972637,22354.867457407,21,230,56,174,92,138,4,2,2,1,3,234,58,176,93,141,161,10.0147993596595,13.7877662185889,0.430862558990957,2020-05-25,2020,5
"8110","SE",2,"Nordeste",28012,"Boquim",165816,10707.5937505428,5,34,14,20,10,24,1,1,0,0,1,35,15,20,10,25,25,9.27870846504707,12.0186340188367,0.268505378847419,2020-02-03,2020,2
"8111","SE",2,"Nordeste",28012,"Boquim",165816,10707.5937505428,6,27,7,20,7,20,0,0,0,0,0,27,7,20,7,20,14,9.27870846504707,12.0186340188367,0.258727693030459,2020-02-10,2020,2
"8112","SE",2,"Nordeste",28012,"Boquim",165816,10707.5937505428,7,38,14,24,13,25,0,0,0,0,0,38,14,24,13,25,20,9.27870846504707,12.0186340188367,0.27209135458312,2020-02-17,2020,2
"8113","SE",2,"Nordeste",28012,"Boquim",165816,10707.5937505428,8,42,22,20,24,18,0,0,0,0,0,42,22,20,24,18,27,9.27870846504707,12.0186340188367,0.314394149342784,2020-02-24,2020,2
"8114","SE",2,"Nordeste",28012,"Boquim",165816,10707.5937505428,9,40,18,22,17,23,0,0,0,0,0,40,18,22,17,23,15,9.27870846504707,12.0186340188367,0.294669397323393,2020-03-02,2020,3
"8115","SE",2,"Nordeste",28012,"Boquim",165816,10707.5937505428,10,41,23,18,23,18,1,1,0,1,0,42,24,18,24,18,23,9.27870846504707,12.0186340188367,0.31379645241436,2020-03-09,2020,3
"8116","SE",2,"Nordeste",28012,"Boquim",165816,10707.5937505428,11,39,24,15,17,22,1,1,0,1,0,40,25,15,18,22,29,9.27870846504707,12.0186340188367,0.374557018027201,2020-03-16,2020,3
"8117","SE",2,"Nordeste",28012,"Boquim",165816,10707.5937505428,12,30,11,19,14,16,0,0,0,0,0,30,11,19,14,16,11,9.27870846504707,12.0186340188367,0.475757172528325,2020-03-23,2020,3
"8118","SE",2,"Nordeste",28012,"Boquim",165816,10707.5937505428,13,33,12,21,19,14,3,2,1,2,1,36,14,22,21,15,24,9.27870846504707,12.0186340188367,0.409735872013836,2020-03-30,2020,3
"8119","SE",2,"Nordeste",28012,"Boquim",165816,10707.5937505428,14,40,15,25,19,21,1,0,1,0,1,41,15,26,19,22,19,9.27870846504707,12.0186340188367,0.395257416572525,2020-04-06,2020,4
"8120","SE",2,"Nordeste",28012,"Boquim",165816,10707.5937505428,15,37,17,20,18,19,0,0,0,0,0,37,17,20,18,19,18,9.27870846504707,12.0186340188367,0.392029834205301,2020-04-13,2020,4
"8121","SE",2,"Nordeste",28012,"Boquim",165816,10707.5937505428,16,33,18,15,16,17,0,0,0,0,0,33,18,15,16,17,14,9.27870846504707,12.0186340188367,0.399588430570049,2020-04-20,2020,4
"8122","SE",2,"Nordeste",28012,"Boquim",165816,10707.5937505428,17,38,17,21,16,22,0,0,0,0,0,38,17,21,16,22,18,9.27870846504707,12.0186340188367,0.3758830289658,2020-04-27,2020,4
"8123","SE",2,"Nordeste",28012,"Boquim",165816,10707.5937505428,18,32,9,23,18,14,1,1,0,0,1,33,10,23,18,15,14,9.27870846504707,12.0186340188367,0.392713212928909,2020-05-04,2020,5
"8124","SE",2,"Nordeste",28012,"Boquim",165816,10707.5937505428,19,50,25,25,25,25,2,1,1,1,1,52,26,26,26,26,16,9.27870846504707,12.0186340188367,0.393826164467039,2020-05-11,2020,5
"8125","SE",2,"Nordeste",28012,"Boquim",165816,10707.5937505428,20,39,18,21,19,20,0,0,0,0,0,39,18,21,19,20,35,9.27870846504707,12.0186340188367,0.404089522691674,2020-05-18,2020,5
"8126","SE",2,"Nordeste",28012,"Boquim",165816,10707.5937505428,21,41,20,21,20,21,0,0,0,0,0,41,20,21,20,21,22,9.27870846504707,12.0186340188367,0.381004424594291,2020-05-25,2020,5
"8127","SE",2,"Nordeste",28013,"Estância",136535,21883.4693089684,5,34,14,20,19,15,0,0,0,0,0,34,14,20,19,15,16,9.99348680470545,11.8243362709961,0.265654054971613,2020-02-03,2020,2
"8128","SE",2,"Nordeste",28013,"Estância",136535,21883.4693089684,6,27,12,15,11,16,0,0,0,0,0,27,12,15,11,16,24,9.99348680470545,11.8243362709961,0.249030208957819,2020-02-10,2020,2
"8129","SE",2,"Nordeste",28013,"Estância",136535,21883.4693089684,7,28,12,16,8,20,0,0,0,0,0,28,12,16,8,20,14,9.99348680470545,11.8243362709961,0.267454657041101,2020-02-17,2020,2
"8130","SE",2,"Nordeste",28013,"Estância",136535,21883.4693089684,8,26,11,15,10,16,0,0,0,0,0,26,11,15,10,16,10,9.99348680470545,11.8243362709961,0.322900396158026,2020-02-24,2020,2
"8131","SE",2,"Nordeste",28013,"Estância",136535,21883.4693089684,9,26,9,17,14,12,0,0,0,0,0,26,9,17,14,12,15,9.99348680470545,11.8243362709961,0.292370165729938,2020-03-02,2020,3
"8132","SE",2,"Nordeste",28013,"Estância",136535,21883.4693089684,10,34,12,22,13,21,0,0,0,0,0,34,12,22,13,21,12,9.99348680470545,11.8243362709961,0.316721104410204,2020-03-09,2020,3
"8133","SE",2,"Nordeste",28013,"Estância",136535,21883.4693089684,11,27,13,14,11,16,0,0,0,0,0,27,13,14,11,16,13,9.99348680470545,11.8243362709961,0.377294479476962,2020-03-16,2020,3
"8134","SE",2,"Nordeste",28013,"Estância",136535,21883.4693089684,12,22,10,12,11,11,2,1,1,2,0,24,11,13,13,11,17,9.99348680470545,11.8243362709961,0.486063876848331,2020-03-23,2020,3
"8135","SE",2,"Nordeste",28013,"Estância",136535,21883.4693089684,13,35,15,20,15,20,2,1,1,1,1,37,16,21,16,21,15,9.99348680470545,11.8243362709961,0.416622034994708,2020-03-30,2020,3
"8136","SE",2,"Nordeste",28013,"Estância",136535,21883.4693089684,14,45,20,25,13,32,0,0,0,0,0,45,20,25,13,32,16,9.99348680470545,11.8243362709961,0.40223313722397,2020-04-06,2020,4
"8137","SE",2,"Nordeste",28013,"Estância",136535,21883.4693089684,15,29,13,16,11,18,0,0,0,0,0,29,13,16,11,18,16,9.99348680470545,11.8243362709961,0.391569115189934,2020-04-13,2020,4
"8138","SE",2,"Nordeste",28013,"Estância",136535,21883.4693089684,16,40,17,23,18,22,0,0,0,0,0,40,17,23,18,22,18,9.99348680470545,11.8243362709961,0.42157084843638,2020-04-20,2020,4
"8139","SE",2,"Nordeste",28013,"Estância",136535,21883.4693089684,17,36,17,19,15,21,0,0,0,0,0,36,17,19,15,21,17,9.99348680470545,11.8243362709961,0.382051770888379,2020-04-27,2020,4
"8140","SE",2,"Nordeste",28013,"Estância",136535,21883.4693089684,18,33,16,17,12,21,1,0,1,1,0,34,16,18,13,21,8,9.99348680470545,11.8243362709961,0.402174056003862,2020-05-04,2020,5
"8141","SE",2,"Nordeste",28013,"Estância",136535,21883.4693089684,19,26,9,17,14,12,1,1,0,1,0,27,10,17,15,12,22,9.99348680470545,11.8243362709961,0.412492857320768,2020-05-11,2020,5
"8142","SE",2,"Nordeste",28013,"Estância",136535,21883.4693089684,20,35,13,22,20,15,0,0,0,0,0,35,13,22,20,15,20,9.99348680470545,11.8243362709961,0.422663181931134,2020-05-18,2020,5
"8143","SE",2,"Nordeste",28013,"Estância",136535,21883.4693089684,21,38,15,23,21,17,0,0,0,0,0,38,15,23,21,17,22,9.99348680470545,11.8243362709961,0.389092007670995,2020-05-25,2020,5
"8144","SP",3,"Sudeste",35001,"Jales",156088,28160.0813747373,5,19,0,19,5,14,0,0,0,0,0,19,0,19,5,14,22,10.2456606999957,11.9581752297497,0.279626086629295,2020-02-03,2020,2
"8145","SP",3,"Sudeste",35001,"Jales",156088,28160.0813747373,6,36,3,33,15,21,0,0,0,0,0,36,3,33,15,21,32,10.2456606999957,11.9581752297497,0.27731941493657,2020-02-10,2020,2
"8146","SP",3,"Sudeste",35001,"Jales",156088,28160.0813747373,7,30,8,22,7,23,0,0,0,0,0,30,8,22,7,23,33,10.2456606999957,11.9581752297497,0.292550046728905,2020-02-17,2020,2
"8147","SP",3,"Sudeste",35001,"Jales",156088,28160.0813747373,8,34,3,31,14,20,0,0,0,0,0,34,3,31,14,20,29,10.2456606999957,11.9581752297497,0.327758516502509,2020-02-24,2020,2
"8148","SP",3,"Sudeste",35001,"Jales",156088,28160.0813747373,9,33,3,30,10,23,0,0,0,0,0,33,3,30,10,23,25,10.2456606999957,11.9581752297497,0.309310254339993,2020-03-02,2020,3
"8149","SP",3,"Sudeste",35001,"Jales",156088,28160.0813747373,10,25,3,22,12,13,1,0,1,1,0,26,3,23,13,13,36,10.2456606999957,11.9581752297497,0.321064320474732,2020-03-09,2020,3
"8150","SP",3,"Sudeste",35001,"Jales",156088,28160.0813747373,11,40,6,34,15,25,0,0,0,0,0,40,6,34,15,25,26,10.2456606999957,11.9581752297497,0.386159456703842,2020-03-16,2020,3
"8151","SP",3,"Sudeste",35001,"Jales",156088,28160.0813747373,12,30,4,26,8,22,1,0,1,0,1,31,4,27,8,23,24,10.2456606999957,11.9581752297497,0.484583530581981,2020-03-23,2020,3
"8152","SP",3,"Sudeste",35001,"Jales",156088,28160.0813747373,13,25,1,24,6,19,2,1,1,1,1,27,2,25,7,20,27,10.2456606999957,11.9581752297497,0.435346762182,2020-03-30,2020,3
"8153","SP",3,"Sudeste",35001,"Jales",156088,28160.0813747373,14,32,4,28,11,21,0,0,0,0,0,32,4,28,11,21,24,10.2456606999957,11.9581752297497,0.423669708918454,2020-04-06,2020,4
"8154","SP",3,"Sudeste",35001,"Jales",156088,28160.0813747373,15,26,3,23,13,13,0,0,0,0,0,26,3,23,13,13,19,10.2456606999957,11.9581752297497,0.404853966319202,2020-04-13,2020,4
"8155","SP",3,"Sudeste",35001,"Jales",156088,28160.0813747373,16,34,5,29,15,19,1,0,1,0,1,35,5,30,15,20,21,10.2456606999957,11.9581752297497,0.405242280274127,2020-04-20,2020,4
"8156","SP",3,"Sudeste",35001,"Jales",156088,28160.0813747373,17,33,4,29,8,25,0,0,0,0,0,33,4,29,8,25,19,10.2456606999957,11.9581752297497,0.391668013965957,2020-04-27,2020,4
"8157","SP",3,"Sudeste",35001,"Jales",156088,28160.0813747373,18,42,6,36,18,24,0,0,0,0,0,42,6,36,18,24,18,10.2456606999957,11.9581752297497,0.369836375462044,2020-05-04,2020,5
"8158","SP",3,"Sudeste",35001,"Jales",156088,28160.0813747373,19,37,6,31,12,25,0,0,0,0,0,37,6,31,12,25,30,10.2456606999957,11.9581752297497,0.375412357052437,2020-05-11,2020,5
"8159","SP",3,"Sudeste",35001,"Jales",156088,28160.0813747373,20,29,1,28,7,22,0,0,0,0,0,29,1,28,7,22,29,10.2456606999957,11.9581752297497,0.372524683802211,2020-05-18,2020,5
"8160","SP",3,"Sudeste",35001,"Jales",156088,28160.0813747373,21,36,8,28,14,22,0,0,0,0,0,36,8,28,14,22,34,10.2456606999957,11.9581752297497,0.376672551732988,2020-05-25,2020,5
"8161","SP",3,"Sudeste",35002,"Fernandópolis",111604,33720.7193090749,5,10,2,8,4,6,0,0,0,0,0,10,2,8,4,6,18,10.4258677437114,11.6227121705809,0.278745796562584,2020-02-03,2020,2
"8162","SP",3,"Sudeste",35002,"Fernandópolis",111604,33720.7193090749,6,20,4,16,7,13,0,0,0,0,0,20,4,16,7,13,17,10.4258677437114,11.6227121705809,0.272655151393263,2020-02-10,2020,2
"8163","SP",3,"Sudeste",35002,"Fernandópolis",111604,33720.7193090749,7,21,1,20,9,12,0,0,0,0,0,21,1,20,9,12,10,10.4258677437114,11.6227121705809,0.289482444363462,2020-02-17,2020,2
"8164","SP",3,"Sudeste",35002,"Fernandópolis",111604,33720.7193090749,8,20,2,18,8,12,0,0,0,0,0,20,2,18,8,12,22,10.4258677437114,11.6227121705809,0.323283842389085,2020-02-24,2020,2
"8165","SP",3,"Sudeste",35002,"Fernandópolis",111604,33720.7193090749,9,19,0,19,4,15,0,0,0,0,0,19,0,19,4,15,19,10.4258677437114,11.6227121705809,0.314565850392101,2020-03-02,2020,3
"8166","SP",3,"Sudeste",35002,"Fernandópolis",111604,33720.7193090749,10,16,2,14,5,11,1,0,1,0,1,17,2,15,5,12,17,10.4258677437114,11.6227121705809,0.317954101374482,2020-03-09,2020,3
"8167","SP",3,"Sudeste",35002,"Fernandópolis",111604,33720.7193090749,11,17,1,16,7,10,1,0,1,1,0,18,1,17,8,10,31,10.4258677437114,11.6227121705809,0.392095134013139,2020-03-16,2020,3
"8168","SP",3,"Sudeste",35002,"Fernandópolis",111604,33720.7193090749,12,17,2,15,2,15,0,0,0,0,0,17,2,15,2,15,19,10.4258677437114,11.6227121705809,0.470123734992473,2020-03-23,2020,3
"8169","SP",3,"Sudeste",35002,"Fernandópolis",111604,33720.7193090749,13,18,3,15,7,11,0,0,0,0,0,18,3,15,7,11,12,10.4258677437114,11.6227121705809,0.434847103215294,2020-03-30,2020,3
"8170","SP",3,"Sudeste",35002,"Fernandópolis",111604,33720.7193090749,14,23,2,21,4,19,1,0,1,0,1,24,2,22,4,20,15,10.4258677437114,11.6227121705809,0.430823096299448,2020-04-06,2020,4
"8171","SP",3,"Sudeste",35002,"Fernandópolis",111604,33720.7193090749,15,19,1,18,8,11,0,0,0,0,0,19,1,18,8,11,17,10.4258677437114,11.6227121705809,0.405214333052277,2020-04-13,2020,4
"8172","SP",3,"Sudeste",35002,"Fernandópolis",111604,33720.7193090749,16,16,2,14,7,9,0,0,0,0,0,16,2,14,7,9,12,10.4258677437114,11.6227121705809,0.407246792392282,2020-04-20,2020,4
"8173","SP",3,"Sudeste",35002,"Fernandópolis",111604,33720.7193090749,17,20,3,17,10,10,0,0,0,0,0,20,3,17,10,10,17,10.4258677437114,11.6227121705809,0.393052201915527,2020-04-27,2020,4
"8174","SP",3,"Sudeste",35002,"Fernandópolis",111604,33720.7193090749,18,31,1,30,6,25,0,0,0,0,0,31,1,30,6,25,14,10.4258677437114,11.6227121705809,0.370176972320207,2020-05-04,2020,5
"8175","SP",3,"Sudeste",35002,"Fernandópolis",111604,33720.7193090749,19,30,3,27,7,23,0,0,0,0,0,30,3,27,7,23,19,10.4258677437114,11.6227121705809,0.371654156781729,2020-05-11,2020,5
"8176","SP",3,"Sudeste",35002,"Fernandópolis",111604,33720.7193090749,20,24,2,22,5,19,0,0,0,0,0,24,2,22,5,19,25,10.4258677437114,11.6227121705809,0.372521582861759,2020-05-18,2020,5
"8177","SP",3,"Sudeste",35002,"Fernandópolis",111604,33720.7193090749,21,29,3,26,10,19,0,0,0,0,0,29,3,26,10,19,24,10.4258677437114,11.6227121705809,0.377534349333571,2020-05-25,2020,5
"8178","SP",3,"Sudeste",35003,"Votuporanga",155580,29720.3353748554,5,27,2,25,8,19,1,0,1,1,0,28,2,26,9,19,23,10.2995867832517,11.9549153477608,0.283217968344522,2020-02-03,2020,2
"8179","SP",3,"Sudeste",35003,"Votuporanga",155580,29720.3353748554,6,35,3,32,14,21,0,0,0,0,0,35,3,32,14,21,16,10.2995867832517,11.9549153477608,0.281421799583247,2020-02-10,2020,2
"8180","SP",3,"Sudeste",35003,"Votuporanga",155580,29720.3353748554,7,32,6,26,9,23,0,0,0,0,0,32,6,26,9,23,17,10.2995867832517,11.9549153477608,0.295411651146021,2020-02-17,2020,2
"8181","SP",3,"Sudeste",35003,"Votuporanga",155580,29720.3353748554,8,29,10,19,11,18,0,0,0,0,0,29,10,19,11,18,27,10.2995867832517,11.9549153477608,0.330228010759968,2020-02-24,2020,2
"8182","SP",3,"Sudeste",35003,"Votuporanga",155580,29720.3353748554,9,34,6,28,11,23,0,0,0,0,0,34,6,28,11,23,30,10.2995867832517,11.9549153477608,0.313231612519187,2020-03-02,2020,3
"8183","SP",3,"Sudeste",35003,"Votuporanga",155580,29720.3353748554,10,24,5,19,9,15,0,0,0,0,0,24,5,19,9,15,16,10.2995867832517,11.9549153477608,0.31808197496896,2020-03-09,2020,3
"8184","SP",3,"Sudeste",35003,"Votuporanga",155580,29720.3353748554,11,24,6,18,8,16,0,0,0,0,0,24,6,18,8,16,26,10.2995867832517,11.9549153477608,0.383512543454551,2020-03-16,2020,3
"8185","SP",3,"Sudeste",35003,"Votuporanga",155580,29720.3353748554,12,31,0,31,8,23,0,0,0,0,0,31,0,31,8,23,17,10.2995867832517,11.9549153477608,0.465320698804257,2020-03-23,2020,3
"8186","SP",3,"Sudeste",35003,"Votuporanga",155580,29720.3353748554,13,32,3,29,8,24,0,0,0,0,0,32,3,29,8,24,21,10.2995867832517,11.9549153477608,0.428772269811721,2020-03-30,2020,3
"8187","SP",3,"Sudeste",35003,"Votuporanga",155580,29720.3353748554,14,30,3,27,4,26,0,0,0,0,0,30,3,27,4,26,20,10.2995867832517,11.9549153477608,0.42139234391836,2020-04-06,2020,4
"8188","SP",3,"Sudeste",35003,"Votuporanga",155580,29720.3353748554,15,36,7,29,11,25,0,0,0,0,0,36,7,29,11,25,31,10.2995867832517,11.9549153477608,0.409169894150018,2020-04-13,2020,4
"8189","SP",3,"Sudeste",35003,"Votuporanga",155580,29720.3353748554,16,45,5,40,14,31,0,0,0,0,0,45,5,40,14,31,23,10.2995867832517,11.9549153477608,0.412680269058748,2020-04-20,2020,4
"8190","SP",3,"Sudeste",35003,"Votuporanga",155580,29720.3353748554,17,38,6,32,10,28,0,0,0,0,0,38,6,32,10,28,19,10.2995867832517,11.9549153477608,0.394478542283969,2020-04-27,2020,4
"8191","SP",3,"Sudeste",35003,"Votuporanga",155580,29720.3353748554,18,32,2,30,11,21,0,0,0,0,0,32,2,30,11,21,20,10.2995867832517,11.9549153477608,0.372080625654903,2020-05-04,2020,5
"8192","SP",3,"Sudeste",35003,"Votuporanga",155580,29720.3353748554,19,33,4,29,10,23,0,0,0,0,0,33,4,29,10,23,34,10.2995867832517,11.9549153477608,0.378784431512796,2020-05-11,2020,5
"8193","SP",3,"Sudeste",35003,"Votuporanga",155580,29720.3353748554,20,33,2,31,12,21,0,0,0,0,0,33,2,31,12,21,26,10.2995867832517,11.9549153477608,0.380253103394672,2020-05-18,2020,5
"8194","SP",3,"Sudeste",35003,"Votuporanga",155580,29720.3353748554,21,31,3,28,12,19,0,0,0,0,0,31,3,28,12,19,20,10.2995867832517,11.9549153477608,0.390055329872212,2020-05-25,2020,5
"8195","SP",3,"Sudeste",35004,"São José do Rio Preto",869487,35072.5352052187,5,205,28,177,63,142,2,0,2,0,2,207,28,179,63,144,134,10.4651736303765,13.6756586615434,0.270608167664491,2020-02-03,2020,2
"8196","SP",3,"Sudeste",35004,"São José do Rio Preto",869487,35072.5352052187,6,192,25,167,56,136,2,0,2,0,2,194,25,169,56,138,123,10.4651736303765,13.6756586615434,0.268340964121961,2020-02-10,2020,2
"8197","SP",3,"Sudeste",35004,"São José do Rio Preto",869487,35072.5352052187,7,172,24,148,57,115,1,0,1,0,1,173,24,149,57,116,116,10.4651736303765,13.6756586615434,0.279289271596166,2020-02-17,2020,2
"8198","SP",3,"Sudeste",35004,"São José do Rio Preto",869487,35072.5352052187,8,184,27,157,64,120,0,0,0,0,0,184,27,157,64,120,141,10.4651736303765,13.6756586615434,0.327145874514879,2020-02-24,2020,2
"8199","SP",3,"Sudeste",35004,"São José do Rio Preto",869487,35072.5352052187,9,184,23,161,54,130,2,0,2,2,0,186,23,163,56,130,117,10.4651736303765,13.6756586615434,0.298558511544109,2020-03-02,2020,3
"8200","SP",3,"Sudeste",35004,"São José do Rio Preto",869487,35072.5352052187,10,182,28,154,54,128,1,1,0,1,0,183,29,154,55,128,155,10.4651736303765,13.6756586615434,0.311009665612914,2020-03-09,2020,3
"8201","SP",3,"Sudeste",35004,"São José do Rio Preto",869487,35072.5352052187,11,194,26,168,55,139,0,0,0,0,0,194,26,168,55,139,137,10.4651736303765,13.6756586615434,0.38404350454498,2020-03-16,2020,3
"8202","SP",3,"Sudeste",35004,"São José do Rio Preto",869487,35072.5352052187,12,176,30,146,62,114,1,0,1,1,0,177,30,147,63,114,115,10.4651736303765,13.6756586615434,0.48073758811254,2020-03-23,2020,3
"8203","SP",3,"Sudeste",35004,"São José do Rio Preto",869487,35072.5352052187,13,174,27,147,51,123,0,0,0,0,0,174,27,147,51,123,127,10.4651736303765,13.6756586615434,0.443918062970731,2020-03-30,2020,3
"8204","SP",3,"Sudeste",35004,"São José do Rio Preto",869487,35072.5352052187,14,210,32,178,57,153,0,0,0,0,0,210,32,178,57,153,123,10.4651736303765,13.6756586615434,0.43243814781723,2020-04-06,2020,4
"8205","SP",3,"Sudeste",35004,"São José do Rio Preto",869487,35072.5352052187,15,167,31,136,54,113,0,0,0,0,0,167,31,136,54,113,111,10.4651736303765,13.6756586615434,0.415818073010598,2020-04-13,2020,4
"8206","SP",3,"Sudeste",35004,"São José do Rio Preto",869487,35072.5352052187,16,217,36,181,72,145,1,0,1,0,1,218,36,182,72,146,121,10.4651736303765,13.6756586615434,0.413705514354927,2020-04-20,2020,4
"8207","SP",3,"Sudeste",35004,"São José do Rio Preto",869487,35072.5352052187,17,187,27,160,64,123,4,0,4,0,4,191,27,164,64,127,115,10.4651736303765,13.6756586615434,0.398640755600336,2020-04-27,2020,4
"8208","SP",3,"Sudeste",35004,"São José do Rio Preto",869487,35072.5352052187,18,233,35,198,89,144,0,0,0,0,0,233,35,198,89,144,114,10.4651736303765,13.6756586615434,0.375280821373094,2020-05-04,2020,5
"8209","SP",3,"Sudeste",35004,"São José do Rio Preto",869487,35072.5352052187,19,179,28,151,48,131,0,0,0,0,0,179,28,151,48,131,104,10.4651736303765,13.6756586615434,0.38195516785585,2020-05-11,2020,5
"8210","SP",3,"Sudeste",35004,"São José do Rio Preto",869487,35072.5352052187,20,202,28,174,67,135,2,0,2,0,2,204,28,176,67,137,118,10.4651736303765,13.6756586615434,0.376957733757081,2020-05-18,2020,5
"8211","SP",3,"Sudeste",35004,"São José do Rio Preto",869487,35072.5352052187,21,239,31,208,82,157,3,1,2,0,3,242,32,210,82,160,144,10.4651736303765,13.6756586615434,0.382552468450986,2020-05-25,2020,5
"8212","SP",3,"Sudeste",35005,"Catanduva",245705,28296.5260611709,5,31,3,28,8,23,0,0,0,0,0,31,3,28,8,23,35,10.2504943220742,12.4118869083226,0.284715899443822,2020-02-03,2020,2
"8213","SP",3,"Sudeste",35005,"Catanduva",245705,28296.5260611709,6,43,7,36,12,31,1,0,1,1,0,44,7,37,13,31,34,10.2504943220742,12.4118869083226,0.289161826133303,2020-02-10,2020,2
"8214","SP",3,"Sudeste",35005,"Catanduva",245705,28296.5260611709,7,47,6,41,19,28,0,0,0,0,0,47,6,41,19,28,33,10.2504943220742,12.4118869083226,0.294329471977741,2020-02-17,2020,2
"8215","SP",3,"Sudeste",35005,"Catanduva",245705,28296.5260611709,8,41,9,32,17,24,0,0,0,0,0,41,9,32,17,24,52,10.2504943220742,12.4118869083226,0.332339188910803,2020-02-24,2020,2
"8216","SP",3,"Sudeste",35005,"Catanduva",245705,28296.5260611709,9,54,7,47,19,35,1,1,0,0,1,55,8,47,19,36,31,10.2504943220742,12.4118869083226,0.309337826683727,2020-03-02,2020,3
"8217","SP",3,"Sudeste",35005,"Catanduva",245705,28296.5260611709,10,29,5,24,7,22,0,0,0,0,0,29,5,24,7,22,42,10.2504943220742,12.4118869083226,0.322198962883651,2020-03-09,2020,3
"8218","SP",3,"Sudeste",35005,"Catanduva",245705,28296.5260611709,11,41,7,34,13,28,0,0,0,0,0,41,7,34,13,28,49,10.2504943220742,12.4118869083226,0.383418351382445,2020-03-16,2020,3
"8219","SP",3,"Sudeste",35005,"Catanduva",245705,28296.5260611709,12,42,6,36,13,29,1,1,0,0,1,43,7,36,13,30,32,10.2504943220742,12.4118869083226,0.46969648900399,2020-03-23,2020,3
"8220","SP",3,"Sudeste",35005,"Catanduva",245705,28296.5260611709,13,42,11,31,11,31,0,0,0,0,0,42,11,31,11,31,44,10.2504943220742,12.4118869083226,0.436621968364787,2020-03-30,2020,3
"8221","SP",3,"Sudeste",35005,"Catanduva",245705,28296.5260611709,14,41,5,36,9,32,0,0,0,0,0,41,5,36,9,32,33,10.2504943220742,12.4118869083226,0.425080870838053,2020-04-06,2020,4
"8222","SP",3,"Sudeste",35005,"Catanduva",245705,28296.5260611709,15,40,4,36,13,27,1,0,1,1,0,41,4,37,14,27,31,10.2504943220742,12.4118869083226,0.409974949299977,2020-04-13,2020,4
"8223","SP",3,"Sudeste",35005,"Catanduva",245705,28296.5260611709,16,48,5,43,14,34,0,0,0,0,0,48,5,43,14,34,33,10.2504943220742,12.4118869083226,0.401320592274282,2020-04-20,2020,4
"8224","SP",3,"Sudeste",35005,"Catanduva",245705,28296.5260611709,17,42,7,35,13,29,0,0,0,0,0,42,7,35,13,29,25,10.2504943220742,12.4118869083226,0.397804826001243,2020-04-27,2020,4
"8225","SP",3,"Sudeste",35005,"Catanduva",245705,28296.5260611709,18,43,10,33,11,32,0,0,0,0,0,43,10,33,11,32,39,10.2504943220742,12.4118869083226,0.371637322646516,2020-05-04,2020,5
"8226","SP",3,"Sudeste",35005,"Catanduva",245705,28296.5260611709,19,45,1,44,19,26,0,0,0,0,0,45,1,44,19,26,34,10.2504943220742,12.4118869083226,0.377058784219791,2020-05-11,2020,5
"8227","SP",3,"Sudeste",35005,"Catanduva",245705,28296.5260611709,20,49,5,44,16,33,1,0,1,0,1,50,5,45,16,34,38,10.2504943220742,12.4118869083226,0.372925887551532,2020-05-18,2020,5
"8228","SP",3,"Sudeste",35005,"Catanduva",245705,28296.5260611709,21,51,4,47,22,29,0,0,0,0,0,51,4,47,22,29,42,10.2504943220742,12.4118869083226,0.388730192603041,2020-05-25,2020,5
"8229","SP",3,"Sudeste",35007,"Nhandeara",73067,26837.7483776534,5,16,4,12,4,12,1,0,1,0,1,17,4,13,4,13,19,10.1975646970172,11.1991321074213,0.277332233044702,2020-02-03,2020,2
"8230","SP",3,"Sudeste",35007,"Nhandeara",73067,26837.7483776534,6,16,3,13,5,11,0,0,0,0,0,16,3,13,5,11,15,10.1975646970172,11.1991321074213,0.27588867684741,2020-02-10,2020,2
"8231","SP",3,"Sudeste",35007,"Nhandeara",73067,26837.7483776534,7,18,6,12,6,12,0,0,0,0,0,18,6,12,6,12,16,10.1975646970172,11.1991321074213,0.282597435411239,2020-02-17,2020,2
"8232","SP",3,"Sudeste",35007,"Nhandeara",73067,26837.7483776534,8,13,1,12,3,10,0,0,0,0,0,13,1,12,3,10,11,10.1975646970172,11.1991321074213,0.329129302158006,2020-02-24,2020,2
"8233","SP",3,"Sudeste",35007,"Nhandeara",73067,26837.7483776534,9,8,1,7,1,7,0,0,0,0,0,8,1,7,1,7,10,10.1975646970172,11.1991321074213,0.307617643881421,2020-03-02,2020,3
"8234","SP",3,"Sudeste",35007,"Nhandeara",73067,26837.7483776534,10,17,5,12,3,14,0,0,0,0,0,17,5,12,3,14,9,10.1975646970172,11.1991321074213,0.30691543752942,2020-03-09,2020,3
"8235","SP",3,"Sudeste",35007,"Nhandeara",73067,26837.7483776534,11,13,4,9,5,8,0,0,0,0,0,13,4,9,5,8,12,10.1975646970172,11.1991321074213,0.36252203221176,2020-03-16,2020,3
"8236","SP",3,"Sudeste",35007,"Nhandeara",73067,26837.7483776534,12,6,0,6,2,4,0,0,0,0,0,6,0,6,2,4,10,10.1975646970172,11.1991321074213,0.430110777572737,2020-03-23,2020,3
"8237","SP",3,"Sudeste",35007,"Nhandeara",73067,26837.7483776534,13,14,6,8,4,10,2,0,2,0,2,16,6,10,4,12,11,10.1975646970172,11.1991321074213,0.419938527183118,2020-03-30,2020,3
"8238","SP",3,"Sudeste",35007,"Nhandeara",73067,26837.7483776534,14,11,2,9,4,7,0,0,0,0,0,11,2,9,4,7,11,10.1975646970172,11.1991321074213,0.411117933784933,2020-04-06,2020,4
"8239","SP",3,"Sudeste",35007,"Nhandeara",73067,26837.7483776534,15,13,3,10,4,9,0,0,0,0,0,13,3,10,4,9,5,10.1975646970172,11.1991321074213,0.38211995547079,2020-04-13,2020,4
"8240","SP",3,"Sudeste",35007,"Nhandeara",73067,26837.7483776534,16,10,0,10,5,5,0,0,0,0,0,10,0,10,5,5,8,10.1975646970172,11.1991321074213,0.386269508514587,2020-04-20,2020,4
"8241","SP",3,"Sudeste",35007,"Nhandeara",73067,26837.7483776534,17,9,1,8,2,7,0,0,0,0,0,9,1,8,2,7,11,10.1975646970172,11.1991321074213,0.383364482510482,2020-04-27,2020,4
"8242","SP",3,"Sudeste",35007,"Nhandeara",73067,26837.7483776534,18,14,2,12,3,11,1,0,1,0,1,15,2,13,3,12,10,10.1975646970172,11.1991321074213,0.363223726783336,2020-05-04,2020,5
"8243","SP",3,"Sudeste",35007,"Nhandeara",73067,26837.7483776534,19,21,5,16,9,12,0,0,0,0,0,21,5,16,9,12,11,10.1975646970172,11.1991321074213,0.366456799909426,2020-05-11,2020,5
"8244","SP",3,"Sudeste",35007,"Nhandeara",73067,26837.7483776534,20,22,8,14,4,18,0,0,0,0,0,22,8,14,4,18,16,10.1975646970172,11.1991321074213,0.364778191304316,2020-05-18,2020,5
"8245","SP",3,"Sudeste",35007,"Nhandeara",73067,26837.7483776534,21,16,2,14,4,12,0,0,0,0,0,16,2,14,4,12,9,10.1975646970172,11.1991321074213,0.366426618562892,2020-05-25,2020,5
"8246","SP",3,"Sudeste",35008,"Novo Horizonte",88118,40938.3358645226,5,23,4,19,6,17,0,0,0,0,0,23,4,19,6,17,23,10.6198222102338,11.3864321043355,0.289369397640996,2020-02-03,2020,2
"8247","SP",3,"Sudeste",35008,"Novo Horizonte",88118,40938.3358645226,6,22,6,16,4,18,1,0,1,0,1,23,6,17,4,19,16,10.6198222102338,11.3864321043355,0.274020709925503,2020-02-10,2020,2
"8248","SP",3,"Sudeste",35008,"Novo Horizonte",88118,40938.3358645226,7,8,0,8,1,7,0,0,0,0,0,8,0,8,1,7,8,10.6198222102338,11.3864321043355,0.283256922732056,2020-02-17,2020,2
"8249","SP",3,"Sudeste",35008,"Novo Horizonte",88118,40938.3358645226,8,23,6,17,11,12,0,0,0,0,0,23,6,17,11,12,17,10.6198222102338,11.3864321043355,0.322878487851984,2020-02-24,2020,2
"8250","SP",3,"Sudeste",35008,"Novo Horizonte",88118,40938.3358645226,9,14,1,13,4,10,0,0,0,0,0,14,1,13,4,10,17,10.6198222102338,11.3864321043355,0.298284822590895,2020-03-02,2020,3
"8251","SP",3,"Sudeste",35008,"Novo Horizonte",88118,40938.3358645226,10,14,4,10,2,12,0,0,0,0,0,14,4,10,2,12,11,10.6198222102338,11.3864321043355,0.309508885848897,2020-03-09,2020,3
"8252","SP",3,"Sudeste",35008,"Novo Horizonte",88118,40938.3358645226,11,20,8,12,6,14,0,0,0,0,0,20,8,12,6,14,18,10.6198222102338,11.3864321043355,0.365365544301956,2020-03-16,2020,3
"8253","SP",3,"Sudeste",35008,"Novo Horizonte",88118,40938.3358645226,12,12,5,7,3,9,0,0,0,0,0,12,5,7,3,9,9,10.6198222102338,11.3864321043355,0.436129937289066,2020-03-23,2020,3
"8254","SP",3,"Sudeste",35008,"Novo Horizonte",88118,40938.3358645226,13,17,5,12,2,15,0,0,0,0,0,17,5,12,2,15,14,10.6198222102338,11.3864321043355,0.398984400699563,2020-03-30,2020,3
"8255","SP",3,"Sudeste",35008,"Novo Horizonte",88118,40938.3358645226,14,21,5,16,9,12,0,0,0,0,0,21,5,16,9,12,13,10.6198222102338,11.3864321043355,0.397244043454466,2020-04-06,2020,4
"8256","SP",3,"Sudeste",35008,"Novo Horizonte",88118,40938.3358645226,15,22,5,17,12,10,0,0,0,0,0,22,5,17,12,10,16,10.6198222102338,11.3864321043355,0.385037892665175,2020-04-13,2020,4
"8257","SP",3,"Sudeste",35008,"Novo Horizonte",88118,40938.3358645226,16,18,3,15,7,11,0,0,0,0,0,18,3,15,7,11,10,10.6198222102338,11.3864321043355,0.383757896743665,2020-04-20,2020,4
"8258","SP",3,"Sudeste",35008,"Novo Horizonte",88118,40938.3358645226,17,20,1,19,5,15,0,0,0,0,0,20,1,19,5,15,16,10.6198222102338,11.3864321043355,0.392698610934279,2020-04-27,2020,4
"8259","SP",3,"Sudeste",35008,"Novo Horizonte",88118,40938.3358645226,18,19,3,16,7,12,0,0,0,0,0,19,3,16,7,12,11,10.6198222102338,11.3864321043355,0.37220973847893,2020-05-04,2020,5
"8260","SP",3,"Sudeste",35008,"Novo Horizonte",88118,40938.3358645226,19,21,4,17,8,13,0,0,0,0,0,21,4,17,8,13,9,10.6198222102338,11.3864321043355,0.380894130979941,2020-05-11,2020,5
"8261","SP",3,"Sudeste",35008,"Novo Horizonte",88118,40938.3358645226,20,15,2,13,2,13,1,1,0,1,0,16,3,13,3,13,8,10.6198222102338,11.3864321043355,0.369039429125612,2020-05-18,2020,5
"8262","SP",3,"Sudeste",35008,"Novo Horizonte",88118,40938.3358645226,21,12,5,7,6,6,0,0,0,0,0,12,5,7,6,6,19,10.6198222102338,11.3864321043355,0.372427884345178,2020-05-25,2020,5
"8263","SP",3,"Sudeste",35009,"Barretos",147584,43133.9301756288,5,32,6,26,8,24,0,0,0,0,0,32,6,26,8,24,17,10.6720652094326,11.9021527841887,0.295993025357941,2020-02-03,2020,2
"8264","SP",3,"Sudeste",35009,"Barretos",147584,43133.9301756288,6,45,5,40,13,32,1,0,1,0,1,46,5,41,13,33,30,10.6720652094326,11.9021527841887,0.29326034370931,2020-02-10,2020,2
"8265","SP",3,"Sudeste",35009,"Barretos",147584,43133.9301756288,7,27,5,22,7,20,0,0,0,0,0,27,5,22,7,20,21,10.6720652094326,11.9021527841887,0.298369901587689,2020-02-17,2020,2
"8266","SP",3,"Sudeste",35009,"Barretos",147584,43133.9301756288,8,41,6,35,17,24,0,0,0,0,0,41,6,35,17,24,16,10.6720652094326,11.9021527841887,0.358575140970496,2020-02-24,2020,2
"8267","SP",3,"Sudeste",35009,"Barretos",147584,43133.9301756288,9,31,3,28,8,23,1,0,1,0,1,32,3,29,8,24,19,10.6720652094326,11.9021527841887,0.320943974280388,2020-03-02,2020,3
"8268","SP",3,"Sudeste",35009,"Barretos",147584,43133.9301756288,10,40,5,35,10,30,0,0,0,0,0,40,5,35,10,30,26,10.6720652094326,11.9021527841887,0.331056350501446,2020-03-09,2020,3
"8269","SP",3,"Sudeste",35009,"Barretos",147584,43133.9301756288,11,36,4,32,12,24,1,0,1,0,1,37,4,33,12,25,29,10.6720652094326,11.9021527841887,0.40340135653636,2020-03-16,2020,3
"8270","SP",3,"Sudeste",35009,"Barretos",147584,43133.9301756288,12,35,4,31,17,18,1,0,1,0,1,36,4,32,17,19,28,10.6720652094326,11.9021527841887,0.499830797239284,2020-03-23,2020,3
"8271","SP",3,"Sudeste",35009,"Barretos",147584,43133.9301756288,13,27,7,20,10,17,0,0,0,0,0,27,7,20,10,17,19,10.6720652094326,11.9021527841887,0.472567646665186,2020-03-30,2020,3
"8272","SP",3,"Sudeste",35009,"Barretos",147584,43133.9301756288,14,23,2,21,8,15,0,0,0,0,0,23,2,21,8,15,22,10.6720652094326,11.9021527841887,0.460199579448884,2020-04-06,2020,4
"8273","SP",3,"Sudeste",35009,"Barretos",147584,43133.9301756288,15,38,3,35,14,24,0,0,0,0,0,38,3,35,14,24,16,10.6720652094326,11.9021527841887,0.446655679613199,2020-04-13,2020,4
"8274","SP",3,"Sudeste",35009,"Barretos",147584,43133.9301756288,16,34,7,27,13,21,1,0,1,0,1,35,7,28,13,22,20,10.6720652094326,11.9021527841887,0.451030067499616,2020-04-20,2020,4
"8275","SP",3,"Sudeste",35009,"Barretos",147584,43133.9301756288,17,24,1,23,4,20,0,0,0,0,0,24,1,23,4,20,19,10.6720652094326,11.9021527841887,0.434605400341197,2020-04-27,2020,4
"8276","SP",3,"Sudeste",35009,"Barretos",147584,43133.9301756288,18,38,9,29,13,25,0,0,0,0,0,38,9,29,13,25,23,10.6720652094326,11.9021527841887,0.406568542059019,2020-05-04,2020,5
"8277","SP",3,"Sudeste",35009,"Barretos",147584,43133.9301756288,19,37,4,33,10,27,1,0,1,1,0,38,4,34,11,27,30,10.6720652094326,11.9021527841887,0.409329268528843,2020-05-11,2020,5
"8278","SP",3,"Sudeste",35009,"Barretos",147584,43133.9301756288,20,30,2,28,6,24,3,1,2,2,1,33,3,30,8,25,21,10.6720652094326,11.9021527841887,0.406011091826451,2020-05-18,2020,5
"8279","SP",3,"Sudeste",35009,"Barretos",147584,43133.9301756288,21,53,7,46,10,43,1,0,1,0,1,54,7,47,10,44,18,10.6720652094326,11.9021527841887,0.407413613596397,2020-05-25,2020,5
"8280","SP",3,"Sudeste",35010,"São Joaquim da Barra",236388,44390.7365843444,5,51,6,45,14,37,0,0,0,0,0,51,6,45,14,37,28,10.7007860911652,12.3732298018044,0.295464149408965,2020-02-03,2020,2
"8281","SP",3,"Sudeste",35010,"São Joaquim da Barra",236388,44390.7365843444,6,56,6,50,15,41,0,0,0,0,0,56,6,50,15,41,30,10.7007860911652,12.3732298018044,0.288201604198673,2020-02-10,2020,2
"8282","SP",3,"Sudeste",35010,"São Joaquim da Barra",236388,44390.7365843444,7,52,9,43,18,34,0,0,0,0,0,52,9,43,18,34,23,10.7007860911652,12.3732298018044,0.296156348498948,2020-02-17,2020,2
"8283","SP",3,"Sudeste",35010,"São Joaquim da Barra",236388,44390.7365843444,8,36,6,30,8,28,0,0,0,0,0,36,6,30,8,28,29,10.7007860911652,12.3732298018044,0.336532881196149,2020-02-24,2020,2
"8284","SP",3,"Sudeste",35010,"São Joaquim da Barra",236388,44390.7365843444,9,53,9,44,17,36,0,0,0,0,0,53,9,44,17,36,23,10.7007860911652,12.3732298018044,0.309408056670859,2020-03-02,2020,3
"8285","SP",3,"Sudeste",35010,"São Joaquim da Barra",236388,44390.7365843444,10,47,7,40,19,28,0,0,0,0,0,47,7,40,19,28,42,10.7007860911652,12.3732298018044,0.319585345335363,2020-03-09,2020,3
"8286","SP",3,"Sudeste",35010,"São Joaquim da Barra",236388,44390.7365843444,11,49,9,40,17,32,1,0,1,1,0,50,9,41,18,32,35,10.7007860911652,12.3732298018044,0.384162178326739,2020-03-16,2020,3
"8287","SP",3,"Sudeste",35010,"São Joaquim da Barra",236388,44390.7365843444,12,30,5,25,10,20,0,0,0,0,0,30,5,25,10,20,17,10.7007860911652,12.3732298018044,0.463959661147876,2020-03-23,2020,3
"8288","SP",3,"Sudeste",35010,"São Joaquim da Barra",236388,44390.7365843444,13,37,6,31,15,22,0,0,0,0,0,37,6,31,15,22,17,10.7007860911652,12.3732298018044,0.436353031614113,2020-03-30,2020,3
"8289","SP",3,"Sudeste",35010,"São Joaquim da Barra",236388,44390.7365843444,14,34,9,25,9,25,0,0,0,0,0,34,9,25,9,25,24,10.7007860911652,12.3732298018044,0.422358391164383,2020-04-06,2020,4
"8290","SP",3,"Sudeste",35010,"São Joaquim da Barra",236388,44390.7365843444,15,39,10,29,17,22,0,0,0,0,0,39,10,29,17,22,23,10.7007860911652,12.3732298018044,0.412035659748209,2020-04-13,2020,4
"8291","SP",3,"Sudeste",35010,"São Joaquim da Barra",236388,44390.7365843444,16,54,7,47,13,41,2,0,2,2,0,56,7,49,15,41,25,10.7007860911652,12.3732298018044,0.425725944682545,2020-04-20,2020,4
"8292","SP",3,"Sudeste",35010,"São Joaquim da Barra",236388,44390.7365843444,17,40,5,35,19,21,0,0,0,0,0,40,5,35,19,21,24,10.7007860911652,12.3732298018044,0.408582992514585,2020-04-27,2020,4
"8293","SP",3,"Sudeste",35010,"São Joaquim da Barra",236388,44390.7365843444,18,46,7,39,18,28,1,0,1,0,1,47,7,40,18,29,33,10.7007860911652,12.3732298018044,0.390739948741401,2020-05-04,2020,5
"8294","SP",3,"Sudeste",35010,"São Joaquim da Barra",236388,44390.7365843444,19,61,6,55,26,35,0,0,0,0,0,61,6,55,26,35,24,10.7007860911652,12.3732298018044,0.393329086715842,2020-05-11,2020,5
"8295","SP",3,"Sudeste",35010,"São Joaquim da Barra",236388,44390.7365843444,20,53,10,43,19,34,0,0,0,0,0,53,10,43,19,34,27,10.7007860911652,12.3732298018044,0.404920297204278,2020-05-18,2020,5
"8296","SP",3,"Sudeste",35010,"São Joaquim da Barra",236388,44390.7365843444,21,51,9,42,25,26,0,0,0,0,0,51,9,42,25,26,38,10.7007860911652,12.3732298018044,0.400693394138597,2020-05-25,2020,5
"8297","SP",3,"Sudeste",35011,"Ituverava",104136,33486.7660922256,5,28,4,24,8,20,0,0,0,0,0,28,4,24,8,20,7,10.4189055977404,11.5534530161463,0.306984995173526,2020-02-03,2020,2
"8298","SP",3,"Sudeste",35011,"Ituverava",104136,33486.7660922256,6,19,6,13,7,12,0,0,0,0,0,19,6,13,7,12,18,10.4189055977404,11.5534530161463,0.291760168361298,2020-02-10,2020,2
"8299","SP",3,"Sudeste",35011,"Ituverava",104136,33486.7660922256,7,14,1,13,2,12,0,0,0,0,0,14,1,13,2,12,9,10.4189055977404,11.5534530161463,0.305672187418146,2020-02-17,2020,2
"8300","SP",3,"Sudeste",35011,"Ituverava",104136,33486.7660922256,8,19,5,14,6,13,0,0,0,0,0,19,5,14,6,13,18,10.4189055977404,11.5534530161463,0.339656663743973,2020-02-24,2020,2
"8301","SP",3,"Sudeste",35011,"Ituverava",104136,33486.7660922256,9,23,4,19,8,15,0,0,0,0,0,23,4,19,8,15,15,10.4189055977404,11.5534530161463,0.32396525476855,2020-03-02,2020,3
"8302","SP",3,"Sudeste",35011,"Ituverava",104136,33486.7660922256,10,22,6,16,4,18,0,0,0,0,0,22,6,16,4,18,17,10.4189055977404,11.5534530161463,0.325586515429192,2020-03-09,2020,3
"8303","SP",3,"Sudeste",35011,"Ituverava",104136,33486.7660922256,11,25,9,16,12,13,0,0,0,0,0,25,9,16,12,13,16,10.4189055977404,11.5534530161463,0.399442200069902,2020-03-16,2020,3
"8304","SP",3,"Sudeste",35011,"Ituverava",104136,33486.7660922256,12,17,2,15,5,12,0,0,0,0,0,17,2,15,5,12,13,10.4189055977404,11.5534530161463,0.498468653393694,2020-03-23,2020,3
"8305","SP",3,"Sudeste",35011,"Ituverava",104136,33486.7660922256,13,19,3,16,5,14,2,0,2,1,1,21,3,18,6,15,17,10.4189055977404,11.5534530161463,0.465555684042019,2020-03-30,2020,3
"8306","SP",3,"Sudeste",35011,"Ituverava",104136,33486.7660922256,14,18,1,17,6,12,0,0,0,0,0,18,1,17,6,12,17,10.4189055977404,11.5534530161463,0.437443551641971,2020-04-06,2020,4
"8307","SP",3,"Sudeste",35011,"Ituverava",104136,33486.7660922256,15,9,3,6,4,5,0,0,0,0,0,9,3,6,4,5,12,10.4189055977404,11.5534530161463,0.428049207738156,2020-04-13,2020,4
"8308","SP",3,"Sudeste",35011,"Ituverava",104136,33486.7660922256,16,13,0,13,2,11,0,0,0,0,0,13,0,13,2,11,11,10.4189055977404,11.5534530161463,0.429018825061556,2020-04-20,2020,4
"8309","SP",3,"Sudeste",35011,"Ituverava",104136,33486.7660922256,17,8,1,7,2,6,0,0,0,0,0,8,1,7,2,6,19,10.4189055977404,11.5534530161463,0.41409124439212,2020-04-27,2020,4
"8310","SP",3,"Sudeste",35011,"Ituverava",104136,33486.7660922256,18,20,3,17,8,12,0,0,0,0,0,20,3,17,8,12,16,10.4189055977404,11.5534530161463,0.398222533233355,2020-05-04,2020,5
"8311","SP",3,"Sudeste",35011,"Ituverava",104136,33486.7660922256,19,15,4,11,4,11,0,0,0,0,0,15,4,11,4,11,9,10.4189055977404,11.5534530161463,0.403784054692819,2020-05-11,2020,5
"8312","SP",3,"Sudeste",35011,"Ituverava",104136,33486.7660922256,20,17,2,15,5,12,0,0,0,0,0,17,2,15,5,12,16,10.4189055977404,11.5534530161463,0.409865892120888,2020-05-18,2020,5
"8313","SP",3,"Sudeste",35011,"Ituverava",104136,33486.7660922256,21,28,4,24,7,21,0,0,0,0,0,28,4,24,7,21,12,10.4189055977404,11.5534530161463,0.402692160208715,2020-05-25,2020,5
"8314","SP",3,"Sudeste",35012,"Franca",430962,29878.2538660949,5,76,11,65,24,52,0,0,0,0,0,76,11,65,24,52,50,10.3048861993228,12.9737751981456,0.280406050890308,2020-02-03,2020,2
"8315","SP",3,"Sudeste",35012,"Franca",430962,29878.2538660949,6,90,16,74,34,56,0,0,0,0,0,90,16,74,34,56,57,10.3048861993228,12.9737751981456,0.280305669872847,2020-02-10,2020,2
"8316","SP",3,"Sudeste",35012,"Franca",430962,29878.2538660949,7,69,6,63,22,47,1,0,1,1,0,70,6,64,23,47,54,10.3048861993228,12.9737751981456,0.286049532937167,2020-02-17,2020,2
"8317","SP",3,"Sudeste",35012,"Franca",430962,29878.2538660949,8,98,17,81,33,65,0,0,0,0,0,98,17,81,33,65,55,10.3048861993228,12.9737751981456,0.335747465889638,2020-02-24,2020,2
"8318","SP",3,"Sudeste",35012,"Franca",430962,29878.2538660949,9,97,16,81,32,65,1,0,1,0,1,98,16,82,32,66,53,10.3048861993228,12.9737751981456,0.302166028593154,2020-03-02,2020,3
"8319","SP",3,"Sudeste",35012,"Franca",430962,29878.2538660949,10,121,14,107,42,79,0,0,0,0,0,121,14,107,42,79,56,10.3048861993228,12.9737751981456,0.312394289856445,2020-03-09,2020,3
"8320","SP",3,"Sudeste",35012,"Franca",430962,29878.2538660949,11,83,12,71,19,64,0,0,0,0,0,83,12,71,19,64,46,10.3048861993228,12.9737751981456,0.418208360892251,2020-03-16,2020,3
"8321","SP",3,"Sudeste",35012,"Franca",430962,29878.2538660949,12,93,11,82,32,61,0,0,0,0,0,93,11,82,32,61,69,10.3048861993228,12.9737751981456,0.531022368772499,2020-03-23,2020,3
"8322","SP",3,"Sudeste",35012,"Franca",430962,29878.2538660949,13,83,14,69,29,54,1,0,1,0,1,84,14,70,29,55,59,10.3048861993228,12.9737751981456,0.481602982404369,2020-03-30,2020,3
"8323","SP",3,"Sudeste",35012,"Franca",430962,29878.2538660949,14,94,15,79,32,62,1,1,0,1,0,95,16,79,33,62,41,10.3048861993228,12.9737751981456,0.463774389238067,2020-04-06,2020,4
"8324","SP",3,"Sudeste",35012,"Franca",430962,29878.2538660949,15,99,18,81,22,77,0,0,0,0,0,99,18,81,22,77,54,10.3048861993228,12.9737751981456,0.442077715348765,2020-04-13,2020,4
"8325","SP",3,"Sudeste",35012,"Franca",430962,29878.2538660949,16,80,9,71,22,58,1,0,1,0,1,81,9,72,22,59,50,10.3048861993228,12.9737751981456,0.43518317029607,2020-04-20,2020,4
"8326","SP",3,"Sudeste",35012,"Franca",430962,29878.2538660949,17,90,15,75,27,63,0,0,0,0,0,90,15,75,27,63,38,10.3048861993228,12.9737751981456,0.432626764005433,2020-04-27,2020,4
"8327","SP",3,"Sudeste",35012,"Franca",430962,29878.2538660949,18,101,14,87,39,62,0,0,0,0,0,101,14,87,39,62,46,10.3048861993228,12.9737751981456,0.401003873840909,2020-05-04,2020,5
"8328","SP",3,"Sudeste",35012,"Franca",430962,29878.2538660949,19,109,15,94,36,73,1,0,1,0,1,110,15,95,36,74,61,10.3048861993228,12.9737751981456,0.402583755709956,2020-05-11,2020,5
"8329","SP",3,"Sudeste",35012,"Franca",430962,29878.2538660949,20,92,14,78,31,61,1,0,1,0,1,93,14,79,31,62,50,10.3048861993228,12.9737751981456,0.397360885123653,2020-05-18,2020,5
"8330","SP",3,"Sudeste",35012,"Franca",430962,29878.2538660949,21,122,16,106,41,81,0,0,0,0,0,122,16,106,41,81,60,10.3048861993228,12.9737751981456,0.392799900080336,2020-05-25,2020,5
"8331","SP",3,"Sudeste",35013,"Jaboticabal",440670,31879.0918730796,5,60,10,50,28,32,0,0,0,0,0,60,10,50,28,32,56,10.3697056467105,12.9960515749936,0.287972186335181,2020-02-03,2020,2
"8332","SP",3,"Sudeste",35013,"Jaboticabal",440670,31879.0918730796,6,94,22,72,38,56,2,0,2,0,2,96,22,74,38,58,51,10.3697056467105,12.9960515749936,0.283713520011326,2020-02-10,2020,2
"8333","SP",3,"Sudeste",35013,"Jaboticabal",440670,31879.0918730796,7,70,13,57,27,43,1,0,1,0,1,71,13,58,27,44,74,10.3697056467105,12.9960515749936,0.293796868988002,2020-02-17,2020,2
"8334","SP",3,"Sudeste",35013,"Jaboticabal",440670,31879.0918730796,8,87,14,73,23,64,0,0,0,0,0,87,14,73,23,64,41,10.3697056467105,12.9960515749936,0.340745834246858,2020-02-24,2020,2
"8335","SP",3,"Sudeste",35013,"Jaboticabal",440670,31879.0918730796,9,91,15,76,42,49,0,0,0,0,0,91,15,76,42,49,67,10.3697056467105,12.9960515749936,0.310593309494656,2020-03-02,2020,3
"8336","SP",3,"Sudeste",35013,"Jaboticabal",440670,31879.0918730796,10,96,19,77,30,66,1,0,1,1,0,97,19,78,31,66,58,10.3697056467105,12.9960515749936,0.322141756701027,2020-03-09,2020,3
"8337","SP",3,"Sudeste",35013,"Jaboticabal",440670,31879.0918730796,11,72,16,56,28,44,1,0,1,1,0,73,16,57,29,44,61,10.3697056467105,12.9960515749936,0.398853104493901,2020-03-16,2020,3
"8338","SP",3,"Sudeste",35013,"Jaboticabal",440670,31879.0918730796,12,70,11,59,29,41,0,0,0,0,0,70,11,59,29,41,67,10.3697056467105,12.9960515749936,0.502864852109828,2020-03-23,2020,3
"8339","SP",3,"Sudeste",35013,"Jaboticabal",440670,31879.0918730796,13,53,5,48,16,37,0,0,0,0,0,53,5,48,16,37,56,10.3697056467105,12.9960515749936,0.465207146609831,2020-03-30,2020,3
"8340","SP",3,"Sudeste",35013,"Jaboticabal",440670,31879.0918730796,14,79,14,65,31,48,0,0,0,0,0,79,14,65,31,48,59,10.3697056467105,12.9960515749936,0.448417563338776,2020-04-06,2020,4
"8341","SP",3,"Sudeste",35013,"Jaboticabal",440670,31879.0918730796,15,71,11,60,25,46,0,0,0,0,0,71,11,60,25,46,52,10.3697056467105,12.9960515749936,0.429209465098958,2020-04-13,2020,4
"8342","SP",3,"Sudeste",35013,"Jaboticabal",440670,31879.0918730796,16,76,23,53,27,49,1,1,0,0,1,77,24,53,27,50,53,10.3697056467105,12.9960515749936,0.422354072190074,2020-04-20,2020,4
"8343","SP",3,"Sudeste",35013,"Jaboticabal",440670,31879.0918730796,17,103,16,87,33,70,1,1,0,1,0,104,17,87,34,70,53,10.3697056467105,12.9960515749936,0.408025057604371,2020-04-27,2020,4
"8344","SP",3,"Sudeste",35013,"Jaboticabal",440670,31879.0918730796,18,78,12,66,24,54,0,0,0,0,0,78,12,66,24,54,52,10.3697056467105,12.9960515749936,0.385987412937629,2020-05-04,2020,5
"8345","SP",3,"Sudeste",35013,"Jaboticabal",440670,31879.0918730796,19,100,20,80,31,69,0,0,0,0,0,100,20,80,31,69,55,10.3697056467105,12.9960515749936,0.391725588736174,2020-05-11,2020,5
"8346","SP",3,"Sudeste",35013,"Jaboticabal",440670,31879.0918730796,20,108,18,90,36,72,0,0,0,0,0,108,18,90,36,72,49,10.3697056467105,12.9960515749936,0.383261453663253,2020-05-18,2020,5
"8347","SP",3,"Sudeste",35013,"Jaboticabal",440670,31879.0918730796,21,105,13,92,38,67,1,0,1,1,0,106,13,93,39,67,78,10.3697056467105,12.9960515749936,0.390809629836869,2020-05-25,2020,5
"8348","SP",3,"Sudeste",35014,"Ribeirão Preto",1214085,42353.5271003101,5,243,41,202,74,169,2,0,2,0,2,245,41,204,74,171,141,10.6538069811532,14.009501264625,0.263957821357688,2020-02-03,2020,2
"8349","SP",3,"Sudeste",35014,"Ribeirão Preto",1214085,42353.5271003101,6,235,47,188,73,162,0,0,0,0,0,235,47,188,73,162,149,10.6538069811532,14.009501264625,0.265297810089898,2020-02-10,2020,2
"8350","SP",3,"Sudeste",35014,"Ribeirão Preto",1214085,42353.5271003101,7,240,53,187,81,159,5,1,4,1,4,245,54,191,82,163,166,10.6538069811532,14.009501264625,0.278112760207191,2020-02-17,2020,2
"8351","SP",3,"Sudeste",35014,"Ribeirão Preto",1214085,42353.5271003101,8,231,42,189,69,162,3,0,3,1,2,234,42,192,70,164,153,10.6538069811532,14.009501264625,0.333314991707877,2020-02-24,2020,2
"8352","SP",3,"Sudeste",35014,"Ribeirão Preto",1214085,42353.5271003101,9,230,52,178,64,166,2,0,2,2,0,232,52,180,66,166,136,10.6538069811532,14.009501264625,0.29385362468195,2020-03-02,2020,3
"8353","SP",3,"Sudeste",35014,"Ribeirão Preto",1214085,42353.5271003101,10,226,42,184,72,154,4,0,4,2,2,230,42,188,74,156,147,10.6538069811532,14.009501264625,0.304334688399782,2020-03-09,2020,3
"8354","SP",3,"Sudeste",35014,"Ribeirão Preto",1214085,42353.5271003101,11,224,39,185,85,139,2,0,2,0,2,226,39,187,85,141,173,10.6538069811532,14.009501264625,0.391211250873005,2020-03-16,2020,3
"8355","SP",3,"Sudeste",35014,"Ribeirão Preto",1214085,42353.5271003101,12,205,35,170,44,161,2,0,2,0,2,207,35,172,44,163,160,10.6538069811532,14.009501264625,0.519593631523882,2020-03-23,2020,3
"8356","SP",3,"Sudeste",35014,"Ribeirão Preto",1214085,42353.5271003101,13,234,50,184,78,156,4,2,2,0,4,238,52,186,78,160,150,10.6538069811532,14.009501264625,0.483310048007785,2020-03-30,2020,3
"8357","SP",3,"Sudeste",35014,"Ribeirão Preto",1214085,42353.5271003101,14,260,49,211,97,163,4,0,4,2,2,264,49,215,99,165,152,10.6538069811532,14.009501264625,0.463939126392121,2020-04-06,2020,4
"8358","SP",3,"Sudeste",35014,"Ribeirão Preto",1214085,42353.5271003101,15,267,66,201,81,186,0,0,0,0,0,267,66,201,81,186,131,10.6538069811532,14.009501264625,0.447501292615105,2020-04-13,2020,4
"8359","SP",3,"Sudeste",35014,"Ribeirão Preto",1214085,42353.5271003101,16,256,53,203,77,179,3,1,2,3,0,259,54,205,80,179,128,10.6538069811532,14.009501264625,0.450675792492231,2020-04-20,2020,4
"8360","SP",3,"Sudeste",35014,"Ribeirão Preto",1214085,42353.5271003101,17,233,48,185,71,162,3,0,3,2,1,236,48,188,73,163,145,10.6538069811532,14.009501264625,0.433762099028302,2020-04-27,2020,4
"8361","SP",3,"Sudeste",35014,"Ribeirão Preto",1214085,42353.5271003101,18,234,47,187,64,170,1,1,0,0,1,235,48,187,64,171,139,10.6538069811532,14.009501264625,0.401849132765037,2020-05-04,2020,5
"8362","SP",3,"Sudeste",35014,"Ribeirão Preto",1214085,42353.5271003101,19,241,42,199,73,168,1,1,0,0,1,242,43,199,73,169,170,10.6538069811532,14.009501264625,0.407432354919733,2020-05-11,2020,5
"8363","SP",3,"Sudeste",35014,"Ribeirão Preto",1214085,42353.5271003101,20,261,53,208,100,161,1,0,1,0,1,262,53,209,100,162,153,10.6538069811532,14.009501264625,0.40133361401457,2020-05-18,2020,5
"8364","SP",3,"Sudeste",35014,"Ribeirão Preto",1214085,42353.5271003101,21,255,57,198,83,172,3,0,3,0,3,258,57,201,83,175,164,10.6538069811532,14.009501264625,0.407401953184766,2020-05-25,2020,5
"8365","SP",3,"Sudeste",35015,"Batatais",117211,25826.0208901895,5,20,6,14,8,12,0,0,0,0,0,20,6,14,8,12,14,10.1591378242884,11.6717310083761,0.2844827664992,2020-02-03,2020,2
"8366","SP",3,"Sudeste",35015,"Batatais",117211,25826.0208901895,6,22,2,20,6,16,1,0,1,0,1,23,2,21,6,17,8,10.1591378242884,11.6717310083761,0.279773553548514,2020-02-10,2020,2
"8367","SP",3,"Sudeste",35015,"Batatais",117211,25826.0208901895,7,16,4,12,7,9,0,0,0,0,0,16,4,12,7,9,14,10.1591378242884,11.6717310083761,0.298425929399013,2020-02-17,2020,2
"8368","SP",3,"Sudeste",35015,"Batatais",117211,25826.0208901895,8,20,7,13,5,15,0,0,0,0,0,20,7,13,5,15,18,10.1591378242884,11.6717310083761,0.347059512307295,2020-02-24,2020,2
"8369","SP",3,"Sudeste",35015,"Batatais",117211,25826.0208901895,9,26,4,22,12,14,0,0,0,0,0,26,4,22,12,14,16,10.1591378242884,11.6717310083761,0.315442832570435,2020-03-02,2020,3
"8370","SP",3,"Sudeste",35015,"Batatais",117211,25826.0208901895,10,9,1,8,3,6,0,0,0,0,0,9,1,8,3,6,17,10.1591378242884,11.6717310083761,0.327676855074915,2020-03-09,2020,3
"8371","SP",3,"Sudeste",35015,"Batatais",117211,25826.0208901895,11,10,1,9,3,7,1,1,0,1,0,11,2,9,4,7,17,10.1591378242884,11.6717310083761,0.386951542327132,2020-03-16,2020,3
"8372","SP",3,"Sudeste",35015,"Batatais",117211,25826.0208901895,12,28,5,23,12,16,0,0,0,0,0,28,5,23,12,16,12,10.1591378242884,11.6717310083761,0.483835586766665,2020-03-23,2020,3
"8373","SP",3,"Sudeste",35015,"Batatais",117211,25826.0208901895,13,17,5,12,5,12,0,0,0,0,0,17,5,12,5,12,15,10.1591378242884,11.6717310083761,0.455670695269921,2020-03-30,2020,3
"8374","SP",3,"Sudeste",35015,"Batatais",117211,25826.0208901895,14,23,5,18,9,14,0,0,0,0,0,23,5,18,9,14,14,10.1591378242884,11.6717310083761,0.446323061610396,2020-04-06,2020,4
"8375","SP",3,"Sudeste",35015,"Batatais",117211,25826.0208901895,15,20,4,16,8,12,0,0,0,0,0,20,4,16,8,12,20,10.1591378242884,11.6717310083761,0.426646687858418,2020-04-13,2020,4
"8376","SP",3,"Sudeste",35015,"Batatais",117211,25826.0208901895,16,19,3,16,9,10,0,0,0,0,0,19,3,16,9,10,17,10.1591378242884,11.6717310083761,0.417701758222826,2020-04-20,2020,4
"8377","SP",3,"Sudeste",35015,"Batatais",117211,25826.0208901895,17,24,4,20,8,16,0,0,0,0,0,24,4,20,8,16,15,10.1591378242884,11.6717310083761,0.411693792524869,2020-04-27,2020,4
"8378","SP",3,"Sudeste",35015,"Batatais",117211,25826.0208901895,18,34,9,25,11,23,2,0,2,1,1,36,9,27,12,24,22,10.1591378242884,11.6717310083761,0.386067017426064,2020-05-04,2020,5
"8379","SP",3,"Sudeste",35015,"Batatais",117211,25826.0208901895,19,24,5,19,8,16,0,0,0,0,0,24,5,19,8,16,16,10.1591378242884,11.6717310083761,0.391674154002119,2020-05-11,2020,5
"8380","SP",3,"Sudeste",35015,"Batatais",117211,25826.0208901895,20,24,6,18,10,14,1,0,1,0,1,25,6,19,10,15,16,10.1591378242884,11.6717310083761,0.388463986518909,2020-05-18,2020,5
"8381","SP",3,"Sudeste",35015,"Batatais",117211,25826.0208901895,21,28,7,21,12,16,1,1,0,1,0,29,8,21,13,16,19,10.1591378242884,11.6717310083761,0.388254247202607,2020-05-25,2020,5
"8382","SP",3,"Sudeste",35016,"Andradina",194182,30205.7116907334,5,36,7,29,11,25,0,0,0,0,0,36,7,29,11,25,32,10.3157863143126,12.176551142593,0.292054631982406,2020-02-03,2020,2
"8383","SP",3,"Sudeste",35016,"Andradina",194182,30205.7116907334,6,27,5,22,7,20,0,0,0,0,0,27,5,22,7,20,27,10.3157863143126,12.176551142593,0.289623641260198,2020-02-10,2020,2
"8384","SP",3,"Sudeste",35016,"Andradina",194182,30205.7116907334,7,18,1,17,5,13,0,0,0,0,0,18,1,17,5,13,32,10.3157863143126,12.176551142593,0.296099553221511,2020-02-17,2020,2
"8385","SP",3,"Sudeste",35016,"Andradina",194182,30205.7116907334,8,26,3,23,8,18,0,0,0,0,0,26,3,23,8,18,31,10.3157863143126,12.176551142593,0.347860932150158,2020-02-24,2020,2
"8386","SP",3,"Sudeste",35016,"Andradina",194182,30205.7116907334,9,27,7,20,8,19,0,0,0,0,0,27,7,20,8,19,21,10.3157863143126,12.176551142593,0.322705129820812,2020-03-02,2020,3
"8387","SP",3,"Sudeste",35016,"Andradina",194182,30205.7116907334,10,25,3,22,12,13,0,0,0,0,0,25,3,22,12,13,38,10.3157863143126,12.176551142593,0.330906474408353,2020-03-09,2020,3
"8388","SP",3,"Sudeste",35016,"Andradina",194182,30205.7116907334,11,23,2,21,6,17,0,0,0,0,0,23,2,21,6,17,38,10.3157863143126,12.176551142593,0.398517427462759,2020-03-16,2020,3
"8389","SP",3,"Sudeste",35016,"Andradina",194182,30205.7116907334,12,27,4,23,11,16,0,0,0,0,0,27,4,23,11,16,36,10.3157863143126,12.176551142593,0.505690936959825,2020-03-23,2020,3
"8390","SP",3,"Sudeste",35016,"Andradina",194182,30205.7116907334,13,32,3,29,10,22,0,0,0,0,0,32,3,29,10,22,34,10.3157863143126,12.176551142593,0.465265177234777,2020-03-30,2020,3
"8391","SP",3,"Sudeste",35016,"Andradina",194182,30205.7116907334,14,37,9,28,13,24,0,0,0,0,0,37,9,28,13,24,35,10.3157863143126,12.176551142593,0.445644587360767,2020-04-06,2020,4
"8392","SP",3,"Sudeste",35016,"Andradina",194182,30205.7116907334,15,37,7,30,13,24,0,0,0,0,0,37,7,30,13,24,31,10.3157863143126,12.176551142593,0.433449840171035,2020-04-13,2020,4
"8393","SP",3,"Sudeste",35016,"Andradina",194182,30205.7116907334,16,28,2,26,9,19,0,0,0,0,0,28,2,26,9,19,15,10.3157863143126,12.176551142593,0.43776191412416,2020-04-20,2020,4
"8394","SP",3,"Sudeste",35016,"Andradina",194182,30205.7116907334,17,38,7,31,13,25,0,0,0,0,0,38,7,31,13,25,29,10.3157863143126,12.176551142593,0.424951916064153,2020-04-27,2020,4
"8395","SP",3,"Sudeste",35016,"Andradina",194182,30205.7116907334,18,31,4,27,10,21,2,0,2,1,1,33,4,29,11,22,27,10.3157863143126,12.176551142593,0.40946678757476,2020-05-04,2020,5
"8396","SP",3,"Sudeste",35016,"Andradina",194182,30205.7116907334,19,32,2,30,9,23,0,0,0,0,0,32,2,30,9,23,27,10.3157863143126,12.176551142593,0.409903231108809,2020-05-11,2020,5
"8397","SP",3,"Sudeste",35016,"Andradina",194182,30205.7116907334,20,38,6,32,11,27,0,0,0,0,0,38,6,32,11,27,26,10.3157863143126,12.176551142593,0.407399019880226,2020-05-18,2020,5
"8398","SP",3,"Sudeste",35016,"Andradina",194182,30205.7116907334,21,46,6,40,15,31,0,0,0,0,0,46,6,40,15,31,30,10.3157863143126,12.176551142593,0.412631280270146,2020-05-25,2020,5
"8399","SP",3,"Sudeste",35017,"Araçatuba",284984,34600.4361385902,5,51,8,43,18,33,0,0,0,0,0,51,8,43,18,33,29,10.4516215661279,12.560188317324,0.269461881736755,2020-02-03,2020,2
"8400","SP",3,"Sudeste",35017,"Araçatuba",284984,34600.4361385902,6,58,8,50,13,45,2,0,2,1,1,60,8,52,14,46,42,10.4516215661279,12.560188317324,0.266608569708365,2020-02-10,2020,2
"8401","SP",3,"Sudeste",35017,"Araçatuba",284984,34600.4361385902,7,53,7,46,17,36,0,0,0,0,0,53,7,46,17,36,33,10.4516215661279,12.560188317324,0.280161870913827,2020-02-17,2020,2
"8402","SP",3,"Sudeste",35017,"Araçatuba",284984,34600.4361385902,8,42,8,34,17,25,1,0,1,0,1,43,8,35,17,26,48,10.4516215661279,12.560188317324,0.323994021638518,2020-02-24,2020,2
"8403","SP",3,"Sudeste",35017,"Araçatuba",284984,34600.4361385902,9,66,9,57,16,50,0,0,0,0,0,66,9,57,16,50,43,10.4516215661279,12.560188317324,0.302556421679831,2020-03-02,2020,3
"8404","SP",3,"Sudeste",35017,"Araçatuba",284984,34600.4361385902,10,61,9,52,20,41,0,0,0,0,0,61,9,52,20,41,55,10.4516215661279,12.560188317324,0.311161472830788,2020-03-09,2020,3
"8405","SP",3,"Sudeste",35017,"Araçatuba",284984,34600.4361385902,11,48,7,41,13,35,0,0,0,0,0,48,7,41,13,35,53,10.4516215661279,12.560188317324,0.382230694777449,2020-03-16,2020,3
"8406","SP",3,"Sudeste",35017,"Araçatuba",284984,34600.4361385902,12,51,7,44,17,34,0,0,0,0,0,51,7,44,17,34,27,10.4516215661279,12.560188317324,0.483752140558911,2020-03-23,2020,3
"8407","SP",3,"Sudeste",35017,"Araçatuba",284984,34600.4361385902,13,53,5,48,20,33,2,0,2,0,2,55,5,50,20,35,42,10.4516215661279,12.560188317324,0.45088403557398,2020-03-30,2020,3
"8408","SP",3,"Sudeste",35017,"Araçatuba",284984,34600.4361385902,14,52,6,46,15,37,1,0,1,0,1,53,6,47,15,38,37,10.4516215661279,12.560188317324,0.432535614495273,2020-04-06,2020,4
"8409","SP",3,"Sudeste",35017,"Araçatuba",284984,34600.4361385902,15,65,9,56,26,39,0,0,0,0,0,65,9,56,26,39,29,10.4516215661279,12.560188317324,0.419957139132226,2020-04-13,2020,4
"8410","SP",3,"Sudeste",35017,"Araçatuba",284984,34600.4361385902,16,71,10,61,28,43,1,0,1,0,1,72,10,62,28,44,41,10.4516215661279,12.560188317324,0.420090607858734,2020-04-20,2020,4
"8411","SP",3,"Sudeste",35017,"Araçatuba",284984,34600.4361385902,17,58,9,49,19,39,0,0,0,0,0,58,9,49,19,39,48,10.4516215661279,12.560188317324,0.406301825522187,2020-04-27,2020,4
"8412","SP",3,"Sudeste",35017,"Araçatuba",284984,34600.4361385902,18,49,8,41,14,35,0,0,0,0,0,49,8,41,14,35,33,10.4516215661279,12.560188317324,0.383972507119159,2020-05-04,2020,5
"8413","SP",3,"Sudeste",35017,"Araçatuba",284984,34600.4361385902,19,47,8,39,11,36,0,0,0,0,0,47,8,39,11,36,48,10.4516215661279,12.560188317324,0.388250013847027,2020-05-11,2020,5
"8414","SP",3,"Sudeste",35017,"Araçatuba",284984,34600.4361385902,20,52,7,45,21,31,0,0,0,0,0,52,7,45,21,31,49,10.4516215661279,12.560188317324,0.378822007140713,2020-05-18,2020,5
"8415","SP",3,"Sudeste",35017,"Araçatuba",284984,34600.4361385902,21,61,9,52,21,40,0,0,0,0,0,61,9,52,21,40,46,10.4516215661279,12.560188317324,0.387001100167048,2020-05-25,2020,5
"8416","SP",3,"Sudeste",35018,"Birigui",291604,25869.2335136349,5,61,9,52,27,34,0,0,0,0,0,61,9,52,27,34,26,10.1608096463544,12.5831519964437,0.276401956983948,2020-02-03,2020,2
"8417","SP",3,"Sudeste",35018,"Birigui",291604,25869.2335136349,6,44,2,42,17,27,1,1,0,0,1,45,3,42,17,28,43,10.1608096463544,12.5831519964437,0.273349864596009,2020-02-10,2020,2
"8418","SP",3,"Sudeste",35018,"Birigui",291604,25869.2335136349,7,44,1,43,14,30,0,0,0,0,0,44,1,43,14,30,39,10.1608096463544,12.5831519964437,0.284126010990165,2020-02-17,2020,2
"8419","SP",3,"Sudeste",35018,"Birigui",291604,25869.2335136349,8,60,10,50,16,44,2,0,2,1,1,62,10,52,17,45,30,10.1608096463544,12.5831519964437,0.326826657602909,2020-02-24,2020,2
"8420","SP",3,"Sudeste",35018,"Birigui",291604,25869.2335136349,9,49,7,42,13,36,1,0,1,1,0,50,7,43,14,36,41,10.1608096463544,12.5831519964437,0.301665354009883,2020-03-02,2020,3
"8421","SP",3,"Sudeste",35018,"Birigui",291604,25869.2335136349,10,54,8,46,12,42,0,0,0,0,0,54,8,46,12,42,32,10.1608096463544,12.5831519964437,0.309766298229345,2020-03-09,2020,3
"8422","SP",3,"Sudeste",35018,"Birigui",291604,25869.2335136349,11,43,3,40,17,26,0,0,0,0,0,43,3,40,17,26,34,10.1608096463544,12.5831519964437,0.373984163140817,2020-03-16,2020,3
"8423","SP",3,"Sudeste",35018,"Birigui",291604,25869.2335136349,12,42,4,38,13,29,0,0,0,0,0,42,4,38,13,29,44,10.1608096463544,12.5831519964437,0.487835779591724,2020-03-23,2020,3
"8424","SP",3,"Sudeste",35018,"Birigui",291604,25869.2335136349,13,52,10,42,20,32,0,0,0,0,0,52,10,42,20,32,44,10.1608096463544,12.5831519964437,0.4455321743317,2020-03-30,2020,3
"8425","SP",3,"Sudeste",35018,"Birigui",291604,25869.2335136349,14,50,7,43,18,32,0,0,0,0,0,50,7,43,18,32,48,10.1608096463544,12.5831519964437,0.427287662161275,2020-04-06,2020,4
"8426","SP",3,"Sudeste",35018,"Birigui",291604,25869.2335136349,15,47,7,40,11,36,0,0,0,0,0,47,7,40,11,36,30,10.1608096463544,12.5831519964437,0.411566763670368,2020-04-13,2020,4
"8427","SP",3,"Sudeste",35018,"Birigui",291604,25869.2335136349,16,59,9,50,24,35,0,0,0,0,0,59,9,50,24,35,26,10.1608096463544,12.5831519964437,0.407632745852146,2020-04-20,2020,4
"8428","SP",3,"Sudeste",35018,"Birigui",291604,25869.2335136349,17,53,5,48,11,42,0,0,0,0,0,53,5,48,11,42,33,10.1608096463544,12.5831519964437,0.39823221356065,2020-04-27,2020,4
"8429","SP",3,"Sudeste",35018,"Birigui",291604,25869.2335136349,18,60,14,46,20,40,0,0,0,0,0,60,14,46,20,40,31,10.1608096463544,12.5831519964437,0.378322166271619,2020-05-04,2020,5
"8430","SP",3,"Sudeste",35018,"Birigui",291604,25869.2335136349,19,68,13,55,23,45,0,0,0,0,0,68,13,55,23,45,22,10.1608096463544,12.5831519964437,0.376780305604331,2020-05-11,2020,5
"8431","SP",3,"Sudeste",35018,"Birigui",291604,25869.2335136349,20,45,10,35,13,32,0,0,0,0,0,45,10,35,13,32,36,10.1608096463544,12.5831519964437,0.371251151919218,2020-05-18,2020,5
"8432","SP",3,"Sudeste",35018,"Birigui",291604,25869.2335136349,21,74,13,61,26,48,1,0,1,1,0,75,13,62,27,48,32,10.1608096463544,12.5831519964437,0.375450843521605,2020-05-25,2020,5
"8433","SP",3,"Sudeste",35019,"Lins",177114,37466.9994699459,5,39,11,28,14,25,0,0,0,0,0,39,11,28,14,25,27,10.531215810384,12.0845488720299,0.279673019966587,2020-02-03,2020,2
"8434","SP",3,"Sudeste",35019,"Lins",177114,37466.9994699459,6,26,5,21,9,17,0,0,0,0,0,26,5,21,9,17,25,10.531215810384,12.0845488720299,0.280033912797242,2020-02-10,2020,2
"8435","SP",3,"Sudeste",35019,"Lins",177114,37466.9994699459,7,30,6,24,5,25,1,0,1,0,1,31,6,25,5,26,35,10.531215810384,12.0845488720299,0.289899916802844,2020-02-17,2020,2
"8436","SP",3,"Sudeste",35019,"Lins",177114,37466.9994699459,8,31,8,23,11,20,0,0,0,0,0,31,8,23,11,20,25,10.531215810384,12.0845488720299,0.337600325043145,2020-02-24,2020,2
"8437","SP",3,"Sudeste",35019,"Lins",177114,37466.9994699459,9,42,12,30,15,27,0,0,0,0,0,42,12,30,15,27,25,10.531215810384,12.0845488720299,0.316880672101966,2020-03-02,2020,3
"8438","SP",3,"Sudeste",35019,"Lins",177114,37466.9994699459,10,31,3,28,14,17,0,0,0,0,0,31,3,28,14,17,28,10.531215810384,12.0845488720299,0.322061996196663,2020-03-09,2020,3
"8439","SP",3,"Sudeste",35019,"Lins",177114,37466.9994699459,11,32,5,27,14,18,0,0,0,0,0,32,5,27,14,18,22,10.531215810384,12.0845488720299,0.378942524304524,2020-03-16,2020,3
"8440","SP",3,"Sudeste",35019,"Lins",177114,37466.9994699459,12,36,6,30,11,25,1,0,1,0,1,37,6,31,11,26,23,10.531215810384,12.0845488720299,0.476419534507087,2020-03-23,2020,3
"8441","SP",3,"Sudeste",35019,"Lins",177114,37466.9994699459,13,40,6,34,17,23,0,0,0,0,0,40,6,34,17,23,25,10.531215810384,12.0845488720299,0.43769941255511,2020-03-30,2020,3
"8442","SP",3,"Sudeste",35019,"Lins",177114,37466.9994699459,14,30,7,23,9,21,0,0,0,0,0,30,7,23,9,21,22,10.531215810384,12.0845488720299,0.427320574561382,2020-04-06,2020,4
"8443","SP",3,"Sudeste",35019,"Lins",177114,37466.9994699459,15,34,5,29,11,23,0,0,0,0,0,34,5,29,11,23,32,10.531215810384,12.0845488720299,0.413688006626252,2020-04-13,2020,4
"8444","SP",3,"Sudeste",35019,"Lins",177114,37466.9994699459,16,41,11,30,13,28,0,0,0,0,0,41,11,30,13,28,23,10.531215810384,12.0845488720299,0.411807668511044,2020-04-20,2020,4
"8445","SP",3,"Sudeste",35019,"Lins",177114,37466.9994699459,17,31,6,25,15,16,0,0,0,0,0,31,6,25,15,16,23,10.531215810384,12.0845488720299,0.402539578658887,2020-04-27,2020,4
"8446","SP",3,"Sudeste",35019,"Lins",177114,37466.9994699459,18,38,10,28,13,25,0,0,0,0,0,38,10,28,13,25,22,10.531215810384,12.0845488720299,0.379036687136747,2020-05-04,2020,5
"8447","SP",3,"Sudeste",35019,"Lins",177114,37466.9994699459,19,41,7,34,14,27,0,0,0,0,0,41,7,34,14,27,34,10.531215810384,12.0845488720299,0.386525715391708,2020-05-11,2020,5
"8448","SP",3,"Sudeste",35019,"Lins",177114,37466.9994699459,20,42,7,35,10,32,0,0,0,0,0,42,7,35,10,32,27,10.531215810384,12.0845488720299,0.384129772222135,2020-05-18,2020,5
"8449","SP",3,"Sudeste",35019,"Lins",177114,37466.9994699459,21,38,14,24,14,24,0,0,0,0,0,38,14,24,14,24,28,10.531215810384,12.0845488720299,0.382495972903867,2020-05-25,2020,5
"8450","SP",3,"Sudeste",35020,"Bauru",621716,36545.345249133,5,130,25,105,42,88,2,1,1,1,1,132,26,106,43,89,67,10.506309104103,13.3402386758117,0.27786373309274,2020-02-03,2020,2
"8451","SP",3,"Sudeste",35020,"Bauru",621716,36545.345249133,6,144,30,114,51,93,2,2,0,1,1,146,32,114,52,94,77,10.506309104103,13.3402386758117,0.279346159585593,2020-02-10,2020,2
"8452","SP",3,"Sudeste",35020,"Bauru",621716,36545.345249133,7,112,21,91,33,79,1,0,1,0,1,113,21,92,33,80,80,10.506309104103,13.3402386758117,0.28747856580813,2020-02-17,2020,2
"8453","SP",3,"Sudeste",35020,"Bauru",621716,36545.345249133,8,116,24,92,51,65,1,0,1,0,1,117,24,93,51,66,83,10.506309104103,13.3402386758117,0.334085056985681,2020-02-24,2020,2
"8454","SP",3,"Sudeste",35020,"Bauru",621716,36545.345249133,9,139,29,110,47,92,2,0,2,2,0,141,29,112,49,92,91,10.506309104103,13.3402386758117,0.3046427344371,2020-03-02,2020,3
"8455","SP",3,"Sudeste",35020,"Bauru",621716,36545.345249133,10,124,25,99,45,79,1,0,1,0,1,125,25,100,45,80,98,10.506309104103,13.3402386758117,0.313144580321803,2020-03-09,2020,3
"8456","SP",3,"Sudeste",35020,"Bauru",621716,36545.345249133,11,111,22,89,29,82,0,0,0,0,0,111,22,89,29,82,92,10.506309104103,13.3402386758117,0.390514886898286,2020-03-16,2020,3
"8457","SP",3,"Sudeste",35020,"Bauru",621716,36545.345249133,12,125,18,107,46,79,0,0,0,0,0,125,18,107,46,79,63,10.506309104103,13.3402386758117,0.504049803118965,2020-03-23,2020,3
"8458","SP",3,"Sudeste",35020,"Bauru",621716,36545.345249133,13,106,9,97,44,62,3,0,3,1,2,109,9,100,45,64,77,10.506309104103,13.3402386758117,0.464772108209475,2020-03-30,2020,3
"8459","SP",3,"Sudeste",35020,"Bauru",621716,36545.345249133,14,146,25,121,51,95,2,0,2,1,1,148,25,123,52,96,72,10.506309104103,13.3402386758117,0.4528627825046,2020-04-06,2020,4
"8460","SP",3,"Sudeste",35020,"Bauru",621716,36545.345249133,15,115,11,104,29,86,1,0,1,0,1,116,11,105,29,87,64,10.506309104103,13.3402386758117,0.431861355558881,2020-04-13,2020,4
"8461","SP",3,"Sudeste",35020,"Bauru",621716,36545.345249133,16,129,26,103,52,77,1,0,1,1,0,130,26,104,53,77,81,10.506309104103,13.3402386758117,0.432339242437695,2020-04-20,2020,4
"8462","SP",3,"Sudeste",35020,"Bauru",621716,36545.345249133,17,128,23,105,47,81,0,0,0,0,0,128,23,105,47,81,82,10.506309104103,13.3402386758117,0.421445874763092,2020-04-27,2020,4
"8463","SP",3,"Sudeste",35020,"Bauru",621716,36545.345249133,18,110,22,88,36,74,0,0,0,0,0,110,22,88,36,74,85,10.506309104103,13.3402386758117,0.395194038471953,2020-05-04,2020,5
"8464","SP",3,"Sudeste",35020,"Bauru",621716,36545.345249133,19,141,22,119,43,98,1,1,0,0,1,142,23,119,43,99,92,10.506309104103,13.3402386758117,0.398768490243892,2020-05-11,2020,5
"8465","SP",3,"Sudeste",35020,"Bauru",621716,36545.345249133,20,156,30,126,47,109,1,0,1,0,1,157,30,127,47,110,74,10.506309104103,13.3402386758117,0.398452039522479,2020-05-18,2020,5
"8466","SP",3,"Sudeste",35020,"Bauru",621716,36545.345249133,21,163,23,140,62,101,1,0,1,1,0,164,23,141,63,101,89,10.506309104103,13.3402386758117,0.39284510719752,2020-05-25,2020,5
"8467","SP",3,"Sudeste",35021,"Jaú",388471,32658.0178567255,5,48,12,36,18,30,0,0,0,0,0,48,12,36,18,30,54,10.3938456744416,12.869973799929,0.289701109537969,2020-02-03,2020,2
"8468","SP",3,"Sudeste",35021,"Jaú",388471,32658.0178567255,6,63,16,47,28,35,1,0,1,0,1,64,16,48,28,36,44,10.3938456744416,12.869973799929,0.294781823562333,2020-02-10,2020,2
"8469","SP",3,"Sudeste",35021,"Jaú",388471,32658.0178567255,7,78,17,61,30,48,0,0,0,0,0,78,17,61,30,48,60,10.3938456744416,12.869973799929,0.301223123382702,2020-02-17,2020,2
"8470","SP",3,"Sudeste",35021,"Jaú",388471,32658.0178567255,8,63,12,51,22,41,0,0,0,0,0,63,12,51,22,41,40,10.3938456744416,12.869973799929,0.346484086369799,2020-02-24,2020,2
"8471","SP",3,"Sudeste",35021,"Jaú",388471,32658.0178567255,9,68,12,56,24,44,2,1,1,1,1,70,13,57,25,45,46,10.3938456744416,12.869973799929,0.317724365052584,2020-03-02,2020,3
"8472","SP",3,"Sudeste",35021,"Jaú",388471,32658.0178567255,10,69,16,53,26,43,1,1,0,0,1,70,17,53,26,44,69,10.3938456744416,12.869973799929,0.326679602488822,2020-03-09,2020,3
"8473","SP",3,"Sudeste",35021,"Jaú",388471,32658.0178567255,11,56,9,47,19,37,0,0,0,0,0,56,9,47,19,37,59,10.3938456744416,12.869973799929,0.401383619108195,2020-03-16,2020,3
"8474","SP",3,"Sudeste",35021,"Jaú",388471,32658.0178567255,12,71,22,49,29,42,0,0,0,0,0,71,22,49,29,42,52,10.3938456744416,12.869973799929,0.497566661112803,2020-03-23,2020,3
"8475","SP",3,"Sudeste",35021,"Jaú",388471,32658.0178567255,13,55,11,44,14,41,2,0,2,0,2,57,11,46,14,43,35,10.3938456744416,12.869973799929,0.460981908796513,2020-03-30,2020,3
"8476","SP",3,"Sudeste",35021,"Jaú",388471,32658.0178567255,14,52,9,43,13,39,1,0,1,0,1,53,9,44,13,40,43,10.3938456744416,12.869973799929,0.448040186920367,2020-04-06,2020,4
"8477","SP",3,"Sudeste",35021,"Jaú",388471,32658.0178567255,15,64,7,57,15,49,2,0,2,0,2,66,7,59,15,51,58,10.3938456744416,12.869973799929,0.427906187333333,2020-04-13,2020,4
"8478","SP",3,"Sudeste",35021,"Jaú",388471,32658.0178567255,16,67,13,54,16,51,0,0,0,0,0,67,13,54,16,51,53,10.3938456744416,12.869973799929,0.435050132891607,2020-04-20,2020,4
"8479","SP",3,"Sudeste",35021,"Jaú",388471,32658.0178567255,17,69,16,53,25,44,0,0,0,0,0,69,16,53,25,44,49,10.3938456744416,12.869973799929,0.425213814781853,2020-04-27,2020,4
"8480","SP",3,"Sudeste",35021,"Jaú",388471,32658.0178567255,18,65,10,55,23,42,1,1,0,0,1,66,11,55,23,43,48,10.3938456744416,12.869973799929,0.400813003238898,2020-05-04,2020,5
"8481","SP",3,"Sudeste",35021,"Jaú",388471,32658.0178567255,19,84,18,66,34,50,1,0,1,1,0,85,18,67,35,50,63,10.3938456744416,12.869973799929,0.4040156433974,2020-05-11,2020,5
"8482","SP",3,"Sudeste",35021,"Jaú",388471,32658.0178567255,20,73,13,60,20,53,2,0,2,0,2,75,13,62,20,55,70,10.3938456744416,12.869973799929,0.409814814518973,2020-05-18,2020,5
"8483","SP",3,"Sudeste",35021,"Jaú",388471,32658.0178567255,21,68,16,52,23,45,1,0,1,1,0,69,16,53,24,45,55,10.3938456744416,12.869973799929,0.401967808358967,2020-05-25,2020,5
"8484","SP",3,"Sudeste",35022,"Avaré",202112,27251.5769294747,5,46,13,33,18,28,0,0,0,0,0,46,13,33,18,28,21,10.2128666673886,12.2165772781753,0.288520022667968,2020-02-03,2020,2
"8485","SP",3,"Sudeste",35022,"Avaré",202112,27251.5769294747,6,54,12,42,20,34,0,0,0,0,0,54,12,42,20,34,28,10.2128666673886,12.2165772781753,0.29506958226809,2020-02-10,2020,2
"8486","SP",3,"Sudeste",35022,"Avaré",202112,27251.5769294747,7,43,11,32,17,26,1,0,1,0,1,44,11,33,17,27,24,10.2128666673886,12.2165772781753,0.304388374711326,2020-02-17,2020,2
"8487","SP",3,"Sudeste",35022,"Avaré",202112,27251.5769294747,8,54,13,41,24,30,1,1,0,0,1,55,14,41,24,31,24,10.2128666673886,12.2165772781753,0.359837327003842,2020-02-24,2020,2
"8488","SP",3,"Sudeste",35022,"Avaré",202112,27251.5769294747,9,44,9,35,16,28,0,0,0,0,0,44,9,35,16,28,27,10.2128666673886,12.2165772781753,0.322542091911236,2020-03-02,2020,3
"8489","SP",3,"Sudeste",35022,"Avaré",202112,27251.5769294747,10,39,11,28,17,22,0,0,0,0,0,39,11,28,17,22,27,10.2128666673886,12.2165772781753,0.324803587486834,2020-03-09,2020,3
"8490","SP",3,"Sudeste",35022,"Avaré",202112,27251.5769294747,11,52,10,42,30,22,0,0,0,0,0,52,10,42,30,22,14,10.2128666673886,12.2165772781753,0.419759253027983,2020-03-16,2020,3
"8491","SP",3,"Sudeste",35022,"Avaré",202112,27251.5769294747,12,38,5,33,14,24,2,1,1,1,1,40,6,34,15,25,37,10.2128666673886,12.2165772781753,0.523445269286161,2020-03-23,2020,3
"8492","SP",3,"Sudeste",35022,"Avaré",202112,27251.5769294747,13,47,11,36,14,33,1,0,1,1,0,48,11,37,15,33,20,10.2128666673886,12.2165772781753,0.479713584940964,2020-03-30,2020,3
"8493","SP",3,"Sudeste",35022,"Avaré",202112,27251.5769294747,14,46,11,35,23,23,0,0,0,0,0,46,11,35,23,23,25,10.2128666673886,12.2165772781753,0.471004626905948,2020-04-06,2020,4
"8494","SP",3,"Sudeste",35022,"Avaré",202112,27251.5769294747,15,60,13,47,21,39,0,0,0,0,0,60,13,47,21,39,32,10.2128666673886,12.2165772781753,0.444332385508106,2020-04-13,2020,4
"8495","SP",3,"Sudeste",35022,"Avaré",202112,27251.5769294747,16,50,14,36,19,31,0,0,0,0,0,50,14,36,19,31,30,10.2128666673886,12.2165772781753,0.452614770628374,2020-04-20,2020,4
"8496","SP",3,"Sudeste",35022,"Avaré",202112,27251.5769294747,17,37,10,27,17,20,1,0,1,0,1,38,10,28,17,21,23,10.2128666673886,12.2165772781753,0.437507528506914,2020-04-27,2020,4
"8497","SP",3,"Sudeste",35022,"Avaré",202112,27251.5769294747,18,50,8,42,17,33,0,0,0,0,0,50,8,42,17,33,27,10.2128666673886,12.2165772781753,0.418238956277826,2020-05-04,2020,5
"8498","SP",3,"Sudeste",35022,"Avaré",202112,27251.5769294747,19,56,9,47,25,31,0,0,0,0,0,56,9,47,25,31,28,10.2128666673886,12.2165772781753,0.416207966676618,2020-05-11,2020,5
"8499","SP",3,"Sudeste",35022,"Avaré",202112,27251.5769294747,20,59,11,48,19,40,1,1,0,0,1,60,12,48,19,41,24,10.2128666673886,12.2165772781753,0.420322966306763,2020-05-18,2020,5
"8500","SP",3,"Sudeste",35022,"Avaré",202112,27251.5769294747,21,52,9,43,19,33,0,0,0,0,0,52,9,43,19,33,33,10.2128666673886,12.2165772781753,0.424137396742111,2020-05-25,2020,5
"8501","SP",3,"Sudeste",35023,"Botucatu",237837,29950.1537309586,5,61,11,50,19,42,0,0,0,0,0,61,11,50,19,42,36,10.3072897364506,12.3793408440707,0.288171383187765,2020-02-03,2020,2
"8502","SP",3,"Sudeste",35023,"Botucatu",237837,29950.1537309586,6,61,16,45,21,40,0,0,0,0,0,61,16,45,21,40,40,10.3072897364506,12.3793408440707,0.2974329058895,2020-02-10,2020,2
"8503","SP",3,"Sudeste",35023,"Botucatu",237837,29950.1537309586,7,49,5,44,12,37,0,0,0,0,0,49,5,44,12,37,34,10.3072897364506,12.3793408440707,0.295149306061825,2020-02-17,2020,2
"8504","SP",3,"Sudeste",35023,"Botucatu",237837,29950.1537309586,8,50,8,42,18,32,2,0,2,0,2,52,8,44,18,34,29,10.3072897364506,12.3793408440707,0.351988432782121,2020-02-24,2020,2
"8505","SP",3,"Sudeste",35023,"Botucatu",237837,29950.1537309586,9,53,16,37,22,31,1,0,1,0,1,54,16,38,22,32,21,10.3072897364506,12.3793408440707,0.315279063394331,2020-03-02,2020,3
"8506","SP",3,"Sudeste",35023,"Botucatu",237837,29950.1537309586,10,49,7,42,19,30,0,0,0,0,0,49,7,42,19,30,36,10.3072897364506,12.3793408440707,0.320802238216573,2020-03-09,2020,3
"8507","SP",3,"Sudeste",35023,"Botucatu",237837,29950.1537309586,11,44,8,36,18,26,1,1,0,0,1,45,9,36,18,27,33,10.3072897364506,12.3793408440707,0.413738577824411,2020-03-16,2020,3
"8508","SP",3,"Sudeste",35023,"Botucatu",237837,29950.1537309586,12,46,9,37,16,30,1,0,1,0,1,47,9,38,16,31,36,10.3072897364506,12.3793408440707,0.544636684713537,2020-03-23,2020,3
"8509","SP",3,"Sudeste",35023,"Botucatu",237837,29950.1537309586,13,47,7,40,17,30,0,0,0,0,0,47,7,40,17,30,27,10.3072897364506,12.3793408440707,0.491533985366333,2020-03-30,2020,3
"8510","SP",3,"Sudeste",35023,"Botucatu",237837,29950.1537309586,14,64,13,51,25,39,1,0,1,0,1,65,13,52,25,40,30,10.3072897364506,12.3793408440707,0.485755741251806,2020-04-06,2020,4
"8511","SP",3,"Sudeste",35023,"Botucatu",237837,29950.1537309586,15,38,15,23,15,23,1,1,0,0,1,39,16,23,15,24,31,10.3072897364506,12.3793408440707,0.467075218742636,2020-04-13,2020,4
"8512","SP",3,"Sudeste",35023,"Botucatu",237837,29950.1537309586,16,47,7,40,14,33,0,0,0,0,0,47,7,40,14,33,25,10.3072897364506,12.3793408440707,0.459935921490956,2020-04-20,2020,4
"8513","SP",3,"Sudeste",35023,"Botucatu",237837,29950.1537309586,17,55,10,45,19,36,0,0,0,0,0,55,10,45,19,36,27,10.3072897364506,12.3793408440707,0.441304747238365,2020-04-27,2020,4
"8514","SP",3,"Sudeste",35023,"Botucatu",237837,29950.1537309586,18,46,8,38,20,26,0,0,0,0,0,46,8,38,20,26,39,10.3072897364506,12.3793408440707,0.421942697537235,2020-05-04,2020,5
"8515","SP",3,"Sudeste",35023,"Botucatu",237837,29950.1537309586,19,55,8,47,24,31,0,0,0,0,0,55,8,47,24,31,42,10.3072897364506,12.3793408440707,0.428584418982701,2020-05-11,2020,5
"8516","SP",3,"Sudeste",35023,"Botucatu",237837,29950.1537309586,20,51,9,42,21,30,1,0,1,1,0,52,9,43,22,30,34,10.3072897364506,12.3793408440707,0.433869940231539,2020-05-18,2020,5
"8517","SP",3,"Sudeste",35023,"Botucatu",237837,29950.1537309586,21,47,8,39,14,33,1,1,0,1,0,48,9,39,15,33,29,10.3072897364506,12.3793408440707,0.424959877851734,2020-05-25,2020,5
"8518","SP",3,"Sudeste",35024,"Araraquara",566133,35935.3738738247,5,113,26,87,32,81,1,0,1,1,0,114,26,88,33,81,59,10.4894774340177,13.2465843119135,0.292068713013581,2020-02-03,2020,2
"8519","SP",3,"Sudeste",35024,"Araraquara",566133,35935.3738738247,6,107,18,89,26,81,1,1,0,1,0,108,19,89,27,81,61,10.4894774340177,13.2465843119135,0.286868555503057,2020-02-10,2020,2
"8520","SP",3,"Sudeste",35024,"Araraquara",566133,35935.3738738247,7,129,22,107,38,91,0,0,0,0,0,129,22,107,38,91,89,10.4894774340177,13.2465843119135,0.292485102389931,2020-02-17,2020,2
"8521","SP",3,"Sudeste",35024,"Araraquara",566133,35935.3738738247,8,106,15,91,34,72,2,0,2,1,1,108,15,93,35,73,67,10.4894774340177,13.2465843119135,0.343398078337504,2020-02-24,2020,2
"8522","SP",3,"Sudeste",35024,"Araraquara",566133,35935.3738738247,9,105,14,91,38,67,2,2,0,1,1,107,16,91,39,68,81,10.4894774340177,13.2465843119135,0.311212083149215,2020-03-02,2020,3
"8523","SP",3,"Sudeste",35024,"Araraquara",566133,35935.3738738247,10,99,16,83,35,64,3,0,3,0,3,102,16,86,35,67,81,10.4894774340177,13.2465843119135,0.322057618875865,2020-03-09,2020,3
"8524","SP",3,"Sudeste",35024,"Araraquara",566133,35935.3738738247,11,107,16,91,24,83,0,0,0,0,0,107,16,91,24,83,84,10.4894774340177,13.2465843119135,0.398765363401047,2020-03-16,2020,3
"8525","SP",3,"Sudeste",35024,"Araraquara",566133,35935.3738738247,12,97,16,81,35,62,1,1,0,1,0,98,17,81,36,62,78,10.4894774340177,13.2465843119135,0.516501865804995,2020-03-23,2020,3
"8526","SP",3,"Sudeste",35024,"Araraquara",566133,35935.3738738247,13,110,14,96,34,76,0,0,0,0,0,110,14,96,34,76,64,10.4894774340177,13.2465843119135,0.474428158938422,2020-03-30,2020,3
"8527","SP",3,"Sudeste",35024,"Araraquara",566133,35935.3738738247,14,93,22,71,31,62,0,0,0,0,0,93,22,71,31,62,73,10.4894774340177,13.2465843119135,0.456893625037055,2020-04-06,2020,4
"8528","SP",3,"Sudeste",35024,"Araraquara",566133,35935.3738738247,15,105,18,87,28,77,1,0,1,0,1,106,18,88,28,78,74,10.4894774340177,13.2465843119135,0.441528128153187,2020-04-13,2020,4
"8529","SP",3,"Sudeste",35024,"Araraquara",566133,35935.3738738247,16,136,21,115,41,95,2,1,1,1,1,138,22,116,42,96,79,10.4894774340177,13.2465843119135,0.441121496781634,2020-04-20,2020,4
"8530","SP",3,"Sudeste",35024,"Araraquara",566133,35935.3738738247,17,94,21,73,31,63,1,0,1,0,1,95,21,74,31,64,73,10.4894774340177,13.2465843119135,0.429573482038823,2020-04-27,2020,4
"8531","SP",3,"Sudeste",35024,"Araraquara",566133,35935.3738738247,18,115,20,95,41,74,3,1,2,0,3,118,21,97,41,77,71,10.4894774340177,13.2465843119135,0.403914477228147,2020-05-04,2020,5
"8532","SP",3,"Sudeste",35024,"Araraquara",566133,35935.3738738247,19,133,19,114,52,81,2,0,2,1,1,135,19,116,53,82,79,10.4894774340177,13.2465843119135,0.404020586007393,2020-05-11,2020,5
"8533","SP",3,"Sudeste",35024,"Araraquara",566133,35935.3738738247,20,133,25,108,41,92,3,0,3,0,3,136,25,111,41,95,70,10.4894774340177,13.2465843119135,0.403775222660543,2020-05-18,2020,5
"8534","SP",3,"Sudeste",35024,"Araraquara",566133,35935.3738738247,21,139,24,115,43,96,0,0,0,0,0,139,24,115,43,96,81,10.4894774340177,13.2465843119135,0.406848984098292,2020-05-25,2020,5
"8535","SP",3,"Sudeste",35025,"São Carlos",351099,42575.4828090083,5,70,11,59,27,43,0,0,0,0,0,70,11,59,27,43,39,10.6590338456664,12.7688235139611,0.273529995449413,2020-02-03,2020,2
"8536","SP",3,"Sudeste",35025,"São Carlos",351099,42575.4828090083,6,92,8,84,32,60,1,0,1,0,1,93,8,85,32,61,42,10.6590338456664,12.7688235139611,0.279449442697243,2020-02-10,2020,2
"8537","SP",3,"Sudeste",35025,"São Carlos",351099,42575.4828090083,7,64,6,58,23,41,0,0,0,0,0,64,6,58,23,41,45,10.6590338456664,12.7688235139611,0.285438422104627,2020-02-17,2020,2
"8538","SP",3,"Sudeste",35025,"São Carlos",351099,42575.4828090083,8,69,8,61,23,46,1,0,1,0,1,70,8,62,23,47,43,10.6590338456664,12.7688235139611,0.345391185624299,2020-02-24,2020,2
"8539","SP",3,"Sudeste",35025,"São Carlos",351099,42575.4828090083,9,81,13,68,28,53,0,0,0,0,0,81,13,68,28,53,38,10.6590338456664,12.7688235139611,0.296914959252607,2020-03-02,2020,3
"8540","SP",3,"Sudeste",35025,"São Carlos",351099,42575.4828090083,10,65,9,56,21,44,1,0,1,0,1,66,9,57,21,45,55,10.6590338456664,12.7688235139611,0.305635095517822,2020-03-09,2020,3
"8541","SP",3,"Sudeste",35025,"São Carlos",351099,42575.4828090083,11,75,13,62,16,59,0,0,0,0,0,75,13,62,16,59,46,10.6590338456664,12.7688235139611,0.423369712006083,2020-03-16,2020,3
"8542","SP",3,"Sudeste",35025,"São Carlos",351099,42575.4828090083,12,69,5,64,25,44,0,0,0,0,0,69,5,64,25,44,45,10.6590338456664,12.7688235139611,0.5545308873347,2020-03-23,2020,3
"8543","SP",3,"Sudeste",35025,"São Carlos",351099,42575.4828090083,13,71,17,54,17,54,2,0,2,0,2,73,17,56,17,56,52,10.6590338456664,12.7688235139611,0.517705151272848,2020-03-30,2020,3
"8544","SP",3,"Sudeste",35025,"São Carlos",351099,42575.4828090083,14,78,10,68,28,50,0,0,0,0,0,78,10,68,28,50,52,10.6590338456664,12.7688235139611,0.50188803095568,2020-04-06,2020,4
"8545","SP",3,"Sudeste",35025,"São Carlos",351099,42575.4828090083,15,83,9,74,34,49,0,0,0,0,0,83,9,74,34,49,44,10.6590338456664,12.7688235139611,0.485916296184251,2020-04-13,2020,4
"8546","SP",3,"Sudeste",35025,"São Carlos",351099,42575.4828090083,16,71,6,65,27,44,2,0,2,0,2,73,6,67,27,46,39,10.6590338456664,12.7688235139611,0.484305023792676,2020-04-20,2020,4
"8547","SP",3,"Sudeste",35025,"São Carlos",351099,42575.4828090083,17,79,12,67,23,56,1,0,1,0,1,80,12,68,23,57,43,10.6590338456664,12.7688235139611,0.47234056789593,2020-04-27,2020,4
"8548","SP",3,"Sudeste",35025,"São Carlos",351099,42575.4828090083,18,87,10,77,17,70,1,0,1,0,1,88,10,78,17,71,45,10.6590338456664,12.7688235139611,0.438749304544215,2020-05-04,2020,5
"8549","SP",3,"Sudeste",35025,"São Carlos",351099,42575.4828090083,19,62,7,55,21,41,1,0,1,1,0,63,7,56,22,41,46,10.6590338456664,12.7688235139611,0.448204349364399,2020-05-11,2020,5
"8550","SP",3,"Sudeste",35025,"São Carlos",351099,42575.4828090083,20,79,2,77,21,58,0,0,0,0,0,79,2,77,21,58,52,10.6590338456664,12.7688235139611,0.449546993355119,2020-05-18,2020,5
"8551","SP",3,"Sudeste",35025,"São Carlos",351099,42575.4828090083,21,86,8,78,19,67,1,0,1,0,1,87,8,79,19,68,37,10.6590338456664,12.7688235139611,0.449793894038847,2020-05-25,2020,5
"8552","SP",3,"Sudeste",35026,"Rio Claro",272838,44803.5797358872,5,48,11,37,23,25,0,0,0,0,0,48,11,37,23,25,44,10.7100433200298,12.5166334914383,0.293825336882416,2020-02-03,2020,2
"8553","SP",3,"Sudeste",35026,"Rio Claro",272838,44803.5797358872,6,47,12,35,21,26,1,0,1,0,1,48,12,36,21,27,38,10.7100433200298,12.5166334914383,0.290092779299503,2020-02-10,2020,2
"8554","SP",3,"Sudeste",35026,"Rio Claro",272838,44803.5797358872,7,57,5,52,17,40,1,0,1,0,1,58,5,53,17,41,39,10.7100433200298,12.5166334914383,0.296627721258386,2020-02-17,2020,2
"8555","SP",3,"Sudeste",35026,"Rio Claro",272838,44803.5797358872,8,61,10,51,17,44,0,0,0,0,0,61,10,51,17,44,37,10.7100433200298,12.5166334914383,0.348322375520664,2020-02-24,2020,2
"8556","SP",3,"Sudeste",35026,"Rio Claro",272838,44803.5797358872,9,48,10,38,14,34,1,0,1,0,1,49,10,39,14,35,29,10.7100433200298,12.5166334914383,0.314556741089951,2020-03-02,2020,3
"8557","SP",3,"Sudeste",35026,"Rio Claro",272838,44803.5797358872,10,57,14,43,23,34,0,0,0,0,0,57,14,43,23,34,37,10.7100433200298,12.5166334914383,0.327317133387939,2020-03-09,2020,3
"8558","SP",3,"Sudeste",35026,"Rio Claro",272838,44803.5797358872,11,57,15,42,13,44,0,0,0,0,0,57,15,42,13,44,39,10.7100433200298,12.5166334914383,0.398717500068992,2020-03-16,2020,3
"8559","SP",3,"Sudeste",35026,"Rio Claro",272838,44803.5797358872,12,45,5,40,11,34,0,0,0,0,0,45,5,40,11,34,33,10.7100433200298,12.5166334914383,0.507483026333301,2020-03-23,2020,3
"8560","SP",3,"Sudeste",35026,"Rio Claro",272838,44803.5797358872,13,54,10,44,16,38,0,0,0,0,0,54,10,44,16,38,32,10.7100433200298,12.5166334914383,0.479457069969646,2020-03-30,2020,3
"8561","SP",3,"Sudeste",35026,"Rio Claro",272838,44803.5797358872,14,65,7,58,22,43,0,0,0,0,0,65,7,58,22,43,35,10.7100433200298,12.5166334914383,0.468904740990789,2020-04-06,2020,4
"8562","SP",3,"Sudeste",35026,"Rio Claro",272838,44803.5797358872,15,49,12,37,17,32,0,0,0,0,0,49,12,37,17,32,31,10.7100433200298,12.5166334914383,0.450025955256033,2020-04-13,2020,4
"8563","SP",3,"Sudeste",35026,"Rio Claro",272838,44803.5797358872,16,58,8,50,21,37,0,0,0,0,0,58,8,50,21,37,37,10.7100433200298,12.5166334914383,0.450923278924932,2020-04-20,2020,4
"8564","SP",3,"Sudeste",35026,"Rio Claro",272838,44803.5797358872,17,65,12,53,24,41,0,0,0,0,0,65,12,53,24,41,48,10.7100433200298,12.5166334914383,0.439915441641997,2020-04-27,2020,4
"8565","SP",3,"Sudeste",35026,"Rio Claro",272838,44803.5797358872,18,64,14,50,21,43,1,0,1,0,1,65,14,51,21,44,37,10.7100433200298,12.5166334914383,0.414452374483447,2020-05-04,2020,5
"8566","SP",3,"Sudeste",35026,"Rio Claro",272838,44803.5797358872,19,49,4,45,6,43,1,1,0,0,1,50,5,45,6,44,35,10.7100433200298,12.5166334914383,0.420334311757842,2020-05-11,2020,5
"8567","SP",3,"Sudeste",35026,"Rio Claro",272838,44803.5797358872,20,63,8,55,21,42,0,0,0,0,0,63,8,55,21,42,37,10.7100433200298,12.5166334914383,0.41162802029454,2020-05-18,2020,5
"8568","SP",3,"Sudeste",35026,"Rio Claro",272838,44803.5797358872,21,52,13,39,20,32,0,0,0,0,0,52,13,39,20,32,43,10.7100433200298,12.5166334914383,0.414862444136745,2020-05-25,2020,5
"8569","SP",3,"Sudeste",35027,"Limeira",657972,45523.2183834874,5,113,21,92,45,68,1,1,0,1,0,114,22,92,46,68,78,10.7259777689258,13.3969176562106,0.286852059513426,2020-02-03,2020,2
"8570","SP",3,"Sudeste",35027,"Limeira",657972,45523.2183834874,6,112,23,89,39,73,3,0,3,1,2,115,23,92,40,75,87,10.7259777689258,13.3969176562106,0.285830125344182,2020-02-10,2020,2
"8571","SP",3,"Sudeste",35027,"Limeira",657972,45523.2183834874,7,142,26,116,44,98,0,0,0,0,0,142,26,116,44,98,92,10.7259777689258,13.3969176562106,0.291461551925477,2020-02-17,2020,2
"8572","SP",3,"Sudeste",35027,"Limeira",657972,45523.2183834874,8,134,24,110,42,92,2,0,2,1,1,136,24,112,43,93,68,10.7259777689258,13.3969176562106,0.338916464622591,2020-02-24,2020,2
"8573","SP",3,"Sudeste",35027,"Limeira",657972,45523.2183834874,9,123,21,102,34,89,1,1,0,0,1,124,22,102,34,90,94,10.7259777689258,13.3969176562106,0.311029146090019,2020-03-02,2020,3
"8574","SP",3,"Sudeste",35027,"Limeira",657972,45523.2183834874,10,112,17,95,36,76,2,0,2,1,1,114,17,97,37,77,89,10.7259777689258,13.3969176562106,0.320924021671166,2020-03-09,2020,3
"8575","SP",3,"Sudeste",35027,"Limeira",657972,45523.2183834874,11,117,18,99,39,78,0,0,0,0,0,117,18,99,39,78,77,10.7259777689258,13.3969176562106,0.398853552330807,2020-03-16,2020,3
"8576","SP",3,"Sudeste",35027,"Limeira",657972,45523.2183834874,12,149,26,123,50,99,1,0,1,0,1,150,26,124,50,100,70,10.7259777689258,13.3969176562106,0.51259113731836,2020-03-23,2020,3
"8577","SP",3,"Sudeste",35027,"Limeira",657972,45523.2183834874,13,127,23,104,50,77,0,0,0,0,0,127,23,104,50,77,78,10.7259777689258,13.3969176562106,0.475579926166435,2020-03-30,2020,3
"8578","SP",3,"Sudeste",35027,"Limeira",657972,45523.2183834874,14,124,26,98,42,82,1,1,0,0,1,125,27,98,42,83,94,10.7259777689258,13.3969176562106,0.462191597837154,2020-04-06,2020,4
"8579","SP",3,"Sudeste",35027,"Limeira",657972,45523.2183834874,15,152,22,130,48,104,1,0,1,0,1,153,22,131,48,105,72,10.7259777689258,13.3969176562106,0.441833569343105,2020-04-13,2020,4
"8580","SP",3,"Sudeste",35027,"Limeira",657972,45523.2183834874,16,119,23,96,35,84,0,0,0,0,0,119,23,96,35,84,80,10.7259777689258,13.3969176562106,0.440743881116754,2020-04-20,2020,4
"8581","SP",3,"Sudeste",35027,"Limeira",657972,45523.2183834874,17,137,27,110,47,90,0,0,0,0,0,137,27,110,47,90,81,10.7259777689258,13.3969176562106,0.430306056834208,2020-04-27,2020,4
"8582","SP",3,"Sudeste",35027,"Limeira",657972,45523.2183834874,18,111,17,94,34,77,0,0,0,0,0,111,17,94,34,77,81,10.7259777689258,13.3969176562106,0.401933107506913,2020-05-04,2020,5
"8583","SP",3,"Sudeste",35027,"Limeira",657972,45523.2183834874,19,119,19,100,54,65,0,0,0,0,0,119,19,100,54,65,74,10.7259777689258,13.3969176562106,0.40798596611789,2020-05-11,2020,5
"8584","SP",3,"Sudeste",35027,"Limeira",657972,45523.2183834874,20,145,25,120,45,100,0,0,0,0,0,145,25,120,45,100,103,10.7259777689258,13.3969176562106,0.395907661633063,2020-05-18,2020,5
"8585","SP",3,"Sudeste",35027,"Limeira",657972,45523.2183834874,21,146,24,122,52,94,0,0,0,0,0,146,24,122,52,94,114,10.7259777689258,13.3969176562106,0.402599942059117,2020-05-25,2020,5
"8586","SP",3,"Sudeste",35028,"Piracicaba",629410,54747.10222421,5,147,20,127,50,97,1,0,1,0,1,148,20,128,50,98,81,10.9104797188664,13.3525381516337,0.271835378127945,2020-02-03,2020,2
"8587","SP",3,"Sudeste",35028,"Piracicaba",629410,54747.10222421,6,118,20,98,41,77,4,2,2,0,4,122,22,100,41,81,70,10.9104797188664,13.3525381516337,0.275862702443227,2020-02-10,2020,2
"8588","SP",3,"Sudeste",35028,"Piracicaba",629410,54747.10222421,7,116,17,99,28,88,2,0,2,1,1,118,17,101,29,89,69,10.9104797188664,13.3525381516337,0.282259989045764,2020-02-17,2020,2
"8589","SP",3,"Sudeste",35028,"Piracicaba",629410,54747.10222421,8,152,32,120,46,106,0,0,0,0,0,152,32,120,46,106,78,10.9104797188664,13.3525381516337,0.330326266810685,2020-02-24,2020,2
"8590","SP",3,"Sudeste",35028,"Piracicaba",629410,54747.10222421,9,130,22,108,38,92,0,0,0,0,0,130,22,108,38,92,77,10.9104797188664,13.3525381516337,0.296901994961994,2020-03-02,2020,3
"8591","SP",3,"Sudeste",35028,"Piracicaba",629410,54747.10222421,10,128,7,121,40,88,3,0,3,1,2,131,7,124,41,90,78,10.9104797188664,13.3525381516337,0.309923058686052,2020-03-09,2020,3
"8592","SP",3,"Sudeste",35028,"Piracicaba",629410,54747.10222421,11,123,28,95,42,81,1,0,1,0,1,124,28,96,42,82,86,10.9104797188664,13.3525381516337,0.389060906339376,2020-03-16,2020,3
"8593","SP",3,"Sudeste",35028,"Piracicaba",629410,54747.10222421,12,107,9,98,41,66,3,0,3,2,1,110,9,101,43,67,70,10.9104797188664,13.3525381516337,0.506842633972488,2020-03-23,2020,3
"8594","SP",3,"Sudeste",35028,"Piracicaba",629410,54747.10222421,13,125,21,104,37,88,1,0,1,0,1,126,21,105,37,89,80,10.9104797188664,13.3525381516337,0.470823646877932,2020-03-30,2020,3
"8595","SP",3,"Sudeste",35028,"Piracicaba",629410,54747.10222421,14,131,21,110,39,92,2,2,0,1,1,133,23,110,40,93,52,10.9104797188664,13.3525381516337,0.453283186542583,2020-04-06,2020,4
"8596","SP",3,"Sudeste",35028,"Piracicaba",629410,54747.10222421,15,114,20,94,32,82,1,0,1,0,1,115,20,95,32,83,88,10.9104797188664,13.3525381516337,0.430886949894145,2020-04-13,2020,4
"8597","SP",3,"Sudeste",35028,"Piracicaba",629410,54747.10222421,16,135,20,115,42,93,0,0,0,0,0,135,20,115,42,93,67,10.9104797188664,13.3525381516337,0.432563009308686,2020-04-20,2020,4
"8598","SP",3,"Sudeste",35028,"Piracicaba",629410,54747.10222421,17,143,23,120,52,91,1,0,1,0,1,144,23,121,52,92,74,10.9104797188664,13.3525381516337,0.424577177514306,2020-04-27,2020,4
"8599","SP",3,"Sudeste",35028,"Piracicaba",629410,54747.10222421,18,144,25,119,59,85,4,0,4,1,3,148,25,123,60,88,70,10.9104797188664,13.3525381516337,0.396502278843126,2020-05-04,2020,5
"8600","SP",3,"Sudeste",35028,"Piracicaba",629410,54747.10222421,19,140,16,124,42,98,0,0,0,0,0,140,16,124,42,98,71,10.9104797188664,13.3525381516337,0.403705183583518,2020-05-11,2020,5
"8601","SP",3,"Sudeste",35028,"Piracicaba",629410,54747.10222421,20,153,32,121,48,105,0,0,0,0,0,153,32,121,48,105,85,10.9104797188664,13.3525381516337,0.395805063448246,2020-05-18,2020,5
"8602","SP",3,"Sudeste",35028,"Piracicaba",629410,54747.10222421,21,128,16,112,38,90,0,0,0,0,0,128,16,112,38,90,94,10.9104797188664,13.3525381516337,0.402682542061277,2020-05-25,2020,5
"8603","SP",3,"Sudeste",35029,"Pirassununga",204766,31465.6287244953,5,35,9,26,16,19,0,0,0,0,0,35,9,26,16,19,30,10.3566510774711,12.2296231427404,0.290943510896269,2020-02-03,2020,2
"8604","SP",3,"Sudeste",35029,"Pirassununga",204766,31465.6287244953,6,37,4,33,15,22,1,0,1,0,1,38,4,34,15,23,36,10.3566510774711,12.2296231427404,0.295196754872908,2020-02-10,2020,2
"8605","SP",3,"Sudeste",35029,"Pirassununga",204766,31465.6287244953,7,47,11,36,14,33,0,0,0,0,0,47,11,36,14,33,21,10.3566510774711,12.2296231427404,0.307533668315895,2020-02-17,2020,2
"8606","SP",3,"Sudeste",35029,"Pirassununga",204766,31465.6287244953,8,39,9,30,14,25,0,0,0,0,0,39,9,30,14,25,28,10.3566510774711,12.2296231427404,0.352616628011852,2020-02-24,2020,2
"8607","SP",3,"Sudeste",35029,"Pirassununga",204766,31465.6287244953,9,30,9,21,14,16,1,0,1,1,0,31,9,22,15,16,41,10.3566510774711,12.2296231427404,0.31826612685341,2020-03-02,2020,3
"8608","SP",3,"Sudeste",35029,"Pirassununga",204766,31465.6287244953,10,27,8,19,7,20,0,0,0,0,0,27,8,19,7,20,29,10.3566510774711,12.2296231427404,0.326094562572195,2020-03-09,2020,3
"8609","SP",3,"Sudeste",35029,"Pirassununga",204766,31465.6287244953,11,34,9,25,7,27,2,1,1,2,0,36,10,26,9,27,28,10.3566510774711,12.2296231427404,0.400181684615537,2020-03-16,2020,3
"8610","SP",3,"Sudeste",35029,"Pirassununga",204766,31465.6287244953,12,41,12,29,12,29,0,0,0,0,0,41,12,29,12,29,39,10.3566510774711,12.2296231427404,0.518068665427534,2020-03-23,2020,3
"8611","SP",3,"Sudeste",35029,"Pirassununga",204766,31465.6287244953,13,36,14,22,13,23,0,0,0,0,0,36,14,22,13,23,25,10.3566510774711,12.2296231427404,0.481256279527299,2020-03-30,2020,3
"8612","SP",3,"Sudeste",35029,"Pirassununga",204766,31465.6287244953,14,42,13,29,17,25,0,0,0,0,0,42,13,29,17,25,26,10.3566510774711,12.2296231427404,0.468720660112246,2020-04-06,2020,4
"8613","SP",3,"Sudeste",35029,"Pirassununga",204766,31465.6287244953,15,27,7,20,12,15,0,0,0,0,0,27,7,20,12,15,25,10.3566510774711,12.2296231427404,0.44704611190058,2020-04-13,2020,4
"8614","SP",3,"Sudeste",35029,"Pirassununga",204766,31465.6287244953,16,42,12,30,21,21,0,0,0,0,0,42,12,30,21,21,28,10.3566510774711,12.2296231427404,0.448018492385939,2020-04-20,2020,4
"8615","SP",3,"Sudeste",35029,"Pirassununga",204766,31465.6287244953,17,42,6,36,15,27,1,1,0,1,0,43,7,36,16,27,23,10.3566510774711,12.2296231427404,0.44142406400051,2020-04-27,2020,4
"8616","SP",3,"Sudeste",35029,"Pirassununga",204766,31465.6287244953,18,35,8,27,14,21,0,0,0,0,0,35,8,27,14,21,30,10.3566510774711,12.2296231427404,0.408123166229404,2020-05-04,2020,5
"8617","SP",3,"Sudeste",35029,"Pirassununga",204766,31465.6287244953,19,39,12,27,17,22,0,0,0,0,0,39,12,27,17,22,30,10.3566510774711,12.2296231427404,0.417237885224314,2020-05-11,2020,5
"8618","SP",3,"Sudeste",35029,"Pirassununga",204766,31465.6287244953,20,41,8,33,16,25,1,0,1,1,0,42,8,34,17,25,19,10.3566510774711,12.2296231427404,0.406130514995306,2020-05-18,2020,5
"8619","SP",3,"Sudeste",35029,"Pirassununga",204766,31465.6287244953,21,40,9,31,13,27,0,0,0,0,0,40,9,31,13,27,37,10.3566510774711,12.2296231427404,0.414802679201082,2020-05-25,2020,5
"8620","SP",3,"Sudeste",35030,"São João da Boa Vista",434425,29110.2513590378,5,92,25,67,36,56,1,1,0,0,1,93,26,67,36,57,68,10.2788456715027,12.9817785965905,0.312309631254719,2020-02-03,2020,2
"8621","SP",3,"Sudeste",35030,"São João da Boa Vista",434425,29110.2513590378,6,78,12,66,18,60,0,0,0,0,0,78,12,66,18,60,62,10.2788456715027,12.9817785965905,0.313840412773023,2020-02-10,2020,2
"8622","SP",3,"Sudeste",35030,"São João da Boa Vista",434425,29110.2513590378,7,90,17,73,29,61,1,1,0,0,1,91,18,73,29,62,55,10.2788456715027,12.9817785965905,0.315412049098599,2020-02-17,2020,2
"8623","SP",3,"Sudeste",35030,"São João da Boa Vista",434425,29110.2513590378,8,78,18,60,28,50,0,0,0,0,0,78,18,60,28,50,56,10.2788456715027,12.9817785965905,0.364641042670747,2020-02-24,2020,2
"8624","SP",3,"Sudeste",35030,"São João da Boa Vista",434425,29110.2513590378,9,71,15,56,16,55,0,0,0,0,0,71,15,56,16,55,58,10.2788456715027,12.9817785965905,0.333627251822408,2020-03-02,2020,3
"8625","SP",3,"Sudeste",35030,"São João da Boa Vista",434425,29110.2513590378,10,71,20,51,25,46,2,0,2,0,2,73,20,53,25,48,64,10.2788456715027,12.9817785965905,0.334873548142499,2020-03-09,2020,3
"8626","SP",3,"Sudeste",35030,"São João da Boa Vista",434425,29110.2513590378,11,73,14,59,24,49,1,0,1,0,1,74,14,60,24,50,76,10.2788456715027,12.9817785965905,0.430024239846501,2020-03-16,2020,3
"8627","SP",3,"Sudeste",35030,"São João da Boa Vista",434425,29110.2513590378,12,83,15,68,26,57,0,0,0,0,0,83,15,68,26,57,76,10.2788456715027,12.9817785965905,0.530542262235661,2020-03-23,2020,3
"8628","SP",3,"Sudeste",35030,"São João da Boa Vista",434425,29110.2513590378,13,58,5,53,17,41,0,0,0,0,0,58,5,53,17,41,69,10.2788456715027,12.9817785965905,0.494903222529261,2020-03-30,2020,3
"8629","SP",3,"Sudeste",35030,"São João da Boa Vista",434425,29110.2513590378,14,68,15,53,23,45,0,0,0,0,0,68,15,53,23,45,67,10.2788456715027,12.9817785965905,0.477707122141317,2020-04-06,2020,4
"8630","SP",3,"Sudeste",35030,"São João da Boa Vista",434425,29110.2513590378,15,69,18,51,27,42,0,0,0,0,0,69,18,51,27,42,53,10.2788456715027,12.9817785965905,0.451119401031724,2020-04-13,2020,4
"8631","SP",3,"Sudeste",35030,"São João da Boa Vista",434425,29110.2513590378,16,76,15,61,30,46,1,0,1,1,0,77,15,62,31,46,63,10.2788456715027,12.9817785965905,0.46366067976414,2020-04-20,2020,4
"8632","SP",3,"Sudeste",35030,"São João da Boa Vista",434425,29110.2513590378,17,88,20,68,25,63,0,0,0,0,0,88,20,68,25,63,60,10.2788456715027,12.9817785965905,0.447101063197308,2020-04-27,2020,4
"8633","SP",3,"Sudeste",35030,"São João da Boa Vista",434425,29110.2513590378,18,82,18,64,26,56,0,0,0,0,0,82,18,64,26,56,63,10.2788456715027,12.9817785965905,0.423088407094674,2020-05-04,2020,5
"8634","SP",3,"Sudeste",35030,"São João da Boa Vista",434425,29110.2513590378,19,101,22,79,32,69,1,0,1,1,0,102,22,80,33,69,77,10.2788456715027,12.9817785965905,0.431316728929909,2020-05-11,2020,5
"8635","SP",3,"Sudeste",35030,"São João da Boa Vista",434425,29110.2513590378,20,84,21,63,28,56,3,0,3,0,3,87,21,66,28,59,68,10.2788456715027,12.9817785965905,0.430648250113944,2020-05-18,2020,5
"8636","SP",3,"Sudeste",35030,"São João da Boa Vista",434425,29110.2513590378,21,87,24,63,28,59,0,0,0,0,0,87,24,63,28,59,63,10.2788456715027,12.9817785965905,0.427539587101526,2020-05-25,2020,5
"8637","SP",3,"Sudeste",35031,"Mogi Mirim",433442,41478.6417115554,5,70,13,57,28,42,0,0,0,0,0,70,13,57,28,42,55,10.6329339161843,12.9795132715571,0.292889737770387,2020-02-03,2020,2
"8638","SP",3,"Sudeste",35031,"Mogi Mirim",433442,41478.6417115554,6,72,16,56,26,46,0,0,0,0,0,72,16,56,26,46,45,10.6329339161843,12.9795132715571,0.290647560860146,2020-02-10,2020,2
"8639","SP",3,"Sudeste",35031,"Mogi Mirim",433442,41478.6417115554,7,75,19,56,18,57,1,1,0,1,0,76,20,56,19,57,49,10.6329339161843,12.9795132715571,0.301865138200652,2020-02-17,2020,2
"8640","SP",3,"Sudeste",35031,"Mogi Mirim",433442,41478.6417115554,8,86,14,72,25,61,0,0,0,0,0,86,14,72,25,61,63,10.6329339161843,12.9795132715571,0.342498228067716,2020-02-24,2020,2
"8641","SP",3,"Sudeste",35031,"Mogi Mirim",433442,41478.6417115554,9,61,12,49,26,35,0,0,0,0,0,61,12,49,26,35,40,10.6329339161843,12.9795132715571,0.314442387158706,2020-03-02,2020,3
"8642","SP",3,"Sudeste",35031,"Mogi Mirim",433442,41478.6417115554,10,65,12,53,23,42,2,0,2,1,1,67,12,55,24,43,56,10.6329339161843,12.9795132715571,0.323628848611036,2020-03-09,2020,3
"8643","SP",3,"Sudeste",35031,"Mogi Mirim",433442,41478.6417115554,11,76,13,63,20,56,0,0,0,0,0,76,13,63,20,56,67,10.6329339161843,12.9795132715571,0.414479288670689,2020-03-16,2020,3
"8644","SP",3,"Sudeste",35031,"Mogi Mirim",433442,41478.6417115554,12,73,16,57,18,55,0,0,0,0,0,73,16,57,18,55,56,10.6329339161843,12.9795132715571,0.525491276467874,2020-03-23,2020,3
"8645","SP",3,"Sudeste",35031,"Mogi Mirim",433442,41478.6417115554,13,62,15,47,13,49,1,1,0,0,1,63,16,47,13,50,50,10.6329339161843,12.9795132715571,0.484850255759328,2020-03-30,2020,3
"8646","SP",3,"Sudeste",35031,"Mogi Mirim",433442,41478.6417115554,14,79,15,64,30,49,0,0,0,0,0,79,15,64,30,49,49,10.6329339161843,12.9795132715571,0.473292775130961,2020-04-06,2020,4
"8647","SP",3,"Sudeste",35031,"Mogi Mirim",433442,41478.6417115554,15,73,8,65,23,50,3,1,2,2,1,76,9,67,25,51,49,10.6329339161843,12.9795132715571,0.442277183659812,2020-04-13,2020,4
"8648","SP",3,"Sudeste",35031,"Mogi Mirim",433442,41478.6417115554,16,78,16,62,24,54,1,0,1,0,1,79,16,63,24,55,62,10.6329339161843,12.9795132715571,0.441738533732894,2020-04-20,2020,4
"8649","SP",3,"Sudeste",35031,"Mogi Mirim",433442,41478.6417115554,17,87,11,76,24,63,0,0,0,0,0,87,11,76,24,63,58,10.6329339161843,12.9795132715571,0.433230839264679,2020-04-27,2020,4
"8650","SP",3,"Sudeste",35031,"Mogi Mirim",433442,41478.6417115554,18,81,20,61,21,60,2,0,2,0,2,83,20,63,21,62,52,10.6329339161843,12.9795132715571,0.406244484198984,2020-05-04,2020,5
"8651","SP",3,"Sudeste",35031,"Mogi Mirim",433442,41478.6417115554,19,79,12,67,30,49,2,0,2,1,1,81,12,69,31,50,62,10.6329339161843,12.9795132715571,0.410134240250319,2020-05-11,2020,5
"8652","SP",3,"Sudeste",35031,"Mogi Mirim",433442,41478.6417115554,20,70,7,63,20,50,2,1,1,0,2,72,8,64,20,52,59,10.6329339161843,12.9795132715571,0.40612835801152,2020-05-18,2020,5
"8653","SP",3,"Sudeste",35031,"Mogi Mirim",433442,41478.6417115554,21,109,17,92,25,84,2,0,2,2,0,111,17,94,27,84,58,10.6329339161843,12.9795132715571,0.414294109798799,2020-05-25,2020,5
"8654","SP",3,"Sudeste",35032,"Campinas",3085794,64407.4777456888,5,597,79,518,193,404,1,0,1,1,0,598,79,519,194,404,280,11.0729850194152,14.9423195565987,0.265057154849918,2020-02-03,2020,2
"8655","SP",3,"Sudeste",35032,"Campinas",3085794,64407.4777456888,6,605,88,517,152,453,3,0,3,0,3,608,88,520,152,456,310,11.0729850194152,14.9423195565987,0.267246111799455,2020-02-10,2020,2
"8656","SP",3,"Sudeste",35032,"Campinas",3085794,64407.4777456888,7,640,97,543,193,447,4,1,3,2,2,644,98,546,195,449,330,11.0729850194152,14.9423195565987,0.277513071355914,2020-02-17,2020,2
"8657","SP",3,"Sudeste",35032,"Campinas",3085794,64407.4777456888,8,613,87,526,179,434,5,0,5,0,5,618,87,531,179,439,339,11.0729850194152,14.9423195565987,0.327093388375121,2020-02-24,2020,2
"8658","SP",3,"Sudeste",35032,"Campinas",3085794,64407.4777456888,9,614,85,529,197,417,2,0,2,0,2,616,85,531,197,419,392,11.0729850194152,14.9423195565987,0.29160110538292,2020-03-02,2020,3
"8659","SP",3,"Sudeste",35032,"Campinas",3085794,64407.4777456888,10,562,75,487,172,390,3,1,2,1,2,565,76,489,173,392,375,11.0729850194152,14.9423195565987,0.30499418272727,2020-03-09,2020,3
"8660","SP",3,"Sudeste",35032,"Campinas",3085794,64407.4777456888,11,621,73,548,195,426,3,0,3,0,3,624,73,551,195,429,367,11.0729850194152,14.9423195565987,0.403834985724753,2020-03-16,2020,3
"8661","SP",3,"Sudeste",35032,"Campinas",3085794,64407.4777456888,12,587,70,517,167,420,5,0,5,1,4,592,70,522,168,424,396,11.0729850194152,14.9423195565987,0.530703552294327,2020-03-23,2020,3
"8662","SP",3,"Sudeste",35032,"Campinas",3085794,64407.4777456888,13,574,83,491,171,403,6,0,6,0,6,580,83,497,171,409,334,11.0729850194152,14.9423195565987,0.491189900051431,2020-03-30,2020,3
"8663","SP",3,"Sudeste",35032,"Campinas",3085794,64407.4777456888,14,606,91,515,191,415,3,0,3,2,1,609,91,518,193,416,353,11.0729850194152,14.9423195565987,0.477711736948578,2020-04-06,2020,4
"8664","SP",3,"Sudeste",35032,"Campinas",3085794,64407.4777456888,15,636,88,548,174,462,2,0,2,1,1,638,88,550,175,463,341,11.0729850194152,14.9423195565987,0.456284508363491,2020-04-13,2020,4
"8665","SP",3,"Sudeste",35032,"Campinas",3085794,64407.4777456888,16,649,100,549,202,447,5,1,4,3,2,654,101,553,205,449,334,11.0729850194152,14.9423195565987,0.4539516427548,2020-04-20,2020,4
"8666","SP",3,"Sudeste",35032,"Campinas",3085794,64407.4777456888,17,636,91,545,203,433,2,0,2,1,1,638,91,547,204,434,355,11.0729850194152,14.9423195565987,0.438871126942612,2020-04-27,2020,4
"8667","SP",3,"Sudeste",35032,"Campinas",3085794,64407.4777456888,18,630,87,543,195,435,3,0,3,3,0,633,87,546,198,435,338,11.0729850194152,14.9423195565987,0.414549652992955,2020-05-04,2020,5
"8668","SP",3,"Sudeste",35032,"Campinas",3085794,64407.4777456888,19,677,101,576,196,481,6,2,4,2,4,683,103,580,198,485,353,11.0729850194152,14.9423195565987,0.42085175942904,2020-05-11,2020,5
"8669","SP",3,"Sudeste",35032,"Campinas",3085794,64407.4777456888,20,688,83,605,179,509,2,0,2,1,1,690,83,607,180,510,370,11.0729850194152,14.9423195565987,0.412293439517741,2020-05-18,2020,5
"8670","SP",3,"Sudeste",35032,"Campinas",3085794,64407.4777456888,21,696,82,614,183,513,3,1,2,0,3,699,83,616,183,516,434,11.0729850194152,14.9423195565987,0.420821132963747,2020-05-25,2020,5
"8671","SP",3,"Sudeste",35033,"Amparo",199990,37695.578819291,5,31,6,25,8,23,0,0,0,0,0,31,6,25,8,23,31,10.5372980938613,12.2060226442801,0.284960631821901,2020-02-03,2020,2
"8672","SP",3,"Sudeste",35033,"Amparo",199990,37695.578819291,6,43,4,39,9,34,0,0,0,0,0,43,4,39,9,34,31,10.5372980938613,12.2060226442801,0.289937764240351,2020-02-10,2020,2
"8673","SP",3,"Sudeste",35033,"Amparo",199990,37695.578819291,7,42,5,37,14,28,0,0,0,0,0,42,5,37,14,28,37,10.5372980938613,12.2060226442801,0.293107229029342,2020-02-17,2020,2
"8674","SP",3,"Sudeste",35033,"Amparo",199990,37695.578819291,8,33,8,25,13,20,0,0,0,0,0,33,8,25,13,20,34,10.5372980938613,12.2060226442801,0.338565046524728,2020-02-24,2020,2
"8675","SP",3,"Sudeste",35033,"Amparo",199990,37695.578819291,9,38,5,33,12,26,0,0,0,0,0,38,5,33,12,26,22,10.5372980938613,12.2060226442801,0.312847687110935,2020-03-02,2020,3
"8676","SP",3,"Sudeste",35033,"Amparo",199990,37695.578819291,10,51,8,43,21,30,0,0,0,0,0,51,8,43,21,30,33,10.5372980938613,12.2060226442801,0.322896983916806,2020-03-09,2020,3
"8677","SP",3,"Sudeste",35033,"Amparo",199990,37695.578819291,11,32,5,27,10,22,0,0,0,0,0,32,5,27,10,22,32,10.5372980938613,12.2060226442801,0.415517762648624,2020-03-16,2020,3
"8678","SP",3,"Sudeste",35033,"Amparo",199990,37695.578819291,12,43,6,37,20,23,0,0,0,0,0,43,6,37,20,23,24,10.5372980938613,12.2060226442801,0.543971484566829,2020-03-23,2020,3
"8679","SP",3,"Sudeste",35033,"Amparo",199990,37695.578819291,13,24,6,18,11,13,0,0,0,0,0,24,6,18,11,13,30,10.5372980938613,12.2060226442801,0.484294630187108,2020-03-30,2020,3
"8680","SP",3,"Sudeste",35033,"Amparo",199990,37695.578819291,14,28,4,24,6,22,0,0,0,0,0,28,4,24,6,22,30,10.5372980938613,12.2060226442801,0.480675598007207,2020-04-06,2020,4
"8681","SP",3,"Sudeste",35033,"Amparo",199990,37695.578819291,15,44,9,35,18,26,0,0,0,0,0,44,9,35,18,26,31,10.5372980938613,12.2060226442801,0.446297946203806,2020-04-13,2020,4
"8682","SP",3,"Sudeste",35033,"Amparo",199990,37695.578819291,16,40,5,35,15,25,0,0,0,0,0,40,5,35,15,25,33,10.5372980938613,12.2060226442801,0.447280988438025,2020-04-20,2020,4
"8683","SP",3,"Sudeste",35033,"Amparo",199990,37695.578819291,17,35,6,29,13,22,2,0,2,0,2,37,6,31,13,24,34,10.5372980938613,12.2060226442801,0.443816156834016,2020-04-27,2020,4
"8684","SP",3,"Sudeste",35033,"Amparo",199990,37695.578819291,18,52,12,40,21,31,0,0,0,0,0,52,12,40,21,31,30,10.5372980938613,12.2060226442801,0.421340722938086,2020-05-04,2020,5
"8685","SP",3,"Sudeste",35033,"Amparo",199990,37695.578819291,19,47,4,43,12,35,1,0,1,0,1,48,4,44,12,36,31,10.5372980938613,12.2060226442801,0.408443940493807,2020-05-11,2020,5
"8686","SP",3,"Sudeste",35033,"Amparo",199990,37695.578819291,20,52,12,40,19,33,0,0,0,0,0,52,12,40,19,33,43,10.5372980938613,12.2060226442801,0.408459965952073,2020-05-18,2020,5
"8687","SP",3,"Sudeste",35033,"Amparo",199990,37695.578819291,21,46,11,35,18,28,0,0,0,0,0,46,11,35,18,28,44,10.5372980938613,12.2060226442801,0.411482267928788,2020-05-25,2020,5
"8688","SP",3,"Sudeste",35034,"Dracena",126927,22507.5244067062,5,22,1,21,2,20,1,0,1,1,0,23,1,22,3,20,15,10.0216049503631,11.7513673970285,0.287991673454408,2020-02-03,2020,2
"8689","SP",3,"Sudeste",35034,"Dracena",126927,22507.5244067062,6,23,4,19,9,14,0,0,0,0,0,23,4,19,9,14,28,10.0216049503631,11.7513673970285,0.276802352353585,2020-02-10,2020,2
"8690","SP",3,"Sudeste",35034,"Dracena",126927,22507.5244067062,7,29,3,26,9,20,0,0,0,0,0,29,3,26,9,20,18,10.0216049503631,11.7513673970285,0.286658857558008,2020-02-17,2020,2
"8691","SP",3,"Sudeste",35034,"Dracena",126927,22507.5244067062,8,22,5,17,7,15,0,0,0,0,0,22,5,17,7,15,21,10.0216049503631,11.7513673970285,0.332577308455212,2020-02-24,2020,2
"8692","SP",3,"Sudeste",35034,"Dracena",126927,22507.5244067062,9,13,2,11,2,11,0,0,0,0,0,13,2,11,2,11,18,10.0216049503631,11.7513673970285,0.306307420047628,2020-03-02,2020,3
"8693","SP",3,"Sudeste",35034,"Dracena",126927,22507.5244067062,10,21,2,19,6,15,0,0,0,0,0,21,2,19,6,15,34,10.0216049503631,11.7513673970285,0.315945343161297,2020-03-09,2020,3
"8694","SP",3,"Sudeste",35034,"Dracena",126927,22507.5244067062,11,26,5,21,12,14,1,0,1,1,0,27,5,22,13,14,32,10.0216049503631,11.7513673970285,0.387944262444404,2020-03-16,2020,3
"8695","SP",3,"Sudeste",35034,"Dracena",126927,22507.5244067062,12,19,3,16,5,14,0,0,0,0,0,19,3,16,5,14,25,10.0216049503631,11.7513673970285,0.475565757136559,2020-03-23,2020,3
"8696","SP",3,"Sudeste",35034,"Dracena",126927,22507.5244067062,13,17,1,16,4,13,0,0,0,0,0,17,1,16,4,13,26,10.0216049503631,11.7513673970285,0.450211946298075,2020-03-30,2020,3
"8697","SP",3,"Sudeste",35034,"Dracena",126927,22507.5244067062,14,20,1,19,6,14,0,0,0,0,0,20,1,19,6,14,17,10.0216049503631,11.7513673970285,0.426490268635574,2020-04-06,2020,4
"8698","SP",3,"Sudeste",35034,"Dracena",126927,22507.5244067062,15,21,1,20,5,16,0,0,0,0,0,21,1,20,5,16,18,10.0216049503631,11.7513673970285,0.404673607828933,2020-04-13,2020,4
"8699","SP",3,"Sudeste",35034,"Dracena",126927,22507.5244067062,16,23,2,21,9,14,1,0,1,0,1,24,2,22,9,15,19,10.0216049503631,11.7513673970285,0.413529472365542,2020-04-20,2020,4
"8700","SP",3,"Sudeste",35034,"Dracena",126927,22507.5244067062,17,30,4,26,8,22,1,0,1,1,0,31,4,27,9,22,23,10.0216049503631,11.7513673970285,0.401834007600713,2020-04-27,2020,4
"8701","SP",3,"Sudeste",35034,"Dracena",126927,22507.5244067062,18,26,4,22,8,18,0,0,0,0,0,26,4,22,8,18,14,10.0216049503631,11.7513673970285,0.384741244232986,2020-05-04,2020,5
"8702","SP",3,"Sudeste",35034,"Dracena",126927,22507.5244067062,19,30,8,22,10,20,1,0,1,0,1,31,8,23,10,21,23,10.0216049503631,11.7513673970285,0.387513005186453,2020-05-11,2020,5
"8703","SP",3,"Sudeste",35034,"Dracena",126927,22507.5244067062,20,31,5,26,13,18,0,0,0,0,0,31,5,26,13,18,22,10.0216049503631,11.7513673970285,0.382340408490714,2020-05-18,2020,5
"8704","SP",3,"Sudeste",35034,"Dracena",126927,22507.5244067062,21,38,8,30,18,20,0,0,0,0,0,38,8,30,18,20,15,10.0216049503631,11.7513673970285,0.383567320910344,2020-05-25,2020,5
"8705","SP",3,"Sudeste",35035,"Adamantina",169804,23441.4872888153,5,35,4,31,10,25,0,0,0,0,0,35,4,31,10,25,29,10.0622626925661,12.042400109708,0.281221445351937,2020-02-03,2020,2
"8706","SP",3,"Sudeste",35035,"Adamantina",169804,23441.4872888153,6,22,5,17,7,15,1,1,0,0,1,23,6,17,7,16,26,10.0622626925661,12.042400109708,0.275519558133874,2020-02-10,2020,2
"8707","SP",3,"Sudeste",35035,"Adamantina",169804,23441.4872888153,7,29,0,29,11,18,0,0,0,0,0,29,0,29,11,18,32,10.0622626925661,12.042400109708,0.280784840724286,2020-02-17,2020,2
"8708","SP",3,"Sudeste",35035,"Adamantina",169804,23441.4872888153,8,24,6,18,6,18,0,0,0,0,0,24,6,18,6,18,29,10.0622626925661,12.042400109708,0.332905520336633,2020-02-24,2020,2
"8709","SP",3,"Sudeste",35035,"Adamantina",169804,23441.4872888153,9,31,3,28,10,21,0,0,0,0,0,31,3,28,10,21,35,10.0622626925661,12.042400109708,0.304033813860339,2020-03-02,2020,3
"8710","SP",3,"Sudeste",35035,"Adamantina",169804,23441.4872888153,10,38,5,33,12,26,0,0,0,0,0,38,5,33,12,26,19,10.0622626925661,12.042400109708,0.308847289825289,2020-03-09,2020,3
"8711","SP",3,"Sudeste",35035,"Adamantina",169804,23441.4872888153,11,33,9,24,19,14,0,0,0,0,0,33,9,24,19,14,21,10.0622626925661,12.042400109708,0.366923451235607,2020-03-16,2020,3
"8712","SP",3,"Sudeste",35035,"Adamantina",169804,23441.4872888153,12,27,3,24,8,19,0,0,0,0,0,27,3,24,8,19,29,10.0622626925661,12.042400109708,0.48542408008561,2020-03-23,2020,3
"8713","SP",3,"Sudeste",35035,"Adamantina",169804,23441.4872888153,13,16,6,10,4,12,1,0,1,1,0,17,6,11,5,12,27,10.0622626925661,12.042400109708,0.422055431077423,2020-03-30,2020,3
"8714","SP",3,"Sudeste",35035,"Adamantina",169804,23441.4872888153,14,24,3,21,8,16,0,0,0,0,0,24,3,21,8,16,26,10.0622626925661,12.042400109708,0.415821414727487,2020-04-06,2020,4
"8715","SP",3,"Sudeste",35035,"Adamantina",169804,23441.4872888153,15,24,3,21,6,18,1,1,0,0,1,25,4,21,6,19,27,10.0622626925661,12.042400109708,0.393924028191889,2020-04-13,2020,4
"8716","SP",3,"Sudeste",35035,"Adamantina",169804,23441.4872888153,16,31,5,26,9,22,0,0,0,0,0,31,5,26,9,22,21,10.0622626925661,12.042400109708,0.400479948682278,2020-04-20,2020,4
"8717","SP",3,"Sudeste",35035,"Adamantina",169804,23441.4872888153,17,29,5,24,11,18,0,0,0,0,0,29,5,24,11,18,24,10.0622626925661,12.042400109708,0.390786552012194,2020-04-27,2020,4
"8718","SP",3,"Sudeste",35035,"Adamantina",169804,23441.4872888153,18,32,8,24,14,18,0,0,0,0,0,32,8,24,14,18,24,10.0622626925661,12.042400109708,0.378367726125487,2020-05-04,2020,5
"8719","SP",3,"Sudeste",35035,"Adamantina",169804,23441.4872888153,19,28,4,24,9,19,0,0,0,0,0,28,4,24,9,19,25,10.0622626925661,12.042400109708,0.385651848312343,2020-05-11,2020,5
"8720","SP",3,"Sudeste",35035,"Adamantina",169804,23441.4872888153,20,32,6,26,14,18,1,0,1,1,0,33,6,27,15,18,23,10.0622626925661,12.042400109708,0.38353982018711,2020-05-18,2020,5
"8721","SP",3,"Sudeste",35035,"Adamantina",169804,23441.4872888153,21,36,8,28,9,27,1,0,1,0,1,37,8,29,9,28,26,10.0622626925661,12.042400109708,0.380158780242318,2020-05-25,2020,5
"8722","SP",3,"Sudeste",35036,"Presidente Prudente",616976,29141.2086118747,5,118,15,103,45,73,2,0,2,0,2,120,15,105,45,75,82,10.2799085549315,13.332585404238,0.284145567170822,2020-02-03,2020,2
"8723","SP",3,"Sudeste",35036,"Presidente Prudente",616976,29141.2086118747,6,110,10,100,38,72,2,0,2,0,2,112,10,102,38,74,88,10.2799085549315,13.332585404238,0.282793299094733,2020-02-10,2020,2
"8724","SP",3,"Sudeste",35036,"Presidente Prudente",616976,29141.2086118747,7,115,18,97,44,71,1,0,1,0,1,116,18,98,44,72,86,10.2799085549315,13.332585404238,0.293699470433127,2020-02-17,2020,2
"8725","SP",3,"Sudeste",35036,"Presidente Prudente",616976,29141.2086118747,8,135,19,116,40,95,0,0,0,0,0,135,19,116,40,95,90,10.2799085549315,13.332585404238,0.33793148420144,2020-02-24,2020,2
"8726","SP",3,"Sudeste",35036,"Presidente Prudente",616976,29141.2086118747,9,117,18,99,43,74,0,0,0,0,0,117,18,99,43,74,72,10.2799085549315,13.332585404238,0.311057431577602,2020-03-02,2020,3
"8727","SP",3,"Sudeste",35036,"Presidente Prudente",616976,29141.2086118747,10,128,21,107,53,75,1,0,1,0,1,129,21,108,53,76,96,10.2799085549315,13.332585404238,0.320444974593653,2020-03-09,2020,3
"8728","SP",3,"Sudeste",35036,"Presidente Prudente",616976,29141.2086118747,11,133,15,118,47,86,1,0,1,0,1,134,15,119,47,87,92,10.2799085549315,13.332585404238,0.396780280028104,2020-03-16,2020,3
"8729","SP",3,"Sudeste",35036,"Presidente Prudente",616976,29141.2086118747,12,120,15,105,45,75,2,0,2,1,1,122,15,107,46,76,92,10.2799085549315,13.332585404238,0.502529640412171,2020-03-23,2020,3
"8730","SP",3,"Sudeste",35036,"Presidente Prudente",616976,29141.2086118747,13,112,16,96,38,74,2,0,2,1,1,114,16,98,39,75,89,10.2799085549315,13.332585404238,0.463717392504875,2020-03-30,2020,3
"8731","SP",3,"Sudeste",35036,"Presidente Prudente",616976,29141.2086118747,14,137,15,122,52,85,2,1,1,1,1,139,16,123,53,86,95,10.2799085549315,13.332585404238,0.450000384928383,2020-04-06,2020,4
"8732","SP",3,"Sudeste",35036,"Presidente Prudente",616976,29141.2086118747,15,126,19,107,46,80,0,0,0,0,0,126,19,107,46,80,83,10.2799085549315,13.332585404238,0.430305837565959,2020-04-13,2020,4
"8733","SP",3,"Sudeste",35036,"Presidente Prudente",616976,29141.2086118747,16,135,22,113,52,83,1,0,1,1,0,136,22,114,53,83,82,10.2799085549315,13.332585404238,0.434207218712221,2020-04-20,2020,4
"8734","SP",3,"Sudeste",35036,"Presidente Prudente",616976,29141.2086118747,17,139,17,122,44,95,1,0,1,1,0,140,17,123,45,95,79,10.2799085549315,13.332585404238,0.425241254521567,2020-04-27,2020,4
"8735","SP",3,"Sudeste",35036,"Presidente Prudente",616976,29141.2086118747,18,132,15,117,44,88,0,0,0,0,0,132,15,117,44,88,91,10.2799085549315,13.332585404238,0.401905298179367,2020-05-04,2020,5
"8736","SP",3,"Sudeste",35036,"Presidente Prudente",616976,29141.2086118747,19,122,16,106,45,77,0,0,0,0,0,122,16,106,45,77,81,10.2799085549315,13.332585404238,0.410096885263018,2020-05-11,2020,5
"8737","SP",3,"Sudeste",35036,"Presidente Prudente",616976,29141.2086118747,20,145,17,128,42,103,1,0,1,0,1,146,17,129,42,104,75,10.2799085549315,13.332585404238,0.404951802482689,2020-05-18,2020,5
"8738","SP",3,"Sudeste",35036,"Presidente Prudente",616976,29141.2086118747,21,141,15,126,47,94,2,1,1,0,2,143,16,127,47,96,101,10.2799085549315,13.332585404238,0.406314178324715,2020-05-25,2020,5
"8739","SP",3,"Sudeste",35037,"Tupã",114327,33492.1263829192,5,22,3,19,5,17,0,0,0,0,0,22,3,19,5,17,22,10.4190656568428,11.6468180423597,0.279767202224961,2020-02-03,2020,2
"8740","SP",3,"Sudeste",35037,"Tupã",114327,33492.1263829192,6,28,1,27,6,22,0,0,0,0,0,28,1,27,6,22,18,10.4190656568428,11.6468180423597,0.284666560472176,2020-02-10,2020,2
"8741","SP",3,"Sudeste",35037,"Tupã",114327,33492.1263829192,7,19,1,18,8,11,1,0,1,1,0,20,1,19,9,11,14,10.4190656568428,11.6468180423597,0.276637571920239,2020-02-17,2020,2
"8742","SP",3,"Sudeste",35037,"Tupã",114327,33492.1263829192,8,17,0,17,5,12,0,0,0,0,0,17,0,17,5,12,18,10.4190656568428,11.6468180423597,0.330230446885367,2020-02-24,2020,2
"8743","SP",3,"Sudeste",35037,"Tupã",114327,33492.1263829192,9,29,5,24,9,20,0,0,0,0,0,29,5,24,9,20,16,10.4190656568428,11.6468180423597,0.300220769954125,2020-03-02,2020,3
"8744","SP",3,"Sudeste",35037,"Tupã",114327,33492.1263829192,10,23,3,20,7,16,0,0,0,0,0,23,3,20,7,16,21,10.4190656568428,11.6468180423597,0.302533625564898,2020-03-09,2020,3
"8745","SP",3,"Sudeste",35037,"Tupã",114327,33492.1263829192,11,25,3,22,7,18,2,1,1,1,1,27,4,23,8,19,27,10.4190656568428,11.6468180423597,0.362756531036103,2020-03-16,2020,3
"8746","SP",3,"Sudeste",35037,"Tupã",114327,33492.1263829192,12,19,4,15,8,11,0,0,0,0,0,19,4,15,8,11,21,10.4190656568428,11.6468180423597,0.45577895036532,2020-03-23,2020,3
"8747","SP",3,"Sudeste",35037,"Tupã",114327,33492.1263829192,13,17,3,14,6,11,0,0,0,0,0,17,3,14,6,11,13,10.4190656568428,11.6468180423597,0.420697121187796,2020-03-30,2020,3
"8748","SP",3,"Sudeste",35037,"Tupã",114327,33492.1263829192,14,17,2,15,2,15,0,0,0,0,0,17,2,15,2,15,12,10.4190656568428,11.6468180423597,0.411856374626964,2020-04-06,2020,4
"8749","SP",3,"Sudeste",35037,"Tupã",114327,33492.1263829192,15,19,3,16,5,14,0,0,0,0,0,19,3,16,5,14,20,10.4190656568428,11.6468180423597,0.389319247592296,2020-04-13,2020,4
"8750","SP",3,"Sudeste",35037,"Tupã",114327,33492.1263829192,16,22,4,18,9,13,0,0,0,0,0,22,4,18,9,13,12,10.4190656568428,11.6468180423597,0.40279088592135,2020-04-20,2020,4
"8751","SP",3,"Sudeste",35037,"Tupã",114327,33492.1263829192,17,26,3,23,5,21,0,0,0,0,0,26,3,23,5,21,20,10.4190656568428,11.6468180423597,0.398885093087168,2020-04-27,2020,4
"8752","SP",3,"Sudeste",35037,"Tupã",114327,33492.1263829192,18,25,2,23,11,14,0,0,0,0,0,25,2,23,11,14,18,10.4190656568428,11.6468180423597,0.369490109746466,2020-05-04,2020,5
"8753","SP",3,"Sudeste",35037,"Tupã",114327,33492.1263829192,19,29,2,27,9,20,0,0,0,0,0,29,2,27,9,20,11,10.4190656568428,11.6468180423597,0.379176152713796,2020-05-11,2020,5
"8754","SP",3,"Sudeste",35037,"Tupã",114327,33492.1263829192,20,34,4,30,10,24,0,0,0,0,0,34,4,30,10,24,16,10.4190656568428,11.6468180423597,0.367157833829223,2020-05-18,2020,5
"8755","SP",3,"Sudeste",35037,"Tupã",114327,33492.1263829192,21,28,6,22,13,15,0,0,0,0,0,28,6,22,13,15,23,10.4190656568428,11.6468180423597,0.377491428526055,2020-05-25,2020,5
"8756","SP",3,"Sudeste",35038,"Marília",358810,32334.2840737159,5,63,3,60,12,51,0,0,0,0,0,63,3,60,12,51,47,10.3838833727268,12.7905482794584,0.275270415489009,2020-02-03,2020,2
"8757","SP",3,"Sudeste",35038,"Marília",358810,32334.2840737159,6,59,6,53,20,39,1,0,1,0,1,60,6,54,20,40,45,10.3838833727268,12.7905482794584,0.2729766161911,2020-02-10,2020,2
"8758","SP",3,"Sudeste",35038,"Marília",358810,32334.2840737159,7,60,6,54,22,38,0,0,0,0,0,60,6,54,22,38,49,10.3838833727268,12.7905482794584,0.282524493367225,2020-02-17,2020,2
"8759","SP",3,"Sudeste",35038,"Marília",358810,32334.2840737159,8,78,4,74,25,53,0,0,0,0,0,78,4,74,25,53,47,10.3838833727268,12.7905482794584,0.332053781989662,2020-02-24,2020,2
"8760","SP",3,"Sudeste",35038,"Marília",358810,32334.2840737159,9,75,12,63,26,49,0,0,0,0,0,75,12,63,26,49,40,10.3838833727268,12.7905482794584,0.299752356176602,2020-03-02,2020,3
"8761","SP",3,"Sudeste",35038,"Marília",358810,32334.2840737159,10,72,2,70,25,47,2,0,2,1,1,74,2,72,26,48,63,10.3838833727268,12.7905482794584,0.309646305084014,2020-03-09,2020,3
"8762","SP",3,"Sudeste",35038,"Marília",358810,32334.2840737159,11,88,10,78,29,59,0,0,0,0,0,88,10,78,29,59,53,10.3838833727268,12.7905482794584,0.386612274331777,2020-03-16,2020,3
"8763","SP",3,"Sudeste",35038,"Marília",358810,32334.2840737159,12,79,2,77,22,57,1,0,1,1,0,80,2,78,23,57,63,10.3838833727268,12.7905482794584,0.502146250206044,2020-03-23,2020,3
"8764","SP",3,"Sudeste",35038,"Marília",358810,32334.2840737159,13,67,4,63,18,49,0,0,0,0,0,67,4,63,18,49,63,10.3838833727268,12.7905482794584,0.461849012397057,2020-03-30,2020,3
"8765","SP",3,"Sudeste",35038,"Marília",358810,32334.2840737159,14,79,11,68,26,53,0,0,0,0,0,79,11,68,26,53,51,10.3838833727268,12.7905482794584,0.444939763980523,2020-04-06,2020,4
"8766","SP",3,"Sudeste",35038,"Marília",358810,32334.2840737159,15,76,8,68,28,48,1,0,1,1,0,77,8,69,29,48,34,10.3838833727268,12.7905482794584,0.42913278055393,2020-04-13,2020,4
"8767","SP",3,"Sudeste",35038,"Marília",358810,32334.2840737159,16,62,5,57,18,44,0,0,0,0,0,62,5,57,18,44,39,10.3838833727268,12.7905482794584,0.432777871907917,2020-04-20,2020,4
"8768","SP",3,"Sudeste",35038,"Marília",358810,32334.2840737159,17,73,4,69,24,49,0,0,0,0,0,73,4,69,24,49,37,10.3838833727268,12.7905482794584,0.415249047707714,2020-04-27,2020,4
"8769","SP",3,"Sudeste",35038,"Marília",358810,32334.2840737159,18,77,7,70,24,53,1,1,0,1,0,78,8,70,25,53,45,10.3838833727268,12.7905482794584,0.392668258225043,2020-05-04,2020,5
"8770","SP",3,"Sudeste",35038,"Marília",358810,32334.2840737159,19,70,7,63,16,54,0,0,0,0,0,70,7,63,16,54,48,10.3838833727268,12.7905482794584,0.396277826158494,2020-05-11,2020,5
"8771","SP",3,"Sudeste",35038,"Marília",358810,32334.2840737159,20,86,9,77,24,62,0,0,0,0,0,86,9,77,24,62,59,10.3838833727268,12.7905482794584,0.394063581589181,2020-05-18,2020,5
"8772","SP",3,"Sudeste",35038,"Marília",358810,32334.2840737159,21,79,8,71,22,57,0,0,0,0,0,79,8,71,22,57,38,10.3838833727268,12.7905482794584,0.389408080297552,2020-05-25,2020,5
"8773","SP",3,"Sudeste",35039,"Assis",287142,34218.7956317432,5,58,11,47,13,45,0,0,0,0,0,58,11,47,13,45,41,10.4405303519625,12.5677321459009,0.284949824408013,2020-02-03,2020,2
"8774","SP",3,"Sudeste",35039,"Assis",287142,34218.7956317432,6,49,6,43,16,33,1,0,1,0,1,50,6,44,16,34,37,10.4405303519625,12.5677321459009,0.284341053244949,2020-02-10,2020,2
"8775","SP",3,"Sudeste",35039,"Assis",287142,34218.7956317432,7,65,13,52,24,41,0,0,0,0,0,65,13,52,24,41,36,10.4405303519625,12.5677321459009,0.291717266541795,2020-02-17,2020,2
"8776","SP",3,"Sudeste",35039,"Assis",287142,34218.7956317432,8,52,8,44,20,32,0,0,0,0,0,52,8,44,20,32,49,10.4405303519625,12.5677321459009,0.334249583866901,2020-02-24,2020,2
"8777","SP",3,"Sudeste",35039,"Assis",287142,34218.7956317432,9,55,8,47,23,32,0,0,0,0,0,55,8,47,23,32,40,10.4405303519625,12.5677321459009,0.312496127693359,2020-03-02,2020,3
"8778","SP",3,"Sudeste",35039,"Assis",287142,34218.7956317432,10,52,7,45,18,34,0,0,0,0,0,52,7,45,18,34,38,10.4405303519625,12.5677321459009,0.329417255681226,2020-03-09,2020,3
"8779","SP",3,"Sudeste",35039,"Assis",287142,34218.7956317432,11,57,9,48,16,41,0,0,0,0,0,57,9,48,16,41,38,10.4405303519625,12.5677321459009,0.399722734704237,2020-03-16,2020,3
"8780","SP",3,"Sudeste",35039,"Assis",287142,34218.7956317432,12,51,7,44,21,30,1,0,1,1,0,52,7,45,22,30,48,10.4405303519625,12.5677321459009,0.506316635224491,2020-03-23,2020,3
"8781","SP",3,"Sudeste",35039,"Assis",287142,34218.7956317432,13,36,6,30,15,21,0,0,0,0,0,36,6,30,15,21,37,10.4405303519625,12.5677321459009,0.456903876916759,2020-03-30,2020,3
"8782","SP",3,"Sudeste",35039,"Assis",287142,34218.7956317432,14,47,4,43,17,30,0,0,0,0,0,47,4,43,17,30,35,10.4405303519625,12.5677321459009,0.449601743436686,2020-04-06,2020,4
"8783","SP",3,"Sudeste",35039,"Assis",287142,34218.7956317432,15,54,6,48,27,27,1,0,1,0,1,55,6,49,27,28,43,10.4405303519625,12.5677321459009,0.43033448418106,2020-04-13,2020,4
"8784","SP",3,"Sudeste",35039,"Assis",287142,34218.7956317432,16,38,8,30,19,19,1,0,1,0,1,39,8,31,19,20,38,10.4405303519625,12.5677321459009,0.431697634214305,2020-04-20,2020,4
"8785","SP",3,"Sudeste",35039,"Assis",287142,34218.7956317432,17,58,5,53,26,32,0,0,0,0,0,58,5,53,26,32,30,10.4405303519625,12.5677321459009,0.427353266468982,2020-04-27,2020,4
"8786","SP",3,"Sudeste",35039,"Assis",287142,34218.7956317432,18,60,6,54,23,37,1,0,1,1,0,61,6,55,24,37,49,10.4405303519625,12.5677321459009,0.407660239790953,2020-05-04,2020,5
"8787","SP",3,"Sudeste",35039,"Assis",287142,34218.7956317432,19,59,4,55,17,42,0,0,0,0,0,59,4,55,17,42,54,10.4405303519625,12.5677321459009,0.408916984582682,2020-05-11,2020,5
"8788","SP",3,"Sudeste",35039,"Assis",287142,34218.7956317432,20,69,8,61,21,48,0,0,0,0,0,69,8,61,21,48,44,10.4405303519625,12.5677321459009,0.407230792767464,2020-05-18,2020,5
"8789","SP",3,"Sudeste",35039,"Assis",287142,34218.7956317432,21,64,10,54,21,43,0,0,0,0,0,64,10,54,21,43,42,10.4405303519625,12.5677321459009,0.401980477060779,2020-05-25,2020,5
"8790","SP",3,"Sudeste",35040,"Ourinhos",315943,27559.6522967751,5,69,10,59,25,44,1,1,0,0,1,70,11,59,25,45,48,10.2241081088207,12.6633170965518,0.29752096681904,2020-02-03,2020,2
"8791","SP",3,"Sudeste",35040,"Ourinhos",315943,27559.6522967751,6,74,11,63,33,41,2,0,2,1,1,76,11,65,34,42,42,10.2241081088207,12.6633170965518,0.295207628899874,2020-02-10,2020,2
"8792","SP",3,"Sudeste",35040,"Ourinhos",315943,27559.6522967751,7,66,13,53,24,42,0,0,0,0,0,66,13,53,24,42,34,10.2241081088207,12.6633170965518,0.299425499975771,2020-02-17,2020,2
"8793","SP",3,"Sudeste",35040,"Ourinhos",315943,27559.6522967751,8,65,9,56,20,45,0,0,0,0,0,65,9,56,20,45,46,10.2241081088207,12.6633170965518,0.341784990858127,2020-02-24,2020,2
"8794","SP",3,"Sudeste",35040,"Ourinhos",315943,27559.6522967751,9,64,7,57,16,48,1,1,0,1,0,65,8,57,17,48,46,10.2241081088207,12.6633170965518,0.312846468441658,2020-03-02,2020,3
"8795","SP",3,"Sudeste",35040,"Ourinhos",315943,27559.6522967751,10,74,20,54,27,47,0,0,0,0,0,74,20,54,27,47,56,10.2241081088207,12.6633170965518,0.325190052730743,2020-03-09,2020,3
"8796","SP",3,"Sudeste",35040,"Ourinhos",315943,27559.6522967751,11,70,12,58,28,42,0,0,0,0,0,70,12,58,28,42,44,10.2241081088207,12.6633170965518,0.402729475943378,2020-03-16,2020,3
"8797","SP",3,"Sudeste",35040,"Ourinhos",315943,27559.6522967751,12,60,17,43,22,38,1,0,1,0,1,61,17,44,22,39,41,10.2241081088207,12.6633170965518,0.512188882971444,2020-03-23,2020,3
"8798","SP",3,"Sudeste",35040,"Ourinhos",315943,27559.6522967751,13,58,11,47,23,35,0,0,0,0,0,58,11,47,23,35,43,10.2241081088207,12.6633170965518,0.471495470892942,2020-03-30,2020,3
"8799","SP",3,"Sudeste",35040,"Ourinhos",315943,27559.6522967751,14,48,10,38,19,29,1,0,1,1,0,49,10,39,20,29,40,10.2241081088207,12.6633170965518,0.466984934959971,2020-04-06,2020,4
"8800","SP",3,"Sudeste",35040,"Ourinhos",315943,27559.6522967751,15,63,17,46,24,39,0,0,0,0,0,63,17,46,24,39,52,10.2241081088207,12.6633170965518,0.448197870135686,2020-04-13,2020,4
"8801","SP",3,"Sudeste",35040,"Ourinhos",315943,27559.6522967751,16,63,9,54,22,41,1,0,1,1,0,64,9,55,23,41,43,10.2241081088207,12.6633170965518,0.444682467475721,2020-04-20,2020,4
"8802","SP",3,"Sudeste",35040,"Ourinhos",315943,27559.6522967751,17,55,7,48,27,28,0,0,0,0,0,55,7,48,27,28,32,10.2241081088207,12.6633170965518,0.431799420342651,2020-04-27,2020,4
"8803","SP",3,"Sudeste",35040,"Ourinhos",315943,27559.6522967751,18,58,13,45,20,38,2,0,2,1,1,60,13,47,21,39,41,10.2241081088207,12.6633170965518,0.416563760832182,2020-05-04,2020,5
"8804","SP",3,"Sudeste",35040,"Ourinhos",315943,27559.6522967751,19,55,8,47,19,36,0,0,0,0,0,55,8,47,19,36,46,10.2241081088207,12.6633170965518,0.411497340949059,2020-05-11,2020,5
"8805","SP",3,"Sudeste",35040,"Ourinhos",315943,27559.6522967751,20,66,11,55,22,44,1,1,0,1,0,67,12,55,23,44,52,10.2241081088207,12.6633170965518,0.416607031161804,2020-05-18,2020,5
"8806","SP",3,"Sudeste",35040,"Ourinhos",315943,27559.6522967751,21,84,17,67,31,53,0,0,0,0,0,84,17,67,31,53,47,10.2241081088207,12.6633170965518,0.41288332868126,2020-05-25,2020,5
"8807","SP",3,"Sudeste",35041,"Itapeva",254651,23459.0357272895,5,56,11,45,23,33,0,0,0,0,0,56,11,45,23,33,27,10.0630110185191,12.4476492592636,0.324212822158799,2020-02-03,2020,2
"8808","SP",3,"Sudeste",35041,"Itapeva",254651,23459.0357272895,6,63,15,48,28,35,1,1,0,1,0,64,16,48,29,35,34,10.0630110185191,12.4476492592636,0.319597183812684,2020-02-10,2020,2
"8809","SP",3,"Sudeste",35041,"Itapeva",254651,23459.0357272895,7,72,15,57,30,42,1,1,0,1,0,73,16,57,31,42,26,10.0630110185191,12.4476492592636,0.339154801952979,2020-02-17,2020,2
"8810","SP",3,"Sudeste",35041,"Itapeva",254651,23459.0357272895,8,52,12,40,28,24,0,0,0,0,0,52,12,40,28,24,37,10.0630110185191,12.4476492592636,0.384700667218235,2020-02-24,2020,2
"8811","SP",3,"Sudeste",35041,"Itapeva",254651,23459.0357272895,9,67,15,52,29,38,0,0,0,0,0,67,15,52,29,38,29,10.0630110185191,12.4476492592636,0.349322833425346,2020-03-02,2020,3
"8812","SP",3,"Sudeste",35041,"Itapeva",254651,23459.0357272895,10,62,19,43,27,35,0,0,0,0,0,62,19,43,27,35,31,10.0630110185191,12.4476492592636,0.353076332726747,2020-03-09,2020,3
"8813","SP",3,"Sudeste",35041,"Itapeva",254651,23459.0357272895,11,58,14,44,22,36,0,0,0,0,0,58,14,44,22,36,29,10.0630110185191,12.4476492592636,0.452487092839594,2020-03-16,2020,3
"8814","SP",3,"Sudeste",35041,"Itapeva",254651,23459.0357272895,12,54,12,42,25,29,0,0,0,0,0,54,12,42,25,29,39,10.0630110185191,12.4476492592636,0.554339641362305,2020-03-23,2020,3
"8815","SP",3,"Sudeste",35041,"Itapeva",254651,23459.0357272895,13,60,16,44,18,42,2,0,2,2,0,62,16,46,20,42,41,10.0630110185191,12.4476492592636,0.520953273705028,2020-03-30,2020,3
"8816","SP",3,"Sudeste",35041,"Itapeva",254651,23459.0357272895,14,66,18,48,35,31,0,0,0,0,0,66,18,48,35,31,37,10.0630110185191,12.4476492592636,0.498106945160202,2020-04-06,2020,4
"8817","SP",3,"Sudeste",35041,"Itapeva",254651,23459.0357272895,15,64,10,54,28,36,0,0,0,0,0,64,10,54,28,36,35,10.0630110185191,12.4476492592636,0.47986065697977,2020-04-13,2020,4
"8818","SP",3,"Sudeste",35041,"Itapeva",254651,23459.0357272895,16,70,15,55,37,33,0,0,0,0,0,70,15,55,37,33,47,10.0630110185191,12.4476492592636,0.469886461530251,2020-04-20,2020,4
"8819","SP",3,"Sudeste",35041,"Itapeva",254651,23459.0357272895,17,70,15,55,24,46,0,0,0,0,0,70,15,55,24,46,29,10.0630110185191,12.4476492592636,0.462248313211059,2020-04-27,2020,4
"8820","SP",3,"Sudeste",35041,"Itapeva",254651,23459.0357272895,18,72,19,53,27,45,1,0,1,1,0,73,19,54,28,45,41,10.0630110185191,12.4476492592636,0.441219087160883,2020-05-04,2020,5
"8821","SP",3,"Sudeste",35041,"Itapeva",254651,23459.0357272895,19,55,18,37,18,37,3,0,3,3,0,58,18,40,21,37,35,10.0630110185191,12.4476492592636,0.452771891719963,2020-05-11,2020,5
"8822","SP",3,"Sudeste",35041,"Itapeva",254651,23459.0357272895,20,76,10,66,26,50,0,0,0,0,0,76,10,66,26,50,40,10.0630110185191,12.4476492592636,0.454360933115063,2020-05-18,2020,5
"8823","SP",3,"Sudeste",35041,"Itapeva",254651,23459.0357272895,21,64,13,51,23,41,0,0,0,0,0,64,13,51,23,41,29,10.0630110185191,12.4476492592636,0.449750357441592,2020-05-25,2020,5
"8824","SP",3,"Sudeste",35042,"Itapetininga",222078,28483.5200973532,5,42,6,36,19,23,0,0,0,0,0,42,6,36,19,23,18,10.2570809568121,12.3107839504963,0.291311521383286,2020-02-03,2020,2
"8825","SP",3,"Sudeste",35042,"Itapetininga",222078,28483.5200973532,6,38,8,30,16,22,0,0,0,0,0,38,8,30,16,22,21,10.2570809568121,12.3107839504963,0.27875665646427,2020-02-10,2020,2
"8826","SP",3,"Sudeste",35042,"Itapetininga",222078,28483.5200973532,7,27,4,23,8,19,0,0,0,0,0,27,4,23,8,19,31,10.2570809568121,12.3107839504963,0.296620037311231,2020-02-17,2020,2
"8827","SP",3,"Sudeste",35042,"Itapetininga",222078,28483.5200973532,8,53,12,41,11,42,0,0,0,0,0,53,12,41,11,42,26,10.2570809568121,12.3107839504963,0.349968707273249,2020-02-24,2020,2
"8828","SP",3,"Sudeste",35042,"Itapetininga",222078,28483.5200973532,9,49,9,40,18,31,0,0,0,0,0,49,9,40,18,31,26,10.2570809568121,12.3107839504963,0.317219873093853,2020-03-02,2020,3
"8829","SP",3,"Sudeste",35042,"Itapetininga",222078,28483.5200973532,10,41,7,34,14,27,1,0,1,0,1,42,7,35,14,28,32,10.2570809568121,12.3107839504963,0.329697003751475,2020-03-09,2020,3
"8830","SP",3,"Sudeste",35042,"Itapetininga",222078,28483.5200973532,11,40,7,33,17,23,0,0,0,0,0,40,7,33,17,23,29,10.2570809568121,12.3107839504963,0.413013560414352,2020-03-16,2020,3
"8831","SP",3,"Sudeste",35042,"Itapetininga",222078,28483.5200973532,12,46,7,39,21,25,0,0,0,0,0,46,7,39,21,25,30,10.2570809568121,12.3107839504963,0.514727622173267,2020-03-23,2020,3
"8832","SP",3,"Sudeste",35042,"Itapetininga",222078,28483.5200973532,13,54,10,44,21,33,0,0,0,0,0,54,10,44,21,33,25,10.2570809568121,12.3107839504963,0.479062813193894,2020-03-30,2020,3
"8833","SP",3,"Sudeste",35042,"Itapetininga",222078,28483.5200973532,14,49,9,40,24,25,0,0,0,0,0,49,9,40,24,25,19,10.2570809568121,12.3107839504963,0.469695877262245,2020-04-06,2020,4
"8834","SP",3,"Sudeste",35042,"Itapetininga",222078,28483.5200973532,15,44,6,38,18,26,0,0,0,0,0,44,6,38,18,26,20,10.2570809568121,12.3107839504963,0.448401132048603,2020-04-13,2020,4
"8835","SP",3,"Sudeste",35042,"Itapetininga",222078,28483.5200973532,16,55,8,47,22,33,0,0,0,0,0,55,8,47,22,33,22,10.2570809568121,12.3107839504963,0.449208666678933,2020-04-20,2020,4
"8836","SP",3,"Sudeste",35042,"Itapetininga",222078,28483.5200973532,17,40,6,34,14,26,1,1,0,0,1,41,7,34,14,27,25,10.2570809568121,12.3107839504963,0.431528905777684,2020-04-27,2020,4
"8837","SP",3,"Sudeste",35042,"Itapetininga",222078,28483.5200973532,18,54,8,46,18,36,0,0,0,0,0,54,8,46,18,36,27,10.2570809568121,12.3107839504963,0.408866101169416,2020-05-04,2020,5
"8838","SP",3,"Sudeste",35042,"Itapetininga",222078,28483.5200973532,19,50,9,41,22,28,0,0,0,0,0,50,9,41,22,28,26,10.2570809568121,12.3107839504963,0.414697555023358,2020-05-11,2020,5
"8839","SP",3,"Sudeste",35042,"Itapetininga",222078,28483.5200973532,20,53,4,49,24,29,0,0,0,0,0,53,4,49,24,29,22,10.2570809568121,12.3107839504963,0.419417062077627,2020-05-18,2020,5
"8840","SP",3,"Sudeste",35042,"Itapetininga",222078,28483.5200973532,21,51,12,39,19,32,1,0,1,0,1,52,12,40,19,33,28,10.2570809568121,12.3107839504963,0.409825119807777,2020-05-25,2020,5
"8841","SP",3,"Sudeste",35043,"Tatuí",307215,34370.7045889686,5,61,14,47,16,45,1,0,1,0,1,62,14,48,16,46,34,10.4449598697492,12.6353031071886,0.29060798197394,2020-02-03,2020,2
"8842","SP",3,"Sudeste",35043,"Tatuí",307215,34370.7045889686,6,52,13,39,24,28,0,0,0,0,0,52,13,39,24,28,40,10.4449598697492,12.6353031071886,0.292192788672789,2020-02-10,2020,2
"8843","SP",3,"Sudeste",35043,"Tatuí",307215,34370.7045889686,7,58,14,44,17,41,0,0,0,0,0,58,14,44,17,41,48,10.4449598697492,12.6353031071886,0.295271285579881,2020-02-17,2020,2
"8844","SP",3,"Sudeste",35043,"Tatuí",307215,34370.7045889686,8,61,12,49,18,43,0,0,0,0,0,61,12,49,18,43,31,10.4449598697492,12.6353031071886,0.345838924575846,2020-02-24,2020,2
"8845","SP",3,"Sudeste",35043,"Tatuí",307215,34370.7045889686,9,67,8,59,23,44,1,1,0,1,0,68,9,59,24,44,36,10.4449598697492,12.6353031071886,0.31973235446201,2020-03-02,2020,3
"8846","SP",3,"Sudeste",35043,"Tatuí",307215,34370.7045889686,10,74,11,63,28,46,0,0,0,0,0,74,11,63,28,46,45,10.4449598697492,12.6353031071886,0.326928117352435,2020-03-09,2020,3
"8847","SP",3,"Sudeste",35043,"Tatuí",307215,34370.7045889686,11,63,12,51,19,44,1,0,1,1,0,64,12,52,20,44,41,10.4449598697492,12.6353031071886,0.410238281258535,2020-03-16,2020,3
"8848","SP",3,"Sudeste",35043,"Tatuí",307215,34370.7045889686,12,60,12,48,21,39,1,0,1,1,0,61,12,49,22,39,35,10.4449598697492,12.6353031071886,0.519507898710323,2020-03-23,2020,3
"8849","SP",3,"Sudeste",35043,"Tatuí",307215,34370.7045889686,13,63,19,44,29,34,2,0,2,0,2,65,19,46,29,36,28,10.4449598697492,12.6353031071886,0.485813864289129,2020-03-30,2020,3
"8850","SP",3,"Sudeste",35043,"Tatuí",307215,34370.7045889686,14,60,10,50,25,35,0,0,0,0,0,60,10,50,25,35,39,10.4449598697492,12.6353031071886,0.46841598539648,2020-04-06,2020,4
"8851","SP",3,"Sudeste",35043,"Tatuí",307215,34370.7045889686,15,65,15,50,25,40,0,0,0,0,0,65,15,50,25,40,49,10.4449598697492,12.6353031071886,0.44990387152534,2020-04-13,2020,4
"8852","SP",3,"Sudeste",35043,"Tatuí",307215,34370.7045889686,16,69,18,51,23,46,0,0,0,0,0,69,18,51,23,46,36,10.4449598697492,12.6353031071886,0.443801868531569,2020-04-20,2020,4
"8853","SP",3,"Sudeste",35043,"Tatuí",307215,34370.7045889686,17,67,14,53,24,43,2,0,2,0,2,69,14,55,24,45,33,10.4449598697492,12.6353031071886,0.434057016200873,2020-04-27,2020,4
"8854","SP",3,"Sudeste",35043,"Tatuí",307215,34370.7045889686,18,65,7,58,17,48,1,1,0,0,1,66,8,58,17,49,46,10.4449598697492,12.6353031071886,0.414284973022011,2020-05-04,2020,5
"8855","SP",3,"Sudeste",35043,"Tatuí",307215,34370.7045889686,19,97,20,77,33,64,1,0,1,1,0,98,20,78,34,64,41,10.4449598697492,12.6353031071886,0.420613279764764,2020-05-11,2020,5
"8856","SP",3,"Sudeste",35043,"Tatuí",307215,34370.7045889686,20,73,13,60,28,45,0,0,0,0,0,73,13,60,28,45,42,10.4449598697492,12.6353031071886,0.413666134537288,2020-05-18,2020,5
"8857","SP",3,"Sudeste",35043,"Tatuí",307215,34370.7045889686,21,84,13,71,35,49,0,0,0,0,0,84,13,71,35,49,47,10.4449598697492,12.6353031071886,0.419569543431914,2020-05-25,2020,5
"8858","SP",3,"Sudeste",35044,"Capão Bonito",133146,19811.9742961861,5,46,8,38,23,23,0,0,0,0,0,46,8,38,23,23,22,9.89404179632117,11.799201549484,0.312882245345294,2020-02-03,2020,2
"8859","SP",3,"Sudeste",35044,"Capão Bonito",133146,19811.9742961861,6,32,7,25,17,15,0,0,0,0,0,32,7,25,17,15,19,9.89404179632117,11.799201549484,0.301285205143247,2020-02-10,2020,2
"8860","SP",3,"Sudeste",35044,"Capão Bonito",133146,19811.9742961861,7,24,4,20,13,11,0,0,0,0,0,24,4,20,13,11,29,9.89404179632117,11.799201549484,0.32000626332426,2020-02-17,2020,2
"8861","SP",3,"Sudeste",35044,"Capão Bonito",133146,19811.9742961861,8,40,8,32,14,26,3,0,3,2,1,43,8,35,16,27,16,9.89404179632117,11.799201549484,0.357665856787597,2020-02-24,2020,2
"8862","SP",3,"Sudeste",35044,"Capão Bonito",133146,19811.9742961861,9,37,10,27,20,17,0,0,0,0,0,37,10,27,20,17,24,9.89404179632117,11.799201549484,0.332822223193485,2020-03-02,2020,3
"8863","SP",3,"Sudeste",35044,"Capão Bonito",133146,19811.9742961861,10,41,8,33,19,22,0,0,0,0,0,41,8,33,19,22,16,9.89404179632117,11.799201549484,0.341096779671766,2020-03-09,2020,3
"8864","SP",3,"Sudeste",35044,"Capão Bonito",133146,19811.9742961861,11,29,7,22,10,19,0,0,0,0,0,29,7,22,10,19,19,9.89404179632117,11.799201549484,0.417011512196955,2020-03-16,2020,3
"8865","SP",3,"Sudeste",35044,"Capão Bonito",133146,19811.9742961861,12,31,10,21,13,18,1,0,1,0,1,32,10,22,13,19,22,9.89404179632117,11.799201549484,0.522251101939982,2020-03-23,2020,3
"8866","SP",3,"Sudeste",35044,"Capão Bonito",133146,19811.9742961861,13,30,7,23,12,18,0,0,0,0,0,30,7,23,12,18,19,9.89404179632117,11.799201549484,0.47021720001153,2020-03-30,2020,3
"8867","SP",3,"Sudeste",35044,"Capão Bonito",133146,19811.9742961861,14,34,7,27,19,15,0,0,0,0,0,34,7,27,19,15,17,9.89404179632117,11.799201549484,0.467362639153234,2020-04-06,2020,4
"8868","SP",3,"Sudeste",35044,"Capão Bonito",133146,19811.9742961861,15,29,8,21,10,19,0,0,0,0,0,29,8,21,10,19,13,9.89404179632117,11.799201549484,0.447206364283522,2020-04-13,2020,4
"8869","SP",3,"Sudeste",35044,"Capão Bonito",133146,19811.9742961861,16,43,4,39,12,31,1,1,0,1,0,44,5,39,13,31,17,9.89404179632117,11.799201549484,0.437013102869016,2020-04-20,2020,4
"8870","SP",3,"Sudeste",35044,"Capão Bonito",133146,19811.9742961861,17,28,7,21,13,15,0,0,0,0,0,28,7,21,13,15,19,9.89404179632117,11.799201549484,0.444567828367375,2020-04-27,2020,4
"8871","SP",3,"Sudeste",35044,"Capão Bonito",133146,19811.9742961861,18,37,11,26,16,21,0,0,0,0,0,37,11,26,16,21,15,9.89404179632117,11.799201549484,0.427341877889311,2020-05-04,2020,5
"8872","SP",3,"Sudeste",35044,"Capão Bonito",133146,19811.9742961861,19,34,11,23,14,20,0,0,0,0,0,34,11,23,14,20,20,9.89404179632117,11.799201549484,0.422827849099591,2020-05-11,2020,5
"8873","SP",3,"Sudeste",35044,"Capão Bonito",133146,19811.9742961861,20,40,12,28,16,24,0,0,0,0,0,40,12,28,16,24,15,9.89404179632117,11.799201549484,0.423257840146366,2020-05-18,2020,5
"8874","SP",3,"Sudeste",35044,"Capão Bonito",133146,19811.9742961861,21,40,11,29,17,23,0,0,0,0,0,40,11,29,17,23,26,9.89404179632117,11.799201549484,0.440079159530772,2020-05-25,2020,5
"8875","SP",3,"Sudeste",35045,"Piedade",205191,21720.43680678,5,48,17,31,22,26,2,2,0,1,1,50,19,31,23,27,31,9.98600888465505,12.2316965316678,0.283753011360354,2020-02-03,2020,2
"8876","SP",3,"Sudeste",35045,"Piedade",205191,21720.43680678,6,39,10,29,22,17,0,0,0,0,0,39,10,29,22,17,37,9.98600888465505,12.2316965316678,0.277692968653187,2020-02-10,2020,2
"8877","SP",3,"Sudeste",35045,"Piedade",205191,21720.43680678,7,54,14,40,16,38,0,0,0,0,0,54,14,40,16,38,27,9.98600888465505,12.2316965316678,0.291922450122881,2020-02-17,2020,2
"8878","SP",3,"Sudeste",35045,"Piedade",205191,21720.43680678,8,50,15,35,17,33,0,0,0,0,0,50,15,35,17,33,29,9.98600888465505,12.2316965316678,0.328553286811155,2020-02-24,2020,2
"8879","SP",3,"Sudeste",35045,"Piedade",205191,21720.43680678,9,51,12,39,20,31,0,0,0,0,0,51,12,39,20,31,30,9.98600888465505,12.2316965316678,0.301338919248391,2020-03-02,2020,3
"8880","SP",3,"Sudeste",35045,"Piedade",205191,21720.43680678,10,49,12,37,19,30,1,0,1,0,1,50,12,38,19,31,28,9.98600888465505,12.2316965316678,0.312662957209931,2020-03-09,2020,3
"8881","SP",3,"Sudeste",35045,"Piedade",205191,21720.43680678,11,28,7,21,5,23,1,0,1,0,1,29,7,22,5,24,20,9.98600888465505,12.2316965316678,0.392503923271643,2020-03-16,2020,3
"8882","SP",3,"Sudeste",35045,"Piedade",205191,21720.43680678,12,32,6,26,17,15,0,0,0,0,0,32,6,26,17,15,21,9.98600888465505,12.2316965316678,0.493530194690947,2020-03-23,2020,3
"8883","SP",3,"Sudeste",35045,"Piedade",205191,21720.43680678,13,35,9,26,7,28,0,0,0,0,0,35,9,26,7,28,20,9.98600888465505,12.2316965316678,0.451409978637305,2020-03-30,2020,3
"8884","SP",3,"Sudeste",35045,"Piedade",205191,21720.43680678,14,57,10,47,28,29,0,0,0,0,0,57,10,47,28,29,15,9.98600888465505,12.2316965316678,0.449368439374868,2020-04-06,2020,4
"8885","SP",3,"Sudeste",35045,"Piedade",205191,21720.43680678,15,51,10,41,22,29,1,1,0,0,1,52,11,41,22,30,28,9.98600888465505,12.2316965316678,0.420196896363369,2020-04-13,2020,4
"8886","SP",3,"Sudeste",35045,"Piedade",205191,21720.43680678,16,61,13,48,25,36,1,1,0,0,1,62,14,48,25,37,15,9.98600888465505,12.2316965316678,0.425532136684182,2020-04-20,2020,4
"8887","SP",3,"Sudeste",35045,"Piedade",205191,21720.43680678,17,48,15,33,22,26,1,0,1,1,0,49,15,34,23,26,30,9.98600888465505,12.2316965316678,0.425848576953293,2020-04-27,2020,4
"8888","SP",3,"Sudeste",35045,"Piedade",205191,21720.43680678,18,43,16,27,21,22,0,0,0,0,0,43,16,27,21,22,43,9.98600888465505,12.2316965316678,0.408477764409748,2020-05-04,2020,5
"8889","SP",3,"Sudeste",35045,"Piedade",205191,21720.43680678,19,46,11,35,19,27,0,0,0,0,0,46,11,35,19,27,21,9.98600888465505,12.2316965316678,0.411802883676624,2020-05-11,2020,5
"8890","SP",3,"Sudeste",35045,"Piedade",205191,21720.43680678,20,56,19,37,24,32,0,0,0,0,0,56,19,37,24,32,31,9.98600888465505,12.2316965316678,0.416841126885584,2020-05-18,2020,5
"8891","SP",3,"Sudeste",35045,"Piedade",205191,21720.43680678,21,45,6,39,19,26,0,0,0,0,0,45,6,39,19,26,32,9.98600888465505,12.2316965316678,0.410252303264279,2020-05-25,2020,5
"8892","SP",3,"Sudeste",35046,"Sorocaba",1541194,49395.9772354032,5,362,52,310,137,225,0,0,0,0,0,362,52,310,137,225,175,10.8076242673785,14.2480679986562,0.278175381382843,2020-02-03,2020,2
"8893","SP",3,"Sudeste",35046,"Sorocaba",1541194,49395.9772354032,6,368,53,315,135,233,0,0,0,0,0,368,53,315,135,233,203,10.8076242673785,14.2480679986562,0.276449595329233,2020-02-10,2020,2
"8894","SP",3,"Sudeste",35046,"Sorocaba",1541194,49395.9772354032,7,367,52,315,119,248,2,0,2,1,1,369,52,317,120,249,171,10.8076242673785,14.2480679986562,0.288423022852129,2020-02-17,2020,2
"8895","SP",3,"Sudeste",35046,"Sorocaba",1541194,49395.9772354032,8,320,34,286,103,217,1,0,1,0,1,321,34,287,103,218,184,10.8076242673785,14.2480679986562,0.336477360449349,2020-02-24,2020,2
"8896","SP",3,"Sudeste",35046,"Sorocaba",1541194,49395.9772354032,9,351,53,298,118,233,1,1,0,0,1,352,54,298,118,234,184,10.8076242673785,14.2480679986562,0.306046730766894,2020-03-02,2020,3
"8897","SP",3,"Sudeste",35046,"Sorocaba",1541194,49395.9772354032,10,322,46,276,120,202,0,0,0,0,0,322,46,276,120,202,194,10.8076242673785,14.2480679986562,0.317111551001624,2020-03-09,2020,3
"8898","SP",3,"Sudeste",35046,"Sorocaba",1541194,49395.9772354032,11,374,58,316,120,254,3,1,2,2,1,377,59,318,122,255,213,10.8076242673785,14.2480679986562,0.40730838509042,2020-03-16,2020,3
"8899","SP",3,"Sudeste",35046,"Sorocaba",1541194,49395.9772354032,12,338,39,299,111,227,4,0,4,1,3,342,39,303,112,230,192,10.8076242673785,14.2480679986562,0.537507477703729,2020-03-23,2020,3
"8900","SP",3,"Sudeste",35046,"Sorocaba",1541194,49395.9772354032,13,330,51,279,125,205,2,0,2,1,1,332,51,281,126,206,169,10.8076242673785,14.2480679986562,0.495976096548083,2020-03-30,2020,3
"8901","SP",3,"Sudeste",35046,"Sorocaba",1541194,49395.9772354032,14,348,49,299,120,228,0,0,0,0,0,348,49,299,120,228,175,10.8076242673785,14.2480679986562,0.484844523399756,2020-04-06,2020,4
"8902","SP",3,"Sudeste",35046,"Sorocaba",1541194,49395.9772354032,15,321,30,291,113,208,3,2,1,2,1,324,32,292,115,209,187,10.8076242673785,14.2480679986562,0.459466177336173,2020-04-13,2020,4
"8903","SP",3,"Sudeste",35046,"Sorocaba",1541194,49395.9772354032,16,356,46,310,129,227,5,0,5,2,3,361,46,315,131,230,188,10.8076242673785,14.2480679986562,0.45818575306623,2020-04-20,2020,4
"8904","SP",3,"Sudeste",35046,"Sorocaba",1541194,49395.9772354032,17,396,46,350,134,262,4,0,4,3,1,400,46,354,137,263,175,10.8076242673785,14.2480679986562,0.442926025131145,2020-04-27,2020,4
"8905","SP",3,"Sudeste",35046,"Sorocaba",1541194,49395.9772354032,18,348,49,299,111,237,2,0,2,2,0,350,49,301,113,237,173,10.8076242673785,14.2480679986562,0.419828554358192,2020-05-04,2020,5
"8906","SP",3,"Sudeste",35046,"Sorocaba",1541194,49395.9772354032,19,359,51,308,114,245,1,0,1,0,1,360,51,309,114,246,202,10.8076242673785,14.2480679986562,0.428878703478834,2020-05-11,2020,5
"8907","SP",3,"Sudeste",35046,"Sorocaba",1541194,49395.9772354032,20,385,40,345,132,253,4,2,2,1,3,389,42,347,133,256,203,10.8076242673785,14.2480679986562,0.422261665448347,2020-05-18,2020,5
"8908","SP",3,"Sudeste",35046,"Sorocaba",1541194,49395.9772354032,21,424,60,364,135,289,1,0,1,0,1,425,60,365,135,290,205,10.8076242673785,14.2480679986562,0.422314001710676,2020-05-25,2020,5
"8909","SP",3,"Sudeste",35047,"Jundiaí",744424,91450.855704894,5,180,11,169,50,130,2,0,2,1,1,182,11,171,51,131,69,11.4235570108544,13.5203660439613,0.27561745492287,2020-02-03,2020,2
"8910","SP",3,"Sudeste",35047,"Jundiaí",744424,91450.855704894,6,173,14,159,46,127,1,0,1,0,1,174,14,160,46,128,97,11.4235570108544,13.5203660439613,0.276452133079487,2020-02-10,2020,2
"8911","SP",3,"Sudeste",35047,"Jundiaí",744424,91450.855704894,7,153,24,129,31,122,3,0,3,1,2,156,24,132,32,124,74,11.4235570108544,13.5203660439613,0.287019206740297,2020-02-17,2020,2
"8912","SP",3,"Sudeste",35047,"Jundiaí",744424,91450.855704894,8,160,14,146,41,119,1,0,1,0,1,161,14,147,41,120,79,11.4235570108544,13.5203660439613,0.331704812218645,2020-02-24,2020,2
"8913","SP",3,"Sudeste",35047,"Jundiaí",744424,91450.855704894,9,163,21,142,42,121,0,0,0,0,0,163,21,142,42,121,90,11.4235570108544,13.5203660439613,0.301647838137448,2020-03-02,2020,3
"8914","SP",3,"Sudeste",35047,"Jundiaí",744424,91450.855704894,10,166,11,155,50,116,0,0,0,0,0,166,11,155,50,116,76,11.4235570108544,13.5203660439613,0.313022387211419,2020-03-09,2020,3
"8915","SP",3,"Sudeste",35047,"Jundiaí",744424,91450.855704894,11,149,16,133,45,104,1,1,0,1,0,150,17,133,46,104,101,11.4235570108544,13.5203660439613,0.418337612884452,2020-03-16,2020,3
"8916","SP",3,"Sudeste",35047,"Jundiaí",744424,91450.855704894,12,155,16,139,47,108,0,0,0,0,0,155,16,139,47,108,83,11.4235570108544,13.5203660439613,0.538466120396328,2020-03-23,2020,3
"8917","SP",3,"Sudeste",35047,"Jundiaí",744424,91450.855704894,13,149,19,130,31,118,0,0,0,0,0,149,19,130,31,118,88,11.4235570108544,13.5203660439613,0.496214517221959,2020-03-30,2020,3
"8918","SP",3,"Sudeste",35047,"Jundiaí",744424,91450.855704894,14,193,18,175,63,130,0,0,0,0,0,193,18,175,63,130,81,11.4235570108544,13.5203660439613,0.490920562581965,2020-04-06,2020,4
"8919","SP",3,"Sudeste",35047,"Jundiaí",744424,91450.855704894,15,206,21,185,68,138,1,0,1,0,1,207,21,186,68,139,89,11.4235570108544,13.5203660439613,0.465936954882959,2020-04-13,2020,4
"8920","SP",3,"Sudeste",35047,"Jundiaí",744424,91450.855704894,16,183,18,165,53,130,1,0,1,0,1,184,18,166,53,131,92,11.4235570108544,13.5203660439613,0.465294838272899,2020-04-20,2020,4
"8921","SP",3,"Sudeste",35047,"Jundiaí",744424,91450.855704894,17,176,18,158,59,117,2,1,1,0,2,178,19,159,59,119,90,11.4235570108544,13.5203660439613,0.445162136214542,2020-04-27,2020,4
"8922","SP",3,"Sudeste",35047,"Jundiaí",744424,91450.855704894,18,187,21,166,58,129,1,0,1,0,1,188,21,167,58,130,78,11.4235570108544,13.5203660439613,0.423848091208476,2020-05-04,2020,5
"8923","SP",3,"Sudeste",35047,"Jundiaí",744424,91450.855704894,19,183,19,164,59,124,1,1,0,1,0,184,20,164,60,124,123,11.4235570108544,13.5203660439613,0.433288692543054,2020-05-11,2020,5
"8924","SP",3,"Sudeste",35047,"Jundiaí",744424,91450.855704894,20,168,19,149,59,109,0,0,0,0,0,168,19,149,59,109,107,11.4235570108544,13.5203660439613,0.431700066181703,2020-05-18,2020,5
"8925","SP",3,"Sudeste",35047,"Jundiaí",744424,91450.855704894,21,178,16,162,53,125,1,0,1,0,1,179,16,163,53,126,137,11.4235570108544,13.5203660439613,0.428624235395898,2020-05-25,2020,5
"8926","SP",3,"Sudeste",35048,"Bragança Paulista",584752,43266.4971443621,5,135,31,104,44,91,0,0,0,0,0,135,31,104,44,91,62,10.6751338764953,13.2789431047056,0.289961617003034,2020-02-03,2020,2
"8927","SP",3,"Sudeste",35048,"Bragança Paulista",584752,43266.4971443621,6,143,27,116,41,102,0,0,0,0,0,143,27,116,41,102,71,10.6751338764953,13.2789431047056,0.283979932885742,2020-02-10,2020,2
"8928","SP",3,"Sudeste",35048,"Bragança Paulista",584752,43266.4971443621,7,136,21,115,55,81,0,0,0,0,0,136,21,115,55,81,67,10.6751338764953,13.2789431047056,0.292546415759063,2020-02-17,2020,2
"8929","SP",3,"Sudeste",35048,"Bragança Paulista",584752,43266.4971443621,8,138,23,115,53,85,0,0,0,0,0,138,23,115,53,85,68,10.6751338764953,13.2789431047056,0.344425934722894,2020-02-24,2020,2
"8930","SP",3,"Sudeste",35048,"Bragança Paulista",584752,43266.4971443621,9,144,19,125,58,86,1,1,0,1,0,145,20,125,59,86,71,10.6751338764953,13.2789431047056,0.310188879396183,2020-03-02,2020,3
"8931","SP",3,"Sudeste",35048,"Bragança Paulista",584752,43266.4971443621,10,116,25,91,37,79,0,0,0,0,0,116,25,91,37,79,70,10.6751338764953,13.2789431047056,0.319024416161912,2020-03-09,2020,3
"8932","SP",3,"Sudeste",35048,"Bragança Paulista",584752,43266.4971443621,11,135,15,120,53,82,1,0,1,0,1,136,15,121,53,83,85,10.6751338764953,13.2789431047056,0.415769097978021,2020-03-16,2020,3
"8933","SP",3,"Sudeste",35048,"Bragança Paulista",584752,43266.4971443621,12,128,20,108,44,84,1,0,1,0,1,129,20,109,44,85,73,10.6751338764953,13.2789431047056,0.534431753248133,2020-03-23,2020,3
"8934","SP",3,"Sudeste",35048,"Bragança Paulista",584752,43266.4971443621,13,110,23,87,32,78,2,1,1,1,1,112,24,88,33,79,74,10.6751338764953,13.2789431047056,0.497279383246079,2020-03-30,2020,3
"8935","SP",3,"Sudeste",35048,"Bragança Paulista",584752,43266.4971443621,14,127,20,107,39,88,1,1,0,0,1,128,21,107,39,89,80,10.6751338764953,13.2789431047056,0.479581448373045,2020-04-06,2020,4
"8936","SP",3,"Sudeste",35048,"Bragança Paulista",584752,43266.4971443621,15,120,20,100,38,82,0,0,0,0,0,120,20,100,38,82,81,10.6751338764953,13.2789431047056,0.453382087057694,2020-04-13,2020,4
"8937","SP",3,"Sudeste",35048,"Bragança Paulista",584752,43266.4971443621,16,127,13,114,40,87,1,0,1,0,1,128,13,115,40,88,86,10.6751338764953,13.2789431047056,0.45170287570527,2020-04-20,2020,4
"8938","SP",3,"Sudeste",35048,"Bragança Paulista",584752,43266.4971443621,17,132,20,112,38,94,1,0,1,0,1,133,20,113,38,95,51,10.6751338764953,13.2789431047056,0.444654789803788,2020-04-27,2020,4
"8939","SP",3,"Sudeste",35048,"Bragança Paulista",584752,43266.4971443621,18,141,18,123,40,101,0,0,0,0,0,141,18,123,40,101,83,10.6751338764953,13.2789431047056,0.422725843843725,2020-05-04,2020,5
"8940","SP",3,"Sudeste",35048,"Bragança Paulista",584752,43266.4971443621,19,146,23,123,46,100,0,0,0,0,0,146,23,123,46,100,93,10.6751338764953,13.2789431047056,0.424911605832263,2020-05-11,2020,5
"8941","SP",3,"Sudeste",35048,"Bragança Paulista",584752,43266.4971443621,20,117,21,96,35,82,1,1,0,1,0,118,22,96,36,82,83,10.6751338764953,13.2789431047056,0.427604078943906,2020-05-18,2020,5
"8942","SP",3,"Sudeste",35048,"Bragança Paulista",584752,43266.4971443621,21,189,24,165,65,124,0,0,0,0,0,189,24,165,65,124,83,10.6751338764953,13.2789431047056,0.426028288315525,2020-05-25,2020,5
"8943","SP",3,"Sudeste",35049,"Campos do Jordão",74821,21984.3466092407,5,12,2,10,5,7,0,0,0,0,0,12,2,10,5,7,7,9.99808596132977,11.2228538732231,0.301141147840967,2020-02-03,2020,2
"8944","SP",3,"Sudeste",35049,"Campos do Jordão",74821,21984.3466092407,6,12,2,10,3,9,0,0,0,0,0,12,2,10,3,9,12,9.99808596132977,11.2228538732231,0.299087175248661,2020-02-10,2020,2
"8945","SP",3,"Sudeste",35049,"Campos do Jordão",74821,21984.3466092407,7,16,2,14,5,11,0,0,0,0,0,16,2,14,5,11,10,9.99808596132977,11.2228538732231,0.308685838803114,2020-02-17,2020,2
"8946","SP",3,"Sudeste",35049,"Campos do Jordão",74821,21984.3466092407,8,12,1,11,4,8,1,1,0,0,1,13,2,11,4,9,12,9.99808596132977,11.2228538732231,0.347303362377699,2020-02-24,2020,2
"8947","SP",3,"Sudeste",35049,"Campos do Jordão",74821,21984.3466092407,9,25,8,17,6,19,0,0,0,0,0,25,8,17,6,19,9,9.99808596132977,11.2228538732231,0.321222607724847,2020-03-02,2020,3
"8948","SP",3,"Sudeste",35049,"Campos do Jordão",74821,21984.3466092407,10,22,5,17,7,15,0,0,0,0,0,22,5,17,7,15,14,9.99808596132977,11.2228538732231,0.330293320634707,2020-03-09,2020,3
"8949","SP",3,"Sudeste",35049,"Campos do Jordão",74821,21984.3466092407,11,16,3,13,6,10,0,0,0,0,0,16,3,13,6,10,13,9.99808596132977,11.2228538732231,0.428520829169784,2020-03-16,2020,3
"8950","SP",3,"Sudeste",35049,"Campos do Jordão",74821,21984.3466092407,12,12,2,10,4,8,0,0,0,0,0,12,2,10,4,8,11,9.99808596132977,11.2228538732231,0.545492672339342,2020-03-23,2020,3
"8951","SP",3,"Sudeste",35049,"Campos do Jordão",74821,21984.3466092407,13,20,3,17,10,10,1,1,0,0,1,21,4,17,10,11,5,9.99808596132977,11.2228538732231,0.501368911968357,2020-03-30,2020,3
"8952","SP",3,"Sudeste",35049,"Campos do Jordão",74821,21984.3466092407,14,23,7,16,10,13,0,0,0,0,0,23,7,16,10,13,6,9.99808596132977,11.2228538732231,0.479989401840789,2020-04-06,2020,4
"8953","SP",3,"Sudeste",35049,"Campos do Jordão",74821,21984.3466092407,15,21,3,18,5,16,0,0,0,0,0,21,3,18,5,16,6,9.99808596132977,11.2228538732231,0.463093624871137,2020-04-13,2020,4
"8954","SP",3,"Sudeste",35049,"Campos do Jordão",74821,21984.3466092407,16,19,3,16,7,12,0,0,0,0,0,19,3,16,7,12,4,9.99808596132977,11.2228538732231,0.456306090036427,2020-04-20,2020,4
"8955","SP",3,"Sudeste",35049,"Campos do Jordão",74821,21984.3466092407,17,18,5,13,4,14,0,0,0,0,0,18,5,13,4,14,9,9.99808596132977,11.2228538732231,0.451350849425067,2020-04-27,2020,4
"8956","SP",3,"Sudeste",35049,"Campos do Jordão",74821,21984.3466092407,18,22,7,15,7,15,0,0,0,0,0,22,7,15,7,15,8,9.99808596132977,11.2228538732231,0.425767265531805,2020-05-04,2020,5
"8957","SP",3,"Sudeste",35049,"Campos do Jordão",74821,21984.3466092407,19,18,4,14,7,11,0,0,0,0,0,18,4,14,7,11,16,9.99808596132977,11.2228538732231,0.43307901197526,2020-05-11,2020,5
"8958","SP",3,"Sudeste",35049,"Campos do Jordão",74821,21984.3466092407,20,13,5,8,6,7,0,0,0,0,0,13,5,8,6,7,8,9.99808596132977,11.2228538732231,0.433871847661488,2020-05-18,2020,5
"8959","SP",3,"Sudeste",35049,"Campos do Jordão",74821,21984.3466092407,21,20,4,16,12,8,0,0,0,0,0,20,4,16,12,8,11,9.99808596132977,11.2228538732231,0.432075395610355,2020-05-25,2020,5
"8960","SP",3,"Sudeste",35050,"São José dos Campos",1620372,52750.8535687114,5,378,42,336,111,267,2,1,1,1,1,380,43,337,112,268,186,10.8733352326048,14.2981663104773,0.269170711473277,2020-02-03,2020,2
"8961","SP",3,"Sudeste",35050,"São José dos Campos",1620372,52750.8535687114,6,315,32,283,87,228,2,0,2,1,1,317,32,285,88,229,180,10.8733352326048,14.2981663104773,0.272026879651683,2020-02-10,2020,2
"8962","SP",3,"Sudeste",35050,"São José dos Campos",1620372,52750.8535687114,7,343,46,297,99,244,0,0,0,0,0,343,46,297,99,244,200,10.8733352326048,14.2981663104773,0.282976537297085,2020-02-17,2020,2
"8963","SP",3,"Sudeste",35050,"São José dos Campos",1620372,52750.8535687114,8,361,44,317,112,249,3,0,3,0,3,364,44,320,112,252,184,10.8733352326048,14.2981663104773,0.340459439388301,2020-02-24,2020,2
"8964","SP",3,"Sudeste",35050,"São José dos Campos",1620372,52750.8535687114,9,371,44,327,118,253,3,0,3,0,3,374,44,330,118,256,179,10.8733352326048,14.2981663104773,0.300565901994965,2020-03-02,2020,3
"8965","SP",3,"Sudeste",35050,"São José dos Campos",1620372,52750.8535687114,10,321,33,288,97,224,2,0,2,1,1,323,33,290,98,225,210,10.8733352326048,14.2981663104773,0.30900702137439,2020-03-09,2020,3
"8966","SP",3,"Sudeste",35050,"São José dos Campos",1620372,52750.8535687114,11,332,27,305,96,236,3,0,3,1,2,335,27,308,97,238,194,10.8733352326048,14.2981663104773,0.422028104719689,2020-03-16,2020,3
"8967","SP",3,"Sudeste",35050,"São José dos Campos",1620372,52750.8535687114,12,337,46,291,106,231,0,0,0,0,0,337,46,291,106,231,164,10.8733352326048,14.2981663104773,0.542903180358828,2020-03-23,2020,3
"8968","SP",3,"Sudeste",35050,"São José dos Campos",1620372,52750.8535687114,13,277,26,251,77,200,0,0,0,0,0,277,26,251,77,200,183,10.8733352326048,14.2981663104773,0.501321219996368,2020-03-30,2020,3
"8969","SP",3,"Sudeste",35050,"São José dos Campos",1620372,52750.8535687114,14,313,40,273,96,217,2,0,2,0,2,315,40,275,96,219,171,10.8733352326048,14.2981663104773,0.485402229309636,2020-04-06,2020,4
"8970","SP",3,"Sudeste",35050,"São José dos Campos",1620372,52750.8535687114,15,342,41,301,119,223,5,3,2,3,2,347,44,303,122,225,167,10.8733352326048,14.2981663104773,0.464003667318706,2020-04-13,2020,4
"8971","SP",3,"Sudeste",35050,"São José dos Campos",1620372,52750.8535687114,16,353,56,297,111,242,0,0,0,0,0,353,56,297,111,242,182,10.8733352326048,14.2981663104773,0.460281868568723,2020-04-20,2020,4
"8972","SP",3,"Sudeste",35050,"São José dos Campos",1620372,52750.8535687114,17,353,46,307,116,237,2,1,1,2,0,355,47,308,118,237,183,10.8733352326048,14.2981663104773,0.443130388751947,2020-04-27,2020,4
"8973","SP",3,"Sudeste",35050,"São José dos Campos",1620372,52750.8535687114,18,351,61,290,99,252,1,1,0,0,1,352,62,290,99,253,176,10.8733352326048,14.2981663104773,0.415943477242059,2020-05-04,2020,5
"8974","SP",3,"Sudeste",35050,"São José dos Campos",1620372,52750.8535687114,19,380,57,323,109,271,4,0,4,0,4,384,57,327,109,275,190,10.8733352326048,14.2981663104773,0.425367426961704,2020-05-11,2020,5
"8975","SP",3,"Sudeste",35050,"São José dos Campos",1620372,52750.8535687114,20,382,48,334,130,252,2,0,2,2,0,384,48,336,132,252,198,10.8733352326048,14.2981663104773,0.417823884089733,2020-05-18,2020,5
"8976","SP",3,"Sudeste",35050,"São José dos Campos",1620372,52750.8535687114,21,440,46,394,133,307,0,0,0,0,0,440,46,394,133,307,198,10.8733352326048,14.2981663104773,0.416335982501015,2020-05-25,2020,5
"8977","SP",3,"Sudeste",35051,"Guaratinguetá",439594,31856.0999239526,5,94,14,80,23,71,1,0,1,0,1,95,14,81,23,72,78,10.3689841630379,12.9936068526468,0.301599088672024,2020-02-03,2020,2
"8978","SP",3,"Sudeste",35051,"Guaratinguetá",439594,31856.0999239526,6,80,14,66,22,58,0,0,0,0,0,80,14,66,22,58,63,10.3689841630379,12.9936068526468,0.29520614619134,2020-02-10,2020,2
"8979","SP",3,"Sudeste",35051,"Guaratinguetá",439594,31856.0999239526,7,90,16,74,23,67,0,0,0,0,0,90,16,74,23,67,66,10.3689841630379,12.9936068526468,0.305434947364068,2020-02-17,2020,2
"8980","SP",3,"Sudeste",35051,"Guaratinguetá",439594,31856.0999239526,8,98,12,86,32,66,0,0,0,0,0,98,12,86,32,66,56,10.3689841630379,12.9936068526468,0.36378252706163,2020-02-24,2020,2
"8981","SP",3,"Sudeste",35051,"Guaratinguetá",439594,31856.0999239526,9,99,10,89,38,61,1,0,1,1,0,100,10,90,39,61,79,10.3689841630379,12.9936068526468,0.331134707219092,2020-03-02,2020,3
"8982","SP",3,"Sudeste",35051,"Guaratinguetá",439594,31856.0999239526,10,94,16,78,38,56,0,0,0,0,0,94,16,78,38,56,71,10.3689841630379,12.9936068526468,0.341741688903895,2020-03-09,2020,3
"8983","SP",3,"Sudeste",35051,"Guaratinguetá",439594,31856.0999239526,11,85,12,73,31,54,1,0,1,0,1,86,12,74,31,55,77,10.3689841630379,12.9936068526468,0.43363470229206,2020-03-16,2020,3
"8984","SP",3,"Sudeste",35051,"Guaratinguetá",439594,31856.0999239526,12,88,19,69,30,58,0,0,0,0,0,88,19,69,30,58,70,10.3689841630379,12.9936068526468,0.553427658109669,2020-03-23,2020,3
"8985","SP",3,"Sudeste",35051,"Guaratinguetá",439594,31856.0999239526,13,66,8,58,24,42,0,0,0,0,0,66,8,58,24,42,59,10.3689841630379,12.9936068526468,0.512224572689671,2020-03-30,2020,3
"8986","SP",3,"Sudeste",35051,"Guaratinguetá",439594,31856.0999239526,14,84,16,68,29,55,0,0,0,0,0,84,16,68,29,55,56,10.3689841630379,12.9936068526468,0.500068873791037,2020-04-06,2020,4
"8987","SP",3,"Sudeste",35051,"Guaratinguetá",439594,31856.0999239526,15,88,9,79,29,59,0,0,0,0,0,88,9,79,29,59,54,10.3689841630379,12.9936068526468,0.481250244698301,2020-04-13,2020,4
"8988","SP",3,"Sudeste",35051,"Guaratinguetá",439594,31856.0999239526,16,86,9,77,28,58,1,1,0,0,1,87,10,77,28,59,60,10.3689841630379,12.9936068526468,0.479313070632115,2020-04-20,2020,4
"8989","SP",3,"Sudeste",35051,"Guaratinguetá",439594,31856.0999239526,17,82,11,71,31,51,0,0,0,0,0,82,11,71,31,51,45,10.3689841630379,12.9936068526468,0.468467585625504,2020-04-27,2020,4
"8990","SP",3,"Sudeste",35051,"Guaratinguetá",439594,31856.0999239526,18,67,9,58,22,45,0,0,0,0,0,67,9,58,22,45,65,10.3689841630379,12.9936068526468,0.433127418080994,2020-05-04,2020,5
"8991","SP",3,"Sudeste",35051,"Guaratinguetá",439594,31856.0999239526,19,109,16,93,45,64,1,0,1,1,0,110,16,94,46,64,76,10.3689841630379,12.9936068526468,0.448531460993659,2020-05-11,2020,5
"8992","SP",3,"Sudeste",35051,"Guaratinguetá",439594,31856.0999239526,20,97,7,90,35,62,0,0,0,0,0,97,7,90,35,62,54,10.3689841630379,12.9936068526468,0.441780559214075,2020-05-18,2020,5
"8993","SP",3,"Sudeste",35051,"Guaratinguetá",439594,31856.0999239526,21,105,10,95,38,67,1,1,0,0,1,106,11,95,38,68,71,10.3689841630379,12.9936068526468,0.437627814551854,2020-05-25,2020,5
"8994","SP",3,"Sudeste",35052,"Bananal",27832,13904.4123954441,5,6,1,5,0,6,0,0,0,0,0,6,1,5,0,6,4,9.53996150726699,10.2339417168318,0.297148358423904,2020-02-03,2020,2
"8995","SP",3,"Sudeste",35052,"Bananal",27832,13904.4123954441,6,2,0,2,0,2,0,0,0,0,0,2,0,2,0,2,2,9.53996150726699,10.2339417168318,0.308897074390061,2020-02-10,2020,2
"8996","SP",3,"Sudeste",35052,"Bananal",27832,13904.4123954441,7,5,1,4,2,3,0,0,0,0,0,5,1,4,2,3,4,9.53996150726699,10.2339417168318,0.303104282157332,2020-02-17,2020,2
"8997","SP",3,"Sudeste",35052,"Bananal",27832,13904.4123954441,8,5,1,4,3,2,0,0,0,0,0,5,1,4,3,2,2,9.53996150726699,10.2339417168318,0.403334521738882,2020-02-24,2020,2
"8998","SP",3,"Sudeste",35052,"Bananal",27832,13904.4123954441,9,8,1,7,3,5,0,0,0,0,0,8,1,7,3,5,5,9.53996150726699,10.2339417168318,0.335289455262757,2020-03-02,2020,3
"8999","SP",3,"Sudeste",35052,"Bananal",27832,13904.4123954441,10,4,1,3,0,4,0,0,0,0,0,4,1,3,0,4,4,9.53996150726699,10.2339417168318,0.367103649197765,2020-03-09,2020,3
"9000","SP",3,"Sudeste",35052,"Bananal",27832,13904.4123954441,11,3,1,2,1,2,0,0,0,0,0,3,1,2,1,2,5,9.53996150726699,10.2339417168318,0.435940362763756,2020-03-16,2020,3
"9001","SP",3,"Sudeste",35052,"Bananal",27832,13904.4123954441,12,4,0,4,1,3,1,1,0,0,1,5,1,4,1,4,5,9.53996150726699,10.2339417168318,0.553703087985533,2020-03-23,2020,3
"9002","SP",3,"Sudeste",35052,"Bananal",27832,13904.4123954441,13,2,1,1,0,2,0,0,0,0,0,2,1,1,0,2,2,9.53996150726699,10.2339417168318,0.484527375282343,2020-03-30,2020,3
"9003","SP",3,"Sudeste",35052,"Bananal",27832,13904.4123954441,14,7,1,6,1,6,0,0,0,0,0,7,1,6,1,6,5,9.53996150726699,10.2339417168318,0.478965581779544,2020-04-06,2020,4
"9004","SP",3,"Sudeste",35052,"Bananal",27832,13904.4123954441,15,6,1,5,3,3,0,0,0,0,0,6,1,5,3,3,4,9.53996150726699,10.2339417168318,0.450788073686592,2020-04-13,2020,4
"9005","SP",3,"Sudeste",35052,"Bananal",27832,13904.4123954441,16,4,1,3,2,2,0,0,0,0,0,4,1,3,2,2,4,9.53996150726699,10.2339417168318,0.45080174928009,2020-04-20,2020,4
"9006","SP",3,"Sudeste",35052,"Bananal",27832,13904.4123954441,17,8,4,4,2,6,0,0,0,0,0,8,4,4,2,6,4,9.53996150726699,10.2339417168318,0.471212298795042,2020-04-27,2020,4
"9007","SP",3,"Sudeste",35052,"Bananal",27832,13904.4123954441,18,7,3,4,5,2,0,0,0,0,0,7,3,4,5,2,3,9.53996150726699,10.2339417168318,0.460393076793407,2020-05-04,2020,5
"9008","SP",3,"Sudeste",35052,"Bananal",27832,13904.4123954441,19,6,0,6,3,3,0,0,0,0,0,6,0,6,3,3,1,9.53996150726699,10.2339417168318,0.454422759124009,2020-05-11,2020,5
"9009","SP",3,"Sudeste",35052,"Bananal",27832,13904.4123954441,20,4,2,2,0,4,0,0,0,0,0,4,2,2,0,4,3,9.53996150726699,10.2339417168318,0.434138826200253,2020-05-18,2020,5
"9010","SP",3,"Sudeste",35052,"Bananal",27832,13904.4123954441,21,4,1,3,2,2,0,0,0,0,0,4,1,3,2,2,3,9.53996150726699,10.2339417168318,0.429856004390157,2020-05-25,2020,5
"9011","SP",3,"Sudeste",35053,"Paraibuna/Paraitinga",72499,15583.1994518545,5,19,6,13,6,13,0,0,0,0,0,19,6,13,6,13,7,9.65394865468697,11.1913280476442,0.291007158968543,2020-02-03,2020,2
"9012","SP",3,"Sudeste",35053,"Paraibuna/Paraitinga",72499,15583.1994518545,6,12,3,9,5,7,0,0,0,0,0,12,3,9,5,7,15,9.65394865468697,11.1913280476442,0.300262756880993,2020-02-10,2020,2
"9013","SP",3,"Sudeste",35053,"Paraibuna/Paraitinga",72499,15583.1994518545,7,9,4,5,4,5,0,0,0,0,0,9,4,5,4,5,10,9.65394865468697,11.1913280476442,0.309043094698743,2020-02-17,2020,2
"9014","SP",3,"Sudeste",35053,"Paraibuna/Paraitinga",72499,15583.1994518545,8,19,4,15,5,14,0,0,0,0,0,19,4,15,5,14,12,9.65394865468697,11.1913280476442,0.362052069286377,2020-02-24,2020,2
"9015","SP",3,"Sudeste",35053,"Paraibuna/Paraitinga",72499,15583.1994518545,9,18,5,13,6,12,0,0,0,0,0,18,5,13,6,12,11,9.65394865468697,11.1913280476442,0.330321786795469,2020-03-02,2020,3
"9016","SP",3,"Sudeste",35053,"Paraibuna/Paraitinga",72499,15583.1994518545,10,14,2,12,3,11,0,0,0,0,0,14,2,12,3,11,7,9.65394865468697,11.1913280476442,0.337845340663395,2020-03-09,2020,3
"9017","SP",3,"Sudeste",35053,"Paraibuna/Paraitinga",72499,15583.1994518545,11,9,1,8,3,6,0,0,0,0,0,9,1,8,3,6,19,9.65394865468697,11.1913280476442,0.429441591965331,2020-03-16,2020,3
"9018","SP",3,"Sudeste",35053,"Paraibuna/Paraitinga",72499,15583.1994518545,12,12,3,9,2,10,1,1,0,0,1,13,4,9,2,11,7,9.65394865468697,11.1913280476442,0.522471245376027,2020-03-23,2020,3
"9019","SP",3,"Sudeste",35053,"Paraibuna/Paraitinga",72499,15583.1994518545,13,7,2,5,2,5,0,0,0,0,0,7,2,5,2,5,9,9.65394865468697,11.1913280476442,0.483636552465578,2020-03-30,2020,3
"9020","SP",3,"Sudeste",35053,"Paraibuna/Paraitinga",72499,15583.1994518545,14,14,7,7,4,10,0,0,0,0,0,14,7,7,4,10,12,9.65394865468697,11.1913280476442,0.472424070252128,2020-04-06,2020,4
"9021","SP",3,"Sudeste",35053,"Paraibuna/Paraitinga",72499,15583.1994518545,15,15,3,12,1,14,1,0,1,0,1,16,3,13,1,15,13,9.65394865468697,11.1913280476442,0.445794242520703,2020-04-13,2020,4
"9022","SP",3,"Sudeste",35053,"Paraibuna/Paraitinga",72499,15583.1994518545,16,18,5,13,4,14,0,0,0,0,0,18,5,13,4,14,14,9.65394865468697,11.1913280476442,0.4401070146305,2020-04-20,2020,4
"9023","SP",3,"Sudeste",35053,"Paraibuna/Paraitinga",72499,15583.1994518545,17,9,2,7,3,6,0,0,0,0,0,9,2,7,3,6,12,9.65394865468697,11.1913280476442,0.448315851756498,2020-04-27,2020,4
"9024","SP",3,"Sudeste",35053,"Paraibuna/Paraitinga",72499,15583.1994518545,18,16,5,11,10,6,0,0,0,0,0,16,5,11,10,6,9,9.65394865468697,11.1913280476442,0.419680273610934,2020-05-04,2020,5
"9025","SP",3,"Sudeste",35053,"Paraibuna/Paraitinga",72499,15583.1994518545,19,18,4,14,5,13,1,0,1,1,0,19,4,15,6,13,13,9.65394865468697,11.1913280476442,0.439316165119163,2020-05-11,2020,5
"9026","SP",3,"Sudeste",35053,"Paraibuna/Paraitinga",72499,15583.1994518545,20,10,3,7,4,6,0,0,0,0,0,10,3,7,4,6,15,9.65394865468697,11.1913280476442,0.427333460716127,2020-05-18,2020,5
"9027","SP",3,"Sudeste",35053,"Paraibuna/Paraitinga",72499,15583.1994518545,21,23,7,16,11,12,0,0,0,0,0,23,7,16,11,12,6,9.65394865468697,11.1913280476442,0.412212038393519,2020-05-25,2020,5
"9028","SP",3,"Sudeste",35054,"Caraguatatuba",341132,71664.7310065898,5,59,11,48,12,47,0,0,0,0,0,59,11,48,12,47,43,11.1797540088666,12.7400247781372,0.277866327704898,2020-02-03,2020,2
"9029","SP",3,"Sudeste",35054,"Caraguatatuba",341132,71664.7310065898,6,82,15,67,28,54,1,0,1,1,0,83,15,68,29,54,20,11.1797540088666,12.7400247781372,0.286557701378021,2020-02-10,2020,2
"9030","SP",3,"Sudeste",35054,"Caraguatatuba",341132,71664.7310065898,7,77,18,59,26,51,0,0,0,0,0,77,18,59,26,51,47,11.1797540088666,12.7400247781372,0.298303410820269,2020-02-17,2020,2
"9031","SP",3,"Sudeste",35054,"Caraguatatuba",341132,71664.7310065898,8,89,15,74,40,49,2,1,1,0,2,91,16,75,40,51,34,11.1797540088666,12.7400247781372,0.350647819196464,2020-02-24,2020,2
"9032","SP",3,"Sudeste",35054,"Caraguatatuba",341132,71664.7310065898,9,89,16,73,27,62,0,0,0,0,0,89,16,73,27,62,30,11.1797540088666,12.7400247781372,0.317558447536071,2020-03-02,2020,3
"9033","SP",3,"Sudeste",35054,"Caraguatatuba",341132,71664.7310065898,10,85,13,72,36,49,0,0,0,0,0,85,13,72,36,49,49,11.1797540088666,12.7400247781372,0.323731881111072,2020-03-09,2020,3
"9034","SP",3,"Sudeste",35054,"Caraguatatuba",341132,71664.7310065898,11,70,13,57,21,49,2,0,2,0,2,72,13,59,21,51,29,11.1797540088666,12.7400247781372,0.442033217941154,2020-03-16,2020,3
"9035","SP",3,"Sudeste",35054,"Caraguatatuba",341132,71664.7310065898,12,69,8,61,32,37,0,0,0,0,0,69,8,61,32,37,43,11.1797540088666,12.7400247781372,0.577499076483361,2020-03-23,2020,3
"9036","SP",3,"Sudeste",35054,"Caraguatatuba",341132,71664.7310065898,13,77,16,61,27,50,0,0,0,0,0,77,16,61,27,50,42,11.1797540088666,12.7400247781372,0.529139749529807,2020-03-30,2020,3
"9037","SP",3,"Sudeste",35054,"Caraguatatuba",341132,71664.7310065898,14,88,12,76,35,53,0,0,0,0,0,88,12,76,35,53,27,11.1797540088666,12.7400247781372,0.508582352540899,2020-04-06,2020,4
"9038","SP",3,"Sudeste",35054,"Caraguatatuba",341132,71664.7310065898,15,85,16,69,32,53,0,0,0,0,0,85,16,69,32,53,28,11.1797540088666,12.7400247781372,0.483956676605728,2020-04-13,2020,4
"9039","SP",3,"Sudeste",35054,"Caraguatatuba",341132,71664.7310065898,16,91,7,84,36,55,2,0,2,1,1,93,7,86,37,56,44,11.1797540088666,12.7400247781372,0.478768867370238,2020-04-20,2020,4
"9040","SP",3,"Sudeste",35054,"Caraguatatuba",341132,71664.7310065898,17,92,14,78,38,54,2,0,2,1,1,94,14,80,39,55,38,11.1797540088666,12.7400247781372,0.471406814389357,2020-04-27,2020,4
"9041","SP",3,"Sudeste",35054,"Caraguatatuba",341132,71664.7310065898,18,68,8,60,19,49,0,0,0,0,0,68,8,60,19,49,44,11.1797540088666,12.7400247781372,0.457760628165526,2020-05-04,2020,5
"9042","SP",3,"Sudeste",35054,"Caraguatatuba",341132,71664.7310065898,19,87,13,74,26,61,1,0,1,1,0,88,13,75,27,61,46,11.1797540088666,12.7400247781372,0.466086807258509,2020-05-11,2020,5
"9043","SP",3,"Sudeste",35054,"Caraguatatuba",341132,71664.7310065898,20,73,14,59,23,50,2,1,1,0,2,75,15,60,23,52,37,11.1797540088666,12.7400247781372,0.446457633158252,2020-05-18,2020,5
"9044","SP",3,"Sudeste",35054,"Caraguatatuba",341132,71664.7310065898,21,101,15,86,48,53,0,0,0,0,0,101,15,86,48,53,48,11.1797540088666,12.7400247781372,0.445568801100278,2020-05-25,2020,5
"9045","SP",3,"Sudeste",35055,"Registro",251708,35059.3299136301,5,56,12,44,23,33,1,1,0,0,1,57,13,44,23,34,26,10.4647970457321,12.436024964488,0.315156283844304,2020-02-03,2020,2
"9046","SP",3,"Sudeste",35055,"Registro",251708,35059.3299136301,6,60,16,44,16,44,0,0,0,0,0,60,16,44,16,44,35,10.4647970457321,12.436024964488,0.311002631764416,2020-02-10,2020,2
"9047","SP",3,"Sudeste",35055,"Registro",251708,35059.3299136301,7,57,17,40,21,36,1,0,1,0,1,58,17,41,21,37,29,10.4647970457321,12.436024964488,0.32138191792348,2020-02-17,2020,2
"9048","SP",3,"Sudeste",35055,"Registro",251708,35059.3299136301,8,47,11,36,20,27,0,0,0,0,0,47,11,36,20,27,20,10.4647970457321,12.436024964488,0.383854022020487,2020-02-24,2020,2
"9049","SP",3,"Sudeste",35055,"Registro",251708,35059.3299136301,9,44,9,35,22,22,1,1,0,0,1,45,10,35,22,23,37,10.4647970457321,12.436024964488,0.347949616687459,2020-03-02,2020,3
"9050","SP",3,"Sudeste",35055,"Registro",251708,35059.3299136301,10,56,18,38,26,30,0,0,0,0,0,56,18,38,26,30,24,10.4647970457321,12.436024964488,0.349883677932371,2020-03-09,2020,3
"9051","SP",3,"Sudeste",35055,"Registro",251708,35059.3299136301,11,54,10,44,31,23,0,0,0,0,0,54,10,44,31,23,34,10.4647970457321,12.436024964488,0.445540697320057,2020-03-16,2020,3
"9052","SP",3,"Sudeste",35055,"Registro",251708,35059.3299136301,12,58,8,50,28,30,0,0,0,0,0,58,8,50,28,30,31,10.4647970457321,12.436024964488,0.558086278548743,2020-03-23,2020,3
"9053","SP",3,"Sudeste",35055,"Registro",251708,35059.3299136301,13,54,15,39,22,32,0,0,0,0,0,54,15,39,22,32,41,10.4647970457321,12.436024964488,0.513654649541421,2020-03-30,2020,3
"9054","SP",3,"Sudeste",35055,"Registro",251708,35059.3299136301,14,53,13,40,26,27,0,0,0,0,0,53,13,40,26,27,31,10.4647970457321,12.436024964488,0.497671603796319,2020-04-06,2020,4
"9055","SP",3,"Sudeste",35055,"Registro",251708,35059.3299136301,15,47,13,34,27,20,1,0,1,1,0,48,13,35,28,20,32,10.4647970457321,12.436024964488,0.483805260304885,2020-04-13,2020,4
"9056","SP",3,"Sudeste",35055,"Registro",251708,35059.3299136301,16,62,10,52,33,29,0,0,0,0,0,62,10,52,33,29,49,10.4647970457321,12.436024964488,0.480485623507144,2020-04-20,2020,4
"9057","SP",3,"Sudeste",35055,"Registro",251708,35059.3299136301,17,64,15,49,31,33,0,0,0,0,0,64,15,49,31,33,30,10.4647970457321,12.436024964488,0.476234907962559,2020-04-27,2020,4
"9058","SP",3,"Sudeste",35055,"Registro",251708,35059.3299136301,18,59,10,49,22,37,1,0,1,1,0,60,10,50,23,37,32,10.4647970457321,12.436024964488,0.454734229271294,2020-05-04,2020,5
"9059","SP",3,"Sudeste",35055,"Registro",251708,35059.3299136301,19,66,18,48,26,40,0,0,0,0,0,66,18,48,26,40,34,10.4647970457321,12.436024964488,0.453074500970536,2020-05-11,2020,5
"9060","SP",3,"Sudeste",35055,"Registro",251708,35059.3299136301,20,71,21,50,25,46,1,0,1,1,0,72,21,51,26,46,42,10.4647970457321,12.436024964488,0.448040173815947,2020-05-18,2020,5
"9061","SP",3,"Sudeste",35055,"Registro",251708,35059.3299136301,21,75,17,58,33,42,1,0,1,0,1,76,17,59,33,43,49,10.4647970457321,12.436024964488,0.452166640385005,2020-05-25,2020,5
"9062","SP",3,"Sudeste",35056,"Itanhaém",258770,19277.0757339723,5,71,12,59,24,47,1,0,1,0,1,72,12,60,24,48,47,9.86667188311178,12.4636949152606,0.322041907434247,2020-02-03,2020,2
"9063","SP",3,"Sudeste",35056,"Itanhaém",258770,19277.0757339723,6,55,14,41,23,32,0,0,0,0,0,55,14,41,23,32,36,9.86667188311178,12.4636949152606,0.310477751530558,2020-02-10,2020,2
"9064","SP",3,"Sudeste",35056,"Itanhaém",258770,19277.0757339723,7,48,9,39,19,29,0,0,0,0,0,48,9,39,19,29,36,9.86667188311178,12.4636949152606,0.326656642425427,2020-02-17,2020,2
"9065","SP",3,"Sudeste",35056,"Itanhaém",258770,19277.0757339723,8,56,12,44,22,34,0,0,0,0,0,56,12,44,22,34,40,9.86667188311178,12.4636949152606,0.38092984450245,2020-02-24,2020,2
"9066","SP",3,"Sudeste",35056,"Itanhaém",258770,19277.0757339723,9,59,11,48,26,33,0,0,0,0,0,59,11,48,26,33,34,9.86667188311178,12.4636949152606,0.355874027133645,2020-03-02,2020,3
"9067","SP",3,"Sudeste",35056,"Itanhaém",258770,19277.0757339723,10,67,11,56,24,43,0,0,0,0,0,67,11,56,24,43,43,9.86667188311178,12.4636949152606,0.351725143774643,2020-03-09,2020,3
"9068","SP",3,"Sudeste",35056,"Itanhaém",258770,19277.0757339723,11,52,13,39,25,27,0,0,0,0,0,52,13,39,25,27,48,9.86667188311178,12.4636949152606,0.448941886280925,2020-03-16,2020,3
"9069","SP",3,"Sudeste",35056,"Itanhaém",258770,19277.0757339723,12,60,21,39,25,35,0,0,0,0,0,60,21,39,25,35,39,9.86667188311178,12.4636949152606,0.562747428605882,2020-03-23,2020,3
"9070","SP",3,"Sudeste",35056,"Itanhaém",258770,19277.0757339723,13,61,14,47,26,35,2,0,2,1,1,63,14,49,27,36,45,9.86667188311178,12.4636949152606,0.521902459196364,2020-03-30,2020,3
"9071","SP",3,"Sudeste",35056,"Itanhaém",258770,19277.0757339723,14,46,6,40,22,24,1,1,0,0,1,47,7,40,22,25,39,9.86667188311178,12.4636949152606,0.508515788213366,2020-04-06,2020,4
"9072","SP",3,"Sudeste",35056,"Itanhaém",258770,19277.0757339723,15,65,14,51,29,36,1,0,1,0,1,66,14,52,29,37,41,9.86667188311178,12.4636949152606,0.487999897922311,2020-04-13,2020,4
"9073","SP",3,"Sudeste",35056,"Itanhaém",258770,19277.0757339723,16,61,15,46,19,42,1,1,0,1,0,62,16,46,20,42,38,9.86667188311178,12.4636949152606,0.479840470365402,2020-04-20,2020,4
"9074","SP",3,"Sudeste",35056,"Itanhaém",258770,19277.0757339723,17,60,14,46,28,32,0,0,0,0,0,60,14,46,28,32,48,9.86667188311178,12.4636949152606,0.470549065346863,2020-04-27,2020,4
"9075","SP",3,"Sudeste",35056,"Itanhaém",258770,19277.0757339723,18,68,15,53,27,41,1,0,1,0,1,69,15,54,27,42,57,9.86667188311178,12.4636949152606,0.455638846867208,2020-05-04,2020,5
"9076","SP",3,"Sudeste",35056,"Itanhaém",258770,19277.0757339723,19,74,12,62,32,42,0,0,0,0,0,74,12,62,32,42,53,9.86667188311178,12.4636949152606,0.466597420482766,2020-05-11,2020,5
"9077","SP",3,"Sudeste",35056,"Itanhaém",258770,19277.0757339723,20,64,12,52,23,41,1,0,1,1,0,65,12,53,24,41,50,9.86667188311178,12.4636949152606,0.45374184519524,2020-05-18,2020,5
"9078","SP",3,"Sudeste",35056,"Itanhaém",258770,19277.0757339723,21,65,13,52,28,37,1,0,1,0,1,66,13,53,28,38,60,9.86667188311178,12.4636949152606,0.451034391299373,2020-05-25,2020,5
"9079","SP",3,"Sudeste",35057,"Osasco",1986839,89887.5044060087,5,541,53,488,175,366,6,1,5,1,5,547,54,493,176,371,180,11.4063142164277,14.5020554915777,0.262939464110336,2020-02-03,2020,2
"9080","SP",3,"Sudeste",35057,"Osasco",1986839,89887.5044060087,6,493,53,440,141,352,7,3,4,5,2,500,56,444,146,354,205,11.4063142164277,14.5020554915777,0.266788872370189,2020-02-10,2020,2
"9081","SP",3,"Sudeste",35057,"Osasco",1986839,89887.5044060087,7,538,66,472,182,356,2,1,1,1,1,540,67,473,183,357,237,11.4063142164277,14.5020554915777,0.273573169685156,2020-02-17,2020,2
"9082","SP",3,"Sudeste",35057,"Osasco",1986839,89887.5044060087,8,535,63,472,175,360,2,1,1,1,1,537,64,473,176,361,222,11.4063142164277,14.5020554915777,0.332029032713325,2020-02-24,2020,2
"9083","SP",3,"Sudeste",35057,"Osasco",1986839,89887.5044060087,9,534,75,459,177,357,3,1,2,1,2,537,76,461,178,359,195,11.4063142164277,14.5020554915777,0.285548954039839,2020-03-02,2020,3
"9084","SP",3,"Sudeste",35057,"Osasco",1986839,89887.5044060087,10,492,64,428,165,327,6,1,5,3,3,498,65,433,168,330,231,11.4063142164277,14.5020554915777,0.294212529802085,2020-03-09,2020,3
"9085","SP",3,"Sudeste",35057,"Osasco",1986839,89887.5044060087,11,460,49,411,134,326,2,0,2,0,2,462,49,413,134,328,238,11.4063142164277,14.5020554915777,0.412217075633383,2020-03-16,2020,3
"9086","SP",3,"Sudeste",35057,"Osasco",1986839,89887.5044060087,12,457,61,396,157,300,7,1,6,3,4,464,62,402,160,304,263,11.4063142164277,14.5020554915777,0.544344761729838,2020-03-23,2020,3
"9087","SP",3,"Sudeste",35057,"Osasco",1986839,89887.5044060087,13,394,56,338,140,254,5,0,5,2,3,399,56,343,142,257,253,11.4063142164277,14.5020554915777,0.507721535720027,2020-03-30,2020,3
"9088","SP",3,"Sudeste",35057,"Osasco",1986839,89887.5044060087,14,471,55,416,179,292,8,0,8,2,6,479,55,424,181,298,288,11.4063142164277,14.5020554915777,0.499939904299756,2020-04-06,2020,4
"9089","SP",3,"Sudeste",35057,"Osasco",1986839,89887.5044060087,15,502,53,449,170,332,8,2,6,1,7,510,55,455,171,339,284,11.4063142164277,14.5020554915777,0.478132292209238,2020-04-13,2020,4
"9090","SP",3,"Sudeste",35057,"Osasco",1986839,89887.5044060087,16,562,63,499,175,387,4,0,4,2,2,566,63,503,177,389,284,11.4063142164277,14.5020554915777,0.480468766319517,2020-04-20,2020,4
"9091","SP",3,"Sudeste",35057,"Osasco",1986839,89887.5044060087,17,596,86,510,212,384,3,0,3,0,3,599,86,513,212,387,329,11.4063142164277,14.5020554915777,0.470112679629438,2020-04-27,2020,4
"9092","SP",3,"Sudeste",35057,"Osasco",1986839,89887.5044060087,18,515,75,440,166,349,10,3,7,5,5,525,78,447,171,354,355,11.4063142164277,14.5020554915777,0.450921437329453,2020-05-04,2020,5
"9093","SP",3,"Sudeste",35057,"Osasco",1986839,89887.5044060087,19,567,69,498,173,394,4,0,4,0,4,571,69,502,173,398,344,11.4063142164277,14.5020554915777,0.461510127217747,2020-05-11,2020,5
"9094","SP",3,"Sudeste",35057,"Osasco",1986839,89887.5044060087,20,536,60,476,208,328,3,1,2,1,2,539,61,478,209,330,383,11.4063142164277,14.5020554915777,0.456230916903999,2020-05-18,2020,5
"9095","SP",3,"Sudeste",35057,"Osasco",1986839,89887.5044060087,21,636,74,562,215,421,6,0,6,2,4,642,74,568,217,425,367,11.4063142164277,14.5020554915777,0.449468976888151,2020-05-25,2020,5
"9096","SP",3,"Sudeste",35058,"Franco da Rocha",538837,18718.2852020184,5,113,10,103,32,81,1,1,0,0,1,114,11,103,32,82,51,9.83725614337954,13.1971683922816,0.286179476847322,2020-02-03,2020,2
"9097","SP",3,"Sudeste",35058,"Franco da Rocha",538837,18718.2852020184,6,100,10,90,41,59,1,0,1,0,1,101,10,91,41,60,64,9.83725614337954,13.1971683922816,0.289166105528207,2020-02-10,2020,2
"9098","SP",3,"Sudeste",35058,"Franco da Rocha",538837,18718.2852020184,7,134,23,111,57,77,2,0,2,2,0,136,23,113,59,77,65,9.83725614337954,13.1971683922816,0.294376411597737,2020-02-17,2020,2
"9099","SP",3,"Sudeste",35058,"Franco da Rocha",538837,18718.2852020184,8,126,19,107,55,71,2,0,2,1,1,128,19,109,56,72,52,9.83725614337954,13.1971683922816,0.352244544431075,2020-02-24,2020,2
"9100","SP",3,"Sudeste",35058,"Franco da Rocha",538837,18718.2852020184,9,148,21,127,43,105,2,0,2,0,2,150,21,129,43,107,50,9.83725614337954,13.1971683922816,0.313374991406733,2020-03-02,2020,3
"9101","SP",3,"Sudeste",35058,"Franco da Rocha",538837,18718.2852020184,10,105,17,88,49,56,3,0,3,1,2,108,17,91,50,58,50,9.83725614337954,13.1971683922816,0.319045904513297,2020-03-09,2020,3
"9102","SP",3,"Sudeste",35058,"Franco da Rocha",538837,18718.2852020184,11,127,19,108,50,77,2,1,1,1,1,129,20,109,51,78,55,9.83725614337954,13.1971683922816,0.42500978432789,2020-03-16,2020,3
"9103","SP",3,"Sudeste",35058,"Franco da Rocha",538837,18718.2852020184,12,117,18,99,47,70,0,0,0,0,0,117,18,99,47,70,63,9.83725614337954,13.1971683922816,0.536891145810114,2020-03-23,2020,3
"9104","SP",3,"Sudeste",35058,"Franco da Rocha",538837,18718.2852020184,13,118,12,106,44,74,2,0,2,1,1,120,12,108,45,75,73,9.83725614337954,13.1971683922816,0.50515526369209,2020-03-30,2020,3
"9105","SP",3,"Sudeste",35058,"Franco da Rocha",538837,18718.2852020184,14,102,12,90,35,67,2,0,2,0,2,104,12,92,35,69,68,9.83725614337954,13.1971683922816,0.494526395586609,2020-04-06,2020,4
"9106","SP",3,"Sudeste",35058,"Franco da Rocha",538837,18718.2852020184,15,138,19,119,47,91,1,0,1,0,1,139,19,120,47,92,81,9.83725614337954,13.1971683922816,0.472202569983031,2020-04-13,2020,4
"9107","SP",3,"Sudeste",35058,"Franco da Rocha",538837,18718.2852020184,16,126,9,117,46,80,0,0,0,0,0,126,9,117,46,80,77,9.83725614337954,13.1971683922816,0.472405074782584,2020-04-20,2020,4
"9108","SP",3,"Sudeste",35058,"Franco da Rocha",538837,18718.2852020184,17,124,14,110,50,74,0,0,0,0,0,124,14,110,50,74,71,9.83725614337954,13.1971683922816,0.461987228626486,2020-04-27,2020,4
"9109","SP",3,"Sudeste",35058,"Franco da Rocha",538837,18718.2852020184,18,144,15,129,59,85,2,0,2,1,1,146,15,131,60,86,81,9.83725614337954,13.1971683922816,0.441646491294421,2020-05-04,2020,5
"9110","SP",3,"Sudeste",35058,"Franco da Rocha",538837,18718.2852020184,19,132,18,114,42,90,0,0,0,0,0,132,18,114,42,90,98,9.83725614337954,13.1971683922816,0.45376070283929,2020-05-11,2020,5
"9111","SP",3,"Sudeste",35058,"Franco da Rocha",538837,18718.2852020184,20,144,18,126,57,87,2,1,1,1,1,146,19,127,58,88,86,9.83725614337954,13.1971683922816,0.459034322855846,2020-05-18,2020,5
"9112","SP",3,"Sudeste",35058,"Franco da Rocha",538837,18718.2852020184,21,156,24,132,52,104,0,0,0,0,0,156,24,132,52,104,88,9.83725614337954,13.1971683922816,0.440696079250165,2020-05-25,2020,5
"9113","SP",3,"Sudeste",35059,"Guarulhos",1541244,45713.1910926563,5,361,55,306,144,217,5,0,5,3,2,366,55,311,147,219,145,10.7301421805858,14.2481004405091,0.26921531491665,2020-02-03,2020,2
"9114","SP",3,"Sudeste",35059,"Guarulhos",1541244,45713.1910926563,6,402,66,336,154,248,3,0,3,1,2,405,66,339,155,250,163,10.7301421805858,14.2481004405091,0.274223696471746,2020-02-10,2020,2
"9115","SP",3,"Sudeste",35059,"Guarulhos",1541244,45713.1910926563,7,387,52,335,135,252,4,1,3,0,4,391,53,338,135,256,181,10.7301421805858,14.2481004405091,0.277206631449932,2020-02-17,2020,2
"9116","SP",3,"Sudeste",35059,"Guarulhos",1541244,45713.1910926563,8,365,43,322,140,225,7,1,6,2,5,372,44,328,142,230,136,10.7301421805858,14.2481004405091,0.335579509682214,2020-02-24,2020,2
"9117","SP",3,"Sudeste",35059,"Guarulhos",1541244,45713.1910926563,9,378,49,329,129,249,4,2,2,1,3,382,51,331,130,252,164,10.7301421805858,14.2481004405091,0.295246299814375,2020-03-02,2020,3
"9118","SP",3,"Sudeste",35059,"Guarulhos",1541244,45713.1910926563,10,369,52,317,127,242,4,2,2,3,1,373,54,319,130,243,180,10.7301421805858,14.2481004405091,0.30184942502558,2020-03-09,2020,3
"9119","SP",3,"Sudeste",35059,"Guarulhos",1541244,45713.1910926563,11,383,53,330,130,253,5,2,3,1,4,388,55,333,131,257,183,10.7301421805858,14.2481004405091,0.407731706656786,2020-03-16,2020,3
"9120","SP",3,"Sudeste",35059,"Guarulhos",1541244,45713.1910926563,12,369,57,312,138,231,2,0,2,1,1,371,57,314,139,232,173,10.7301421805858,14.2481004405091,0.532728651523484,2020-03-23,2020,3
"9121","SP",3,"Sudeste",35059,"Guarulhos",1541244,45713.1910926563,13,349,58,291,140,209,4,1,3,3,1,353,59,294,143,210,203,10.7301421805858,14.2481004405091,0.502045209135507,2020-03-30,2020,3
"9122","SP",3,"Sudeste",35059,"Guarulhos",1541244,45713.1910926563,14,377,55,322,137,240,2,1,1,0,2,379,56,323,137,242,188,10.7301421805858,14.2481004405091,0.498147055696045,2020-04-06,2020,4
"9123","SP",3,"Sudeste",35059,"Guarulhos",1541244,45713.1910926563,15,389,46,343,135,254,3,2,1,2,1,392,48,344,137,255,193,10.7301421805858,14.2481004405091,0.473866687193924,2020-04-13,2020,4
"9124","SP",3,"Sudeste",35059,"Guarulhos",1541244,45713.1910926563,16,386,53,333,149,237,8,0,8,4,4,394,53,341,153,241,218,10.7301421805858,14.2481004405091,0.474506024891098,2020-04-20,2020,4
"9125","SP",3,"Sudeste",35059,"Guarulhos",1541244,45713.1910926563,17,362,56,306,120,242,6,2,4,4,2,368,58,310,124,244,224,10.7301421805858,14.2481004405091,0.462552215522876,2020-04-27,2020,4
"9126","SP",3,"Sudeste",35059,"Guarulhos",1541244,45713.1910926563,18,398,68,330,139,259,4,0,4,0,4,402,68,334,139,263,246,10.7301421805858,14.2481004405091,0.438608065225948,2020-05-04,2020,5
"9127","SP",3,"Sudeste",35059,"Guarulhos",1541244,45713.1910926563,19,396,66,330,152,244,8,1,7,1,7,404,67,337,153,251,271,10.7301421805858,14.2481004405091,0.451301384425412,2020-05-11,2020,5
"9128","SP",3,"Sudeste",35059,"Guarulhos",1541244,45713.1910926563,20,430,57,373,138,292,6,3,3,3,3,436,60,376,141,295,284,10.7301421805858,14.2481004405091,0.444105424914163,2020-05-18,2020,5
"9129","SP",3,"Sudeste",35059,"Guarulhos",1541244,45713.1910926563,21,405,55,350,149,256,7,2,5,3,4,412,57,355,152,260,294,10.7301421805858,14.2481004405091,0.44176365607485,2020-05-25,2020,5
"9130","SP",3,"Sudeste",35060,"Itapecerica da Serra",1172450,36594.4090648898,5,276,38,238,91,185,3,0,3,0,3,279,38,241,91,188,129,10.5076507499309,13.9746061344701,0.28035353702206,2020-02-03,2020,2
"9131","SP",3,"Sudeste",35060,"Itapecerica da Serra",1172450,36594.4090648898,6,312,50,262,118,194,4,0,4,1,3,316,50,266,119,197,107,10.5076507499309,13.9746061344701,0.280701666684516,2020-02-10,2020,2
"9132","SP",3,"Sudeste",35060,"Itapecerica da Serra",1172450,36594.4090648898,7,279,47,232,80,199,4,0,4,2,2,283,47,236,82,201,122,10.5076507499309,13.9746061344701,0.295059542788319,2020-02-17,2020,2
"9133","SP",3,"Sudeste",35060,"Itapecerica da Serra",1172450,36594.4090648898,8,289,46,243,113,176,3,1,2,2,1,292,47,245,115,177,120,10.5076507499309,13.9746061344701,0.345157273853615,2020-02-24,2020,2
"9134","SP",3,"Sudeste",35060,"Itapecerica da Serra",1172450,36594.4090648898,9,290,42,248,99,191,4,0,4,1,3,294,42,252,100,194,115,10.5076507499309,13.9746061344701,0.305291288781964,2020-03-02,2020,3
"9135","SP",3,"Sudeste",35060,"Itapecerica da Serra",1172450,36594.4090648898,10,258,31,227,83,175,5,2,3,3,2,263,33,230,86,177,143,10.5076507499309,13.9746061344701,0.312883631523787,2020-03-09,2020,3
"9136","SP",3,"Sudeste",35060,"Itapecerica da Serra",1172450,36594.4090648898,11,241,38,203,80,161,3,0,3,0,3,244,38,206,80,164,136,10.5076507499309,13.9746061344701,0.413931516523902,2020-03-16,2020,3
"9137","SP",3,"Sudeste",35060,"Itapecerica da Serra",1172450,36594.4090648898,12,263,30,233,85,178,3,1,2,2,1,266,31,235,87,179,141,10.5076507499309,13.9746061344701,0.538280826287006,2020-03-23,2020,3
"9138","SP",3,"Sudeste",35060,"Itapecerica da Serra",1172450,36594.4090648898,13,261,37,224,92,169,1,0,1,1,0,262,37,225,93,169,160,10.5076507499309,13.9746061344701,0.504095080643317,2020-03-30,2020,3
"9139","SP",3,"Sudeste",35060,"Itapecerica da Serra",1172450,36594.4090648898,14,300,36,264,107,193,4,1,3,3,1,304,37,267,110,194,130,10.5076507499309,13.9746061344701,0.494634463497923,2020-04-06,2020,4
"9140","SP",3,"Sudeste",35060,"Itapecerica da Serra",1172450,36594.4090648898,15,278,28,250,97,181,1,0,1,0,1,279,28,251,97,182,131,10.5076507499309,13.9746061344701,0.467827506540247,2020-04-13,2020,4
"9141","SP",3,"Sudeste",35060,"Itapecerica da Serra",1172450,36594.4090648898,16,312,42,270,116,196,2,1,1,1,1,314,43,271,117,197,141,10.5076507499309,13.9746061344701,0.467933712433988,2020-04-20,2020,4
"9142","SP",3,"Sudeste",35060,"Itapecerica da Serra",1172450,36594.4090648898,17,327,47,280,134,193,3,3,0,1,2,330,50,280,135,195,178,10.5076507499309,13.9746061344701,0.456176164679606,2020-04-27,2020,4
"9143","SP",3,"Sudeste",35060,"Itapecerica da Serra",1172450,36594.4090648898,18,288,48,240,100,188,9,1,8,4,5,297,49,248,104,193,150,10.5076507499309,13.9746061344701,0.442157993056476,2020-05-04,2020,5
"9144","SP",3,"Sudeste",35060,"Itapecerica da Serra",1172450,36594.4090648898,19,300,49,251,101,199,3,1,2,2,1,303,50,253,103,200,172,10.5076507499309,13.9746061344701,0.454992610099406,2020-05-11,2020,5
"9145","SP",3,"Sudeste",35060,"Itapecerica da Serra",1172450,36594.4090648898,20,303,46,257,108,195,1,0,1,1,0,304,46,258,109,195,184,10.5076507499309,13.9746061344701,0.457090410971767,2020-05-18,2020,5
"9146","SP",3,"Sudeste",35060,"Itapecerica da Serra",1172450,36594.4090648898,21,300,53,247,93,207,5,0,5,1,4,305,53,252,94,211,192,10.5076507499309,13.9746061344701,0.438595660159082,2020-05-25,2020,5
"9147","SP",3,"Sudeste",35061,"São Paulo",15132944,56272.1295723324,5,3333,449,2884,1036,2297,23,8,15,5,18,3356,457,2899,1041,2315,1687,10.9379546573187,16.5323846471403,0.278253117500921,2020-02-03,2020,2
"9148","SP",3,"Sudeste",35061,"São Paulo",15132944,56272.1295723324,6,3349,430,2919,952,2397,25,5,20,5,20,3374,435,2939,957,2417,1715,10.9379546573187,16.5323846471403,0.281724919930843,2020-02-10,2020,2
"9149","SP",3,"Sudeste",35061,"São Paulo",15132944,56272.1295723324,7,3168,431,2737,990,2178,22,6,16,11,11,3190,437,2753,1001,2189,1781,10.9379546573187,16.5323846471403,0.29253617101751,2020-02-17,2020,2
"9150","SP",3,"Sudeste",35061,"São Paulo",15132944,56272.1295723324,8,3208,437,2771,1035,2173,23,3,20,4,19,3231,440,2791,1039,2192,1784,10.9379546573187,16.5323846471403,0.34724563290869,2020-02-24,2020,2
"9151","SP",3,"Sudeste",35061,"São Paulo",15132944,56272.1295723324,9,3175,405,2770,979,2196,25,6,19,8,17,3200,411,2789,987,2213,1786,10.9379546573187,16.5323846471403,0.307698876333167,2020-03-02,2020,3
"9152","SP",3,"Sudeste",35061,"São Paulo",15132944,56272.1295723324,10,3133,426,2707,999,2134,22,4,18,7,15,3155,430,2725,1006,2149,1844,10.9379546573187,16.5323846471403,0.318807904418213,2020-03-09,2020,3
"9153","SP",3,"Sudeste",35061,"São Paulo",15132944,56272.1295723324,11,3154,420,2734,933,2221,21,4,17,9,12,3175,424,2751,942,2233,2006,10.9379546573187,16.5323846471403,0.434002267352907,2020-03-16,2020,3
"9154","SP",3,"Sudeste",35061,"São Paulo",15132944,56272.1295723324,12,2865,374,2491,916,1949,23,3,20,6,17,2888,377,2511,922,1966,2113,10.9379546573187,16.5323846471403,0.565461936092228,2020-03-23,2020,3
"9155","SP",3,"Sudeste",35061,"São Paulo",15132944,56272.1295723324,13,2810,381,2429,876,1934,17,4,13,8,9,2827,385,2442,884,1943,2324,10.9379546573187,16.5323846471403,0.532638426514461,2020-03-30,2020,3
"9156","SP",3,"Sudeste",35061,"São Paulo",15132944,56272.1295723324,14,3066,362,2704,986,2080,25,4,21,6,19,3091,366,2725,992,2099,2300,10.9379546573187,16.5323846471403,0.524171102336293,2020-04-06,2020,4
"9157","SP",3,"Sudeste",35061,"São Paulo",15132944,56272.1295723324,15,3050,410,2640,938,2112,25,6,19,5,20,3075,416,2659,943,2132,2287,10.9379546573187,16.5323846471403,0.502728653033559,2020-04-13,2020,4
"9158","SP",3,"Sudeste",35061,"São Paulo",15132944,56272.1295723324,16,3247,447,2800,1015,2232,14,4,10,4,10,3261,451,2810,1019,2242,2385,10.9379546573187,16.5323846471403,0.49997354370965,2020-04-20,2020,4
"9159","SP",3,"Sudeste",35061,"São Paulo",15132944,56272.1295723324,17,3120,419,2701,997,2123,25,4,21,7,18,3145,423,2722,1004,2141,2655,10.9379546573187,16.5323846471403,0.484168364999596,2020-04-27,2020,4
"9160","SP",3,"Sudeste",35061,"São Paulo",15132944,56272.1295723324,18,3164,376,2788,1015,2149,22,4,18,8,14,3186,380,2806,1023,2163,2636,10.9379546573187,16.5323846471403,0.469157055585076,2020-05-04,2020,5
"9161","SP",3,"Sudeste",35061,"São Paulo",15132944,56272.1295723324,19,3194,430,2764,945,2249,25,3,22,5,20,3219,433,2786,950,2269,2766,10.9379546573187,16.5323846471403,0.488213532652355,2020-05-11,2020,5
"9162","SP",3,"Sudeste",35061,"São Paulo",15132944,56272.1295723324,20,3278,427,2851,986,2292,26,6,20,12,14,3304,433,2871,998,2306,2803,10.9379546573187,16.5323846471403,0.478759216532556,2020-05-18,2020,5
"9163","SP",3,"Sudeste",35061,"São Paulo",15132944,56272.1295723324,21,3387,424,2963,991,2396,26,6,20,9,17,3413,430,2983,1000,2413,2857,10.9379546573187,16.5323846471403,0.458165180310993,2020-05-25,2020,5
"9164","SP",3,"Sudeste",35062,"Mogi das Cruzes",1521528,29435.1347966321,5,399,44,355,130,269,1,0,1,1,0,400,44,356,131,269,144,10.2899443009196,14.2352256510417,0.287943258819273,2020-02-03,2020,2
"9165","SP",3,"Sudeste",35062,"Mogi das Cruzes",1521528,29435.1347966321,6,403,41,362,141,262,5,0,5,0,5,408,41,367,141,267,166,10.2899443009196,14.2352256510417,0.291713216598599,2020-02-10,2020,2
"9166","SP",3,"Sudeste",35062,"Mogi das Cruzes",1521528,29435.1347966321,7,384,48,336,150,234,5,0,5,1,4,389,48,341,151,238,153,10.2899443009196,14.2352256510417,0.302510323288595,2020-02-17,2020,2
"9167","SP",3,"Sudeste",35062,"Mogi das Cruzes",1521528,29435.1347966321,8,386,41,345,139,247,4,0,4,0,4,390,41,349,139,251,156,10.2899443009196,14.2352256510417,0.352515437149868,2020-02-24,2020,2
"9168","SP",3,"Sudeste",35062,"Mogi das Cruzes",1521528,29435.1347966321,9,393,33,360,130,263,8,3,5,6,2,401,36,365,136,265,168,10.2899443009196,14.2352256510417,0.319740721052432,2020-03-02,2020,3
"9169","SP",3,"Sudeste",35062,"Mogi das Cruzes",1521528,29435.1347966321,10,365,42,323,130,235,3,1,2,2,1,368,43,325,132,236,180,10.2899443009196,14.2352256510417,0.327636039810609,2020-03-09,2020,3
"9170","SP",3,"Sudeste",35062,"Mogi das Cruzes",1521528,29435.1347966321,11,379,53,326,138,241,1,0,1,0,1,380,53,327,138,242,192,10.2899443009196,14.2352256510417,0.420283893343574,2020-03-16,2020,3
"9171","SP",3,"Sudeste",35062,"Mogi das Cruzes",1521528,29435.1347966321,12,327,47,280,107,220,2,0,2,1,1,329,47,282,108,221,188,10.2899443009196,14.2352256510417,0.545997645767207,2020-03-23,2020,3
"9172","SP",3,"Sudeste",35062,"Mogi das Cruzes",1521528,29435.1347966321,13,282,31,251,93,189,5,1,4,2,3,287,32,255,95,192,169,10.2899443009196,14.2352256510417,0.512767655136078,2020-03-30,2020,3
"9173","SP",3,"Sudeste",35062,"Mogi das Cruzes",1521528,29435.1347966321,14,345,43,302,131,214,2,1,1,2,0,347,44,303,133,214,194,10.2899443009196,14.2352256510417,0.498950600844467,2020-04-06,2020,4
"9174","SP",3,"Sudeste",35062,"Mogi das Cruzes",1521528,29435.1347966321,15,337,43,294,123,214,1,1,0,0,1,338,44,294,123,215,157,10.2899443009196,14.2352256510417,0.477785307789729,2020-04-13,2020,4
"9175","SP",3,"Sudeste",35062,"Mogi das Cruzes",1521528,29435.1347966321,16,415,54,361,163,252,5,2,3,3,2,420,56,364,166,254,185,10.2899443009196,14.2352256510417,0.473626106748239,2020-04-20,2020,4
"9176","SP",3,"Sudeste",35062,"Mogi das Cruzes",1521528,29435.1347966321,17,339,45,294,118,221,3,1,2,2,1,342,46,296,120,222,204,10.2899443009196,14.2352256510417,0.464415198978948,2020-04-27,2020,4
"9177","SP",3,"Sudeste",35062,"Mogi das Cruzes",1521528,29435.1347966321,18,346,41,305,135,211,3,0,3,0,3,349,41,308,135,214,220,10.2899443009196,14.2352256510417,0.443041886515187,2020-05-04,2020,5
"9178","SP",3,"Sudeste",35062,"Mogi das Cruzes",1521528,29435.1347966321,19,363,58,305,142,221,2,0,2,1,1,365,58,307,143,222,206,10.2899443009196,14.2352256510417,0.453520839424675,2020-05-11,2020,5
"9179","SP",3,"Sudeste",35062,"Mogi das Cruzes",1521528,29435.1347966321,20,369,56,313,125,244,10,3,7,4,6,379,59,320,129,250,247,10.2899443009196,14.2352256510417,0.452136816995569,2020-05-18,2020,5
"9180","SP",3,"Sudeste",35062,"Mogi das Cruzes",1521528,29435.1347966321,21,368,55,313,137,231,3,1,2,1,2,371,56,315,138,233,272,10.2899443009196,14.2352256510417,0.43908236465901,2020-05-25,2020,5
"9181","SP",3,"Sudeste",35063,"Santos",1651955,35842.8411419439,5,313,54,259,102,211,1,1,0,0,1,314,55,259,102,212,226,10.4868991368806,14.3174699929826,0.282764760946609,2020-02-03,2020,2
"9182","SP",3,"Sudeste",35063,"Santos",1651955,35842.8411419439,6,306,50,256,99,207,3,0,3,1,2,309,50,259,100,209,252,10.4868991368806,14.3174699929826,0.284478066073904,2020-02-10,2020,2
"9183","SP",3,"Sudeste",35063,"Santos",1651955,35842.8411419439,7,345,44,301,107,238,4,2,2,1,3,349,46,303,108,241,263,10.4868991368806,14.3174699929826,0.301822018502245,2020-02-17,2020,2
"9184","SP",3,"Sudeste",35063,"Santos",1651955,35842.8411419439,8,300,53,247,114,186,0,0,0,0,0,300,53,247,114,186,229,10.4868991368806,14.3174699929826,0.355651204690388,2020-02-24,2020,2
"9185","SP",3,"Sudeste",35063,"Santos",1651955,35842.8411419439,9,347,76,271,125,222,1,0,1,0,1,348,76,272,125,223,260,10.4868991368806,14.3174699929826,0.325317414427267,2020-03-02,2020,3
"9186","SP",3,"Sudeste",35063,"Santos",1651955,35842.8411419439,10,315,61,254,104,211,4,0,4,2,2,319,61,258,106,213,236,10.4868991368806,14.3174699929826,0.323919196351671,2020-03-09,2020,3
"9187","SP",3,"Sudeste",35063,"Santos",1651955,35842.8411419439,11,315,63,252,117,198,4,1,3,1,3,319,64,255,118,201,249,10.4868991368806,14.3174699929826,0.424874583766378,2020-03-16,2020,3
"9188","SP",3,"Sudeste",35063,"Santos",1651955,35842.8411419439,12,371,64,307,134,237,1,0,1,0,1,372,64,308,134,238,240,10.4868991368806,14.3174699929826,0.54228872064868,2020-03-23,2020,3
"9189","SP",3,"Sudeste",35063,"Santos",1651955,35842.8411419439,13,324,69,255,113,211,3,0,3,1,2,327,69,258,114,213,260,10.4868991368806,14.3174699929826,0.504884073566001,2020-03-30,2020,3
"9190","SP",3,"Sudeste",35063,"Santos",1651955,35842.8411419439,14,342,78,264,138,204,5,2,3,1,4,347,80,267,139,208,265,10.4868991368806,14.3174699929826,0.496103148038595,2020-04-06,2020,4
"9191","SP",3,"Sudeste",35063,"Santos",1651955,35842.8411419439,15,342,59,283,112,230,4,1,3,1,3,346,60,286,113,233,247,10.4868991368806,14.3174699929826,0.47747957032732,2020-04-13,2020,4
"9192","SP",3,"Sudeste",35063,"Santos",1651955,35842.8411419439,16,350,68,282,126,224,3,1,2,0,3,353,69,284,126,227,255,10.4868991368806,14.3174699929826,0.473377291440334,2020-04-20,2020,4
"9193","SP",3,"Sudeste",35063,"Santos",1651955,35842.8411419439,17,358,79,279,110,248,1,1,0,0,1,359,80,279,110,249,334,10.4868991368806,14.3174699929826,0.465239024089689,2020-04-27,2020,4
"9194","SP",3,"Sudeste",35063,"Santos",1651955,35842.8411419439,18,345,58,287,120,225,2,1,1,1,1,347,59,288,121,226,306,10.4868991368806,14.3174699929826,0.44437550834805,2020-05-04,2020,5
"9195","SP",3,"Sudeste",35063,"Santos",1651955,35842.8411419439,19,374,76,298,129,245,4,2,2,3,1,378,78,300,132,246,347,10.4868991368806,14.3174699929826,0.452354843448933,2020-05-11,2020,5
"9196","SP",3,"Sudeste",35063,"Santos",1651955,35842.8411419439,20,348,68,280,127,221,0,0,0,0,0,348,68,280,127,221,373,10.4868991368806,14.3174699929826,0.441771539350779,2020-05-18,2020,5
"9197","SP",3,"Sudeste",35063,"Santos",1651955,35842.8411419439,21,434,79,355,163,271,5,2,3,2,3,439,81,358,165,274,415,10.4868991368806,14.3174699929826,0.438923565161121,2020-05-25,2020,5
"9198","TO",1,"Norte",17001,"Bico do Papagaio",217560,12003.6146360544,5,57,19,38,29,28,0,0,0,0,0,57,19,38,29,28,15,9.3929631030838,12.2902299535369,0.232491965644572,2020-02-03,2020,2
"9199","TO",1,"Norte",17001,"Bico do Papagaio",217560,12003.6146360544,6,43,7,36,18,25,1,1,0,1,0,44,8,36,19,25,25,9.3929631030838,12.2902299535369,0.227902541352822,2020-02-10,2020,2
"9200","TO",1,"Norte",17001,"Bico do Papagaio",217560,12003.6146360544,7,58,14,44,20,38,0,0,0,0,0,58,14,44,20,38,18,9.3929631030838,12.2902299535369,0.23833777790822,2020-02-17,2020,2
"9201","TO",1,"Norte",17001,"Bico do Papagaio",217560,12003.6146360544,8,60,17,43,35,25,0,0,0,0,0,60,17,43,35,25,32,9.3929631030838,12.2902299535369,0.268390163039625,2020-02-24,2020,2
"9202","TO",1,"Norte",17001,"Bico do Papagaio",217560,12003.6146360544,9,45,17,28,20,25,0,0,0,0,0,45,17,28,20,25,26,9.3929631030838,12.2902299535369,0.252421522793794,2020-03-02,2020,3
"9203","TO",1,"Norte",17001,"Bico do Papagaio",217560,12003.6146360544,10,37,14,23,19,18,0,0,0,0,0,37,14,23,19,18,23,9.3929631030838,12.2902299535369,0.26428141217189,2020-03-09,2020,3
"9204","TO",1,"Norte",17001,"Bico do Papagaio",217560,12003.6146360544,11,46,11,35,23,23,3,1,2,0,3,49,12,37,23,26,20,9.3929631030838,12.2902299535369,0.331998978449237,2020-03-16,2020,3
"9205","TO",1,"Norte",17001,"Bico do Papagaio",217560,12003.6146360544,12,44,17,27,21,23,0,0,0,0,0,44,17,27,21,23,17,9.3929631030838,12.2902299535369,0.396770505295063,2020-03-23,2020,3
"9206","TO",1,"Norte",17001,"Bico do Papagaio",217560,12003.6146360544,13,32,9,23,10,22,0,0,0,0,0,32,9,23,10,22,21,9.3929631030838,12.2902299535369,0.349286441423304,2020-03-30,2020,3
"9207","TO",1,"Norte",17001,"Bico do Papagaio",217560,12003.6146360544,14,48,11,37,18,30,0,0,0,0,0,48,11,37,18,30,16,9.3929631030838,12.2902299535369,0.334224522686705,2020-04-06,2020,4
"9208","TO",1,"Norte",17001,"Bico do Papagaio",217560,12003.6146360544,15,45,12,33,26,19,0,0,0,0,0,45,12,33,26,19,18,9.3929631030838,12.2902299535369,0.325289527869363,2020-04-13,2020,4
"9209","TO",1,"Norte",17001,"Bico do Papagaio",217560,12003.6146360544,16,50,20,30,29,21,0,0,0,0,0,50,20,30,29,21,19,9.3929631030838,12.2902299535369,0.333208537371163,2020-04-20,2020,4
"9210","TO",1,"Norte",17001,"Bico do Papagaio",217560,12003.6146360544,17,43,12,31,24,19,0,0,0,0,0,43,12,31,24,19,26,9.3929631030838,12.2902299535369,0.342000489947693,2020-04-27,2020,4
"9211","TO",1,"Norte",17001,"Bico do Papagaio",217560,12003.6146360544,18,34,9,25,18,16,0,0,0,0,0,34,9,25,18,16,25,9.3929631030838,12.2902299535369,0.371580753970892,2020-05-04,2020,5
"9212","TO",1,"Norte",17001,"Bico do Papagaio",217560,12003.6146360544,19,40,9,31,24,16,1,0,1,0,1,41,9,32,24,17,39,9.3929631030838,12.2902299535369,0.382807003510138,2020-05-11,2020,5
"9213","TO",1,"Norte",17001,"Bico do Papagaio",217560,12003.6146360544,20,55,11,44,25,30,1,1,0,0,1,56,12,44,25,31,29,9.3929631030838,12.2902299535369,0.419872488625744,2020-05-18,2020,5
"9214","TO",1,"Norte",17001,"Bico do Papagaio",217560,12003.6146360544,21,64,14,50,32,32,0,0,0,0,0,64,14,50,32,32,22,9.3929631030838,12.2902299535369,0.369577765347854,2020-05-25,2020,5
"9215","TO",1,"Norte",17002,"Araguaína",323491,22082.8319929148,5,109,26,83,52,57,0,0,0,0,0,109,26,83,52,57,42,10.002555752715,12.6869265718251,0.273966677268639,2020-02-03,2020,2
"9216","TO",1,"Norte",17002,"Araguaína",323491,22082.8319929148,6,90,25,65,39,51,1,0,1,1,0,91,25,66,40,51,22,10.002555752715,12.6869265718251,0.268056433325889,2020-02-10,2020,2
"9217","TO",1,"Norte",17002,"Araguaína",323491,22082.8319929148,7,91,10,81,43,48,1,1,0,1,0,92,11,81,44,48,31,10.002555752715,12.6869265718251,0.286913851521496,2020-02-17,2020,2
"9218","TO",1,"Norte",17002,"Araguaína",323491,22082.8319929148,8,93,20,73,37,56,0,0,0,0,0,93,20,73,37,56,27,10.002555752715,12.6869265718251,0.320371620898072,2020-02-24,2020,2
"9219","TO",1,"Norte",17002,"Araguaína",323491,22082.8319929148,9,95,28,67,40,55,0,0,0,0,0,95,28,67,40,55,23,10.002555752715,12.6869265718251,0.293089543912506,2020-03-02,2020,3
"9220","TO",1,"Norte",17002,"Araguaína",323491,22082.8319929148,10,81,14,67,40,41,1,1,0,1,0,82,15,67,41,41,42,10.002555752715,12.6869265718251,0.313397240762953,2020-03-09,2020,3
"9221","TO",1,"Norte",17002,"Araguaína",323491,22082.8319929148,11,85,12,73,29,56,0,0,0,0,0,85,12,73,29,56,28,10.002555752715,12.6869265718251,0.384647923006496,2020-03-16,2020,3
"9222","TO",1,"Norte",17002,"Araguaína",323491,22082.8319929148,12,83,12,71,32,51,1,1,0,0,1,84,13,71,32,52,23,10.002555752715,12.6869265718251,0.455815517734673,2020-03-23,2020,3
"9223","TO",1,"Norte",17002,"Araguaína",323491,22082.8319929148,13,73,18,55,38,35,0,0,0,0,0,73,18,55,38,35,35,10.002555752715,12.6869265718251,0.402880342982617,2020-03-30,2020,3
"9224","TO",1,"Norte",17002,"Araguaína",323491,22082.8319929148,14,84,20,64,31,53,0,0,0,0,0,84,20,64,31,53,41,10.002555752715,12.6869265718251,0.404454226428875,2020-04-06,2020,4
"9225","TO",1,"Norte",17002,"Araguaína",323491,22082.8319929148,15,81,13,68,40,41,1,0,1,0,1,82,13,69,40,42,26,10.002555752715,12.6869265718251,0.386602929598079,2020-04-13,2020,4
"9226","TO",1,"Norte",17002,"Araguaína",323491,22082.8319929148,16,81,22,59,30,51,0,0,0,0,0,81,22,59,30,51,26,10.002555752715,12.6869265718251,0.388068141437857,2020-04-20,2020,4
"9227","TO",1,"Norte",17002,"Araguaína",323491,22082.8319929148,17,79,15,64,43,36,0,0,0,0,0,79,15,64,43,36,33,10.002555752715,12.6869265718251,0.398336739807721,2020-04-27,2020,4
"9228","TO",1,"Norte",17002,"Araguaína",323491,22082.8319929148,18,84,17,67,34,50,1,0,1,1,0,85,17,68,35,50,32,10.002555752715,12.6869265718251,0.385803228523925,2020-05-04,2020,5
"9229","TO",1,"Norte",17002,"Araguaína",323491,22082.8319929148,19,79,19,60,36,43,0,0,0,0,0,79,19,60,36,43,40,10.002555752715,12.6869265718251,0.426152848088961,2020-05-11,2020,5
"9230","TO",1,"Norte",17002,"Araguaína",323491,22082.8319929148,20,79,22,57,39,40,1,0,1,0,1,80,22,58,39,41,43,10.002555752715,12.6869265718251,0.440295357205312,2020-05-18,2020,5
"9231","TO",1,"Norte",17002,"Araguaína",323491,22082.8319929148,21,92,20,72,41,51,3,0,3,0,3,95,20,75,41,54,38,10.002555752715,12.6869265718251,0.394091745404984,2020-05-25,2020,5
"9232","TO",1,"Norte",17003,"Miracema do Tocantins",149583,21685.0453459283,5,39,12,27,19,20,0,0,0,0,0,39,12,27,19,20,17,9.98437814738687,11.9156067017018,0.257830100194861,2020-02-03,2020,2
"9233","TO",1,"Norte",17003,"Miracema do Tocantins",149583,21685.0453459283,6,35,9,26,20,15,0,0,0,0,0,35,9,26,20,15,20,9.98437814738687,11.9156067017018,0.240417265013937,2020-02-10,2020,2
"9234","TO",1,"Norte",17003,"Miracema do Tocantins",149583,21685.0453459283,7,47,14,33,26,21,1,0,1,0,1,48,14,34,26,22,15,9.98437814738687,11.9156067017018,0.267151490046142,2020-02-17,2020,2
"9235","TO",1,"Norte",17003,"Miracema do Tocantins",149583,21685.0453459283,8,54,10,44,28,26,0,0,0,0,0,54,10,44,28,26,13,9.98437814738687,11.9156067017018,0.295771904452954,2020-02-24,2020,2
"9236","TO",1,"Norte",17003,"Miracema do Tocantins",149583,21685.0453459283,9,32,6,26,9,23,0,0,0,0,0,32,6,26,9,23,19,9.98437814738687,11.9156067017018,0.274814496164335,2020-03-02,2020,3
"9237","TO",1,"Norte",17003,"Miracema do Tocantins",149583,21685.0453459283,10,37,15,22,23,14,0,0,0,0,0,37,15,22,23,14,26,9.98437814738687,11.9156067017018,0.282528562312949,2020-03-09,2020,3
"9238","TO",1,"Norte",17003,"Miracema do Tocantins",149583,21685.0453459283,11,43,7,36,18,25,0,0,0,0,0,43,7,36,18,25,20,9.98437814738687,11.9156067017018,0.346556588101695,2020-03-16,2020,3
"9239","TO",1,"Norte",17003,"Miracema do Tocantins",149583,21685.0453459283,12,44,9,35,18,26,0,0,0,0,0,44,9,35,18,26,13,9.98437814738687,11.9156067017018,0.41813439654783,2020-03-23,2020,3
"9240","TO",1,"Norte",17003,"Miracema do Tocantins",149583,21685.0453459283,13,36,17,19,23,13,0,0,0,0,0,36,17,19,23,13,26,9.98437814738687,11.9156067017018,0.359210323139587,2020-03-30,2020,3
"9241","TO",1,"Norte",17003,"Miracema do Tocantins",149583,21685.0453459283,14,30,4,26,8,22,0,0,0,0,0,30,4,26,8,22,11,9.98437814738687,11.9156067017018,0.373534808704301,2020-04-06,2020,4
"9242","TO",1,"Norte",17003,"Miracema do Tocantins",149583,21685.0453459283,15,43,9,34,27,16,1,0,1,0,1,44,9,35,27,17,13,9.98437814738687,11.9156067017018,0.342346663152129,2020-04-13,2020,4
"9243","TO",1,"Norte",17003,"Miracema do Tocantins",149583,21685.0453459283,16,33,9,24,12,21,0,0,0,0,0,33,9,24,12,21,16,9.98437814738687,11.9156067017018,0.338073896553291,2020-04-20,2020,4
"9244","TO",1,"Norte",17003,"Miracema do Tocantins",149583,21685.0453459283,17,35,15,20,18,17,0,0,0,0,0,35,15,20,18,17,17,9.98437814738687,11.9156067017018,0.366669302098144,2020-04-27,2020,4
"9245","TO",1,"Norte",17003,"Miracema do Tocantins",149583,21685.0453459283,18,32,12,20,12,20,0,0,0,0,0,32,12,20,12,20,15,9.98437814738687,11.9156067017018,0.368607437683149,2020-05-04,2020,5
"9246","TO",1,"Norte",17003,"Miracema do Tocantins",149583,21685.0453459283,19,22,7,15,10,12,3,0,3,2,1,25,7,18,12,13,16,9.98437814738687,11.9156067017018,0.379246321020395,2020-05-11,2020,5
"9247","TO",1,"Norte",17003,"Miracema do Tocantins",149583,21685.0453459283,20,33,10,23,13,20,0,0,0,0,0,33,10,23,13,20,9,9.98437814738687,11.9156067017018,0.384647110930499,2020-05-18,2020,5
"9248","TO",1,"Norte",17003,"Miracema do Tocantins",149583,21685.0453459283,21,33,7,26,18,15,0,0,0,0,0,33,7,26,18,15,15,9.98437814738687,11.9156067017018,0.369587704444946,2020-05-25,2020,5
"9249","TO",1,"Norte",17004,"Rio Formoso",128892,23195.4467949136,5,38,5,33,14,24,0,0,0,0,0,38,5,33,14,24,12,10.0517112795532,11.766730123386,0.260214513698161,2020-02-03,2020,2
"9250","TO",1,"Norte",17004,"Rio Formoso",128892,23195.4467949136,6,28,7,21,13,15,1,0,1,0,1,29,7,22,13,16,18,10.0517112795532,11.766730123386,0.25468800854108,2020-02-10,2020,2
"9251","TO",1,"Norte",17004,"Rio Formoso",128892,23195.4467949136,7,34,9,25,13,21,0,0,0,0,0,34,9,25,13,21,11,10.0517112795532,11.766730123386,0.263710749603939,2020-02-17,2020,2
"9252","TO",1,"Norte",17004,"Rio Formoso",128892,23195.4467949136,8,25,6,19,11,14,0,0,0,0,0,25,6,19,11,14,9,10.0517112795532,11.766730123386,0.294737416818261,2020-02-24,2020,2
"9253","TO",1,"Norte",17004,"Rio Formoso",128892,23195.4467949136,9,30,8,22,15,15,0,0,0,0,0,30,8,22,15,15,10,10.0517112795532,11.766730123386,0.292598099467271,2020-03-02,2020,3
"9254","TO",1,"Norte",17004,"Rio Formoso",128892,23195.4467949136,10,38,7,31,14,24,0,0,0,0,0,38,7,31,14,24,18,10.0517112795532,11.766730123386,0.305156000857762,2020-03-09,2020,3
"9255","TO",1,"Norte",17004,"Rio Formoso",128892,23195.4467949136,11,32,8,24,10,22,0,0,0,0,0,32,8,24,10,22,11,10.0517112795532,11.766730123386,0.360425596968631,2020-03-16,2020,3
"9256","TO",1,"Norte",17004,"Rio Formoso",128892,23195.4467949136,12,29,7,22,13,16,1,0,1,1,0,30,7,23,14,16,16,10.0517112795532,11.766730123386,0.432517836168765,2020-03-23,2020,3
"9257","TO",1,"Norte",17004,"Rio Formoso",128892,23195.4467949136,13,22,8,14,10,12,0,0,0,0,0,22,8,14,10,12,10,10.0517112795532,11.766730123386,0.370798019176634,2020-03-30,2020,3
"9258","TO",1,"Norte",17004,"Rio Formoso",128892,23195.4467949136,14,26,6,20,13,13,0,0,0,0,0,26,6,20,13,13,15,10.0517112795532,11.766730123386,0.367592933525143,2020-04-06,2020,4
"9259","TO",1,"Norte",17004,"Rio Formoso",128892,23195.4467949136,15,24,3,21,14,10,0,0,0,0,0,24,3,21,14,10,11,10.0517112795532,11.766730123386,0.348281513026284,2020-04-13,2020,4
"9260","TO",1,"Norte",17004,"Rio Formoso",128892,23195.4467949136,16,40,4,36,19,21,0,0,0,0,0,40,4,36,19,21,16,10.0517112795532,11.766730123386,0.351742040423048,2020-04-20,2020,4
"9261","TO",1,"Norte",17004,"Rio Formoso",128892,23195.4467949136,17,29,8,21,12,17,0,0,0,0,0,29,8,21,12,17,14,10.0517112795532,11.766730123386,0.361571460500808,2020-04-27,2020,4
"9262","TO",1,"Norte",17004,"Rio Formoso",128892,23195.4467949136,18,26,3,23,12,14,0,0,0,0,0,26,3,23,12,14,10,10.0517112795532,11.766730123386,0.350514205710184,2020-05-04,2020,5
"9263","TO",1,"Norte",17004,"Rio Formoso",128892,23195.4467949136,19,26,12,14,13,13,0,0,0,0,0,26,12,14,13,13,15,10.0517112795532,11.766730123386,0.370470308415164,2020-05-11,2020,5
"9264","TO",1,"Norte",17004,"Rio Formoso",128892,23195.4467949136,20,33,8,25,16,17,0,0,0,0,0,33,8,25,16,17,19,10.0517112795532,11.766730123386,0.369378789952773,2020-05-18,2020,5
"9265","TO",1,"Norte",17004,"Rio Formoso",128892,23195.4467949136,21,35,11,24,15,20,2,0,2,0,2,37,11,26,15,22,13,10.0517112795532,11.766730123386,0.369191899805812,2020-05-25,2020,5
"9266","TO",1,"Norte",17005,"Gurupi",151930,28875.7612465609,5,35,8,27,15,20,0,0,0,0,0,35,8,27,15,20,15,10.2707578109938,11.9311751674378,0.2710120111927,2020-02-03,2020,2
"9267","TO",1,"Norte",17005,"Gurupi",151930,28875.7612465609,6,32,8,24,11,21,2,1,1,2,0,34,9,25,13,21,18,10.2707578109938,11.9311751674378,0.255061769171184,2020-02-10,2020,2
"9268","TO",1,"Norte",17005,"Gurupi",151930,28875.7612465609,7,36,10,26,14,22,0,0,0,0,0,36,10,26,14,22,12,10.2707578109938,11.9311751674378,0.273027326866851,2020-02-17,2020,2
"9269","TO",1,"Norte",17005,"Gurupi",151930,28875.7612465609,8,38,9,29,17,21,0,0,0,0,0,38,9,29,17,21,18,10.2707578109938,11.9311751674378,0.301945597069014,2020-02-24,2020,2
"9270","TO",1,"Norte",17005,"Gurupi",151930,28875.7612465609,9,44,7,37,17,27,0,0,0,0,0,44,7,37,17,27,13,10.2707578109938,11.9311751674378,0.279476365166536,2020-03-02,2020,3
"9271","TO",1,"Norte",17005,"Gurupi",151930,28875.7612465609,10,33,10,23,20,13,0,0,0,0,0,33,10,23,20,13,11,10.2707578109938,11.9311751674378,0.285844047061939,2020-03-09,2020,3
"9272","TO",1,"Norte",17005,"Gurupi",151930,28875.7612465609,11,30,3,27,12,18,0,0,0,0,0,30,3,27,12,18,14,10.2707578109938,11.9311751674378,0.362283942442904,2020-03-16,2020,3
"9273","TO",1,"Norte",17005,"Gurupi",151930,28875.7612465609,12,38,5,33,11,27,0,0,0,0,0,38,5,33,11,27,17,10.2707578109938,11.9311751674378,0.449017347486086,2020-03-23,2020,3
"9274","TO",1,"Norte",17005,"Gurupi",151930,28875.7612465609,13,30,7,23,11,19,1,0,1,1,0,31,7,24,12,19,15,10.2707578109938,11.9311751674378,0.395086960000098,2020-03-30,2020,3
"9275","TO",1,"Norte",17005,"Gurupi",151930,28875.7612465609,14,30,5,25,16,14,1,0,1,1,0,31,5,26,17,14,10,10.2707578109938,11.9311751674378,0.379523815034865,2020-04-06,2020,4
"9276","TO",1,"Norte",17005,"Gurupi",151930,28875.7612465609,15,36,9,27,17,19,1,0,1,0,1,37,9,28,17,20,10,10.2707578109938,11.9311751674378,0.358293180770929,2020-04-13,2020,4
"9277","TO",1,"Norte",17005,"Gurupi",151930,28875.7612465609,16,39,8,31,15,24,0,0,0,0,0,39,8,31,15,24,14,10.2707578109938,11.9311751674378,0.363226396182572,2020-04-20,2020,4
"9278","TO",1,"Norte",17005,"Gurupi",151930,28875.7612465609,17,37,7,30,15,22,0,0,0,0,0,37,7,30,15,22,15,10.2707578109938,11.9311751674378,0.356383765430899,2020-04-27,2020,4
"9279","TO",1,"Norte",17005,"Gurupi",151930,28875.7612465609,18,25,4,21,13,12,0,0,0,0,0,25,4,21,13,12,14,10.2707578109938,11.9311751674378,0.3544646686867,2020-05-04,2020,5
"9280","TO",1,"Norte",17005,"Gurupi",151930,28875.7612465609,19,39,12,27,21,18,1,0,1,0,1,40,12,28,21,19,16,10.2707578109938,11.9311751674378,0.375086871410268,2020-05-11,2020,5
"9281","TO",1,"Norte",17005,"Gurupi",151930,28875.7612465609,20,36,6,30,18,18,1,0,1,0,1,37,6,31,18,19,15,10.2707578109938,11.9311751674378,0.360533505438648,2020-05-18,2020,5
"9282","TO",1,"Norte",17005,"Gurupi",151930,28875.7612465609,21,44,8,36,20,24,0,0,0,0,0,44,8,36,20,24,12,10.2707578109938,11.9311751674378,0.362721702185561,2020-05-25,2020,5
"9283","TO",1,"Norte",17006,"Porto Nacional",413057,31203.2091276507,5,102,19,83,41,61,0,0,0,0,0,102,19,83,41,61,38,10.3482762251637,12.9313408769479,0.254050012762665,2020-02-03,2020,2
"9284","TO",1,"Norte",17006,"Porto Nacional",413057,31203.2091276507,6,115,26,89,51,64,0,0,0,0,0,115,26,89,51,64,31,10.3482762251637,12.9313408769479,0.245767469002563,2020-02-10,2020,2
"9285","TO",1,"Norte",17006,"Porto Nacional",413057,31203.2091276507,7,132,15,117,55,77,1,0,1,0,1,133,15,118,55,78,29,10.3482762251637,12.9313408769479,0.263012504245962,2020-02-17,2020,2
"9286","TO",1,"Norte",17006,"Porto Nacional",413057,31203.2091276507,8,128,19,109,51,77,1,0,1,0,1,129,19,110,51,78,28,10.3482762251637,12.9313408769479,0.309030082834467,2020-02-24,2020,2
"9287","TO",1,"Norte",17006,"Porto Nacional",413057,31203.2091276507,9,119,13,106,46,73,0,0,0,0,0,119,13,106,46,73,30,10.3482762251637,12.9313408769479,0.280625844091152,2020-03-02,2020,3
"9288","TO",1,"Norte",17006,"Porto Nacional",413057,31203.2091276507,10,123,16,107,50,73,2,0,2,1,1,125,16,109,51,74,33,10.3482762251637,12.9313408769479,0.29305595562631,2020-03-09,2020,3
"9289","TO",1,"Norte",17006,"Porto Nacional",413057,31203.2091276507,11,133,22,111,51,82,1,1,0,0,1,134,23,111,51,83,36,10.3482762251637,12.9313408769479,0.40848407123054,2020-03-16,2020,3
"9290","TO",1,"Norte",17006,"Porto Nacional",413057,31203.2091276507,12,109,13,96,42,67,0,0,0,0,0,109,13,96,42,67,42,10.3482762251637,12.9313408769479,0.501035618935467,2020-03-23,2020,3
"9291","TO",1,"Norte",17006,"Porto Nacional",413057,31203.2091276507,13,114,13,101,50,64,1,0,1,0,1,115,13,102,50,65,34,10.3482762251637,12.9313408769479,0.439923168258372,2020-03-30,2020,3
"9292","TO",1,"Norte",17006,"Porto Nacional",413057,31203.2091276507,14,131,10,121,44,87,0,0,0,0,0,131,10,121,44,87,32,10.3482762251637,12.9313408769479,0.432421726642863,2020-04-06,2020,4
"9293","TO",1,"Norte",17006,"Porto Nacional",413057,31203.2091276507,15,135,25,110,48,87,0,0,0,0,0,135,25,110,48,87,33,10.3482762251637,12.9313408769479,0.405262830502422,2020-04-13,2020,4
"9294","TO",1,"Norte",17006,"Porto Nacional",413057,31203.2091276507,16,132,21,111,50,82,1,0,1,0,1,133,21,112,50,83,29,10.3482762251637,12.9313408769479,0.422053049748317,2020-04-20,2020,4
"9295","TO",1,"Norte",17006,"Porto Nacional",413057,31203.2091276507,17,118,12,106,50,68,0,0,0,0,0,118,12,106,50,68,25,10.3482762251637,12.9313408769479,0.401989322364005,2020-04-27,2020,4
"9296","TO",1,"Norte",17006,"Porto Nacional",413057,31203.2091276507,18,129,12,117,45,84,2,1,1,0,2,131,13,118,45,86,31,10.3482762251637,12.9313408769479,0.382940852998943,2020-05-04,2020,5
"9297","TO",1,"Norte",17006,"Porto Nacional",413057,31203.2091276507,19,136,13,123,37,99,1,1,0,1,0,137,14,123,38,99,39,10.3482762251637,12.9313408769479,0.396914508082337,2020-05-11,2020,5
"9298","TO",1,"Norte",17006,"Porto Nacional",413057,31203.2091276507,20,120,17,103,50,70,3,1,2,3,0,123,18,105,53,70,26,10.3482762251637,12.9313408769479,0.400466194249838,2020-05-18,2020,5
"9299","TO",1,"Norte",17006,"Porto Nacional",413057,31203.2091276507,21,128,23,105,50,78,1,1,0,0,1,129,24,105,50,79,38,10.3482762251637,12.9313408769479,0.378487092731307,2020-05-25,2020,5
"9300","TO",1,"Norte",17007,"Jalapão",80915,15745.1859781252,5,19,6,13,14,5,0,0,0,0,0,19,6,13,14,5,7,9.6642899453501,11.301154499951,0.264921666417147,2020-02-03,2020,2
"9301","TO",1,"Norte",17007,"Jalapão",80915,15745.1859781252,6,21,9,12,11,10,0,0,0,0,0,21,9,12,11,10,3,9.6642899453501,11.301154499951,0.292867363188696,2020-02-10,2020,2
"9302","TO",1,"Norte",17007,"Jalapão",80915,15745.1859781252,7,23,8,15,10,13,0,0,0,0,0,23,8,15,10,13,8,9.6642899453501,11.301154499951,0.294986682001434,2020-02-17,2020,2
"9303","TO",1,"Norte",17007,"Jalapão",80915,15745.1859781252,8,25,3,22,17,8,0,0,0,0,0,25,3,22,17,8,7,9.6642899453501,11.301154499951,0.291783513820389,2020-02-24,2020,2
"9304","TO",1,"Norte",17007,"Jalapão",80915,15745.1859781252,9,16,3,13,9,7,0,0,0,0,0,16,3,13,9,7,3,9.6642899453501,11.301154499951,0.320346329195521,2020-03-02,2020,3
"9305","TO",1,"Norte",17007,"Jalapão",80915,15745.1859781252,10,29,4,25,14,15,0,0,0,0,0,29,4,25,14,15,6,9.6642899453501,11.301154499951,0.320680899712253,2020-03-09,2020,3
"9306","TO",1,"Norte",17007,"Jalapão",80915,15745.1859781252,11,19,9,10,7,12,0,0,0,0,0,19,9,10,7,12,16,9.6642899453501,11.301154499951,0.388244798262972,2020-03-16,2020,3
"9307","TO",1,"Norte",17007,"Jalapão",80915,15745.1859781252,12,22,9,13,9,13,0,0,0,0,0,22,9,13,9,13,7,9.6642899453501,11.301154499951,0.392587542145225,2020-03-23,2020,3
"9308","TO",1,"Norte",17007,"Jalapão",80915,15745.1859781252,13,22,6,16,7,15,0,0,0,0,0,22,6,16,7,15,8,9.6642899453501,11.301154499951,0.354078536021807,2020-03-30,2020,3
"9309","TO",1,"Norte",17007,"Jalapão",80915,15745.1859781252,14,22,9,13,11,11,2,2,0,0,2,24,11,13,11,13,9,9.6642899453501,11.301154499951,0.355752740607839,2020-04-06,2020,4
"9310","TO",1,"Norte",17007,"Jalapão",80915,15745.1859781252,15,22,11,11,9,13,1,0,1,1,0,23,11,12,10,13,9,9.6642899453501,11.301154499951,0.33369591679544,2020-04-13,2020,4
"9311","TO",1,"Norte",17007,"Jalapão",80915,15745.1859781252,16,22,15,7,14,8,1,1,0,0,1,23,16,7,14,9,8,9.6642899453501,11.301154499951,0.359246749279269,2020-04-20,2020,4
"9312","TO",1,"Norte",17007,"Jalapão",80915,15745.1859781252,17,11,3,8,6,5,1,1,0,1,0,12,4,8,7,5,10,9.6642899453501,11.301154499951,0.377056233530249,2020-04-27,2020,4
"9313","TO",1,"Norte",17007,"Jalapão",80915,15745.1859781252,18,18,9,9,13,5,0,0,0,0,0,18,9,9,13,5,9,9.6642899453501,11.301154499951,0.395063132901357,2020-05-04,2020,5
"9314","TO",1,"Norte",17007,"Jalapão",80915,15745.1859781252,19,21,3,18,8,13,0,0,0,0,0,21,3,18,8,13,6,9.6642899453501,11.301154499951,0.433869257224164,2020-05-11,2020,5
"9315","TO",1,"Norte",17007,"Jalapão",80915,15745.1859781252,20,28,13,15,12,16,0,0,0,0,0,28,13,15,12,16,7,9.6642899453501,11.301154499951,0.366589842328085,2020-05-18,2020,5
"9316","TO",1,"Norte",17007,"Jalapão",80915,15745.1859781252,21,16,9,7,4,12,0,0,0,0,0,16,9,7,4,12,7,9.6642899453501,11.301154499951,0.39385058756064,2020-05-25,2020,5
"9317","TO",1,"Norte",17008,"Dianópolis",124820,16426.4508932062,5,31,8,23,14,17,1,0,1,0,1,32,8,24,14,18,11,9.70664817389333,11.734627978488,0.252157326413902,2020-02-03,2020,2
"9318","TO",1,"Norte",17008,"Dianópolis",124820,16426.4508932062,6,24,7,17,12,12,0,0,0,0,0,24,7,17,12,12,8,9.70664817389333,11.734627978488,0.232593516304741,2020-02-10,2020,2
"9319","TO",1,"Norte",17008,"Dianópolis",124820,16426.4508932062,7,25,10,15,8,17,0,0,0,0,0,25,10,15,8,17,19,9.70664817389333,11.734627978488,0.263525430896255,2020-02-17,2020,2
"9320","TO",1,"Norte",17008,"Dianópolis",124820,16426.4508932062,8,35,17,18,22,13,0,0,0,0,0,35,17,18,22,13,8,9.70664817389333,11.734627978488,0.293338639657249,2020-02-24,2020,2
"9321","TO",1,"Norte",17008,"Dianópolis",124820,16426.4508932062,9,36,16,20,19,17,0,0,0,0,0,36,16,20,19,17,13,9.70664817389333,11.734627978488,0.273790652378311,2020-03-02,2020,3
"9322","TO",1,"Norte",17008,"Dianópolis",124820,16426.4508932062,10,34,14,20,16,18,0,0,0,0,0,34,14,20,16,18,10,9.70664817389333,11.734627978488,0.282295112811888,2020-03-09,2020,3
"9323","TO",1,"Norte",17008,"Dianópolis",124820,16426.4508932062,11,21,10,11,11,10,0,0,0,0,0,21,10,11,11,10,19,9.70664817389333,11.734627978488,0.32850586994739,2020-03-16,2020,3
"9324","TO",1,"Norte",17008,"Dianópolis",124820,16426.4508932062,12,32,8,24,10,22,0,0,0,0,0,32,8,24,10,22,10,9.70664817389333,11.734627978488,0.407429484709453,2020-03-23,2020,3
"9325","TO",1,"Norte",17008,"Dianópolis",124820,16426.4508932062,13,19,5,14,11,8,0,0,0,0,0,19,5,14,11,8,14,9.70664817389333,11.734627978488,0.3544654890476,2020-03-30,2020,3
"9326","TO",1,"Norte",17008,"Dianópolis",124820,16426.4508932062,14,28,9,19,16,12,0,0,0,0,0,28,9,19,16,12,8,9.70664817389333,11.734627978488,0.362497513537742,2020-04-06,2020,4
"9327","TO",1,"Norte",17008,"Dianópolis",124820,16426.4508932062,15,23,7,16,12,11,1,0,1,0,1,24,7,17,12,12,12,9.70664817389333,11.734627978488,0.329717928969711,2020-04-13,2020,4
"9328","TO",1,"Norte",17008,"Dianópolis",124820,16426.4508932062,16,28,8,20,13,15,3,1,2,2,1,31,9,22,15,16,8,9.70664817389333,11.734627978488,0.34356836821433,2020-04-20,2020,4
"9329","TO",1,"Norte",17008,"Dianópolis",124820,16426.4508932062,17,37,9,28,19,18,0,0,0,0,0,37,9,28,19,18,10,9.70664817389333,11.734627978488,0.329373845802468,2020-04-27,2020,4
"9330","TO",1,"Norte",17008,"Dianópolis",124820,16426.4508932062,18,28,6,22,12,16,1,1,0,1,0,29,7,22,13,16,11,9.70664817389333,11.734627978488,0.357343061101242,2020-05-04,2020,5
"9331","TO",1,"Norte",17008,"Dianópolis",124820,16426.4508932062,19,34,7,27,13,21,1,0,1,0,1,35,7,28,13,22,14,9.70664817389333,11.734627978488,0.354650126364168,2020-05-11,2020,5
"9332","TO",1,"Norte",17008,"Dianópolis",124820,16426.4508932062,20,32,9,23,14,18,0,0,0,0,0,32,9,23,14,18,11,9.70664817389333,11.734627978488,0.350560516332181,2020-05-18,2020,5
"9333","TO",1,"Norte",17008,"Dianópolis",124820,16426.4508932062,21,23,6,17,13,10,1,0,1,0,1,24,6,18,13,11,12,9.70664817389333,11.734627978488,0.346988666062445,2020-05-25,2020,5
