"","UF","name","popm","gdpc","microregion","microregion_name","region","region_name","urban","codmun6","month","nconcep","nconcep_educ_low","nconcep_educ_high","nconcep_age_young","nconcep_age_old","nfetal","nfetal_educ_low","nfetal_educ_high","nfetal_age_young","nfetal_age_old","totalconcep","totalconcep_educ_low","totalconcep_educ_high","totalconcep_age_young","totalconcep_age_old","deaths","lgdp","lpop","isolated","n"
"1","RO","Alta Floresta D'Oeste",22728,21552.47,11006,"Cacoal",1,"Norte",0,"110001",2,24,8,16,8,16,0,0,0,0,0,24,8,16,8,16,10,9.97824570613322,10.031352923534,0.313762028255278,29
"2","RO","Alta Floresta D'Oeste",22728,21552.47,11006,"Cacoal",1,"Norte",0,"110001",3,20,6,14,10,10,0,0,0,0,0,20,6,14,10,10,8,9.97824570613322,10.031352923534,0.410957733516824,31
"3","RO","Alta Floresta D'Oeste",22728,21552.47,11006,"Cacoal",1,"Norte",0,"110001",4,27,12,15,13,14,0,0,0,0,0,27,12,15,13,14,11,9.97824570613322,10.031352923534,0.411934125123187,30
"4","RO","Alta Floresta D'Oeste",22728,21552.47,11006,"Cacoal",1,"Norte",0,"110001",5,24,6,18,13,11,0,0,0,0,0,24,6,18,13,11,10,9.97824570613322,10.031352923534,0.439771444109699,31
"5","RO","Ariquemes",109523,23206.36,11003,"Ariquemes",1,"Norte",1,"110002",2,112,33,79,53,59,0,0,0,0,0,112,33,79,53,59,33,10.0521816580165,11.6038898518443,0.302274032496523,29
"6","RO","Ariquemes",109523,23206.36,11003,"Ariquemes",1,"Norte",1,"110002",3,127,34,93,67,60,3,1,2,1,2,130,35,95,68,62,50,10.0521816580165,11.6038898518443,0.382985907351202,31
"7","RO","Ariquemes",109523,23206.36,11003,"Ariquemes",1,"Norte",1,"110002",4,129,31,98,55,74,2,0,2,0,2,131,31,100,55,76,44,10.0521816580165,11.6038898518443,0.415762381587051,30
"8","RO","Ariquemes",109523,23206.36,11003,"Ariquemes",1,"Norte",1,"110002",5,138,34,104,64,74,2,1,1,1,1,140,35,105,65,75,48,10.0521816580165,11.6038898518443,0.395834346236795,31
"9","RO","Cacoal",85893,25708.96,11006,"Cacoal",1,"Norte",1,"110004",2,112,17,95,41,71,0,0,0,0,0,112,17,95,41,71,26,10.1545948482555,11.3608576145471,0.316755494112133,29
"10","RO","Cacoal",85893,25708.96,11006,"Cacoal",1,"Norte",1,"110004",3,122,26,96,44,78,0,0,0,0,0,122,26,96,44,78,44,10.1545948482555,11.3608576145471,0.412615702474296,31
"11","RO","Cacoal",85893,25708.96,11006,"Cacoal",1,"Norte",1,"110004",4,99,23,76,38,61,1,0,1,1,0,100,23,77,39,61,36,10.1545948482555,11.3608576145471,0.438044449925928,30
"12","RO","Cacoal",85893,25708.96,11006,"Cacoal",1,"Norte",1,"110004",5,126,31,95,49,77,0,0,0,0,0,126,31,95,49,77,44,10.1545948482555,11.3608576145471,0.414557463978431,31
"13","RO","Cerejeiras",16204,28714.35,11008,"Colorado do Oeste",1,"Norte",1,"110005",2,21,11,10,7,14,0,0,0,0,0,21,11,10,7,14,7,10.2651522767894,9.69301340432258,0.318097365681646,29
"14","RO","Cerejeiras",16204,28714.35,11008,"Colorado do Oeste",1,"Norte",1,"110005",3,22,5,17,12,10,0,0,0,0,0,22,5,17,12,10,7,10.2651522767894,9.69301340432258,0.381834139779908,31
"15","RO","Cerejeiras",16204,28714.35,11008,"Colorado do Oeste",1,"Norte",1,"110005",4,17,2,15,8,9,1,0,1,0,1,18,2,16,8,10,7,10.2651522767894,9.69301340432258,0.423814819651316,30
"16","RO","Cerejeiras",16204,28714.35,11008,"Colorado do Oeste",1,"Norte",1,"110005",5,22,6,16,4,18,0,0,0,0,0,22,6,16,4,18,6,10.2651522767894,9.69301340432258,0.379788695703754,31
"17","RO","Colorado do Oeste",15544,20362.88,11008,"Colorado do Oeste",1,"Norte",0,"110006",2,16,5,11,6,10,0,0,0,0,0,16,5,11,6,10,8,9.92146891449185,9.65142999105728,0.3231189152917,29
"18","RO","Colorado do Oeste",15544,20362.88,11008,"Colorado do Oeste",1,"Norte",0,"110006",3,14,4,10,3,11,0,0,0,0,0,14,4,10,3,11,9,9.92146891449185,9.65142999105728,0.423153370680315,31
"19","RO","Colorado do Oeste",15544,20362.88,11008,"Colorado do Oeste",1,"Norte",0,"110006",4,12,1,11,5,7,0,0,0,0,0,12,1,11,5,7,10,9.92146891449185,9.65142999105728,0.469508731538151,30
"20","RO","Colorado do Oeste",15544,20362.88,11008,"Colorado do Oeste",1,"Norte",0,"110006",5,16,5,11,8,8,0,0,0,0,0,16,5,11,8,8,8,9.92146891449185,9.65142999105728,0.453461031746386,31
"21","RO","Costa Marques",18798,12890.7,11002,"Guajará-Mirim",1,"Norte",0,"110008",2,10,5,5,4,6,0,0,0,0,0,10,5,5,4,6,1,9.46426140012204,9.84150576018025,0.342953297867111,29
"22","RO","Costa Marques",18798,12890.7,11002,"Guajará-Mirim",1,"Norte",0,"110008",3,19,9,10,9,10,0,0,0,0,0,19,9,10,9,10,10,9.46426140012204,9.84150576018025,0.437642001494323,31
"23","RO","Costa Marques",18798,12890.7,11002,"Guajará-Mirim",1,"Norte",0,"110008",4,13,6,7,9,4,0,0,0,0,0,13,6,7,9,4,3,9.46426140012204,9.84150576018025,0.443144765014464,30
"24","RO","Costa Marques",18798,12890.7,11002,"Guajará-Mirim",1,"Norte",0,"110008",5,10,7,3,8,2,0,0,0,0,0,10,7,3,8,2,7,9.46426140012204,9.84150576018025,0.421290427371824,31
"25","RO","Espigão D'Oeste",32695,18984.55,11006,"Cacoal",1,"Norte",0,"110009",2,33,11,22,14,19,0,0,0,0,0,33,11,22,14,19,16,9.85138076946162,10.3949774399954,0.366473474454986,29
"26","RO","Espigão D'Oeste",32695,18984.55,11006,"Cacoal",1,"Norte",0,"110009",3,40,12,28,18,22,0,0,0,0,0,40,12,28,18,22,17,9.85138076946162,10.3949774399954,0.43445381681002,31
"27","RO","Espigão D'Oeste",32695,18984.55,11006,"Cacoal",1,"Norte",0,"110009",4,29,9,20,14,15,3,0,3,1,2,32,9,23,15,17,10,9.85138076946162,10.3949774399954,0.461425341491426,30
"28","RO","Espigão D'Oeste",32695,18984.55,11006,"Cacoal",1,"Norte",0,"110009",5,46,12,34,14,32,0,0,0,0,0,46,12,34,14,32,12,9.85138076946162,10.3949774399954,0.444587448687829,31
"29","RO","Guajará-Mirim",46556,18279.32,11002,"Guajará-Mirim",1,"Norte",1,"110010",2,68,24,44,27,41,2,0,2,0,2,70,24,46,27,43,22,9.81352564519151,10.7484111680619,0.312030131255039,29
"30","RO","Guajará-Mirim",46556,18279.32,11002,"Guajará-Mirim",1,"Norte",1,"110010",3,58,30,28,27,31,0,0,0,0,0,58,30,28,27,31,20,9.81352564519151,10.7484111680619,0.387221076339958,31
"31","RO","Guajará-Mirim",46556,18279.32,11002,"Guajará-Mirim",1,"Norte",1,"110010",4,62,29,33,23,39,0,0,0,0,0,62,29,33,23,39,18,9.81352564519151,10.7484111680619,0.427506933420117,30
"32","RO","Guajará-Mirim",46556,18279.32,11002,"Guajará-Mirim",1,"Norte",1,"110010",5,56,23,33,22,34,0,0,0,0,0,56,23,33,22,34,42,9.81352564519151,10.7484111680619,0.464927492831153,31
"33","RO","Jaru",51620,28433.31,11004,"Ji-Paraná",1,"Norte",1,"110011",2,75,16,59,30,45,0,0,0,0,0,75,16,59,30,45,30,10.2553166241783,10.8516644732726,0.305756921597329,29
"34","RO","Jaru",51620,28433.31,11004,"Ji-Paraná",1,"Norte",1,"110011",3,58,11,47,25,33,0,0,0,0,0,58,11,47,25,33,24,10.2553166241783,10.8516644732726,0.377790060491767,31
"35","RO","Jaru",51620,28433.31,11004,"Ji-Paraná",1,"Norte",1,"110011",4,58,13,45,25,33,0,0,0,0,0,58,13,45,25,33,18,10.2553166241783,10.8516644732726,0.399574853383529,30
"36","RO","Jaru",51620,28433.31,11004,"Ji-Paraná",1,"Norte",1,"110011",5,57,12,45,20,37,0,0,0,0,0,57,12,45,20,37,27,10.2553166241783,10.8516644732726,0.39126017944871,31
"37","RO","Ji-Paraná",130009,26287.35,11004,"Ji-Paraná",1,"Norte",1,"110012",2,127,34,93,53,74,2,1,1,2,0,129,35,94,55,74,50,10.1768431138606,11.7753589578106,0.312829126633488,29
"38","RO","Ji-Paraná",130009,26287.35,11004,"Ji-Paraná",1,"Norte",1,"110012",3,145,36,109,60,85,1,0,1,1,0,146,36,110,61,85,52,10.1768431138606,11.7753589578106,0.399997992266472,31
"39","RO","Ji-Paraná",130009,26287.35,11004,"Ji-Paraná",1,"Norte",1,"110012",4,117,29,88,54,63,1,0,1,1,0,118,29,89,55,63,45,10.1768431138606,11.7753589578106,0.418157078541927,30
"40","RO","Ji-Paraná",130009,26287.35,11004,"Ji-Paraná",1,"Norte",1,"110012",5,132,33,99,52,80,1,0,1,1,0,133,33,100,53,80,56,10.1768431138606,11.7753589578106,0.402632367778117,31
"41","RO","Machadinho D'Oeste",40867,16423.33,11003,"Ariquemes",1,"Norte",0,"110013",2,48,19,29,20,28,0,0,0,0,0,48,19,29,20,28,11,9.70645816390661,10.6180781703897,0.314185045999266,29
"42","RO","Machadinho D'Oeste",40867,16423.33,11003,"Ariquemes",1,"Norte",0,"110013",3,39,14,25,15,24,0,0,0,0,0,39,14,25,15,24,9,9.70645816390661,10.6180781703897,0.406719669582353,31
"43","RO","Machadinho D'Oeste",40867,16423.33,11003,"Ariquemes",1,"Norte",0,"110013",4,23,14,9,12,11,0,0,0,0,0,23,14,9,12,11,7,9.70645816390661,10.6180781703897,0.425229940538788,30
"44","RO","Machadinho D'Oeste",40867,16423.33,11003,"Ariquemes",1,"Norte",0,"110013",5,41,17,24,18,23,0,0,0,0,0,41,17,24,18,23,11,9.70645816390661,10.6180781703897,0.447237276403376,31
"45","RO","Nova Brasilândia D'Oeste",20489,18086.15,11005,"Alvorada D'Oeste",1,"Norte",0,"110014",2,16,5,11,9,7,0,0,0,0,0,16,5,11,9,7,5,9.80290173097387,9.9276434357472,0.330461085872681,29
"46","RO","Nova Brasilândia D'Oeste",20489,18086.15,11005,"Alvorada D'Oeste",1,"Norte",0,"110014",3,19,2,17,7,12,0,0,0,0,0,19,2,17,7,12,4,9.80290173097387,9.9276434357472,0.378662245597666,31
"47","RO","Nova Brasilândia D'Oeste",20489,18086.15,11005,"Alvorada D'Oeste",1,"Norte",0,"110014",4,14,2,12,6,8,0,0,0,0,0,14,2,12,6,8,12,9.80290173097387,9.9276434357472,0.406849955052334,30
"48","RO","Nova Brasilândia D'Oeste",20489,18086.15,11005,"Alvorada D'Oeste",1,"Norte",0,"110014",5,22,4,18,5,17,0,0,0,0,0,22,4,18,5,17,4,9.80290173097387,9.9276434357472,0.418003227582752,31
"49","RO","Ouro Preto do Oeste",35737,22252.8,11004,"Ji-Paraná",1,"Norte",1,"110015",2,41,12,29,18,23,0,0,0,0,0,41,12,29,18,23,13,10.0102231223735,10.4839418456268,0.293831262595354,29
"50","RO","Ouro Preto do Oeste",35737,22252.8,11004,"Ji-Paraná",1,"Norte",1,"110015",3,50,13,37,22,28,0,0,0,0,0,50,13,37,22,28,23,10.0102231223735,10.4839418456268,0.37550511632357,31
"51","RO","Ouro Preto do Oeste",35737,22252.8,11004,"Ji-Paraná",1,"Norte",1,"110015",4,33,4,29,16,17,0,0,0,0,0,33,4,29,16,17,18,10.0102231223735,10.4839418456268,0.403816935599158,30
"52","RO","Ouro Preto do Oeste",35737,22252.8,11004,"Ji-Paraná",1,"Norte",1,"110015",5,32,6,26,15,17,0,0,0,0,0,32,6,26,15,17,17,10.0102231223735,10.4839418456268,0.3972330686142,31
"53","RO","Pimenta Bueno",36881,31046.76,11007,"Vilhena",1,"Norte",1,"110018",2,36,12,24,22,14,1,0,1,0,1,37,12,25,22,15,4,10.3432497340909,10.5154517922704,0.317125437960628,29
"54","RO","Pimenta Bueno",36881,31046.76,11007,"Vilhena",1,"Norte",1,"110018",3,45,10,35,16,29,0,0,0,0,0,45,10,35,16,29,15,10.3432497340909,10.5154517922704,0.401051385844442,31
"55","RO","Pimenta Bueno",36881,31046.76,11007,"Vilhena",1,"Norte",1,"110018",4,42,15,27,19,23,0,0,0,0,0,42,15,27,19,23,15,10.3432497340909,10.5154517922704,0.425586902886357,30
"56","RO","Pimenta Bueno",36881,31046.76,11007,"Vilhena",1,"Norte",1,"110018",5,48,10,38,24,24,0,0,0,0,0,48,10,38,24,24,25,10.3432497340909,10.5154517922704,0.416034324320679,31
"57","RO","Porto Velho",539354,32042.66,11001,"Porto Velho",1,"Norte",1,"110020",2,539,165,374,249,290,6,3,3,3,3,545,168,377,252,293,172,10.3748234189597,13.1981274061106,0.31231803276805,29
"58","RO","Porto Velho",539354,32042.66,11001,"Porto Velho",1,"Norte",1,"110020",3,580,153,427,246,334,3,2,1,1,2,583,155,428,247,336,222,10.3748234189597,13.1981274061106,0.417353601194784,31
"59","RO","Porto Velho",539354,32042.66,11001,"Porto Velho",1,"Norte",1,"110020",4,548,155,393,232,316,7,2,5,3,4,555,157,398,235,320,216,10.3748234189597,13.1981274061106,0.467701724580404,30
"60","RO","Porto Velho",539354,32042.66,11001,"Porto Velho",1,"Norte",1,"110020",5,516,133,383,241,275,8,2,6,3,5,524,135,389,244,280,313,10.3748234189597,13.1981274061106,0.451462989732605,31
"61","RO","Presidente Médici",18571,21515.83,11004,"Ji-Paraná",1,"Norte",0,"110025",2,13,3,10,8,5,0,0,0,0,0,13,3,10,8,5,15,9.97654422226506,9.82935650319305,0.35296208306941,29
"62","RO","Presidente Médici",18571,21515.83,11004,"Ji-Paraná",1,"Norte",0,"110025",3,25,10,15,7,18,0,0,0,0,0,25,10,15,7,18,6,9.97654422226506,9.82935650319305,0.415731713459309,31
"63","RO","Presidente Médici",18571,21515.83,11004,"Ji-Paraná",1,"Norte",0,"110025",4,17,1,16,4,13,0,0,0,0,0,17,1,16,4,13,11,9.97654422226506,9.82935650319305,0.443225933219614,30
"64","RO","Presidente Médici",18571,21515.83,11004,"Ji-Paraná",1,"Norte",0,"110025",5,23,6,17,11,12,0,0,0,0,0,23,6,17,11,12,15,9.97654422226506,9.82935650319305,0.440606327009992,31
"65","RO","Rolim de Moura",55407,24077.57,11006,"Cacoal",1,"Norte",1,"110028",2,53,14,39,26,27,0,0,0,0,0,53,14,39,26,27,26,10.0890359807094,10.922461218544,0.320299707487464,29
"66","RO","Rolim de Moura",55407,24077.57,11006,"Cacoal",1,"Norte",1,"110028",3,56,8,48,27,29,0,0,0,0,0,56,8,48,27,29,32,10.0890359807094,10.922461218544,0.414119132372106,31
"67","RO","Rolim de Moura",55407,24077.57,11006,"Cacoal",1,"Norte",1,"110028",4,77,12,65,25,52,0,0,0,0,0,77,12,65,25,52,22,10.0890359807094,10.922461218544,0.440277120031501,30
"68","RO","Rolim de Moura",55407,24077.57,11006,"Cacoal",1,"Norte",1,"110028",5,55,17,38,27,28,1,0,1,0,1,56,17,39,27,29,22,10.0890359807094,10.922461218544,0.415045634908602,31
"69","RO","Vilhena",102211,28420.11,11007,"Vilhena",1,"Norte",1,"110030",2,108,23,85,35,73,3,1,2,2,1,111,24,87,37,74,36,10.2548522721573,11.5347945830538,0.323250221458671,29
"70","RO","Vilhena",102211,28420.11,11007,"Vilhena",1,"Norte",1,"110030",3,129,30,99,54,75,1,0,1,1,0,130,30,100,55,75,43,10.2548522721573,11.5347945830538,0.398693991044705,31
"71","RO","Vilhena",102211,28420.11,11007,"Vilhena",1,"Norte",1,"110030",4,121,26,95,46,75,0,0,0,0,0,121,26,95,46,75,42,10.2548522721573,11.5347945830538,0.431790542446465,30
"72","RO","Vilhena",102211,28420.11,11007,"Vilhena",1,"Norte",1,"110030",5,157,35,122,70,87,1,0,1,1,0,158,35,123,71,87,50,10.2548522721573,11.5347945830538,0.407512819185178,31
"73","RO","São Miguel do Guaporé",23077,31025.71,11005,"Alvorada D'Oeste",1,"Norte",0,"110032",2,32,5,27,11,21,0,0,0,0,0,32,5,27,11,21,16,10.3425714945813,10.0465917295046,0.347441096534059,29
"74","RO","São Miguel do Guaporé",23077,31025.71,11005,"Alvorada D'Oeste",1,"Norte",0,"110032",3,37,12,25,9,28,0,0,0,0,0,37,12,25,9,28,8,10.3425714945813,10.0465917295046,0.400881543888032,31
"75","RO","São Miguel do Guaporé",23077,31025.71,11005,"Alvorada D'Oeste",1,"Norte",0,"110032",4,29,8,21,12,17,0,0,0,0,0,29,8,21,12,17,9,10.3425714945813,10.0465917295046,0.411411697831091,30
"76","RO","São Miguel do Guaporé",23077,31025.71,11005,"Alvorada D'Oeste",1,"Norte",0,"110032",5,31,7,24,18,13,0,0,0,0,0,31,7,24,18,13,11,10.3425714945813,10.0465917295046,0.477486334114911,31
"77","RO","Nova Mamoré",31392,17095.19,11001,"Porto Velho",1,"Norte",0,"110033",2,24,9,15,10,14,1,1,0,1,0,25,10,15,11,14,6,9.74655241637256,10.3543083623651,0.345543756647012,29
"78","RO","Nova Mamoré",31392,17095.19,11001,"Porto Velho",1,"Norte",0,"110033",3,31,10,21,17,14,0,0,0,0,0,31,10,21,17,14,12,9.74655241637256,10.3543083623651,0.408226568203771,31
"79","RO","Nova Mamoré",31392,17095.19,11001,"Porto Velho",1,"Norte",0,"110033",4,26,5,21,11,15,0,0,0,0,0,26,5,21,11,15,8,9.74655241637256,10.3543083623651,0.441940600020456,30
"80","RO","Nova Mamoré",31392,17095.19,11001,"Porto Velho",1,"Norte",0,"110033",5,26,10,16,17,9,1,1,0,1,0,27,11,16,18,9,12,9.74655241637256,10.3543083623651,0.46951938296521,31
"81","RO","Alvorada D'Oeste",14106,17423.49,11005,"Alvorada D'Oeste",1,"Norte",0,"110034",2,22,7,15,8,14,0,0,0,0,0,22,7,15,8,14,8,9.76557457477192,9.55435551776812,0.326287052189632,29
"82","RO","Alvorada D'Oeste",14106,17423.49,11005,"Alvorada D'Oeste",1,"Norte",0,"110034",3,12,3,9,6,6,0,0,0,0,0,12,3,9,6,6,10,9.76557457477192,9.55435551776812,0.406361213778052,31
"83","RO","Alvorada D'Oeste",14106,17423.49,11005,"Alvorada D'Oeste",1,"Norte",0,"110034",4,4,0,4,0,4,0,0,0,0,0,4,0,4,0,4,7,9.76557457477192,9.55435551776812,0.457502979025962,30
"84","RO","Alvorada D'Oeste",14106,17423.49,11005,"Alvorada D'Oeste",1,"Norte",0,"110034",5,17,3,14,6,11,0,0,0,0,0,17,3,14,6,11,7,9.76557457477192,9.55435551776812,0.471443359183091,31
"85","RO","Alto Paraíso",21847,15655.57,11003,"Ariquemes",1,"Norte",0,"110040",2,15,4,11,12,3,0,0,0,0,0,15,4,11,12,3,8,9.6585820431903,9.99181889132609,0.320094137230605,29
"86","RO","Alto Paraíso",21847,15655.57,11003,"Ariquemes",1,"Norte",0,"110040",3,24,9,15,10,14,0,0,0,0,0,24,9,15,10,14,7,9.6585820431903,9.99181889132609,0.414974491829417,31
"87","RO","Alto Paraíso",21847,15655.57,11003,"Ariquemes",1,"Norte",0,"110040",4,16,8,8,7,9,0,0,0,0,0,16,8,8,7,9,6,9.6585820431903,9.99181889132609,0.435590781542704,30
"88","RO","Alto Paraíso",21847,15655.57,11003,"Ariquemes",1,"Norte",0,"110040",5,12,4,8,5,7,0,0,0,0,0,12,4,8,5,7,6,9.6585820431903,9.99181889132609,0.418481501836099,31
"89","RO","Buritis",40356,17489.18,11001,"Porto Velho",1,"Norte",0,"110045",2,31,12,19,18,13,0,0,0,0,0,31,12,19,18,13,8,9.76933768297989,10.6054953615283,0.311273118641721,29
"90","RO","Buritis",40356,17489.18,11001,"Porto Velho",1,"Norte",0,"110045",3,44,9,35,23,21,0,0,0,0,0,44,9,35,23,21,13,9.76933768297989,10.6054953615283,0.379569097079542,31
"91","RO","Buritis",40356,17489.18,11001,"Porto Velho",1,"Norte",0,"110045",4,44,17,27,24,20,0,0,0,0,0,44,17,27,24,20,12,9.76933768297989,10.6054953615283,0.389972623814078,30
"92","RO","Buritis",40356,17489.18,11001,"Porto Velho",1,"Norte",0,"110045",5,46,15,31,24,22,0,0,0,0,0,46,15,31,24,22,12,9.76933768297989,10.6054953615283,0.379346425654326,31
"93","RO","Candeias do Jamari",27388,21856.51,11001,"Porto Velho",1,"Norte",1,"110080",2,20,10,10,11,9,2,1,1,0,2,22,11,11,11,11,11,9.99225409665171,10.217860240241,0.354851578403345,29
"94","RO","Candeias do Jamari",27388,21856.51,11001,"Porto Velho",1,"Norte",1,"110080",3,22,11,11,12,10,0,0,0,0,0,22,11,11,12,10,7,9.99225409665171,10.217860240241,0.432909610606436,31
"95","RO","Candeias do Jamari",27388,21856.51,11001,"Porto Velho",1,"Norte",1,"110080",4,22,9,13,13,9,0,0,0,0,0,22,9,13,13,9,7,9.99225409665171,10.217860240241,0.458569467980301,30
"96","RO","Candeias do Jamari",27388,21856.51,11001,"Porto Velho",1,"Norte",1,"110080",5,32,12,20,17,15,0,0,0,0,0,32,12,20,17,15,21,9.99225409665171,10.217860240241,0.463759324576636,31
"97","RO","Chupinguaia",11472,27680.65,11007,"Vilhena",1,"Norte",0,"110092",2,12,2,10,5,7,1,1,0,0,1,13,3,10,5,8,1,10.2284888921149,9.3476645628394,0.372746786441529,29
"98","RO","Chupinguaia",11472,27680.65,11007,"Vilhena",1,"Norte",0,"110092",3,10,4,6,5,5,0,0,0,0,0,10,4,6,5,5,2,10.2284888921149,9.3476645628394,0.399932788118029,31
"99","RO","Chupinguaia",11472,27680.65,11007,"Vilhena",1,"Norte",0,"110092",4,9,2,7,4,5,0,0,0,0,0,9,2,7,4,5,3,10.2284888921149,9.3476645628394,0.415973086306039,30
"100","RO","Chupinguaia",11472,27680.65,11007,"Vilhena",1,"Norte",0,"110092",5,22,5,17,13,9,0,0,0,0,0,22,5,17,13,9,3,10.2284888921149,9.3476645628394,0.410683173184278,31
"101","RO","Cujubim",26183,14739.4,11001,"Porto Velho",1,"Norte",0,"110094",2,22,8,14,14,8,0,0,0,0,0,22,8,14,14,8,7,9.59827945935174,10.1728656241899,0.352335991640297,29
"102","RO","Cujubim",26183,14739.4,11001,"Porto Velho",1,"Norte",0,"110094",3,19,7,12,8,11,0,0,0,0,0,19,7,12,8,11,9,9.59827945935174,10.1728656241899,0.404520499516046,31
"103","RO","Cujubim",26183,14739.4,11001,"Porto Velho",1,"Norte",0,"110094",4,12,5,7,3,9,0,0,0,0,0,12,5,7,3,9,9,9.59827945935174,10.1728656241899,0.42123014278659,30
"104","RO","Cujubim",26183,14739.4,11001,"Porto Velho",1,"Norte",0,"110094",5,16,6,10,11,5,0,0,0,0,0,16,6,10,11,5,3,9.59827945935174,10.1728656241899,0.437334335614922,31
"105","RO","Itapuã do Oeste",10641,17551.21,11001,"Porto Velho",1,"Norte",0,"110110",2,9,4,5,3,6,0,0,0,0,0,9,4,5,3,6,6,9.7728781723863,9.27246974344173,0.328215453610724,29
"106","RO","Itapuã do Oeste",10641,17551.21,11001,"Porto Velho",1,"Norte",0,"110110",3,13,8,5,6,7,0,0,0,0,0,13,8,5,6,7,2,9.7728781723863,9.27246974344173,0.407960979873332,31
"107","RO","Itapuã do Oeste",10641,17551.21,11001,"Porto Velho",1,"Norte",0,"110110",4,5,1,4,1,4,0,0,0,0,0,5,1,4,1,4,3,9.7728781723863,9.27246974344173,0.400812042245946,30
"108","RO","Itapuã do Oeste",10641,17551.21,11001,"Porto Velho",1,"Norte",0,"110110",5,10,3,7,3,7,0,0,0,0,0,10,3,7,3,7,1,9.7728781723863,9.27246974344173,0.431393378010565,31
"109","RO","Mirante da Serra",10818,19672.11,11004,"Ji-Paraná",1,"Norte",0,"110130",2,12,2,10,3,9,0,0,0,0,0,12,2,10,3,9,5,9.88695717558434,9.28896669243137,0.343033397660931,29
"110","RO","Mirante da Serra",10818,19672.11,11004,"Ji-Paraná",1,"Norte",0,"110130",3,13,7,6,6,7,0,0,0,0,0,13,7,6,6,7,2,9.88695717558434,9.28896669243137,0.420013945631224,31
"111","RO","Mirante da Serra",10818,19672.11,11004,"Ji-Paraná",1,"Norte",0,"110130",4,11,3,8,6,5,0,0,0,0,0,11,3,8,6,5,9,9.88695717558434,9.28896669243137,0.4148600010257,30
"112","RO","Mirante da Serra",10818,19672.11,11004,"Ji-Paraná",1,"Norte",0,"110130",5,8,3,5,2,6,0,0,0,0,0,8,3,5,2,6,4,9.88695717558434,9.28896669243137,0.45307681089269,31
"113","RO","São Francisco do Guaporé",20681,17778.54,11002,"Guajará-Mirim",1,"Norte",0,"110149",2,17,6,11,11,6,0,0,0,0,0,17,6,11,11,6,6,9.78574739096064,9.93697068335268,0.310342474568364,29
"114","RO","São Francisco do Guaporé",20681,17778.54,11002,"Guajará-Mirim",1,"Norte",0,"110149",3,11,3,8,6,5,0,0,0,0,0,11,3,8,6,5,3,9.78574739096064,9.93697068335268,0.369802418250709,31
"115","RO","São Francisco do Guaporé",20681,17778.54,11002,"Guajará-Mirim",1,"Norte",0,"110149",4,20,5,15,13,7,1,1,0,1,0,21,6,15,14,7,7,9.78574739096064,9.93697068335268,0.411531319181909,30
"116","RO","São Francisco do Guaporé",20681,17778.54,11002,"Guajará-Mirim",1,"Norte",0,"110149",5,26,4,22,9,17,0,0,0,0,0,26,4,22,9,17,10,9.78574739096064,9.93697068335268,0.438478543521889,31
"117","AC","Acrelândia",15490,15737.64,12004,"Rio Branco",1,"Norte",0,"120001",2,18,10,8,9,9,0,0,0,0,0,18,10,8,9,9,8,9.6638105742622,9.64794993341091,0.328380379202718,29
"118","AC","Acrelândia",15490,15737.64,12004,"Rio Branco",1,"Norte",0,"120001",3,21,8,13,15,6,0,0,0,0,0,21,8,13,15,6,3,9.6638105742622,9.64794993341091,0.425500474472966,31
"119","AC","Acrelândia",15490,15737.64,12004,"Rio Branco",1,"Norte",0,"120001",4,19,8,11,8,11,0,0,0,0,0,19,8,11,8,11,1,9.6638105742622,9.64794993341091,0.440096885288628,30
"120","AC","Acrelândia",15490,15737.64,12004,"Rio Branco",1,"Norte",0,"120001",5,18,5,13,6,12,0,0,0,0,0,18,5,13,6,12,6,9.6638105742622,9.64794993341091,0.433600432057412,31
"121","AC","Brasiléia",26702,16165.25,12005,"Brasiléia",1,"Norte",0,"120010",2,27,11,16,16,11,0,0,0,0,0,27,11,16,16,11,6,9.69061915555185,10.19249374795,0.312974746519202,29
"122","AC","Brasiléia",26702,16165.25,12005,"Brasiléia",1,"Norte",0,"120010",3,26,10,16,13,13,0,0,0,0,0,26,10,16,13,13,4,9.69061915555185,10.19249374795,0.384529225273248,31
"123","AC","Brasiléia",26702,16165.25,12005,"Brasiléia",1,"Norte",0,"120010",4,41,13,28,20,21,0,0,0,0,0,41,13,28,20,21,14,9.69061915555185,10.19249374795,0.420885389408681,30
"124","AC","Brasiléia",26702,16165.25,12005,"Brasiléia",1,"Norte",0,"120010",5,36,18,18,16,20,1,0,1,0,1,37,18,19,16,21,16,9.69061915555185,10.19249374795,0.434863492066098,31
"125","AC","Bujari",10420,15606.47,12004,"Rio Branco",1,"Norte",0,"120013",2,17,11,6,10,7,0,0,0,0,0,17,11,6,10,7,5,9.65544085084502,9.25148231530736,0.309387028400998,29
"126","AC","Bujari",10420,15606.47,12004,"Rio Branco",1,"Norte",0,"120013",3,24,13,11,13,11,0,0,0,0,0,24,13,11,13,11,5,9.65544085084502,9.25148231530736,0.389171034761988,31
"127","AC","Bujari",10420,15606.47,12004,"Rio Branco",1,"Norte",0,"120013",4,23,10,13,13,10,0,0,0,0,0,23,10,13,13,10,10,9.65544085084502,9.25148231530736,0.449492790305523,30
"128","AC","Bujari",10420,15606.47,12004,"Rio Branco",1,"Norte",0,"120013",5,15,6,9,8,7,0,0,0,0,0,15,6,9,8,7,5,9.65544085084502,9.25148231530736,0.476780825751431,31
"129","AC","Capixaba",12008,14874.52,12004,"Rio Branco",1,"Norte",0,"120017",2,14,6,8,9,5,0,0,0,0,0,14,6,8,9,5,2,9.60740496098562,9.3933283733133,0.298253228011711,29
"130","AC","Capixaba",12008,14874.52,12004,"Rio Branco",1,"Norte",0,"120017",3,19,8,11,8,11,0,0,0,0,0,19,8,11,8,11,6,9.60740496098562,9.3933283733133,0.408659309473277,31
"131","AC","Capixaba",12008,14874.52,12004,"Rio Branco",1,"Norte",0,"120017",4,17,10,7,14,3,0,0,0,0,0,17,10,7,14,3,5,9.60740496098562,9.3933283733133,0.424493702056289,30
"132","AC","Capixaba",12008,14874.52,12004,"Rio Branco",1,"Norte",0,"120017",5,17,9,8,9,8,0,0,0,0,0,17,9,8,9,8,6,9.60740496098562,9.3933283733133,0.455732231596428,31
"133","AC","Cruzeiro do Sul",89072,16261.39,12001,"Cruzeiro do Sul",1,"Norte",1,"120020",2,130,42,88,66,64,3,3,0,1,2,133,45,88,67,66,36,9.69654886530295,11.3972003104233,0.322340334628148,29
"134","AC","Cruzeiro do Sul",89072,16261.39,12001,"Cruzeiro do Sul",1,"Norte",1,"120020",3,124,46,78,58,66,0,0,0,0,0,124,46,78,58,66,27,9.69654886530295,11.3972003104233,0.401346856482689,31
"135","AC","Cruzeiro do Sul",89072,16261.39,12001,"Cruzeiro do Sul",1,"Norte",1,"120020",4,59,17,42,27,32,2,1,1,2,0,61,18,43,29,32,36,9.69654886530295,11.3972003104233,0.478311730018264,30
"136","AC","Cruzeiro do Sul",89072,16261.39,12001,"Cruzeiro do Sul",1,"Norte",1,"120020",5,85,33,52,47,38,0,0,0,0,0,85,33,52,47,38,39,9.69654886530295,11.3972003104233,0.519555958265841,31
"137","AC","Epitaciolândia",18696,25349.75,12005,"Brasiléia",1,"Norte",0,"120025",2,28,10,18,15,13,0,0,0,0,0,28,10,18,15,13,3,10.1405241470378,9.83606487621869,0.319568045030431,29
"138","AC","Epitaciolândia",18696,25349.75,12005,"Brasiléia",1,"Norte",0,"120025",3,17,7,10,8,9,1,0,1,1,0,18,7,11,9,9,10,10.1405241470378,9.83606487621869,0.446105976786695,31
"139","AC","Epitaciolândia",18696,25349.75,12005,"Brasiléia",1,"Norte",0,"120025",4,17,7,10,7,10,0,0,0,0,0,17,7,10,7,10,8,10.1405241470378,9.83606487621869,0.458774852790977,30
"140","AC","Epitaciolândia",18696,25349.75,12005,"Brasiléia",1,"Norte",0,"120025",5,17,11,6,8,9,0,0,0,0,0,17,11,6,8,9,10,10.1405241470378,9.83606487621869,0.46329916059353,31
"141","AC","Feijó",34884,10500.72,12002,"Tarauacá",1,"Norte",0,"120030",2,44,21,23,22,22,1,1,0,1,0,45,22,23,23,22,9,9.25919910522327,10.4597835503469,0.335539737431991,29
"142","AC","Feijó",34884,10500.72,12002,"Tarauacá",1,"Norte",0,"120030",3,51,25,26,31,20,1,0,1,1,0,52,25,27,32,20,17,9.25919910522327,10.4597835503469,0.404405425329154,31
"143","AC","Feijó",34884,10500.72,12002,"Tarauacá",1,"Norte",0,"120030",4,54,24,30,30,24,0,0,0,0,0,54,24,30,30,24,5,9.25919910522327,10.4597835503469,0.432637855120585,30
"144","AC","Feijó",34884,10500.72,12002,"Tarauacá",1,"Norte",0,"120030",5,64,40,24,33,31,0,0,0,0,0,64,40,24,33,31,15,9.25919910522327,10.4597835503469,0.442662579132782,31
"145","AC","Plácido de Castro",19955,12926.47,12004,"Rio Branco",1,"Norte",0,"120038",2,22,15,7,12,10,0,0,0,0,0,22,15,7,12,10,10,9.46703242598495,9.90123501748283,0.316552868673336,29
"146","AC","Plácido de Castro",19955,12926.47,12004,"Rio Branco",1,"Norte",0,"120038",3,24,10,14,14,10,0,0,0,0,0,24,10,14,14,10,6,9.46703242598495,9.90123501748283,0.391762127132903,31
"147","AC","Plácido de Castro",19955,12926.47,12004,"Rio Branco",1,"Norte",0,"120038",4,19,10,9,9,10,0,0,0,0,0,19,10,9,9,10,8,9.46703242598495,9.90123501748283,0.450309865338551,30
"148","AC","Plácido de Castro",19955,12926.47,12004,"Rio Branco",1,"Norte",0,"120038",5,22,12,10,9,13,0,0,0,0,0,22,12,10,9,13,6,9.46703242598495,9.90123501748283,0.473276996077043,31
"149","AC","Rio Branco",413418,22287.7,12004,"Rio Branco",1,"Norte",1,"120040",2,394,118,276,168,226,4,1,3,2,2,398,119,279,170,228,175,10.0117902357711,12.9322144666462,0.333779128808831,29
"150","AC","Rio Branco",413418,22287.7,12004,"Rio Branco",1,"Norte",1,"120040",3,458,112,346,177,281,6,2,4,3,3,464,114,350,180,284,189,10.0117902357711,12.9322144666462,0.437916550192601,31
"151","AC","Rio Branco",413418,22287.7,12004,"Rio Branco",1,"Norte",1,"120040",4,407,124,283,171,236,6,2,4,1,5,413,126,287,172,241,178,10.0117902357711,12.9322144666462,0.492587414095601,30
"152","AC","Rio Branco",413418,22287.7,12004,"Rio Branco",1,"Norte",1,"120040",5,394,107,287,172,222,3,1,2,1,2,397,108,289,173,224,352,10.0117902357711,12.9322144666462,0.494399780774378,31
"153","AC","Senador Guiomard",23236,16360.61,12004,"Rio Branco",1,"Norte",0,"120045",2,36,16,20,21,15,0,0,0,0,0,36,16,20,21,15,4,9.7026318955252,10.0534580791124,0.34466456392792,29
"154","AC","Senador Guiomard",23236,16360.61,12004,"Rio Branco",1,"Norte",0,"120045",3,32,11,21,18,14,0,0,0,0,0,32,11,21,18,14,8,9.7026318955252,10.0534580791124,0.435728294877038,31
"155","AC","Senador Guiomard",23236,16360.61,12004,"Rio Branco",1,"Norte",0,"120045",4,29,12,17,18,11,2,1,1,1,1,31,13,18,19,12,9,9.7026318955252,10.0534580791124,0.479047853185034,30
"156","AC","Senador Guiomard",23236,16360.61,12004,"Rio Branco",1,"Norte",0,"120045",5,38,12,26,15,23,0,0,0,0,0,38,12,26,15,23,10,9.7026318955252,10.0534580791124,0.486610509283062,31
"157","AC","Sena Madureira",46511,11475.22,12003,"Sena Madureira",1,"Norte",0,"120050",2,32,14,18,25,7,0,0,0,0,0,32,14,18,25,7,17,9.34794520685825,10.7474441227395,0.319604307306778,29
"158","AC","Sena Madureira",46511,11475.22,12003,"Sena Madureira",1,"Norte",0,"120050",3,32,18,14,15,17,0,0,0,0,0,32,18,14,15,17,16,9.34794520685825,10.7474441227395,0.404438493304436,31
"159","AC","Sena Madureira",46511,11475.22,12003,"Sena Madureira",1,"Norte",0,"120050",4,51,21,30,33,18,0,0,0,0,0,51,21,30,33,18,25,9.34794520685825,10.7474441227395,0.442155085981083,30
"160","AC","Sena Madureira",46511,11475.22,12003,"Sena Madureira",1,"Norte",0,"120050",5,23,12,11,9,14,0,0,0,0,0,23,12,11,9,14,19,9.34794520685825,10.7474441227395,0.448366305918097,31
"161","AC","Tarauacá",43151,11645.35,12002,"Tarauacá",1,"Norte",0,"120060",2,87,52,35,53,34,2,1,1,1,1,89,53,36,54,35,13,9.36266223768472,10.6724608712141,0.28493216399017,29
"162","AC","Tarauacá",43151,11645.35,12002,"Tarauacá",1,"Norte",0,"120060",3,70,45,25,46,24,3,1,2,0,3,73,46,27,46,27,29,9.36266223768472,10.6724608712141,0.365612132358222,31
"163","AC","Tarauacá",43151,11645.35,12002,"Tarauacá",1,"Norte",0,"120060",4,72,43,29,47,25,0,0,0,0,0,72,43,29,47,25,13,9.36266223768472,10.6724608712141,0.425617532668442,30
"164","AC","Tarauacá",43151,11645.35,12002,"Tarauacá",1,"Norte",0,"120060",5,79,46,33,53,26,3,3,0,2,1,82,49,33,55,27,7,9.36266223768472,10.6724608712141,0.456543238150129,31
"165","AC","Xapuri",19596,12553.21,12005,"Brasiléia",1,"Norte",0,"120070",2,19,10,9,12,7,0,0,0,0,0,19,10,9,12,7,5,9.43773168874703,9.88308074275847,0.277344778476483,29
"166","AC","Xapuri",19596,12553.21,12005,"Brasiléia",1,"Norte",0,"120070",3,24,10,14,11,13,0,0,0,0,0,24,10,14,11,13,7,9.43773168874703,9.88308074275847,0.407957256208128,31
"167","AC","Xapuri",19596,12553.21,12005,"Brasiléia",1,"Norte",0,"120070",4,25,11,14,15,10,0,0,0,0,0,25,11,14,15,10,3,9.43773168874703,9.88308074275847,0.468961209204499,30
"168","AC","Xapuri",19596,12553.21,12005,"Brasiléia",1,"Norte",0,"120070",5,30,11,19,14,16,0,0,0,0,0,30,11,19,14,16,10,9.43773168874703,9.88308074275847,0.469400025933348,31
"169","AC","Porto Acre",18824,12855.64,12004,"Rio Branco",1,"Norte",0,"120080",2,37,17,20,18,19,1,0,1,0,1,38,17,21,18,20,12,9.46153790453616,9.8428879304072,0.350547671515036,29
"170","AC","Porto Acre",18824,12855.64,12004,"Rio Branco",1,"Norte",0,"120080",3,29,12,17,13,16,0,0,0,0,0,29,12,17,13,16,10,9.46153790453616,9.8428879304072,0.435101089812198,31
"171","AC","Porto Acre",18824,12855.64,12004,"Rio Branco",1,"Norte",0,"120080",4,27,11,16,21,6,0,0,0,0,0,27,11,16,21,6,8,9.46153790453616,9.8428879304072,0.488111978503506,30
"172","AC","Porto Acre",18824,12855.64,12004,"Rio Branco",1,"Norte",0,"120080",5,29,12,17,21,8,1,0,1,1,0,30,12,18,22,8,15,9.46153790453616,9.8428879304072,0.483829148436519,31
"173","AM","Anori",21477,10626.79,13006,"Coari",1,"Norte",0,"130010",2,22,10,12,15,7,0,0,0,0,0,22,10,12,15,7,4,9.27113345019128,9.97473787406429,0.306183960348118,29
"174","AM","Anori",21477,10626.79,13006,"Coari",1,"Norte",0,"130010",3,14,5,9,12,2,0,0,0,0,0,14,5,9,12,2,4,9.27113345019128,9.97473787406429,0.399510757709311,31
"175","AM","Anori",21477,10626.79,13006,"Coari",1,"Norte",0,"130010",4,9,3,6,5,4,0,0,0,0,0,9,3,6,5,4,2,9.27113345019128,9.97473787406429,0.466901439869663,30
"176","AM","Anori",21477,10626.79,13006,"Coari",1,"Norte",0,"130010",5,19,7,12,12,7,0,0,0,0,0,19,7,12,12,7,12,9.27113345019128,9.97473787406429,0.413211019296618,31
"177","AM","Autazes",40290,9196.44,13007,"Manaus",1,"Norte",0,"130030",2,76,27,49,44,32,0,0,0,0,0,76,27,49,44,32,11,9.1265717316284,10.6038585781854,0.310748432218744,29
"178","AM","Autazes",40290,9196.44,13007,"Manaus",1,"Norte",0,"130030",3,84,33,51,54,30,0,0,0,0,0,84,33,51,54,30,18,9.1265717316284,10.6038585781854,0.396485337421486,31
"179","AM","Autazes",40290,9196.44,13007,"Manaus",1,"Norte",0,"130030",4,62,25,37,39,23,2,0,2,1,1,64,25,39,40,24,23,9.1265717316284,10.6038585781854,0.463745631660714,30
"180","AM","Autazes",40290,9196.44,13007,"Manaus",1,"Norte",0,"130030",5,73,23,50,45,28,1,1,0,0,1,74,24,50,45,29,28,9.1265717316284,10.6038585781854,0.479499717477216,31
"181","AM","Barcelos",27638,6145.96,13001,"Rio Negro",1,"Norte",0,"130040",2,29,17,12,16,13,0,0,0,0,0,29,17,12,16,13,7,8.72355023437117,10.2269469163634,0.339450086479915,29
"182","AM","Barcelos",27638,6145.96,13001,"Rio Negro",1,"Norte",0,"130040",3,34,16,18,18,16,0,0,0,0,0,34,16,18,18,16,5,8.72355023437117,10.2269469163634,0.400977172617127,31
"183","AM","Barcelos",27638,6145.96,13001,"Rio Negro",1,"Norte",0,"130040",4,32,12,20,20,12,0,0,0,0,0,32,12,20,20,12,6,8.72355023437117,10.2269469163634,0.476725012580951,30
"184","AM","Barcelos",27638,6145.96,13001,"Rio Negro",1,"Norte",0,"130040",5,26,12,14,19,7,0,0,0,0,0,26,12,14,19,7,22,8.72355023437117,10.2269469163634,0.580889824265037,31
"185","AM","Beruri",20093,7868.69,13006,"Coari",1,"Norte",0,"130063",2,41,30,11,25,16,0,0,0,0,0,41,30,11,25,16,3,8.9706468726643,9.90812677468455,0.291575702486391,29
"186","AM","Beruri",20093,7868.69,13006,"Coari",1,"Norte",0,"130063",3,31,15,16,14,17,2,1,1,2,0,33,16,17,16,17,4,8.9706468726643,9.90812677468455,0.360296929884661,31
"187","AM","Beruri",20093,7868.69,13006,"Coari",1,"Norte",0,"130063",4,41,21,20,24,17,2,2,0,2,0,43,23,20,26,17,7,8.9706468726643,9.90812677468455,0.421584118833657,30
"188","AM","Beruri",20093,7868.69,13006,"Coari",1,"Norte",0,"130063",5,35,26,9,24,11,1,1,0,1,0,36,27,9,25,11,13,8.9706468726643,9.90812677468455,0.499865284233169,31
"189","AM","Boca do Acre",34635,12248.29,13011,"Boca do Acre",1,"Norte",0,"130070",2,51,33,18,38,13,1,1,0,0,1,52,34,18,38,14,14,9.41314161439229,10.4526200104567,0.353322581875452,29
"190","AM","Boca do Acre",34635,12248.29,13011,"Boca do Acre",1,"Norte",0,"130070",3,51,27,24,26,25,2,1,1,1,1,53,28,25,27,26,22,9.41314161439229,10.4526200104567,0.429913642072024,31
"191","AM","Boca do Acre",34635,12248.29,13011,"Boca do Acre",1,"Norte",0,"130070",4,46,20,26,33,13,1,1,0,1,0,47,21,26,34,13,13,9.41314161439229,10.4526200104567,0.488139702907873,30
"192","AM","Boca do Acre",34635,12248.29,13011,"Boca do Acre",1,"Norte",0,"130070",5,64,31,33,34,30,1,1,0,1,0,65,32,33,35,30,21,9.41314161439229,10.4526200104567,0.506974905257307,31
"193","AM","Borba",41748,7487.09,13013,"Madeira",1,"Norte",0,"130080",2,56,28,28,41,15,0,0,0,0,0,56,28,28,41,15,10,8.92093548299455,10.6394068249399,0.322123736338795,29
"194","AM","Borba",41748,7487.09,13013,"Madeira",1,"Norte",0,"130080",3,57,34,23,34,23,1,1,0,0,1,58,35,23,34,24,8,8.92093548299455,10.6394068249399,0.417835300759318,31
"195","AM","Borba",41748,7487.09,13013,"Madeira",1,"Norte",0,"130080",4,58,25,33,37,21,0,0,0,0,0,58,25,33,37,21,7,8.92093548299455,10.6394068249399,0.50701654009241,30
"196","AM","Borba",41748,7487.09,13013,"Madeira",1,"Norte",0,"130080",5,61,33,28,36,25,1,0,1,1,0,62,33,29,37,25,31,8.92093548299455,10.6394068249399,0.533318692956931,31
"197","AM","Careiro",38348,8414.97,13007,"Manaus",1,"Norte",0,"130110",2,55,25,30,22,33,0,0,0,0,0,55,25,30,22,33,10,9.03776754155616,10.5544576541969,0.333741314999185,29
"198","AM","Careiro",38348,8414.97,13007,"Manaus",1,"Norte",0,"130110",3,30,12,18,11,19,1,1,0,0,1,31,13,18,11,20,14,9.03776754155616,10.5544576541969,0.39723274759393,31
"199","AM","Careiro",38348,8414.97,13007,"Manaus",1,"Norte",0,"130110",4,41,13,28,25,16,0,0,0,0,0,41,13,28,25,16,21,9.03776754155616,10.5544576541969,0.462357053948193,30
"200","AM","Careiro",38348,8414.97,13007,"Manaus",1,"Norte",0,"130110",5,37,15,22,26,11,0,0,0,0,0,37,15,22,26,11,19,9.03776754155616,10.5544576541969,0.494038168065194,31
"201","AM","Careiro da Várzea",30846,11396.04,13007,"Manaus",1,"Norte",0,"130115",2,15,6,9,4,11,0,0,0,0,0,15,6,9,4,11,10,9.34102120561515,10.3367623612836,0.32497978497407,29
"202","AM","Careiro da Várzea",30846,11396.04,13007,"Manaus",1,"Norte",0,"130115",3,14,3,11,5,9,0,0,0,0,0,14,3,11,5,9,4,9.34102120561515,10.3367623612836,0.422137009722875,31
"203","AM","Careiro da Várzea",30846,11396.04,13007,"Manaus",1,"Norte",0,"130115",4,14,5,9,7,7,1,1,0,1,0,15,6,9,8,7,11,9.34102120561515,10.3367623612836,0.526662998022826,30
"204","AM","Careiro da Várzea",30846,11396.04,13007,"Manaus",1,"Norte",0,"130115",5,23,8,15,12,11,0,0,0,0,0,23,8,15,12,11,3,9.34102120561515,10.3367623612836,0.566417096949328,31
"205","AM","Coari",85910,23921.53,13006,"Coari",1,"Norte",1,"130120",2,113,48,65,61,52,0,0,0,0,0,113,48,65,61,52,28,10.0825341692297,11.3610555156321,0.348330254649053,29
"206","AM","Coari",85910,23921.53,13006,"Coari",1,"Norte",1,"130120",3,144,66,78,78,66,2,1,1,1,1,146,67,79,79,67,24,10.0825341692297,11.3610555156321,0.409160896072735,31
"207","AM","Coari",85910,23921.53,13006,"Coari",1,"Norte",1,"130120",4,110,58,52,68,42,1,0,1,1,0,111,58,53,69,42,41,10.0825341692297,11.3610555156321,0.482579909661506,30
"208","AM","Coari",85910,23921.53,13006,"Coari",1,"Norte",1,"130120",5,140,62,78,89,51,1,0,1,0,1,141,62,79,89,52,103,10.0825341692297,11.3610555156321,0.505492591034575,31
"209","AM","Humaitá",56144,11521.07,13013,"Madeira",1,"Norte",1,"130170",2,63,27,36,31,32,1,0,1,1,0,64,27,37,32,32,18,9.35193281188107,10.935675097823,0.303116354938608,29
"210","AM","Humaitá",56144,11521.07,13013,"Madeira",1,"Norte",1,"130170",3,77,25,52,42,35,1,0,1,0,1,78,25,53,42,36,22,9.35193281188107,10.935675097823,0.361985234272097,31
"211","AM","Humaitá",56144,11521.07,13013,"Madeira",1,"Norte",1,"130170",4,71,33,38,44,27,2,1,1,1,1,73,34,39,45,28,11,9.35193281188107,10.935675097823,0.42890399062401,30
"212","AM","Humaitá",56144,11521.07,13013,"Madeira",1,"Norte",1,"130170",5,96,40,56,52,44,3,2,1,2,1,99,42,57,54,45,17,9.35193281188107,10.935675097823,0.420314949303331,31
"213","AM","Iranduba",49011,14276.35,13007,"Manaus",1,"Norte",0,"130185",2,75,30,45,44,31,1,0,1,0,1,76,30,46,44,32,19,9.56635960098086,10.7998000416946,0.3200874116886,29
"214","AM","Iranduba",49011,14276.35,13007,"Manaus",1,"Norte",0,"130185",3,65,23,42,36,29,1,1,0,1,0,66,24,42,37,29,10,9.56635960098086,10.7998000416946,0.405179454342616,31
"215","AM","Iranduba",49011,14276.35,13007,"Manaus",1,"Norte",0,"130185",4,56,22,34,29,27,0,0,0,0,0,56,22,34,29,27,43,9.56635960098086,10.7998000416946,0.500169697998253,30
"216","AM","Iranduba",49011,14276.35,13007,"Manaus",1,"Norte",0,"130185",5,84,26,58,44,40,4,1,3,3,1,88,27,61,47,41,63,9.56635960098086,10.7998000416946,0.462817464470757,31
"217","AM","Itacoatiara",102701,18818.5,13009,"Itacoatiara",1,"Norte",1,"130190",2,151,44,107,79,72,1,0,1,0,1,152,44,108,79,73,40,9.84259570751875,11.5395771329676,0.277566065648203,29
"218","AM","Itacoatiara",102701,18818.5,13009,"Itacoatiara",1,"Norte",1,"130190",3,168,50,118,81,87,3,3,0,1,2,171,53,118,82,89,38,9.84259570751875,11.5395771329676,0.380619883802556,31
"219","AM","Itacoatiara",102701,18818.5,13009,"Itacoatiara",1,"Norte",1,"130190",4,131,35,96,69,62,1,1,0,0,1,132,36,96,69,63,61,9.84259570751875,11.5395771329676,0.471589527526818,30
"220","AM","Itacoatiara",102701,18818.5,13009,"Itacoatiara",1,"Norte",1,"130190",5,157,48,109,92,65,2,2,0,2,0,159,50,109,94,65,103,9.84259570751875,11.5395771329676,0.463527205941186,31
"221","AM","Itapiranga",9230,12126.8,13009,"Itacoatiara",1,"Norte",0,"130200",2,11,2,9,6,5,0,0,0,0,0,11,2,9,6,5,4,9.40317315839578,9.1302143274969,0.318357901409705,29
"222","AM","Itapiranga",9230,12126.8,13009,"Itacoatiara",1,"Norte",0,"130200",3,19,5,14,11,8,0,0,0,0,0,19,5,14,11,8,1,9.40317315839578,9.1302143274969,0.400327800062747,31
"223","AM","Itapiranga",9230,12126.8,13009,"Itacoatiara",1,"Norte",0,"130200",4,9,2,7,6,3,0,0,0,0,0,9,2,7,6,3,5,9.40317315839578,9.1302143274969,0.444418427565203,30
"224","AM","Itapiranga",9230,12126.8,13009,"Itacoatiara",1,"Norte",0,"130200",5,12,5,7,7,5,1,0,1,1,0,13,5,8,8,5,8,9.40317315839578,9.1302143274969,0.431568724294568,31
"225","AM","Lábrea",46882,10941.94,13012,"Purus",1,"Norte",0,"130240",2,64,30,34,42,22,0,0,0,0,0,64,30,34,42,22,12,9.3003583911505,10.7553890854569,0.325075064671648,29
"226","AM","Lábrea",46882,10941.94,13012,"Purus",1,"Norte",0,"130240",3,49,21,28,30,19,0,0,0,0,0,49,21,28,30,19,19,9.3003583911505,10.7553890854569,0.410791056299774,31
"227","AM","Lábrea",46882,10941.94,13012,"Purus",1,"Norte",0,"130240",4,55,25,30,33,22,0,0,0,0,0,55,25,30,33,22,12,9.3003583911505,10.7553890854569,0.476636535590686,30
"228","AM","Lábrea",46882,10941.94,13012,"Purus",1,"Norte",0,"130240",5,63,26,37,42,21,1,1,0,1,0,64,27,37,43,21,20,9.3003583911505,10.7553890854569,0.467732469288181,31
"229","AM","Manacapuru",98502,14839.87,13007,"Manaus",1,"Norte",1,"130250",2,174,59,115,96,78,3,1,2,2,1,177,60,117,98,79,42,9.60507275657518,11.4978321315226,0.315890701778199,29
"230","AM","Manacapuru",98502,14839.87,13007,"Manaus",1,"Norte",1,"130250",3,169,55,114,90,79,1,1,0,1,0,170,56,114,91,79,30,9.60507275657518,11.4978321315226,0.397606706766636,31
"231","AM","Manacapuru",98502,14839.87,13007,"Manaus",1,"Norte",1,"130250",4,165,66,99,72,93,0,0,0,0,0,165,66,99,72,93,79,9.60507275657518,11.4978321315226,0.494318728015803,30
"232","AM","Manacapuru",98502,14839.87,13007,"Manaus",1,"Norte",1,"130250",5,192,65,127,95,97,1,1,0,1,0,193,66,127,96,97,108,9.60507275657518,11.4978321315226,0.457188040417288,31
"233","AM","Manaquiri",33049,8834.03,13007,"Manaus",1,"Norte",0,"130255",2,13,6,7,9,4,0,0,0,0,0,13,6,7,9,4,5,9.08636658812082,10.405746587636,0.286864715503603,29
"234","AM","Manaquiri",33049,8834.03,13007,"Manaus",1,"Norte",0,"130255",3,17,5,12,11,6,1,1,0,0,1,18,6,12,11,7,6,9.08636658812082,10.405746587636,0.372290741234454,31
"235","AM","Manaquiri",33049,8834.03,13007,"Manaus",1,"Norte",0,"130255",4,13,4,9,6,7,0,0,0,0,0,13,4,9,6,7,8,9.08636658812082,10.405746587636,0.482413464264983,30
"236","AM","Manaquiri",33049,8834.03,13007,"Manaus",1,"Norte",0,"130255",5,21,4,17,10,11,0,0,0,0,0,21,4,17,10,11,11,9.08636658812082,10.405746587636,0.44703825098012,31
"237","AM","Manaus",2219580,36445.75,13007,"Manaus",1,"Norte",1,"130260",2,2940,700,2240,1319,1621,26,10,16,12,14,2966,710,2256,1331,1635,920,10.5035801325592,14.6128285467607,0.330203834221807,29
"238","AM","Manaus",2219580,36445.75,13007,"Manaus",1,"Norte",1,"130260",3,2965,660,2305,1309,1656,33,14,19,7,26,2998,674,2324,1316,1682,990,10.5035801325592,14.6128285467607,0.428987368721834,31
"239","AM","Manaus",2219580,36445.75,13007,"Manaus",1,"Norte",1,"130260",4,2718,617,2101,1204,1514,34,12,22,9,25,2752,629,2123,1213,1539,2947,10.5035801325592,14.6128285467607,0.531817799721067,30
"240","AM","Manaus",2219580,36445.75,13007,"Manaus",1,"Norte",1,"130260",5,3039,679,2360,1333,1706,38,11,27,10,28,3077,690,2387,1343,1734,2214,10.5035801325592,14.6128285467607,0.480108244805488,31
"241","AM","Manicoré",56583,9633.66,13013,"Madeira",1,"Norte",0,"130270",2,80,36,44,40,40,0,0,0,0,0,80,36,44,40,40,13,9.17301849489208,10.9434638657193,0.313908053993124,29
"242","AM","Manicoré",56583,9633.66,13013,"Madeira",1,"Norte",0,"130270",3,99,48,51,57,42,2,2,0,2,0,101,50,51,59,42,10,9.17301849489208,10.9434638657193,0.405874033168848,31
"243","AM","Manicoré",56583,9633.66,13013,"Madeira",1,"Norte",0,"130270",4,77,35,42,50,27,0,0,0,0,0,77,35,42,50,27,16,9.17301849489208,10.9434638657193,0.423906293189086,30
"244","AM","Manicoré",56583,9633.66,13013,"Madeira",1,"Norte",0,"130270",5,76,33,43,50,26,4,4,0,3,1,80,37,43,53,27,11,9.17301849489208,10.9434638657193,0.451851369129619,31
"245","AM","Maués",65040,7988.19,13010,"Parintins",1,"Norte",0,"130290",2,104,49,55,57,47,0,0,0,0,0,104,49,55,57,47,24,8.98571947993135,11.0827577442217,0.248918003820801,29
"246","AM","Maués",65040,7988.19,13010,"Parintins",1,"Norte",0,"130290",3,99,46,53,53,46,5,2,3,2,3,104,48,56,55,49,15,8.98571947993135,11.0827577442217,0.326638573147343,31
"247","AM","Maués",65040,7988.19,13010,"Parintins",1,"Norte",0,"130290",4,91,53,38,53,38,2,1,1,0,2,93,54,39,53,40,35,8.98571947993135,11.0827577442217,0.421673441873328,30
"248","AM","Maués",65040,7988.19,13010,"Parintins",1,"Norte",0,"130290",5,103,41,62,55,48,2,1,1,1,1,105,42,63,56,49,43,8.98571947993135,11.0827577442217,0.410758245087167,31
"249","AM","Nhamundá",21443,7250.55,13010,"Parintins",1,"Norte",0,"130300",2,21,7,14,10,11,1,0,1,1,0,22,7,15,11,11,10,8.8888326070403,9.97315353076923,0.33126539527856,29
"250","AM","Nhamundá",21443,7250.55,13010,"Parintins",1,"Norte",0,"130300",3,24,10,14,13,11,0,0,0,0,0,24,10,14,13,11,7,8.8888326070403,9.97315353076923,0.416717294766183,31
"251","AM","Nhamundá",21443,7250.55,13010,"Parintins",1,"Norte",0,"130300",4,18,5,13,7,11,0,0,0,0,0,18,5,13,7,11,2,8.8888326070403,9.97315353076923,0.457699396478176,30
"252","AM","Nhamundá",21443,7250.55,13010,"Parintins",1,"Norte",0,"130300",5,23,3,20,14,9,0,0,0,0,0,23,3,20,14,9,7,8.8888326070403,9.97315353076923,0.494120864481076,31
"253","AM","Nova Olinda do Norte",38026,6718.55,13009,"Itacoatiara",1,"Norte",0,"130310",2,50,25,25,26,24,1,1,0,0,1,51,26,25,26,25,6,8.81262763642515,10.5460254152695,0.319752359598046,29
"254","AM","Nova Olinda do Norte",38026,6718.55,13009,"Itacoatiara",1,"Norte",0,"130310",3,49,26,23,27,22,0,0,0,0,0,49,26,23,27,22,12,8.81262763642515,10.5460254152695,0.392748575518943,31
"255","AM","Nova Olinda do Norte",38026,6718.55,13009,"Itacoatiara",1,"Norte",0,"130310",4,40,22,18,24,16,1,0,1,0,1,41,22,19,24,17,8,8.81262763642515,10.5460254152695,0.453551063010261,30
"256","AM","Nova Olinda do Norte",38026,6718.55,13009,"Itacoatiara",1,"Norte",0,"130310",5,47,24,23,25,22,2,0,2,2,0,49,24,25,27,22,26,8.81262763642515,10.5460254152695,0.448326237837574,31
"257","AM","Novo Airão",19928,7168.78,13001,"Rio Negro",1,"Norte",0,"130320",2,24,10,14,13,11,0,0,0,0,0,24,10,14,13,11,4,8.87749076569892,9.89988105694202,0.32943258298017,29
"258","AM","Novo Airão",19928,7168.78,13001,"Rio Negro",1,"Norte",0,"130320",3,22,11,11,11,11,0,0,0,0,0,22,11,11,11,11,2,8.87749076569892,9.89988105694202,0.400563821240732,31
"259","AM","Novo Airão",19928,7168.78,13001,"Rio Negro",1,"Norte",0,"130320",4,13,8,5,4,9,0,0,0,0,0,13,8,5,4,9,13,8.87749076569892,9.89988105694202,0.468901608627586,30
"260","AM","Novo Airão",19928,7168.78,13001,"Rio Negro",1,"Norte",0,"130320",5,26,12,14,17,9,0,0,0,0,0,26,12,14,17,9,16,8.87749076569892,9.89988105694202,0.452704877201661,31
"261","AM","Parintins",115363,9890.96,13010,"Parintins",1,"Norte",1,"130340",2,139,24,115,77,62,2,1,1,0,2,141,25,116,77,64,28,9.19937648765119,11.6558389577285,0.252975157756642,29
"262","AM","Parintins",115363,9890.96,13010,"Parintins",1,"Norte",1,"130340",3,146,32,114,60,86,0,0,0,0,0,146,32,114,60,86,32,9.19937648765119,11.6558389577285,0.341902391775529,31
"263","AM","Parintins",115363,9890.96,13010,"Parintins",1,"Norte",1,"130340",4,128,33,95,72,56,0,0,0,0,0,128,33,95,72,56,47,9.19937648765119,11.6558389577285,0.441887989686988,30
"264","AM","Parintins",115363,9890.96,13010,"Parintins",1,"Norte",1,"130340",5,155,40,115,88,67,1,0,1,0,1,156,40,116,88,68,65,9.19937648765119,11.6558389577285,0.438927536893829,31
"265","AM","Presidente Figueiredo",37193,23264,13008,"Rio Preto da Eva",1,"Norte",0,"130353",2,42,17,25,24,18,3,2,1,2,1,45,19,26,26,19,13,10.0546623803332,10.5238758505116,0.310162781755762,29
"266","AM","Presidente Figueiredo",37193,23264,13008,"Rio Preto da Eva",1,"Norte",0,"130353",3,30,8,22,17,13,0,0,0,0,0,30,8,22,17,13,4,10.0546623803332,10.5238758505116,0.378837811564623,31
"267","AM","Presidente Figueiredo",37193,23264,13008,"Rio Preto da Eva",1,"Norte",0,"130353",4,46,13,33,18,28,0,0,0,0,0,46,13,33,18,28,18,10.0546623803332,10.5238758505116,0.454230467608217,30
"268","AM","Presidente Figueiredo",37193,23264,13008,"Rio Preto da Eva",1,"Norte",0,"130353",5,45,10,35,30,15,1,1,0,0,1,46,11,35,30,16,22,10.0546623803332,10.5238758505116,0.457466554425027,31
"269","AM","Rio Preto da Eva",34106,11769.8,13008,"Rio Preto da Eva",1,"Norte",0,"130356",2,26,11,15,12,14,1,0,1,0,1,27,11,16,12,15,9,9.37329220775651,10.4372286008729,0.298368757316284,29
"270","AM","Rio Preto da Eva",34106,11769.8,13008,"Rio Preto da Eva",1,"Norte",0,"130356",3,41,20,21,21,20,0,0,0,0,0,41,20,21,21,20,6,9.37329220775651,10.4372286008729,0.396393037360717,31
"271","AM","Rio Preto da Eva",34106,11769.8,13008,"Rio Preto da Eva",1,"Norte",0,"130356",4,35,15,20,23,12,0,0,0,0,0,35,15,20,23,12,19,9.37329220775651,10.4372286008729,0.469701185942674,30
"272","AM","Rio Preto da Eva",34106,11769.8,13008,"Rio Preto da Eva",1,"Norte",0,"130356",5,40,18,22,19,21,1,0,1,0,1,41,18,23,19,22,16,9.37329220775651,10.4372286008729,0.479636816408807,31
"273","AM","São Gabriel da Cachoeira",46303,7344.41,13001,"Rio Negro",1,"Norte",0,"130380",2,98,55,43,57,41,1,0,1,1,0,99,55,44,58,41,28,8.90169475862872,10.7429620327916,0.281766156092189,29
"274","AM","São Gabriel da Cachoeira",46303,7344.41,13001,"Rio Negro",1,"Norte",0,"130380",3,105,55,50,54,51,3,3,0,3,0,108,58,50,57,51,32,8.90169475862872,10.7429620327916,0.339095008980391,31
"275","AM","São Gabriel da Cachoeira",46303,7344.41,13001,"Rio Negro",1,"Norte",0,"130380",4,76,37,39,35,41,2,1,1,2,0,78,38,40,37,41,19,8.90169475862872,10.7429620327916,0.381474461448245,30
"276","AM","São Gabriel da Cachoeira",46303,7344.41,13001,"Rio Negro",1,"Norte",0,"130380",5,83,35,48,38,45,1,1,0,0,1,84,36,48,38,46,58,8.90169475862872,10.7429620327916,0.426005920950457,31
"277","AM","Tabatinga",67182,8274.57,13003,"Alto Solimões",1,"Norte",1,"130406",2,140,59,81,68,72,3,1,2,1,2,143,60,83,69,74,40,9.02094223514888,11.1151606334883,0.322618447787893,29
"278","AM","Tabatinga",67182,8274.57,13003,"Alto Solimões",1,"Norte",1,"130406",3,111,43,68,55,56,2,1,1,1,1,113,44,69,56,57,14,9.02094223514888,11.1151606334883,0.404678774180793,31
"279","AM","Tabatinga",67182,8274.57,13003,"Alto Solimões",1,"Norte",1,"130406",4,109,42,67,56,53,1,1,0,0,1,110,43,67,56,54,61,9.02094223514888,11.1151606334883,0.490040637058728,30
"280","AM","Tabatinga",67182,8274.57,13003,"Alto Solimões",1,"Norte",1,"130406",5,126,41,85,62,64,3,1,2,1,2,129,42,87,63,66,83,9.02094223514888,11.1151606334883,0.505963693030495,31
"281","AM","Tefé",59547,15530.32,13005,"Tefé",1,"Norte",1,"130420",2,127,54,73,70,57,1,0,1,0,1,128,54,74,70,58,19,9.65054952121055,10.9945211956807,0.317178017835617,29
"282","AM","Tefé",59547,15530.32,13005,"Tefé",1,"Norte",1,"130420",3,161,79,82,98,63,2,0,2,2,0,163,79,84,100,63,16,9.65054952121055,10.9945211956807,0.387806479415222,31
"283","AM","Tefé",59547,15530.32,13005,"Tefé",1,"Norte",1,"130420",4,124,63,61,79,45,2,2,0,1,1,126,65,61,80,46,38,9.65054952121055,10.9945211956807,0.495084174264744,30
"284","AM","Tefé",59547,15530.32,13005,"Tefé",1,"Norte",1,"130420",5,158,64,94,96,62,2,1,1,1,1,160,65,95,97,63,94,9.65054952121055,10.9945211956807,0.494297119652536,31
"285","AM","Urucurituba",23585,7381.23,13009,"Itacoatiara",1,"Norte",0,"130440",2,26,9,17,9,17,0,0,0,0,0,26,9,17,9,17,4,8.90669557037384,10.0683661957184,0.290008101130562,29
"286","AM","Urucurituba",23585,7381.23,13009,"Itacoatiara",1,"Norte",0,"130440",3,17,9,8,4,13,0,0,0,0,0,17,9,8,4,13,3,8.90669557037384,10.0683661957184,0.349918975586432,31
"287","AM","Urucurituba",23585,7381.23,13009,"Itacoatiara",1,"Norte",0,"130440",4,22,11,11,17,5,0,0,0,0,0,22,11,11,17,5,7,8.90669557037384,10.0683661957184,0.416197205731215,30
"288","AM","Urucurituba",23585,7381.23,13009,"Itacoatiara",1,"Norte",0,"130440",5,26,13,13,16,10,0,0,0,0,0,26,13,13,16,10,9,8.90669557037384,10.0683661957184,0.425871755007561,31
"289","RR","Amajari",13185,13690.88,14001,"Boa Vista",1,"Norte",0,"140002",2,33,20,13,22,11,0,0,0,0,0,33,20,13,22,11,10,9.52448519671331,9.48683509878739,0.334432761361829,29
"290","RR","Amajari",13185,13690.88,14001,"Boa Vista",1,"Norte",0,"140002",3,38,30,8,24,14,0,0,0,0,0,38,30,8,24,14,4,9.52448519671331,9.48683509878739,0.411369309150591,31
"291","RR","Amajari",13185,13690.88,14001,"Boa Vista",1,"Norte",0,"140002",4,22,15,7,9,13,0,0,0,0,0,22,15,7,9,13,7,9.52448519671331,9.48683509878739,0.455244236019587,30
"292","RR","Amajari",13185,13690.88,14001,"Boa Vista",1,"Norte",0,"140002",5,22,10,12,13,9,2,2,0,2,0,24,12,12,15,9,14,9.52448519671331,9.48683509878739,0.511131232622745,31
"293","RR","Alto Alegre",15380,17912.43,14001,"Boa Vista",1,"Norte",0,"140005",2,68,52,16,37,31,1,1,0,0,1,69,53,16,37,32,6,9.79325016424324,9.64082324305964,0.343443894813139,29
"294","RR","Alto Alegre",15380,17912.43,14001,"Boa Vista",1,"Norte",0,"140005",3,46,28,18,26,20,0,0,0,0,0,46,28,18,26,20,9,9.79325016424324,9.64082324305964,0.403433748588591,31
"295","RR","Alto Alegre",15380,17912.43,14001,"Boa Vista",1,"Norte",0,"140005",4,43,25,18,30,13,0,0,0,0,0,43,25,18,30,13,9,9.79325016424324,9.64082324305964,0.444475822113095,30
"296","RR","Alto Alegre",15380,17912.43,14001,"Boa Vista",1,"Norte",0,"140005",5,22,10,12,12,10,0,0,0,0,0,22,10,12,12,10,6,9.79325016424324,9.64082324305964,0.491959685894888,31
"297","RR","Boa Vista",419652,26752.67,14001,"Boa Vista",1,"Norte",1,"140010",2,644,171,473,302,342,4,2,2,2,2,648,173,475,304,344,143,10.1943895604273,12.9471810753759,0.295698126328316,29
"298","RR","Boa Vista",419652,26752.67,14001,"Boa Vista",1,"Norte",1,"140010",3,641,135,506,300,341,3,1,2,0,3,644,136,508,300,344,166,10.1943895604273,12.9471810753759,0.387778993490517,31
"299","RR","Boa Vista",419652,26752.67,14001,"Boa Vista",1,"Norte",1,"140010",4,600,146,454,288,312,4,0,4,1,3,604,146,458,289,315,147,10.1943895604273,12.9471810753759,0.434692752325294,30
"300","RR","Boa Vista",419652,26752.67,14001,"Boa Vista",1,"Norte",1,"140010",5,608,165,443,287,321,8,3,5,1,7,616,168,448,288,328,300,10.1943895604273,12.9471810753759,0.427553706203024,31
"301","RR","Bonfim",12557,22953.42,14002,"Nordeste de Roraima",1,"Norte",0,"140015",2,43,24,19,22,21,0,0,0,0,0,43,24,19,22,21,4,10.0412222239942,9.43803355798896,0.299246739232592,29
"302","RR","Bonfim",12557,22953.42,14002,"Nordeste de Roraima",1,"Norte",0,"140015",3,37,21,16,18,19,0,0,0,0,0,37,21,16,18,19,4,10.0412222239942,9.43803355798896,0.385158680466528,31
"303","RR","Bonfim",12557,22953.42,14002,"Nordeste de Roraima",1,"Norte",0,"140015",4,32,15,17,21,11,0,0,0,0,0,32,15,17,21,11,6,10.0412222239942,9.43803355798896,0.437143362161075,30
"304","RR","Bonfim",12557,22953.42,14002,"Nordeste de Roraima",1,"Norte",0,"140015",5,23,12,11,15,8,0,0,0,0,0,23,12,11,15,8,8,10.0412222239942,9.43803355798896,0.517142611639012,31
"305","RR","Cantá",18799,15025.69,14002,"Nordeste de Roraima",1,"Norte",0,"140017",2,20,4,16,7,13,1,0,1,1,0,21,4,17,8,13,4,9.61751668180986,9.84155895591396,0.333795341247553,29
"306","RR","Cantá",18799,15025.69,14002,"Nordeste de Roraima",1,"Norte",0,"140017",3,35,10,25,21,14,0,0,0,0,0,35,10,25,21,14,10,9.61751668180986,9.84155895591396,0.403698679845848,31
"307","RR","Cantá",18799,15025.69,14002,"Nordeste de Roraima",1,"Norte",0,"140017",4,29,14,15,11,18,0,0,0,0,0,29,14,15,11,18,6,9.61751668180986,9.84155895591396,0.444897843364248,30
"308","RR","Cantá",18799,15025.69,14002,"Nordeste de Roraima",1,"Norte",0,"140017",5,29,12,17,15,14,0,0,0,0,0,29,12,17,15,14,7,9.61751668180986,9.84155895591396,0.466098467346864,31
"309","RR","Caracaraí",22283,16093.39,14003,"Caracaraí",1,"Norte",0,"140020",2,40,20,20,18,22,1,0,1,1,0,41,20,21,19,22,6,9.68616390766392,10.011579334887,0.290604669288104,29
"310","RR","Caracaraí",22283,16093.39,14003,"Caracaraí",1,"Norte",0,"140020",3,40,24,16,25,15,0,0,0,0,0,40,24,16,25,15,11,9.68616390766392,10.011579334887,0.361574361650257,31
"311","RR","Caracaraí",22283,16093.39,14003,"Caracaraí",1,"Norte",0,"140020",4,30,16,14,14,16,0,0,0,0,0,30,16,14,14,16,13,9.68616390766392,10.011579334887,0.403569989865718,30
"312","RR","Caracaraí",22283,16093.39,14003,"Caracaraí",1,"Norte",0,"140020",5,26,11,15,15,11,1,0,1,0,1,27,11,16,15,12,9,9.68616390766392,10.011579334887,0.424765980284207,31
"313","RR","Caroebe",10383,17928.78,14004,"Sudeste de Roraima",1,"Norte",0,"140023",2,16,5,11,9,7,0,0,0,0,0,16,5,11,9,7,2,9.79416252189713,9.24792513230345,0.334328207175219,29
"314","RR","Caroebe",10383,17928.78,14004,"Sudeste de Roraima",1,"Norte",0,"140023",3,14,8,6,4,10,0,0,0,0,0,14,8,6,4,10,3,9.79416252189713,9.24792513230345,0.413502029303422,31
"315","RR","Caroebe",10383,17928.78,14004,"Sudeste de Roraima",1,"Norte",0,"140023",4,16,5,11,8,8,0,0,0,0,0,16,5,11,8,8,3,9.79416252189713,9.24792513230345,0.451090706203317,30
"316","RR","Caroebe",10383,17928.78,14004,"Sudeste de Roraima",1,"Norte",0,"140023",5,12,4,8,6,6,0,0,0,0,0,12,4,8,6,6,4,9.79416252189713,9.24792513230345,0.450152702579943,31
"317","RR","Iracema",12296,13783.97,14003,"Caracaraí",1,"Norte",0,"140028",2,15,8,7,7,8,0,0,0,0,0,15,8,7,7,8,0,9.53126160176895,9.41702928521843,0.338894428483966,29
"318","RR","Iracema",12296,13783.97,14003,"Caracaraí",1,"Norte",0,"140028",3,7,3,4,1,6,0,0,0,0,0,7,3,4,1,6,4,9.53126160176895,9.41702928521843,0.416317144692628,31
"319","RR","Iracema",12296,13783.97,14003,"Caracaraí",1,"Norte",0,"140028",4,9,3,6,3,6,0,0,0,0,0,9,3,6,3,6,6,9.53126160176895,9.41702928521843,0.448419856730568,30
"320","RR","Iracema",12296,13783.97,14003,"Caracaraí",1,"Norte",0,"140028",5,6,3,3,3,3,0,0,0,0,0,6,3,3,3,3,3,9.53126160176895,9.41702928521843,0.448941410050103,31
"321","RR","Mucajaí",18172,17661.31,14003,"Caracaraí",1,"Norte",0,"140030",2,20,6,14,13,7,0,0,0,0,0,20,6,14,13,7,4,9.77913165034228,9.80763722687929,0.30567186415731,29
"322","RR","Mucajaí",18172,17661.31,14003,"Caracaraí",1,"Norte",0,"140030",3,31,10,21,16,15,0,0,0,0,0,31,10,21,16,15,12,9.77913165034228,9.80763722687929,0.365145059440761,31
"323","RR","Mucajaí",18172,17661.31,14003,"Caracaraí",1,"Norte",0,"140030",4,30,12,18,11,19,0,0,0,0,0,30,12,18,11,19,6,9.77913165034228,9.80763722687929,0.429668648162608,30
"324","RR","Mucajaí",18172,17661.31,14003,"Caracaraí",1,"Norte",0,"140030",5,24,7,17,10,14,0,0,0,0,0,24,7,17,10,14,8,9.77913165034228,9.80763722687929,0.460928932263989,31
"325","RR","Pacaraima",18913,13123.04,14001,"Boa Vista",1,"Norte",0,"140045",2,36,22,14,20,16,0,0,0,0,0,36,22,14,20,16,4,9.48212474297516,9.84760479528845,0.315473946947491,29
"326","RR","Pacaraima",18913,13123.04,14001,"Boa Vista",1,"Norte",0,"140045",3,48,20,28,27,21,0,0,0,0,0,48,20,28,27,21,2,9.48212474297516,9.84760479528845,0.384061810126814,31
"327","RR","Pacaraima",18913,13123.04,14001,"Boa Vista",1,"Norte",0,"140045",4,48,22,26,26,22,0,0,0,0,0,48,22,26,26,22,1,9.48212474297516,9.84760479528845,0.393756416148679,30
"328","RR","Pacaraima",18913,13123.04,14001,"Boa Vista",1,"Norte",0,"140045",5,37,19,18,26,11,1,1,0,0,1,38,20,18,26,12,11,9.48212474297516,9.84760479528845,0.418891285708086,31
"329","RR","Rorainópolis",30782,18536.04,14004,"Sudeste de Roraima",1,"Norte",0,"140047",2,49,18,31,30,19,0,0,0,0,0,49,18,31,30,19,6,9.82747222407277,10.3346853825399,0.294260557367811,29
"330","RR","Rorainópolis",30782,18536.04,14004,"Sudeste de Roraima",1,"Norte",0,"140047",3,39,12,27,19,20,1,0,1,1,0,40,12,28,20,20,16,9.82747222407277,10.3346853825399,0.343863436298281,31
"331","RR","Rorainópolis",30782,18536.04,14004,"Sudeste de Roraima",1,"Norte",0,"140047",4,42,15,27,27,15,1,0,1,1,0,43,15,28,28,15,5,9.82747222407277,10.3346853825399,0.387909449229315,30
"332","RR","Rorainópolis",30782,18536.04,14004,"Sudeste de Roraima",1,"Norte",0,"140047",5,50,18,32,21,29,0,0,0,0,0,50,18,32,21,29,19,9.82747222407277,10.3346853825399,0.412005281640484,31
"333","RR","São João da Baliza",8348,22072.82,14004,"Sudeste de Roraima",1,"Norte",0,"140050",2,10,4,6,6,4,0,0,0,0,0,10,4,6,6,4,0,10.0021022663488,9.02977726819709,0.340237362210953,29
"334","RR","São João da Baliza",8348,22072.82,14004,"Sudeste de Roraima",1,"Norte",0,"140050",3,8,3,5,2,6,0,0,0,0,0,8,3,5,2,6,3,10.0021022663488,9.02977726819709,0.409916324569194,31
"335","RR","São João da Baliza",8348,22072.82,14004,"Sudeste de Roraima",1,"Norte",0,"140050",4,9,1,8,4,5,0,0,0,0,0,9,1,8,4,5,1,10.0021022663488,9.02977726819709,0.409316673177774,30
"336","RR","São João da Baliza",8348,22072.82,14004,"Sudeste de Roraima",1,"Norte",0,"140050",5,5,1,4,4,1,0,0,0,0,0,5,1,4,4,1,1,10.0021022663488,9.02977726819709,0.400886900487692,31
"337","RR","São Luiz",8110,17693.77,14004,"Sudeste de Roraima",1,"Norte",0,"140060",2,9,2,7,3,6,0,0,0,0,0,9,2,7,3,6,3,9.78096787920221,9.00085314710946,0.354558167146054,29
"338","RR","São Luiz",8110,17693.77,14004,"Sudeste de Roraima",1,"Norte",0,"140060",3,5,3,2,0,5,0,0,0,0,0,5,3,2,0,5,4,9.78096787920221,9.00085314710946,0.419132475875349,31
"339","RR","São Luiz",8110,17693.77,14004,"Sudeste de Roraima",1,"Norte",0,"140060",4,7,2,5,4,3,0,0,0,0,0,7,2,5,4,3,1,9.78096787920221,9.00085314710946,0.439178201976668,30
"340","RR","São Luiz",8110,17693.77,14004,"Sudeste de Roraima",1,"Norte",0,"140060",5,9,0,9,4,5,0,0,0,0,0,9,0,9,4,5,5,9.78096787920221,9.00085314710946,0.440097310813332,31
"341","PA","Abaetetuba",159080,9046.13,15011,"Cametá",1,"Norte",1,"150010",2,197,64,133,88,109,2,0,2,0,2,199,64,135,88,111,58,9.11009232092723,11.9771624993216,0.301599434714306,29
"342","PA","Abaetetuba",159080,9046.13,15011,"Cametá",1,"Norte",1,"150010",3,188,56,132,100,88,2,0,2,1,1,190,56,134,101,89,64,9.11009232092723,11.9771624993216,0.39107413840779,31
"343","PA","Abaetetuba",159080,9046.13,15011,"Cametá",1,"Norte",1,"150010",4,187,47,140,92,95,2,2,0,2,0,189,49,140,94,95,65,9.11009232092723,11.9771624993216,0.467174306647447,30
"344","PA","Abaetetuba",159080,9046.13,15011,"Cametá",1,"Norte",1,"150010",5,201,53,148,101,100,4,3,1,3,1,205,56,149,104,101,204,9.11009232092723,11.9771624993216,0.524090030097437,31
"345","PA","Acará",55669,16467.17,15012,"Tomé-Açu",1,"Norte",0,"150020",2,60,34,26,33,27,1,1,0,1,0,61,35,26,34,27,20,9.70912398084237,10.92717871802,0.30676128265755,29
"346","PA","Acará",55669,16467.17,15012,"Tomé-Açu",1,"Norte",0,"150020",3,64,33,31,32,32,0,0,0,0,0,64,33,31,32,32,15,9.70912398084237,10.92717871802,0.381091359182981,31
"347","PA","Acará",55669,16467.17,15012,"Tomé-Açu",1,"Norte",0,"150020",4,62,29,33,34,28,1,0,1,1,0,63,29,34,35,28,16,9.70912398084237,10.92717871802,0.452339757814636,30
"348","PA","Acará",55669,16467.17,15012,"Tomé-Açu",1,"Norte",0,"150020",5,45,27,18,24,21,1,0,1,0,1,46,27,19,24,22,34,9.70912398084237,10.92717871802,0.494895734814678,31
"349","PA","Afuá",39567,9207.83,15005,"Furos de Breves",1,"Norte",0,"150030",2,69,50,19,41,28,0,0,0,0,0,69,50,19,41,28,4,9.12780948802451,10.585750716494,0.312468091705511,29
"350","PA","Afuá",39567,9207.83,15005,"Furos de Breves",1,"Norte",0,"150030",3,77,51,26,35,42,0,0,0,0,0,77,51,26,35,42,8,9.12780948802451,10.585750716494,0.402854237211545,31
"351","PA","Afuá",39567,9207.83,15005,"Furos de Breves",1,"Norte",0,"150030",4,69,45,24,34,35,1,1,0,1,0,70,46,24,35,35,4,9.12780948802451,10.585750716494,0.481607128092029,30
"352","PA","Afuá",39567,9207.83,15005,"Furos de Breves",1,"Norte",0,"150030",5,81,64,17,52,29,1,0,1,1,0,82,64,18,53,29,17,9.12780948802451,10.585750716494,0.53607974632383,31
"353","PA","Água Azul do Norte",27615,15529.79,15019,"Parauapebas",1,"Norte",0,"150034",2,15,8,7,12,3,0,0,0,0,0,15,8,7,12,3,5,9.65051539383624,10.2261143823353,0.316054716212925,29
"354","PA","Água Azul do Norte",27615,15529.79,15019,"Parauapebas",1,"Norte",0,"150034",3,13,5,8,3,10,0,0,0,0,0,13,5,8,3,10,4,9.65051539383624,10.2261143823353,0.35443571569755,31
"355","PA","Água Azul do Norte",27615,15529.79,15019,"Parauapebas",1,"Norte",0,"150034",4,16,6,10,5,11,0,0,0,0,0,16,6,10,5,11,4,9.65051539383624,10.2261143823353,0.379409353964191,30
"356","PA","Água Azul do Norte",27615,15529.79,15019,"Parauapebas",1,"Norte",0,"150034",5,17,6,11,10,7,0,0,0,0,0,17,6,11,10,7,3,9.65051539383624,10.2261143823353,0.400474339538166,31
"357","PA","Alenquer",57092,10034.93,15002,"Santarém",1,"Norte",1,"150040",2,82,40,42,38,44,1,1,0,0,1,83,41,42,38,45,14,9.21382728562066,10.9524192807497,0.251425561163296,29
"358","PA","Alenquer",57092,10034.93,15002,"Santarém",1,"Norte",1,"150040",3,72,39,33,29,43,1,1,0,0,1,73,40,33,29,44,12,9.21382728562066,10.9524192807497,0.328752417718601,31
"359","PA","Alenquer",57092,10034.93,15002,"Santarém",1,"Norte",1,"150040",4,73,38,35,36,37,0,0,0,0,0,73,38,35,36,37,20,9.21382728562066,10.9524192807497,0.37848757280888,30
"360","PA","Alenquer",57092,10034.93,15002,"Santarém",1,"Norte",1,"150040",5,83,46,37,55,28,0,0,0,0,0,83,46,37,55,28,32,9.21382728562066,10.9524192807497,0.399507634340238,31
"361","PA","Almeirim",34076,17327.19,15003,"Almeirim",1,"Norte",0,"150050",2,57,32,25,34,23,2,2,0,0,2,59,34,25,34,25,10,9.76003222299583,10.4363486031627,0.286330531339274,29
"362","PA","Almeirim",34076,17327.19,15003,"Almeirim",1,"Norte",0,"150050",3,59,35,24,33,26,0,0,0,0,0,59,35,24,33,26,12,9.76003222299583,10.4363486031627,0.352451626725285,31
"363","PA","Almeirim",34076,17327.19,15003,"Almeirim",1,"Norte",0,"150050",4,44,27,17,25,19,0,0,0,0,0,44,27,17,25,19,19,9.76003222299583,10.4363486031627,0.403345003689123,30
"364","PA","Almeirim",34076,17327.19,15003,"Almeirim",1,"Norte",0,"150050",5,54,33,21,35,19,1,1,0,1,0,55,34,21,36,19,18,9.76003222299583,10.4363486031627,0.445786899487189,31
"365","PA","Altamira",115969,24049.71,15015,"Altamira",1,"Norte",1,"150060",2,179,74,105,100,79,2,1,1,0,2,181,75,106,100,81,65,10.0878782172491,11.6610781929939,0.308306750630636,29
"366","PA","Altamira",115969,24049.71,15015,"Altamira",1,"Norte",1,"150060",3,199,74,125,103,96,1,0,1,0,1,200,74,126,103,97,62,10.0878782172491,11.6610781929939,0.385752867161572,31
"367","PA","Altamira",115969,24049.71,15015,"Altamira",1,"Norte",1,"150060",4,183,69,114,103,80,1,0,1,0,1,184,69,115,103,81,63,10.0878782172491,11.6610781929939,0.429187745113457,30
"368","PA","Altamira",115969,24049.71,15015,"Altamira",1,"Norte",1,"150060",5,155,61,94,84,71,0,0,0,0,0,155,61,94,84,71,66,10.0878782172491,11.6610781929939,0.454863558822887,31
"369","PA","Anajás",29688,7166.52,15005,"Furos de Breves",1,"Norte",0,"150070",2,79,52,27,45,34,0,0,0,0,0,79,52,27,45,34,5,8.87717546012195,10.2984982027404,0.345205460650045,29
"370","PA","Anajás",29688,7166.52,15005,"Furos de Breves",1,"Norte",0,"150070",3,64,40,24,38,26,0,0,0,0,0,64,40,24,38,26,4,8.87717546012195,10.2984982027404,0.459111036622762,31
"371","PA","Anajás",29688,7166.52,15005,"Furos de Breves",1,"Norte",0,"150070",4,53,34,19,34,19,1,0,1,0,1,54,34,20,34,20,7,8.87717546012195,10.2984982027404,0.504455444547167,30
"372","PA","Anajás",29688,7166.52,15005,"Furos de Breves",1,"Norte",0,"150070",5,53,37,16,32,21,0,0,0,0,0,53,37,16,32,21,11,8.87717546012195,10.2984982027404,0.589041467489536,31
"373","PA","Ananindeua",535547,14314.96,15007,"Belém",1,"Norte",1,"150080",2,299,57,242,132,167,4,1,3,1,3,303,58,245,133,170,230,9.56906042325657,13.1910439334592,0.304421153624467,29
"374","PA","Ananindeua",535547,14314.96,15007,"Belém",1,"Norte",1,"150080",3,364,62,302,151,213,7,4,3,2,5,371,66,305,153,218,273,9.56906042325657,13.1910439334592,0.398873145481486,31
"375","PA","Ananindeua",535547,14314.96,15007,"Belém",1,"Norte",1,"150080",4,318,72,246,145,173,6,2,4,4,2,324,74,250,149,175,503,9.56906042325657,13.1910439334592,0.484491744575952,30
"376","PA","Ananindeua",535547,14314.96,15007,"Belém",1,"Norte",1,"150080",5,333,62,271,149,184,1,1,0,0,1,334,63,271,149,185,717,9.56906042325657,13.1910439334592,0.494338989849631,31
"377","PA","Anapu",28607,13582.65,15015,"Altamira",1,"Norte",0,"150085",2,48,28,20,30,18,1,0,1,1,0,49,28,21,31,18,6,9.51654852198701,10.261406722105,0.308208233152816,29
"378","PA","Anapu",28607,13582.65,15015,"Altamira",1,"Norte",0,"150085",3,52,28,24,34,18,1,0,1,0,1,53,28,25,34,19,11,9.51654852198701,10.261406722105,0.379645261465541,31
"379","PA","Anapu",28607,13582.65,15015,"Altamira",1,"Norte",0,"150085",4,49,27,22,32,17,0,0,0,0,0,49,27,22,32,17,16,9.51654852198701,10.261406722105,0.423153093979191,30
"380","PA","Anapu",28607,13582.65,15015,"Altamira",1,"Norte",0,"150085",5,36,14,22,21,15,0,0,0,0,0,36,14,22,21,15,12,9.51654852198701,10.261406722105,0.446806089248992,31
"381","PA","Augusto Corrêa",46471,6719.53,15010,"Bragantina",1,"Norte",0,"150090",2,54,25,29,27,27,0,0,0,0,0,54,25,29,27,27,12,8.81277349059506,10.7465837411072,0.318768940399244,29
"382","PA","Augusto Corrêa",46471,6719.53,15010,"Bragantina",1,"Norte",0,"150090",3,64,38,26,43,21,0,0,0,0,0,64,38,26,43,21,13,8.81277349059506,10.7465837411072,0.385702967417256,31
"383","PA","Augusto Corrêa",46471,6719.53,15010,"Bragantina",1,"Norte",0,"150090",4,58,34,24,40,18,0,0,0,0,0,58,34,24,40,18,24,8.81277349059506,10.7465837411072,0.433261103315029,30
"384","PA","Augusto Corrêa",46471,6719.53,15010,"Bragantina",1,"Norte",0,"150090",5,57,37,20,29,28,1,1,0,0,1,58,38,20,29,29,39,8.81277349059506,10.7465837411072,0.456108146886502,31
"385","PA","Aurora do Pará",31773,8442.6,15013,"Guamá",1,"Norte",0,"150095",2,27,11,16,16,11,0,0,0,0,0,27,11,16,16,11,7,9.04104559702226,10.3663721515118,0.283693412965613,29
"386","PA","Aurora do Pará",31773,8442.6,15013,"Guamá",1,"Norte",0,"150095",3,23,12,11,11,12,0,0,0,0,0,23,12,11,11,12,8,9.04104559702226,10.3663721515118,0.369363568454998,31
"387","PA","Aurora do Pará",31773,8442.6,15013,"Guamá",1,"Norte",0,"150095",4,23,13,10,13,10,0,0,0,0,0,23,13,10,13,10,15,9.04104559702226,10.3663721515118,0.416802864477017,30
"388","PA","Aurora do Pará",31773,8442.6,15013,"Guamá",1,"Norte",0,"150095",5,36,16,20,21,15,0,0,0,0,0,36,16,20,21,15,10,9.04104559702226,10.3663721515118,0.433218444685649,31
"389","PA","Baião",48459,7471.71,15011,"Cametá",1,"Norte",0,"150120",2,33,16,17,24,9,1,0,1,1,0,34,16,18,25,9,10,8.91887916759232,10.7884733585819,0.284904678556009,29
"390","PA","Baião",48459,7471.71,15011,"Cametá",1,"Norte",0,"150120",3,40,15,25,23,17,0,0,0,0,0,40,15,25,23,17,14,8.91887916759232,10.7884733585819,0.378285341051046,31
"391","PA","Baião",48459,7471.71,15011,"Cametá",1,"Norte",0,"150120",4,33,15,18,19,14,0,0,0,0,0,33,15,18,19,14,13,8.91887916759232,10.7884733585819,0.459769885454311,30
"392","PA","Baião",48459,7471.71,15011,"Cametá",1,"Norte",0,"150120",5,34,10,24,19,15,0,0,0,0,0,34,10,24,19,15,14,8.91887916759232,10.7884733585819,0.523150613825041,31
"393","PA","Barcarena",127027,38739.32,15007,"Belém",1,"Norte",1,"150130",2,169,57,112,87,82,0,0,0,0,0,169,57,112,87,82,38,10.5646103838901,11.7521549412701,0.292103843653382,29
"394","PA","Barcarena",127027,38739.32,15007,"Belém",1,"Norte",1,"150130",3,174,48,126,78,96,2,0,2,0,2,176,48,128,78,98,53,10.5646103838901,11.7521549412701,0.372433226486967,31
"395","PA","Barcarena",127027,38739.32,15007,"Belém",1,"Norte",1,"150130",4,168,57,111,92,76,1,0,1,1,0,169,57,112,93,76,53,10.5646103838901,11.7521549412701,0.43684584802906,30
"396","PA","Barcarena",127027,38739.32,15007,"Belém",1,"Norte",1,"150130",5,197,63,134,106,91,4,1,3,2,2,201,64,137,108,93,161,10.5646103838901,11.7521549412701,0.445604716781895,31
"397","PA","Belém",1499641,21191.47,15007,"Belém",1,"Norte",1,"150140",2,1347,314,1033,529,818,18,7,11,7,11,1365,321,1044,536,829,788,9.96135402120164,14.2207363040943,0.310430574444174,29
"398","PA","Belém",1499641,21191.47,15007,"Belém",1,"Norte",1,"150140",3,1271,318,953,510,761,19,5,14,10,9,1290,323,967,520,770,996,9.96135402120164,14.2207363040943,0.413086213427028,31
"399","PA","Belém",1499641,21191.47,15007,"Belém",1,"Norte",1,"150140",4,1034,262,772,456,578,11,5,6,7,4,1045,267,778,463,582,2229,9.96135402120164,14.2207363040943,0.510919245493658,30
"400","PA","Belém",1499641,21191.47,15007,"Belém",1,"Norte",1,"150140",5,1207,287,920,481,726,15,9,6,9,6,1222,296,926,490,732,2520,9.96135402120164,14.2207363040943,0.516164779313101,31
"401","PA","Belterra",17839,9032.66,15002,"Santarém",1,"Norte",0,"150145",2,23,7,16,12,11,0,0,0,0,0,23,7,16,12,11,10,9.10860217667615,9.78914235075127,0.294850412060522,29
"402","PA","Belterra",17839,9032.66,15002,"Santarém",1,"Norte",0,"150145",3,26,17,9,14,12,0,0,0,0,0,26,17,9,14,12,12,9.10860217667615,9.78914235075127,0.388981100564168,31
"403","PA","Belterra",17839,9032.66,15002,"Santarém",1,"Norte",0,"150145",4,15,2,13,9,6,0,0,0,0,0,15,2,13,9,6,7,9.10860217667615,9.78914235075127,0.423108159091184,30
"404","PA","Belterra",17839,9032.66,15002,"Santarém",1,"Norte",0,"150145",5,15,3,12,8,7,0,0,0,0,0,15,3,12,8,7,17,9.10860217667615,9.78914235075127,0.440748112425419,31
"405","PA","Benevides",63768,25772.35,15007,"Belém",1,"Norte",1,"150150",2,54,16,38,29,25,0,0,0,0,0,54,16,38,29,25,27,10.1570574907965,11.0630067761078,0.312089920342077,29
"406","PA","Benevides",63768,25772.35,15007,"Belém",1,"Norte",1,"150150",3,56,20,36,30,26,2,1,1,1,1,58,21,37,31,27,31,10.1570574907965,11.0630067761078,0.399172677576308,31
"407","PA","Benevides",63768,25772.35,15007,"Belém",1,"Norte",1,"150150",4,56,22,34,31,25,0,0,0,0,0,56,22,34,31,25,49,10.1570574907965,11.0630067761078,0.466989586163332,30
"408","PA","Benevides",63768,25772.35,15007,"Belém",1,"Norte",1,"150150",5,57,16,41,28,29,0,0,0,0,0,57,16,41,28,29,62,10.1570574907965,11.0630067761078,0.478212218949961,31
"409","PA","Bom Jesus do Tocantins",17118,10451.71,15017,"Paragominas",1,"Norte",0,"150157",2,31,8,23,11,20,1,1,0,1,0,32,9,23,12,20,10,9.25452088036962,9.74788582044155,0.27052353173888,29
"410","PA","Bom Jesus do Tocantins",17118,10451.71,15017,"Paragominas",1,"Norte",0,"150157",3,23,7,16,15,8,1,0,1,0,1,24,7,17,15,9,11,9.25452088036962,9.74788582044155,0.314368094724826,31
"411","PA","Bom Jesus do Tocantins",17118,10451.71,15017,"Paragominas",1,"Norte",0,"150157",4,30,14,16,19,11,0,0,0,0,0,30,14,16,19,11,2,9.25452088036962,9.74788582044155,0.378613189961828,30
"412","PA","Bom Jesus do Tocantins",17118,10451.71,15017,"Paragominas",1,"Norte",0,"150157",5,21,11,10,13,8,0,0,0,0,0,21,11,10,13,8,8,9.25452088036962,9.74788582044155,0.381411206586173,31
"413","PA","Bragança",128914,8920.18,15010,"Bragantina",1,"Norte",1,"150170",2,143,61,82,78,65,1,0,1,1,0,144,61,83,79,65,67,9.09607140474265,11.7669007943561,0.315933510493444,29
"414","PA","Bragança",128914,8920.18,15010,"Bragantina",1,"Norte",1,"150170",3,140,51,89,87,53,3,3,0,3,0,143,54,89,90,53,61,9.09607140474265,11.7669007943561,0.409423231173295,31
"415","PA","Bragança",128914,8920.18,15010,"Bragantina",1,"Norte",1,"150170",4,113,38,75,63,50,2,1,1,1,1,115,39,76,64,51,78,9.09607140474265,11.7669007943561,0.484916075317793,30
"416","PA","Bragança",128914,8920.18,15010,"Bragantina",1,"Norte",1,"150170",5,141,67,74,79,62,1,1,0,1,0,142,68,74,80,62,186,9.09607140474265,11.7669007943561,0.510770080008904,31
"417","PA","Brasil Novo",14983,16581.6,15015,"Altamira",1,"Norte",0,"150172",2,29,11,18,14,15,0,0,0,0,0,29,11,18,14,15,5,9.71604892584269,9.61467150404314,0.282132793354877,29
"418","PA","Brasil Novo",14983,16581.6,15015,"Altamira",1,"Norte",0,"150172",3,31,13,18,15,16,0,0,0,0,0,31,13,18,15,16,16,9.71604892584269,9.61467150404314,0.357478991899518,31
"419","PA","Brasil Novo",14983,16581.6,15015,"Altamira",1,"Norte",0,"150172",4,19,9,10,7,12,0,0,0,0,0,19,9,10,7,12,12,9.71604892584269,9.61467150404314,0.357950683605375,30
"420","PA","Brasil Novo",14983,16581.6,15015,"Altamira",1,"Norte",0,"150172",5,24,11,13,14,10,0,0,0,0,0,24,11,13,14,10,14,9.71604892584269,9.61467150404314,0.388916030633984,31
"421","PA","Breu Branco",67332,8800.88,15016,"Tucuruí",1,"Norte",1,"150178",2,58,29,29,31,27,0,0,0,0,0,58,29,29,31,27,17,9.08260699546663,11.117390885539,0.315850002802319,29
"422","PA","Breu Branco",67332,8800.88,15016,"Tucuruí",1,"Norte",1,"150178",3,61,24,37,40,21,1,0,1,1,0,62,24,38,41,21,24,9.08260699546663,11.117390885539,0.389797212305217,31
"423","PA","Breu Branco",67332,8800.88,15016,"Tucuruí",1,"Norte",1,"150178",4,47,15,32,27,20,0,0,0,0,0,47,15,32,27,20,22,9.08260699546663,11.117390885539,0.394506052621277,30
"424","PA","Breu Branco",67332,8800.88,15016,"Tucuruí",1,"Norte",1,"150178",5,61,37,24,42,19,0,0,0,0,0,61,37,24,42,19,36,9.08260699546663,11.117390885539,0.419977307679982,31
"425","PA","Breves",103497,7986.65,15005,"Furos de Breves",1,"Norte",1,"150180",2,231,168,63,113,118,2,2,0,2,0,233,170,63,115,118,29,8.98552667674775,11.5472979057602,0.299180627073605,29
"426","PA","Breves",103497,7986.65,15005,"Furos de Breves",1,"Norte",1,"150180",3,225,149,76,110,115,3,2,1,3,0,228,151,77,113,115,27,8.98552667674775,11.5472979057602,0.39557261641565,31
"427","PA","Breves",103497,7986.65,15005,"Furos de Breves",1,"Norte",1,"150180",4,174,113,61,95,79,1,1,0,1,0,175,114,61,96,79,37,8.98552667674775,11.5472979057602,0.473981024542254,30
"428","PA","Breves",103497,7986.65,15005,"Furos de Breves",1,"Norte",1,"150180",5,182,118,64,92,90,3,1,2,1,2,185,119,66,93,92,75,8.98552667674775,11.5472979057602,0.56678384285281,31
"429","PA","Bujaru",29427,15721.51,15008,"Castanhal",1,"Norte",0,"150190",2,35,13,22,18,17,0,0,0,0,0,35,13,22,18,17,13,9.66278511734976,10.2896678992324,0.351993524028983,29
"430","PA","Bujaru",29427,15721.51,15008,"Castanhal",1,"Norte",0,"150190",3,26,10,16,13,13,0,0,0,0,0,26,10,16,13,13,10,9.66278511734976,10.2896678992324,0.420970033660153,31
"431","PA","Bujaru",29427,15721.51,15008,"Castanhal",1,"Norte",0,"150190",4,19,12,7,13,6,0,0,0,0,0,19,12,7,13,6,10,9.66278511734976,10.2896678992324,0.458754250818981,30
"432","PA","Bujaru",29427,15721.51,15008,"Castanhal",1,"Norte",0,"150190",5,41,17,24,26,15,1,0,1,0,1,42,17,25,26,16,21,9.66278511734976,10.2896678992324,0.523397389139518,31
"433","PA","Cachoeira do Piriá",34609,5408.39,15013,"Guamá",1,"Norte",0,"150195",2,22,17,5,15,7,0,0,0,0,0,22,17,5,15,7,4,8.59570673050723,10.4518690428286,0.32149204396645,29
"434","PA","Cachoeira do Piriá",34609,5408.39,15013,"Guamá",1,"Norte",0,"150195",3,20,12,8,14,6,0,0,0,0,0,20,12,8,14,6,6,8.59570673050723,10.4518690428286,0.469151809349026,31
"435","PA","Cachoeira do Piriá",34609,5408.39,15013,"Guamá",1,"Norte",0,"150195",4,15,10,5,8,7,1,1,0,0,1,16,11,5,8,8,3,8.59570673050723,10.4518690428286,0.463454459392821,30
"436","PA","Cachoeira do Piriá",34609,5408.39,15013,"Guamá",1,"Norte",0,"150195",5,24,16,8,17,7,1,1,0,0,1,25,17,8,17,8,5,8.59570673050723,10.4518690428286,0.508728851282635,31
"437","PA","Cachoeira do Arari",24064,7811.71,15006,"Arari",1,"Norte",0,"150200",2,31,17,14,18,13,1,1,0,1,0,32,18,14,19,13,4,8.96337916893168,10.0884722267496,0.378071625830929,29
"438","PA","Cachoeira do Arari",24064,7811.71,15006,"Arari",1,"Norte",0,"150200",3,30,17,13,21,9,0,0,0,0,0,30,17,13,21,9,6,8.96337916893168,10.0884722267496,0.462155547021105,31
"439","PA","Cachoeira do Arari",24064,7811.71,15006,"Arari",1,"Norte",0,"150200",4,14,8,6,9,5,0,0,0,0,0,14,8,6,9,5,3,8.96337916893168,10.0884722267496,0.482726120146444,30
"440","PA","Cachoeira do Arari",24064,7811.71,15006,"Arari",1,"Norte",0,"150200",5,21,13,8,12,9,0,0,0,0,0,21,13,8,12,9,19,8.96337916893168,10.0884722267496,0.544690421806925,31
"441","PA","Cametá",139364,8333.51,15011,"Cametá",1,"Norte",1,"150210",2,196,82,114,115,81,1,1,0,0,1,197,83,114,115,82,38,9.02804001495751,11.8448444943151,0.307985602855247,29
"442","PA","Cametá",139364,8333.51,15011,"Cametá",1,"Norte",1,"150210",3,188,88,100,102,86,4,2,2,1,3,192,90,102,103,89,47,9.02804001495751,11.8448444943151,0.411728969299501,31
"443","PA","Cametá",139364,8333.51,15011,"Cametá",1,"Norte",1,"150210",4,160,59,101,86,74,1,0,1,0,1,161,59,102,86,75,38,9.02804001495751,11.8448444943151,0.502643331324434,30
"444","PA","Cametá",139364,8333.51,15011,"Cametá",1,"Norte",1,"150210",5,172,70,102,96,76,2,0,2,1,1,174,70,104,97,77,103,9.02804001495751,11.8448444943151,0.527102786625405,31
"445","PA","Canaã dos Carajás",38103,197137.69,15019,"Parauapebas",1,"Norte",0,"150215",2,101,27,74,61,40,1,1,0,1,0,102,28,74,62,40,10,12.1916576975897,10.5480482981724,0.287568744178999,29
"446","PA","Canaã dos Carajás",38103,197137.69,15019,"Parauapebas",1,"Norte",0,"150215",3,120,36,84,66,54,0,0,0,0,0,120,36,84,66,54,25,12.1916576975897,10.5480482981724,0.351258150315785,31
"447","PA","Canaã dos Carajás",38103,197137.69,15019,"Parauapebas",1,"Norte",0,"150215",4,78,22,56,36,42,1,0,1,1,0,79,22,57,37,42,16,12.1916576975897,10.5480482981724,0.392890847606284,30
"448","PA","Canaã dos Carajás",38103,197137.69,15019,"Parauapebas",1,"Norte",0,"150215",5,106,36,70,52,54,0,0,0,0,0,106,36,70,52,54,25,12.1916576975897,10.5480482981724,0.426227714820839,31
"449","PA","Capanema",69431,14974.3,15010,"Bragantina",1,"Norte",1,"150220",2,69,11,58,29,40,0,0,0,0,0,69,11,58,29,40,31,9.6140906773168,11.1480887326394,0.308639447313259,29
"450","PA","Capanema",69431,14974.3,15010,"Bragantina",1,"Norte",1,"150220",3,93,26,67,37,56,0,0,0,0,0,93,26,67,37,56,39,9.6140906773168,11.1480887326394,0.3969884476643,31
"451","PA","Capanema",69431,14974.3,15010,"Bragantina",1,"Norte",1,"150220",4,50,14,36,22,28,0,0,0,0,0,50,14,36,22,28,43,9.6140906773168,11.1480887326394,0.448339739902278,30
"452","PA","Capanema",69431,14974.3,15010,"Bragantina",1,"Norte",1,"150220",5,58,15,43,30,28,0,0,0,0,0,58,15,43,30,28,105,9.6140906773168,11.1480887326394,0.465420781647539,31
"453","PA","Capitão Poço",54425,9217.63,15013,"Guamá",1,"Norte",0,"150230",2,63,25,38,34,29,0,0,0,0,0,63,25,38,34,29,27,9.12887323361611,10.9045788861027,0.304659149755762,29
"454","PA","Capitão Poço",54425,9217.63,15013,"Guamá",1,"Norte",0,"150230",3,72,36,36,43,29,1,1,0,0,1,73,37,36,43,30,20,9.12887323361611,10.9045788861027,0.372742404342204,31
"455","PA","Capitão Poço",54425,9217.63,15013,"Guamá",1,"Norte",0,"150230",4,57,24,33,27,30,0,0,0,0,0,57,24,33,27,30,27,9.12887323361611,10.9045788861027,0.423887762345966,30
"456","PA","Capitão Poço",54425,9217.63,15013,"Guamá",1,"Norte",0,"150230",5,48,23,25,27,21,2,1,1,1,1,50,24,26,28,22,46,9.12887323361611,10.9045788861027,0.453525865441303,31
"457","PA","Castanhal",203251,19728.13,15008,"Castanhal",1,"Norte",1,"150240",2,252,67,185,122,130,2,1,1,0,2,254,68,186,122,132,82,9.88980081500123,12.2221969474472,0.299829259238867,29
"458","PA","Castanhal",203251,19728.13,15008,"Castanhal",1,"Norte",1,"150240",3,253,84,169,123,130,3,3,0,3,0,256,87,169,126,130,124,9.88980081500123,12.2221969474472,0.391130421629495,31
"459","PA","Castanhal",203251,19728.13,15008,"Castanhal",1,"Norte",1,"150240",4,210,58,152,100,110,1,0,1,0,1,211,58,153,100,111,126,9.88980081500123,12.2221969474472,0.454689851116956,30
"460","PA","Castanhal",203251,19728.13,15008,"Castanhal",1,"Norte",1,"150240",5,228,58,170,106,122,2,1,1,0,2,230,59,171,106,124,311,9.88980081500123,12.2221969474472,0.486495244509431,31
"461","PA","Conceição do Araguaia",47991,11577.95,15022,"Conceição do Araguaia",1,"Norte",1,"150270",2,54,8,46,26,28,1,1,0,1,0,55,9,46,27,28,25,9.35685770609447,10.7787687723097,0.289951621895693,29
"462","PA","Conceição do Araguaia",47991,11577.95,15022,"Conceição do Araguaia",1,"Norte",1,"150270",3,55,7,48,34,21,0,0,0,0,0,55,7,48,34,21,17,9.35685770609447,10.7787687723097,0.35853793192293,31
"463","PA","Conceição do Araguaia",47991,11577.95,15022,"Conceição do Araguaia",1,"Norte",1,"150270",4,48,12,36,27,21,0,0,0,0,0,48,12,36,27,21,20,9.35685770609447,10.7787687723097,0.38402487827687,30
"464","PA","Conceição do Araguaia",47991,11577.95,15022,"Conceição do Araguaia",1,"Norte",1,"150270",5,50,9,41,27,23,2,0,2,1,1,52,9,43,28,24,25,9.35685770609447,10.7787687723097,0.387850190908135,31
"465","PA","Concórdia do Pará",33781,8940.13,15012,"Tomé-Açu",1,"Norte",0,"150275",2,28,10,18,15,13,0,0,0,0,0,28,10,18,15,13,10,9.09830540944886,10.4276537932392,0.282950385786335,29
"466","PA","Concórdia do Pará",33781,8940.13,15012,"Tomé-Açu",1,"Norte",0,"150275",3,44,21,23,22,22,0,0,0,0,0,44,21,23,22,22,6,9.09830540944886,10.4276537932392,0.349253217752774,31
"467","PA","Concórdia do Pará",33781,8940.13,15012,"Tomé-Açu",1,"Norte",0,"150275",4,32,20,12,14,18,1,1,0,1,0,33,21,12,15,18,14,9.09830540944886,10.4276537932392,0.400870933336964,30
"468","PA","Concórdia do Pará",33781,8940.13,15012,"Tomé-Açu",1,"Norte",0,"150275",5,42,20,22,30,12,0,0,0,0,0,42,20,22,30,12,19,9.09830540944886,10.4276537932392,0.412899960418737,31
"469","PA","Curionópolis",17846,45532.54,15019,"Parauapebas",1,"Norte",1,"150277",2,23,10,13,9,14,0,0,0,0,0,23,10,13,9,14,10,10.7261825141657,9.7895346724601,0.27429029068492,29
"470","PA","Curionópolis",17846,45532.54,15019,"Parauapebas",1,"Norte",1,"150277",3,26,11,15,17,9,0,0,0,0,0,26,11,15,17,9,19,10.7261825141657,9.7895346724601,0.329504899035302,31
"471","PA","Curionópolis",17846,45532.54,15019,"Parauapebas",1,"Norte",1,"150277",4,19,3,16,10,9,0,0,0,0,0,19,3,16,10,9,9,10.7261825141657,9.7895346724601,0.365456272507227,30
"472","PA","Curionópolis",17846,45532.54,15019,"Parauapebas",1,"Norte",1,"150277",5,24,8,16,9,15,0,0,0,0,0,24,8,16,9,15,21,10.7261825141657,9.7895346724601,0.389395174688803,31
"473","PA","Curralinho",34994,14591.11,15005,"Furos de Breves",1,"Norte",0,"150280",2,46,30,16,30,16,0,0,0,0,0,46,30,16,30,16,6,9.58816771812944,10.4629318972046,0.343375836734331,29
"474","PA","Curralinho",34994,14591.11,15005,"Furos de Breves",1,"Norte",0,"150280",3,40,25,15,26,14,3,1,2,2,1,43,26,17,28,15,8,9.58816771812944,10.4629318972046,0.393373317931777,31
"475","PA","Curralinho",34994,14591.11,15005,"Furos de Breves",1,"Norte",0,"150280",4,50,32,18,30,20,1,1,0,0,1,51,33,18,30,21,7,9.58816771812944,10.4629318972046,0.458715319476168,30
"476","PA","Curralinho",34994,14591.11,15005,"Furos de Breves",1,"Norte",0,"150280",5,34,21,13,19,15,0,0,0,0,0,34,21,13,19,15,9,9.58816771812944,10.4629318972046,0.534171967553442,31
"477","PA","Curuçá",40584,7355.01,15009,"Salgado",1,"Norte",0,"150290",2,32,9,23,11,21,0,0,0,0,0,32,9,23,11,21,16,8.90313699265392,10.6111291792465,0.320770608096927,29
"478","PA","Curuçá",40584,7355.01,15009,"Salgado",1,"Norte",0,"150290",3,43,20,23,24,19,0,0,0,0,0,43,20,23,24,19,23,8.90313699265392,10.6111291792465,0.389570717114772,31
"479","PA","Curuçá",40584,7355.01,15009,"Salgado",1,"Norte",0,"150290",4,36,16,20,19,17,0,0,0,0,0,36,16,20,19,17,33,8.90313699265392,10.6111291792465,0.458197032411159,30
"480","PA","Curuçá",40584,7355.01,15009,"Salgado",1,"Norte",0,"150290",5,31,9,22,19,12,0,0,0,0,0,31,9,22,19,12,64,8.90313699265392,10.6111291792465,0.481266131135414,31
"481","PA","Dom Eliseu",60469,11626.49,15017,"Paragominas",1,"Norte",1,"150293",2,50,22,28,24,26,0,0,0,0,0,50,22,28,24,26,18,9.36104139428523,11.0098861160047,0.287492375064073,29
"482","PA","Dom Eliseu",60469,11626.49,15017,"Paragominas",1,"Norte",1,"150293",3,46,22,24,23,23,0,0,0,0,0,46,22,24,23,23,20,9.36104139428523,11.0098861160047,0.372940814785118,31
"483","PA","Dom Eliseu",60469,11626.49,15017,"Paragominas",1,"Norte",1,"150293",4,45,14,31,22,23,2,0,2,0,2,47,14,33,22,25,20,9.36104139428523,11.0098861160047,0.401882746347123,30
"484","PA","Dom Eliseu",60469,11626.49,15017,"Paragominas",1,"Norte",1,"150293",5,57,25,32,35,22,0,0,0,0,0,57,25,32,35,22,27,9.36104139428523,11.0098861160047,0.413807177583482,31
"485","PA","Eldorado do Carajás",33940,11216.38,15019,"Parauapebas",1,"Norte",0,"150295",2,32,12,20,17,15,0,0,0,0,0,32,12,20,17,15,3,9.32513048887163,10.4323495387882,0.296682012699125,29
"486","PA","Eldorado do Carajás",33940,11216.38,15019,"Parauapebas",1,"Norte",0,"150295",3,42,22,20,28,14,0,0,0,0,0,42,22,20,28,14,15,9.32513048887163,10.4323495387882,0.356728608452483,31
"487","PA","Eldorado do Carajás",33940,11216.38,15019,"Parauapebas",1,"Norte",0,"150295",4,35,14,21,22,13,0,0,0,0,0,35,14,21,22,13,11,9.32513048887163,10.4323495387882,0.375833231353575,30
"488","PA","Eldorado do Carajás",33940,11216.38,15019,"Parauapebas",1,"Norte",0,"150295",5,36,20,16,21,15,0,0,0,0,0,36,20,16,21,15,19,9.32513048887163,10.4323495387882,0.411087082799308,31
"489","PA","Floresta do Araguaia",20525,16942.98,15022,"Conceição do Araguaia",1,"Norte",0,"150304",2,19,4,15,13,6,0,0,0,0,0,19,4,15,13,6,9,9.73760886772891,9.92939893432063,0.302119932436926,29
"490","PA","Floresta do Araguaia",20525,16942.98,15022,"Conceição do Araguaia",1,"Norte",0,"150304",3,16,8,8,10,6,0,0,0,0,0,16,8,8,10,6,12,9.73760886772891,9.92939893432063,0.384253980731037,31
"491","PA","Floresta do Araguaia",20525,16942.98,15022,"Conceição do Araguaia",1,"Norte",0,"150304",4,22,9,13,13,9,0,0,0,0,0,22,9,13,13,9,6,9.73760886772891,9.92939893432063,0.392107046374242,30
"492","PA","Floresta do Araguaia",20525,16942.98,15022,"Conceição do Araguaia",1,"Norte",0,"150304",5,28,11,17,17,11,0,0,0,0,0,28,11,17,17,11,10,9.73760886772891,9.92939893432063,0.393394769504096,31
"493","PA","Garrafão do Norte",26111,8407.2,15013,"Guamá",1,"Norte",0,"150307",2,38,22,16,15,23,0,0,0,0,0,38,22,16,15,23,10,9.03684376055139,10.1701119604619,0.315655923120553,29
"494","PA","Garrafão do Norte",26111,8407.2,15013,"Guamá",1,"Norte",0,"150307",3,47,26,21,26,21,0,0,0,0,0,47,26,21,26,21,10,9.03684376055139,10.1701119604619,0.386124611520868,31
"495","PA","Garrafão do Norte",26111,8407.2,15013,"Guamá",1,"Norte",0,"150307",4,38,21,17,23,15,1,1,0,0,1,39,22,17,23,16,11,9.03684376055139,10.1701119604619,0.402974688208494,30
"496","PA","Garrafão do Norte",26111,8407.2,15013,"Guamá",1,"Norte",0,"150307",5,29,14,15,18,11,2,1,1,2,0,31,15,16,20,11,20,9.03684376055139,10.1701119604619,0.460839407857274,31
"497","PA","Goianésia do Pará",41081,8517.09,15017,"Paragominas",1,"Norte",0,"150309",2,50,23,27,34,16,2,0,2,0,2,52,23,29,34,18,11,9.04983001218634,10.6233010064921,0.256042969909697,29
"498","PA","Goianésia do Pará",41081,8517.09,15017,"Paragominas",1,"Norte",0,"150309",3,47,22,25,31,16,1,1,0,1,0,48,23,25,32,16,7,9.04983001218634,10.6233010064921,0.335416430276699,31
"499","PA","Goianésia do Pará",41081,8517.09,15017,"Paragominas",1,"Norte",0,"150309",4,32,13,19,19,13,1,0,1,1,0,33,13,20,20,13,12,9.04983001218634,10.6233010064921,0.344175954046982,30
"500","PA","Goianésia do Pará",41081,8517.09,15017,"Paragominas",1,"Norte",0,"150309",5,51,28,23,27,24,0,0,0,0,0,51,28,23,27,24,19,9.04983001218634,10.6233010064921,0.363365030194572,31
"501","PA","Gurupá",33755,8176.92,15004,"Portel",1,"Norte",0,"150310",2,51,34,17,26,25,1,1,0,0,1,52,35,17,26,26,7,9.00907083057492,10.426883833476,0.342695920708265,29
"502","PA","Gurupá",33755,8176.92,15004,"Portel",1,"Norte",0,"150310",3,62,38,24,32,30,0,0,0,0,0,62,38,24,32,30,7,9.00907083057492,10.426883833476,0.404514741219909,31
"503","PA","Gurupá",33755,8176.92,15004,"Portel",1,"Norte",0,"150310",4,58,43,15,25,33,1,0,1,0,1,59,43,16,25,34,7,9.00907083057492,10.426883833476,0.431069569253435,30
"504","PA","Gurupá",33755,8176.92,15004,"Portel",1,"Norte",0,"150310",5,55,32,23,32,23,1,0,1,1,0,56,32,24,33,23,14,9.00907083057492,10.426883833476,0.553478780072531,31
"505","PA","Igarapé-Açu",39023,9202.31,15010,"Bragantina",1,"Norte",0,"150320",2,45,21,24,24,21,1,1,0,1,0,46,22,24,25,21,15,9.1272098184766,10.5719064948711,0.300983875551696,29
"506","PA","Igarapé-Açu",39023,9202.31,15010,"Bragantina",1,"Norte",0,"150320",3,43,16,27,21,22,0,0,0,0,0,43,16,27,21,22,30,9.1272098184766,10.5719064948711,0.39221561114786,31
"507","PA","Igarapé-Açu",39023,9202.31,15010,"Bragantina",1,"Norte",0,"150320",4,30,11,19,15,15,0,0,0,0,0,30,11,19,15,15,21,9.1272098184766,10.5719064948711,0.447788851807996,30
"508","PA","Igarapé-Açu",39023,9202.31,15010,"Bragantina",1,"Norte",0,"150320",5,39,11,28,22,17,1,0,1,1,0,40,11,29,23,17,46,9.1272098184766,10.5719064948711,0.477929954880275,31
"509","PA","Igarapé-Miri",63036,6251.33,15011,"Cametá",1,"Norte",0,"150330",2,87,45,42,48,39,0,0,0,0,0,87,45,42,48,39,15,8.74054952009174,11.051461270742,0.295118148812136,29
"510","PA","Igarapé-Miri",63036,6251.33,15011,"Cametá",1,"Norte",0,"150330",3,76,41,35,49,27,1,0,1,0,1,77,41,36,49,28,21,8.74054952009174,11.051461270742,0.358242167449293,31
"511","PA","Igarapé-Miri",63036,6251.33,15011,"Cametá",1,"Norte",0,"150330",4,72,35,37,44,28,1,1,0,0,1,73,36,37,44,29,30,8.74054952009174,11.051461270742,0.448190876128813,30
"512","PA","Igarapé-Miri",63036,6251.33,15011,"Cametá",1,"Norte",0,"150330",5,73,33,40,42,31,0,0,0,0,0,73,33,40,42,31,64,8.74054952009174,11.051461270742,0.523327141930893,31
"513","PA","Ipixuna do Pará",65625,8311.48,15013,"Guamá",1,"Norte",0,"150345",2,46,21,25,26,20,1,1,0,1,0,47,22,25,27,20,12,9.0253929706681,11.0917119998939,0.294235018135479,29
"514","PA","Ipixuna do Pará",65625,8311.48,15013,"Guamá",1,"Norte",0,"150345",3,40,21,19,18,22,0,0,0,0,0,40,21,19,18,22,13,9.0253929706681,11.0917119998939,0.373185825610325,31
"515","PA","Ipixuna do Pará",65625,8311.48,15013,"Guamá",1,"Norte",0,"150345",4,40,14,26,28,12,0,0,0,0,0,40,14,26,28,12,16,9.0253929706681,11.0917119998939,0.433818674506311,30
"516","PA","Ipixuna do Pará",65625,8311.48,15013,"Guamá",1,"Norte",0,"150345",5,44,23,21,30,14,1,0,1,1,0,45,23,22,31,14,30,9.0253929706681,11.0917119998939,0.47567481435633,31
"517","PA","Irituia",32595,6568.83,15013,"Guamá",1,"Norte",0,"150350",2,27,10,17,17,10,0,0,0,0,0,27,10,17,17,10,16,8.79009101342836,10.3919141813586,0.286193613963555,29
"518","PA","Irituia",32595,6568.83,15013,"Guamá",1,"Norte",0,"150350",3,39,21,18,19,20,0,0,0,0,0,39,21,18,19,20,14,8.79009101342836,10.3919141813586,0.364111064103156,31
"519","PA","Irituia",32595,6568.83,15013,"Guamá",1,"Norte",0,"150350",4,35,16,19,20,15,1,1,0,0,1,36,17,19,20,16,18,8.79009101342836,10.3919141813586,0.43705608864754,30
"520","PA","Irituia",32595,6568.83,15013,"Guamá",1,"Norte",0,"150350",5,36,14,22,18,18,2,2,0,1,1,38,16,22,19,19,21,8.79009101342836,10.3919141813586,0.509356544316428,31
"521","PA","Itaituba",101395,17949.27,15014,"Itaituba",1,"Norte",1,"150360",2,218,76,142,132,86,2,0,2,0,2,220,76,144,132,88,46,9.79530472456576,11.5267790592588,0.308303167270108,29
"522","PA","Itaituba",101395,17949.27,15014,"Itaituba",1,"Norte",1,"150360",3,190,73,117,110,80,3,0,3,1,2,193,73,120,111,82,73,9.79530472456576,11.5267790592588,0.370396705775488,31
"523","PA","Itaituba",101395,17949.27,15014,"Itaituba",1,"Norte",1,"150360",4,164,59,105,94,70,3,1,2,1,2,167,60,107,95,72,58,9.79530472456576,11.5267790592588,0.403303920348516,30
"524","PA","Itaituba",101395,17949.27,15014,"Itaituba",1,"Norte",1,"150360",5,195,85,110,120,75,2,0,2,0,2,197,85,112,120,77,84,9.79530472456576,11.5267790592588,0.421153316562189,31
"525","PA","Itupiranga",53355,9760.03,15016,"Tucuruí",1,"Norte",1,"150370",2,60,25,35,36,24,0,0,0,0,0,60,25,35,36,24,16,9.18605075317291,10.8847229730507,0.287536983720933,29
"526","PA","Itupiranga",53355,9760.03,15016,"Tucuruí",1,"Norte",1,"150370",3,60,31,29,33,27,0,0,0,0,0,60,31,29,33,27,24,9.18605075317291,10.8847229730507,0.361064009831383,31
"527","PA","Itupiranga",53355,9760.03,15016,"Tucuruí",1,"Norte",1,"150370",4,49,20,29,27,22,0,0,0,0,0,49,20,29,27,22,26,9.18605075317291,10.8847229730507,0.402795538030817,30
"528","PA","Itupiranga",53355,9760.03,15016,"Tucuruí",1,"Norte",1,"150370",5,52,19,33,32,20,0,0,0,0,0,52,19,33,32,20,27,9.18605075317291,10.8847229730507,0.414687733053964,31
"529","PA","Jacareacanga",7590,51864.99,15014,"Itaituba",1,"Norte",0,"150375",2,59,36,23,35,24,1,1,0,0,1,60,37,23,35,25,5,10.8563992750577,8.93458687038968,0.326128262893454,29
"530","PA","Jacareacanga",7590,51864.99,15014,"Itaituba",1,"Norte",0,"150375",3,39,25,14,25,14,0,0,0,0,0,39,25,14,25,14,8,10.8563992750577,8.93458687038968,0.399713980587955,31
"531","PA","Jacareacanga",7590,51864.99,15014,"Itaituba",1,"Norte",0,"150375",4,22,13,9,16,6,0,0,0,0,0,22,13,9,16,6,5,10.8563992750577,8.93458687038968,0.400097633922869,30
"532","PA","Jacareacanga",7590,51864.99,15014,"Itaituba",1,"Norte",0,"150375",5,24,17,7,12,12,2,1,1,2,0,26,18,8,14,12,12,10.8563992750577,8.93458687038968,0.453271088909721,31
"533","PA","Jacundá",59842,8283.6,15016,"Tucuruí",1,"Norte",1,"150380",2,62,26,36,33,29,2,1,1,0,2,64,27,37,33,31,29,9.02203293549743,10.9994630345497,0.27543596676875,29
"534","PA","Jacundá",59842,8283.6,15016,"Tucuruí",1,"Norte",1,"150380",3,61,30,31,40,21,1,0,1,0,1,62,30,32,40,22,23,9.02203293549743,10.9994630345497,0.348880620910563,31
"535","PA","Jacundá",59842,8283.6,15016,"Tucuruí",1,"Norte",1,"150380",4,47,13,34,28,19,0,0,0,0,0,47,13,34,28,19,24,9.02203293549743,10.9994630345497,0.372180343685294,30
"536","PA","Jacundá",59842,8283.6,15016,"Tucuruí",1,"Norte",1,"150380",5,49,19,30,21,28,1,0,1,1,0,50,19,31,22,28,29,9.02203293549743,10.9994630345497,0.362690863203282,31
"537","PA","Juruti",58960,17514.79,15001,"Óbidos",1,"Norte",0,"150390",2,83,35,48,47,36,2,1,1,0,2,85,36,49,47,38,14,9.77080094583662,10.9846145268632,0.258240573150753,29
"538","PA","Juruti",58960,17514.79,15001,"Óbidos",1,"Norte",0,"150390",3,80,28,52,40,40,2,0,2,1,1,82,28,54,41,41,12,9.77080094583662,10.9846145268632,0.329105463181544,31
"539","PA","Juruti",58960,17514.79,15001,"Óbidos",1,"Norte",0,"150390",4,84,31,53,43,41,2,0,2,0,2,86,31,55,43,43,22,9.77080094583662,10.9846145268632,0.399009262268872,30
"540","PA","Juruti",58960,17514.79,15001,"Óbidos",1,"Norte",0,"150390",5,94,41,53,55,39,1,0,1,1,0,95,41,54,56,39,45,9.77080094583662,10.9846145268632,0.400683366032385,31
"541","PA","Mãe do Rio",30235,9794.11,15013,"Guamá",1,"Norte",1,"150405",2,42,14,28,20,22,0,0,0,0,0,42,14,28,20,22,15,9.18953646356533,10.3167554727073,0.277355859180142,29
"542","PA","Mãe do Rio",30235,9794.11,15013,"Guamá",1,"Norte",1,"150405",3,51,16,35,24,27,2,0,2,0,2,53,16,37,24,29,23,9.18953646356533,10.3167554727073,0.341452081574569,31
"543","PA","Mãe do Rio",30235,9794.11,15013,"Guamá",1,"Norte",1,"150405",4,37,15,22,23,14,3,0,3,0,3,40,15,25,23,17,16,9.18953646356533,10.3167554727073,0.384564104522483,30
"544","PA","Mãe do Rio",30235,9794.11,15013,"Guamá",1,"Norte",1,"150405",5,34,13,21,18,16,0,0,0,0,0,34,13,21,18,16,29,9.18953646356533,10.3167554727073,0.436461605705676,31
"545","PA","Marabá",283542,31920.2,15020,"Marabá",1,"Norte",1,"150420",2,329,92,237,158,171,3,2,1,2,1,332,94,238,160,172,131,10.3709943172083,12.5551155393252,0.299799139387206,29
"546","PA","Marabá",283542,31920.2,15020,"Marabá",1,"Norte",1,"150420",3,368,101,267,150,218,1,1,0,0,1,369,102,267,150,219,133,10.3709943172083,12.5551155393252,0.374469933929352,31
"547","PA","Marabá",283542,31920.2,15020,"Marabá",1,"Norte",1,"150420",4,356,110,246,169,187,0,0,0,0,0,356,110,246,169,187,116,10.3709943172083,12.5551155393252,0.424270567019081,30
"548","PA","Marabá",283542,31920.2,15020,"Marabá",1,"Norte",1,"150420",5,311,104,207,153,158,1,1,0,1,0,312,105,207,154,158,261,10.3709943172083,12.5551155393252,0.433705556034256,31
"549","PA","Maracanã",29516,7971.52,15009,"Salgado",1,"Norte",0,"150430",2,28,10,18,14,14,0,0,0,0,0,28,10,18,14,14,9,8.98363046878236,10.2926877681783,0.333726512795661,29
"550","PA","Maracanã",29516,7971.52,15009,"Salgado",1,"Norte",0,"150430",3,31,11,20,18,13,0,0,0,0,0,31,11,20,18,13,8,8.98363046878236,10.2926877681783,0.413952843032703,31
"551","PA","Maracanã",29516,7971.52,15009,"Salgado",1,"Norte",0,"150430",4,23,10,13,11,12,0,0,0,0,0,23,10,13,11,12,15,8.98363046878236,10.2926877681783,0.456653113145955,30
"552","PA","Maracanã",29516,7971.52,15009,"Salgado",1,"Norte",0,"150430",5,27,13,14,12,15,0,0,0,0,0,27,13,14,12,15,42,8.98363046878236,10.2926877681783,0.528386549495627,31
"553","PA","Marapanim",28450,8311.98,15009,"Salgado",1,"Norte",0,"150440",2,18,7,11,11,7,0,0,0,0,0,18,7,11,11,7,14,9.0254531266164,10.2559034395545,0.328361205201362,29
"554","PA","Marapanim",28450,8311.98,15009,"Salgado",1,"Norte",0,"150440",3,13,8,5,10,3,0,0,0,0,0,13,8,5,10,3,15,9.0254531266164,10.2559034395545,0.409315464757327,31
"555","PA","Marapanim",28450,8311.98,15009,"Salgado",1,"Norte",0,"150440",4,18,8,10,12,6,0,0,0,0,0,18,8,10,12,6,12,9.0254531266164,10.2559034395545,0.470579961697402,30
"556","PA","Marapanim",28450,8311.98,15009,"Salgado",1,"Norte",0,"150440",5,23,10,13,10,13,0,0,0,0,0,23,10,13,10,13,33,9.0254531266164,10.2559034395545,0.523297534005768,31
"557","PA","Marituba",133685,14706.6,15007,"Belém",1,"Norte",1,"150442",2,96,25,71,50,46,0,0,0,0,0,96,25,71,50,46,41,9.59605165159749,11.8032415653227,0.300970389383999,29
"558","PA","Marituba",133685,14706.6,15007,"Belém",1,"Norte",1,"150442",3,96,23,73,52,44,0,0,0,0,0,96,23,73,52,44,68,9.59605165159749,11.8032415653227,0.384216591975682,31
"559","PA","Marituba",133685,14706.6,15007,"Belém",1,"Norte",1,"150442",4,115,23,92,55,60,0,0,0,0,0,115,23,92,55,60,92,9.59605165159749,11.8032415653227,0.458909466341396,30
"560","PA","Marituba",133685,14706.6,15007,"Belém",1,"Norte",1,"150442",5,118,37,81,67,51,1,0,1,0,1,119,37,82,67,52,130,9.59605165159749,11.8032415653227,0.466023755498243,31
"561","PA","Medicilândia",31975,19671.8,15015,"Altamira",1,"Norte",0,"150445",2,43,16,27,27,16,0,0,0,0,0,43,16,27,27,16,8,9.8869414171099,10.372709626447,0.318462405106621,29
"562","PA","Medicilândia",31975,19671.8,15015,"Altamira",1,"Norte",0,"150445",3,29,17,12,20,9,0,0,0,0,0,29,17,12,20,9,12,9.8869414171099,10.372709626447,0.385624751804111,31
"563","PA","Medicilândia",31975,19671.8,15015,"Altamira",1,"Norte",0,"150445",4,31,14,17,16,15,1,1,0,1,0,32,15,17,17,15,11,9.8869414171099,10.372709626447,0.40952633284413,30
"564","PA","Medicilândia",31975,19671.8,15015,"Altamira",1,"Norte",0,"150445",5,27,18,9,14,13,0,0,0,0,0,27,18,9,14,13,13,9.8869414171099,10.372709626447,0.452044516082564,31
"565","PA","Mocajuba",31530,9588.54,15011,"Cametá",1,"Norte",0,"150460",2,38,21,17,16,22,0,0,0,0,0,38,21,17,16,22,9,9.16832391436884,10.3586947525391,0.3059695865765,29
"566","PA","Mocajuba",31530,9588.54,15011,"Cametá",1,"Norte",0,"150460",3,40,22,18,23,17,0,0,0,0,0,40,22,18,23,17,13,9.16832391436884,10.3586947525391,0.392985901162211,31
"567","PA","Mocajuba",31530,9588.54,15011,"Cametá",1,"Norte",0,"150460",4,36,15,21,21,15,2,2,0,2,0,38,17,21,23,15,9,9.16832391436884,10.3586947525391,0.433199080100443,30
"568","PA","Mocajuba",31530,9588.54,15011,"Cametá",1,"Norte",0,"150460",5,41,14,27,28,13,0,0,0,0,0,41,14,27,28,13,34,9.16832391436884,10.3586947525391,0.48758489873576,31
"569","PA","Moju",83182,11653.36,15012,"Tomé-Açu",1,"Norte",0,"150470",2,84,30,54,53,31,0,0,0,0,0,84,30,54,53,31,26,9.36334982942826,11.3287862572492,0.329887746521302,29
"570","PA","Moju",83182,11653.36,15012,"Tomé-Açu",1,"Norte",0,"150470",3,83,39,44,44,39,2,2,0,0,2,85,41,44,44,41,33,9.36334982942826,11.3287862572492,0.406961168491271,31
"571","PA","Moju",83182,11653.36,15012,"Tomé-Açu",1,"Norte",0,"150470",4,75,32,43,46,29,2,1,1,2,0,77,33,44,48,29,35,9.36334982942826,11.3287862572492,0.451257360150357,30
"572","PA","Moju",83182,11653.36,15012,"Tomé-Açu",1,"Norte",0,"150470",5,85,31,54,55,30,2,1,1,1,1,87,32,55,56,31,68,9.36334982942826,11.3287862572492,0.504187184426424,31
"573","PA","Monte Alegre",58162,12455.01,15002,"Santarém",1,"Norte",1,"150480",2,81,38,43,42,39,1,0,1,0,1,82,38,44,42,40,21,9.42987823058636,10.9709874995116,0.276161382967249,29
"574","PA","Monte Alegre",58162,12455.01,15002,"Santarém",1,"Norte",1,"150480",3,89,48,41,50,39,0,0,0,0,0,89,48,41,50,39,21,9.42987823058636,10.9709874995116,0.341829403797011,31
"575","PA","Monte Alegre",58162,12455.01,15002,"Santarém",1,"Norte",1,"150480",4,73,26,47,37,36,0,0,0,0,0,73,26,47,37,36,26,9.42987823058636,10.9709874995116,0.384788819519247,30
"576","PA","Monte Alegre",58162,12455.01,15002,"Santarém",1,"Norte",1,"150480",5,81,45,36,45,36,0,0,0,0,0,81,45,36,45,36,32,9.42987823058636,10.9709874995116,0.418352649476715,31
"577","PA","Muaná",40906,6472.59,15006,"Arari",1,"Norte",0,"150490",2,48,30,18,30,18,0,0,0,0,0,48,30,18,30,18,8,8.77533161651164,10.6190320305381,0.289449173679101,29
"578","PA","Muaná",40906,6472.59,15006,"Arari",1,"Norte",0,"150490",3,40,29,11,25,15,1,0,1,0,1,41,29,12,25,16,10,8.77533161651164,10.6190320305381,0.379712840129516,31
"579","PA","Muaná",40906,6472.59,15006,"Arari",1,"Norte",0,"150490",4,43,18,25,24,19,2,1,1,2,0,45,19,26,26,19,7,8.77533161651164,10.6190320305381,0.447136549818025,30
"580","PA","Muaná",40906,6472.59,15006,"Arari",1,"Norte",0,"150490",5,54,32,22,32,22,0,0,0,0,0,54,32,22,32,22,28,8.77533161651164,10.6190320305381,0.516188107886616,31
"581","PA","Nova Ipixuna",16854,8263.67,15016,"Tucuruí",1,"Norte",0,"150497",2,12,3,9,7,5,0,0,0,0,0,12,3,9,7,5,7,9.01962407776596,9.7323432963323,0.258248963982525,29
"582","PA","Nova Ipixuna",16854,8263.67,15016,"Tucuruí",1,"Norte",0,"150497",3,17,8,9,10,7,0,0,0,0,0,17,8,9,10,7,4,9.01962407776596,9.7323432963323,0.343828111797567,31
"583","PA","Nova Ipixuna",16854,8263.67,15016,"Tucuruí",1,"Norte",0,"150497",4,10,5,5,6,4,1,1,0,1,0,11,6,5,7,4,4,9.01962407776596,9.7323432963323,0.388381654597828,30
"584","PA","Nova Ipixuna",16854,8263.67,15016,"Tucuruí",1,"Norte",0,"150497",5,16,6,10,6,10,0,0,0,0,0,16,6,10,6,10,8,9.01962407776596,9.7323432963323,0.407590675152929,31
"585","PA","Nova Timboteua",15506,7801.32,15010,"Bragantina",1,"Norte",0,"150500",2,7,4,3,3,4,0,0,0,0,0,7,4,3,3,4,10,8.962048229129,9.6489823247789,0.331456810497448,29
"586","PA","Nova Timboteua",15506,7801.32,15010,"Bragantina",1,"Norte",0,"150500",3,15,2,13,3,12,0,0,0,0,0,15,2,13,3,12,5,8.962048229129,9.6489823247789,0.414352855512073,31
"587","PA","Nova Timboteua",15506,7801.32,15010,"Bragantina",1,"Norte",0,"150500",4,5,3,2,2,3,0,0,0,0,0,5,3,2,2,3,6,8.962048229129,9.6489823247789,0.457220859535397,30
"588","PA","Nova Timboteua",15506,7801.32,15010,"Bragantina",1,"Norte",0,"150500",5,10,5,5,6,4,0,0,0,0,0,10,5,5,6,4,9,8.962048229129,9.6489823247789,0.481224278001391,31
"589","PA","Novo Progresso",25766,22691.73,15014,"Itaituba",1,"Norte",0,"150503",2,57,26,31,37,20,0,0,0,0,0,57,26,31,37,20,12,10.0297558199093,10.1568110723515,0.334531115768999,29
"590","PA","Novo Progresso",25766,22691.73,15014,"Itaituba",1,"Norte",0,"150503",3,43,20,23,19,24,0,0,0,0,0,43,20,23,19,24,7,10.0297558199093,10.1568110723515,0.408846197158748,31
"591","PA","Novo Progresso",25766,22691.73,15014,"Itaituba",1,"Norte",0,"150503",4,54,25,29,31,23,0,0,0,0,0,54,25,29,31,23,14,10.0297558199093,10.1568110723515,0.408006557973348,30
"592","PA","Novo Progresso",25766,22691.73,15014,"Itaituba",1,"Norte",0,"150503",5,57,23,34,30,27,0,0,0,0,0,57,23,34,30,27,14,10.0297558199093,10.1568110723515,0.404865879428621,31
"593","PA","Novo Repartimento",77214,11449.04,15016,"Tucuruí",1,"Norte",0,"150506",2,109,58,51,68,41,0,0,0,0,0,109,58,51,68,41,25,9.34566116267262,11.2543360667217,0.275943495174821,29
"594","PA","Novo Repartimento",77214,11449.04,15016,"Tucuruí",1,"Norte",0,"150506",3,79,47,32,45,34,1,1,0,1,0,80,48,32,46,34,24,9.34566116267262,11.2543360667217,0.344912465192483,31
"595","PA","Novo Repartimento",77214,11449.04,15016,"Tucuruí",1,"Norte",0,"150506",4,92,47,45,62,30,0,0,0,0,0,92,47,45,62,30,31,9.34566116267262,11.2543360667217,0.36608057796042,30
"596","PA","Novo Repartimento",77214,11449.04,15016,"Tucuruí",1,"Norte",0,"150506",5,94,58,36,57,37,1,1,0,1,0,95,59,36,58,37,30,9.34566116267262,11.2543360667217,0.42403886654976,31
"597","PA","Óbidos",52306,12336.86,15001,"Óbidos",1,"Norte",1,"150510",2,84,35,49,42,42,3,2,1,1,2,87,37,50,43,44,17,9.42034680802945,10.8648663662262,0.297762323427808,29
"598","PA","Óbidos",52306,12336.86,15001,"Óbidos",1,"Norte",1,"150510",3,83,37,46,48,35,0,0,0,0,0,83,37,46,48,35,19,9.42034680802945,10.8648663662262,0.366233870309834,31
"599","PA","Óbidos",52306,12336.86,15001,"Óbidos",1,"Norte",1,"150510",4,56,21,35,29,27,0,0,0,0,0,56,21,35,29,27,19,9.42034680802945,10.8648663662262,0.409985522834874,30
"600","PA","Óbidos",52306,12336.86,15001,"Óbidos",1,"Norte",1,"150510",5,98,40,58,51,47,1,0,1,0,1,99,40,59,51,48,26,9.42034680802945,10.8648663662262,0.416478255491924,31
"601","PA","Oeiras do Pará",32850,12077.28,15011,"Cametá",1,"Norte",0,"150520",2,38,27,11,24,14,1,0,1,0,1,39,27,12,24,15,13,9.39908128057232,10.3997070239128,0.270027201848313,29
"602","PA","Oeiras do Pará",32850,12077.28,15011,"Cametá",1,"Norte",0,"150520",3,47,24,23,31,16,2,1,1,2,0,49,25,24,33,16,13,9.39908128057232,10.3997070239128,0.314280985887718,31
"603","PA","Oeiras do Pará",32850,12077.28,15011,"Cametá",1,"Norte",0,"150520",4,43,29,14,29,14,0,0,0,0,0,43,29,14,29,14,11,9.39908128057232,10.3997070239128,0.427882326573802,30
"604","PA","Oeiras do Pará",32850,12077.28,15011,"Cametá",1,"Norte",0,"150520",5,27,17,10,18,9,1,1,0,1,0,28,18,10,19,9,23,9.39908128057232,10.3997070239128,0.462538088395869,31
"605","PA","Oriximiná",74016,22543.08,15001,"Óbidos",1,"Norte",1,"150530",2,109,56,53,66,43,1,1,0,0,1,110,57,53,66,44,25,10.0231834242213,11.2120365650312,0.268180498404489,29
"606","PA","Oriximiná",74016,22543.08,15001,"Óbidos",1,"Norte",1,"150530",3,124,61,63,63,61,2,1,1,2,0,126,62,64,65,61,27,10.0231834242213,11.2120365650312,0.31664557564691,31
"607","PA","Oriximiná",74016,22543.08,15001,"Óbidos",1,"Norte",1,"150530",4,94,35,59,52,42,3,1,2,1,2,97,36,61,53,44,14,10.0231834242213,11.2120365650312,0.384111441163023,30
"608","PA","Oriximiná",74016,22543.08,15001,"Óbidos",1,"Norte",1,"150530",5,153,52,101,86,67,1,0,1,0,1,154,52,102,86,68,40,10.0231834242213,11.2120365650312,0.377129656916044,31
"609","PA","Ourém",17961,9544.04,15013,"Guamá",1,"Norte",0,"150540",2,27,10,17,12,15,3,2,1,2,1,30,12,18,14,16,10,9.16367215488381,9.79595801959346,0.32830195491639,29
"610","PA","Ourém",17961,9544.04,15013,"Guamá",1,"Norte",0,"150540",3,19,9,10,13,6,0,0,0,0,0,19,9,10,13,6,12,9.16367215488381,9.79595801959346,0.431363520664358,31
"611","PA","Ourém",17961,9544.04,15013,"Guamá",1,"Norte",0,"150540",4,9,1,8,5,4,0,0,0,0,0,9,1,8,5,4,9,9.16367215488381,9.79595801959346,0.475076990814259,30
"612","PA","Ourém",17961,9544.04,15013,"Guamá",1,"Norte",0,"150540",5,17,12,5,10,7,0,0,0,0,0,17,12,5,10,7,7,9.16367215488381,9.79595801959346,0.463286327388308,31
"613","PA","Ourilândia do Norte",33335,18895.86,15018,"São Félix do Xingu",1,"Norte",1,"150543",2,56,25,31,25,31,2,0,2,0,2,58,25,33,25,33,13,9.84669812943425,10.4143631750522,0.287777045058361,29
"614","PA","Ourilândia do Norte",33335,18895.86,15018,"São Félix do Xingu",1,"Norte",1,"150543",3,51,26,25,32,19,0,0,0,0,0,51,26,25,32,19,10,9.84669812943425,10.4143631750522,0.349153770348672,31
"615","PA","Ourilândia do Norte",33335,18895.86,15018,"São Félix do Xingu",1,"Norte",1,"150543",4,59,33,26,27,32,1,0,1,1,0,60,33,27,28,32,10,9.84669812943425,10.4143631750522,0.376516916778646,30
"616","PA","Ourilândia do Norte",33335,18895.86,15018,"São Félix do Xingu",1,"Norte",1,"150543",5,54,19,35,31,23,1,0,1,0,1,55,19,36,31,24,12,9.84669812943425,10.4143631750522,0.396318821992001,31
"617","PA","Pacajá",48414,12677.22,15015,"Altamira",1,"Norte",0,"150548",2,66,38,28,34,32,2,1,1,1,1,68,39,29,35,33,11,9.44756196105177,10.7875443070766,0.320523229339457,29
"618","PA","Pacajá",48414,12677.22,15015,"Altamira",1,"Norte",0,"150548",3,65,32,33,36,29,2,2,0,0,2,67,34,33,36,31,19,9.44756196105177,10.7875443070766,0.372082836874945,31
"619","PA","Pacajá",48414,12677.22,15015,"Altamira",1,"Norte",0,"150548",4,52,28,24,27,25,0,0,0,0,0,52,28,24,27,25,12,9.44756196105177,10.7875443070766,0.391256079511516,30
"620","PA","Pacajá",48414,12677.22,15015,"Altamira",1,"Norte",0,"150548",5,56,27,29,33,23,1,1,0,1,0,57,28,29,34,23,27,9.44756196105177,10.7875443070766,0.44399539228917,31
"621","PA","Paragominas",114503,23685.18,15017,"Paragominas",1,"Norte",1,"150550",2,17,1,16,3,14,0,0,0,0,0,17,1,16,3,14,39,10.0726048150756,11.6483563025066,0.295605594197736,29
"622","PA","Paragominas",114503,23685.18,15017,"Paragominas",1,"Norte",1,"150550",3,8,0,8,1,7,1,0,1,0,1,9,0,9,1,8,42,10.0726048150756,11.6483563025066,0.375387308846579,31
"623","PA","Paragominas",114503,23685.18,15017,"Paragominas",1,"Norte",1,"150550",4,10,4,6,5,5,1,1,0,0,1,11,5,6,5,6,39,10.0726048150756,11.6483563025066,0.417015133518837,30
"624","PA","Paragominas",114503,23685.18,15017,"Paragominas",1,"Norte",1,"150550",5,9,3,6,3,6,0,0,0,0,0,9,3,6,3,6,105,10.0726048150756,11.6483563025066,0.448545342586395,31
"625","PA","Parauapebas",213576,78841.15,15019,"Parauapebas",1,"Norte",1,"150553",2,378,84,294,174,204,0,0,0,0,0,378,84,294,174,204,69,11.2751903476646,12.2717480202048,0.304550904938831,29
"626","PA","Parauapebas",213576,78841.15,15019,"Parauapebas",1,"Norte",1,"150553",3,378,84,294,150,228,1,0,1,1,0,379,84,295,151,228,56,11.2751903476646,12.2717480202048,0.383941595011455,31
"627","PA","Parauapebas",213576,78841.15,15019,"Parauapebas",1,"Norte",1,"150553",4,314,73,241,133,181,1,0,1,1,0,315,73,242,134,181,93,11.2751903476646,12.2717480202048,0.437644152112087,30
"628","PA","Parauapebas",213576,78841.15,15019,"Parauapebas",1,"Norte",1,"150553",5,370,80,290,158,212,1,0,1,1,0,371,80,291,159,212,164,11.2751903476646,12.2717480202048,0.453727830682472,31
"629","PA","Placas",31659,8103.04,15002,"Santarém",1,"Norte",0,"150565",2,26,12,14,17,9,1,0,1,0,1,27,12,15,17,10,6,8.99999457889183,10.3627777473392,0.333000152075446,29
"630","PA","Placas",31659,8103.04,15002,"Santarém",1,"Norte",0,"150565",3,27,11,16,10,17,0,0,0,0,0,27,11,16,10,17,2,8.99999457889183,10.3627777473392,0.420106997830233,31
"631","PA","Placas",31659,8103.04,15002,"Santarém",1,"Norte",0,"150565",4,18,8,10,7,11,0,0,0,0,0,18,8,10,7,11,6,8.99999457889183,10.3627777473392,0.42294087920849,30
"632","PA","Placas",31659,8103.04,15002,"Santarém",1,"Norte",0,"150565",5,31,15,16,18,13,0,0,0,0,0,31,15,16,18,13,6,8.99999457889183,10.3627777473392,0.437743058767413,31
"633","PA","Ponta de Pedras",31549,6928.47,15006,"Arari",1,"Norte",0,"150570",2,24,7,17,16,8,0,0,0,0,0,24,7,17,16,8,4,8.84339428858785,10.359297171746,0.280556757742964,29
"634","PA","Ponta de Pedras",31549,6928.47,15006,"Arari",1,"Norte",0,"150570",3,26,14,12,15,11,1,0,1,1,0,27,14,13,16,11,9,8.84339428858785,10.359297171746,0.358612272139772,31
"635","PA","Ponta de Pedras",31549,6928.47,15006,"Arari",1,"Norte",0,"150570",4,16,10,6,9,7,1,1,0,0,1,17,11,6,9,8,9,8.84339428858785,10.359297171746,0.471730994178577,30
"636","PA","Ponta de Pedras",31549,6928.47,15006,"Arari",1,"Norte",0,"150570",5,24,12,12,15,9,0,0,0,0,0,24,12,12,15,9,11,8.84339428858785,10.359297171746,0.474002628583077,31
"637","PA","Portel",62945,14619.53,15004,"Portel",1,"Norte",0,"150580",2,116,80,36,56,60,2,1,1,0,2,118,81,37,56,62,17,9.5901135850442,11.0500166082004,0.300246836388741,29
"638","PA","Portel",62945,14619.53,15004,"Portel",1,"Norte",0,"150580",3,118,89,29,73,45,1,1,0,1,0,119,90,29,74,45,14,9.5901135850442,11.0500166082004,0.396935389139851,31
"639","PA","Portel",62945,14619.53,15004,"Portel",1,"Norte",0,"150580",4,106,76,30,65,41,5,5,0,3,2,111,81,30,68,43,11,9.5901135850442,11.0500166082004,0.462540537309095,30
"640","PA","Portel",62945,14619.53,15004,"Portel",1,"Norte",0,"150580",5,96,70,26,59,37,0,0,0,0,0,96,70,26,59,37,35,9.5901135850442,11.0500166082004,0.576812630934425,31
"641","PA","Porto de Moz",41801,7660.88,15003,"Almeirim",1,"Norte",0,"150590",2,59,35,24,35,24,0,0,0,0,0,59,35,24,35,24,8,8.94388213864267,10.6406755416717,0.313209263780865,29
"642","PA","Porto de Moz",41801,7660.88,15003,"Almeirim",1,"Norte",0,"150590",3,60,36,24,34,26,0,0,0,0,0,60,36,24,34,26,6,8.94388213864267,10.6406755416717,0.35089469924961,31
"643","PA","Porto de Moz",41801,7660.88,15003,"Almeirim",1,"Norte",0,"150590",4,37,16,21,24,13,0,0,0,0,0,37,16,21,24,13,9,8.94388213864267,10.6406755416717,0.415301222690846,30
"644","PA","Porto de Moz",41801,7660.88,15003,"Almeirim",1,"Norte",0,"150590",5,54,34,20,37,17,0,0,0,0,0,54,34,20,37,17,25,8.94388213864267,10.6406755416717,0.493737974806409,31
"645","PA","Prainha",29846,9660.37,15002,"Santarém",1,"Norte",0,"150600",2,44,21,23,19,25,1,0,1,1,0,45,21,24,20,25,9,9.17578722875048,10.3038061064914,0.381255703021617,29
"646","PA","Prainha",29846,9660.37,15002,"Santarém",1,"Norte",0,"150600",3,67,30,37,39,28,0,0,0,0,0,67,30,37,39,28,11,9.17578722875048,10.3038061064914,0.431938486338251,31
"647","PA","Prainha",29846,9660.37,15002,"Santarém",1,"Norte",0,"150600",4,52,22,30,35,17,0,0,0,0,0,52,22,30,35,17,4,9.17578722875048,10.3038061064914,0.460575112373331,30
"648","PA","Prainha",29846,9660.37,15002,"Santarém",1,"Norte",0,"150600",5,59,22,37,38,21,0,0,0,0,0,59,22,37,38,21,12,9.17578722875048,10.3038061064914,0.471763454175228,31
"649","PA","Redenção",85563,21459.84,15021,"Redenção",1,"Norte",1,"150613",2,137,56,81,81,56,1,0,1,1,0,138,56,82,82,56,47,9.9739385604253,11.3570082256952,0.293362179011521,29
"650","PA","Redenção",85563,21459.84,15021,"Redenção",1,"Norte",1,"150613",3,135,35,100,74,61,1,0,1,0,1,136,35,101,74,62,41,9.9739385604253,11.3570082256952,0.378835560261228,31
"651","PA","Redenção",85563,21459.84,15021,"Redenção",1,"Norte",1,"150613",4,120,36,84,72,48,0,0,0,0,0,120,36,84,72,48,39,9.9739385604253,11.3570082256952,0.398436320372021,30
"652","PA","Redenção",85563,21459.84,15021,"Redenção",1,"Norte",1,"150613",5,127,54,73,77,50,0,0,0,0,0,127,54,73,77,50,43,9.9739385604253,11.3570082256952,0.389414194149799,31
"653","PA","Rio Maria",18201,26363.76,15021,"Redenção",1,"Norte",1,"150616",2,19,11,8,13,6,0,0,0,0,0,19,11,8,13,6,10,10.1797456188085,9.80923181661041,0.269835038724306,29
"654","PA","Rio Maria",18201,26363.76,15021,"Redenção",1,"Norte",1,"150616",3,21,9,12,16,5,0,0,0,0,0,21,9,12,16,5,8,10.1797456188085,9.80923181661041,0.326660704926077,31
"655","PA","Rio Maria",18201,26363.76,15021,"Redenção",1,"Norte",1,"150616",4,22,9,13,15,7,0,0,0,0,0,22,9,13,15,7,10,10.1797456188085,9.80923181661041,0.330455185599933,30
"656","PA","Rio Maria",18201,26363.76,15021,"Redenção",1,"Norte",1,"150616",5,19,9,10,13,6,1,0,1,1,0,20,9,11,14,6,7,10.1797456188085,9.80923181661041,0.374090631858653,31
"657","PA","Rondon do Pará",52803,10248.03,15017,"Paragominas",1,"Norte",1,"150618",2,32,12,20,14,18,0,0,0,0,0,32,12,20,14,18,16,9.23484077097275,10.8743232862621,0.274850753871444,29
"658","PA","Rondon do Pará",52803,10248.03,15017,"Paragominas",1,"Norte",1,"150618",3,41,21,20,28,13,1,0,1,1,0,42,21,21,29,13,20,9.23484077097275,10.8743232862621,0.348270520907442,31
"659","PA","Rondon do Pará",52803,10248.03,15017,"Paragominas",1,"Norte",1,"150618",4,50,15,35,31,19,0,0,0,0,0,50,15,35,31,19,12,9.23484077097275,10.8743232862621,0.374212453987006,30
"660","PA","Rondon do Pará",52803,10248.03,15017,"Paragominas",1,"Norte",1,"150618",5,46,19,27,28,18,2,2,0,2,0,48,21,27,30,18,31,9.23484077097275,10.8743232862621,0.385029331815798,31
"661","PA","Rurópolis",51500,7077.44,15014,"Itaituba",1,"Norte",0,"150619",2,35,20,15,20,15,0,0,0,0,0,35,20,15,20,15,8,8.86466753938036,10.8493370866518,0.337926452041765,29
"662","PA","Rurópolis",51500,7077.44,15014,"Itaituba",1,"Norte",0,"150619",3,32,16,16,15,17,0,0,0,0,0,32,16,16,15,17,8,8.86466753938036,10.8493370866518,0.417982155023984,31
"663","PA","Rurópolis",51500,7077.44,15014,"Itaituba",1,"Norte",0,"150619",4,30,19,11,18,12,1,1,0,0,1,31,20,11,18,13,11,8.86466753938036,10.8493370866518,0.432172925049185,30
"664","PA","Rurópolis",51500,7077.44,15014,"Itaituba",1,"Norte",0,"150619",5,30,10,20,17,13,1,0,1,0,1,31,10,21,17,14,17,8.86466753938036,10.8493370866518,0.443911182615505,31
"665","PA","Salinópolis",40922,11636.45,15009,"Salgado",1,"Norte",1,"150620",2,40,14,26,23,17,1,1,0,1,0,41,15,26,24,17,26,9.36189769195084,10.6194230947265,0.279742452405521,29
"666","PA","Salinópolis",40922,11636.45,15009,"Salgado",1,"Norte",1,"150620",3,27,7,20,14,13,1,0,1,0,1,28,7,21,14,14,19,9.36189769195084,10.6194230947265,0.378735250765811,31
"667","PA","Salinópolis",40922,11636.45,15009,"Salgado",1,"Norte",1,"150620",4,33,12,21,22,11,0,0,0,0,0,33,12,21,22,11,27,9.36189769195084,10.6194230947265,0.456663173859468,30
"668","PA","Salinópolis",40922,11636.45,15009,"Salgado",1,"Norte",1,"150620",5,27,8,19,19,8,0,0,0,0,0,27,8,19,19,8,48,9.36189769195084,10.6194230947265,0.471929802196878,31
"669","PA","Salvaterra",24075,7470.17,15006,"Arari",1,"Norte",0,"150630",2,35,13,22,21,14,0,0,0,0,0,35,13,22,21,14,10,8.91867303556537,10.0889292366663,0.342030205210742,29
"670","PA","Salvaterra",24075,7470.17,15006,"Arari",1,"Norte",0,"150630",3,23,7,16,14,9,0,0,0,0,0,23,7,16,14,9,14,8.91867303556537,10.0889292366663,0.412861990311027,31
"671","PA","Salvaterra",24075,7470.17,15006,"Arari",1,"Norte",0,"150630",4,17,5,12,5,12,0,0,0,0,0,17,5,12,5,12,9,8.91867303556537,10.0889292366663,0.469727818077045,30
"672","PA","Salvaterra",24075,7470.17,15006,"Arari",1,"Norte",0,"150630",5,27,10,17,16,11,0,0,0,0,0,27,10,17,16,11,20,8.91867303556537,10.0889292366663,0.495500092422601,31
"673","PA","Santa Bárbara do Pará",21449,8325.1,15007,"Belém",1,"Norte",0,"150635",2,9,4,5,5,4,1,0,1,0,1,10,4,6,5,5,4,9.02703032678851,9.97343330322279,0.304143066505874,29
"674","PA","Santa Bárbara do Pará",21449,8325.1,15007,"Belém",1,"Norte",0,"150635",3,25,12,13,11,14,0,0,0,0,0,25,12,13,11,14,16,9.02703032678851,9.97343330322279,0.380794691297887,31
"675","PA","Santa Bárbara do Pará",21449,8325.1,15007,"Belém",1,"Norte",0,"150635",4,22,10,12,11,11,1,0,1,1,0,23,10,13,12,11,15,9.02703032678851,9.97343330322279,0.450303393600609,30
"676","PA","Santa Bárbara do Pará",21449,8325.1,15007,"Belém",1,"Norte",0,"150635",5,20,5,15,12,8,0,0,0,0,0,20,5,15,12,8,27,9.02703032678851,9.97343330322279,0.458330665318309,31
"677","PA","Santa Izabel do Pará",71837,10867.42,15008,"Castanhal",1,"Norte",1,"150650",2,67,20,47,41,26,1,0,1,0,1,68,20,48,41,27,26,9.29352460143719,11.1821549426387,0.308348061717108,29
"678","PA","Santa Izabel do Pará",71837,10867.42,15008,"Castanhal",1,"Norte",1,"150650",3,65,20,45,32,33,0,0,0,0,0,65,20,45,32,33,35,9.29352460143719,11.1821549426387,0.383710453553384,31
"679","PA","Santa Izabel do Pará",71837,10867.42,15008,"Castanhal",1,"Norte",1,"150650",4,60,20,40,28,32,0,0,0,0,0,60,20,40,28,32,37,9.29352460143719,11.1821549426387,0.445352309707464,30
"680","PA","Santa Izabel do Pará",71837,10867.42,15008,"Castanhal",1,"Norte",1,"150650",5,70,19,51,37,33,2,0,2,1,1,72,19,53,38,34,66,9.29352460143719,11.1821549426387,0.466740501654522,31
"681","PA","Santa Luzia do Pará",19843,8218.49,15013,"Guamá",1,"Norte",0,"150655",2,25,8,17,12,13,0,0,0,0,0,25,8,17,12,13,13,9.01414177287879,9.89560657908525,0.274336751523872,29
"682","PA","Santa Luzia do Pará",19843,8218.49,15013,"Guamá",1,"Norte",0,"150655",3,21,9,12,9,12,0,0,0,0,0,21,9,12,9,12,8,9.01414177287879,9.89560657908525,0.363191485274084,31
"683","PA","Santa Luzia do Pará",19843,8218.49,15013,"Guamá",1,"Norte",0,"150655",4,22,13,9,13,9,0,0,0,0,0,22,13,9,13,9,7,9.01414177287879,9.89560657908525,0.410709278513845,30
"684","PA","Santa Luzia do Pará",19843,8218.49,15013,"Guamá",1,"Norte",0,"150655",5,21,11,10,10,11,0,0,0,0,0,21,11,10,10,11,13,9.01414177287879,9.89560657908525,0.476151874043582,31
"685","PA","Santa Maria das Barreiras",21850,18052.36,15022,"Conceição do Araguaia",1,"Norte",0,"150658",2,8,3,5,4,4,0,0,0,0,0,8,3,5,4,4,10,9.8010317031367,9.99195620052374,0.321093717291438,29
"686","PA","Santa Maria das Barreiras",21850,18052.36,15022,"Conceição do Araguaia",1,"Norte",0,"150658",3,15,7,8,10,5,0,0,0,0,0,15,7,8,10,5,5,9.8010317031367,9.99195620052374,0.396695911688716,31
"687","PA","Santa Maria das Barreiras",21850,18052.36,15022,"Conceição do Araguaia",1,"Norte",0,"150658",4,3,0,3,1,2,0,0,0,0,0,3,0,3,1,2,6,9.8010317031367,9.99195620052374,0.408028525242042,30
"688","PA","Santa Maria das Barreiras",21850,18052.36,15022,"Conceição do Araguaia",1,"Norte",0,"150658",5,6,4,2,6,0,2,2,0,0,2,8,6,2,6,2,6,9.8010317031367,9.99195620052374,0.47977873314209,31
"689","PA","Santa Maria do Pará",24995,15526.48,15010,"Bragantina",1,"Norte",0,"150660",2,33,16,17,17,16,1,0,1,1,0,34,16,18,18,16,12,9.65030223237078,10.1264310838477,0.28822092195208,29
"690","PA","Santa Maria do Pará",24995,15526.48,15010,"Bragantina",1,"Norte",0,"150660",3,36,17,19,19,17,0,0,0,0,0,36,17,19,19,17,15,9.65030223237078,10.1264310838477,0.385481936762448,31
"691","PA","Santa Maria do Pará",24995,15526.48,15010,"Bragantina",1,"Norte",0,"150660",4,23,10,13,11,12,1,0,1,0,1,24,10,14,11,13,11,9.65030223237078,10.1264310838477,0.41512533099333,30
"692","PA","Santa Maria do Pará",24995,15526.48,15010,"Bragantina",1,"Norte",0,"150660",5,22,5,17,10,12,1,1,0,1,0,23,6,17,11,12,26,9.65030223237078,10.1264310838477,0.443762988865663,31
"693","PA","Santana do Araguaia",74419,11850.1,15022,"Conceição do Araguaia",1,"Norte",1,"150670",2,38,18,20,19,19,0,0,0,0,0,38,18,20,19,19,17,9.38009158534624,11.2174665645623,0.295352492515607,29
"694","PA","Santana do Araguaia",74419,11850.1,15022,"Conceição do Araguaia",1,"Norte",1,"150670",3,41,16,25,23,18,1,1,0,1,0,42,17,25,24,18,16,9.38009158534624,11.2174665645623,0.358072560166927,31
"695","PA","Santana do Araguaia",74419,11850.1,15022,"Conceição do Araguaia",1,"Norte",1,"150670",4,42,20,22,27,15,1,1,0,1,0,43,21,22,28,15,12,9.38009158534624,11.2174665645623,0.388601805240426,30
"696","PA","Santana do Araguaia",74419,11850.1,15022,"Conceição do Araguaia",1,"Norte",1,"150670",5,38,16,22,19,19,0,0,0,0,0,38,16,22,19,19,14,9.38009158534624,11.2174665645623,0.382014279906155,31
"697","PA","Santarém",306480,16053.85,15002,"Santarém",1,"Norte",1,"150680",2,526,126,400,232,294,1,1,0,1,0,527,127,400,233,294,130,9.68370397518207,12.6329077793745,0.28009119419618,29
"698","PA","Santarém",306480,16053.85,15002,"Santarém",1,"Norte",1,"150680",3,470,117,353,183,287,5,3,2,4,1,475,120,355,187,288,144,9.68370397518207,12.6329077793745,0.361005687582853,31
"699","PA","Santarém",306480,16053.85,15002,"Santarém",1,"Norte",1,"150680",4,426,119,307,207,219,3,0,3,1,2,429,119,310,208,221,152,9.68370397518207,12.6329077793745,0.424464315295543,30
"700","PA","Santarém",306480,16053.85,15002,"Santarém",1,"Norte",1,"150680",5,493,114,379,213,280,3,2,1,2,1,496,116,380,215,281,338,9.68370397518207,12.6329077793745,0.447629202761558,31
"701","PA","Santo Antônio do Tauá",31918,11825.46,15008,"Castanhal",1,"Norte",0,"150700",2,36,7,29,19,17,1,1,0,0,1,37,8,29,19,18,15,9.37801011323777,10.3709253929591,0.304695090784686,29
"702","PA","Santo Antônio do Tauá",31918,11825.46,15008,"Castanhal",1,"Norte",0,"150700",3,31,9,22,14,17,1,1,0,1,0,32,10,22,15,17,10,9.37801011323777,10.3709253929591,0.38409897645682,31
"703","PA","Santo Antônio do Tauá",31918,11825.46,15008,"Castanhal",1,"Norte",0,"150700",4,28,14,14,19,9,0,0,0,0,0,28,14,14,19,9,25,9.37801011323777,10.3709253929591,0.459125124873766,30
"704","PA","Santo Antônio do Tauá",31918,11825.46,15008,"Castanhal",1,"Norte",0,"150700",5,33,8,25,17,16,0,0,0,0,0,33,8,25,17,16,27,9.37801011323777,10.3709253929591,0.501920170715826,31
"705","PA","São Domingos do Araguaia",25753,11082.05,15020,"Marabá",1,"Norte",0,"150715",2,30,14,16,16,14,1,1,0,1,0,31,15,16,17,14,14,9.31308196123809,10.1563064041601,0.283787939752489,29
"706","PA","São Domingos do Araguaia",25753,11082.05,15020,"Marabá",1,"Norte",0,"150715",3,25,13,12,16,9,0,0,0,0,0,25,13,12,16,9,10,9.31308196123809,10.1563064041601,0.346414159144468,31
"707","PA","São Domingos do Araguaia",25753,11082.05,15020,"Marabá",1,"Norte",0,"150715",4,29,10,19,19,10,0,0,0,0,0,29,10,19,19,10,12,9.31308196123809,10.1563064041601,0.359584581988526,30
"708","PA","São Domingos do Araguaia",25753,11082.05,15020,"Marabá",1,"Norte",0,"150715",5,27,12,15,15,12,0,0,0,0,0,27,12,15,15,12,15,9.31308196123809,10.1563064041601,0.408241912898676,31
"709","PA","São Félix do Xingu",132138,11187,15018,"São Félix do Xingu",1,"Norte",1,"150730",2,103,52,51,64,39,1,1,0,0,1,104,53,51,64,40,21,9.32250766884693,11.7916021100069,0.328474596647293,29
"710","PA","São Félix do Xingu",132138,11187,15018,"São Félix do Xingu",1,"Norte",1,"150730",3,43,22,21,25,18,1,0,1,0,1,44,22,22,25,19,20,9.32250766884693,11.7916021100069,0.375245684100863,31
"711","PA","São Félix do Xingu",132138,11187,15018,"São Félix do Xingu",1,"Norte",1,"150730",4,67,27,40,38,29,1,1,0,0,1,68,28,40,38,30,20,9.32250766884693,11.7916021100069,0.402412063503567,30
"712","PA","São Félix do Xingu",132138,11187,15018,"São Félix do Xingu",1,"Norte",1,"150730",5,68,33,35,40,28,0,0,0,0,0,68,33,35,40,28,21,9.32250766884693,11.7916021100069,0.430540291019749,31
"713","PA","São Francisco do Pará",15930,14783.65,15010,"Bragantina",1,"Norte",0,"150740",2,23,8,15,10,13,0,0,0,0,0,23,8,15,10,13,6,9.6012771193588,9.67595940290409,0.316084309926978,29
"714","PA","São Francisco do Pará",15930,14783.65,15010,"Bragantina",1,"Norte",0,"150740",3,29,6,23,9,20,0,0,0,0,0,29,6,23,9,20,5,9.6012771193588,9.67595940290409,0.406648941914112,31
"715","PA","São Francisco do Pará",15930,14783.65,15010,"Bragantina",1,"Norte",0,"150740",4,9,4,5,5,4,0,0,0,0,0,9,4,5,5,4,4,9.6012771193588,9.67595940290409,0.469127900033609,30
"716","PA","São Francisco do Pará",15930,14783.65,15010,"Bragantina",1,"Norte",0,"150740",5,18,6,12,7,11,0,0,0,0,0,18,6,12,7,11,18,9.6012771193588,9.67595940290409,0.4656528815364,31
"717","PA","São Geraldo do Araguaia",24705,19620.1,15021,"Redenção",1,"Norte",0,"150745",2,26,15,11,18,8,0,0,0,0,0,26,15,11,18,8,12,9.88430982994633,10.1147609312799,0.275769024110216,29
"718","PA","São Geraldo do Araguaia",24705,19620.1,15021,"Redenção",1,"Norte",0,"150745",3,30,16,14,22,8,1,1,0,1,0,31,17,14,23,8,15,9.88430982994633,10.1147609312799,0.353527983047107,31
"719","PA","São Geraldo do Araguaia",24705,19620.1,15021,"Redenção",1,"Norte",0,"150745",4,26,13,13,17,9,0,0,0,0,0,26,13,13,17,9,9,9.88430982994633,10.1147609312799,0.362384184449912,30
"720","PA","São Geraldo do Araguaia",24705,19620.1,15021,"Redenção",1,"Norte",0,"150745",5,30,10,20,15,15,0,0,0,0,0,30,10,20,15,15,21,9.88430982994633,10.1147609312799,0.406052763607624,31
"721","PA","São Miguel do Guamá",59632,11593.97,15013,"Guamá",1,"Norte",1,"150760",2,71,28,43,36,35,1,0,1,1,0,72,28,44,37,35,21,9.35824041435105,10.995947621719,0.289305920688912,29
"722","PA","São Miguel do Guamá",59632,11593.97,15013,"Guamá",1,"Norte",1,"150760",3,76,37,39,43,33,0,0,0,0,0,76,37,39,43,33,27,9.35824041435105,10.995947621719,0.371817580049263,31
"723","PA","São Miguel do Guamá",59632,11593.97,15013,"Guamá",1,"Norte",1,"150760",4,58,27,31,36,22,0,0,0,0,0,58,27,31,36,22,32,9.35824041435105,10.995947621719,0.413039656885803,30
"724","PA","São Miguel do Guamá",59632,11593.97,15013,"Guamá",1,"Norte",1,"150760",5,50,21,29,29,21,0,0,0,0,0,50,21,29,29,21,64,9.35824041435105,10.995947621719,0.442903428624338,31
"725","PA","São Sebastião da Boa Vista",26974,7956.47,15005,"Furos de Breves",1,"Norte",0,"150770",2,40,20,20,19,21,0,0,0,0,0,40,20,20,19,21,3,8.98174071314103,10.2026287180768,0.259943634500434,29
"726","PA","São Sebastião da Boa Vista",26974,7956.47,15005,"Furos de Breves",1,"Norte",0,"150770",3,42,24,18,24,18,0,0,0,0,0,42,24,18,24,18,5,8.98174071314103,10.2026287180768,0.313226827963042,31
"727","PA","São Sebastião da Boa Vista",26974,7956.47,15005,"Furos de Breves",1,"Norte",0,"150770",4,27,18,9,17,10,0,0,0,0,0,27,18,9,17,10,5,8.98174071314103,10.2026287180768,0.424630074036184,30
"728","PA","São Sebastião da Boa Vista",26974,7956.47,15005,"Furos de Breves",1,"Norte",0,"150770",5,29,14,15,18,11,1,1,0,1,0,30,15,15,19,11,16,8.98174071314103,10.2026287180768,0.462554818954062,31
"729","PA","Soure",25565,7469.63,15006,"Arari",1,"Norte",1,"150790",2,34,14,20,20,14,1,1,0,0,1,35,15,20,20,15,6,8.91860074544097,10.1489795075141,0.294788299310107,29
"730","PA","Soure",25565,7469.63,15006,"Arari",1,"Norte",1,"150790",3,35,15,20,19,16,0,0,0,0,0,35,15,20,19,16,16,8.91860074544097,10.1489795075141,0.367256330457832,31
"731","PA","Soure",25565,7469.63,15006,"Arari",1,"Norte",1,"150790",4,42,21,21,27,15,0,0,0,0,0,42,21,21,27,15,10,8.91860074544097,10.1489795075141,0.402394887367092,30
"732","PA","Soure",25565,7469.63,15006,"Arari",1,"Norte",1,"150790",5,28,15,13,18,10,0,0,0,0,0,28,15,13,18,10,19,8.91860074544097,10.1489795075141,0.426354942733958,31
"733","PA","Tailândia",108969,8660.12,15012,"Tomé-Açu",1,"Norte",1,"150795",2,129,54,75,59,70,3,2,1,1,2,132,56,76,60,72,26,9.06648385827341,11.5988187170912,0.293700235281558,29
"734","PA","Tailândia",108969,8660.12,15012,"Tomé-Açu",1,"Norte",1,"150795",3,131,54,77,73,58,1,1,0,0,1,132,55,77,73,59,28,9.06648385827341,11.5988187170912,0.353358050324538,31
"735","PA","Tailândia",108969,8660.12,15012,"Tomé-Açu",1,"Norte",1,"150795",4,129,46,83,77,52,1,1,0,1,0,130,47,83,78,52,41,9.06648385827341,11.5988187170912,0.38870875479336,30
"736","PA","Tailândia",108969,8660.12,15012,"Tomé-Açu",1,"Norte",1,"150795",5,125,54,71,67,58,2,1,1,1,1,127,55,72,68,59,53,9.06648385827341,11.5988187170912,0.418103429459053,31
"737","PA","Terra Alta",11847,6074.4,15009,"Salgado",1,"Norte",0,"150796",2,15,7,8,8,7,0,0,0,0,0,15,7,8,8,7,6,8.71183849789902,9.37982994995476,0.311422043103728,29
"738","PA","Terra Alta",11847,6074.4,15009,"Salgado",1,"Norte",0,"150796",3,13,5,8,9,4,0,0,0,0,0,13,5,8,9,4,3,8.71183849789902,9.37982994995476,0.370960973403699,31
"739","PA","Terra Alta",11847,6074.4,15009,"Salgado",1,"Norte",0,"150796",4,9,4,5,4,5,0,0,0,0,0,9,4,5,4,5,8,8.71183849789902,9.37982994995476,0.461010602768556,30
"740","PA","Terra Alta",11847,6074.4,15009,"Salgado",1,"Norte",0,"150796",5,18,6,12,7,11,1,1,0,0,1,19,7,12,7,12,15,8.71183849789902,9.37982994995476,0.508850279183501,31
"741","PA","Terra Santa",18917,27414,15001,"Óbidos",1,"Norte",1,"150797",2,21,7,14,13,8,0,0,0,0,0,21,7,14,13,8,5,10.2188091107913,9.84781626766566,0.266536212170065,29
"742","PA","Terra Santa",18917,27414,15001,"Óbidos",1,"Norte",1,"150797",3,20,6,14,11,9,0,0,0,0,0,20,6,14,11,9,9,10.2188091107913,9.84781626766566,0.330771223078605,31
"743","PA","Terra Santa",18917,27414,15001,"Óbidos",1,"Norte",1,"150797",4,24,7,17,17,7,0,0,0,0,0,24,7,17,17,7,4,10.2188091107913,9.84781626766566,0.38303440377624,30
"744","PA","Terra Santa",18917,27414,15001,"Óbidos",1,"Norte",1,"150797",5,24,11,13,13,11,0,0,0,0,0,24,11,13,13,11,12,10.2188091107913,9.84781626766566,0.431275222226249,31
"745","PA","Tomé-Açu",64030,10625.48,15012,"Tomé-Açu",1,"Norte",1,"150800",2,115,56,59,62,53,2,2,0,1,1,117,58,59,63,54,23,9.27101016924278,11.0671070025128,0.300493513025748,29
"746","PA","Tomé-Açu",64030,10625.48,15012,"Tomé-Açu",1,"Norte",1,"150800",3,98,52,46,53,45,3,2,1,0,3,101,54,47,53,48,25,9.27101016924278,11.0671070025128,0.382240278451908,31
"747","PA","Tomé-Açu",64030,10625.48,15012,"Tomé-Açu",1,"Norte",1,"150800",4,102,52,50,53,49,1,1,0,0,1,103,53,50,53,50,40,9.27101016924278,11.0671070025128,0.416696802340816,30
"748","PA","Tomé-Açu",64030,10625.48,15012,"Tomé-Açu",1,"Norte",1,"150800",5,105,44,61,57,48,1,1,0,0,1,106,45,61,57,49,79,9.27101016924278,11.0671070025128,0.481888952559904,31
"749","PA","Tracuateua",31257,7036.19,15010,"Bragantina",1,"Norte",0,"150803",2,26,11,15,12,14,0,0,0,0,0,26,11,15,12,14,9,8.85882210947238,10.3499986300803,0.334029552016649,29
"750","PA","Tracuateua",31257,7036.19,15010,"Bragantina",1,"Norte",0,"150803",3,28,12,16,18,10,0,0,0,0,0,28,12,16,18,10,14,8.85882210947238,10.3499986300803,0.405390825644312,31
"751","PA","Tracuateua",31257,7036.19,15010,"Bragantina",1,"Norte",0,"150803",4,23,7,16,13,10,0,0,0,0,0,23,7,16,13,10,17,8.85882210947238,10.3499986300803,0.455975104966133,30
"752","PA","Tracuateua",31257,7036.19,15010,"Bragantina",1,"Norte",0,"150803",5,25,9,16,12,13,0,0,0,0,0,25,9,16,12,13,39,8.85882210947238,10.3499986300803,0.526915118733997,31
"753","PA","Trairão",19168,15639.24,15014,"Itaituba",1,"Norte",0,"150805",2,15,5,10,11,4,0,0,0,0,0,15,5,10,11,4,3,9.65753841956822,9.86099750091518,0.336313727262785,29
"754","PA","Trairão",19168,15639.24,15014,"Itaituba",1,"Norte",0,"150805",3,22,12,10,13,9,1,0,1,0,1,23,12,11,13,10,5,9.65753841956822,9.86099750091518,0.37991109786587,31
"755","PA","Trairão",19168,15639.24,15014,"Itaituba",1,"Norte",0,"150805",4,17,11,6,12,5,1,1,0,0,1,18,12,6,12,6,0,9.65753841956822,9.86099750091518,0.406383869540518,30
"756","PA","Trairão",19168,15639.24,15014,"Itaituba",1,"Norte",0,"150805",5,1,1,0,0,1,0,0,0,0,0,1,1,0,0,1,14,9.65753841956822,9.86099750091518,0.430954061745528,31
"757","PA","Tucumã",40136,19936.09,15018,"São Félix do Xingu",1,"Norte",1,"150808",2,62,19,43,32,30,1,1,0,0,1,63,20,43,32,31,21,9.90028693602322,10.6000289661641,0.282627398613947,29
"758","PA","Tucumã",40136,19936.09,15018,"São Félix do Xingu",1,"Norte",1,"150808",3,56,30,26,28,28,2,1,1,1,1,58,31,27,29,29,12,9.90028693602322,10.6000289661641,0.353571242901687,31
"759","PA","Tucumã",40136,19936.09,15018,"São Félix do Xingu",1,"Norte",1,"150808",4,45,20,25,15,30,1,1,0,1,0,46,21,25,16,30,16,9.90028693602322,10.6000289661641,0.357987366235179,30
"760","PA","Tucumã",40136,19936.09,15018,"São Félix do Xingu",1,"Norte",1,"150808",5,61,29,32,34,27,0,0,0,0,0,61,29,32,34,27,19,9.90028693602322,10.6000289661641,0.393579806977547,31
"761","PA","Tucuruí",115144,66715,15016,"Tucuruí",1,"Norte",1,"150810",2,153,58,95,87,66,3,0,3,0,3,156,58,98,87,69,35,11.1081850941765,11.6539387979425,0.321609942142434,29
"762","PA","Tucuruí",115144,66715,15016,"Tucuruí",1,"Norte",1,"150810",3,148,48,100,78,70,1,0,1,0,1,149,48,101,78,71,46,11.1081850941765,11.6539387979425,0.408809700879749,31
"763","PA","Tucuruí",115144,66715,15016,"Tucuruí",1,"Norte",1,"150810",4,108,33,75,56,52,3,1,2,2,1,111,34,77,58,53,40,11.1081850941765,11.6539387979425,0.461367940992884,30
"764","PA","Tucuruí",115144,66715,15016,"Tucuruí",1,"Norte",1,"150810",5,116,38,78,55,61,1,0,1,1,0,117,38,79,56,61,104,11.1081850941765,11.6539387979425,0.503440949389592,31
"765","PA","Ulianópolis",60761,23080.67,15017,"Paragominas",1,"Norte",1,"150812",2,30,17,13,18,12,0,0,0,0,0,30,17,13,18,12,11,10.0467507496634,11.0147034147705,0.302838351406035,29
"766","PA","Ulianópolis",60761,23080.67,15017,"Paragominas",1,"Norte",1,"150812",3,36,18,18,16,20,1,0,1,1,0,37,18,19,17,20,13,10.0467507496634,11.0147034147705,0.356987595177239,31
"767","PA","Ulianópolis",60761,23080.67,15017,"Paragominas",1,"Norte",1,"150812",4,28,13,15,16,12,1,0,1,1,0,29,13,16,17,12,5,10.0467507496634,11.0147034147705,0.374738270513783,30
"768","PA","Ulianópolis",60761,23080.67,15017,"Paragominas",1,"Norte",1,"150812",5,23,12,11,13,10,0,0,0,0,0,23,12,11,13,10,17,10.0467507496634,11.0147034147705,0.430887355047538,31
"769","PA","Uruará",45435,11986.94,15015,"Altamira",1,"Norte",0,"150815",2,79,35,44,43,36,1,0,1,1,0,80,35,45,44,36,20,9.39157300277203,10.7240380121294,0.294090685526431,29
"770","PA","Uruará",45435,11986.94,15015,"Altamira",1,"Norte",0,"150815",3,65,37,28,39,26,1,0,1,1,0,66,37,29,40,26,17,9.39157300277203,10.7240380121294,0.360247607579529,31
"771","PA","Uruará",45435,11986.94,15015,"Altamira",1,"Norte",0,"150815",4,54,22,32,34,20,1,0,1,1,0,55,22,33,35,20,9,9.39157300277203,10.7240380121294,0.386378953289974,30
"772","PA","Uruará",45435,11986.94,15015,"Altamira",1,"Norte",0,"150815",5,74,39,35,35,39,1,0,1,0,1,75,39,36,35,40,11,9.39157300277203,10.7240380121294,0.40673741983914,31
"773","PA","Vigia",54172,7188.06,15009,"Salgado",1,"Norte",1,"150820",2,43,19,24,21,22,2,0,2,2,0,45,19,26,23,22,14,8.88017659511402,10.8999194487753,0.323387084182388,29
"774","PA","Vigia",54172,7188.06,15009,"Salgado",1,"Norte",1,"150820",3,51,19,32,30,21,0,0,0,0,0,51,19,32,30,21,30,8.88017659511402,10.8999194487753,0.393462711922914,31
"775","PA","Vigia",54172,7188.06,15009,"Salgado",1,"Norte",1,"150820",4,41,17,24,21,20,0,0,0,0,0,41,17,24,21,20,48,8.88017659511402,10.8999194487753,0.490059761670887,30
"776","PA","Vigia",54172,7188.06,15009,"Salgado",1,"Norte",1,"150820",5,42,18,24,23,19,0,0,0,0,0,42,18,24,23,19,69,8.88017659511402,10.8999194487753,0.480137790819035,31
"777","PA","Viseu",61751,7971.69,15013,"Guamá",1,"Norte",0,"150830",2,83,41,42,51,32,0,0,0,0,0,83,41,42,51,32,16,8.98365179447525,11.0308654486911,0.360597193780508,29
"778","PA","Viseu",61751,7971.69,15013,"Guamá",1,"Norte",0,"150830",3,71,45,26,43,28,1,1,0,1,0,72,46,26,44,28,14,8.98365179447525,11.0308654486911,0.444097378348893,31
"779","PA","Viseu",61751,7971.69,15013,"Guamá",1,"Norte",0,"150830",4,59,32,27,37,22,1,1,0,1,0,60,33,27,38,22,29,8.98365179447525,11.0308654486911,0.47222932637928,30
"780","PA","Viseu",61751,7971.69,15013,"Guamá",1,"Norte",0,"150830",5,67,36,31,43,24,0,0,0,0,0,67,36,31,43,24,39,8.98365179447525,11.0308654486911,0.515205367813983,31
"781","PA","Xinguara",45086,27618.27,15021,"Redenção",1,"Norte",1,"150840",2,66,22,44,33,33,0,0,0,0,0,66,22,44,33,33,28,10.2262327892304,10.7163270560141,0.285487188923848,29
"782","PA","Xinguara",45086,27618.27,15021,"Redenção",1,"Norte",1,"150840",3,71,23,48,47,24,0,0,0,0,0,71,23,48,47,24,28,10.2262327892304,10.7163270560141,0.355811028486298,31
"783","PA","Xinguara",45086,27618.27,15021,"Redenção",1,"Norte",1,"150840",4,79,28,51,40,39,0,0,0,0,0,79,28,51,40,39,12,10.2262327892304,10.7163270560141,0.376467252911629,30
"784","PA","Xinguara",45086,27618.27,15021,"Redenção",1,"Norte",1,"150840",5,75,27,48,39,36,0,0,0,0,0,75,27,48,39,36,30,10.2262327892304,10.7163270560141,0.38353999170638,31
"785","AP","Ferreira Gomes",7967,70268.95,16003,"Macapá",1,"Norte",0,"160023",2,8,3,5,4,4,0,0,0,0,0,8,3,5,4,4,3,11.1600853017094,8.98306328938037,0.335262987872393,29
"786","AP","Ferreira Gomes",7967,70268.95,16003,"Macapá",1,"Norte",0,"160023",3,8,6,2,6,2,0,0,0,0,0,8,6,2,6,2,2,11.1600853017094,8.98306328938037,0.416647937891955,31
"787","AP","Ferreira Gomes",7967,70268.95,16003,"Macapá",1,"Norte",0,"160023",4,9,2,7,6,3,0,0,0,0,0,9,2,7,6,3,2,11.1600853017094,8.98306328938037,0.464468979416873,30
"788","AP","Ferreira Gomes",7967,70268.95,16003,"Macapá",1,"Norte",0,"160023",5,14,6,8,9,5,1,1,0,0,1,15,7,8,9,6,7,11.1600853017094,8.98306328938037,0.512639959041717,31
"789","AP","Laranjal do Jari",51362,18252.7,16004,"Mazagão",1,"Norte",1,"160027",2,70,34,36,41,29,0,0,0,0,0,70,34,36,41,29,19,9.8120682932733,10.8466538784156,0.316394397952677,29
"790","AP","Laranjal do Jari",51362,18252.7,16004,"Mazagão",1,"Norte",1,"160027",3,58,33,25,38,20,0,0,0,0,0,58,33,25,38,20,12,9.8120682932733,10.8466538784156,0.417330337296306,31
"791","AP","Laranjal do Jari",51362,18252.7,16004,"Mazagão",1,"Norte",1,"160027",4,52,21,31,30,22,1,1,0,0,1,53,22,31,30,23,32,9.8120682932733,10.8466538784156,0.478427906579563,30
"792","AP","Laranjal do Jari",51362,18252.7,16004,"Mazagão",1,"Norte",1,"160027",5,55,26,29,36,19,1,1,0,0,1,56,27,29,36,20,48,9.8120682932733,10.8466538784156,0.492564050883897,31
"793","AP","Macapá",512902,22181.72,16003,"Macapá",1,"Norte",1,"160030",2,684,195,489,303,381,6,4,2,1,5,690,199,491,304,386,199,10.0070238052377,13.1478400727654,0.308445036107411,29
"794","AP","Macapá",512902,22181.72,16003,"Macapá",1,"Norte",1,"160030",3,644,205,439,301,343,7,3,4,2,5,651,208,443,303,348,181,10.0070238052377,13.1478400727654,0.420173136815511,31
"795","AP","Macapá",512902,22181.72,16003,"Macapá",1,"Norte",1,"160030",4,659,198,461,308,351,5,2,3,3,2,664,200,464,311,353,262,10.0070238052377,13.1478400727654,0.487956187908677,30
"796","AP","Macapá",512902,22181.72,16003,"Macapá",1,"Norte",1,"160030",5,666,184,482,307,359,6,2,4,3,3,672,186,486,310,362,536,10.0070238052377,13.1478400727654,0.522087777954478,31
"797","AP","Mazagão",22053,12172.06,16004,"Mazagão",1,"Norte",0,"160040",2,30,14,16,19,11,0,0,0,0,0,30,14,16,19,11,3,9.40689844035075,10.0012039260422,0.304805934181877,29
"798","AP","Mazagão",22053,12172.06,16004,"Mazagão",1,"Norte",0,"160040",3,36,18,18,18,18,0,0,0,0,0,36,18,18,18,18,4,9.40689844035075,10.0012039260422,0.418622871037837,31
"799","AP","Mazagão",22053,12172.06,16004,"Mazagão",1,"Norte",0,"160040",4,42,20,22,21,21,0,0,0,0,0,42,20,22,21,21,10,9.40689844035075,10.0012039260422,0.478538043256998,30
"800","AP","Mazagão",22053,12172.06,16004,"Mazagão",1,"Norte",0,"160040",5,43,20,23,23,20,0,0,0,0,0,43,20,23,23,20,14,9.40689844035075,10.0012039260422,0.52641603007893,31
"801","AP","Porto Grande",22452,15834.25,16003,"Macapá",1,"Norte",0,"160053",2,29,16,13,16,13,0,0,0,0,0,29,16,13,16,13,4,9.66993059441563,10.0191349760621,0.344914317402961,29
"802","AP","Porto Grande",22452,15834.25,16003,"Macapá",1,"Norte",0,"160053",3,20,8,12,11,9,0,0,0,0,0,20,8,12,11,9,5,9.66993059441563,10.0191349760621,0.424788149636507,31
"803","AP","Porto Grande",22452,15834.25,16003,"Macapá",1,"Norte",0,"160053",4,33,17,16,17,16,2,2,0,2,0,35,19,16,19,16,7,9.66993059441563,10.0191349760621,0.462015803304241,30
"804","AP","Porto Grande",22452,15834.25,16003,"Macapá",1,"Norte",0,"160053",5,28,12,16,12,16,1,1,0,1,0,29,13,16,13,16,7,9.66993059441563,10.0191349760621,0.486159288396812,31
"805","AP","Santana",123096,17307.11,16003,"Macapá",1,"Norte",1,"160060",2,93,26,67,45,48,1,1,0,1,0,94,27,67,46,48,46,9.75887267871459,11.7207198177372,0.308246105796098,29
"806","AP","Santana",123096,17307.11,16003,"Macapá",1,"Norte",1,"160060",3,147,33,114,61,86,1,0,1,0,1,148,33,115,61,87,43,9.75887267871459,11.7207198177372,0.419792035350688,31
"807","AP","Santana",123096,17307.11,16003,"Macapá",1,"Norte",1,"160060",4,117,34,83,56,61,2,0,2,0,2,119,34,85,56,63,62,9.75887267871459,11.7207198177372,0.480725785131204,30
"808","AP","Santana",123096,17307.11,16003,"Macapá",1,"Norte",1,"160060",5,117,21,96,52,65,0,0,0,0,0,117,21,96,52,65,148,9.75887267871459,11.7207198177372,0.522834219758721,31
"809","TO","Alvorada",8396,32238.9,17005,"Gurupi",1,"Norte",0,"170070",2,6,3,3,2,4,1,1,0,1,0,7,4,3,3,4,4,10.3809290769318,9.03551068094052,0.241793347173042,29
"810","TO","Alvorada",8396,32238.9,17005,"Gurupi",1,"Norte",0,"170070",3,9,2,7,3,6,0,0,0,0,0,9,2,7,3,6,4,10.3809290769318,9.03551068094052,0.290650533701452,31
"811","TO","Alvorada",8396,32238.9,17005,"Gurupi",1,"Norte",0,"170070",4,13,2,11,9,4,0,0,0,0,0,13,2,11,9,4,5,10.3809290769318,9.03551068094052,0.320038525884202,30
"812","TO","Alvorada",8396,32238.9,17005,"Gurupi",1,"Norte",0,"170070",5,8,1,7,6,2,0,0,0,0,0,8,1,7,6,2,1,10.3809290769318,9.03551068094052,0.347105073966215,31
"813","TO","Araguaçu",8467,22458.34,17004,"Rio Formoso",1,"Norte",0,"170200",2,11,3,8,5,6,0,0,0,0,0,11,3,8,5,6,6,10.0194173163892,9.04393153364228,0.28793857966814,29
"814","TO","Araguaçu",8467,22458.34,17004,"Rio Formoso",1,"Norte",0,"170200",3,11,1,10,6,5,0,0,0,0,0,11,1,10,6,5,3,10.0194173163892,9.04393153364228,0.369105473165971,31
"815","TO","Araguaçu",8467,22458.34,17004,"Rio Formoso",1,"Norte",0,"170200",4,1,1,0,1,0,0,0,0,0,0,1,1,0,1,0,6,10.0194173163892,9.04393153364228,0.34780382606521,30
"816","TO","Araguaçu",8467,22458.34,17004,"Rio Formoso",1,"Norte",0,"170200",5,3,2,1,2,1,0,0,0,0,0,3,2,1,2,1,3,10.0194173163892,9.04393153364228,0.388482069385379,31
"817","TO","Araguaína",183381,24715.96,17002,"Araguaína",1,"Norte",1,"170210",2,233,38,195,95,138,1,0,1,1,0,234,38,196,96,138,69,10.1152044677947,12.1193212347464,0.290499691360703,29
"818","TO","Araguaína",183381,24715.96,17002,"Araguaína",1,"Norte",1,"170210",3,236,51,185,93,143,1,1,0,1,0,237,52,185,94,143,73,10.1152044677947,12.1193212347464,0.369860314688848,31
"819","TO","Araguaína",183381,24715.96,17002,"Araguaína",1,"Norte",1,"170210",4,204,33,171,81,123,1,0,1,0,1,205,33,172,81,124,82,10.1152044677947,12.1193212347464,0.399120131919237,30
"820","TO","Araguaína",183381,24715.96,17002,"Araguaína",1,"Norte",1,"170210",5,245,48,197,104,141,4,0,4,1,3,249,48,201,105,144,94,10.1152044677947,12.1193212347464,0.422896333989474,31
"821","TO","Araguatins",36170,12060.54,17001,"Bico do Papagaio",1,"Norte",0,"170220",2,36,5,31,14,22,0,0,0,0,0,36,5,31,14,22,11,9.39769424539816,10.4959853249461,0.235670474289129,29
"822","TO","Araguatins",36170,12060.54,17001,"Bico do Papagaio",1,"Norte",0,"170220",3,32,11,21,12,20,0,0,0,0,0,32,11,21,12,20,15,9.39769424539816,10.4959853249461,0.318866327984184,31
"823","TO","Araguatins",36170,12060.54,17001,"Bico do Papagaio",1,"Norte",0,"170220",4,28,8,20,16,12,0,0,0,0,0,28,8,20,16,12,20,9.39769424539816,10.4959853249461,0.328700407371947,30
"824","TO","Araguatins",36170,12060.54,17001,"Bico do Papagaio",1,"Norte",0,"170220",5,34,8,26,19,15,2,1,1,0,2,36,9,27,19,17,25,9.39769424539816,10.4959853249461,0.395976736842578,31
"825","TO","Arraias",10534,17500.23,17008,"Dianópolis",1,"Norte",0,"170240",2,15,5,10,3,12,0,0,0,0,0,15,5,10,3,12,2,9.76996930268238,9.26236340004333,0.303439661136353,29
"826","TO","Arraias",10534,17500.23,17008,"Dianópolis",1,"Norte",0,"170240",3,12,2,10,7,5,0,0,0,0,0,12,2,10,7,5,5,9.76996930268238,9.26236340004333,0.395946640849852,31
"827","TO","Arraias",10534,17500.23,17008,"Dianópolis",1,"Norte",0,"170240",4,11,2,9,7,4,0,0,0,0,0,11,2,9,7,4,5,9.76996930268238,9.26236340004333,0.420665942561998,30
"828","TO","Arraias",10534,17500.23,17008,"Dianópolis",1,"Norte",0,"170240",5,15,1,14,6,9,0,0,0,0,0,15,1,14,6,9,5,9.76996930268238,9.26236340004333,0.43619483234321,31
"829","TO","Augustinópolis",18643,13961.17,17001,"Bico do Papagaio",1,"Norte",1,"170255",2,26,9,17,15,11,0,0,0,0,0,26,9,17,15,11,8,9.54403518369268,9.83322601949546,0.240318934853892,29
"830","TO","Augustinópolis",18643,13961.17,17001,"Bico do Papagaio",1,"Norte",1,"170255",3,19,7,12,7,12,0,0,0,0,0,19,7,12,7,12,8,9.54403518369268,9.83322601949546,0.29870358633264,31
"831","TO","Augustinópolis",18643,13961.17,17001,"Bico do Papagaio",1,"Norte",1,"170255",4,22,2,20,11,11,0,0,0,0,0,22,2,20,11,11,7,9.54403518369268,9.83322601949546,0.338000911017738,30
"832","TO","Augustinópolis",18643,13961.17,17001,"Bico do Papagaio",1,"Norte",1,"170255",5,25,5,20,15,10,0,0,0,0,0,25,5,20,15,10,7,9.54403518369268,9.83322601949546,0.376876133221472,31
"833","TO","Barrolândia",5651,16696.13,17003,"Miracema do Tocantins",1,"Norte",0,"170310",2,5,1,4,4,1,0,0,0,0,0,5,1,4,4,1,3,9.72293223502284,8.63958779962984,0.271260906921682,29
"834","TO","Barrolândia",5651,16696.13,17003,"Miracema do Tocantins",1,"Norte",0,"170310",3,4,3,1,3,1,0,0,0,0,0,4,3,1,3,1,0,9.72293223502284,8.63958779962984,0.316216073984039,31
"835","TO","Barrolândia",5651,16696.13,17003,"Miracema do Tocantins",1,"Norte",0,"170310",4,2,0,2,2,0,0,0,0,0,0,2,0,2,2,0,3,9.72293223502284,8.63958779962984,0.379890072116215,30
"836","TO","Barrolândia",5651,16696.13,17003,"Miracema do Tocantins",1,"Norte",0,"170310",5,2,1,1,1,1,0,0,0,0,0,2,1,1,1,1,2,9.72293223502284,8.63958779962984,0.361659651051789,31
"837","TO","Colinas do Tocantins",35851,20752.91,17002,"Araguaína",1,"Norte",1,"170550",2,45,7,38,24,21,1,1,0,1,0,46,8,38,25,21,22,9.94044175678986,10.4871267396415,0.277166139021657,29
"838","TO","Colinas do Tocantins",35851,20752.91,17002,"Araguaína",1,"Norte",1,"170550",3,37,9,28,16,21,1,1,0,0,1,38,10,28,16,22,22,9.94044175678986,10.4871267396415,0.359728273836512,31
"839","TO","Colinas do Tocantins",35851,20752.91,17002,"Araguaína",1,"Norte",1,"170550",4,47,15,32,26,21,0,0,0,0,0,47,15,32,26,21,19,9.94044175678986,10.4871267396415,0.367897962610943,30
"840","TO","Colinas do Tocantins",35851,20752.91,17002,"Araguaína",1,"Norte",1,"170550",5,36,11,25,15,21,1,0,1,0,1,37,11,26,15,22,22,9.94044175678986,10.4871267396415,0.377837738426672,31
"841","TO","Cristalândia",7278,15058.8,17004,"Rio Formoso",1,"Norte",0,"170610",2,5,2,3,2,3,0,0,0,0,0,5,2,3,2,3,5,9.61971781690426,8.89261137817211,0.29659369529697,29
"842","TO","Cristalândia",7278,15058.8,17004,"Rio Formoso",1,"Norte",0,"170610",3,7,1,6,4,3,0,0,0,0,0,7,1,6,4,3,3,9.61971781690426,8.89261137817211,0.379043664874631,31
"843","TO","Cristalândia",7278,15058.8,17004,"Rio Formoso",1,"Norte",0,"170610",4,4,0,4,2,2,0,0,0,0,0,4,0,4,2,2,5,9.61971781690426,8.89261137817211,0.3828790513524,30
"844","TO","Cristalândia",7278,15058.8,17004,"Rio Formoso",1,"Norte",0,"170610",5,11,4,7,3,8,0,0,0,0,0,11,4,7,3,8,4,9.61971781690426,8.89261137817211,0.380275838997689,31
"845","TO","Dianópolis",22424,15912.16,17008,"Dianópolis",1,"Norte",1,"170700",2,22,8,14,12,10,0,0,0,0,0,22,8,14,12,10,8,9.67483887578743,10.0178870928446,0.26028128066241,29
"846","TO","Dianópolis",22424,15912.16,17008,"Dianópolis",1,"Norte",1,"170700",3,27,12,15,14,13,0,0,0,0,0,27,12,15,14,13,8,9.67483887578743,10.0178870928446,0.333794573317894,31
"847","TO","Dianópolis",22424,15912.16,17008,"Dianópolis",1,"Norte",1,"170700",4,16,5,11,9,7,1,1,0,1,0,17,6,11,10,7,7,9.67483887578743,10.0178870928446,0.350768875909323,30
"848","TO","Dianópolis",22424,15912.16,17008,"Dianópolis",1,"Norte",1,"170700",5,18,5,13,7,11,0,0,0,0,0,18,5,13,7,11,13,9.67483887578743,10.0178870928446,0.341354357417832,31
"849","TO","Divinópolis do Tocantins",6943,17949.32,17003,"Miracema do Tocantins",1,"Norte",0,"170710",2,2,0,2,1,1,0,0,0,0,0,2,0,2,1,1,5,9.79530751019049,8.84548923675327,0.212383853415693,29
"850","TO","Divinópolis do Tocantins",6943,17949.32,17003,"Miracema do Tocantins",1,"Norte",0,"170710",3,6,0,6,3,3,0,0,0,0,0,6,0,6,3,3,4,9.79530751019049,8.84548923675327,0.28129604939186,31
"851","TO","Divinópolis do Tocantins",6943,17949.32,17003,"Miracema do Tocantins",1,"Norte",0,"170710",4,7,1,6,3,4,0,0,0,0,0,7,1,6,3,4,6,9.79530751019049,8.84548923675327,0.278165597813257,30
"852","TO","Divinópolis do Tocantins",6943,17949.32,17003,"Miracema do Tocantins",1,"Norte",0,"170710",5,4,1,3,1,3,0,0,0,0,0,4,1,3,1,3,5,9.79530751019049,8.84548923675327,0.320926343701095,31
"853","TO","Dois Irmãos do Tocantins",7185,14213.92,17003,"Miracema do Tocantins",1,"Norte",0,"170720",2,6,1,5,3,3,0,0,0,0,0,6,1,5,3,3,1,9.56197704511717,8.87975079851313,0.238083809233011,29
"854","TO","Dois Irmãos do Tocantins",7185,14213.92,17003,"Miracema do Tocantins",1,"Norte",0,"170720",3,5,0,5,1,4,0,0,0,0,0,5,0,5,1,4,7,9.56197704511717,8.87975079851313,0.252305694085004,31
"855","TO","Dois Irmãos do Tocantins",7185,14213.92,17003,"Miracema do Tocantins",1,"Norte",0,"170720",4,4,2,2,2,2,0,0,0,0,0,4,2,2,2,2,3,9.56197704511717,8.87975079851313,0.342258570801153,30
"856","TO","Dois Irmãos do Tocantins",7185,14213.92,17003,"Miracema do Tocantins",1,"Norte",0,"170720",5,6,2,4,3,3,0,0,0,0,0,6,2,4,3,3,3,9.56197704511717,8.87975079851313,0.392234669220514,31
"857","TO","Formoso do Araguaia",18399,18913.66,17004,"Rio Formoso",1,"Norte",0,"170820",2,18,4,14,9,9,1,0,1,0,1,19,4,15,9,10,10,9.84763969131153,9.82005159429409,0.260253163483187,29
"858","TO","Formoso do Araguaia",18399,18913.66,17004,"Rio Formoso",1,"Norte",0,"170820",3,17,6,11,5,12,0,0,0,0,0,17,6,11,5,12,13,9.84763969131153,9.82005159429409,0.35741104346965,31
"859","TO","Formoso do Araguaia",18399,18913.66,17004,"Rio Formoso",1,"Norte",0,"170820",4,13,5,8,9,4,0,0,0,0,0,13,5,8,9,4,11,9.84763969131153,9.82005159429409,0.348084088665117,30
"860","TO","Formoso do Araguaia",18399,18913.66,17004,"Rio Formoso",1,"Norte",0,"170820",5,27,9,18,15,12,0,0,0,0,0,27,9,18,15,12,12,9.84763969131153,9.82005159429409,0.381193255902548,31
"861","TO","Goiatins",13095,12487.88,17007,"Jalapão",1,"Norte",0,"170900",2,19,7,12,12,7,0,0,0,0,0,19,7,12,12,7,6,9.43251385292424,9.47998575694181,0.286109308770267,29
"862","TO","Goiatins",13095,12487.88,17007,"Jalapão",1,"Norte",0,"170900",3,18,4,14,5,13,0,0,0,0,0,18,4,14,5,13,2,9.43251385292424,9.47998575694181,0.356797920494142,31
"863","TO","Goiatins",13095,12487.88,17007,"Jalapão",1,"Norte",0,"170900",4,14,8,6,6,8,1,1,0,0,1,15,9,6,6,9,9,9.43251385292424,9.47998575694181,0.349346931543645,30
"864","TO","Goiatins",13095,12487.88,17007,"Jalapão",1,"Norte",0,"170900",5,16,9,7,8,8,0,0,0,0,0,16,9,7,8,8,3,9.43251385292424,9.47998575694181,0.400310574537397,31
"865","TO","Guaraí",26165,25371.81,17003,"Miracema do Tocantins",1,"Norte",1,"170930",2,45,5,40,20,25,0,0,0,0,0,45,5,40,20,25,15,10.1413939941557,10.1721779188063,0.269075457490676,29
"866","TO","Guaraí",26165,25371.81,17003,"Miracema do Tocantins",1,"Norte",1,"170930",3,28,5,23,10,18,0,0,0,0,0,28,5,23,10,18,13,10.1413939941557,10.1721779188063,0.337966851256288,31
"867","TO","Guaraí",26165,25371.81,17003,"Miracema do Tocantins",1,"Norte",1,"170930",4,26,5,21,15,11,0,0,0,0,0,26,5,21,15,11,11,10.1413939941557,10.1721779188063,0.360529018279489,30
"868","TO","Guaraí",26165,25371.81,17003,"Miracema do Tocantins",1,"Norte",1,"170930",5,25,4,21,11,14,0,0,0,0,0,25,4,21,11,14,13,10.1413939941557,10.1721779188063,0.375473864021665,31
"869","TO","Gurupi",87545,25690.42,17005,"Gurupi",1,"Norte",1,"170950",2,105,22,83,41,64,2,0,2,1,1,107,22,85,42,65,37,10.1538734387441,11.3799082258604,0.27581684489804,29
"870","TO","Gurupi",87545,25690.42,17005,"Gurupi",1,"Norte",1,"170950",3,102,15,87,40,62,0,0,0,0,0,102,15,87,40,62,41,10.1538734387441,11.3799082258604,0.355954696472628,31
"871","TO","Gurupi",87545,25690.42,17005,"Gurupi",1,"Norte",1,"170950",4,90,15,75,37,53,2,0,2,1,1,92,15,77,38,54,30,10.1538734387441,11.3799082258604,0.376200000631163,30
"872","TO","Gurupi",87545,25690.42,17005,"Gurupi",1,"Norte",1,"170950",5,91,17,74,42,49,2,0,2,0,2,93,17,76,42,51,32,10.1538734387441,11.3799082258604,0.366405621259447,31
"873","TO","Lagoa da Confusão",13676,37107.01,17004,"Rio Formoso",1,"Norte",0,"171190",2,11,6,5,7,4,0,0,0,0,0,11,6,5,7,4,3,10.521561179534,9.52339775075919,0.25538274497615,29
"874","TO","Lagoa da Confusão",13676,37107.01,17004,"Rio Formoso",1,"Norte",0,"171190",3,23,9,14,12,11,0,0,0,0,0,23,9,14,12,11,3,10.521561179534,9.52339775075919,0.327645294015001,31
"875","TO","Lagoa da Confusão",13676,37107.01,17004,"Rio Formoso",1,"Norte",0,"171190",4,13,5,8,9,4,0,0,0,0,0,13,5,8,9,4,5,10.521561179534,9.52339775075919,0.347755627419395,30
"876","TO","Lagoa da Confusão",13676,37107.01,17004,"Rio Formoso",1,"Norte",0,"171190",5,18,5,13,10,8,1,0,1,0,1,19,5,14,10,9,3,10.521561179534,9.52339775075919,0.352353615683641,31
"877","TO","Miracema do Tocantins",17936,28347.5,17003,"Miracema do Tocantins",1,"Norte",0,"171320",2,28,7,21,9,19,0,0,0,0,0,28,7,21,9,19,9,10.252294121846,9.79456514531194,0.280315762146464,29
"878","TO","Miracema do Tocantins",17936,28347.5,17003,"Miracema do Tocantins",1,"Norte",0,"171320",3,22,7,15,17,5,0,0,0,0,0,22,7,15,17,5,13,10.252294121846,9.79456514531194,0.371212437200498,31
"879","TO","Miracema do Tocantins",17936,28347.5,17003,"Miracema do Tocantins",1,"Norte",0,"171320",4,19,6,13,9,10,0,0,0,0,0,19,6,13,9,10,7,10.252294121846,9.79456514531194,0.390261461156187,30
"880","TO","Miracema do Tocantins",17936,28347.5,17003,"Miracema do Tocantins",1,"Norte",0,"171320",5,23,10,13,10,13,1,0,1,0,1,24,10,14,10,14,9,10.252294121846,9.79456514531194,0.401286923192815,31
"881","TO","Miranorte",13493,19648.43,17003,"Miracema do Tocantins",1,"Norte",1,"171330",2,9,3,6,7,2,0,0,0,0,0,9,3,6,7,2,5,9.88575271588654,9.50992631143079,0.267981507293073,29
"882","TO","Miranorte",13493,19648.43,17003,"Miracema do Tocantins",1,"Norte",1,"171330",3,20,5,15,6,14,0,0,0,0,0,20,5,15,6,14,11,9.88575271588654,9.50992631143079,0.336736832784596,31
"883","TO","Miranorte",13493,19648.43,17003,"Miracema do Tocantins",1,"Norte",1,"171330",4,17,4,13,8,9,1,0,1,0,1,18,4,14,8,10,9,9.88575271588654,9.50992631143079,0.322039041422925,30
"884","TO","Miranorte",13493,19648.43,17003,"Miracema do Tocantins",1,"Norte",1,"171330",5,12,5,7,3,9,0,0,0,0,0,12,5,7,3,9,8,9.88575271588654,9.50992631143079,0.368966789411177,31
"885","TO","Natividade",9250,18906.3,17008,"Dianópolis",1,"Norte",0,"171420",2,15,3,12,7,8,0,0,0,0,0,15,3,12,7,8,3,9.84725047883785,9.13237883050647,0.253299055526202,29
"886","TO","Natividade",9250,18906.3,17008,"Dianópolis",1,"Norte",0,"171420",3,16,7,9,6,10,0,0,0,0,0,16,7,9,6,10,8,9.84725047883785,9.13237883050647,0.295570569224391,31
"887","TO","Natividade",9250,18906.3,17008,"Dianópolis",1,"Norte",0,"171420",4,9,1,8,3,6,1,0,1,0,1,10,1,9,3,7,5,9.84725047883785,9.13237883050647,0.311961349182252,30
"888","TO","Natividade",9250,18906.3,17008,"Dianópolis",1,"Norte",0,"171420",5,5,2,3,3,2,0,0,0,0,0,5,2,3,3,2,3,9.84725047883785,9.13237883050647,0.338591845703944,31
"889","TO","Palmeirópolis",7676,15543.8,17005,"Gurupi",1,"Norte",0,"171575",2,9,5,4,5,4,0,0,0,0,0,9,5,4,5,4,1,9.65141712427352,8.94585385712759,0.290617924756205,29
"890","TO","Palmeirópolis",7676,15543.8,17005,"Gurupi",1,"Norte",0,"171575",3,8,1,7,2,6,0,0,0,0,0,8,1,7,2,6,3,9.65141712427352,8.94585385712759,0.352742799926086,31
"891","TO","Palmeirópolis",7676,15543.8,17005,"Gurupi",1,"Norte",0,"171575",4,2,1,1,2,0,0,0,0,0,0,2,1,1,2,0,2,9.65141712427352,8.94585385712759,0.333173184934417,30
"892","TO","Palmeirópolis",7676,15543.8,17005,"Gurupi",1,"Norte",0,"171575",5,10,3,7,8,2,0,0,0,0,0,10,3,7,8,2,2,9.65141712427352,8.94585385712759,0.340587812729437,31
"893","TO","Paraíso do Tocantins",51891,24316.23,17004,"Rio Formoso",1,"Norte",1,"171610",2,57,5,52,21,36,0,0,0,0,0,57,5,52,21,36,20,10.0988993076164,10.856900643712,0.270512430818,29
"894","TO","Paraíso do Tocantins",51891,24316.23,17004,"Rio Formoso",1,"Norte",1,"171610",3,57,9,48,21,36,1,0,1,1,0,58,9,49,22,36,22,10.0988993076164,10.856900643712,0.343359035444137,31
"895","TO","Paraíso do Tocantins",51891,24316.23,17004,"Rio Formoso",1,"Norte",1,"171610",4,65,10,55,29,36,0,0,0,0,0,65,10,55,29,36,22,10.0988993076164,10.856900643712,0.360344488335279,30
"896","TO","Paraíso do Tocantins",51891,24316.23,17004,"Rio Formoso",1,"Norte",1,"171610",5,53,10,43,25,28,0,0,0,0,0,53,10,43,25,28,18,10.0988993076164,10.856900643712,0.360967491011987,31
"897","TO","Paranã",10437,20584.61,17008,"Dianópolis",1,"Norte",0,"171620",2,15,6,9,8,7,0,0,0,0,0,15,6,9,8,7,4,9.93229898819019,9.25311246382005,0.242596162463647,29
"898","TO","Paranã",10437,20584.61,17008,"Dianópolis",1,"Norte",0,"171620",3,11,7,4,6,5,0,0,0,0,0,11,7,4,6,5,4,9.93229898819019,9.25311246382005,0.294844463337323,31
"899","TO","Paranã",10437,20584.61,17008,"Dianópolis",1,"Norte",0,"171620",4,14,5,9,5,9,0,0,0,0,0,14,5,9,5,9,3,9.93229898819019,9.25311246382005,0.310417461698069,30
"900","TO","Paranã",10437,20584.61,17008,"Dianópolis",1,"Norte",0,"171620",5,19,4,15,8,11,0,0,0,0,0,19,4,15,8,11,4,9.93229898819019,9.25311246382005,0.343136283990171,31
"901","TO","Pedro Afonso",13773,39844.35,17006,"Porto Nacional",1,"Norte",0,"171650",2,16,5,11,8,8,0,0,0,0,0,16,5,11,8,8,4,10.5927358924851,9.53046543291733,0.270705523598729,29
"902","TO","Pedro Afonso",13773,39844.35,17006,"Porto Nacional",1,"Norte",0,"171650",3,17,1,16,9,8,0,0,0,0,0,17,1,16,9,8,7,10.5927358924851,9.53046543291733,0.334555791564104,31
"903","TO","Pedro Afonso",13773,39844.35,17006,"Porto Nacional",1,"Norte",0,"171650",4,15,3,12,6,9,0,0,0,0,0,15,3,12,6,9,8,10.5927358924851,9.53046543291733,0.343439176922779,30
"904","TO","Pedro Afonso",13773,39844.35,17006,"Porto Nacional",1,"Norte",0,"171650",5,24,5,19,11,13,1,1,0,0,1,25,6,19,11,14,8,10.5927358924851,9.53046543291733,0.337832679774114,31
"905","TO","Peixe",11873,45449.34,17005,"Gurupi",1,"Norte",0,"171660",2,6,2,4,3,3,0,0,0,0,0,6,2,4,3,3,2,10.724353578048,9.38202219366579,0.286013106763162,29
"906","TO","Peixe",11873,45449.34,17005,"Gurupi",1,"Norte",0,"171660",3,8,2,6,4,4,0,0,0,0,0,8,2,6,4,4,5,10.724353578048,9.38202219366579,0.324397344600241,31
"907","TO","Peixe",11873,45449.34,17005,"Gurupi",1,"Norte",0,"171660",4,13,5,8,8,5,0,0,0,0,0,13,5,8,8,5,2,10.724353578048,9.38202219366579,0.359115047136497,30
"908","TO","Peixe",11873,45449.34,17005,"Gurupi",1,"Norte",0,"171660",5,8,5,3,5,3,0,0,0,0,0,8,5,3,5,3,3,10.724353578048,9.38202219366579,0.389701271238077,31
"909","TO","Colméia",8141,17497.68,17003,"Miracema do Tocantins",1,"Norte",0,"171670",2,7,1,6,6,1,0,0,0,0,0,7,1,6,6,1,2,9.76982357969467,9.00466830157398,0.281339480534432,29
"910","TO","Colméia",8141,17497.68,17003,"Miracema do Tocantins",1,"Norte",0,"171670",3,14,6,8,10,4,0,0,0,0,0,14,6,8,10,4,7,9.76982357969467,9.00466830157398,0.343729622782285,31
"911","TO","Colméia",8141,17497.68,17003,"Miracema do Tocantins",1,"Norte",0,"171670",4,7,2,5,2,5,0,0,0,0,0,7,2,5,2,5,4,9.76982357969467,9.00466830157398,0.35471258990837,30
"912","TO","Colméia",8141,17497.68,17003,"Miracema do Tocantins",1,"Norte",0,"171670",5,9,3,6,5,4,0,0,0,0,0,9,3,6,5,4,4,9.76982357969467,9.00466830157398,0.385245534313013,31
"913","TO","Porto Nacional",53316,31830.46,17006,"Porto Nacional",1,"Norte",1,"171820",2,82,21,61,43,39,0,0,0,0,0,82,21,61,43,39,27,10.3681789719468,10.8839917527239,0.258321404366753,29
"914","TO","Porto Nacional",53316,31830.46,17006,"Porto Nacional",1,"Norte",1,"171820",3,88,12,76,33,55,1,0,1,0,1,89,12,77,33,56,29,10.3681789719468,10.8839917527239,0.340738915363424,31
"915","TO","Porto Nacional",53316,31830.46,17006,"Porto Nacional",1,"Norte",1,"171820",4,89,18,71,38,51,0,0,0,0,0,89,18,71,38,51,27,10.3681789719468,10.8839917527239,0.364677954909008,30
"916","TO","Porto Nacional",53316,31830.46,17006,"Porto Nacional",1,"Norte",1,"171820",5,84,8,76,37,47,1,0,1,0,1,85,8,77,37,48,33,10.3681789719468,10.8839917527239,0.358299988796226,31
"917","TO","Taguatinga",16825,14648.47,17008,"Dianópolis",1,"Norte",0,"172090",2,10,3,7,4,6,0,0,0,0,0,10,3,7,4,6,10,9.59209117213124,9.73062115451293,0.244066308617301,29
"918","TO","Taguatinga",16825,14648.47,17008,"Dianópolis",1,"Norte",0,"172090",3,11,4,7,3,8,0,0,0,0,0,11,4,7,3,8,4,9.59209117213124,9.73062115451293,0.308666365541426,31
"919","TO","Taguatinga",16825,14648.47,17008,"Dianópolis",1,"Norte",0,"172090",4,12,6,6,5,7,0,0,0,0,0,12,6,6,5,7,6,9.59209117213124,9.73062115451293,0.315684723083385,30
"920","TO","Taguatinga",16825,14648.47,17008,"Dianópolis",1,"Norte",0,"172090",5,17,6,11,10,7,0,0,0,0,0,17,6,11,10,7,5,9.59209117213124,9.73062115451293,0.333110682873481,31
"921","TO","Palmas",306296,32293.89,17006,"Porto Nacional",1,"Norte",1,"172100",2,355,44,311,135,220,2,0,2,0,2,357,44,313,135,222,94,10.3826333272303,12.6323072336432,0.269610545954865,29
"922","TO","Palmas",306296,32293.89,17006,"Porto Nacional",1,"Norte",1,"172100",3,390,43,347,151,239,2,1,1,1,1,392,44,348,152,240,101,10.3826333272303,12.6323072336432,0.38305825820778,31
"923","TO","Palmas",306296,32293.89,17006,"Porto Nacional",1,"Norte",1,"172100",4,382,41,341,122,260,2,0,2,0,2,384,41,343,122,262,87,10.3826333272303,12.6323072336432,0.429371695291192,30
"924","TO","Palmas",306296,32293.89,17006,"Porto Nacional",1,"Norte",1,"172100",5,416,42,374,137,279,5,3,2,4,1,421,45,376,141,280,82,10.3826333272303,12.6323072336432,0.404161089753356,31
"925","TO","Tocantinópolis",22845,12913.56,17001,"Bico do Papagaio",1,"Norte",1,"172120",2,30,7,23,12,18,0,0,0,0,0,30,7,23,12,18,16,9.46603320105571,10.0364875539974,0.253148071743011,29
"926","TO","Tocantinópolis",22845,12913.56,17001,"Bico do Papagaio",1,"Norte",1,"172120",3,28,10,18,14,14,2,0,2,0,2,30,10,20,14,16,9,9.46603320105571,10.0364875539974,0.319033713573419,31
"927","TO","Tocantinópolis",22845,12913.56,17001,"Bico do Papagaio",1,"Norte",1,"172120",4,23,8,15,12,11,0,0,0,0,0,23,8,15,12,11,10,9.46603320105571,10.0364875539974,0.32944394982845,30
"928","TO","Tocantinópolis",22845,12913.56,17001,"Bico do Papagaio",1,"Norte",1,"172120",5,39,5,34,24,15,0,0,0,0,0,39,5,34,24,15,10,9.46603320105571,10.0364875539974,0.375937466465335,31
"929","TO","Wanderlândia",11734,12089.51,17002,"Araguaína",1,"Norte",0,"172208",2,10,2,8,8,2,0,0,0,0,0,10,2,8,8,2,5,9.40009341342439,9.3702458894858,0.291661995173627,29
"930","TO","Wanderlândia",11734,12089.51,17002,"Araguaína",1,"Norte",0,"172208",3,8,2,6,6,2,0,0,0,0,0,8,2,6,6,2,1,9.40009341342439,9.3702458894858,0.342957449434789,31
"931","TO","Wanderlândia",11734,12089.51,17002,"Araguaína",1,"Norte",0,"172208",4,12,4,8,6,6,0,0,0,0,0,12,4,8,6,6,4,9.40009341342439,9.3702458894858,0.40638625328525,30
"932","TO","Wanderlândia",11734,12089.51,17002,"Araguaína",1,"Norte",0,"172208",5,12,3,9,9,3,0,0,0,0,0,12,3,9,9,3,4,9.40009341342439,9.3702458894858,0.417838815201106,31
"933","TO","Xambioá",11520,25166.89,17002,"Araguaína",1,"Norte",0,"172210",2,13,2,11,3,10,0,0,0,0,0,13,2,11,3,10,8,10.1332845207018,9.35183993424988,0.266603513386236,29
"934","TO","Xambioá",11520,25166.89,17002,"Araguaína",1,"Norte",0,"172210",3,16,4,12,5,11,0,0,0,0,0,16,4,12,5,11,6,10.1332845207018,9.35183993424988,0.319900834797167,31
"935","TO","Xambioá",11520,25166.89,17002,"Araguaína",1,"Norte",0,"172210",4,10,4,6,4,6,0,0,0,0,0,10,4,6,4,6,4,10.1332845207018,9.35183993424988,0.327038805016615,30
"936","TO","Xambioá",11520,25166.89,17002,"Araguaína",1,"Norte",0,"172210",5,11,4,7,5,6,0,0,0,0,0,11,4,7,5,6,12,10.1332845207018,9.35183993424988,0.40187071179515,31
"937","MA","Açailândia",113121,23289.73,21009,"Imperatriz",2,"Nordeste",1,"210005",2,105,25,80,49,56,1,1,0,0,1,106,26,80,49,57,66,10.0557677698528,11.6362133212611,0.299808810768889,29
"938","MA","Açailândia",113121,23289.73,21009,"Imperatriz",2,"Nordeste",1,"210005",3,134,36,98,66,68,0,0,0,0,0,134,36,98,66,68,44,10.0557677698528,11.6362133212611,0.384441131209705,31
"939","MA","Açailândia",113121,23289.73,21009,"Imperatriz",2,"Nordeste",1,"210005",4,134,34,100,66,68,0,0,0,0,0,134,34,100,66,68,42,10.0557677698528,11.6362133212611,0.417157112009066,30
"940","MA","Açailândia",113121,23289.73,21009,"Imperatriz",2,"Nordeste",1,"210005",5,142,45,97,59,83,4,2,2,3,1,146,47,99,62,84,140,10.0557677698528,11.6362133212611,0.435470581934144,31
"941","MA","Água Doce do Maranhão",12652,6901.51,21013,"Baixo Parnaíba Maranhense",2,"Nordeste",0,"210015",2,7,2,5,4,3,0,0,0,0,0,7,2,5,4,3,4,8.83949550722295,9.44557058442554,0.374725868806758,29
"942","MA","Água Doce do Maranhão",12652,6901.51,21013,"Baixo Parnaíba Maranhense",2,"Nordeste",0,"210015",3,10,7,3,5,5,0,0,0,0,0,10,7,3,5,5,2,8.83949550722295,9.44557058442554,0.485892655033585,31
"943","MA","Água Doce do Maranhão",12652,6901.51,21013,"Baixo Parnaíba Maranhense",2,"Nordeste",0,"210015",4,12,5,7,10,2,0,0,0,0,0,12,5,7,10,2,4,8.83949550722295,9.44557058442554,0.529817574771441,30
"944","MA","Água Doce do Maranhão",12652,6901.51,21013,"Baixo Parnaíba Maranhense",2,"Nordeste",0,"210015",5,15,5,10,10,5,0,0,0,0,0,15,5,10,10,5,3,8.83949550722295,9.44557058442554,0.541694512479368,31
"945","MA","Alcântara",22112,5880.13,21001,"Litoral Ocidental Maranhense",2,"Nordeste",0,"210020",2,9,4,5,5,4,0,0,0,0,0,9,4,5,5,4,7,8.67933414949181,10.0038757265674,0.325198115331732,29
"946","MA","Alcântara",22112,5880.13,21001,"Litoral Ocidental Maranhense",2,"Nordeste",0,"210020",3,11,3,8,6,5,0,0,0,0,0,11,3,8,6,5,5,8.67933414949181,10.0038757265674,0.423739410790786,31
"947","MA","Alcântara",22112,5880.13,21001,"Litoral Ocidental Maranhense",2,"Nordeste",0,"210020",4,12,5,7,7,5,0,0,0,0,0,12,5,7,7,5,7,8.67933414949181,10.0038757265674,0.463684885282483,30
"948","MA","Alcântara",22112,5880.13,21001,"Litoral Ocidental Maranhense",2,"Nordeste",0,"210020",5,12,4,8,5,7,1,1,0,1,0,13,5,8,6,7,16,8.67933414949181,10.0038757265674,0.506954524399368,31
"949","MA","Aldeias Altas",26757,6895.22,21016,"Coelho Neto",2,"Nordeste",0,"210030",2,37,18,19,17,20,2,2,0,1,1,39,20,19,18,21,14,8.83858369689749,10.1945514003343,0.321300846781306,29
"950","MA","Aldeias Altas",26757,6895.22,21016,"Coelho Neto",2,"Nordeste",0,"210030",3,35,22,13,20,15,0,0,0,0,0,35,22,13,20,15,10,8.83858369689749,10.1945514003343,0.403854855103586,31
"951","MA","Aldeias Altas",26757,6895.22,21016,"Coelho Neto",2,"Nordeste",0,"210030",4,35,12,23,19,16,2,1,1,2,0,37,13,24,21,16,8,8.83858369689749,10.1945514003343,0.433565791233711,30
"952","MA","Aldeias Altas",26757,6895.22,21016,"Coelho Neto",2,"Nordeste",0,"210030",5,31,18,13,13,18,0,0,0,0,0,31,18,13,13,18,12,8.83858369689749,10.1945514003343,0.415062396805155,31
"953","MA","Altamira do Maranhão",8189,7008.78,21008,"Pindaré",2,"Nordeste",0,"210040",2,6,1,5,4,2,0,0,0,0,0,6,1,5,4,2,3,8.85491892779255,9.01054706927019,0.27471707793615,29
"954","MA","Altamira do Maranhão",8189,7008.78,21008,"Pindaré",2,"Nordeste",0,"210040",3,7,1,6,4,3,0,0,0,0,0,7,1,6,4,3,3,8.85491892779255,9.01054706927019,0.405567597677751,31
"955","MA","Altamira do Maranhão",8189,7008.78,21008,"Pindaré",2,"Nordeste",0,"210040",4,7,5,2,2,5,0,0,0,0,0,7,5,2,2,5,4,8.85491892779255,9.01054706927019,0.440787960893149,30
"956","MA","Altamira do Maranhão",8189,7008.78,21008,"Pindaré",2,"Nordeste",0,"210040",5,4,2,2,3,1,0,0,0,0,0,4,2,2,3,1,2,8.85491892779255,9.01054706927019,0.478747234418827,31
"957","MA","Alto Alegre do Maranhão",27858,10020.02,21015,"Codó",2,"Nordeste",1,"210043",2,37,16,21,16,21,0,0,0,0,0,37,16,21,16,21,12,9.21234037064485,10.234875457248,0.278421245203477,29
"958","MA","Alto Alegre do Maranhão",27858,10020.02,21015,"Codó",2,"Nordeste",1,"210043",3,30,14,16,16,14,1,1,0,1,0,31,15,16,17,14,14,9.21234037064485,10.234875457248,0.35782025147281,31
"959","MA","Alto Alegre do Maranhão",27858,10020.02,21015,"Codó",2,"Nordeste",1,"210043",4,26,12,14,15,11,1,0,1,1,0,27,12,15,16,11,14,9.21234037064485,10.234875457248,0.374353757269339,30
"960","MA","Alto Alegre do Maranhão",27858,10020.02,21015,"Codó",2,"Nordeste",1,"210043",5,33,10,23,22,11,0,0,0,0,0,33,10,23,22,11,28,9.21234037064485,10.234875457248,0.376196140991188,31
"961","MA","Alto Alegre do Pindaré",31943,5980.04,21008,"Pindaré",2,"Nordeste",0,"210047",2,37,17,20,24,13,0,0,0,0,0,37,17,20,24,13,7,8.69618253588552,10.3717083434697,0.327073419595343,29
"962","MA","Alto Alegre do Pindaré",31943,5980.04,21008,"Pindaré",2,"Nordeste",0,"210047",3,35,10,25,23,12,0,0,0,0,0,35,10,25,23,12,11,8.69618253588552,10.3717083434697,0.418202348570929,31
"963","MA","Alto Alegre do Pindaré",31943,5980.04,21008,"Pindaré",2,"Nordeste",0,"210047",4,16,4,12,8,8,0,0,0,0,0,16,4,12,8,8,10,8.69618253588552,10.3717083434697,0.433526133092254,30
"964","MA","Alto Alegre do Pindaré",31943,5980.04,21008,"Pindaré",2,"Nordeste",0,"210047",5,36,9,27,25,11,0,0,0,0,0,36,9,27,25,11,18,8.69618253588552,10.3717083434697,0.493378287403283,31
"965","MA","Alto Parnaíba",11212,31263.56,21020,"Gerais de Balsas",2,"Nordeste",0,"210050",2,17,6,11,9,8,0,0,0,0,0,17,6,11,9,8,8,10.3502084810485,9.32473991228468,0.291306959808715,29
"966","MA","Alto Parnaíba",11212,31263.56,21020,"Gerais de Balsas",2,"Nordeste",0,"210050",3,4,0,4,2,2,1,0,1,1,0,5,0,5,3,2,4,10.3502084810485,9.32473991228468,0.363263235394251,31
"967","MA","Alto Parnaíba",11212,31263.56,21020,"Gerais de Balsas",2,"Nordeste",0,"210050",4,9,5,4,3,6,0,0,0,0,0,9,5,4,3,6,4,10.3502084810485,9.32473991228468,0.376486008150749,30
"968","MA","Alto Parnaíba",11212,31263.56,21020,"Gerais de Balsas",2,"Nordeste",0,"210050",5,4,2,2,2,2,0,0,0,0,0,4,2,2,2,2,3,10.3502084810485,9.32473991228468,0.397870288788347,31
"969","MA","Amarante do Maranhão",41729,7638.94,21009,"Imperatriz",2,"Nordeste",0,"210060",2,48,30,18,29,19,1,1,0,0,1,49,31,18,29,20,21,8.9410141290793,10.6389516097231,0.297142362027702,29
"970","MA","Amarante do Maranhão",41729,7638.94,21009,"Imperatriz",2,"Nordeste",0,"210060",3,42,25,17,27,15,0,0,0,0,0,42,25,17,27,15,16,8.9410141290793,10.6389516097231,0.375223916936409,31
"971","MA","Amarante do Maranhão",41729,7638.94,21009,"Imperatriz",2,"Nordeste",0,"210060",4,54,33,21,25,29,2,2,0,1,1,56,35,21,26,30,15,8.9410141290793,10.6389516097231,0.369699850375398,30
"972","MA","Amarante do Maranhão",41729,7638.94,21009,"Imperatriz",2,"Nordeste",0,"210060",5,60,39,21,46,14,0,0,0,0,0,60,39,21,46,14,29,8.9410141290793,10.6389516097231,0.417550796622789,31
"973","MA","Anajatuba",26988,6692.9,21005,"Baixada Maranhense",2,"Nordeste",0,"210070",2,22,6,16,10,12,0,0,0,0,0,22,6,16,10,12,16,8.80880254200591,10.2031476017473,0.307357811884076,29
"974","MA","Anajatuba",26988,6692.9,21005,"Baixada Maranhense",2,"Nordeste",0,"210070",3,19,5,14,8,11,0,0,0,0,0,19,5,14,8,11,13,8.80880254200591,10.2031476017473,0.399446732408006,31
"975","MA","Anajatuba",26988,6692.9,21005,"Baixada Maranhense",2,"Nordeste",0,"210070",4,21,9,12,7,14,0,0,0,0,0,21,9,12,7,14,13,8.80880254200591,10.2031476017473,0.427722918305637,30
"976","MA","Anajatuba",26988,6692.9,21005,"Baixada Maranhense",2,"Nordeste",0,"210070",5,16,8,8,11,5,0,0,0,0,0,16,8,8,11,5,18,8.80880254200591,10.2031476017473,0.478304711989059,31
"977","MA","Anapurus",15894,8464.04,21014,"Chapadinha",2,"Nordeste",0,"210080",2,14,4,10,5,9,0,0,0,0,0,14,4,10,5,9,2,9.04358187998483,9.67369695850013,0.263563978767629,29
"978","MA","Anapurus",15894,8464.04,21014,"Chapadinha",2,"Nordeste",0,"210080",3,13,7,6,7,6,1,1,0,1,0,14,8,6,8,6,8,9.04358187998483,9.67369695850013,0.362500362830444,31
"979","MA","Anapurus",15894,8464.04,21014,"Chapadinha",2,"Nordeste",0,"210080",4,23,7,16,13,10,0,0,0,0,0,23,7,16,13,10,3,9.04358187998483,9.67369695850013,0.381381998850474,30
"980","MA","Anapurus",15894,8464.04,21014,"Chapadinha",2,"Nordeste",0,"210080",5,17,6,11,11,6,1,1,0,1,0,18,7,11,12,6,12,9.04358187998483,9.67369695850013,0.451021333442129,31
"981","MA","Apicum-Açu",17413,6388.28,21001,"Litoral Ocidental Maranhense",2,"Nordeste",0,"210083",2,23,9,14,12,11,0,0,0,0,0,23,9,14,12,11,6,8.76222034055965,9.76497233267938,0.289036986474103,29
"982","MA","Apicum-Açu",17413,6388.28,21001,"Litoral Ocidental Maranhense",2,"Nordeste",0,"210083",3,12,6,6,6,6,1,0,1,1,0,13,6,7,7,6,9,8.76222034055965,9.76497233267938,0.342496688990232,31
"983","MA","Apicum-Açu",17413,6388.28,21001,"Litoral Ocidental Maranhense",2,"Nordeste",0,"210083",4,12,6,6,8,4,1,0,1,0,1,13,6,7,8,5,5,8.76222034055965,9.76497233267938,0.355443989728736,30
"984","MA","Apicum-Açu",17413,6388.28,21001,"Litoral Ocidental Maranhense",2,"Nordeste",0,"210083",5,15,11,4,9,6,0,0,0,0,0,15,11,4,9,6,12,8.76222034055965,9.76497233267938,0.389335324037491,31
"985","MA","Araguanã",15551,5309.7,21008,"Pindaré",2,"Nordeste",0,"210087",2,8,5,3,5,3,0,0,0,0,0,8,5,3,5,3,1,8.57729061546482,9.65188022422134,0.328873971288898,29
"986","MA","Araguanã",15551,5309.7,21008,"Pindaré",2,"Nordeste",0,"210087",3,8,4,4,7,1,2,1,1,0,2,10,5,5,7,3,3,8.57729061546482,9.65188022422134,0.386527797784603,31
"987","MA","Araguanã",15551,5309.7,21008,"Pindaré",2,"Nordeste",0,"210087",4,1,0,1,1,0,0,0,0,0,0,1,0,1,1,0,0,8.57729061546482,9.65188022422134,0.390548683486333,30
"988","MA","Araguanã",15551,5309.7,21008,"Pindaré",2,"Nordeste",0,"210087",5,6,2,4,4,2,0,0,0,0,0,6,2,4,4,2,1,8.57729061546482,9.65188022422134,0.490149506328551,31
"989","MA","Araioses",46771,5853.72,21013,"Baixo Parnaíba Maranhense",2,"Nordeste",0,"210090",2,51,29,22,31,20,1,0,1,1,0,52,29,23,32,20,15,8.6748326355647,10.7530186317186,0.340389320044272,29
"990","MA","Araioses",46771,5853.72,21013,"Baixo Parnaíba Maranhense",2,"Nordeste",0,"210090",3,49,18,31,31,18,0,0,0,0,0,49,18,31,31,18,22,8.6748326355647,10.7530186317186,0.441465069716969,31
"991","MA","Araioses",46771,5853.72,21013,"Baixo Parnaíba Maranhense",2,"Nordeste",0,"210090",4,41,22,19,24,17,0,0,0,0,0,41,22,19,24,17,18,8.6748326355647,10.7530186317186,0.446686314341891,30
"992","MA","Araioses",46771,5853.72,21013,"Baixo Parnaíba Maranhense",2,"Nordeste",0,"210090",5,29,16,13,17,12,1,0,1,0,1,30,16,14,17,13,28,8.6748326355647,10.7530186317186,0.523785974952606,31
"993","MA","Arame",32764,7157.11,21011,"Alto Mearim e Grajaú",2,"Nordeste",0,"210095",2,44,28,16,26,18,0,0,0,0,0,44,28,16,26,18,16,8.87586154718874,10.3970856306355,0.278041137164483,29
"994","MA","Arame",32764,7157.11,21011,"Alto Mearim e Grajaú",2,"Nordeste",0,"210095",3,50,28,22,30,20,1,0,1,0,1,51,28,23,30,21,11,8.87586154718874,10.3970856306355,0.334445105570158,31
"995","MA","Arame",32764,7157.11,21011,"Alto Mearim e Grajaú",2,"Nordeste",0,"210095",4,33,26,7,20,13,1,0,1,1,0,34,26,8,21,13,5,8.87586154718874,10.3970856306355,0.359055695499871,30
"996","MA","Arame",32764,7157.11,21011,"Alto Mearim e Grajaú",2,"Nordeste",0,"210095",5,52,35,17,30,22,1,1,0,1,0,53,36,17,31,22,12,8.87586154718874,10.3970856306355,0.431155996781959,31
"997","MA","Arari",29932,8528.04,21005,"Baixada Maranhense",2,"Nordeste",0,"210100",2,38,17,21,19,19,0,0,0,0,0,38,17,21,19,19,26,9.05111483682615,10.3066834212002,0.295770545996326,29
"998","MA","Arari",29932,8528.04,21005,"Baixada Maranhense",2,"Nordeste",0,"210100",3,31,9,22,18,13,0,0,0,0,0,31,9,22,18,13,22,9.05111483682615,10.3066834212002,0.385240172778299,31
"999","MA","Arari",29932,8528.04,21005,"Baixada Maranhense",2,"Nordeste",0,"210100",4,35,12,23,20,15,1,0,1,1,0,36,12,24,21,15,13,9.05111483682615,10.3066834212002,0.427621780701691,30
"1000","MA","Arari",29932,8528.04,21005,"Baixada Maranhense",2,"Nordeste",0,"210100",5,31,10,21,17,14,0,0,0,0,0,31,10,21,17,14,25,9.05111483682615,10.3066834212002,0.460417579063825,31
"1001","MA","Bacabal",104790,10881.15,21010,"Médio Mearim",2,"Nordeste",1,"210120",2,140,46,94,73,67,1,0,1,1,0,141,46,95,74,67,49,9.29478721335365,11.559713626469,0.273464133173844,29
"1002","MA","Bacabal",104790,10881.15,21010,"Médio Mearim",2,"Nordeste",1,"210120",3,117,29,88,63,54,0,0,0,0,0,117,29,88,63,54,63,9.29478721335365,11.559713626469,0.366916719651683,31
"1003","MA","Bacabal",104790,10881.15,21010,"Médio Mearim",2,"Nordeste",1,"210120",4,124,27,97,72,52,1,0,1,1,0,125,27,98,73,52,52,9.29478721335365,11.559713626469,0.412233411200442,30
"1004","MA","Bacabal",104790,10881.15,21010,"Médio Mearim",2,"Nordeste",1,"210120",5,116,41,75,69,47,1,0,1,0,1,117,41,76,69,48,104,9.29478721335365,11.559713626469,0.42797850402346,31
"1005","MA","Bacabeira",17252,18224.09,21003,"Rosário",2,"Nordeste",0,"210125",2,21,7,14,14,7,1,1,0,0,1,22,8,14,14,8,6,9.81049962421735,9.75568335776773,0.281694812265924,29
"1006","MA","Bacabeira",17252,18224.09,21003,"Rosário",2,"Nordeste",0,"210125",3,8,4,4,6,2,1,0,1,1,0,9,4,5,7,2,9,9.81049962421735,9.75568335776773,0.350759654489503,31
"1007","MA","Bacabeira",17252,18224.09,21003,"Rosário",2,"Nordeste",0,"210125",4,15,2,13,9,6,0,0,0,0,0,15,2,13,9,6,8,9.81049962421735,9.75568335776773,0.370020080889306,30
"1008","MA","Bacabeira",17252,18224.09,21003,"Rosário",2,"Nordeste",0,"210125",5,9,1,8,5,4,0,0,0,0,0,9,1,8,5,4,21,9.81049962421735,9.75568335776773,0.365535785024979,31
"1009","MA","Bacuri",18654,5320.4,21001,"Litoral Ocidental Maranhense",2,"Nordeste",0,"210130",2,27,7,20,17,10,0,0,0,0,0,27,7,20,17,10,8,8.57930376747914,9.83381587928681,0.311782133543932,29
"1010","MA","Bacuri",18654,5320.4,21001,"Litoral Ocidental Maranhense",2,"Nordeste",0,"210130",3,12,1,11,7,5,0,0,0,0,0,12,1,11,7,5,5,8.57930376747914,9.83381587928681,0.386316973524286,31
"1011","MA","Bacuri",18654,5320.4,21001,"Litoral Ocidental Maranhense",2,"Nordeste",0,"210130",4,13,7,6,11,2,0,0,0,0,0,13,7,6,11,2,12,8.57930376747914,9.83381587928681,0.468972131784673,30
"1012","MA","Bacuri",18654,5320.4,21001,"Litoral Ocidental Maranhense",2,"Nordeste",0,"210130",5,19,6,13,10,9,0,0,0,0,0,19,6,13,10,9,17,8.57930376747914,9.83381587928681,0.492852313921745,31
"1013","MA","Balsas",95929,36852.56,21020,"Gerais de Balsas",2,"Nordeste",1,"210140",2,141,43,98,64,77,2,0,2,0,2,143,43,100,64,79,36,10.5146803660322,11.47136361349,0.284056831297561,29
"1014","MA","Balsas",95929,36852.56,21020,"Gerais de Balsas",2,"Nordeste",1,"210140",3,159,49,110,75,84,0,0,0,0,0,159,49,110,75,84,57,10.5146803660322,11.47136361349,0.356192881968187,31
"1015","MA","Balsas",95929,36852.56,21020,"Gerais de Balsas",2,"Nordeste",1,"210140",4,131,41,90,60,71,1,0,1,1,0,132,41,91,61,71,32,10.5146803660322,11.47136361349,0.368924077406057,30
"1016","MA","Balsas",95929,36852.56,21020,"Gerais de Balsas",2,"Nordeste",1,"210140",5,150,44,106,79,71,1,0,1,0,1,151,44,107,79,72,53,10.5146803660322,11.47136361349,0.378518395232266,31
"1017","MA","Barão de Grajaú",18924,11089.03,21018,"Chapadas do Alto Itapecuru",2,"Nordeste",1,"210150",2,17,7,10,8,9,0,0,0,0,0,17,7,10,8,9,14,9.31371161033327,9.84818623675104,0.241098495012787,29
"1018","MA","Barão de Grajaú",18924,11089.03,21018,"Chapadas do Alto Itapecuru",2,"Nordeste",1,"210150",3,25,8,17,11,14,1,1,0,0,1,26,9,17,11,15,16,9.31371161033327,9.84818623675104,0.375852779297947,31
"1019","MA","Barão de Grajaú",18924,11089.03,21018,"Chapadas do Alto Itapecuru",2,"Nordeste",1,"210150",4,20,10,10,14,6,0,0,0,0,0,20,10,10,14,6,9,9.31371161033327,9.84818623675104,0.412028225925413,30
"1020","MA","Barão de Grajaú",18924,11089.03,21018,"Chapadas do Alto Itapecuru",2,"Nordeste",1,"210150",5,25,7,18,10,15,0,0,0,0,0,25,7,18,10,15,15,9.31371161033327,9.84818623675104,0.40889809616117,31
"1021","MA","Barra do Corda",88492,8239.59,21011,"Alto Mearim e Grajaú",2,"Nordeste",1,"210160",2,105,48,57,60,45,2,0,2,0,2,107,48,59,60,47,42,9.01670586438403,11.3906674314299,0.296259432725647,29
"1022","MA","Barra do Corda",88492,8239.59,21011,"Alto Mearim e Grajaú",2,"Nordeste",1,"210160",3,78,41,37,35,43,1,1,0,0,1,79,42,37,35,44,45,9.01670586438403,11.3906674314299,0.400322799324701,31
"1023","MA","Barra do Corda",88492,8239.59,21011,"Alto Mearim e Grajaú",2,"Nordeste",1,"210160",4,99,44,55,55,44,2,2,0,1,1,101,46,55,56,45,34,9.01670586438403,11.3906674314299,0.407502040927003,30
"1024","MA","Barra do Corda",88492,8239.59,21011,"Alto Mearim e Grajaú",2,"Nordeste",1,"210160",5,121,54,67,60,61,2,0,2,1,1,123,54,69,61,62,47,9.01670586438403,11.3906674314299,0.473404693337088,31
"1025","MA","Barreirinhas",63217,7851.92,21004,"Lençóis Maranhenses",2,"Nordeste",0,"210170",2,95,34,61,49,46,1,1,0,1,0,96,35,61,50,46,11,8.96851336685744,11.0543285313061,0.245300192154181,29
"1026","MA","Barreirinhas",63217,7851.92,21004,"Lençóis Maranhenses",2,"Nordeste",0,"210170",3,89,31,58,42,47,3,3,0,2,1,92,34,58,44,48,29,8.96851336685744,11.0543285313061,0.327434980322306,31
"1027","MA","Barreirinhas",63217,7851.92,21004,"Lençóis Maranhenses",2,"Nordeste",0,"210170",4,81,35,46,40,41,3,2,1,1,2,84,37,47,41,43,20,8.96851336685744,11.0543285313061,0.37465541686871,30
"1028","MA","Barreirinhas",63217,7851.92,21004,"Lençóis Maranhenses",2,"Nordeste",0,"210170",5,101,35,66,54,47,0,0,0,0,0,101,35,66,54,47,64,8.96851336685744,11.0543285313061,0.403060387951543,31
"1029","MA","Bela Vista do Maranhão",11279,7613.43,21005,"Baixada Maranhense",2,"Nordeste",0,"210177",2,18,6,12,7,11,1,1,0,0,1,19,7,12,7,12,5,8.937669072044,9.33069786863992,0.317849262028748,29
"1030","MA","Bela Vista do Maranhão",11279,7613.43,21005,"Baixada Maranhense",2,"Nordeste",0,"210177",3,12,3,9,8,4,0,0,0,0,0,12,3,9,8,4,6,8.937669072044,9.33069786863992,0.408746388440822,31
"1031","MA","Bela Vista do Maranhão",11279,7613.43,21005,"Baixada Maranhense",2,"Nordeste",0,"210177",4,12,4,8,7,5,1,1,0,1,0,13,5,8,8,5,9,8.937669072044,9.33069786863992,0.42109685422388,30
"1032","MA","Bela Vista do Maranhão",11279,7613.43,21005,"Baixada Maranhense",2,"Nordeste",0,"210177",5,10,4,6,4,6,1,0,1,0,1,11,4,7,4,7,8,8.937669072044,9.33069786863992,0.446408701140827,31
"1033","MA","Bequimão",21299,6082.57,21001,"Litoral Ocidental Maranhense",2,"Nordeste",0,"210190",2,17,3,14,7,10,0,0,0,0,0,17,3,14,7,10,12,8.71318258301727,9.9664154022386,0.261476016230329,29
"1034","MA","Bequimão",21299,6082.57,21001,"Litoral Ocidental Maranhense",2,"Nordeste",0,"210190",3,8,2,6,2,6,1,0,1,1,0,9,2,7,3,6,11,8.71318258301727,9.9664154022386,0.351170654628481,31
"1035","MA","Bequimão",21299,6082.57,21001,"Litoral Ocidental Maranhense",2,"Nordeste",0,"210190",4,13,5,8,8,5,0,0,0,0,0,13,5,8,8,5,6,8.71318258301727,9.9664154022386,0.399408554408009,30
"1036","MA","Bequimão",21299,6082.57,21001,"Litoral Ocidental Maranhense",2,"Nordeste",0,"210190",5,23,10,13,14,9,0,0,0,0,0,23,10,13,14,9,12,8.71318258301727,9.9664154022386,0.486441393779555,31
"1037","MA","Bom Jardim",41822,7607.9,21008,"Pindaré",2,"Nordeste",0,"210200",2,43,19,24,29,14,0,0,0,0,0,43,19,24,29,14,13,8.93694246007996,10.6411777958467,0.298029191332399,29
"1038","MA","Bom Jardim",41822,7607.9,21008,"Pindaré",2,"Nordeste",0,"210200",3,49,22,27,25,24,0,0,0,0,0,49,22,27,25,24,19,8.93694246007996,10.6411777958467,0.378438020992087,31
"1039","MA","Bom Jardim",41822,7607.9,21008,"Pindaré",2,"Nordeste",0,"210200",4,52,24,28,38,14,1,1,0,0,1,53,25,28,38,15,26,8.93694246007996,10.6411777958467,0.391990442543998,30
"1040","MA","Bom Jardim",41822,7607.9,21008,"Pindaré",2,"Nordeste",0,"210200",5,43,25,18,29,14,0,0,0,0,0,43,25,18,29,14,29,8.93694246007996,10.6411777958467,0.436735115782313,31
"1041","MA","Bom Jesus das Selvas",34567,8666.68,21008,"Pindaré",2,"Nordeste",0,"210203",2,35,13,22,22,13,0,0,0,0,0,35,13,22,22,13,14,9.06724106679586,10.4506547487046,0.26995942527354,29
"1042","MA","Bom Jesus das Selvas",34567,8666.68,21008,"Pindaré",2,"Nordeste",0,"210203",3,37,14,23,20,17,2,2,0,2,0,39,16,23,22,17,11,9.06724106679586,10.4506547487046,0.335514060450788,31
"1043","MA","Bom Jesus das Selvas",34567,8666.68,21008,"Pindaré",2,"Nordeste",0,"210203",4,21,9,12,12,9,1,0,1,1,0,22,9,13,13,9,5,9.06724106679586,10.4506547487046,0.351132397530331,30
"1044","MA","Bom Jesus das Selvas",34567,8666.68,21008,"Pindaré",2,"Nordeste",0,"210203",5,21,12,9,14,7,0,0,0,0,0,21,12,9,14,7,13,9.06724106679586,10.4506547487046,0.401480260486283,31
"1045","MA","Brejo",36651,8082.28,21014,"Chapadinha",2,"Nordeste",0,"210210",2,42,12,30,26,16,0,0,0,0,0,42,12,30,26,16,16,8.99742928992818,10.5091959920722,0.307734145878261,29
"1046","MA","Brejo",36651,8082.28,21014,"Chapadinha",2,"Nordeste",0,"210210",3,28,14,14,14,14,0,0,0,0,0,28,14,14,14,14,15,8.99742928992818,10.5091959920722,0.391286370101544,31
"1047","MA","Brejo",36651,8082.28,21014,"Chapadinha",2,"Nordeste",0,"210210",4,22,11,11,13,9,2,2,0,0,2,24,13,11,13,11,14,8.99742928992818,10.5091959920722,0.423237648777927,30
"1048","MA","Brejo",36651,8082.28,21014,"Chapadinha",2,"Nordeste",0,"210210",5,27,14,13,11,16,0,0,0,0,0,27,14,13,11,16,23,8.99742928992818,10.5091959920722,0.450763113631081,31
"1049","MA","Buriti",28798,7090.84,21014,"Chapadinha",2,"Nordeste",0,"210220",2,34,13,21,18,16,1,0,1,0,1,35,13,22,18,17,8,8.86655908923615,10.2680612192682,0.30090657276004,29
"1050","MA","Buriti",28798,7090.84,21014,"Chapadinha",2,"Nordeste",0,"210220",3,29,11,18,19,10,1,1,0,0,1,30,12,18,19,11,20,8.86655908923615,10.2680612192682,0.377648532080731,31
"1051","MA","Buriti",28798,7090.84,21014,"Chapadinha",2,"Nordeste",0,"210220",4,29,16,13,17,12,0,0,0,0,0,29,16,13,17,12,13,8.86655908923615,10.2680612192682,0.376058433452507,30
"1052","MA","Buriti",28798,7090.84,21014,"Chapadinha",2,"Nordeste",0,"210220",5,33,14,19,23,10,0,0,0,0,0,33,14,19,23,10,22,8.86655908923615,10.2680612192682,0.425390404856255,31
"1053","MA","Buriti Bravo",23939,7111.22,21017,"Caxias",2,"Nordeste",1,"210230",2,26,7,19,15,11,1,1,0,0,1,27,8,19,15,12,21,8.86942909738835,10.0832642071451,0.316325031101196,29
"1054","MA","Buriti Bravo",23939,7111.22,21017,"Caxias",2,"Nordeste",1,"210230",3,20,7,13,11,9,1,0,1,0,1,21,7,14,11,10,22,8.86942909738835,10.0832642071451,0.413784329040188,31
"1055","MA","Buriti Bravo",23939,7111.22,21017,"Caxias",2,"Nordeste",1,"210230",4,20,6,14,13,7,0,0,0,0,0,20,6,14,13,7,15,8.86942909738835,10.0832642071451,0.42771611008332,30
"1056","MA","Buriti Bravo",23939,7111.22,21017,"Caxias",2,"Nordeste",1,"210230",5,34,13,21,18,16,0,0,0,0,0,34,13,21,18,16,21,8.86942909738835,10.0832642071451,0.436783803193887,31
"1057","MA","Buriticupu",72983,7822.02,21008,"Pindaré",2,"Nordeste",1,"210232",2,76,34,42,40,36,2,1,1,1,1,78,35,43,41,37,26,8.96469811220301,11.1979818162982,0.317252360275844,29
"1058","MA","Buriticupu",72983,7822.02,21008,"Pindaré",2,"Nordeste",1,"210232",3,74,26,48,45,29,2,1,1,2,0,76,27,49,47,29,26,8.96469811220301,11.1979818162982,0.404404883174148,31
"1059","MA","Buriticupu",72983,7822.02,21008,"Pindaré",2,"Nordeste",1,"210232",4,75,36,39,44,31,1,0,1,0,1,76,36,40,44,32,23,8.96469811220301,11.1979818162982,0.411190679685805,30
"1060","MA","Buriticupu",72983,7822.02,21008,"Pindaré",2,"Nordeste",1,"210232",5,84,34,50,45,39,0,0,0,0,0,84,34,50,45,39,49,8.96469811220301,11.1979818162982,0.469923259109735,31
"1061","MA","Cajari",19451,5351.2,21005,"Baixada Maranhense",2,"Nordeste",0,"210250",2,23,5,18,11,12,0,0,0,0,0,23,5,18,11,12,7,8.5850761138042,9.87565376160669,0.318760440735594,29
"1062","MA","Cajari",19451,5351.2,21005,"Baixada Maranhense",2,"Nordeste",0,"210250",3,16,9,7,10,6,0,0,0,0,0,16,9,7,10,6,3,8.5850761138042,9.87565376160669,0.407710668044526,31
"1063","MA","Cajari",19451,5351.2,21005,"Baixada Maranhense",2,"Nordeste",0,"210250",4,14,4,10,5,9,0,0,0,0,0,14,4,10,5,9,9,8.5850761138042,9.87565376160669,0.401185988457979,30
"1064","MA","Cajari",19451,5351.2,21005,"Baixada Maranhense",2,"Nordeste",0,"210250",5,7,3,4,5,2,0,0,0,0,0,7,3,4,5,2,9,8.5850761138042,9.87565376160669,0.448206549574819,31
"1065","MA","Campestre do Maranhão",14453,11570.45,21019,"Porto Franco",2,"Nordeste",1,"210255",2,9,2,7,7,2,2,1,1,1,1,11,3,8,8,3,6,9.35620971312196,9.57865728444884,0.30552057001734,29
"1066","MA","Campestre do Maranhão",14453,11570.45,21019,"Porto Franco",2,"Nordeste",1,"210255",3,14,4,10,7,7,0,0,0,0,0,14,4,10,7,7,1,9.35620971312196,9.57865728444884,0.365150516732762,31
"1067","MA","Campestre do Maranhão",14453,11570.45,21019,"Porto Franco",2,"Nordeste",1,"210255",4,13,5,8,6,7,1,0,1,1,0,14,5,9,7,7,0,9.35620971312196,9.57865728444884,0.379642343253909,30
"1068","MA","Campestre do Maranhão",14453,11570.45,21019,"Porto Franco",2,"Nordeste",1,"210255",5,10,3,7,4,6,0,0,0,0,0,10,3,7,4,6,12,9.35620971312196,9.57865728444884,0.432223577877362,31
"1069","MA","Cantanhede",22117,5690.35,21006,"Itapecuru Mirim",2,"Nordeste",0,"210270",2,23,11,12,15,8,0,0,0,0,0,23,11,12,15,8,5,8.64652703665218,10.0041018225687,0.305440530537555,29
"1070","MA","Cantanhede",22117,5690.35,21006,"Itapecuru Mirim",2,"Nordeste",0,"210270",3,19,9,10,11,8,0,0,0,0,0,19,9,10,11,8,15,8.64652703665218,10.0041018225687,0.393297863895994,31
"1071","MA","Cantanhede",22117,5690.35,21006,"Itapecuru Mirim",2,"Nordeste",0,"210270",4,24,9,15,11,13,0,0,0,0,0,24,9,15,11,13,8,8.64652703665218,10.0041018225687,0.452199267658767,30
"1072","MA","Cantanhede",22117,5690.35,21006,"Itapecuru Mirim",2,"Nordeste",0,"210270",5,17,6,11,11,6,0,0,0,0,0,17,6,11,11,6,14,8.64652703665218,10.0041018225687,0.41370697685785,31
"1073","MA","Capinzal do Norte",10935,13164.1,21015,"Codó",2,"Nordeste",0,"210275",2,14,3,11,5,9,0,0,0,0,0,14,3,11,5,9,3,9.48524870650961,9.29972393311087,0.257077732556006,29
"1074","MA","Capinzal do Norte",10935,13164.1,21015,"Codó",2,"Nordeste",0,"210275",3,17,9,8,10,7,0,0,0,0,0,17,9,8,10,7,3,9.48524870650961,9.29972393311087,0.358981152911788,31
"1075","MA","Capinzal do Norte",10935,13164.1,21015,"Codó",2,"Nordeste",0,"210275",4,8,2,6,5,3,0,0,0,0,0,8,2,6,5,3,5,9.48524870650961,9.29972393311087,0.402238692136637,30
"1076","MA","Capinzal do Norte",10935,13164.1,21015,"Codó",2,"Nordeste",0,"210275",5,13,1,12,7,6,0,0,0,0,0,13,1,12,7,6,9,9.48524870650961,9.29972393311087,0.434338176454861,31
"1077","MA","Carolina",24165,13268.52,21019,"Porto Franco",2,"Nordeste",0,"210280",2,30,10,20,16,14,1,1,0,0,1,31,11,20,16,15,10,9.49314959133996,10.0926605842792,0.293787288608733,29
"1078","MA","Carolina",24165,13268.52,21019,"Porto Franco",2,"Nordeste",0,"210280",3,24,7,17,15,9,1,0,1,1,0,25,7,18,16,9,17,9.49314959133996,10.0926605842792,0.376640314759367,31
"1079","MA","Carolina",24165,13268.52,21019,"Porto Franco",2,"Nordeste",0,"210280",4,20,4,16,10,10,0,0,0,0,0,20,4,16,10,10,14,9.49314959133996,10.0926605842792,0.374926789899889,30
"1080","MA","Carolina",24165,13268.52,21019,"Porto Franco",2,"Nordeste",0,"210280",5,27,10,17,14,13,1,1,0,1,0,28,11,17,15,13,16,9.49314959133996,10.0926605842792,0.391552433607947,31
"1081","MA","Carutapera",23952,7029.33,21007,"Gurupi",2,"Nordeste",1,"210290",2,41,11,30,28,13,0,0,0,0,0,41,11,30,28,13,4,8.85784667443067,10.0838071066594,0.302765716097428,29
"1082","MA","Carutapera",23952,7029.33,21007,"Gurupi",2,"Nordeste",1,"210290",3,33,14,19,19,14,1,0,1,1,0,34,14,20,20,14,5,8.85784667443067,10.0838071066594,0.35624263333191,31
"1083","MA","Carutapera",23952,7029.33,21007,"Gurupi",2,"Nordeste",1,"210290",4,35,11,24,16,19,0,0,0,0,0,35,11,24,16,19,13,8.85784667443067,10.0838071066594,0.4230330370904,30
"1084","MA","Carutapera",23952,7029.33,21007,"Gurupi",2,"Nordeste",1,"210290",5,20,3,17,11,9,1,0,1,1,0,21,3,18,12,9,16,8.85784667443067,10.0838071066594,0.454950035929297,31
"1085","MA","Caxias",165525,11046.47,21017,"Caxias",2,"Nordeste",1,"210300",2,197,67,130,95,102,0,0,0,0,0,197,67,130,95,102,71,9.30986619889506,12.016877519793,0.288002651892418,29
"1086","MA","Caxias",165525,11046.47,21017,"Caxias",2,"Nordeste",1,"210300",3,195,56,139,102,93,2,2,0,1,1,197,58,139,103,94,97,9.30986619889506,12.016877519793,0.38921626960202,31
"1087","MA","Caxias",165525,11046.47,21017,"Caxias",2,"Nordeste",1,"210300",4,166,65,101,83,83,0,0,0,0,0,166,65,101,83,83,81,9.30986619889506,12.016877519793,0.442547989843463,30
"1088","MA","Caxias",165525,11046.47,21017,"Caxias",2,"Nordeste",1,"210300",5,189,58,131,109,80,3,2,1,0,3,192,60,132,109,83,109,9.30986619889506,12.016877519793,0.445698427920954,31
"1089","MA","Centro do Guilherme",13670,6100.9,21007,"Gurupi",2,"Nordeste",0,"210315",2,5,2,3,4,1,0,0,0,0,0,5,2,3,4,1,3,8.71619158026191,9.522958929718,0.309223600650855,29
"1090","MA","Centro do Guilherme",13670,6100.9,21007,"Gurupi",2,"Nordeste",0,"210315",3,4,2,2,1,3,0,0,0,0,0,4,2,2,1,3,1,8.71619158026191,9.522958929718,0.415722511745105,31
"1091","MA","Centro do Guilherme",13670,6100.9,21007,"Gurupi",2,"Nordeste",0,"210315",4,2,1,1,1,1,0,0,0,0,0,2,1,1,1,1,0,8.71619158026191,9.522958929718,0.400882310565011,30
"1092","MA","Centro do Guilherme",13670,6100.9,21007,"Gurupi",2,"Nordeste",0,"210315",5,2,0,2,0,2,0,0,0,0,0,2,0,2,0,2,10,8.71619158026191,9.522958929718,0.459499576069327,31
"1093","MA","Centro Novo do Maranhão",21840,6852.79,21007,"Gurupi",2,"Nordeste",0,"210317",2,10,2,8,4,6,0,0,0,0,0,10,2,8,4,6,4,8.83241114760251,9.99149842985884,0.287444170510606,29
"1094","MA","Centro Novo do Maranhão",21840,6852.79,21007,"Gurupi",2,"Nordeste",0,"210317",3,4,1,3,3,1,0,0,0,0,0,4,1,3,3,1,4,8.83241114760251,9.99149842985884,0.397776987387986,31
"1095","MA","Centro Novo do Maranhão",21840,6852.79,21007,"Gurupi",2,"Nordeste",0,"210317",4,2,0,2,1,1,0,0,0,0,0,2,0,2,1,1,5,8.83241114760251,9.99149842985884,0.392940168898786,30
"1096","MA","Centro Novo do Maranhão",21840,6852.79,21007,"Gurupi",2,"Nordeste",0,"210317",5,4,2,2,3,1,1,0,1,1,0,5,2,3,4,1,7,8.83241114760251,9.99149842985884,0.453477668782044,31
"1097","MA","Chapadinha",80195,8997.04,21014,"Chapadinha",2,"Nordeste",1,"210320",2,101,40,61,55,46,1,1,0,0,1,102,41,61,55,47,40,9.10465091333366,11.2922164477715,0.263709558589604,29
"1098","MA","Chapadinha",80195,8997.04,21014,"Chapadinha",2,"Nordeste",1,"210320",3,79,35,44,48,31,1,0,1,1,0,80,35,45,49,31,38,9.10465091333366,11.2922164477715,0.364534887448559,31
"1099","MA","Chapadinha",80195,8997.04,21014,"Chapadinha",2,"Nordeste",1,"210320",4,90,39,51,40,50,2,2,0,1,1,92,41,51,41,51,50,9.10465091333366,11.2922164477715,0.397115054217268,30
"1100","MA","Chapadinha",80195,8997.04,21014,"Chapadinha",2,"Nordeste",1,"210320",5,83,28,55,45,38,1,1,0,0,1,84,29,55,45,39,74,9.10465091333366,11.2922164477715,0.42680087509009,31
"1101","MA","Codó",123116,7856.47,21015,"Codó",2,"Nordeste",1,"210330",2,133,57,76,77,56,3,1,2,1,2,136,58,78,78,58,55,8.96909267512866,11.720882279356,0.309794557863788,29
"1102","MA","Codó",123116,7856.47,21015,"Codó",2,"Nordeste",1,"210330",3,130,50,80,62,68,2,1,1,1,1,132,51,81,63,69,80,8.96909267512866,11.720882279356,0.398184927761811,31
"1103","MA","Codó",123116,7856.47,21015,"Codó",2,"Nordeste",1,"210330",4,127,50,77,67,60,1,1,0,0,1,128,51,77,67,61,54,8.96909267512866,11.720882279356,0.417805016394407,30
"1104","MA","Codó",123116,7856.47,21015,"Codó",2,"Nordeste",1,"210330",5,119,52,67,66,53,3,2,1,2,1,122,54,68,68,54,119,8.96909267512866,11.720882279356,0.45026889968443,31
"1105","MA","Coelho Neto",49621,7462.53,21016,"Coelho Neto",2,"Nordeste",1,"210340",2,48,24,24,24,24,1,0,1,1,0,49,24,25,25,24,26,8.91764977779328,10.8121694102068,0.291349568488844,29
"1106","MA","Coelho Neto",49621,7462.53,21016,"Coelho Neto",2,"Nordeste",1,"210340",3,52,26,26,29,23,1,0,1,0,1,53,26,27,29,24,30,8.91764977779328,10.8121694102068,0.385220005561816,31
"1107","MA","Coelho Neto",49621,7462.53,21016,"Coelho Neto",2,"Nordeste",1,"210340",4,50,22,28,30,20,0,0,0,0,0,50,22,28,30,20,22,8.91764977779328,10.8121694102068,0.413596636535086,30
"1108","MA","Coelho Neto",49621,7462.53,21016,"Coelho Neto",2,"Nordeste",1,"210340",5,59,29,30,24,35,1,0,1,1,0,60,29,31,25,35,33,8.91764977779328,10.8121694102068,0.454290619423108,31
"1109","MA","Colinas",41312,9345.17,21018,"Chapadas do Alto Itapecuru",2,"Nordeste",0,"210350",2,49,11,38,29,20,0,0,0,0,0,49,11,38,29,20,15,9.14261491127048,10.6289082936464,0.270985719145337,29
"1110","MA","Colinas",41312,9345.17,21018,"Chapadas do Alto Itapecuru",2,"Nordeste",0,"210350",3,52,18,34,27,25,1,0,1,0,1,53,18,35,27,26,28,9.14261491127048,10.6289082936464,0.343760060187738,31
"1111","MA","Colinas",41312,9345.17,21018,"Chapadas do Alto Itapecuru",2,"Nordeste",0,"210350",4,46,15,31,30,16,2,0,2,1,1,48,15,33,31,17,15,9.14261491127048,10.6289082936464,0.380894156101398,30
"1112","MA","Colinas",41312,9345.17,21018,"Chapadas do Alto Itapecuru",2,"Nordeste",0,"210350",5,56,32,24,31,25,3,0,3,0,3,59,32,27,31,28,21,9.14261491127048,10.6289082936464,0.388645427180888,31
"1113","MA","Coroatá",65544,7031.3,21015,"Codó",2,"Nordeste",1,"210360",2,90,37,53,37,53,0,0,0,0,0,90,37,53,37,53,28,8.85812688947266,11.0904769518217,0.291441774237163,29
"1114","MA","Coroatá",65544,7031.3,21015,"Codó",2,"Nordeste",1,"210360",3,55,16,39,35,20,1,1,0,1,0,56,17,39,36,20,33,8.85812688947266,11.0904769518217,0.394727556415072,31
"1115","MA","Coroatá",65544,7031.3,21015,"Codó",2,"Nordeste",1,"210360",4,85,30,55,50,35,0,0,0,0,0,85,30,55,50,35,33,8.85812688947266,11.0904769518217,0.406428448690637,30
"1116","MA","Coroatá",65544,7031.3,21015,"Codó",2,"Nordeste",1,"210360",5,78,35,43,48,30,0,0,0,0,0,78,35,43,48,30,62,8.85812688947266,11.0904769518217,0.463233678155197,31
"1117","MA","Cururupu",32626,7150.07,21001,"Litoral Ocidental Maranhense",2,"Nordeste",0,"210370",2,49,14,35,25,24,1,1,0,0,1,50,15,35,25,25,17,8.87487742584992,10.3928647954962,0.27841229716999,29
"1118","MA","Cururupu",32626,7150.07,21001,"Litoral Ocidental Maranhense",2,"Nordeste",0,"210370",3,36,15,21,22,14,1,0,1,1,0,37,15,22,23,14,10,8.87487742584992,10.3928647954962,0.363191016691422,31
"1119","MA","Cururupu",32626,7150.07,21001,"Litoral Ocidental Maranhense",2,"Nordeste",0,"210370",4,34,10,24,18,16,1,0,1,1,0,35,10,25,19,16,15,8.87487742584992,10.3928647954962,0.419166556054036,30
"1120","MA","Cururupu",32626,7150.07,21001,"Litoral Ocidental Maranhense",2,"Nordeste",0,"210370",5,34,13,21,21,13,0,0,0,0,0,34,13,21,21,13,30,8.87487742584992,10.3928647954962,0.44702605927474,31
"1121","MA","Davinópolis",12916,37649.26,21009,"Imperatriz",2,"Nordeste",1,"210375",2,1,0,1,0,1,0,0,0,0,0,1,0,1,0,1,7,10.5360685783204,9.46622213187817,0.333825779804126,29
"1122","MA","Davinópolis",12916,37649.26,21009,"Imperatriz",2,"Nordeste",1,"210375",3,1,1,0,0,1,0,0,0,0,0,1,1,0,0,1,8,10.5360685783204,9.46622213187817,0.376355244958045,31
"1123","MA","Davinópolis",12916,37649.26,21009,"Imperatriz",2,"Nordeste",1,"210375",4,3,0,3,1,2,0,0,0,0,0,3,0,3,1,2,17,10.5360685783204,9.46622213187817,0.394190322540666,30
"1124","MA","Davinópolis",12916,37649.26,21009,"Imperatriz",2,"Nordeste",1,"210375",5,0,0,0,0,0,0,0,0,0,0,0,0,0,0,0,15,10.5360685783204,9.46622213187817,0.412865269281906,31
"1125","MA","Dom Pedro",23372,9852.49,21012,"Presidente Dutra",2,"Nordeste",0,"210380",2,27,9,18,14,13,0,0,0,0,0,27,9,18,14,13,9,9.19547949409782,10.0592940036743,0.262305095245698,29
"1126","MA","Dom Pedro",23372,9852.49,21012,"Presidente Dutra",2,"Nordeste",0,"210380",3,20,4,16,11,9,0,0,0,0,0,20,4,16,11,9,17,9.19547949409782,10.0592940036743,0.373606463380561,31
"1127","MA","Dom Pedro",23372,9852.49,21012,"Presidente Dutra",2,"Nordeste",0,"210380",4,17,6,11,8,9,0,0,0,0,0,17,6,11,8,9,10,9.19547949409782,10.0592940036743,0.394383010649968,30
"1128","MA","Dom Pedro",23372,9852.49,21012,"Presidente Dutra",2,"Nordeste",0,"210380",5,15,4,11,7,8,0,0,0,0,0,15,4,11,7,8,16,9.19547949409782,10.0592940036743,0.429088873007075,31
"1129","MA","Duque Bacelar",11401,6820.37,21016,"Coelho Neto",2,"Nordeste",0,"210390",2,7,5,2,6,1,1,0,1,1,0,8,5,3,7,1,4,8.82766900156532,9.34145634983372,0.270189898097519,29
"1130","MA","Duque Bacelar",11401,6820.37,21016,"Coelho Neto",2,"Nordeste",0,"210390",3,13,5,8,11,2,0,0,0,0,0,13,5,8,11,2,6,8.82766900156532,9.34145634983372,0.372506222597177,31
"1131","MA","Duque Bacelar",11401,6820.37,21016,"Coelho Neto",2,"Nordeste",0,"210390",4,11,5,6,6,5,0,0,0,0,0,11,5,6,6,5,4,8.82766900156532,9.34145634983372,0.357334711512867,30
"1132","MA","Duque Bacelar",11401,6820.37,21016,"Coelho Neto",2,"Nordeste",0,"210390",5,9,3,6,7,2,0,0,0,0,0,9,3,6,7,2,4,8.82766900156532,9.34145634983372,0.415541831212974,31
"1133","MA","Esperantinópolis",17104,8084.84,21010,"Médio Mearim",2,"Nordeste",0,"210400",2,20,8,12,11,9,0,0,0,0,0,20,8,12,11,9,3,8.99774598208131,9.74706763326483,0.280924797260726,29
"1134","MA","Esperantinópolis",17104,8084.84,21010,"Médio Mearim",2,"Nordeste",0,"210400",3,16,5,11,3,13,0,0,0,0,0,16,5,11,3,13,8,8.99774598208131,9.74706763326483,0.385940203364721,31
"1135","MA","Esperantinópolis",17104,8084.84,21010,"Médio Mearim",2,"Nordeste",0,"210400",4,16,6,10,6,10,0,0,0,0,0,16,6,10,6,10,9,8.99774598208131,9.74706763326483,0.400545051834162,30
"1136","MA","Esperantinópolis",17104,8084.84,21010,"Médio Mearim",2,"Nordeste",0,"210400",5,19,6,13,8,11,0,0,0,0,0,19,6,13,8,11,19,8.99774598208131,9.74706763326483,0.480305546715068,31
"1137","MA","Estreito",42527,23771.43,21019,"Porto Franco",2,"Nordeste",1,"210405",2,35,11,24,22,13,0,0,0,0,0,35,11,24,22,13,13,10.0762397184101,10.6578944473163,0.295853803977032,29
"1138","MA","Estreito",42527,23771.43,21019,"Porto Franco",2,"Nordeste",1,"210405",3,34,10,24,13,21,1,0,1,0,1,35,10,25,13,22,21,10.0762397184101,10.6578944473163,0.361517294230125,31
"1139","MA","Estreito",42527,23771.43,21019,"Porto Franco",2,"Nordeste",1,"210405",4,23,6,17,12,11,0,0,0,0,0,23,6,17,12,11,21,10.0762397184101,10.6578944473163,0.382470143927246,30
"1140","MA","Estreito",42527,23771.43,21019,"Porto Franco",2,"Nordeste",1,"210405",5,24,7,17,11,13,0,0,0,0,0,24,7,17,11,13,27,10.0762397184101,10.6578944473163,0.424514848950005,31
"1141","MA","Formosa da Serra Negra",19258,7403.28,21011,"Alto Mearim e Grajaú",2,"Nordeste",0,"210409",2,10,4,6,5,5,0,0,0,0,0,10,4,6,5,5,4,8.90967842423223,9.86568183780023,0.275017298389632,29
"1142","MA","Formosa da Serra Negra",19258,7403.28,21011,"Alto Mearim e Grajaú",2,"Nordeste",0,"210409",3,13,6,7,6,7,0,0,0,0,0,13,6,7,6,7,5,8.90967842423223,9.86568183780023,0.319769950390981,31
"1143","MA","Formosa da Serra Negra",19258,7403.28,21011,"Alto Mearim e Grajaú",2,"Nordeste",0,"210409",4,7,0,7,5,2,0,0,0,0,0,7,0,7,5,2,2,8.90967842423223,9.86568183780023,0.365620822054872,30
"1144","MA","Formosa da Serra Negra",19258,7403.28,21011,"Alto Mearim e Grajaú",2,"Nordeste",0,"210409",5,17,4,13,9,8,0,0,0,0,0,17,4,13,9,8,5,8.90967842423223,9.86568183780023,0.376595664091409,31
"1145","MA","Fortaleza dos Nogueiras",12647,12571.1,21021,"Chapadas das Mangabeiras",2,"Nordeste",0,"210410",2,13,5,8,6,7,0,0,0,0,0,13,5,8,6,7,8,9.43915580769983,9.44517531187998,0.297407856175457,29
"1146","MA","Fortaleza dos Nogueiras",12647,12571.1,21021,"Chapadas das Mangabeiras",2,"Nordeste",0,"210410",3,22,7,15,15,7,1,0,1,0,1,23,7,16,15,8,7,9.43915580769983,9.44517531187998,0.369554508976467,31
"1147","MA","Fortaleza dos Nogueiras",12647,12571.1,21021,"Chapadas das Mangabeiras",2,"Nordeste",0,"210410",4,18,10,8,10,8,0,0,0,0,0,18,10,8,10,8,2,9.43915580769983,9.44517531187998,0.377038205030458,30
"1148","MA","Fortaleza dos Nogueiras",12647,12571.1,21021,"Chapadas das Mangabeiras",2,"Nordeste",0,"210410",5,19,5,14,8,11,0,0,0,0,0,19,5,14,8,11,3,9.43915580769983,9.44517531187998,0.41599106002487,31
"1149","MA","Fortuna",15567,6963.71,21012,"Presidente Dutra",2,"Nordeste",0,"210420",2,10,4,6,6,4,0,0,0,0,0,10,4,6,6,4,5,8.84846765728694,9.65290856803585,0.294666506351624,29
"1150","MA","Fortuna",15567,6963.71,21012,"Presidente Dutra",2,"Nordeste",0,"210420",3,13,6,7,5,8,0,0,0,0,0,13,6,7,5,8,6,8.84846765728694,9.65290856803585,0.394167503711801,31
"1151","MA","Fortuna",15567,6963.71,21012,"Presidente Dutra",2,"Nordeste",0,"210420",4,13,6,7,12,1,0,0,0,0,0,13,6,7,12,1,11,8.84846765728694,9.65290856803585,0.395904815573391,30
"1152","MA","Fortuna",15567,6963.71,21012,"Presidente Dutra",2,"Nordeste",0,"210420",5,19,10,9,10,9,0,0,0,0,0,19,10,9,10,9,14,8.84846765728694,9.65290856803585,0.426161700188054,31
"1153","MA","Godofredo Viana",11963,9853.67,21007,"Gurupi",2,"Nordeste",0,"210430",2,11,1,10,7,4,0,0,0,0,0,11,1,10,7,4,2,9.19559925360464,9.38957383217091,0.312454966660155,29
"1154","MA","Godofredo Viana",11963,9853.67,21007,"Gurupi",2,"Nordeste",0,"210430",3,8,3,5,4,4,0,0,0,0,0,8,3,5,4,4,1,9.19559925360464,9.38957383217091,0.378989814515991,31
"1155","MA","Godofredo Viana",11963,9853.67,21007,"Gurupi",2,"Nordeste",0,"210430",4,9,3,6,5,4,1,0,1,1,0,10,3,7,6,4,3,9.19559925360464,9.38957383217091,0.404689970955859,30
"1156","MA","Godofredo Viana",11963,9853.67,21007,"Gurupi",2,"Nordeste",0,"210430",5,9,4,5,4,5,0,0,0,0,0,9,4,5,4,5,9,9.19559925360464,9.38957383217091,0.449435520817868,31
"1157","MA","Gonçalves Dias",17944,6743.87,21012,"Presidente Dutra",2,"Nordeste",0,"210440",2,16,7,9,6,10,0,0,0,0,0,16,7,9,6,10,8,8.81638922310207,9.79501107620004,0.316544928305882,29
"1158","MA","Gonçalves Dias",17944,6743.87,21012,"Presidente Dutra",2,"Nordeste",0,"210440",3,16,7,9,8,8,0,0,0,0,0,16,7,9,8,8,7,8.81638922310207,9.79501107620004,0.41664131842802,31
"1159","MA","Gonçalves Dias",17944,6743.87,21012,"Presidente Dutra",2,"Nordeste",0,"210440",4,25,9,16,13,12,0,0,0,0,0,25,9,16,13,12,11,8.81638922310207,9.79501107620004,0.435713400713648,30
"1160","MA","Gonçalves Dias",17944,6743.87,21012,"Presidente Dutra",2,"Nordeste",0,"210440",5,13,4,9,7,6,0,0,0,0,0,13,4,9,7,6,12,8.81638922310207,9.79501107620004,0.474442925232051,31
"1161","MA","Governador Edison Lobão",18520,14228.27,21009,"Imperatriz",2,"Nordeste",0,"210455",2,3,1,2,1,2,0,0,0,0,0,3,1,2,1,2,8,9.56298610955402,9.82660650820017,0.312248933652298,29
"1162","MA","Governador Edison Lobão",18520,14228.27,21009,"Imperatriz",2,"Nordeste",0,"210455",3,1,0,1,1,0,0,0,0,0,0,1,0,1,1,0,8,9.56298610955402,9.82660650820017,0.381965329689795,31
"1163","MA","Governador Edison Lobão",18520,14228.27,21009,"Imperatriz",2,"Nordeste",0,"210455",4,1,0,1,0,1,0,0,0,0,0,1,0,1,0,1,9,9.56298610955402,9.82660650820017,0.401466830535491,30
"1164","MA","Governador Edison Lobão",18520,14228.27,21009,"Imperatriz",2,"Nordeste",0,"210455",5,0,0,0,0,0,1,0,1,1,0,1,0,1,1,0,22,9.56298610955402,9.82660650820017,0.449857820226594,31
"1165","MA","Governador Eugênio Barros",16882,5829.88,21012,"Presidente Dutra",2,"Nordeste",0,"210460",2,22,10,12,12,10,1,0,1,0,1,23,10,13,12,11,9,8.67075169594231,9.73400324454366,0.372943875602201,29
"1166","MA","Governador Eugênio Barros",16882,5829.88,21012,"Presidente Dutra",2,"Nordeste",0,"210460",3,15,5,10,10,5,0,0,0,0,0,15,5,10,10,5,9,8.67075169594231,9.73400324454366,0.466841679748356,31
"1167","MA","Governador Eugênio Barros",16882,5829.88,21012,"Presidente Dutra",2,"Nordeste",0,"210460",4,12,6,6,8,4,0,0,0,0,0,12,6,6,8,4,9,8.67075169594231,9.73400324454366,0.470182268722191,30
"1168","MA","Governador Eugênio Barros",16882,5829.88,21012,"Presidente Dutra",2,"Nordeste",0,"210460",5,21,13,8,10,11,0,0,0,0,0,21,13,8,10,11,10,8.67075169594231,9.73400324454366,0.510857434199452,31
"1169","MA","Governador Newton Bello",10151,6599.87,21008,"Pindaré",2,"Nordeste",0,"210465",2,10,7,3,7,3,0,0,0,0,0,10,7,3,7,3,4,8.79480523085083,9.22532750178443,0.347385295395451,29
"1170","MA","Governador Newton Bello",10151,6599.87,21008,"Pindaré",2,"Nordeste",0,"210465",3,9,3,6,6,3,1,1,0,1,0,10,4,6,7,3,2,8.79480523085083,9.22532750178443,0.439373211132303,31
"1171","MA","Governador Newton Bello",10151,6599.87,21008,"Pindaré",2,"Nordeste",0,"210465",4,8,6,2,3,5,1,1,0,0,1,9,7,2,3,6,5,8.79480523085083,9.22532750178443,0.470758311599249,30
"1172","MA","Governador Newton Bello",10151,6599.87,21008,"Pindaré",2,"Nordeste",0,"210465",5,5,3,2,2,3,0,0,0,0,0,5,3,2,2,3,9,8.79480523085083,9.22532750178443,0.538512211152194,31
"1173","MA","Governador Nunes Freire",25539,8397.79,21007,"Gurupi",2,"Nordeste",0,"210467",2,11,3,8,7,4,1,0,1,1,0,12,3,9,8,4,10,9.03572385497769,10.1479619745522,0.277023947941877,29
"1174","MA","Governador Nunes Freire",25539,8397.79,21007,"Gurupi",2,"Nordeste",0,"210467",3,5,1,4,4,1,0,0,0,0,0,5,1,4,4,1,11,9.03572385497769,10.1479619745522,0.399361684434169,31
"1175","MA","Governador Nunes Freire",25539,8397.79,21007,"Gurupi",2,"Nordeste",0,"210467",4,2,1,1,2,0,0,0,0,0,0,2,1,1,2,0,9,9.03572385497769,10.1479619745522,0.405209769557673,30
"1176","MA","Governador Nunes Freire",25539,8397.79,21007,"Gurupi",2,"Nordeste",0,"210467",5,1,1,0,0,1,0,0,0,0,0,1,1,0,0,1,19,9.03572385497769,10.1479619745522,0.453694849045468,31
"1177","MA","Grajaú",70065,10913.15,21011,"Alto Mearim e Grajaú",2,"Nordeste",1,"210480",2,84,52,32,52,32,0,0,0,0,0,84,52,32,52,32,39,9.29772376309331,11.1571786616043,0.278424648074126,29
"1178","MA","Grajaú",70065,10913.15,21011,"Alto Mearim e Grajaú",2,"Nordeste",1,"210480",3,92,45,47,50,42,0,0,0,0,0,92,45,47,50,42,53,9.29772376309331,11.1571786616043,0.355143569236912,31
"1179","MA","Grajaú",70065,10913.15,21011,"Alto Mearim e Grajaú",2,"Nordeste",1,"210480",4,81,32,49,40,41,4,4,0,4,0,85,36,49,44,41,33,9.29772376309331,11.1571786616043,0.371716560878935,30
"1180","MA","Grajaú",70065,10913.15,21011,"Alto Mearim e Grajaú",2,"Nordeste",1,"210480",5,85,40,45,41,44,2,2,0,1,1,87,42,45,42,45,35,9.29772376309331,11.1571786616043,0.407446984167515,31
"1181","MA","Igarapé do Meio",14324,13283.34,21005,"Baixada Maranhense",2,"Nordeste",0,"210515",2,25,5,20,14,11,0,0,0,0,0,25,5,20,14,11,10,9.49426589743218,9.56969173111832,0.313171025122405,29
"1182","MA","Igarapé do Meio",14324,13283.34,21005,"Baixada Maranhense",2,"Nordeste",0,"210515",3,20,9,11,14,6,0,0,0,0,0,20,9,11,14,6,8,9.49426589743218,9.56969173111832,0.368815295279331,31
"1183","MA","Igarapé do Meio",14324,13283.34,21005,"Baixada Maranhense",2,"Nordeste",0,"210515",4,13,2,11,10,3,0,0,0,0,0,13,2,11,10,3,6,9.49426589743218,9.56969173111832,0.420911646435545,30
"1184","MA","Igarapé do Meio",14324,13283.34,21005,"Baixada Maranhense",2,"Nordeste",0,"210515",5,17,9,8,12,5,0,0,0,0,0,17,9,8,12,5,11,9.49426589743218,9.56969173111832,0.469888547939535,31
"1185","MA","Igarapé Grande",11387,7911.24,21010,"Médio Mearim",2,"Nordeste",0,"210520",2,19,9,10,8,11,0,0,0,0,0,19,9,10,8,11,5,8.97603981206596,9.3402276328106,0.291452611897223,29
"1186","MA","Igarapé Grande",11387,7911.24,21010,"Médio Mearim",2,"Nordeste",0,"210520",3,12,7,5,7,5,0,0,0,0,0,12,7,5,7,5,6,8.97603981206596,9.3402276328106,0.394597725896261,31
"1187","MA","Igarapé Grande",11387,7911.24,21010,"Médio Mearim",2,"Nordeste",0,"210520",4,13,7,6,6,7,0,0,0,0,0,13,7,6,6,7,7,8.97603981206596,9.3402276328106,0.395434962755603,30
"1188","MA","Igarapé Grande",11387,7911.24,21010,"Médio Mearim",2,"Nordeste",0,"210520",5,15,3,12,6,9,0,0,0,0,0,15,3,12,6,9,8,8.97603981206596,9.3402276328106,0.485992367102532,31
"1189","MA","Imperatriz",259337,27621.33,21009,"Imperatriz",2,"Nordeste",1,"210530",2,76,4,72,16,60,4,3,1,2,2,80,7,73,18,62,165,10.2263435793159,12.4658836532099,0.301343885177672,29
"1190","MA","Imperatriz",259337,27621.33,21009,"Imperatriz",2,"Nordeste",1,"210530",3,87,3,84,11,76,3,3,0,3,0,90,6,84,14,76,143,10.2263435793159,12.4658836532099,0.395985322974029,31
"1191","MA","Imperatriz",259337,27621.33,21009,"Imperatriz",2,"Nordeste",1,"210530",4,77,5,72,15,62,1,1,0,0,1,78,6,72,15,63,161,10.2263435793159,12.4658836532099,0.45356014348045,30
"1192","MA","Imperatriz",259337,27621.33,21009,"Imperatriz",2,"Nordeste",1,"210530",5,90,6,84,16,74,3,3,0,1,2,93,9,84,17,76,353,10.2263435793159,12.4658836532099,0.454798693459655,31
"1193","MA","Itapecuru Mirim",68723,8342.28,21006,"Itapecuru Mirim",2,"Nordeste",1,"210540",2,101,28,73,51,50,1,0,1,0,1,102,28,74,51,51,30,9.0290918392859,11.1378392111185,0.264123885321152,29
"1194","MA","Itapecuru Mirim",68723,8342.28,21006,"Itapecuru Mirim",2,"Nordeste",1,"210540",3,77,20,57,45,32,1,1,0,0,1,78,21,57,45,33,27,9.0290918392859,11.1378392111185,0.332871237057293,31
"1195","MA","Itapecuru Mirim",68723,8342.28,21006,"Itapecuru Mirim",2,"Nordeste",1,"210540",4,75,30,45,39,36,1,0,1,1,0,76,30,46,40,36,19,9.0290918392859,11.1378392111185,0.367464614981822,30
"1196","MA","Itapecuru Mirim",68723,8342.28,21006,"Itapecuru Mirim",2,"Nordeste",1,"210540",5,85,29,56,46,39,1,1,0,0,1,86,30,56,46,40,45,9.0290918392859,11.1378392111185,0.39203122969325,31
"1197","MA","Itinga do Maranhão",26068,12384.98,21009,"Imperatriz",2,"Nordeste",0,"210542",2,11,4,7,5,6,0,0,0,0,0,11,4,7,5,6,17,9.42423972706547,10.1684637874523,0.316853752118707,29
"1198","MA","Itinga do Maranhão",26068,12384.98,21009,"Imperatriz",2,"Nordeste",0,"210542",3,20,9,11,12,8,2,1,1,0,2,22,10,12,12,10,11,9.42423972706547,10.1684637874523,0.395505562575972,31
"1199","MA","Itinga do Maranhão",26068,12384.98,21009,"Imperatriz",2,"Nordeste",0,"210542",4,19,9,10,7,12,0,0,0,0,0,19,9,10,7,12,9,9.42423972706547,10.1684637874523,0.426243566785969,30
"1200","MA","Itinga do Maranhão",26068,12384.98,21009,"Imperatriz",2,"Nordeste",0,"210542",5,21,12,9,11,10,1,1,0,1,0,22,13,9,12,10,35,9.42423972706547,10.1684637874523,0.462481030625308,31
"1201","MA","João Lisboa",23740,9150.22,21009,"Imperatriz",2,"Nordeste",0,"210550",2,6,2,4,3,3,0,0,0,0,0,6,2,4,3,3,5,9.12153320169637,10.0749166681637,0.297017747294895,29
"1202","MA","João Lisboa",23740,9150.22,21009,"Imperatriz",2,"Nordeste",0,"210550",3,6,0,6,1,5,0,0,0,0,0,6,0,6,1,5,15,9.12153320169637,10.0749166681637,0.412946918975742,31
"1203","MA","João Lisboa",23740,9150.22,21009,"Imperatriz",2,"Nordeste",0,"210550",4,4,0,4,1,3,0,0,0,0,0,4,0,4,1,3,15,9.12153320169637,10.0749166681637,0.439747623581863,30
"1204","MA","João Lisboa",23740,9150.22,21009,"Imperatriz",2,"Nordeste",0,"210550",5,5,0,5,1,4,0,0,0,0,0,5,0,5,1,4,24,9.12153320169637,10.0749166681637,0.454798926691957,31
"1205","MA","Joselândia",16198,6227.24,21011,"Alto Mearim e Grajaú",2,"Nordeste",0,"210560",2,16,2,14,9,7,0,0,0,0,0,16,2,14,9,7,5,8.73668849596368,9.69264305680893,0.292741763573768,29
"1206","MA","Joselândia",16198,6227.24,21011,"Alto Mearim e Grajaú",2,"Nordeste",0,"210560",3,17,8,9,9,8,0,0,0,0,0,17,8,9,9,8,8,8.73668849596368,9.69264305680893,0.356864190975676,31
"1207","MA","Joselândia",16198,6227.24,21011,"Alto Mearim e Grajaú",2,"Nordeste",0,"210560",4,16,7,9,8,8,0,0,0,0,0,16,7,9,8,8,3,8.73668849596368,9.69264305680893,0.351651029733207,30
"1208","MA","Joselândia",16198,6227.24,21011,"Alto Mearim e Grajaú",2,"Nordeste",0,"210560",5,12,7,5,5,7,0,0,0,0,0,12,7,5,5,7,16,8.73668849596368,9.69264305680893,0.400600974854589,31
"1209","MA","Lago da Pedra",50616,7931.64,21008,"Pindaré",2,"Nordeste",1,"210570",2,65,34,31,34,31,0,0,0,0,0,65,34,31,34,31,22,8.9786151028306,10.8320230108267,0.280665012162631,29
"1210","MA","Lago da Pedra",50616,7931.64,21008,"Pindaré",2,"Nordeste",1,"210570",3,55,20,35,32,23,2,1,1,2,0,57,21,36,34,23,18,8.9786151028306,10.8320230108267,0.363441714957364,31
"1211","MA","Lago da Pedra",50616,7931.64,21008,"Pindaré",2,"Nordeste",1,"210570",4,54,21,33,32,22,0,0,0,0,0,54,21,33,32,22,20,8.9786151028306,10.8320230108267,0.375049230045581,30
"1212","MA","Lago da Pedra",50616,7931.64,21008,"Pindaré",2,"Nordeste",1,"210570",5,49,21,28,24,25,0,0,0,0,0,49,21,28,24,25,50,8.9786151028306,10.8320230108267,0.420579691486837,31
"1213","MA","Lima Campos",11918,14459.73,21010,"Médio Mearim",2,"Nordeste",0,"210600",2,7,2,5,2,5,0,0,0,0,0,7,2,5,2,5,2,9.57912282333926,9.38580514130692,0.264892067624444,29
"1214","MA","Lima Campos",11918,14459.73,21010,"Médio Mearim",2,"Nordeste",0,"210600",3,21,9,12,9,12,0,0,0,0,0,21,9,12,9,12,8,9.57912282333926,9.38580514130692,0.363240467317453,31
"1215","MA","Lima Campos",11918,14459.73,21010,"Médio Mearim",2,"Nordeste",0,"210600",4,14,7,7,6,8,0,0,0,0,0,14,7,7,6,8,6,9.57912282333926,9.38580514130692,0.377204038559748,30
"1216","MA","Lima Campos",11918,14459.73,21010,"Médio Mearim",2,"Nordeste",0,"210600",5,10,5,5,9,1,1,0,1,1,0,11,5,6,10,1,26,9.57912282333926,9.38580514130692,0.495948785863894,31
"1217","MA","Loreto",12214,18298.49,21021,"Chapadas das Mangabeiras",2,"Nordeste",0,"210610",2,8,1,7,4,4,1,1,0,1,0,9,2,7,5,4,6,9.81457382176387,9.41033811378308,0.289102338713175,29
"1218","MA","Loreto",12214,18298.49,21021,"Chapadas das Mangabeiras",2,"Nordeste",0,"210610",3,12,5,7,6,6,0,0,0,0,0,12,5,7,6,6,4,9.81457382176387,9.41033811378308,0.397397311352022,31
"1219","MA","Loreto",12214,18298.49,21021,"Chapadas das Mangabeiras",2,"Nordeste",0,"210610",4,8,1,7,7,1,0,0,0,0,0,8,1,7,7,1,4,9.81457382176387,9.41033811378308,0.409142906347413,30
"1220","MA","Loreto",12214,18298.49,21021,"Chapadas das Mangabeiras",2,"Nordeste",0,"210610",5,16,2,14,6,10,0,0,0,0,0,16,2,14,6,10,5,9.81457382176387,9.41033811378308,0.397239195656806,31
"1221","MA","Magalhães de Almeida",20029,6274.84,21013,"Baixo Parnaíba Maranhense",2,"Nordeste",0,"210630",2,13,6,7,5,8,0,0,0,0,0,13,6,7,5,8,9,8.74430326566694,9.90493650230123,0.285176801876217,29
"1222","MA","Magalhães de Almeida",20029,6274.84,21013,"Baixo Parnaíba Maranhense",2,"Nordeste",0,"210630",3,12,6,6,7,5,0,0,0,0,0,12,6,6,7,5,4,8.74430326566694,9.90493650230123,0.363039766003115,31
"1223","MA","Magalhães de Almeida",20029,6274.84,21013,"Baixo Parnaíba Maranhense",2,"Nordeste",0,"210630",4,10,4,6,7,3,1,0,1,0,1,11,4,7,7,4,9,8.74430326566694,9.90493650230123,0.396583602610328,30
"1224","MA","Magalhães de Almeida",20029,6274.84,21013,"Baixo Parnaíba Maranhense",2,"Nordeste",0,"210630",5,10,2,8,4,6,0,0,0,0,0,10,2,8,4,6,3,8.74430326566694,9.90493650230123,0.456176983122069,31
"1225","MA","Maracaçumé",21586,8432,21007,"Gurupi",2,"Nordeste",1,"210632",2,2,2,0,1,1,0,0,0,0,0,2,2,0,1,1,11,9.03978927078114,9.97980023538529,0.279050749597386,29
"1226","MA","Maracaçumé",21586,8432,21007,"Gurupi",2,"Nordeste",1,"210632",3,3,1,2,1,2,0,0,0,0,0,3,1,2,1,2,6,9.03978927078114,9.97980023538529,0.347260247908111,31
"1227","MA","Maracaçumé",21586,8432,21007,"Gurupi",2,"Nordeste",1,"210632",4,4,1,3,2,2,0,0,0,0,0,4,1,3,2,2,7,9.03978927078114,9.97980023538529,0.374046995406856,30
"1228","MA","Maracaçumé",21586,8432,21007,"Gurupi",2,"Nordeste",1,"210632",5,4,1,3,1,3,0,0,0,0,0,4,1,3,1,3,8,9.03978927078114,9.97980023538529,0.414248665551643,31
"1229","MA","Mata Roma",16977,8804.63,21014,"Chapadinha",2,"Nordeste",0,"210640",2,13,3,10,9,4,0,0,0,0,0,13,3,10,9,4,7,9.08303299846873,9.73961476581063,0.307064551290083,29
"1230","MA","Mata Roma",16977,8804.63,21014,"Chapadinha",2,"Nordeste",0,"210640",3,10,7,3,6,4,0,0,0,0,0,10,7,3,6,4,3,9.08303299846873,9.73961476581063,0.411070175789428,31
"1231","MA","Mata Roma",16977,8804.63,21014,"Chapadinha",2,"Nordeste",0,"210640",4,26,10,16,15,11,0,0,0,0,0,26,10,16,15,11,6,9.08303299846873,9.73961476581063,0.418641395400504,30
"1232","MA","Mata Roma",16977,8804.63,21014,"Chapadinha",2,"Nordeste",0,"210640",5,30,12,18,17,13,0,0,0,0,0,30,12,18,17,13,10,9.08303299846873,9.73961476581063,0.447095751405028,31
"1233","MA","Matinha",23482,6951.88,21005,"Baixada Maranhense",2,"Nordeste",0,"210650",2,20,10,10,10,10,0,0,0,0,0,20,10,10,10,10,7,8.84676740557646,10.0639894491902,0.303330484752564,29
"1234","MA","Matinha",23482,6951.88,21005,"Baixada Maranhense",2,"Nordeste",0,"210650",3,18,6,12,8,10,1,1,0,0,1,19,7,12,8,11,10,8.84676740557646,10.0639894491902,0.363061339402505,31
"1235","MA","Matinha",23482,6951.88,21005,"Baixada Maranhense",2,"Nordeste",0,"210650",4,21,8,13,8,13,0,0,0,0,0,21,8,13,8,13,13,8.84676740557646,10.0639894491902,0.431119888595606,30
"1236","MA","Matinha",23482,6951.88,21005,"Baixada Maranhense",2,"Nordeste",0,"210650",5,29,9,20,15,14,0,0,0,0,0,29,9,20,15,14,17,8.84676740557646,10.0639894491902,0.464005185077901,31
"1237","MA","Matões",33943,5499.84,21017,"Caxias",2,"Nordeste",0,"210660",2,39,23,16,17,22,1,0,1,0,1,40,23,17,17,23,10,8.61247427988832,10.4324379261607,0.264111794311571,29
"1238","MA","Matões",33943,5499.84,21017,"Caxias",2,"Nordeste",0,"210660",3,30,17,13,20,10,0,0,0,0,0,30,17,13,20,10,14,8.61247427988832,10.4324379261607,0.367911506943755,31
"1239","MA","Matões",33943,5499.84,21017,"Caxias",2,"Nordeste",0,"210660",4,37,21,16,18,19,0,0,0,0,0,37,21,16,18,19,9,8.61247427988832,10.4324379261607,0.397171781045291,30
"1240","MA","Matões",33943,5499.84,21017,"Caxias",2,"Nordeste",0,"210660",5,33,18,15,20,13,1,1,0,1,0,34,19,15,21,13,18,8.61247427988832,10.4324379261607,0.412754131472711,31
"1241","MA","Mirador",21031,9806.13,21018,"Chapadas do Alto Itapecuru",2,"Nordeste",0,"210670",2,20,10,10,16,4,0,0,0,0,0,20,10,10,16,4,9,9.19076297931278,9.95375281868368,0.269510482048093,29
"1242","MA","Mirador",21031,9806.13,21018,"Chapadas do Alto Itapecuru",2,"Nordeste",0,"210670",3,22,7,15,11,11,0,0,0,0,0,22,7,15,11,11,7,9.19076297931278,9.95375281868368,0.350969417202222,31
"1243","MA","Mirador",21031,9806.13,21018,"Chapadas do Alto Itapecuru",2,"Nordeste",0,"210670",4,26,7,19,16,10,1,1,0,0,1,27,8,19,16,11,6,9.19076297931278,9.95375281868368,0.404995203628452,30
"1244","MA","Mirador",21031,9806.13,21018,"Chapadas do Alto Itapecuru",2,"Nordeste",0,"210670",5,20,9,11,13,7,0,0,0,0,0,20,9,11,13,7,4,9.19076297931278,9.95375281868368,0.420240999693753,31
"1245","MA","Miranda do Norte",28754,19809.18,21006,"Itapecuru Mirim",2,"Nordeste",1,"210675",2,27,7,20,14,13,0,0,0,0,0,27,7,20,14,13,20,9.89390074560013,10.2665321669825,0.289670519320393,29
"1246","MA","Miranda do Norte",28754,19809.18,21006,"Itapecuru Mirim",2,"Nordeste",1,"210675",3,19,8,11,11,8,0,0,0,0,0,19,8,11,11,8,14,9.89390074560013,10.2665321669825,0.371141969865705,31
"1247","MA","Miranda do Norte",28754,19809.18,21006,"Itapecuru Mirim",2,"Nordeste",1,"210675",4,25,6,19,14,11,0,0,0,0,0,25,6,19,14,11,15,9.89390074560013,10.2665321669825,0.400981509692759,30
"1248","MA","Miranda do Norte",28754,19809.18,21006,"Itapecuru Mirim",2,"Nordeste",1,"210675",5,22,5,17,12,10,0,0,0,0,0,22,5,17,12,10,21,9.89390074560013,10.2665321669825,0.407998464376371,31
"1249","MA","Mirinzal",15011,6821.57,21001,"Litoral Ocidental Maranhense",2,"Nordeste",0,"210680",2,19,3,16,9,10,0,0,0,0,0,19,3,16,9,10,5,8.82784492962293,9.61653854466018,0.262557012356397,29
"1250","MA","Mirinzal",15011,6821.57,21001,"Litoral Ocidental Maranhense",2,"Nordeste",0,"210680",3,19,7,12,13,6,0,0,0,0,0,19,7,12,13,6,5,8.82784492962293,9.61653854466018,0.347022780467782,31
"1251","MA","Mirinzal",15011,6821.57,21001,"Litoral Ocidental Maranhense",2,"Nordeste",0,"210680",4,12,5,7,6,6,0,0,0,0,0,12,5,7,6,6,8,8.82784492962293,9.61653854466018,0.396606403550951,30
"1252","MA","Mirinzal",15011,6821.57,21001,"Litoral Ocidental Maranhense",2,"Nordeste",0,"210680",5,17,2,15,8,9,0,0,0,0,0,17,2,15,8,9,13,8.82784492962293,9.61653854466018,0.433618742352556,31
"1253","MA","Monção",33664,6545.79,21005,"Baixada Maranhense",2,"Nordeste",0,"210690",2,35,15,20,25,10,0,0,0,0,0,35,15,20,25,10,7,8.78657737388659,10.4241842960974,0.303032230542181,29
"1254","MA","Monção",33664,6545.79,21005,"Baixada Maranhense",2,"Nordeste",0,"210690",3,31,11,20,15,16,2,1,1,1,1,33,12,21,16,17,13,8.78657737388659,10.4241842960974,0.36388663957981,31
"1255","MA","Monção",33664,6545.79,21005,"Baixada Maranhense",2,"Nordeste",0,"210690",4,34,22,12,22,12,1,0,1,0,1,35,22,13,22,13,10,8.78657737388659,10.4241842960974,0.359837287372016,30
"1256","MA","Monção",33664,6545.79,21005,"Baixada Maranhense",2,"Nordeste",0,"210690",5,34,17,17,23,11,0,0,0,0,0,34,17,17,23,11,24,8.78657737388659,10.4241842960974,0.413328521049015,31
"1257","MA","Morros",19572,6451.76,21003,"Rosário",2,"Nordeste",0,"210710",2,21,11,10,14,7,0,0,0,0,0,21,11,10,14,7,5,8.77210824078511,9.88185525240901,0.304427993383456,29
"1258","MA","Morros",19572,6451.76,21003,"Rosário",2,"Nordeste",0,"210710",3,27,12,15,17,10,0,0,0,0,0,27,12,15,17,10,4,8.77210824078511,9.88185525240901,0.342528418607354,31
"1259","MA","Morros",19572,6451.76,21003,"Rosário",2,"Nordeste",0,"210710",4,21,9,12,13,8,0,0,0,0,0,21,9,12,13,8,8,8.77210824078511,9.88185525240901,0.39722081528971,30
"1260","MA","Morros",19572,6451.76,21003,"Rosário",2,"Nordeste",0,"210710",5,25,11,14,15,10,0,0,0,0,0,25,11,14,15,10,10,8.77210824078511,9.88185525240901,0.390882534791781,31
"1261","MA","Nova Olinda do Maranhão",21080,6408.69,21008,"Pindaré",2,"Nordeste",0,"210735",2,18,5,13,11,7,0,0,0,0,0,18,5,13,11,7,4,8.76541016085397,9.9560800026553,0.263477268160936,29
"1262","MA","Nova Olinda do Maranhão",21080,6408.69,21008,"Pindaré",2,"Nordeste",0,"210735",3,22,8,14,16,6,0,0,0,0,0,22,8,14,16,6,6,8.76541016085397,9.9560800026553,0.313062511432258,31
"1263","MA","Nova Olinda do Maranhão",21080,6408.69,21008,"Pindaré",2,"Nordeste",0,"210735",4,9,3,6,4,5,2,1,1,1,1,11,4,7,5,6,11,8.76541016085397,9.9560800026553,0.359473583891404,30
"1264","MA","Nova Olinda do Maranhão",21080,6408.69,21008,"Pindaré",2,"Nordeste",0,"210735",5,24,6,18,16,8,2,2,0,2,0,26,8,18,18,8,15,8.76541016085397,9.9560800026553,0.372789054149789,31
"1265","MA","Olho d'Água das Cunhãs",19561,7747.88,21010,"Médio Mearim",2,"Nordeste",0,"210740",2,24,15,9,16,8,0,0,0,0,0,24,15,9,16,8,11,8.95517453653911,9.88129306702636,0.30226227659387,29
"1266","MA","Olho d'Água das Cunhãs",19561,7747.88,21010,"Médio Mearim",2,"Nordeste",0,"210740",3,15,2,13,5,10,1,1,0,1,0,16,3,13,6,10,6,8.95517453653911,9.88129306702636,0.392191212326065,31
"1267","MA","Olho d'Água das Cunhãs",19561,7747.88,21010,"Médio Mearim",2,"Nordeste",0,"210740",4,15,5,10,9,6,0,0,0,0,0,15,5,10,9,6,4,8.95517453653911,9.88129306702636,0.423718615441132,30
"1268","MA","Olho d'Água das Cunhãs",19561,7747.88,21010,"Médio Mearim",2,"Nordeste",0,"210740",5,19,8,11,11,8,0,0,0,0,0,19,8,11,11,8,14,8.95517453653911,9.88129306702636,0.456335981077512,31
"1269","MA","Paço do Lumiar",123747,7733.25,21002,"Aglomeração Urbana de São Luís",2,"Nordeste",1,"210750",2,131,19,112,44,87,0,0,0,0,0,131,19,112,44,87,49,8.95328449306616,11.7259944377128,0.307532431576877,29
"1270","MA","Paço do Lumiar",123747,7733.25,21002,"Aglomeração Urbana de São Luís",2,"Nordeste",1,"210750",3,133,36,97,49,84,2,1,1,0,2,135,37,98,49,86,54,8.95328449306616,11.7259944377128,0.405761337585849,31
"1271","MA","Paço do Lumiar",123747,7733.25,21002,"Aglomeração Urbana de São Luís",2,"Nordeste",1,"210750",4,108,20,88,47,61,1,0,1,0,1,109,20,89,47,62,78,8.95328449306616,11.7259944377128,0.477809371323457,30
"1272","MA","Paço do Lumiar",123747,7733.25,21002,"Aglomeração Urbana de São Luís",2,"Nordeste",1,"210750",5,130,31,99,50,80,3,1,2,1,2,133,32,101,51,82,120,8.95328449306616,11.7259944377128,0.47656013495163,31
"1273","MA","Palmeirândia",19781,6301.12,21005,"Baixada Maranhense",2,"Nordeste",0,"210760",2,17,5,12,11,6,1,0,1,0,1,18,5,13,11,7,5,8.74848267435681,9.89247716001608,0.286140780343522,29
"1274","MA","Palmeirândia",19781,6301.12,21005,"Baixada Maranhense",2,"Nordeste",0,"210760",3,8,3,5,7,1,1,0,1,0,1,9,3,6,7,2,9,8.74848267435681,9.89247716001608,0.373363788962208,31
"1275","MA","Palmeirândia",19781,6301.12,21005,"Baixada Maranhense",2,"Nordeste",0,"210760",4,14,5,9,5,9,1,0,1,1,0,15,5,10,6,9,10,8.74848267435681,9.89247716001608,0.434365242393257,30
"1276","MA","Palmeirândia",19781,6301.12,21005,"Baixada Maranhense",2,"Nordeste",0,"210760",5,21,9,12,13,8,0,0,0,0,0,21,9,12,13,8,8,8.74848267435681,9.89247716001608,0.489064146537874,31
"1277","MA","Paraibano",21479,6450.14,21018,"Chapadas do Alto Itapecuru",2,"Nordeste",1,"210770",2,21,9,12,13,8,0,0,0,0,0,21,9,12,13,8,10,8.77185711498062,9.97483099260426,0.289689610491025,29
"1278","MA","Paraibano",21479,6450.14,21018,"Chapadas do Alto Itapecuru",2,"Nordeste",1,"210770",3,20,7,13,11,9,0,0,0,0,0,20,7,13,11,9,13,8.77185711498062,9.97483099260426,0.386017325905579,31
"1279","MA","Paraibano",21479,6450.14,21018,"Chapadas do Alto Itapecuru",2,"Nordeste",1,"210770",4,16,6,10,11,5,0,0,0,0,0,16,6,10,11,5,11,8.77185711498062,9.97483099260426,0.393551291377008,30
"1280","MA","Paraibano",21479,6450.14,21018,"Chapadas do Alto Itapecuru",2,"Nordeste",1,"210770",5,16,7,9,9,7,1,0,1,0,1,17,7,10,9,8,8,8.77185711498062,9.97483099260426,0.427896653445844,31
"1281","MA","Parnarama",35008,6574.68,21017,"Caxias",2,"Nordeste",0,"210780",2,24,11,13,10,14,0,0,0,0,0,24,11,13,10,14,16,8.79098118666006,10.4633318857817,0.283890080461847,29
"1282","MA","Parnarama",35008,6574.68,21017,"Caxias",2,"Nordeste",0,"210780",3,24,13,11,14,10,0,0,0,0,0,24,13,11,14,10,15,8.79098118666006,10.4633318857817,0.39726235085716,31
"1283","MA","Parnarama",35008,6574.68,21017,"Caxias",2,"Nordeste",0,"210780",4,35,17,18,20,15,0,0,0,0,0,35,17,18,20,15,17,8.79098118666006,10.4633318857817,0.406382861136689,30
"1284","MA","Parnarama",35008,6574.68,21017,"Caxias",2,"Nordeste",0,"210780",5,28,17,11,18,10,2,1,1,1,1,30,18,12,19,11,15,8.79098118666006,10.4633318857817,0.448177822311484,31
"1285","MA","Passagem Franca",19137,7787.83,21018,"Chapadas do Alto Itapecuru",2,"Nordeste",0,"210790",2,24,12,12,13,11,0,0,0,0,0,24,12,12,13,11,13,8.96031753779981,9.85937891291007,0.24298562721497,29
"1286","MA","Passagem Franca",19137,7787.83,21018,"Chapadas do Alto Itapecuru",2,"Nordeste",0,"210790",3,23,10,13,9,14,1,0,1,1,0,24,10,14,10,14,10,8.96031753779981,9.85937891291007,0.371858156257551,31
"1287","MA","Passagem Franca",19137,7787.83,21018,"Chapadas do Alto Itapecuru",2,"Nordeste",0,"210790",4,23,9,14,15,8,0,0,0,0,0,23,9,14,15,8,8,8.96031753779981,9.85937891291007,0.402473793782788,30
"1288","MA","Passagem Franca",19137,7787.83,21018,"Chapadas do Alto Itapecuru",2,"Nordeste",0,"210790",5,21,10,11,12,9,0,0,0,0,0,21,10,11,12,9,7,8.96031753779981,9.85937891291007,0.377910701208954,31
"1289","MA","Pastos Bons",19583,10180.01,21018,"Chapadas do Alto Itapecuru",2,"Nordeste",0,"210800",2,14,3,11,7,7,1,0,1,0,1,15,3,12,7,8,5,9.2281812724223,9.88241712191684,0.27214996866987,29
"1290","MA","Pastos Bons",19583,10180.01,21018,"Chapadas do Alto Itapecuru",2,"Nordeste",0,"210800",3,19,5,14,4,15,0,0,0,0,0,19,5,14,4,15,8,9.2281812724223,9.88241712191684,0.349454697551081,31
"1291","MA","Pastos Bons",19583,10180.01,21018,"Chapadas do Alto Itapecuru",2,"Nordeste",0,"210800",4,15,3,12,3,12,0,0,0,0,0,15,3,12,3,12,14,9.2281812724223,9.88241712191684,0.311611016815555,30
"1292","MA","Pastos Bons",19583,10180.01,21018,"Chapadas do Alto Itapecuru",2,"Nordeste",0,"210800",5,14,6,8,5,9,0,0,0,0,0,14,6,8,5,9,13,9.2281812724223,9.88241712191684,0.335140534392323,31
"1293","MA","Paulino Neves",16166,6487.82,21004,"Lençóis Maranhenses",2,"Nordeste",0,"210805",2,22,8,14,11,11,0,0,0,0,0,22,8,14,11,11,3,8.77768185188388,9.69066555029379,0.293896012337053,29
"1294","MA","Paulino Neves",16166,6487.82,21004,"Lençóis Maranhenses",2,"Nordeste",0,"210805",3,25,7,18,19,6,0,0,0,0,0,25,7,18,19,6,8,8.77768185188388,9.69066555029379,0.348294541220341,31
"1295","MA","Paulino Neves",16166,6487.82,21004,"Lençóis Maranhenses",2,"Nordeste",0,"210805",4,15,7,8,6,9,0,0,0,0,0,15,7,8,6,9,6,8.77768185188388,9.69066555029379,0.375938479586712,30
"1296","MA","Paulino Neves",16166,6487.82,21004,"Lençóis Maranhenses",2,"Nordeste",0,"210805",5,29,8,21,9,20,0,0,0,0,0,29,8,21,9,20,13,8.77768185188388,9.69066555029379,0.456736213882287,31
"1297","MA","Paulo Ramos",21066,7161.16,21008,"Pindaré",2,"Nordeste",0,"210810",2,33,20,13,14,19,0,0,0,0,0,33,20,13,14,19,8,8.87642725800548,9.95541564539649,0.266670676520884,29
"1298","MA","Paulo Ramos",21066,7161.16,21008,"Pindaré",2,"Nordeste",0,"210810",3,22,8,14,13,9,0,0,0,0,0,22,8,14,13,9,11,8.87642725800548,9.95541564539649,0.374977152997073,31
"1299","MA","Paulo Ramos",21066,7161.16,21008,"Pindaré",2,"Nordeste",0,"210810",4,28,16,12,13,15,1,0,1,1,0,29,16,13,14,15,7,8.87642725800548,9.95541564539649,0.393692443631516,30
"1300","MA","Paulo Ramos",21066,7161.16,21008,"Pindaré",2,"Nordeste",0,"210810",5,17,10,7,8,9,0,0,0,0,0,17,10,7,8,9,17,8.87642725800548,9.95541564539649,0.440914556747942,31
"1301","MA","Pedreiras",39191,15334.36,21010,"Médio Mearim",2,"Nordeste",1,"210820",2,37,10,27,18,19,0,0,0,0,0,37,10,27,18,19,18,9.63785134108337,10.5762024075816,0.272135655629625,29
"1302","MA","Pedreiras",39191,15334.36,21010,"Médio Mearim",2,"Nordeste",1,"210820",3,39,5,34,19,20,0,0,0,0,0,39,5,34,19,20,29,9.63785134108337,10.5762024075816,0.375950751004726,31
"1303","MA","Pedreiras",39191,15334.36,21010,"Médio Mearim",2,"Nordeste",1,"210820",4,47,12,35,24,23,1,0,1,0,1,48,12,36,24,24,20,9.63785134108337,10.5762024075816,0.411876900798653,30
"1304","MA","Pedreiras",39191,15334.36,21010,"Médio Mearim",2,"Nordeste",1,"210820",5,35,7,28,19,16,1,0,1,1,0,36,7,29,20,16,72,9.63785134108337,10.5762024075816,0.448528192958036,31
"1305","MA","Penalva",38731,5606.64,21005,"Baixada Maranhense",2,"Nordeste",0,"210830",2,59,24,35,39,20,0,0,0,0,0,59,24,35,39,20,18,8.63170688860495,10.5643955919534,0.286395661652214,29
"1306","MA","Penalva",38731,5606.64,21005,"Baixada Maranhense",2,"Nordeste",0,"210830",3,35,8,27,20,15,0,0,0,0,0,35,8,27,20,15,16,8.63170688860495,10.5643955919534,0.374226959390925,31
"1307","MA","Penalva",38731,5606.64,21005,"Baixada Maranhense",2,"Nordeste",0,"210830",4,44,19,25,19,25,0,0,0,0,0,44,19,25,19,25,13,8.63170688860495,10.5643955919534,0.401673613870406,30
"1308","MA","Penalva",38731,5606.64,21005,"Baixada Maranhense",2,"Nordeste",0,"210830",5,51,24,27,31,20,2,1,1,1,1,53,25,28,32,21,57,8.63170688860495,10.5643955919534,0.420758825767542,31
"1309","MA","Peri Mirim",14345,5489.02,21005,"Baixada Maranhense",2,"Nordeste",0,"210840",2,7,2,5,6,1,0,0,0,0,0,7,2,5,6,1,5,8.61050501219419,9.57115672841547,0.299773044321132,29
"1310","MA","Peri Mirim",14345,5489.02,21005,"Baixada Maranhense",2,"Nordeste",0,"210840",3,13,4,9,8,5,1,0,1,1,0,14,4,10,9,5,4,8.61050501219419,9.57115672841547,0.370254975822002,31
"1311","MA","Peri Mirim",14345,5489.02,21005,"Baixada Maranhense",2,"Nordeste",0,"210840",4,6,2,4,1,5,0,0,0,0,0,6,2,4,1,5,6,8.61050501219419,9.57115672841547,0.428766266532518,30
"1312","MA","Peri Mirim",14345,5489.02,21005,"Baixada Maranhense",2,"Nordeste",0,"210840",5,4,0,4,3,1,0,0,0,0,0,4,0,4,3,1,11,8.61050501219419,9.57115672841547,0.502501774066094,31
"1313","MA","Peritoró",23364,9459.6,21015,"Codó",2,"Nordeste",0,"210845",2,38,16,22,18,20,0,0,0,0,0,38,16,22,18,20,9,9.15478537785386,10.0589516551602,0.302790220307614,29
"1314","MA","Peritoró",23364,9459.6,21015,"Codó",2,"Nordeste",0,"210845",3,31,16,15,14,17,1,1,0,1,0,32,17,15,15,17,10,9.15478537785386,10.0589516551602,0.394799153594318,31
"1315","MA","Peritoró",23364,9459.6,21015,"Codó",2,"Nordeste",0,"210845",4,25,9,16,15,10,0,0,0,0,0,25,9,16,15,10,7,9.15478537785386,10.0589516551602,0.420544207048425,30
"1316","MA","Peritoró",23364,9459.6,21015,"Codó",2,"Nordeste",0,"210845",5,31,13,18,23,8,0,0,0,0,0,31,13,18,23,8,10,9.15478537785386,10.0589516551602,0.455468051106592,31
"1317","MA","Pindaré-Mirim",33065,7942.86,21008,"Pindaré",2,"Nordeste",0,"210850",2,44,14,30,22,22,0,0,0,0,0,44,14,30,22,22,15,8.98002869089553,10.4062306001088,0.320253156446926,29
"1318","MA","Pindaré-Mirim",33065,7942.86,21008,"Pindaré",2,"Nordeste",0,"210850",3,29,12,17,17,12,0,0,0,0,0,29,12,17,17,12,15,8.98002869089553,10.4062306001088,0.427526279237645,31
"1319","MA","Pindaré-Mirim",33065,7942.86,21008,"Pindaré",2,"Nordeste",0,"210850",4,33,14,19,17,16,0,0,0,0,0,33,14,19,17,16,27,8.98002869089553,10.4062306001088,0.461081101655864,30
"1320","MA","Pindaré-Mirim",33065,7942.86,21008,"Pindaré",2,"Nordeste",0,"210850",5,48,14,34,32,16,0,0,0,0,0,48,14,34,32,16,44,8.98002869089553,10.4062306001088,0.511239348876599,31
"1321","MA","Pinheiro",83777,9970.68,21005,"Baixada Maranhense",2,"Nordeste",1,"210860",2,100,25,75,44,56,2,0,2,2,0,102,25,77,46,56,40,9.2074040652439,11.3359137857912,0.276905215014692,29
"1322","MA","Pinheiro",83777,9970.68,21005,"Baixada Maranhense",2,"Nordeste",1,"210860",3,117,25,92,45,72,1,0,1,1,0,118,25,93,46,72,39,9.2074040652439,11.3359137857912,0.355870474423264,31
"1323","MA","Pinheiro",83777,9970.68,21005,"Baixada Maranhense",2,"Nordeste",1,"210860",4,87,17,70,48,39,1,1,0,1,0,88,18,70,49,39,32,9.2074040652439,11.3359137857912,0.392281433335688,30
"1324","MA","Pinheiro",83777,9970.68,21005,"Baixada Maranhense",2,"Nordeste",1,"210860",5,101,30,71,53,48,3,1,2,0,3,104,31,73,53,51,102,9.2074040652439,11.3359137857912,0.437064289391685,31
"1325","MA","Pio XII",21379,7376.57,21010,"Médio Mearim",2,"Nordeste",0,"210870",2,29,13,16,20,9,1,1,0,0,1,30,14,16,20,10,7,8.90606403990793,9.97016441080041,0.275359281244705,29
"1326","MA","Pio XII",21379,7376.57,21010,"Médio Mearim",2,"Nordeste",0,"210870",3,33,11,22,19,14,0,0,0,0,0,33,11,22,19,14,14,8.90606403990793,9.97016441080041,0.365484804183237,31
"1327","MA","Pio XII",21379,7376.57,21010,"Médio Mearim",2,"Nordeste",0,"210870",4,21,4,17,13,8,1,1,0,1,0,22,5,17,14,8,12,8.90606403990793,9.97016441080041,0.400754619319486,30
"1328","MA","Pio XII",21379,7376.57,21010,"Médio Mearim",2,"Nordeste",0,"210870",5,18,11,7,10,8,0,0,0,0,0,18,11,7,10,8,14,8.90606403990793,9.97016441080041,0.446300425865108,31
"1329","MA","Pirapemas",18720,6289.57,21006,"Itapecuru Mirim",2,"Nordeste",0,"210880",2,21,13,8,14,7,1,1,0,0,1,22,14,8,14,8,8,8.74664798487754,9.83734775003158,0.301373320899253,29
"1330","MA","Pirapemas",18720,6289.57,21006,"Itapecuru Mirim",2,"Nordeste",0,"210880",3,19,10,9,12,7,0,0,0,0,0,19,10,9,12,7,5,8.74664798487754,9.83734775003158,0.432559637931343,31
"1331","MA","Pirapemas",18720,6289.57,21006,"Itapecuru Mirim",2,"Nordeste",0,"210880",4,18,8,10,10,8,1,0,1,1,0,19,8,11,11,8,9,8.74664798487754,9.83734775003158,0.43974840278179,30
"1332","MA","Pirapemas",18720,6289.57,21006,"Itapecuru Mirim",2,"Nordeste",0,"210880",5,19,4,15,12,7,0,0,0,0,0,19,4,15,12,7,8,8.74664798487754,9.83734775003158,0.4472594999835,31
"1333","MA","Poção de Pedras",17595,8212,21010,"Médio Mearim",2,"Nordeste",0,"210890",2,14,3,11,10,4,0,0,0,0,0,14,3,11,10,4,15,9.01335177813882,9.77537004975569,0.289100324819427,29
"1334","MA","Poção de Pedras",17595,8212,21010,"Médio Mearim",2,"Nordeste",0,"210890",3,16,6,10,8,8,0,0,0,0,0,16,6,10,8,8,12,9.01335177813882,9.77537004975569,0.403547156272839,31
"1335","MA","Poção de Pedras",17595,8212,21010,"Médio Mearim",2,"Nordeste",0,"210890",4,19,6,13,12,7,0,0,0,0,0,19,6,13,12,7,5,9.01335177813882,9.77537004975569,0.427505579702846,30
"1336","MA","Poção de Pedras",17595,8212,21010,"Médio Mearim",2,"Nordeste",0,"210890",5,13,4,9,6,7,0,0,0,0,0,13,4,9,6,7,7,9.01335177813882,9.77537004975569,0.449659401852692,31
"1337","MA","Porto Franco",24092,22240.43,21019,"Porto Franco",2,"Nordeste",1,"210900",2,31,7,24,17,14,0,0,0,0,0,31,7,24,17,14,14,10.00966708271,10.0896351141636,0.258575987796278,29
"1338","MA","Porto Franco",24092,22240.43,21019,"Porto Franco",2,"Nordeste",1,"210900",3,23,8,15,12,11,0,0,0,0,0,23,8,15,12,11,6,10.00966708271,10.0896351141636,0.34438814941311,31
"1339","MA","Porto Franco",24092,22240.43,21019,"Porto Franco",2,"Nordeste",1,"210900",4,17,4,13,10,7,0,0,0,0,0,17,4,13,10,7,10,10.00966708271,10.0896351141636,0.369996763089682,30
"1340","MA","Porto Franco",24092,22240.43,21019,"Porto Franco",2,"Nordeste",1,"210900",5,25,2,23,10,15,0,0,0,0,0,25,2,23,10,15,13,10.00966708271,10.0896351141636,0.382742375686715,31
"1341","MA","Presidente Dutra",48036,12362.73,21012,"Presidente Dutra",2,"Nordeste",1,"210910",2,55,12,43,27,28,1,1,0,0,1,56,13,43,27,29,19,9.42244158040907,10.7797060087806,0.271409248856997,29
"1342","MA","Presidente Dutra",48036,12362.73,21012,"Presidente Dutra",2,"Nordeste",1,"210910",3,53,14,39,20,33,0,0,0,0,0,53,14,39,20,33,19,9.42244158040907,10.7797060087806,0.358924841583696,31
"1343","MA","Presidente Dutra",48036,12362.73,21012,"Presidente Dutra",2,"Nordeste",1,"210910",4,47,11,36,24,23,0,0,0,0,0,47,11,36,24,23,20,9.42244158040907,10.7797060087806,0.372012268552965,30
"1344","MA","Presidente Dutra",48036,12362.73,21012,"Presidente Dutra",2,"Nordeste",1,"210910",5,52,9,43,26,26,0,0,0,0,0,52,9,43,26,26,40,9.42244158040907,10.7797060087806,0.402090573811492,31
"1345","MA","Raposa",31177,7838.23,21002,"Aglomeração Urbana de São Luís",2,"Nordeste",1,"210945",2,38,14,24,17,21,0,0,0,0,0,38,14,24,17,21,10,8.96676832254951,10.34743592246,0.298672389652848,29
"1346","MA","Raposa",31177,7838.23,21002,"Aglomeração Urbana de São Luís",2,"Nordeste",1,"210945",3,25,9,16,10,15,1,1,0,0,1,26,10,16,10,16,12,8.96676832254951,10.34743592246,0.401281583299018,31
"1347","MA","Raposa",31177,7838.23,21002,"Aglomeração Urbana de São Luís",2,"Nordeste",1,"210945",4,32,9,23,21,11,0,0,0,0,0,32,9,23,21,11,24,8.96676832254951,10.34743592246,0.46350539656418,30
"1348","MA","Raposa",31177,7838.23,21002,"Aglomeração Urbana de São Luís",2,"Nordeste",1,"210945",5,36,8,28,19,17,0,0,0,0,0,36,8,28,19,17,30,8.96676832254951,10.34743592246,0.461976504599635,31
"1349","MA","Riachão",20334,17440.2,21020,"Gerais de Balsas",2,"Nordeste",0,"210950",2,30,10,20,16,14,1,1,0,1,0,31,11,20,17,14,8,9.76653316528712,9.92004964083511,0.295470788597982,29
"1350","MA","Riachão",20334,17440.2,21020,"Gerais de Balsas",2,"Nordeste",0,"210950",3,24,14,10,12,12,0,0,0,0,0,24,14,10,12,12,15,9.76653316528712,9.92004964083511,0.377130618347075,31
"1351","MA","Riachão",20334,17440.2,21020,"Gerais de Balsas",2,"Nordeste",0,"210950",4,24,11,13,11,13,0,0,0,0,0,24,11,13,11,13,5,9.76653316528712,9.92004964083511,0.362585974086953,30
"1352","MA","Riachão",20334,17440.2,21020,"Gerais de Balsas",2,"Nordeste",0,"210950",5,25,14,11,19,6,0,0,0,0,0,25,14,11,19,6,13,9.76653316528712,9.92004964083511,0.403218723647018,31
"1353","MA","Rosário",42994,8426.98,21003,"Rosário",2,"Nordeste",1,"210960",2,46,10,36,26,20,0,0,0,0,0,46,10,36,26,20,29,9.0391937424457,10.6688158500561,0.283487259617629,29
"1354","MA","Rosário",42994,8426.98,21003,"Rosário",2,"Nordeste",1,"210960",3,32,8,24,13,19,2,1,1,1,1,34,9,25,14,20,28,9.0391937424457,10.6688158500561,0.378012251763324,31
"1355","MA","Rosário",42994,8426.98,21003,"Rosário",2,"Nordeste",1,"210960",4,35,10,25,17,18,0,0,0,0,0,35,10,25,17,18,22,9.0391937424457,10.6688158500561,0.403894740496736,30
"1356","MA","Rosário",42994,8426.98,21003,"Rosário",2,"Nordeste",1,"210960",5,23,7,16,11,12,1,0,1,0,1,24,7,17,11,13,49,9.0391937424457,10.6688158500561,0.40622617061709,31
"1357","MA","Santa Helena",42483,6862.82,21005,"Baixada Maranhense",2,"Nordeste",1,"210980",2,37,11,26,17,20,0,0,0,0,0,37,11,26,17,20,10,8.83387371496742,10.6568592748912,0.296877760560799,29
"1358","MA","Santa Helena",42483,6862.82,21005,"Baixada Maranhense",2,"Nordeste",1,"210980",3,25,9,16,17,8,1,1,0,0,1,26,10,16,17,9,11,8.83387371496742,10.6568592748912,0.39364460392298,31
"1359","MA","Santa Helena",42483,6862.82,21005,"Baixada Maranhense",2,"Nordeste",1,"210980",4,31,12,19,19,12,0,0,0,0,0,31,12,19,19,12,16,8.83387371496742,10.6568592748912,0.434290438090218,30
"1360","MA","Santa Helena",42483,6862.82,21005,"Baixada Maranhense",2,"Nordeste",1,"210980",5,45,14,31,27,18,0,0,0,0,0,45,14,31,27,18,35,8.83387371496742,10.6568592748912,0.481025010449371,31
"1361","MA","Santa Inês",89489,14593.34,21008,"Pindaré",2,"Nordeste",1,"210990",2,115,37,78,58,57,2,0,2,1,1,117,37,80,59,58,43,9.58832053923824,11.4018709916816,0.306129055134721,29
"1362","MA","Santa Inês",89489,14593.34,21008,"Pindaré",2,"Nordeste",1,"210990",3,112,32,80,50,62,2,0,2,1,1,114,32,82,51,63,46,9.58832053923824,11.4018709916816,0.390528263819367,31
"1363","MA","Santa Inês",89489,14593.34,21008,"Pindaré",2,"Nordeste",1,"210990",4,119,29,90,67,52,3,1,2,2,1,122,30,92,69,53,54,9.58832053923824,11.4018709916816,0.431949514693913,30
"1364","MA","Santa Inês",89489,14593.34,21008,"Pindaré",2,"Nordeste",1,"210990",5,109,26,83,62,47,2,1,1,0,2,111,27,84,62,49,123,9.58832053923824,11.4018709916816,0.456918625407809,31
"1365","MA","Santa Luzia",72887,7867.14,21008,"Pindaré",2,"Nordeste",0,"211000",2,94,41,53,54,40,0,0,0,0,0,94,41,53,54,40,32,8.97044987002701,11.1966655756201,0.311789982232337,29
"1366","MA","Santa Luzia",72887,7867.14,21008,"Pindaré",2,"Nordeste",0,"211000",3,87,36,51,51,36,0,0,0,0,0,87,36,51,51,36,33,8.97044987002701,11.1966655756201,0.400115141229984,31
"1367","MA","Santa Luzia",72887,7867.14,21008,"Pindaré",2,"Nordeste",0,"211000",4,79,27,52,55,24,3,1,2,1,2,82,28,54,56,26,33,8.97044987002701,11.1966655756201,0.414949881174371,30
"1368","MA","Santa Luzia",72887,7867.14,21008,"Pindaré",2,"Nordeste",0,"211000",5,66,32,34,43,23,0,0,0,0,0,66,32,34,43,23,44,8.97044987002701,11.1966655756201,0.442865513399004,31
"1369","MA","Santa Luzia do Paruá",25371,8526.12,21008,"Pindaré",2,"Nordeste",0,"211003",2,11,3,8,3,8,1,0,1,1,0,12,3,9,4,8,7,9.05088967182147,10.1413620684503,0.277458593104405,29
"1370","MA","Santa Luzia do Paruá",25371,8526.12,21008,"Pindaré",2,"Nordeste",0,"211003",3,18,5,13,7,11,0,0,0,0,0,18,5,13,7,11,11,9.05088967182147,10.1413620684503,0.345336920973271,31
"1371","MA","Santa Luzia do Paruá",25371,8526.12,21008,"Pindaré",2,"Nordeste",0,"211003",4,3,1,2,1,2,0,0,0,0,0,3,1,2,1,2,4,9.05088967182147,10.1413620684503,0.371089223479142,30
"1372","MA","Santa Luzia do Paruá",25371,8526.12,21008,"Pindaré",2,"Nordeste",0,"211003",5,7,5,2,3,4,1,1,0,1,0,8,6,2,4,4,12,9.05088967182147,10.1413620684503,0.397149561081236,31
"1373","MA","Santa Quitéria do Maranhão",25764,7256.54,21013,"Baixo Parnaíba Maranhense",2,"Nordeste",0,"211010",2,20,9,11,12,8,1,0,1,1,0,21,9,12,13,8,6,8.88965841019454,10.1567334476668,0.311742451281552,29
"1374","MA","Santa Quitéria do Maranhão",25764,7256.54,21013,"Baixo Parnaíba Maranhense",2,"Nordeste",0,"211010",3,21,7,14,13,8,1,1,0,1,0,22,8,14,14,8,16,8.88965841019454,10.1567334476668,0.42358701665908,31
"1375","MA","Santa Quitéria do Maranhão",25764,7256.54,21013,"Baixo Parnaíba Maranhense",2,"Nordeste",0,"211010",4,26,12,14,17,9,0,0,0,0,0,26,12,14,17,9,15,8.88965841019454,10.1567334476668,0.46113563265503,30
"1376","MA","Santa Quitéria do Maranhão",25764,7256.54,21013,"Baixo Parnaíba Maranhense",2,"Nordeste",0,"211010",5,30,9,21,17,13,1,1,0,1,0,31,10,21,18,13,20,8.88965841019454,10.1567334476668,0.543355309047256,31
"1377","MA","Santa Rita",38298,7226.98,21003,"Rosário",2,"Nordeste",0,"211020",2,38,7,31,22,16,0,0,0,0,0,38,7,31,22,16,14,8.88557652387912,10.5531529544841,0.276476554795219,29
"1378","MA","Santa Rita",38298,7226.98,21003,"Rosário",2,"Nordeste",0,"211020",3,45,16,29,21,24,2,2,0,0,2,47,18,29,21,26,8,8.88557652387912,10.5531529544841,0.355599640967436,31
"1379","MA","Santa Rita",38298,7226.98,21003,"Rosário",2,"Nordeste",0,"211020",4,43,18,25,22,21,0,0,0,0,0,43,18,25,22,21,12,8.88557652387912,10.5531529544841,0.398156070955418,30
"1380","MA","Santa Rita",38298,7226.98,21003,"Rosário",2,"Nordeste",0,"211020",5,45,19,26,28,17,0,0,0,0,0,45,19,26,28,17,33,8.88557652387912,10.5531529544841,0.411727479057668,31
"1381","MA","Santo Antônio dos Lopes",14522,131703.11,21010,"Médio Mearim",2,"Nordeste",0,"211030",2,13,1,12,5,8,1,0,1,0,1,14,1,13,5,9,12,11.7883055017274,9.58342001994019,0.272885151945669,29
"1382","MA","Santo Antônio dos Lopes",14522,131703.11,21010,"Médio Mearim",2,"Nordeste",0,"211030",3,21,6,15,10,11,0,0,0,0,0,21,6,15,10,11,7,11.7883055017274,9.58342001994019,0.369801401787135,31
"1383","MA","Santo Antônio dos Lopes",14522,131703.11,21010,"Médio Mearim",2,"Nordeste",0,"211030",4,13,5,8,8,5,0,0,0,0,0,13,5,8,8,5,5,11.7883055017274,9.58342001994019,0.385750100207391,30
"1384","MA","Santo Antônio dos Lopes",14522,131703.11,21010,"Médio Mearim",2,"Nordeste",0,"211030",5,18,5,13,8,10,0,0,0,0,0,18,5,13,8,10,15,11.7883055017274,9.58342001994019,0.448931888322235,31
"1385","MA","São Benedito do Rio Preto",18717,6366.23,21014,"Chapadinha",2,"Nordeste",0,"211040",2,38,19,19,24,14,0,0,0,0,0,38,19,19,24,14,10,8.75876273662702,9.8371874807789,0.290213162703649,29
"1386","MA","São Benedito do Rio Preto",18717,6366.23,21014,"Chapadinha",2,"Nordeste",0,"211040",3,23,10,13,15,8,0,0,0,0,0,23,10,13,15,8,6,8.75876273662702,9.8371874807789,0.383721039373691,31
"1387","MA","São Benedito do Rio Preto",18717,6366.23,21014,"Chapadinha",2,"Nordeste",0,"211040",4,26,10,16,17,9,0,0,0,0,0,26,10,16,17,9,8,8.75876273662702,9.8371874807789,0.413693111215833,30
"1388","MA","São Benedito do Rio Preto",18717,6366.23,21014,"Chapadinha",2,"Nordeste",0,"211040",5,20,9,11,14,6,1,0,1,1,0,21,9,12,15,6,8,8.75876273662702,9.8371874807789,0.432036120346288,31
"1389","MA","São Bento",45604,6118.81,21005,"Baixada Maranhense",2,"Nordeste",0,"211050",2,29,9,20,16,13,0,0,0,0,0,29,9,20,16,13,7,8.71912291215516,10.7277507109536,0.276698920832715,29
"1390","MA","São Bento",45604,6118.81,21005,"Baixada Maranhense",2,"Nordeste",0,"211050",3,36,8,28,19,17,1,0,1,0,1,37,8,29,19,18,17,8.71912291215516,10.7277507109536,0.344395340125032,31
"1391","MA","São Bento",45604,6118.81,21005,"Baixada Maranhense",2,"Nordeste",0,"211050",4,34,18,16,20,14,0,0,0,0,0,34,18,16,20,14,10,8.71912291215516,10.7277507109536,0.411829484192065,30
"1392","MA","São Bento",45604,6118.81,21005,"Baixada Maranhense",2,"Nordeste",0,"211050",5,30,9,21,13,17,2,0,2,0,2,32,9,23,13,19,21,8.71912291215516,10.7277507109536,0.459336709894081,31
"1393","MA","São Bernardo",28667,8975.53,21013,"Baixo Parnaíba Maranhense",2,"Nordeste",0,"211060",2,23,5,18,13,10,0,0,0,0,0,23,5,18,13,10,3,9.10225726453772,10.2635019144069,0.258331049679257,29
"1394","MA","São Bernardo",28667,8975.53,21013,"Baixo Parnaíba Maranhense",2,"Nordeste",0,"211060",3,28,9,19,14,14,1,1,0,1,0,29,10,19,15,14,9,9.10225726453772,10.2635019144069,0.358012137526107,31
"1395","MA","São Bernardo",28667,8975.53,21013,"Baixo Parnaíba Maranhense",2,"Nordeste",0,"211060",4,27,10,17,8,19,0,0,0,0,0,27,10,17,8,19,6,9.10225726453772,10.2635019144069,0.390860110318394,30
"1396","MA","São Bernardo",28667,8975.53,21013,"Baixo Parnaíba Maranhense",2,"Nordeste",0,"211060",5,24,10,14,10,14,0,0,0,0,0,24,10,14,10,14,13,9.10225726453772,10.2635019144069,0.461840873570013,31
"1397","MA","São Domingos do Maranhão",34384,8465.37,21012,"Presidente Dutra",2,"Nordeste",0,"211070",2,51,19,32,25,26,0,0,0,0,0,51,19,32,25,26,17,9.04373900300362,10.4453466188823,0.294708277896716,29
"1398","MA","São Domingos do Maranhão",34384,8465.37,21012,"Presidente Dutra",2,"Nordeste",0,"211070",3,45,13,32,21,24,0,0,0,0,0,45,13,32,21,24,25,9.04373900300362,10.4453466188823,0.381200021869972,31
"1399","MA","São Domingos do Maranhão",34384,8465.37,21012,"Presidente Dutra",2,"Nordeste",0,"211070",4,40,12,28,25,15,0,0,0,0,0,40,12,28,25,15,12,9.04373900300362,10.4453466188823,0.387644541848211,30
"1400","MA","São Domingos do Maranhão",34384,8465.37,21012,"Presidente Dutra",2,"Nordeste",0,"211070",5,53,20,33,31,22,0,0,0,0,0,53,20,33,31,22,27,9.04373900300362,10.4453466188823,0.424985697930062,31
"1401","MA","São João do Soter",18645,5536.58,21017,"Caxias",2,"Nordeste",0,"211107",2,24,6,18,14,10,0,0,0,0,0,24,6,18,14,10,6,8.61913226059577,9.83333329261292,0.31673355785954,29
"1402","MA","São João do Soter",18645,5536.58,21017,"Caxias",2,"Nordeste",0,"211107",3,12,7,5,9,3,1,1,0,0,1,13,8,5,9,4,5,8.61913226059577,9.83333329261292,0.388849104134958,31
"1403","MA","São João do Soter",18645,5536.58,21017,"Caxias",2,"Nordeste",0,"211107",4,14,8,6,8,6,1,1,0,1,0,15,9,6,9,6,7,8.61913226059577,9.83333329261292,0.397127226938097,30
"1404","MA","São João do Soter",18645,5536.58,21017,"Caxias",2,"Nordeste",0,"211107",5,18,6,12,14,4,0,0,0,0,0,18,6,12,14,4,14,8.61913226059577,9.83333329261292,0.412654843875761,31
"1405","MA","São João dos Patos",25996,10324.86,21018,"Chapadas do Alto Itapecuru",2,"Nordeste",1,"211110",2,23,10,13,11,12,0,0,0,0,0,23,10,13,11,12,14,9.24230985841527,10.1656979590142,0.258406173348064,29
"1406","MA","São João dos Patos",25996,10324.86,21018,"Chapadas do Alto Itapecuru",2,"Nordeste",1,"211110",3,30,8,22,14,16,0,0,0,0,0,30,8,22,14,16,19,9.24230985841527,10.1656979590142,0.35033320457742,31
"1407","MA","São João dos Patos",25996,10324.86,21018,"Chapadas do Alto Itapecuru",2,"Nordeste",1,"211110",4,21,6,15,13,8,0,0,0,0,0,21,6,15,13,8,14,9.24230985841527,10.1656979590142,0.399586756025136,30
"1408","MA","São João dos Patos",25996,10324.86,21018,"Chapadas do Alto Itapecuru",2,"Nordeste",1,"211110",5,25,7,18,12,13,0,0,0,0,0,25,7,18,12,13,19,9.24230985841527,10.1656979590142,0.392843002307114,31
"1409","MA","São José de Ribamar",179028,12366.97,21002,"Aglomeração Urbana de São Luís",2,"Nordeste",1,"211120",2,273,61,212,106,167,0,0,0,0,0,273,61,212,106,167,88,9.42278448792849,12.0952974971708,0.292528470976765,29
"1410","MA","São José de Ribamar",179028,12366.97,21002,"Aglomeração Urbana de São Luís",2,"Nordeste",1,"211120",3,243,37,206,102,141,1,0,1,0,1,244,37,207,102,142,116,9.42278448792849,12.0952974971708,0.392031187780465,31
"1411","MA","São José de Ribamar",179028,12366.97,21002,"Aglomeração Urbana de São Luís",2,"Nordeste",1,"211120",4,229,42,187,102,127,3,0,3,1,2,232,42,190,103,129,152,9.42278448792849,12.0952974971708,0.468761649088927,30
"1412","MA","São José de Ribamar",179028,12366.97,21002,"Aglomeração Urbana de São Luís",2,"Nordeste",1,"211120",5,269,53,216,110,159,3,1,2,0,3,272,54,218,110,162,226,9.42278448792849,12.0952974971708,0.471342764893992,31
"1413","MA","São Luís",1108975,30699.57,21002,"Aglomeração Urbana de São Luís",2,"Nordeste",1,"211130",2,1119,185,934,444,675,12,3,9,5,7,1131,188,943,449,682,463,10.3320039269625,13.918946723247,0.299085779268054,29
"1414","MA","São Luís",1108975,30699.57,21002,"Aglomeração Urbana de São Luís",2,"Nordeste",1,"211130",3,1057,183,874,414,643,7,2,5,5,2,1064,185,879,419,645,554,10.3320039269625,13.918946723247,0.400947433217733,31
"1415","MA","São Luís",1108975,30699.57,21002,"Aglomeração Urbana de São Luís",2,"Nordeste",1,"211130",4,949,169,780,375,574,6,2,4,3,3,955,171,784,378,577,1163,10.3320039269625,13.918946723247,0.488882277799385,30
"1416","MA","São Luís",1108975,30699.57,21002,"Aglomeração Urbana de São Luís",2,"Nordeste",1,"211130",5,1120,188,932,397,723,6,4,2,1,5,1126,192,934,398,728,1398,10.3320039269625,13.918946723247,0.484594197044201,31
"1417","MA","São Luís Gonzaga do Maranhão",18727,7278.09,21010,"Médio Mearim",2,"Nordeste",0,"211140",2,26,13,13,17,9,0,0,0,0,0,26,13,13,17,9,4,8.89262374413027,9.83772161176051,0.265202173778586,29
"1418","MA","São Luís Gonzaga do Maranhão",18727,7278.09,21010,"Médio Mearim",2,"Nordeste",0,"211140",3,21,4,17,8,13,0,0,0,0,0,21,4,17,8,13,3,8.89262374413027,9.83772161176051,0.352321143791089,31
"1419","MA","São Luís Gonzaga do Maranhão",18727,7278.09,21010,"Médio Mearim",2,"Nordeste",0,"211140",4,21,5,16,11,10,1,0,1,1,0,22,5,17,12,10,12,8.89262374413027,9.83772161176051,0.399344457172966,30
"1420","MA","São Luís Gonzaga do Maranhão",18727,7278.09,21010,"Médio Mearim",2,"Nordeste",0,"211140",5,20,2,18,10,10,0,0,0,0,0,20,2,18,10,10,15,8.89262374413027,9.83772161176051,0.465959346001734,31
"1421","MA","São Mateus do Maranhão",41579,8333.39,21010,"Médio Mearim",2,"Nordeste",1,"211150",2,44,13,31,23,21,1,1,0,0,1,45,14,31,23,22,19,9.02802561515911,10.6353505110987,0.289795678993896,29
"1422","MA","São Mateus do Maranhão",41579,8333.39,21010,"Médio Mearim",2,"Nordeste",1,"211150",3,44,20,24,25,19,1,0,1,0,1,45,20,25,25,20,23,9.02802561515911,10.6353505110987,0.385845998266992,31
"1423","MA","São Mateus do Maranhão",41579,8333.39,21010,"Médio Mearim",2,"Nordeste",1,"211150",4,45,17,28,27,18,0,0,0,0,0,45,17,28,27,18,12,9.02802561515911,10.6353505110987,0.391098125976226,30
"1424","MA","São Mateus do Maranhão",41579,8333.39,21010,"Médio Mearim",2,"Nordeste",1,"211150",5,39,17,22,24,15,0,0,0,0,0,39,17,22,24,15,49,9.02802561515911,10.6353505110987,0.438019190703644,31
"1425","MA","São Raimundo das Mangabeiras",18980,22251.85,21021,"Chapadas das Mangabeiras",2,"Nordeste",0,"211160",2,28,12,16,18,10,0,0,0,0,0,28,12,16,18,10,12,10.0101804302054,9.85114107216392,0.280882309782591,29
"1426","MA","São Raimundo das Mangabeiras",18980,22251.85,21021,"Chapadas das Mangabeiras",2,"Nordeste",0,"211160",3,18,5,13,8,10,0,0,0,0,0,18,5,13,8,10,16,10.0101804302054,9.85114107216392,0.343356755488424,31
"1427","MA","São Raimundo das Mangabeiras",18980,22251.85,21021,"Chapadas das Mangabeiras",2,"Nordeste",0,"211160",4,27,8,19,15,12,2,2,0,1,1,29,10,19,16,13,11,10.0101804302054,9.85114107216392,0.354898064186661,30
"1428","MA","São Raimundo das Mangabeiras",18980,22251.85,21021,"Chapadas das Mangabeiras",2,"Nordeste",0,"211160",5,20,5,15,14,6,0,0,0,0,0,20,5,15,14,6,6,10.0101804302054,9.85114107216392,0.351733250463846,31
"1429","MA","São Vicente Ferrer",22350,6201.44,21005,"Baixada Maranhense",2,"Nordeste",0,"211170",2,15,2,13,10,5,0,0,0,0,0,15,2,13,10,5,3,8.73253680212997,10.0145816000417,0.301040857759073,29
"1430","MA","São Vicente Ferrer",22350,6201.44,21005,"Baixada Maranhense",2,"Nordeste",0,"211170",3,16,4,12,9,7,1,1,0,0,1,17,5,12,9,8,11,8.73253680212997,10.0145816000417,0.364660995929086,31
"1431","MA","São Vicente Ferrer",22350,6201.44,21005,"Baixada Maranhense",2,"Nordeste",0,"211170",4,13,3,10,8,5,1,1,0,1,0,14,4,10,9,5,8,8.73253680212997,10.0145816000417,0.390993194910276,30
"1432","MA","São Vicente Ferrer",22350,6201.44,21005,"Baixada Maranhense",2,"Nordeste",0,"211170",5,18,6,12,12,6,0,0,0,0,0,18,6,12,12,6,12,8.73253680212997,10.0145816000417,0.429548873893425,31
"1433","MA","Senador La Rocque",14050,10120.64,21009,"Imperatriz",2,"Nordeste",0,"211176",2,4,1,3,2,2,0,0,0,0,0,4,1,3,2,2,7,9.22233218194854,9.55037767476189,0.326035570114315,29
"1434","MA","Senador La Rocque",14050,10120.64,21009,"Imperatriz",2,"Nordeste",0,"211176",3,1,0,1,1,0,0,0,0,0,0,1,0,1,1,0,6,9.22233218194854,9.55037767476189,0.422090160895004,31
"1435","MA","Senador La Rocque",14050,10120.64,21009,"Imperatriz",2,"Nordeste",0,"211176",4,3,0,3,1,2,0,0,0,0,0,3,0,3,1,2,13,9.22233218194854,9.55037767476189,0.456374681190773,30
"1436","MA","Senador La Rocque",14050,10120.64,21009,"Imperatriz",2,"Nordeste",0,"211176",5,3,0,3,0,3,0,0,0,0,0,3,0,3,0,3,22,9.22233218194854,9.55037767476189,0.464379611970563,31
"1437","MA","Sítio Novo",18160,8476.85,21011,"Alto Mearim e Grajaú",2,"Nordeste",0,"211180",2,11,5,6,4,7,0,0,0,0,0,11,5,6,4,7,8,9.0450941975126,9.80697665215529,0.300183061740373,29
"1438","MA","Sítio Novo",18160,8476.85,21011,"Alto Mearim e Grajaú",2,"Nordeste",0,"211180",3,16,5,11,12,4,1,0,1,0,1,17,5,12,12,5,8,9.0450941975126,9.80697665215529,0.376442294475863,31
"1439","MA","Sítio Novo",18160,8476.85,21011,"Alto Mearim e Grajaú",2,"Nordeste",0,"211180",4,15,5,10,6,9,1,0,1,1,0,16,5,11,7,9,4,9.0450941975126,9.80697665215529,0.410192259436005,30
"1440","MA","Sítio Novo",18160,8476.85,21011,"Alto Mearim e Grajaú",2,"Nordeste",0,"211180",5,16,5,11,8,8,0,0,0,0,0,16,5,11,8,8,5,9.0450941975126,9.80697665215529,0.473602479256601,31
"1441","MA","Timbiras",29183,5776.82,21015,"Codó",2,"Nordeste",0,"211210",2,25,13,12,13,12,1,1,0,0,1,26,14,12,13,13,9,8.66160863725534,10.2813416269361,0.312703598066626,29
"1442","MA","Timbiras",29183,5776.82,21015,"Codó",2,"Nordeste",0,"211210",3,40,16,24,19,21,0,0,0,0,0,40,16,24,19,21,11,8.66160863725534,10.2813416269361,0.416119893839639,31
"1443","MA","Timbiras",29183,5776.82,21015,"Codó",2,"Nordeste",0,"211210",4,31,15,16,20,11,0,0,0,0,0,31,15,16,20,11,6,8.66160863725534,10.2813416269361,0.43376195186499,30
"1444","MA","Timbiras",29183,5776.82,21015,"Codó",2,"Nordeste",0,"211210",5,27,13,14,18,9,2,2,0,2,0,29,15,14,20,9,23,8.66160863725534,10.2813416269361,0.492330337430404,31
"1445","MA","Timon",170222,11120.68,21017,"Caxias",2,"Nordeste",1,"211220",2,205,50,155,100,105,2,2,0,0,2,207,52,155,100,107,69,9.31656171701406,12.0448587464626,0.288655868483829,29
"1446","MA","Timon",170222,11120.68,21017,"Caxias",2,"Nordeste",1,"211220",3,258,80,178,127,131,2,0,2,0,2,260,80,180,127,133,122,9.31656171701406,12.0448587464626,0.401952410194251,31
"1447","MA","Timon",170222,11120.68,21017,"Caxias",2,"Nordeste",1,"211220",4,196,59,137,85,111,5,1,4,2,3,201,60,141,87,114,99,9.31656171701406,12.0448587464626,0.464583175639414,30
"1448","MA","Timon",170222,11120.68,21017,"Caxias",2,"Nordeste",1,"211220",5,218,53,165,110,108,0,0,0,0,0,218,53,165,110,108,119,9.31656171701406,12.0448587464626,0.459986671746255,31
"1449","MA","Trizidela do Vale",22112,12874.46,21010,"Médio Mearim",2,"Nordeste",1,"211223",2,21,4,17,15,6,0,0,0,0,0,21,4,17,15,6,8,9.46300078290478,10.0038757265674,0.274958745230405,29
"1450","MA","Trizidela do Vale",22112,12874.46,21010,"Médio Mearim",2,"Nordeste",1,"211223",3,26,6,20,10,16,1,0,1,0,1,27,6,21,10,17,19,9.46300078290478,10.0038757265674,0.369087366517314,31
"1451","MA","Trizidela do Vale",22112,12874.46,21010,"Médio Mearim",2,"Nordeste",1,"211223",4,21,6,15,13,8,0,0,0,0,0,21,6,15,13,8,17,9.46300078290478,10.0038757265674,0.38043818404515,30
"1452","MA","Trizidela do Vale",22112,12874.46,21010,"Médio Mearim",2,"Nordeste",1,"211223",5,21,2,19,10,11,0,0,0,0,0,21,2,19,10,11,44,9.46300078290478,10.0038757265674,0.418026042950078,31
"1453","MA","Tuntum",42040,7528.18,21011,"Alto Mearim e Grajaú",2,"Nordeste",0,"211230",2,40,14,26,21,19,0,0,0,0,0,40,14,26,21,19,12,8.92640859171262,10.6463768249909,0.296070572152353,29
"1454","MA","Tuntum",42040,7528.18,21011,"Alto Mearim e Grajaú",2,"Nordeste",0,"211230",3,35,17,18,17,18,0,0,0,0,0,35,17,18,17,18,14,8.92640859171262,10.6463768249909,0.38436098413075,31
"1455","MA","Tuntum",42040,7528.18,21011,"Alto Mearim e Grajaú",2,"Nordeste",0,"211230",4,30,6,24,14,16,0,0,0,0,0,30,6,24,14,16,13,8.92640859171262,10.6463768249909,0.392149248274857,30
"1456","MA","Tuntum",42040,7528.18,21011,"Alto Mearim e Grajaú",2,"Nordeste",0,"211230",5,33,16,17,18,15,0,0,0,0,0,33,16,17,18,15,16,8.92640859171262,10.6463768249909,0.427085327964956,31
"1457","MA","Turiaçu",35709,7178.43,21007,"Gurupi",2,"Nordeste",0,"211240",2,57,22,35,32,25,1,0,1,1,0,58,22,36,33,25,4,8.8788359751794,10.483158036836,0.313309631405422,29
"1458","MA","Turiaçu",35709,7178.43,21007,"Gurupi",2,"Nordeste",0,"211240",3,34,15,19,18,16,0,0,0,0,0,34,15,19,18,16,14,8.8788359751794,10.483158036836,0.397024014192505,31
"1459","MA","Turiaçu",35709,7178.43,21007,"Gurupi",2,"Nordeste",0,"211240",4,37,17,20,18,19,0,0,0,0,0,37,17,20,18,19,11,8.8788359751794,10.483158036836,0.451186558665042,30
"1460","MA","Turiaçu",35709,7178.43,21007,"Gurupi",2,"Nordeste",0,"211240",5,44,25,19,24,20,0,0,0,0,0,44,25,19,24,20,20,8.8788359751794,10.483158036836,0.529700906451366,31
"1461","MA","Turilândia",25868,6267.27,21007,"Gurupi",2,"Nordeste",1,"211245",2,21,12,9,14,7,0,0,0,0,0,21,12,9,14,7,6,8.74309613211138,10.1607619625665,0.325197145709443,29
"1462","MA","Turilândia",25868,6267.27,21007,"Gurupi",2,"Nordeste",1,"211245",3,22,14,8,11,11,1,1,0,1,0,23,15,8,12,11,1,8.74309613211138,10.1607619625665,0.403663105360048,31
"1463","MA","Turilândia",25868,6267.27,21007,"Gurupi",2,"Nordeste",1,"211245",4,21,11,10,12,9,0,0,0,0,0,21,11,10,12,9,9,8.74309613211138,10.1607619625665,0.439252260020981,30
"1464","MA","Turilândia",25868,6267.27,21007,"Gurupi",2,"Nordeste",1,"211245",5,18,9,9,10,8,0,0,0,0,0,18,9,9,10,8,14,8.74309613211138,10.1607619625665,0.479800959113126,31
"1465","MA","Tutóia",59398,7013.35,21004,"Lençóis Maranhenses",2,"Nordeste",0,"211250",2,96,47,49,53,43,0,0,0,0,0,96,47,49,53,43,21,8.85557075460657,10.9920158347502,0.313119811101715,29
"1466","MA","Tutóia",59398,7013.35,21004,"Lençóis Maranhenses",2,"Nordeste",0,"211250",3,67,31,36,33,34,0,0,0,0,0,67,31,36,33,34,25,8.85557075460657,10.9920158347502,0.386069407649613,31
"1467","MA","Tutóia",59398,7013.35,21004,"Lençóis Maranhenses",2,"Nordeste",0,"211250",4,73,26,47,38,35,2,1,1,1,1,75,27,48,39,36,27,8.85557075460657,10.9920158347502,0.420888991077157,30
"1468","MA","Tutóia",59398,7013.35,21004,"Lençóis Maranhenses",2,"Nordeste",0,"211250",5,64,21,43,30,34,0,0,0,0,0,64,21,43,30,34,56,8.85557075460657,10.9920158347502,0.467724770914726,31
"1469","MA","Urbano Santos",33459,5828.91,21014,"Chapadinha",2,"Nordeste",0,"211260",2,53,18,35,28,25,0,0,0,0,0,53,18,35,28,25,8,8.67058529788518,10.4180760876626,0.251749240120308,29
"1470","MA","Urbano Santos",33459,5828.91,21014,"Chapadinha",2,"Nordeste",0,"211260",3,48,17,31,28,20,0,0,0,0,0,48,17,31,28,20,5,8.67058529788518,10.4180760876626,0.32650285439984,31
"1471","MA","Urbano Santos",33459,5828.91,21014,"Chapadinha",2,"Nordeste",0,"211260",4,48,20,28,25,23,0,0,0,0,0,48,20,28,25,23,12,8.67058529788518,10.4180760876626,0.366011310472798,30
"1472","MA","Urbano Santos",33459,5828.91,21014,"Chapadinha",2,"Nordeste",0,"211260",5,45,27,18,29,16,0,0,0,0,0,45,27,18,29,16,15,8.67058529788518,10.4180760876626,0.411268094985869,31
"1473","MA","Vargem Grande",57168,5832.73,21006,"Itapecuru Mirim",2,"Nordeste",0,"211270",2,65,26,39,33,32,1,1,0,1,0,66,27,39,34,32,24,8.67124043732296,10.9537495802632,0.233922838990923,29
"1474","MA","Vargem Grande",57168,5832.73,21006,"Itapecuru Mirim",2,"Nordeste",0,"211270",3,57,26,31,35,22,0,0,0,0,0,57,26,31,35,22,18,8.67124043732296,10.9537495802632,0.303456941351773,31
"1475","MA","Vargem Grande",57168,5832.73,21006,"Itapecuru Mirim",2,"Nordeste",0,"211270",4,54,17,37,34,20,0,0,0,0,0,54,17,37,34,20,16,8.67124043732296,10.9537495802632,0.328744688085202,30
"1476","MA","Vargem Grande",57168,5832.73,21006,"Itapecuru Mirim",2,"Nordeste",0,"211270",5,78,31,47,37,41,0,0,0,0,0,78,31,47,37,41,35,8.67124043732296,10.9537495802632,0.372735755590838,31
"1477","MA","Viana",52649,7895.21,21005,"Baixada Maranhense",2,"Nordeste",0,"211280",2,66,23,43,42,24,0,0,0,0,0,66,23,43,42,24,28,8.97401152544936,10.8714025240294,0.259359743411512,29
"1478","MA","Viana",52649,7895.21,21005,"Baixada Maranhense",2,"Nordeste",0,"211280",3,65,25,40,40,25,0,0,0,0,0,65,25,40,40,25,25,8.97401152544936,10.8714025240294,0.31626318789054,31
"1479","MA","Viana",52649,7895.21,21005,"Baixada Maranhense",2,"Nordeste",0,"211280",4,62,18,44,37,25,0,0,0,0,0,62,18,44,37,25,33,8.97401152544936,10.8714025240294,0.344427812709526,30
"1480","MA","Viana",52649,7895.21,21005,"Baixada Maranhense",2,"Nordeste",0,"211280",5,60,16,44,29,31,0,0,0,0,0,60,16,44,29,31,54,8.97401152544936,10.8714025240294,0.392758435399387,31
"1481","MA","Vitória do Mearim",32861,7892.92,21005,"Baixada Maranhense",2,"Nordeste",0,"211290",2,11,4,7,8,3,0,0,0,0,0,11,4,7,8,3,14,8.97372143409388,10.4000418232645,0.313949092890762,29
"1482","MA","Vitória do Mearim",32861,7892.92,21005,"Baixada Maranhense",2,"Nordeste",0,"211290",3,16,6,10,6,10,1,0,1,1,0,17,6,11,7,10,21,8.97372143409388,10.4000418232645,0.391668136570989,31
"1483","MA","Vitória do Mearim",32861,7892.92,21005,"Baixada Maranhense",2,"Nordeste",0,"211290",4,10,2,8,5,5,0,0,0,0,0,10,2,8,5,5,19,8.97372143409388,10.4000418232645,0.427404843790164,30
"1484","MA","Vitória do Mearim",32861,7892.92,21005,"Baixada Maranhense",2,"Nordeste",0,"211290",5,10,3,7,2,8,0,0,0,0,0,10,3,7,2,8,28,8.97372143409388,10.4000418232645,0.427789923969589,31
"1485","MA","Vitorino Freire",31522,8154.74,21008,"Pindaré",2,"Nordeste",0,"211300",2,29,7,22,17,12,0,0,0,0,0,29,7,22,17,12,17,9.00635463226605,10.3584409937355,0.31097025528105,29
"1486","MA","Vitorino Freire",31522,8154.74,21008,"Pindaré",2,"Nordeste",0,"211300",3,48,15,33,24,24,0,0,0,0,0,48,15,33,24,24,19,9.00635463226605,10.3584409937355,0.396888036915103,31
"1487","MA","Vitorino Freire",31522,8154.74,21008,"Pindaré",2,"Nordeste",0,"211300",4,31,12,19,18,13,1,0,1,0,1,32,12,20,18,14,9,9.00635463226605,10.3584409937355,0.423063514785716,30
"1488","MA","Vitorino Freire",31522,8154.74,21008,"Pindaré",2,"Nordeste",0,"211300",5,35,13,22,14,21,1,1,0,0,1,36,14,22,14,22,17,9.00635463226605,10.3584409937355,0.437987312611552,31
"1489","MA","Zé Doca",51956,8429.4,21008,"Pindaré",2,"Nordeste",1,"211400",2,52,23,29,34,18,0,0,0,0,0,52,23,29,34,18,14,9.03948087408566,10.8581524855272,0.279881388867383,29
"1490","MA","Zé Doca",51956,8429.4,21008,"Pindaré",2,"Nordeste",1,"211400",3,45,17,28,28,17,0,0,0,0,0,45,17,28,28,17,30,9.03948087408566,10.8581524855272,0.373285614947265,31
"1491","MA","Zé Doca",51956,8429.4,21008,"Pindaré",2,"Nordeste",1,"211400",4,51,20,31,28,23,0,0,0,0,0,51,20,31,28,23,20,9.03948087408566,10.8581524855272,0.389346452917251,30
"1492","MA","Zé Doca",51956,8429.4,21008,"Pindaré",2,"Nordeste",1,"211400",5,62,22,40,41,21,1,1,0,1,0,63,23,40,42,21,38,9.03948087408566,10.8581524855272,0.429193276181414,31
"1493","PI","Água Branca",17470,11560.54,22005,"Médio Parnaíba Piauiense",2,"Nordeste",1,"220020",2,10,3,7,3,7,0,0,0,0,0,10,3,7,3,7,11,9.35535285393813,9.7682404031281,0.24351585422366,29
"1494","PI","Água Branca",17470,11560.54,22005,"Médio Parnaíba Piauiense",2,"Nordeste",1,"220020",3,12,4,8,5,7,0,0,0,0,0,12,4,8,5,7,10,9.35535285393813,9.7682404031281,0.328428888223874,31
"1495","PI","Água Branca",17470,11560.54,22005,"Médio Parnaíba Piauiense",2,"Nordeste",1,"220020",4,12,1,11,6,6,0,0,0,0,0,12,1,11,6,6,6,9.35535285393813,9.7682404031281,0.365668392700164,30
"1496","PI","Água Branca",17470,11560.54,22005,"Médio Parnaíba Piauiense",2,"Nordeste",1,"220020",5,17,5,12,7,10,0,0,0,0,0,17,5,12,7,10,16,9.35535285393813,9.7682404031281,0.392189986457383,31
"1497","PI","Alto Longá",14339,7050.48,22004,"Campo Maior",2,"Nordeste",0,"220030",2,6,3,3,2,4,0,0,0,0,0,6,3,3,2,4,7,8.86085097859501,9.57073837671504,0.281379453334141,29
"1498","PI","Alto Longá",14339,7050.48,22004,"Campo Maior",2,"Nordeste",0,"220030",3,6,2,4,2,4,0,0,0,0,0,6,2,4,2,4,10,8.86085097859501,9.57073837671504,0.348087647614784,31
"1499","PI","Alto Longá",14339,7050.48,22004,"Campo Maior",2,"Nordeste",0,"220030",4,4,3,1,3,1,0,0,0,0,0,4,3,1,3,1,10,8.86085097859501,9.57073837671504,0.409378638870375,30
"1500","PI","Alto Longá",14339,7050.48,22004,"Campo Maior",2,"Nordeste",0,"220030",5,9,2,7,3,6,0,0,0,0,0,9,2,7,3,6,11,8.86085097859501,9.57073837671504,0.459746147587761,31
"1501","PI","Altos",40605,10361.22,22003,"Teresina",2,"Nordeste",1,"220040",2,43,13,30,18,25,0,0,0,0,0,43,13,30,18,25,15,9.245825269498,10.6116464907165,0.265216342485376,29
"1502","PI","Altos",40605,10361.22,22003,"Teresina",2,"Nordeste",1,"220040",3,50,18,32,24,26,1,0,1,1,0,51,18,33,25,26,24,9.245825269498,10.6116464907165,0.356567448227413,31
"1503","PI","Altos",40605,10361.22,22003,"Teresina",2,"Nordeste",1,"220040",4,30,7,23,13,17,0,0,0,0,0,30,7,23,13,17,25,9.245825269498,10.6116464907165,0.424609039689084,30
"1504","PI","Altos",40605,10361.22,22003,"Teresina",2,"Nordeste",1,"220040",5,41,11,30,19,22,1,1,0,0,1,42,12,30,19,23,26,9.245825269498,10.6116464907165,0.422465440386088,31
"1505","PI","Amarante",17604,8206.67,22005,"Médio Parnaíba Piauiense",2,"Nordeste",0,"220050",2,15,5,10,6,9,1,1,0,1,0,16,6,10,7,9,13,9.0127025172441,9.77588142793098,0.276195290565942,29
"1506","PI","Amarante",17604,8206.67,22005,"Médio Parnaíba Piauiense",2,"Nordeste",0,"220050",3,14,4,10,10,4,0,0,0,0,0,14,4,10,10,4,11,9.0127025172441,9.77588142793098,0.35481102253363,31
"1507","PI","Amarante",17604,8206.67,22005,"Médio Parnaíba Piauiense",2,"Nordeste",0,"220050",4,17,6,11,8,9,0,0,0,0,0,17,6,11,8,9,10,9.0127025172441,9.77588142793098,0.402915243127489,30
"1508","PI","Amarante",17604,8206.67,22005,"Médio Parnaíba Piauiense",2,"Nordeste",0,"220050",5,25,7,18,6,19,1,1,0,0,1,26,8,18,6,20,8,9.0127025172441,9.77588142793098,0.411612843184899,31
"1509","PI","Angical do Piauí",6783,9428.55,22005,"Médio Parnaíba Piauiense",2,"Nordeste",0,"220060",2,4,2,2,4,0,0,0,0,0,0,4,2,2,4,0,4,9.15149759922339,8.82217476094608,0.274689255860728,29
"1510","PI","Angical do Piauí",6783,9428.55,22005,"Médio Parnaíba Piauiense",2,"Nordeste",0,"220060",3,3,2,1,0,3,0,0,0,0,0,3,2,1,0,3,6,9.15149759922339,8.82217476094608,0.394670860968423,31
"1511","PI","Angical do Piauí",6783,9428.55,22005,"Médio Parnaíba Piauiense",2,"Nordeste",0,"220060",4,8,3,5,2,6,0,0,0,0,0,8,3,5,2,6,5,9.15149759922339,8.82217476094608,0.422916444783009,30
"1512","PI","Angical do Piauí",6783,9428.55,22005,"Médio Parnaíba Piauiense",2,"Nordeste",0,"220060",5,5,2,3,2,3,0,0,0,0,0,5,2,3,2,3,2,9.15149759922339,8.82217476094608,0.424497553617341,31
"1513","PI","Assunção do Piauí",7863,7099.72,22004,"Campo Maior",2,"Nordeste",0,"220105",2,4,3,1,1,3,0,0,0,0,0,4,3,1,1,3,4,8.86781062563204,8.96992349199152,0.276075329979589,29
"1514","PI","Assunção do Piauí",7863,7099.72,22004,"Campo Maior",2,"Nordeste",0,"220105",3,4,3,1,3,1,0,0,0,0,0,4,3,1,3,1,2,8.86781062563204,8.96992349199152,0.361059844647413,31
"1515","PI","Assunção do Piauí",7863,7099.72,22004,"Campo Maior",2,"Nordeste",0,"220105",4,9,3,6,1,8,0,0,0,0,0,9,3,6,1,8,5,8.86781062563204,8.96992349199152,0.383670225408073,30
"1516","PI","Assunção do Piauí",7863,7099.72,22004,"Campo Maior",2,"Nordeste",0,"220105",5,10,3,7,5,5,0,0,0,0,0,10,3,7,5,5,3,8.86781062563204,8.96992349199152,0.356793109992502,31
"1517","PI","Baixa Grande do Ribeiro",11671,82913.59,22007,"Alto Parnaíba Piauiense",2,"Nordeste",0,"220115",2,17,5,12,11,6,0,0,0,0,0,17,5,12,11,6,6,11.3255542601367,9.36486241141235,0.295336459307247,29
"1518","PI","Baixa Grande do Ribeiro",11671,82913.59,22007,"Alto Parnaíba Piauiense",2,"Nordeste",0,"220115",3,19,5,14,9,10,0,0,0,0,0,19,5,14,9,10,7,11.3255542601367,9.36486241141235,0.342486387319809,31
"1519","PI","Baixa Grande do Ribeiro",11671,82913.59,22007,"Alto Parnaíba Piauiense",2,"Nordeste",0,"220115",4,17,6,11,10,7,0,0,0,0,0,17,6,11,10,7,6,11.3255542601367,9.36486241141235,0.357854576387094,30
"1520","PI","Baixa Grande do Ribeiro",11671,82913.59,22007,"Alto Parnaíba Piauiense",2,"Nordeste",0,"220115",5,16,7,9,8,8,1,1,0,0,1,17,8,9,8,9,4,11.3255542601367,9.36486241141235,0.391065184903256,31
"1521","PI","Barras",47185,8412,22001,"Baixo Parnaíba Piauiense",2,"Nordeste",0,"220120",2,51,17,34,24,27,0,0,0,0,0,51,17,34,24,27,24,9.03741453682259,10.7618313244554,0.26369562470749,29
"1522","PI","Barras",47185,8412,22001,"Baixo Parnaíba Piauiense",2,"Nordeste",0,"220120",3,42,14,28,21,21,0,0,0,0,0,42,14,28,21,21,25,9.03741453682259,10.7618313244554,0.354846627232533,31
"1523","PI","Barras",47185,8412,22001,"Baixo Parnaíba Piauiense",2,"Nordeste",0,"220120",4,47,22,25,23,24,0,0,0,0,0,47,22,25,23,24,15,9.03741453682259,10.7618313244554,0.422027939023659,30
"1524","PI","Barras",47185,8412,22001,"Baixo Parnaíba Piauiense",2,"Nordeste",0,"220120",5,63,14,49,32,31,0,0,0,0,0,63,14,49,32,31,29,9.03741453682259,10.7618313244554,0.451374736912961,31
"1525","PI","Batalha",26905,7161.96,22001,"Baixo Parnaíba Piauiense",2,"Nordeste",0,"220150",2,18,8,10,9,9,0,0,0,0,0,18,8,10,9,9,8,8.87653896551067,10.2000674219235,0.26975554202158,29
"1526","PI","Batalha",26905,7161.96,22001,"Baixo Parnaíba Piauiense",2,"Nordeste",0,"220150",3,18,5,13,5,13,1,0,1,1,0,19,5,14,6,13,18,8.87653896551067,10.2000674219235,0.357159649437629,31
"1527","PI","Batalha",26905,7161.96,22001,"Baixo Parnaíba Piauiense",2,"Nordeste",0,"220150",4,25,10,15,17,8,1,1,0,0,1,26,11,15,17,9,17,8.87653896551067,10.2000674219235,0.389206275737116,30
"1528","PI","Batalha",26905,7161.96,22001,"Baixo Parnaíba Piauiense",2,"Nordeste",0,"220150",5,25,9,16,9,16,0,0,0,0,0,25,9,16,9,16,21,8.87653896551067,10.2000674219235,0.446559301374146,31
"1529","PI","Beneditinos",10473,7260.24,22003,"Teresina",2,"Nordeste",0,"220160",2,10,4,6,4,6,0,0,0,0,0,10,4,6,4,6,0,8.89016816512368,9.25655579577315,0.283851029802913,29
"1530","PI","Beneditinos",10473,7260.24,22003,"Teresina",2,"Nordeste",0,"220160",3,3,0,3,1,2,0,0,0,0,0,3,0,3,1,2,7,8.89016816512368,9.25655579577315,0.35642335619742,31
"1531","PI","Beneditinos",10473,7260.24,22003,"Teresina",2,"Nordeste",0,"220160",4,11,5,6,5,6,0,0,0,0,0,11,5,6,5,6,10,8.89016816512368,9.25655579577315,0.387908244386456,30
"1532","PI","Beneditinos",10473,7260.24,22003,"Teresina",2,"Nordeste",0,"220160",5,8,4,4,6,2,0,0,0,0,0,8,4,4,6,2,3,8.89016816512368,9.25655579577315,0.380874429762066,31
"1533","PI","Bom Jesus",25387,36392.02,22010,"Alto Médio Gurguéia",2,"Nordeste",1,"220190",2,42,14,28,25,17,1,1,0,0,1,43,15,28,25,18,7,10.502104798821,10.141992510963,0.233457110153727,29
"1534","PI","Bom Jesus",25387,36392.02,22010,"Alto Médio Gurguéia",2,"Nordeste",1,"220190",3,48,16,32,22,26,0,0,0,0,0,48,16,32,22,26,9,10.502104798821,10.141992510963,0.322683682268518,31
"1535","PI","Bom Jesus",25387,36392.02,22010,"Alto Médio Gurguéia",2,"Nordeste",1,"220190",4,44,18,26,18,26,0,0,0,0,0,44,18,26,18,26,7,10.502104798821,10.141992510963,0.355504819479994,30
"1536","PI","Bom Jesus",25387,36392.02,22010,"Alto Médio Gurguéia",2,"Nordeste",1,"220190",5,21,7,14,12,9,1,0,1,1,0,22,7,15,13,9,6,10.502104798821,10.141992510963,0.37605932118899,31
"1537","PI","Brasileira",8347,6752.32,22001,"Baixo Parnaíba Piauiense",2,"Nordeste",0,"220196",2,3,1,2,1,2,0,0,0,0,0,3,1,2,1,2,5,8.81764142851769,9.02965747185074,0.343287350135519,29
"1538","PI","Brasileira",8347,6752.32,22001,"Baixo Parnaíba Piauiense",2,"Nordeste",0,"220196",3,9,5,4,3,6,0,0,0,0,0,9,5,4,3,6,4,8.81764142851769,9.02965747185074,0.454193088790645,31
"1539","PI","Brasileira",8347,6752.32,22001,"Baixo Parnaíba Piauiense",2,"Nordeste",0,"220196",4,5,0,5,2,3,0,0,0,0,0,5,0,5,2,3,3,8.81764142851769,9.02965747185074,0.508701157490704,30
"1540","PI","Brasileira",8347,6752.32,22001,"Baixo Parnaíba Piauiense",2,"Nordeste",0,"220196",5,2,1,1,1,1,0,0,0,0,0,2,1,1,1,1,1,8.81764142851769,9.02965747185074,0.522850690465538,31
"1541","PI","Buriti dos Lopes",19807,8822.34,22002,"Litoral Piauiense",2,"Nordeste",0,"220200",2,29,14,15,16,13,1,1,0,1,0,30,15,15,17,13,15,9.08504241993584,9.89379068955726,0.317592278663561,29
"1542","PI","Buriti dos Lopes",19807,8822.34,22002,"Litoral Piauiense",2,"Nordeste",0,"220200",3,19,12,7,11,8,2,1,1,2,0,21,13,8,13,8,17,9.08504241993584,9.89379068955726,0.396164563731938,31
"1543","PI","Buriti dos Lopes",19807,8822.34,22002,"Litoral Piauiense",2,"Nordeste",0,"220200",4,20,7,13,12,8,0,0,0,0,0,20,7,13,12,8,14,9.08504241993584,9.89379068955726,0.429870086675998,30
"1544","PI","Buriti dos Lopes",19807,8822.34,22002,"Litoral Piauiense",2,"Nordeste",0,"220200",5,23,12,11,16,7,0,0,0,0,0,23,12,11,16,7,8,9.08504241993584,9.89379068955726,0.434604107113554,31
"1545","PI","Buriti dos Montes",8264,6978.01,22004,"Campo Maior",2,"Nordeste",0,"220202",2,2,1,1,0,2,0,0,0,0,0,2,1,1,0,2,6,8.85051905482107,9.01966401079947,0.31330230005972,29
"1546","PI","Buriti dos Montes",8264,6978.01,22004,"Campo Maior",2,"Nordeste",0,"220202",3,0,0,0,0,0,0,0,0,0,0,0,0,0,0,0,2,8.85051905482107,9.01966401079947,0.41498410643908,31
"1547","PI","Buriti dos Montes",8264,6978.01,22004,"Campo Maior",2,"Nordeste",0,"220202",4,3,1,2,1,2,0,0,0,0,0,3,1,2,1,2,0,8.85051905482107,9.01966401079947,0.43781894519937,30
"1548","PI","Buriti dos Montes",8264,6978.01,22004,"Campo Maior",2,"Nordeste",0,"220202",5,7,1,6,1,6,0,0,0,0,0,7,1,6,1,6,2,8.85051905482107,9.01966401079947,0.464794289057591,31
"1549","PI","Cajueiro da Praia",7674,10776.62,22002,"Litoral Piauiense",2,"Nordeste",0,"220208",2,10,4,6,7,3,0,0,0,0,0,10,4,6,7,3,5,9.28513425169866,8.9455932708069,0.336677939212111,29
"1550","PI","Cajueiro da Praia",7674,10776.62,22002,"Litoral Piauiense",2,"Nordeste",0,"220208",3,3,2,1,1,2,0,0,0,0,0,3,2,1,1,2,2,9.28513425169866,8.9455932708069,0.450784777159471,31
"1551","PI","Cajueiro da Praia",7674,10776.62,22002,"Litoral Piauiense",2,"Nordeste",0,"220208",4,11,7,4,8,3,0,0,0,0,0,11,7,4,8,3,2,9.28513425169866,8.9455932708069,0.485079993796139,30
"1552","PI","Cajueiro da Praia",7674,10776.62,22002,"Litoral Piauiense",2,"Nordeste",0,"220208",5,8,3,5,3,5,0,0,0,0,0,8,3,5,3,5,1,9.28513425169866,8.9455932708069,0.508401951835951,31
"1553","PI","Campo Maior",46893,13062.7,22004,"Campo Maior",2,"Nordeste",1,"220220",2,43,9,34,22,21,0,0,0,0,0,43,9,34,22,21,22,9.47751611959474,10.7556236895636,0.259079493257864,29
"1554","PI","Campo Maior",46893,13062.7,22004,"Campo Maior",2,"Nordeste",1,"220220",3,40,8,32,18,22,1,0,1,0,1,41,8,33,18,23,41,9.47751611959474,10.7556236895636,0.361453320719722,31
"1555","PI","Campo Maior",46893,13062.7,22004,"Campo Maior",2,"Nordeste",1,"220220",4,37,7,30,13,24,0,0,0,0,0,37,7,30,13,24,34,9.47751611959474,10.7556236895636,0.4091631757215,30
"1556","PI","Campo Maior",46893,13062.7,22004,"Campo Maior",2,"Nordeste",1,"220220",5,38,6,32,14,24,1,1,0,0,1,39,7,32,14,25,35,9.47751611959474,10.7556236895636,0.403399107151643,31
"1557","PI","Canto do Buriti",21258,10520.05,22011,"São Raimundo Nonato",2,"Nordeste",0,"220230",2,27,8,19,16,11,0,0,0,0,0,27,8,19,16,11,6,9.26103823913212,9.96448857409353,0.2589176504102,29
"1558","PI","Canto do Buriti",21258,10520.05,22011,"São Raimundo Nonato",2,"Nordeste",0,"220230",3,16,7,9,6,10,0,0,0,0,0,16,7,9,6,10,17,9.26103823913212,9.96448857409353,0.358319889885996,31
"1559","PI","Canto do Buriti",21258,10520.05,22011,"São Raimundo Nonato",2,"Nordeste",0,"220230",4,18,7,11,7,11,0,0,0,0,0,18,7,11,7,11,11,9.26103823913212,9.96448857409353,0.383962985554635,30
"1560","PI","Canto do Buriti",21258,10520.05,22011,"São Raimundo Nonato",2,"Nordeste",0,"220230",5,16,9,7,9,7,0,0,0,0,0,16,9,7,9,7,11,9.26103823913212,9.96448857409353,0.372494815206053,31
"1561","PI","Capitão de Campos",11445,8130.92,22004,"Campo Maior",2,"Nordeste",0,"220240",2,11,3,8,6,5,0,0,0,0,0,11,3,8,6,5,7,9.00342935727123,9.34530823238667,0.286452708744574,29
"1562","PI","Capitão de Campos",11445,8130.92,22004,"Campo Maior",2,"Nordeste",0,"220240",3,13,6,7,3,10,0,0,0,0,0,13,6,7,3,10,6,9.00342935727123,9.34530823238667,0.414013024922973,31
"1563","PI","Capitão de Campos",11445,8130.92,22004,"Campo Maior",2,"Nordeste",0,"220240",4,15,5,10,6,9,0,0,0,0,0,15,5,10,6,9,6,9.00342935727123,9.34530823238667,0.433432979018297,30
"1564","PI","Capitão de Campos",11445,8130.92,22004,"Campo Maior",2,"Nordeste",0,"220240",5,12,5,7,6,6,0,0,0,0,0,12,5,7,6,6,7,9.00342935727123,9.34530823238667,0.446992574059551,31
"1565","PI","Castelo do Piauí",19715,8915.5,22004,"Campo Maior",2,"Nordeste",0,"220260",2,18,7,11,7,11,0,0,0,0,0,18,7,11,7,11,12,9.0955466139741,9.88913504631173,0.27532026161316,29
"1566","PI","Castelo do Piauí",19715,8915.5,22004,"Campo Maior",2,"Nordeste",0,"220260",3,16,7,9,9,7,0,0,0,0,0,16,7,9,9,7,11,9.0955466139741,9.88913504631173,0.393221020392483,31
"1567","PI","Castelo do Piauí",19715,8915.5,22004,"Campo Maior",2,"Nordeste",0,"220260",4,15,7,8,8,7,0,0,0,0,0,15,7,8,8,7,10,9.0955466139741,9.88913504631173,0.425916888496462,30
"1568","PI","Castelo do Piauí",19715,8915.5,22004,"Campo Maior",2,"Nordeste",0,"220260",5,20,5,15,7,13,0,0,0,0,0,20,5,15,7,13,9,9.0955466139741,9.88913504631173,0.415599838729376,31
"1569","PI","Cocal",27845,7999.27,22002,"Litoral Piauiense",2,"Nordeste",0,"220270",2,43,22,21,15,28,0,0,0,0,0,43,22,21,15,28,12,8.98710556649844,10.2344086960238,0.324969238697229,29
"1570","PI","Cocal",27845,7999.27,22002,"Litoral Piauiense",2,"Nordeste",0,"220270",3,35,23,12,15,20,0,0,0,0,0,35,23,12,15,20,13,8.98710556649844,10.2344086960238,0.442882528982292,31
"1571","PI","Cocal",27845,7999.27,22002,"Litoral Piauiense",2,"Nordeste",0,"220270",4,31,16,15,12,19,0,0,0,0,0,31,16,15,12,19,15,8.98710556649844,10.2344086960238,0.478661732779147,30
"1572","PI","Cocal",27845,7999.27,22002,"Litoral Piauiense",2,"Nordeste",0,"220270",5,37,17,20,19,18,1,0,1,1,0,38,17,21,20,18,15,8.98710556649844,10.2344086960238,0.454472639663232,31
"1573","PI","Corrente",26709,17079.37,22012,"Chapadas do Extremo Sul Piauiense",2,"Nordeste",0,"220290",2,45,16,29,18,27,1,0,1,0,1,46,16,30,18,28,13,9.74562658141638,10.1927558662418,0.249965378527559,29
"1574","PI","Corrente",26709,17079.37,22012,"Chapadas do Extremo Sul Piauiense",2,"Nordeste",0,"220290",3,26,6,20,13,13,1,1,0,1,0,27,7,20,14,13,10,9.74562658141638,10.1927558662418,0.32776289072212,31
"1575","PI","Corrente",26709,17079.37,22012,"Chapadas do Extremo Sul Piauiense",2,"Nordeste",0,"220290",4,29,9,20,15,14,0,0,0,0,0,29,9,20,15,14,22,9.74562658141638,10.1927558662418,0.350461673345548,30
"1576","PI","Corrente",26709,17079.37,22012,"Chapadas do Extremo Sul Piauiense",2,"Nordeste",0,"220290",5,40,18,22,23,17,1,1,0,0,1,41,19,22,23,18,16,9.74562658141638,10.1927558662418,0.361837779345765,31
"1577","PI","Cristino Castro",10444,9800.11,22010,"Alto Médio Gurguéia",2,"Nordeste",0,"220310",2,15,5,10,7,8,0,0,0,0,0,15,5,10,7,8,7,9.19014888908547,9.25378292981902,0.257758129160172,29
"1578","PI","Cristino Castro",10444,9800.11,22010,"Alto Médio Gurguéia",2,"Nordeste",0,"220310",3,12,4,8,8,4,0,0,0,0,0,12,4,8,8,4,6,9.19014888908547,9.25378292981902,0.349398920580926,31
"1579","PI","Cristino Castro",10444,9800.11,22010,"Alto Médio Gurguéia",2,"Nordeste",0,"220310",4,11,3,8,3,8,0,0,0,0,0,11,3,8,3,8,5,9.19014888908547,9.25378292981902,0.351848115455379,30
"1580","PI","Cristino Castro",10444,9800.11,22010,"Alto Médio Gurguéia",2,"Nordeste",0,"220310",5,10,6,4,5,5,0,0,0,0,0,10,6,4,5,5,7,9.19014888908547,9.25378292981902,0.372043757751037,31
"1581","PI","Curimatá",11426,8990.73,22012,"Chapadas do Extremo Sul Piauiense",2,"Nordeste",0,"220320",2,8,1,7,2,6,0,0,0,0,0,8,1,7,2,6,5,9.10394932550383,9.34364673928441,0.269248272930885,29
"1582","PI","Curimatá",11426,8990.73,22012,"Chapadas do Extremo Sul Piauiense",2,"Nordeste",0,"220320",3,13,8,5,5,8,0,0,0,0,0,13,8,5,5,8,8,9.10394932550383,9.34364673928441,0.355091642385329,31
"1583","PI","Curimatá",11426,8990.73,22012,"Chapadas do Extremo Sul Piauiense",2,"Nordeste",0,"220320",4,12,6,6,6,6,0,0,0,0,0,12,6,6,6,6,5,9.10394932550383,9.34364673928441,0.361933935007053,30
"1584","PI","Curimatá",11426,8990.73,22012,"Chapadas do Extremo Sul Piauiense",2,"Nordeste",0,"220320",5,22,10,12,9,13,0,0,0,0,0,22,10,12,9,13,1,9.10394932550383,9.34364673928441,0.350797961462903,31
"1585","PI","Demerval Lobão",13840,12246.6,22003,"Teresina",2,"Nordeste",0,"220330",2,7,2,5,4,3,0,0,0,0,0,7,2,5,4,3,10,9.41300362642805,9.53531822917166,0.279587077126274,29
"1586","PI","Demerval Lobão",13840,12246.6,22003,"Teresina",2,"Nordeste",0,"220330",3,9,4,5,6,3,0,0,0,0,0,9,4,5,6,3,7,9.41300362642805,9.53531822917166,0.368904151654892,31
"1587","PI","Demerval Lobão",13840,12246.6,22003,"Teresina",2,"Nordeste",0,"220330",4,19,6,13,8,11,0,0,0,0,0,19,6,13,8,11,13,9.41300362642805,9.53531822917166,0.427326723047461,30
"1588","PI","Demerval Lobão",13840,12246.6,22003,"Teresina",2,"Nordeste",0,"220330",5,17,8,9,7,10,0,0,0,0,0,17,8,9,7,10,13,9.41300362642805,9.53531822917166,0.430313949185876,31
"1589","PI","Dom Expedito Lopes",6922,10880.85,22013,"Picos",2,"Nordeste",0,"220340",2,4,1,3,2,2,0,0,0,0,0,4,1,3,2,2,5,9.29475964235833,8.84246002419529,0.367842794215381,29
"1590","PI","Dom Expedito Lopes",6922,10880.85,22013,"Picos",2,"Nordeste",0,"220340",3,1,0,1,0,1,0,0,0,0,0,1,0,1,0,1,2,9.29475964235833,8.84246002419529,0.43692658245674,31
"1591","PI","Dom Expedito Lopes",6922,10880.85,22013,"Picos",2,"Nordeste",0,"220340",4,2,1,1,1,1,0,0,0,0,0,2,1,1,1,1,5,9.29475964235833,8.84246002419529,0.472520431620117,30
"1592","PI","Dom Expedito Lopes",6922,10880.85,22013,"Picos",2,"Nordeste",0,"220340",5,0,0,0,0,0,0,0,0,0,0,0,0,0,0,0,2,9.29475964235833,8.84246002419529,0.468940463883816,31
"1593","PI","Elesbão Veloso",14575,9461.37,22006,"Valença do Piauí",2,"Nordeste",0,"220350",2,12,4,8,4,8,0,0,0,0,0,12,4,8,4,8,10,9.15497247185646,9.58706301121869,0.235533585199948,29
"1594","PI","Elesbão Veloso",14575,9461.37,22006,"Valença do Piauí",2,"Nordeste",0,"220350",3,7,1,6,4,3,0,0,0,0,0,7,1,6,4,3,15,9.15497247185646,9.58706301121869,0.312349385577957,31
"1595","PI","Elesbão Veloso",14575,9461.37,22006,"Valença do Piauí",2,"Nordeste",0,"220350",4,10,3,7,1,9,1,0,1,0,1,11,3,8,1,10,9,9.15497247185646,9.58706301121869,0.379541865375674,30
"1596","PI","Elesbão Veloso",14575,9461.37,22006,"Valença do Piauí",2,"Nordeste",0,"220350",5,9,3,6,4,5,0,0,0,0,0,9,3,6,4,5,21,9.15497247185646,9.58706301121869,0.418266312437128,31
"1597","PI","Esperantina",39848,9472.03,22001,"Baixo Parnaíba Piauiense",2,"Nordeste",0,"220370",2,56,24,32,19,37,3,0,3,0,3,59,24,35,19,40,19,9.1560985243485,10.5928274947531,0.290259465027336,29
"1598","PI","Esperantina",39848,9472.03,22001,"Baixo Parnaíba Piauiense",2,"Nordeste",0,"220370",3,59,26,33,26,33,1,1,0,1,0,60,27,33,27,33,20,9.1560985243485,10.5928274947531,0.389492604887398,31
"1599","PI","Esperantina",39848,9472.03,22001,"Baixo Parnaíba Piauiense",2,"Nordeste",0,"220370",4,56,26,30,26,30,1,1,0,1,0,57,27,30,27,30,21,9.1560985243485,10.5928274947531,0.421203719347097,30
"1600","PI","Esperantina",39848,9472.03,22001,"Baixo Parnaíba Piauiense",2,"Nordeste",0,"220370",5,37,16,21,20,17,0,0,0,0,0,37,16,21,20,17,22,9.1560985243485,10.5928274947531,0.440502832092917,31
"1601","PI","Floriano",60025,18465.4,22009,"Floriano",2,"Nordeste",1,"220390",2,81,15,66,26,55,0,0,0,0,0,81,15,66,26,55,35,9.82365398965696,11.0025164210895,0.263193887917761,29
"1602","PI","Floriano",60025,18465.4,22009,"Floriano",2,"Nordeste",1,"220390",3,73,11,62,21,52,0,0,0,0,0,73,11,62,21,52,46,9.82365398965696,11.0025164210895,0.369698446291412,31
"1603","PI","Floriano",60025,18465.4,22009,"Floriano",2,"Nordeste",1,"220390",4,61,11,50,21,40,0,0,0,0,0,61,11,50,21,40,42,9.82365398965696,11.0025164210895,0.44141691548807,30
"1604","PI","Floriano",60025,18465.4,22009,"Floriano",2,"Nordeste",1,"220390",5,78,17,61,26,52,0,0,0,0,0,78,17,61,26,52,42,9.82365398965696,11.0025164210895,0.420538343640894,31
"1605","PI","Fronteiras",11659,8715.75,22015,"Alto Médio Canindé",2,"Nordeste",0,"220430",2,9,5,4,3,6,1,1,0,1,0,10,6,4,4,6,5,9.07288701277109,9.36383369293329,0.300607217076474,29
"1606","PI","Fronteiras",11659,8715.75,22015,"Alto Médio Canindé",2,"Nordeste",0,"220430",3,7,2,5,4,3,1,0,1,1,0,8,2,6,5,3,6,9.07288701277109,9.36383369293329,0.389762512583199,31
"1607","PI","Fronteiras",11659,8715.75,22015,"Alto Médio Canindé",2,"Nordeste",0,"220430",4,6,2,4,2,4,0,0,0,0,0,6,2,4,2,4,7,9.07288701277109,9.36383369293329,0.427629660343205,30
"1608","PI","Fronteiras",11659,8715.75,22015,"Alto Médio Canindé",2,"Nordeste",0,"220430",5,1,0,1,1,0,0,0,0,0,0,1,0,1,1,0,7,9.07288701277109,9.36383369293329,0.440269948358951,31
"1609","PI","Geminiano",5460,8660.45,22013,"Picos",2,"Nordeste",0,"220435",2,10,1,9,2,8,0,0,0,0,0,10,1,9,2,8,3,9.06652196325495,8.60520406873895,0.322369923538597,29
"1610","PI","Geminiano",5460,8660.45,22013,"Picos",2,"Nordeste",0,"220435",3,6,2,4,6,0,0,0,0,0,0,6,2,4,6,0,6,9.06652196325495,8.60520406873895,0.40739787081103,31
"1611","PI","Geminiano",5460,8660.45,22013,"Picos",2,"Nordeste",0,"220435",4,1,1,0,0,1,0,0,0,0,0,1,1,0,0,1,3,9.06652196325495,8.60520406873895,0.40546434318598,30
"1612","PI","Geminiano",5460,8660.45,22013,"Picos",2,"Nordeste",0,"220435",5,0,0,0,0,0,0,0,0,0,0,0,0,0,0,0,1,9.06652196325495,8.60520406873895,0.388064010047362,31
"1613","PI","Gilbués",10694,21181.84,22010,"Alto Médio Gurguéia",2,"Nordeste",0,"220440",2,17,5,12,6,11,1,0,1,1,0,18,5,13,7,11,6,9.96089948979185,9.27743811550868,0.274130621008416,29
"1614","PI","Gilbués",10694,21181.84,22010,"Alto Médio Gurguéia",2,"Nordeste",0,"220440",3,12,6,6,6,6,0,0,0,0,0,12,6,6,6,6,3,9.96089948979185,9.27743811550868,0.320848757171658,31
"1615","PI","Gilbués",10694,21181.84,22010,"Alto Médio Gurguéia",2,"Nordeste",0,"220440",4,8,2,6,4,4,1,0,1,0,1,9,2,7,4,5,1,9.96089948979185,9.27743811550868,0.356495158513551,30
"1616","PI","Gilbués",10694,21181.84,22010,"Alto Médio Gurguéia",2,"Nordeste",0,"220440",5,14,10,4,8,6,1,1,0,1,0,15,11,4,9,6,4,9.96089948979185,9.27743811550868,0.338755409379552,31
"1617","PI","Guadalupe",10497,70596.56,22009,"Floriano",2,"Nordeste",0,"220450",2,11,7,4,6,5,0,0,0,0,0,11,7,4,6,5,5,11.1647366970818,9.2588447810358,0.276908041941162,29
"1618","PI","Guadalupe",10497,70596.56,22009,"Floriano",2,"Nordeste",0,"220450",3,14,5,9,7,7,0,0,0,0,0,14,5,9,7,7,8,11.1647366970818,9.2588447810358,0.355067233499039,31
"1619","PI","Guadalupe",10497,70596.56,22009,"Floriano",2,"Nordeste",0,"220450",4,11,3,8,5,6,0,0,0,0,0,11,3,8,5,6,7,11.1647366970818,9.2588447810358,0.377352340905807,30
"1620","PI","Guadalupe",10497,70596.56,22009,"Floriano",2,"Nordeste",0,"220450",5,13,5,8,7,6,0,0,0,0,0,13,5,8,7,6,3,11.1647366970818,9.2588447810358,0.354929829170115,31
"1621","PI","Inhuma",15319,8959.41,22006,"Valença do Piauí",2,"Nordeste",0,"220470",2,12,2,10,8,4,0,0,0,0,0,12,2,10,8,4,12,9.1004596555866,9.6368491670127,0.264749435474923,29
"1622","PI","Inhuma",15319,8959.41,22006,"Valença do Piauí",2,"Nordeste",0,"220470",3,16,3,13,9,7,1,0,1,1,0,17,3,14,10,7,10,9.1004596555866,9.6368491670127,0.369305030621311,31
"1623","PI","Inhuma",15319,8959.41,22006,"Valença do Piauí",2,"Nordeste",0,"220470",4,11,1,10,2,9,0,0,0,0,0,11,1,10,2,9,5,9.1004596555866,9.6368491670127,0.400527423178466,30
"1624","PI","Inhuma",15319,8959.41,22006,"Valença do Piauí",2,"Nordeste",0,"220470",5,11,4,7,7,4,0,0,0,0,0,11,4,7,7,4,7,9.1004596555866,9.6368491670127,0.401581298644451,31
"1625","PI","Ipiranga do Piauí",9838,7368.94,22013,"Picos",2,"Nordeste",0,"220480",2,5,0,5,3,2,0,0,0,0,0,5,0,5,3,2,5,8.90502914851645,9.19400771735529,0.264675247236392,29
"1626","PI","Ipiranga do Piauí",9838,7368.94,22013,"Picos",2,"Nordeste",0,"220480",3,6,2,4,1,5,1,0,1,0,1,7,2,5,1,6,4,8.90502914851645,9.19400771735529,0.368732880620942,31
"1627","PI","Ipiranga do Piauí",9838,7368.94,22013,"Picos",2,"Nordeste",0,"220480",4,3,0,3,0,3,0,0,0,0,0,3,0,3,0,3,5,8.90502914851645,9.19400771735529,0.384120645607136,30
"1628","PI","Ipiranga do Piauí",9838,7368.94,22013,"Picos",2,"Nordeste",0,"220480",5,2,1,1,0,2,0,0,0,0,0,2,1,1,0,2,5,8.90502914851645,9.19400771735529,0.411039856845655,31
"1629","PI","Itainópolis",11551,7712.13,22015,"Alto Médio Canindé",2,"Nordeste",0,"220500",2,10,5,5,2,8,0,0,0,0,0,10,5,5,2,8,6,8.95054969299478,9.35452729228868,0.250815954924774,29
"1630","PI","Itainópolis",11551,7712.13,22015,"Alto Médio Canindé",2,"Nordeste",0,"220500",3,4,1,3,3,1,0,0,0,0,0,4,1,3,3,1,8,8.95054969299478,9.35452729228868,0.343739765183193,31
"1631","PI","Itainópolis",11551,7712.13,22015,"Alto Médio Canindé",2,"Nordeste",0,"220500",4,2,1,1,1,1,0,0,0,0,0,2,1,1,1,1,7,8.95054969299478,9.35452729228868,0.383184046386137,30
"1632","PI","Itainópolis",11551,7712.13,22015,"Alto Médio Canindé",2,"Nordeste",0,"220500",5,0,0,0,0,0,0,0,0,0,0,0,0,0,0,0,6,8.95054969299478,9.35452729228868,0.389665554947201,31
"1633","PI","Itaueira",11028,10006.91,22009,"Floriano",2,"Nordeste",0,"220510",2,5,2,3,2,3,0,0,0,0,0,5,2,3,2,3,2,9.2110311333456,9.30819277214369,0.247299393844139,29
"1634","PI","Itaueira",11028,10006.91,22009,"Floriano",2,"Nordeste",0,"220510",3,7,3,4,2,5,0,0,0,0,0,7,3,4,2,5,9,9.2110311333456,9.30819277214369,0.312737456490864,31
"1635","PI","Itaueira",11028,10006.91,22009,"Floriano",2,"Nordeste",0,"220510",4,10,4,6,5,5,0,0,0,0,0,10,4,6,5,5,10,9.2110311333456,9.30819277214369,0.341999777559617,30
"1636","PI","Itaueira",11028,10006.91,22009,"Floriano",2,"Nordeste",0,"220510",5,9,3,6,2,7,0,0,0,0,0,9,3,6,2,7,4,9.2110311333456,9.30819277214369,0.336169918740245,31
"1637","PI","Jaicós",19170,9027.86,22015,"Alto Médio Canindé",2,"Nordeste",0,"220520",2,21,11,10,8,13,1,1,0,0,1,22,12,10,8,14,4,9.1080706305066,9.86110183603969,0.2534678724657,29
"1638","PI","Jaicós",19170,9027.86,22015,"Alto Médio Canindé",2,"Nordeste",0,"220520",3,17,9,8,7,10,0,0,0,0,0,17,9,8,7,10,18,9.1080706305066,9.86110183603969,0.345171306508313,31
"1639","PI","Jaicós",19170,9027.86,22015,"Alto Médio Canindé",2,"Nordeste",0,"220520",4,6,3,3,3,3,1,1,0,1,0,7,4,3,4,3,12,9.1080706305066,9.86110183603969,0.369860975571849,30
"1640","PI","Jaicós",19170,9027.86,22015,"Alto Médio Canindé",2,"Nordeste",0,"220520",5,2,0,2,1,1,0,0,0,0,0,2,0,2,1,1,6,9.1080706305066,9.86110183603969,0.382846464215907,31
"1641","PI","Joaquim Pires",14376,6745,22001,"Baixo Parnaíba Piauiense",2,"Nordeste",0,"220540",2,14,5,9,7,7,0,0,0,0,0,14,5,9,7,7,9,8.81655676864186,9.5733154284634,0.321478335695925,29
"1642","PI","Joaquim Pires",14376,6745,22001,"Baixo Parnaíba Piauiense",2,"Nordeste",0,"220540",3,13,9,4,6,7,1,0,1,0,1,14,9,5,6,8,5,8.81655676864186,9.5733154284634,0.444840883709935,31
"1643","PI","Joaquim Pires",14376,6745,22001,"Baixo Parnaíba Piauiense",2,"Nordeste",0,"220540",4,11,1,10,4,7,0,0,0,0,0,11,1,10,4,7,6,8.81655676864186,9.5733154284634,0.428778494781311,30
"1644","PI","Joaquim Pires",14376,6745,22001,"Baixo Parnaíba Piauiense",2,"Nordeste",0,"220540",5,22,13,9,8,14,0,0,0,0,0,22,13,9,8,14,4,8.81655676864186,9.5733154284634,0.46294112630704,31
"1645","PI","José de Freitas",39336,8962.16,22003,"Teresina",2,"Nordeste",0,"220550",2,51,23,28,25,26,2,0,2,0,2,53,23,30,25,28,23,9.1007665483445,10.5798954090918,0.268322907447593,29
"1646","PI","José de Freitas",39336,8962.16,22003,"Teresina",2,"Nordeste",0,"220550",3,42,14,28,18,24,0,0,0,0,0,42,14,28,18,24,26,9.1007665483445,10.5798954090918,0.378122719516732,31
"1647","PI","José de Freitas",39336,8962.16,22003,"Teresina",2,"Nordeste",0,"220550",4,37,16,21,17,20,0,0,0,0,0,37,16,21,17,20,25,9.1007665483445,10.5798954090918,0.423767871537235,30
"1648","PI","José de Freitas",39336,8962.16,22003,"Teresina",2,"Nordeste",0,"220550",5,32,12,20,10,22,0,0,0,0,0,32,12,20,10,22,19,9.1007665483445,10.5798954090918,0.415958549052465,31
"1649","PI","Lagoa do Barro do Piauí",4656,38007.17,22015,"Alto Médio Canindé",2,"Nordeste",0,"220556",2,5,2,3,3,2,0,0,0,0,0,5,2,3,3,2,2,10.5455301051204,8.44591198941127,0.221286805144653,29
"1650","PI","Lagoa do Barro do Piauí",4656,38007.17,22015,"Alto Médio Canindé",2,"Nordeste",0,"220556",3,2,0,2,1,1,0,0,0,0,0,2,0,2,1,1,1,10.5455301051204,8.44591198941127,0.286306583413287,31
"1651","PI","Lagoa do Barro do Piauí",4656,38007.17,22015,"Alto Médio Canindé",2,"Nordeste",0,"220556",4,3,1,2,1,2,0,0,0,0,0,3,1,2,1,2,3,10.5455301051204,8.44591198941127,0.324759366775887,30
"1652","PI","Lagoa do Barro do Piauí",4656,38007.17,22015,"Alto Médio Canindé",2,"Nordeste",0,"220556",5,3,1,2,2,1,0,0,0,0,0,3,1,2,2,1,2,10.5455301051204,8.44591198941127,0.350272939910259,31
"1653","PI","Luís Correia",30438,10137.26,22002,"Litoral Piauiense",2,"Nordeste",0,"220570",2,25,13,12,13,12,0,0,0,0,0,25,13,12,13,12,17,9.22397302366747,10.3234471067947,0.324240673778743,29
"1654","PI","Luís Correia",30438,10137.26,22002,"Litoral Piauiense",2,"Nordeste",0,"220570",3,32,13,19,15,17,0,0,0,0,0,32,13,19,15,17,11,9.22397302366747,10.3234471067947,0.413557252626325,31
"1655","PI","Luís Correia",30438,10137.26,22002,"Litoral Piauiense",2,"Nordeste",0,"220570",4,25,12,13,9,16,0,0,0,0,0,25,12,13,9,16,6,9.22397302366747,10.3234471067947,0.473112445033549,30
"1656","PI","Luís Correia",30438,10137.26,22002,"Litoral Piauiense",2,"Nordeste",0,"220570",5,38,20,18,18,20,0,0,0,0,0,38,20,18,18,20,13,9.22397302366747,10.3234471067947,0.491326781868058,31
"1657","PI","Luzilândia",25504,8110.41,22001,"Baixo Parnaíba Piauiense",2,"Nordeste",0,"220580",2,24,8,16,15,9,0,0,0,0,0,24,8,16,15,9,11,9.00090370070213,10.1465905815899,0.269636034665544,29
"1658","PI","Luzilândia",25504,8110.41,22001,"Baixo Parnaíba Piauiense",2,"Nordeste",0,"220580",3,20,3,17,7,13,1,1,0,0,1,21,4,17,7,14,13,9.00090370070213,10.1465905815899,0.37398011136127,31
"1659","PI","Luzilândia",25504,8110.41,22001,"Baixo Parnaíba Piauiense",2,"Nordeste",0,"220580",4,18,4,14,7,11,0,0,0,0,0,18,4,14,7,11,9,9.00090370070213,10.1465905815899,0.411126563509001,30
"1660","PI","Luzilândia",25504,8110.41,22001,"Baixo Parnaíba Piauiense",2,"Nordeste",0,"220580",5,18,13,5,9,9,0,0,0,0,0,18,13,5,9,9,19,9.00090370070213,10.1465905815899,0.441038951230121,31
"1661","PI","Marcolândia",8543,8248.42,22015,"Alto Médio Canindé",2,"Nordeste",0,"220595",2,11,3,8,7,4,0,0,0,0,0,11,3,8,7,4,3,9.01777694583584,9.05286751315162,0.243406826563396,29
"1662","PI","Marcolândia",8543,8248.42,22015,"Alto Médio Canindé",2,"Nordeste",0,"220595",3,8,5,3,6,2,0,0,0,0,0,8,5,3,6,2,5,9.01777694583584,9.05286751315162,0.312342132385672,31
"1663","PI","Marcolândia",8543,8248.42,22015,"Alto Médio Canindé",2,"Nordeste",0,"220595",4,4,2,2,3,1,0,0,0,0,0,4,2,2,3,1,5,9.01777694583584,9.05286751315162,0.326347141831899,30
"1664","PI","Marcolândia",8543,8248.42,22015,"Alto Médio Canindé",2,"Nordeste",0,"220595",5,9,4,5,5,4,1,0,1,1,0,10,4,6,6,4,4,9.01777694583584,9.05286751315162,0.386242203197768,31
"1665","PI","Matias Olímpio",10958,7071.35,22001,"Baixo Parnaíba Piauiense",2,"Nordeste",0,"220610",2,8,3,5,6,2,0,0,0,0,0,8,3,5,6,2,5,8.86380668832863,9.30182506209836,0.300956306234237,29
"1666","PI","Matias Olímpio",10958,7071.35,22001,"Baixo Parnaíba Piauiense",2,"Nordeste",0,"220610",3,13,6,7,10,3,1,1,0,1,0,14,7,7,11,3,8,8.86380668832863,9.30182506209836,0.340558593776806,31
"1667","PI","Matias Olímpio",10958,7071.35,22001,"Baixo Parnaíba Piauiense",2,"Nordeste",0,"220610",4,3,1,2,1,2,0,0,0,0,0,3,1,2,1,2,5,8.86380668832863,9.30182506209836,0.415519157559281,30
"1668","PI","Matias Olímpio",10958,7071.35,22001,"Baixo Parnaíba Piauiense",2,"Nordeste",0,"220610",5,19,7,12,5,14,0,0,0,0,0,19,7,12,5,14,4,8.86380668832863,9.30182506209836,0.47719891540722,31
"1669","PI","Miguel Alves",33833,7090.86,22001,"Baixo Parnaíba Piauiense",2,"Nordeste",0,"220620",2,35,20,15,15,20,0,0,0,0,0,35,20,15,15,20,8,8.86656190977247,10.4291919365306,0.28095492175476,29
"1670","PI","Miguel Alves",33833,7090.86,22001,"Baixo Parnaíba Piauiense",2,"Nordeste",0,"220620",3,26,16,10,13,13,1,1,0,1,0,27,17,10,14,13,14,8.86656190977247,10.4291919365306,0.341869440792784,31
"1671","PI","Miguel Alves",33833,7090.86,22001,"Baixo Parnaíba Piauiense",2,"Nordeste",0,"220620",4,25,16,9,8,17,0,0,0,0,0,25,16,9,8,17,20,8.86656190977247,10.4291919365306,0.376314083922089,30
"1672","PI","Miguel Alves",33833,7090.86,22001,"Baixo Parnaíba Piauiense",2,"Nordeste",0,"220620",5,28,16,12,18,10,2,0,2,1,1,30,16,14,19,11,25,8.86656190977247,10.4291919365306,0.43214153415877,31
"1673","PI","Monsenhor Gil",10564,8898.35,22003,"Teresina",2,"Nordeste",0,"220640",2,6,2,4,1,5,0,0,0,0,0,6,2,4,1,5,3,9.09362114527435,9.26520727341702,0.300578936922827,29
"1674","PI","Monsenhor Gil",10564,8898.35,22003,"Teresina",2,"Nordeste",0,"220640",3,8,2,6,3,5,0,0,0,0,0,8,2,6,3,5,6,9.09362114527435,9.26520727341702,0.388857517282567,31
"1675","PI","Monsenhor Gil",10564,8898.35,22003,"Teresina",2,"Nordeste",0,"220640",4,8,2,6,4,4,0,0,0,0,0,8,2,6,4,4,6,9.09362114527435,9.26520727341702,0.424105848049229,30
"1676","PI","Monsenhor Gil",10564,8898.35,22003,"Teresina",2,"Nordeste",0,"220640",5,11,2,9,4,7,0,0,0,0,0,11,2,9,4,7,6,9.09362114527435,9.26520727341702,0.437677363013895,31
"1677","PI","Monte Alegre do Piauí",10615,18484.95,22010,"Alto Médio Gurguéia",2,"Nordeste",0,"220660",2,15,7,8,11,4,0,0,0,0,0,15,7,8,11,4,5,9.82471216647121,9.27002337413736,0.274237155268812,29
"1678","PI","Monte Alegre do Piauí",10615,18484.95,22010,"Alto Médio Gurguéia",2,"Nordeste",0,"220660",3,16,7,9,7,9,0,0,0,0,0,16,7,9,7,9,8,9.82471216647121,9.27002337413736,0.367256772970786,31
"1679","PI","Monte Alegre do Piauí",10615,18484.95,22010,"Alto Médio Gurguéia",2,"Nordeste",0,"220660",4,16,4,12,11,5,0,0,0,0,0,16,4,12,11,5,6,9.82471216647121,9.27002337413736,0.363825341269964,30
"1680","PI","Monte Alegre do Piauí",10615,18484.95,22010,"Alto Médio Gurguéia",2,"Nordeste",0,"220660",5,22,12,10,12,10,0,0,0,0,0,22,12,10,12,10,6,9.82471216647121,9.27002337413736,0.39467207865962,31
"1681","PI","Nazária",8602,10205.47,22003,"Teresina",2,"Nordeste",0,"220672",2,9,3,6,7,2,0,0,0,0,0,9,3,6,7,2,5,9.23067913003838,9.05975001334368,0.306127383945175,29
"1682","PI","Nazária",8602,10205.47,22003,"Teresina",2,"Nordeste",0,"220672",3,12,5,7,5,7,0,0,0,0,0,12,5,7,5,7,8,9.23067913003838,9.05975001334368,0.403898623722794,31
"1683","PI","Nazária",8602,10205.47,22003,"Teresina",2,"Nordeste",0,"220672",4,6,2,4,4,2,0,0,0,0,0,6,2,4,4,2,3,9.23067913003838,9.05975001334368,0.411756986873976,30
"1684","PI","Nazária",8602,10205.47,22003,"Teresina",2,"Nordeste",0,"220672",5,8,3,5,3,5,0,0,0,0,0,8,3,5,3,5,5,9.23067913003838,9.05975001334368,0.448089867027017,31
"1685","PI","Novo Oriente do Piauí",6556,6968.94,22006,"Valença do Piauí",2,"Nordeste",0,"220690",2,5,1,4,4,1,0,0,0,0,0,5,1,4,4,1,5,8.84921841184485,8.78813593986372,0.305996816428039,29
"1686","PI","Novo Oriente do Piauí",6556,6968.94,22006,"Valença do Piauí",2,"Nordeste",0,"220690",3,2,1,1,0,2,0,0,0,0,0,2,1,1,0,2,3,8.84921841184485,8.78813593986372,0.365297557864731,31
"1687","PI","Novo Oriente do Piauí",6556,6968.94,22006,"Valença do Piauí",2,"Nordeste",0,"220690",4,4,1,3,3,1,1,1,0,0,1,5,2,3,3,2,5,8.84921841184485,8.78813593986372,0.423407120133985,30
"1688","PI","Novo Oriente do Piauí",6556,6968.94,22006,"Valença do Piauí",2,"Nordeste",0,"220690",5,2,1,1,1,1,0,0,0,0,0,2,1,1,1,1,3,8.84921841184485,8.78813593986372,0.425679615236008,31
"1689","PI","Oeiras",37085,11928.73,22013,"Picos",2,"Nordeste",0,"220700",2,35,9,26,23,12,0,0,0,0,0,35,9,26,23,12,26,9.38670505510845,10.5209678541707,0.257399742509168,29
"1690","PI","Oeiras",37085,11928.73,22013,"Picos",2,"Nordeste",0,"220700",3,46,15,31,25,21,0,0,0,0,0,46,15,31,25,21,25,9.38670505510845,10.5209678541707,0.346718340293967,31
"1691","PI","Oeiras",37085,11928.73,22013,"Picos",2,"Nordeste",0,"220700",4,33,9,24,12,21,0,0,0,0,0,33,9,24,12,21,17,9.38670505510845,10.5209678541707,0.386492861671467,30
"1692","PI","Oeiras",37085,11928.73,22013,"Picos",2,"Nordeste",0,"220700",5,35,7,28,12,23,1,0,1,1,0,36,7,29,13,23,19,9.38670505510845,10.5209678541707,0.394520981010556,31
"1693","PI","Palmeirais",14587,7313.76,22005,"Médio Parnaíba Piauiense",2,"Nordeste",0,"220750",2,18,9,9,9,9,0,0,0,0,0,18,9,9,9,9,4,8.89751278438915,9.58788600008621,0.228842431364188,29
"1694","PI","Palmeirais",14587,7313.76,22005,"Médio Parnaíba Piauiense",2,"Nordeste",0,"220750",3,9,5,4,2,7,1,1,0,0,1,10,6,4,2,8,10,8.89751278438915,9.58788600008621,0.335618504238923,31
"1695","PI","Palmeirais",14587,7313.76,22005,"Médio Parnaíba Piauiense",2,"Nordeste",0,"220750",4,9,3,6,3,6,0,0,0,0,0,9,3,6,3,6,4,8.89751278438915,9.58788600008621,0.378186557834589,30
"1696","PI","Palmeirais",14587,7313.76,22005,"Médio Parnaíba Piauiense",2,"Nordeste",0,"220750",5,9,4,5,2,7,0,0,0,0,0,9,4,5,2,7,7,8.89751278438915,9.58788600008621,0.423071709950413,31
"1697","PI","Parnaíba",153482,15216.39,22002,"Litoral Piauiense",2,"Nordeste",1,"220770",2,196,65,131,85,111,2,0,2,1,1,198,65,133,86,112,84,9.63012841537153,11.9413385752898,0.290289779129864,29
"1698","PI","Parnaíba",153482,15216.39,22002,"Litoral Piauiense",2,"Nordeste",1,"220770",3,175,64,111,69,106,1,0,1,1,0,176,64,112,70,106,94,9.63012841537153,11.9413385752898,0.402625908278887,31
"1699","PI","Parnaíba",153482,15216.39,22002,"Litoral Piauiense",2,"Nordeste",1,"220770",4,188,62,126,77,111,3,1,2,0,3,191,63,128,77,114,92,9.63012841537153,11.9413385752898,0.474181737715369,30
"1700","PI","Parnaíba",153482,15216.39,22002,"Litoral Piauiense",2,"Nordeste",1,"220770",5,163,53,110,70,93,2,1,1,1,1,165,54,111,71,94,103,9.63012841537153,11.9413385752898,0.45282980847721,31
"1701","PI","Paulistana",20554,10053.24,22015,"Alto Médio Canindé",2,"Nordeste",0,"220780",2,36,17,19,18,18,0,0,0,0,0,36,17,19,18,18,15,9.21565024959106,9.93081084818502,0.240864837825994,29
"1702","PI","Paulistana",20554,10053.24,22015,"Alto Médio Canindé",2,"Nordeste",0,"220780",3,22,8,14,7,15,0,0,0,0,0,22,8,14,7,15,11,9.21565024959106,9.93081084818502,0.334367451345057,31
"1703","PI","Paulistana",20554,10053.24,22015,"Alto Médio Canindé",2,"Nordeste",0,"220780",4,22,8,14,14,8,1,1,0,0,1,23,9,14,14,9,8,9.21565024959106,9.93081084818502,0.372068093596781,30
"1704","PI","Paulistana",20554,10053.24,22015,"Alto Médio Canindé",2,"Nordeste",0,"220780",5,16,6,10,7,9,1,1,0,1,0,17,7,10,8,9,11,9.21565024959106,9.93081084818502,0.360006068503206,31
"1705","PI","Pedro II",38778,8296.92,22004,"Campo Maior",2,"Nordeste",0,"220790",2,38,16,22,21,17,0,0,0,0,0,38,16,22,21,17,23,9.02363964057851,10.5656083544909,0.267792649335027,29
"1706","PI","Pedro II",38778,8296.92,22004,"Campo Maior",2,"Nordeste",0,"220790",3,42,19,23,18,24,0,0,0,0,0,42,19,23,18,24,40,9.02363964057851,10.5656083544909,0.375721931813227,31
"1707","PI","Pedro II",38778,8296.92,22004,"Campo Maior",2,"Nordeste",0,"220790",4,37,24,13,20,17,1,0,1,0,1,38,24,14,20,18,18,9.02363964057851,10.5656083544909,0.427273056831038,30
"1708","PI","Pedro II",38778,8296.92,22004,"Campo Maior",2,"Nordeste",0,"220790",5,45,23,22,18,27,0,0,0,0,0,45,23,22,18,27,26,9.02363964057851,10.5656083544909,0.448184239795912,31
"1709","PI","Picos",78431,19445.94,22013,"Picos",2,"Nordeste",1,"220800",2,79,26,53,31,48,1,0,1,0,1,80,26,54,31,49,34,9.87539358689739,11.2699745363486,0.268161104100122,29
"1710","PI","Picos",78431,19445.94,22013,"Picos",2,"Nordeste",1,"220800",3,66,17,49,27,39,0,0,0,0,0,66,17,49,27,39,80,9.87539358689739,11.2699745363486,0.376526535625698,31
"1711","PI","Picos",78431,19445.94,22013,"Picos",2,"Nordeste",1,"220800",4,25,6,19,11,14,0,0,0,0,0,25,6,19,11,14,34,9.87539358689739,11.2699745363486,0.430938012372387,30
"1712","PI","Picos",78431,19445.94,22013,"Picos",2,"Nordeste",1,"220800",5,13,3,10,4,9,0,0,0,0,0,13,3,10,4,9,48,9.87539358689739,11.2699745363486,0.412108627858196,31
"1713","PI","Pimenteiras",12139,7085.51,22006,"Valença do Piauí",2,"Nordeste",0,"220810",2,19,9,10,4,15,0,0,0,0,0,19,9,10,4,15,6,8.86580713259693,9.4041786888978,0.239834726463162,29
"1714","PI","Pimenteiras",12139,7085.51,22006,"Valença do Piauí",2,"Nordeste",0,"220810",3,8,5,3,4,4,0,0,0,0,0,8,5,3,4,4,3,8.86580713259693,9.4041786888978,0.32473567384637,31
"1715","PI","Pimenteiras",12139,7085.51,22006,"Valença do Piauí",2,"Nordeste",0,"220810",4,11,3,8,5,6,0,0,0,0,0,11,3,8,5,6,7,8.86580713259693,9.4041786888978,0.396604487881112,30
"1716","PI","Pimenteiras",12139,7085.51,22006,"Valença do Piauí",2,"Nordeste",0,"220810",5,9,4,5,6,3,0,0,0,0,0,9,4,5,6,3,8,8.86580713259693,9.4041786888978,0.40599622584983,31
"1717","PI","Pio IX",18459,9461.94,22014,"Pio IX",2,"Nordeste",0,"220820",2,21,5,16,8,13,1,1,0,1,0,22,6,16,9,13,6,9.1550327150169,9.8233073354086,0.268542383193585,29
"1718","PI","Pio IX",18459,9461.94,22014,"Pio IX",2,"Nordeste",0,"220820",3,22,9,13,10,12,0,0,0,0,0,22,9,13,10,12,5,9.1550327150169,9.8233073354086,0.354564555467806,31
"1719","PI","Pio IX",18459,9461.94,22014,"Pio IX",2,"Nordeste",0,"220820",4,4,1,3,1,3,1,1,0,0,1,5,2,3,1,4,11,9.1550327150169,9.8233073354086,0.369515225309064,30
"1720","PI","Pio IX",18459,9461.94,22014,"Pio IX",2,"Nordeste",0,"220820",5,7,2,5,3,4,0,0,0,0,0,7,2,5,3,4,12,9.1550327150169,9.8233073354086,0.406580790014625,31
"1721","PI","Piracuruca",28874,9793.87,22002,"Litoral Piauiense",2,"Nordeste",0,"220830",2,35,13,22,20,15,0,0,0,0,0,35,13,22,20,15,18,9.18951195874146,10.2706968151898,0.245205850266509,29
"1722","PI","Piracuruca",28874,9793.87,22002,"Litoral Piauiense",2,"Nordeste",0,"220830",3,27,8,19,10,17,0,0,0,0,0,27,8,19,10,17,15,9.18951195874146,10.2706968151898,0.364788914969867,31
"1723","PI","Piracuruca",28874,9793.87,22002,"Litoral Piauiense",2,"Nordeste",0,"220830",4,22,5,17,10,12,1,0,1,0,1,23,5,18,10,13,22,9.18951195874146,10.2706968151898,0.428203248002445,30
"1724","PI","Piracuruca",28874,9793.87,22002,"Litoral Piauiense",2,"Nordeste",0,"220830",5,29,12,17,16,13,0,0,0,0,0,29,12,17,16,13,21,9.18951195874146,10.2706968151898,0.398552127240786,31
"1725","PI","Piripiri",63787,11286.42,22001,"Baixo Parnaíba Piauiense",2,"Nordeste",1,"220840",2,59,28,31,25,34,0,0,0,0,0,59,28,31,25,34,41,9.33135551208439,11.0633046868151,0.268347085697707,29
"1726","PI","Piripiri",63787,11286.42,22001,"Baixo Parnaíba Piauiense",2,"Nordeste",1,"220840",3,84,31,53,36,48,1,0,1,0,1,85,31,54,36,49,39,9.33135551208439,11.0633046868151,0.379592613044666,31
"1727","PI","Piripiri",63787,11286.42,22001,"Baixo Parnaíba Piauiense",2,"Nordeste",1,"220840",4,59,24,35,24,35,1,0,1,1,0,60,24,36,25,35,36,9.33135551208439,11.0633046868151,0.431338426556834,30
"1728","PI","Piripiri",63787,11286.42,22001,"Baixo Parnaíba Piauiense",2,"Nordeste",1,"220840",5,65,21,44,29,36,0,0,0,0,0,65,21,44,29,36,34,9.33135551208439,11.0633046868151,0.441786434742993,31
"1729","PI","Porto",12608,7246.7,22001,"Baixo Parnaíba Piauiense",2,"Nordeste",0,"220850",2,13,8,5,8,5,0,0,0,0,0,13,8,5,8,5,3,8.88830147181252,9.44208681209766,0.306256369793237,29
"1730","PI","Porto",12608,7246.7,22001,"Baixo Parnaíba Piauiense",2,"Nordeste",0,"220850",3,12,4,8,7,5,1,1,0,1,0,13,5,8,8,5,5,8.88830147181252,9.44208681209766,0.387680605823703,31
"1731","PI","Porto",12608,7246.7,22001,"Baixo Parnaíba Piauiense",2,"Nordeste",0,"220850",4,12,6,6,6,6,0,0,0,0,0,12,6,6,6,6,11,8.88830147181252,9.44208681209766,0.412359206068487,30
"1732","PI","Porto",12608,7246.7,22001,"Baixo Parnaíba Piauiense",2,"Nordeste",0,"220850",5,16,7,9,11,5,1,0,1,0,1,17,7,10,11,6,8,8.88830147181252,9.44208681209766,0.414445071694206,31
"1733","PI","Queimada Nova",9017,8367.88,22015,"Alto Médio Canindé",2,"Nordeste",0,"220865",2,8,3,5,3,5,1,1,0,1,0,9,4,5,4,5,7,9.03215584585771,9.10686696349991,0.235341239102878,29
"1734","PI","Queimada Nova",9017,8367.88,22015,"Alto Médio Canindé",2,"Nordeste",0,"220865",3,3,0,3,1,2,0,0,0,0,0,3,0,3,1,2,6,9.03215584585771,9.10686696349991,0.302281609559218,31
"1735","PI","Queimada Nova",9017,8367.88,22015,"Alto Médio Canindé",2,"Nordeste",0,"220865",4,8,4,4,3,5,0,0,0,0,0,8,4,4,3,5,9,9.03215584585771,9.10686696349991,0.308703124690363,30
"1736","PI","Queimada Nova",9017,8367.88,22015,"Alto Médio Canindé",2,"Nordeste",0,"220865",5,10,4,6,3,7,0,0,0,0,0,10,4,6,3,7,2,9.03215584585771,9.10686696349991,0.320893748069443,31
"1737","PI","Regeneração",17979,10306.62,22005,"Médio Parnaíba Piauiense",2,"Nordeste",1,"220880",2,13,4,9,7,6,1,0,1,0,1,14,4,10,7,7,7,9.24054168620929,9.79695968912629,0.252434652082321,29
"1738","PI","Regeneração",17979,10306.62,22005,"Médio Parnaíba Piauiense",2,"Nordeste",1,"220880",3,13,2,11,5,8,0,0,0,0,0,13,2,11,5,8,7,9.24054168620929,9.79695968912629,0.379440364541538,31
"1739","PI","Regeneração",17979,10306.62,22005,"Médio Parnaíba Piauiense",2,"Nordeste",1,"220880",4,14,9,5,6,8,0,0,0,0,0,14,9,5,6,8,10,9.24054168620929,9.79695968912629,0.414249690691799,30
"1740","PI","Regeneração",17979,10306.62,22005,"Médio Parnaíba Piauiense",2,"Nordeste",1,"220880",5,13,3,10,7,6,0,0,0,0,0,13,3,10,7,6,10,9.24054168620929,9.79695968912629,0.421771237526317,31
"1741","PI","São João da Fronteira",6064,7816.02,22002,"Litoral Piauiense",2,"Nordeste",0,"220987",2,4,2,2,2,2,1,1,0,0,1,5,3,2,2,3,3,8.96393075257298,8.71012492732221,0.297416777877473,29
"1742","PI","São João da Fronteira",6064,7816.02,22002,"Litoral Piauiense",2,"Nordeste",0,"220987",3,7,3,4,5,2,0,0,0,0,0,7,3,4,5,2,2,8.96393075257298,8.71012492732221,0.405022977262265,31
"1743","PI","São João da Fronteira",6064,7816.02,22002,"Litoral Piauiense",2,"Nordeste",0,"220987",4,8,6,2,4,4,0,0,0,0,0,8,6,2,4,4,3,8.96393075257298,8.71012492732221,0.401286494688662,30
"1744","PI","São João da Fronteira",6064,7816.02,22002,"Litoral Piauiense",2,"Nordeste",0,"220987",5,2,2,0,2,0,0,0,0,0,0,2,2,0,2,0,4,8.96393075257298,8.71012492732221,0.429501367878231,31
"1745","PI","São João do Piauí",20662,11149.29,22015,"Alto Médio Canindé",2,"Nordeste",0,"221000",2,20,7,13,8,12,0,0,0,0,0,20,7,13,8,12,9,9.31913109773074,9.93605154340939,0.254735506651212,29
"1746","PI","São João do Piauí",20662,11149.29,22015,"Alto Médio Canindé",2,"Nordeste",0,"221000",3,22,7,15,10,12,0,0,0,0,0,22,7,15,10,12,12,9.31913109773074,9.93605154340939,0.317686426247134,31
"1747","PI","São João do Piauí",20662,11149.29,22015,"Alto Médio Canindé",2,"Nordeste",0,"221000",4,31,7,24,15,16,0,0,0,0,0,31,7,24,15,16,13,9.31913109773074,9.93605154340939,0.379578595259692,30
"1748","PI","São João do Piauí",20662,11149.29,22015,"Alto Médio Canindé",2,"Nordeste",0,"221000",5,28,7,21,14,14,0,0,0,0,0,28,7,21,14,14,15,9.31913109773074,9.93605154340939,0.384169790818232,31
"1749","PI","São Miguel do Tapuio",17639,7529.35,22004,"Campo Maior",2,"Nordeste",0,"221040",2,11,10,1,6,5,0,0,0,0,0,11,10,1,6,5,14,8.92656399568689,9.77786763861148,0.252960462196353,29
"1750","PI","São Miguel do Tapuio",17639,7529.35,22004,"Campo Maior",2,"Nordeste",0,"221040",3,12,5,7,6,6,1,1,0,0,1,13,6,7,6,7,19,8.92656399568689,9.77786763861148,0.354191998788244,31
"1751","PI","São Miguel do Tapuio",17639,7529.35,22004,"Campo Maior",2,"Nordeste",0,"221040",4,12,6,6,7,5,0,0,0,0,0,12,6,6,7,5,6,8.92656399568689,9.77786763861148,0.370249484263127,30
"1752","PI","São Miguel do Tapuio",17639,7529.35,22004,"Campo Maior",2,"Nordeste",0,"221040",5,9,2,7,4,5,0,0,0,0,0,9,2,7,4,5,11,8.92656399568689,9.77786763861148,0.382533033166765,31
"1753","PI","São Pedro do Piauí",14324,7329.39,22005,"Médio Parnaíba Piauiense",2,"Nordeste",0,"221050",2,11,9,2,4,7,0,0,0,0,0,11,9,2,4,7,7,8.89964757177246,9.56969173111832,0.31640330406775,29
"1754","PI","São Pedro do Piauí",14324,7329.39,22005,"Médio Parnaíba Piauiense",2,"Nordeste",0,"221050",3,7,1,6,3,4,1,1,0,1,0,8,2,6,4,4,6,8.89964757177246,9.56969173111832,0.395907266695331,31
"1755","PI","São Pedro do Piauí",14324,7329.39,22005,"Médio Parnaíba Piauiense",2,"Nordeste",0,"221050",4,13,7,6,7,6,0,0,0,0,0,13,7,6,7,6,9,8.89964757177246,9.56969173111832,0.423524045850877,30
"1756","PI","São Pedro do Piauí",14324,7329.39,22005,"Médio Parnaíba Piauiense",2,"Nordeste",0,"221050",5,22,9,13,9,13,0,0,0,0,0,22,9,13,9,13,10,8.89964757177246,9.56969173111832,0.459530099707837,31
"1757","PI","São Raimundo Nonato",34877,12993.94,22011,"São Raimundo Nonato",2,"Nordeste",0,"221060",2,41,15,26,26,15,0,0,0,0,0,41,15,26,26,15,18,9.47223837391404,10.4595828651496,0.228841050511652,29
"1758","PI","São Raimundo Nonato",34877,12993.94,22011,"São Raimundo Nonato",2,"Nordeste",0,"221060",3,31,11,20,12,19,0,0,0,0,0,31,11,20,12,19,16,9.47223837391404,10.4595828651496,0.332918537675037,31
"1759","PI","São Raimundo Nonato",34877,12993.94,22011,"São Raimundo Nonato",2,"Nordeste",0,"221060",4,37,16,21,16,21,0,0,0,0,0,37,16,21,16,21,20,9.47223837391404,10.4595828651496,0.391404006364303,30
"1760","PI","São Raimundo Nonato",34877,12993.94,22011,"São Raimundo Nonato",2,"Nordeste",0,"221060",5,38,13,25,16,22,1,0,1,0,1,39,13,26,16,23,25,9.47223837391404,10.4595828651496,0.372221193586924,31
"1761","PI","Simões",14649,17754.79,22015,"Alto Médio Canindé",2,"Nordeste",0,"221070",2,12,5,7,6,6,0,0,0,0,0,12,5,7,6,6,11,9.78441061765306,9.59212735272977,0.262530306850646,29
"1762","PI","Simões",14649,17754.79,22015,"Alto Médio Canindé",2,"Nordeste",0,"221070",3,13,8,5,5,8,0,0,0,0,0,13,8,5,5,8,7,9.78441061765306,9.59212735272977,0.354606371526463,31
"1763","PI","Simões",14649,17754.79,22015,"Alto Médio Canindé",2,"Nordeste",0,"221070",4,10,1,9,4,6,0,0,0,0,0,10,1,9,4,6,8,9.78441061765306,9.59212735272977,0.39973835343337,30
"1764","PI","Simões",14649,17754.79,22015,"Alto Médio Canindé",2,"Nordeste",0,"221070",5,14,3,11,7,7,0,0,0,0,0,14,3,11,7,7,7,9.78441061765306,9.59212735272977,0.440334366774647,31
"1765","PI","Simplício Mendes",12746,11240.79,22015,"Alto Médio Canindé",2,"Nordeste",0,"221080",2,11,4,7,7,4,0,0,0,0,0,11,4,7,7,4,7,9.32730440567534,9.45297277587424,0.224752065754124,29
"1766","PI","Simplício Mendes",12746,11240.79,22015,"Alto Médio Canindé",2,"Nordeste",0,"221080",3,8,2,6,1,7,0,0,0,0,0,8,2,6,1,7,8,9.32730440567534,9.45297277587424,0.321863341731749,31
"1767","PI","Simplício Mendes",12746,11240.79,22015,"Alto Médio Canindé",2,"Nordeste",0,"221080",4,10,3,7,5,5,1,0,1,0,1,11,3,8,5,6,6,9.32730440567534,9.45297277587424,0.382973918388149,30
"1768","PI","Simplício Mendes",12746,11240.79,22015,"Alto Médio Canindé",2,"Nordeste",0,"221080",5,15,3,12,7,8,0,0,0,0,0,15,3,12,7,8,8,9.32730440567534,9.45297277587424,0.386865640363151,31
"1769","PI","Sussuapara",6767,8269.49,22013,"Picos",2,"Nordeste",0,"221093",2,8,3,5,6,2,0,0,0,0,0,8,3,5,6,2,2,9.02032811743416,8.81981313623223,0.288520686209651,29
"1770","PI","Sussuapara",6767,8269.49,22013,"Picos",2,"Nordeste",0,"221093",3,6,1,5,1,5,0,0,0,0,0,6,1,5,1,5,8,9.02032811743416,8.81981313623223,0.396451191574732,31
"1771","PI","Sussuapara",6767,8269.49,22013,"Picos",2,"Nordeste",0,"221093",4,1,0,1,1,0,0,0,0,0,0,1,0,1,1,0,4,9.02032811743416,8.81981313623223,0.435340385344934,30
"1772","PI","Sussuapara",6767,8269.49,22013,"Picos",2,"Nordeste",0,"221093",5,0,0,0,0,0,0,0,0,0,0,0,0,0,0,0,5,9.02032811743416,8.81981313623223,0.404335795858385,31
"1773","PI","Teresina",868075,24333,22003,"Teresina",2,"Nordeste",1,"221100",2,926,149,777,327,599,6,1,5,3,3,932,150,782,330,602,430,10.0995887327385,13.6740333954397,0.284690711895926,29
"1774","PI","Teresina",868075,24333,22003,"Teresina",2,"Nordeste",1,"221100",3,849,147,702,282,567,10,5,5,5,5,859,152,707,287,572,478,10.0995887327385,13.6740333954397,0.40853563932531,31
"1775","PI","Teresina",868075,24333,22003,"Teresina",2,"Nordeste",1,"221100",4,700,122,578,240,460,12,1,11,4,8,712,123,589,244,468,403,10.0995887327385,13.6740333954397,0.492520246901886,30
"1776","PI","Teresina",868075,24333,22003,"Teresina",2,"Nordeste",1,"221100",5,724,125,599,237,487,6,2,4,2,4,730,127,603,239,491,504,10.0995887327385,13.6740333954397,0.472091034188623,31
"1777","PI","União",44569,8241.26,22003,"Teresina",2,"Nordeste",0,"221110",2,38,15,23,15,23,0,0,0,0,0,38,15,23,15,23,24,9.01690852383493,10.7047938290723,0.295801226721024,29
"1778","PI","União",44569,8241.26,22003,"Teresina",2,"Nordeste",0,"221110",3,32,10,22,18,14,0,0,0,0,0,32,10,22,18,14,21,9.01690852383493,10.7047938290723,0.396426700776397,31
"1779","PI","União",44569,8241.26,22003,"Teresina",2,"Nordeste",0,"221110",4,28,11,17,10,18,0,0,0,0,0,28,11,17,10,18,27,9.01690852383493,10.7047938290723,0.432310039531966,30
"1780","PI","União",44569,8241.26,22003,"Teresina",2,"Nordeste",0,"221110",5,46,23,23,17,29,0,0,0,0,0,46,23,23,17,29,26,9.01690852383493,10.7047938290723,0.448490111834631,31
"1781","PI","Uruçuí",21655,79384.48,22007,"Alto Parnaíba Piauiense",2,"Nordeste",0,"221120",2,45,14,31,22,23,0,0,0,0,0,45,14,31,22,23,14,11.2820581621343,9.98299165364873,0.24568617067067,29
"1782","PI","Uruçuí",21655,79384.48,22007,"Alto Parnaíba Piauiense",2,"Nordeste",0,"221120",3,29,11,18,14,15,0,0,0,0,0,29,11,18,14,15,9,11.2820581621343,9.98299165364873,0.319991562520626,31
"1783","PI","Uruçuí",21655,79384.48,22007,"Alto Parnaíba Piauiense",2,"Nordeste",0,"221120",4,30,6,24,11,19,0,0,0,0,0,30,6,24,11,19,14,11.2820581621343,9.98299165364873,0.352502509802547,30
"1784","PI","Uruçuí",21655,79384.48,22007,"Alto Parnaíba Piauiense",2,"Nordeste",0,"221120",5,44,14,30,22,22,0,0,0,0,0,44,14,30,22,22,12,11.2820581621343,9.98299165364873,0.362337639577986,31
"1785","PI","Valença do Piauí",20929,11449.03,22006,"Valença do Piauí",2,"Nordeste",1,"221130",2,8,2,6,3,5,0,0,0,0,0,8,2,6,3,5,8,9.34566028923656,9.94889103598998,0.237644676576689,29
"1786","PI","Valença do Piauí",20929,11449.03,22006,"Valença do Piauí",2,"Nordeste",1,"221130",3,24,7,17,12,12,0,0,0,0,0,24,7,17,12,12,10,9.34566028923656,9.94889103598998,0.334427675457058,31
"1787","PI","Valença do Piauí",20929,11449.03,22006,"Valença do Piauí",2,"Nordeste",1,"221130",4,15,3,12,4,11,0,0,0,0,0,15,3,12,4,11,16,9.34566028923656,9.94889103598998,0.380039750666282,30
"1788","PI","Valença do Piauí",20929,11449.03,22006,"Valença do Piauí",2,"Nordeste",1,"221130",5,25,7,18,12,13,0,0,0,0,0,25,7,18,12,13,19,9.34566028923656,9.94889103598998,0.377393896362577,31
"1789","PI","Várzea Grande",4386,7425.19,22006,"Valença do Piauí",2,"Nordeste",0,"221140",2,2,0,2,1,1,0,0,0,0,0,2,0,2,1,1,1,8.91263355256909,8.38617292897783,0.298453846639289,29
"1790","PI","Várzea Grande",4386,7425.19,22006,"Valença do Piauí",2,"Nordeste",0,"221140",3,6,3,3,4,2,0,0,0,0,0,6,3,3,4,2,5,8.91263355256909,8.38617292897783,0.385053712345325,31
"1791","PI","Várzea Grande",4386,7425.19,22006,"Valença do Piauí",2,"Nordeste",0,"221140",4,4,1,3,2,2,0,0,0,0,0,4,1,3,2,2,7,8.91263355256909,8.38617292897783,0.44723510751715,30
"1792","PI","Várzea Grande",4386,7425.19,22006,"Valença do Piauí",2,"Nordeste",0,"221140",5,5,0,5,5,0,0,0,0,0,0,5,0,5,5,0,3,8.91263355256909,8.38617292897783,0.466825390883791,31
"1793","CE","Abaiara",11853,7360.5,23033,"Brejo Santo",2,"Nordeste",0,"230010",2,10,3,7,4,6,0,0,0,0,0,10,3,7,4,6,5,8.90388314419807,9.3803362790795,0.253691612820298,29
"1794","CE","Abaiara",11853,7360.5,23033,"Brejo Santo",2,"Nordeste",0,"230010",3,15,5,10,6,9,0,0,0,0,0,15,5,10,6,9,5,8.90388314419807,9.3803362790795,0.386337118401434,31
"1795","CE","Abaiara",11853,7360.5,23033,"Brejo Santo",2,"Nordeste",0,"230010",4,10,4,6,7,3,1,0,1,0,1,11,4,7,7,4,7,8.90388314419807,9.3803362790795,0.407646393030505,30
"1796","CE","Abaiara",11853,7360.5,23033,"Brejo Santo",2,"Nordeste",0,"230010",5,12,2,10,5,7,0,0,0,0,0,12,2,10,5,7,5,8.90388314419807,9.3803362790795,0.410366947469224,31
"1797","CE","Acarape",15036,8075.56,23013,"Baturité",2,"Nordeste",0,"230015",2,16,6,10,6,10,1,1,0,1,0,17,7,10,7,10,8,8.99659749553147,9.61820260468407,0.298358465298689,29
"1798","CE","Acarape",15036,8075.56,23013,"Baturité",2,"Nordeste",0,"230015",3,10,2,8,4,6,1,1,0,0,1,11,3,8,4,7,8,8.99659749553147,9.61820260468407,0.398859964230409,31
"1799","CE","Acarape",15036,8075.56,23013,"Baturité",2,"Nordeste",0,"230015",4,13,3,10,9,4,0,0,0,0,0,13,3,10,9,4,11,8.99659749553147,9.61820260468407,0.455833890800231,30
"1800","CE","Acarape",15036,8075.56,23013,"Baturité",2,"Nordeste",0,"230015",5,12,4,8,3,9,2,1,1,1,1,14,5,9,4,10,20,8.99659749553147,9.61820260468407,0.511233015186917,31
"1801","CE","Acaraú",63104,8932.85,23001,"Litoral de Camocim e Acaraú",2,"Nordeste",0,"230020",2,77,31,46,32,45,0,0,0,0,0,77,31,46,32,45,42,9.09749077188953,11.0525394379623,0.307030515611461,29
"1802","CE","Acaraú",63104,8932.85,23001,"Litoral de Camocim e Acaraú",2,"Nordeste",0,"230020",3,66,18,48,29,37,2,0,2,0,2,68,18,50,29,39,44,9.09749077188953,11.0525394379623,0.419269966760943,31
"1803","CE","Acaraú",63104,8932.85,23001,"Litoral de Camocim e Acaraú",2,"Nordeste",0,"230020",4,80,28,52,34,46,0,0,0,0,0,80,28,52,34,46,33,9.09749077188953,11.0525394379623,0.46656743903767,30
"1804","CE","Acaraú",63104,8932.85,23001,"Litoral de Camocim e Acaraú",2,"Nordeste",0,"230020",5,75,21,54,33,42,1,1,0,0,1,76,22,54,33,43,69,9.09749077188953,11.0525394379623,0.495858807605025,31
"1805","CE","Acopiara",54481,7038.21,23021,"Sertão de Senador Pompeu",2,"Nordeste",0,"230030",2,46,15,31,18,28,2,2,0,0,2,48,17,31,18,30,18,8.85910915545855,10.9056072960147,0.273013166553585,29
"1806","CE","Acopiara",54481,7038.21,23021,"Sertão de Senador Pompeu",2,"Nordeste",0,"230030",3,38,9,29,22,16,1,0,1,0,1,39,9,30,22,17,27,8.85910915545855,10.9056072960147,0.380654041770535,31
"1807","CE","Acopiara",54481,7038.21,23021,"Sertão de Senador Pompeu",2,"Nordeste",0,"230030",4,56,25,31,26,30,2,0,2,0,2,58,25,33,26,32,40,8.85910915545855,10.9056072960147,0.424547203859254,30
"1808","CE","Acopiara",54481,7038.21,23021,"Sertão de Senador Pompeu",2,"Nordeste",0,"230030",5,52,18,34,23,29,1,0,1,1,0,53,18,35,24,29,50,8.85910915545855,10.9056072960147,0.443649464702397,31
"1809","CE","Aiuaba",17493,6424.51,23020,"Sertão de Inhamuns",2,"Nordeste",0,"230040",2,13,6,7,3,10,0,0,0,0,0,13,6,7,3,10,7,8.76787564226369,9.76955607989027,0.28718475042825,29
"1810","CE","Aiuaba",17493,6424.51,23020,"Sertão de Inhamuns",2,"Nordeste",0,"230040",3,11,4,7,4,7,0,0,0,0,0,11,4,7,4,7,15,8.76787564226369,9.76955607989027,0.363395086132703,31
"1811","CE","Aiuaba",17493,6424.51,23020,"Sertão de Inhamuns",2,"Nordeste",0,"230040",4,15,4,11,8,7,0,0,0,0,0,15,4,11,8,7,11,8.76787564226369,9.76955607989027,0.390042407645384,30
"1812","CE","Aiuaba",17493,6424.51,23020,"Sertão de Inhamuns",2,"Nordeste",0,"230040",5,8,4,4,4,4,0,0,0,0,0,8,4,4,4,4,5,8.76787564226369,9.76955607989027,0.392678814602032,31
"1813","CE","Alcântaras",11781,6506.65,23004,"Meruoca",2,"Nordeste",0,"230050",2,14,4,10,4,10,1,0,1,1,0,15,4,11,5,10,7,8.78058000982028,9.37424334324612,0.305968641164121,29
"1814","CE","Alcântaras",11781,6506.65,23004,"Meruoca",2,"Nordeste",0,"230050",3,6,0,6,1,5,0,0,0,0,0,6,0,6,1,5,6,8.78058000982028,9.37424334324612,0.434654124015089,31
"1815","CE","Alcântaras",11781,6506.65,23004,"Meruoca",2,"Nordeste",0,"230050",4,12,5,7,7,5,0,0,0,0,0,12,5,7,7,5,4,8.78058000982028,9.37424334324612,0.472919866519293,30
"1816","CE","Alcântaras",11781,6506.65,23004,"Meruoca",2,"Nordeste",0,"230050",5,12,3,9,5,7,0,0,0,0,0,12,3,9,5,7,6,8.78058000982028,9.37424334324612,0.515060659204118,31
"1817","CE","Altaneira",7650,6606.64,23030,"Caririaçu",2,"Nordeste",0,"230060",2,9,3,6,7,2,0,0,0,0,0,9,3,6,7,2,4,8.79583048288078,8.94246092682058,0.252373050812235,29
"1818","CE","Altaneira",7650,6606.64,23030,"Caririaçu",2,"Nordeste",0,"230060",3,11,3,8,2,9,0,0,0,0,0,11,3,8,2,9,5,8.79583048288078,8.94246092682058,0.367401362772866,31
"1819","CE","Altaneira",7650,6606.64,23030,"Caririaçu",2,"Nordeste",0,"230060",4,10,5,5,8,2,0,0,0,0,0,10,5,5,8,2,4,8.79583048288078,8.94246092682058,0.396665243620858,30
"1820","CE","Altaneira",7650,6606.64,23030,"Caririaçu",2,"Nordeste",0,"230060",5,6,3,3,1,5,0,0,0,0,0,6,3,3,1,5,2,8.79583048288078,8.94246092682058,0.407648268964225,31
"1821","CE","Alto Santo",17196,8908.98,23023,"Baixo Jaguaribe",2,"Nordeste",0,"230070",2,12,3,9,3,9,0,0,0,0,0,12,3,9,3,9,3,9.09481503579726,9.75243207761617,0.310382607852802,29
"1822","CE","Alto Santo",17196,8908.98,23023,"Baixo Jaguaribe",2,"Nordeste",0,"230070",3,17,5,12,7,10,0,0,0,0,0,17,5,12,7,10,7,9.09481503579726,9.75243207761617,0.38471322540019,31
"1823","CE","Alto Santo",17196,8908.98,23023,"Baixo Jaguaribe",2,"Nordeste",0,"230070",4,10,4,6,4,6,1,0,1,0,1,11,4,7,4,7,13,9.09481503579726,9.75243207761617,0.443987796195212,30
"1824","CE","Alto Santo",17196,8908.98,23023,"Baixo Jaguaribe",2,"Nordeste",0,"230070",5,13,3,10,7,6,0,0,0,0,0,13,3,10,7,6,5,9.09481503579726,9.75243207761617,0.443926284521161,31
"1825","CE","Amontada",43829,10090.68,23008,"Itapipoca",2,"Nordeste",0,"230075",2,44,11,33,20,24,0,0,0,0,0,44,11,33,20,24,14,9.21936750453569,10.6880509777294,0.307119550572126,29
"1826","CE","Amontada",43829,10090.68,23008,"Itapipoca",2,"Nordeste",0,"230075",3,57,16,41,28,29,1,1,0,0,1,58,17,41,28,30,20,9.21936750453569,10.6880509777294,0.424827366621894,31
"1827","CE","Amontada",43829,10090.68,23008,"Itapipoca",2,"Nordeste",0,"230075",4,55,15,40,22,33,1,0,1,0,1,56,15,41,22,34,15,9.21936750453569,10.6880509777294,0.4397282725909,30
"1828","CE","Amontada",43829,10090.68,23008,"Itapipoca",2,"Nordeste",0,"230075",5,30,7,23,14,16,0,0,0,0,0,30,7,23,14,16,31,9.21936750453569,10.6880509777294,0.493123716864828,31
"1829","CE","Antonina do Norte",7378,7290.2,23027,"Várzea Alegre",2,"Nordeste",0,"230080",2,10,7,3,6,4,0,0,0,0,0,10,7,3,6,4,4,8.89428625946863,8.90625787815662,0.264734308360197,29
"1830","CE","Antonina do Norte",7378,7290.2,23027,"Várzea Alegre",2,"Nordeste",0,"230080",3,10,3,7,2,8,0,0,0,0,0,10,3,7,2,8,3,8.89428625946863,8.90625787815662,0.354249689281733,31
"1831","CE","Antonina do Norte",7378,7290.2,23027,"Várzea Alegre",2,"Nordeste",0,"230080",4,8,2,6,4,4,1,0,1,0,1,9,2,7,4,5,5,8.89428625946863,8.90625787815662,0.379649795942183,30
"1832","CE","Antonina do Norte",7378,7290.2,23027,"Várzea Alegre",2,"Nordeste",0,"230080",5,7,2,5,4,3,0,0,0,0,0,7,2,5,4,3,0,8.89428625946863,8.90625787815662,0.386374635692875,31
"1833","CE","Apuiarés",14672,6805.1,23011,"Médio Curu",2,"Nordeste",0,"230090",2,12,6,6,2,10,0,0,0,0,0,12,6,6,2,10,10,8.82542761005474,9.59369619449625,0.304800118818776,29
"1834","CE","Apuiarés",14672,6805.1,23011,"Médio Curu",2,"Nordeste",0,"230090",3,10,2,8,3,7,0,0,0,0,0,10,2,8,3,7,7,8.82542761005474,9.59369619449625,0.42044765364369,31
"1835","CE","Apuiarés",14672,6805.1,23011,"Médio Curu",2,"Nordeste",0,"230090",4,11,1,10,6,5,0,0,0,0,0,11,1,10,6,5,10,8.82542761005474,9.59369619449625,0.429989660014734,30
"1836","CE","Apuiarés",14672,6805.1,23011,"Médio Curu",2,"Nordeste",0,"230090",5,10,4,6,5,5,0,0,0,0,0,10,4,6,5,5,13,8.82542761005474,9.59369619449625,0.495286441581284,31
"1837","CE","Aquiraz",80935,24630.33,23016,"Fortaleza",2,"Nordeste",1,"230100",2,36,11,25,14,22,0,0,0,0,0,36,11,25,14,22,55,10.1117338893196,11.3014016423681,0.306918587520023,29
"1838","CE","Aquiraz",80935,24630.33,23016,"Fortaleza",2,"Nordeste",1,"230100",3,45,14,31,20,25,0,0,0,0,0,45,14,31,20,25,56,10.1117338893196,11.3014016423681,0.41865849373783,31
"1839","CE","Aquiraz",80935,24630.33,23016,"Fortaleza",2,"Nordeste",1,"230100",4,33,12,21,18,15,1,1,0,1,0,34,13,21,19,15,47,10.1117338893196,11.3014016423681,0.477071766115249,30
"1840","CE","Aquiraz",80935,24630.33,23016,"Fortaleza",2,"Nordeste",1,"230100",5,40,9,31,13,27,0,0,0,0,0,40,9,31,13,27,80,10.1117338893196,11.3014016423681,0.477023062399028,31
"1841","CE","Aracati",74975,15210.71,23022,"Litoral de Aracati",2,"Nordeste",1,"230110",2,65,20,45,28,37,1,0,1,1,0,66,20,46,29,37,32,9.62975506397978,11.2249100036172,0.295404579242083,29
"1842","CE","Aracati",74975,15210.71,23022,"Litoral de Aracati",2,"Nordeste",1,"230110",3,75,15,60,34,41,1,0,1,1,0,76,15,61,35,41,43,9.62975506397978,11.2249100036172,0.415015269038487,31
"1843","CE","Aracati",74975,15210.71,23022,"Litoral de Aracati",2,"Nordeste",1,"230110",4,63,17,46,25,38,0,0,0,0,0,63,17,46,25,38,38,9.62975506397978,11.2249100036172,0.456523633189675,30
"1844","CE","Aracati",74975,15210.71,23022,"Litoral de Aracati",2,"Nordeste",1,"230110",5,49,17,32,18,31,0,0,0,0,0,49,17,32,18,31,61,9.62975506397978,11.2249100036172,0.466517337035409,31
"1845","CE","Aracoiaba",26535,7457.75,23013,"Baturité",2,"Nordeste",0,"230120",2,28,9,19,8,20,0,0,0,0,0,28,9,19,8,20,20,8.9170090391257,10.186219895262,0.317536843955054,29
"1846","CE","Aracoiaba",26535,7457.75,23013,"Baturité",2,"Nordeste",0,"230120",3,16,7,9,6,10,0,0,0,0,0,16,7,9,6,10,32,8.9170090391257,10.186219895262,0.430489843882011,31
"1847","CE","Aracoiaba",26535,7457.75,23013,"Baturité",2,"Nordeste",0,"230120",4,18,6,12,7,11,0,0,0,0,0,18,6,12,7,11,18,8.9170090391257,10.186219895262,0.477152369959348,30
"1848","CE","Aracoiaba",26535,7457.75,23013,"Baturité",2,"Nordeste",0,"230120",5,21,9,12,7,14,0,0,0,0,0,21,9,12,7,14,23,8.9170090391257,10.186219895262,0.504735132586046,31
"1849","CE","Ararendá",10959,7162.31,23018,"Sertão de Cratéus",2,"Nordeste",0,"230125",2,3,1,2,1,2,0,0,0,0,0,3,1,2,1,2,11,8.87658783362054,9.30191631546339,0.308458483574897,29
"1850","CE","Ararendá",10959,7162.31,23018,"Sertão de Cratéus",2,"Nordeste",0,"230125",3,1,1,0,0,1,1,1,0,0,1,2,2,0,0,2,5,8.87658783362054,9.30191631546339,0.424632707419847,31
"1851","CE","Ararendá",10959,7162.31,23018,"Sertão de Cratéus",2,"Nordeste",0,"230125",4,3,2,1,0,3,0,0,0,0,0,3,2,1,0,3,7,8.87658783362054,9.30191631546339,0.45990374553729,30
"1852","CE","Ararendá",10959,7162.31,23018,"Sertão de Cratéus",2,"Nordeste",0,"230125",5,2,1,1,1,1,0,0,0,0,0,2,1,1,1,1,9,8.87658783362054,9.30191631546339,0.464976025239694,31
"1853","CE","Araripe",21654,6724.7,23029,"Chapada do Araripe",2,"Nordeste",0,"230130",2,21,9,12,15,6,0,0,0,0,0,21,9,12,15,6,11,8.81354259380957,9.98294547387084,0.27877935016326,29
"1854","CE","Araripe",21654,6724.7,23029,"Chapada do Araripe",2,"Nordeste",0,"230130",3,22,8,14,9,13,0,0,0,0,0,22,8,14,9,13,11,8.81354259380957,9.98294547387084,0.384742217281181,31
"1855","CE","Araripe",21654,6724.7,23029,"Chapada do Araripe",2,"Nordeste",0,"230130",4,23,11,12,12,11,1,1,0,0,1,24,12,12,12,12,17,8.81354259380957,9.98294547387084,0.392720986941663,30
"1856","CE","Araripe",21654,6724.7,23029,"Chapada do Araripe",2,"Nordeste",0,"230130",5,30,11,19,21,9,0,0,0,0,0,30,11,19,21,9,14,8.81354259380957,9.98294547387084,0.407593379167036,31
"1857","CE","Aratuba",11802,11444.89,23013,"Baturité",2,"Nordeste",0,"230140",2,12,2,10,3,9,0,0,0,0,0,12,2,10,3,9,6,9.34529862115656,9.37602428761711,0.325734992054815,29
"1858","CE","Aratuba",11802,11444.89,23013,"Baturité",2,"Nordeste",0,"230140",3,4,1,3,0,4,1,0,1,0,1,5,1,4,0,5,9,9.34529862115656,9.37602428761711,0.417293494876912,31
"1859","CE","Aratuba",11802,11444.89,23013,"Baturité",2,"Nordeste",0,"230140",4,9,0,9,3,6,0,0,0,0,0,9,0,9,3,6,6,9.34529862115656,9.37602428761711,0.446697134884966,30
"1860","CE","Aratuba",11802,11444.89,23013,"Baturité",2,"Nordeste",0,"230140",5,15,4,11,6,9,0,0,0,0,0,15,4,11,6,9,12,9.34529862115656,9.37602428761711,0.47596260909096,31
"1861","CE","Arneiroz",7844,6907.11,23020,"Sertão de Inhamuns",2,"Nordeste",0,"230150",2,5,0,5,3,2,0,0,0,0,0,5,0,5,3,2,6,8.84030659483446,8.96750418731624,0.27874854287497,29
"1862","CE","Arneiroz",7844,6907.11,23020,"Sertão de Inhamuns",2,"Nordeste",0,"230150",3,8,5,3,4,4,0,0,0,0,0,8,5,3,4,4,3,8.84030659483446,8.96750418731624,0.391651635049572,31
"1863","CE","Arneiroz",7844,6907.11,23020,"Sertão de Inhamuns",2,"Nordeste",0,"230150",4,5,1,4,1,4,0,0,0,0,0,5,1,4,1,4,5,8.84030659483446,8.96750418731624,0.417907034253472,30
"1864","CE","Arneiroz",7844,6907.11,23020,"Sertão de Inhamuns",2,"Nordeste",0,"230150",5,8,3,5,2,6,0,0,0,0,0,8,3,5,2,6,5,8.84030659483446,8.96750418731624,0.434376204750868,31
"1865","CE","Assaré",23478,6947.09,23029,"Chapada do Araripe",2,"Nordeste",0,"230160",2,16,6,10,5,11,3,3,0,0,3,19,9,10,5,14,15,8.84607814584144,10.0638190914385,0.27201453236318,29
"1866","CE","Assaré",23478,6947.09,23029,"Chapada do Araripe",2,"Nordeste",0,"230160",3,25,10,15,8,17,1,1,0,0,1,26,11,15,8,18,11,8.84607814584144,10.0638190914385,0.359716007911007,31
"1867","CE","Assaré",23478,6947.09,23029,"Chapada do Araripe",2,"Nordeste",0,"230160",4,13,3,10,6,7,0,0,0,0,0,13,3,10,6,7,15,8.84607814584144,10.0638190914385,0.383487255654,30
"1868","CE","Assaré",23478,6947.09,23029,"Chapada do Araripe",2,"Nordeste",0,"230160",5,27,8,19,8,19,0,0,0,0,0,27,8,19,8,19,14,8.84607814584144,10.0638190914385,0.389457006894308,31
"1869","CE","Aurora",24610,7511.26,23031,"Barro",2,"Nordeste",0,"230170",2,18,3,15,8,10,0,0,0,0,0,18,3,15,8,10,6,8.92415850698358,10.1109081433851,0.256468297100271,29
"1870","CE","Aurora",24610,7511.26,23031,"Barro",2,"Nordeste",0,"230170",3,40,21,19,17,23,0,0,0,0,0,40,21,19,17,23,9,8.92415850698358,10.1109081433851,0.358340544752033,31
"1871","CE","Aurora",24610,7511.26,23031,"Barro",2,"Nordeste",0,"230170",4,25,11,14,13,12,0,0,0,0,0,25,11,14,13,12,15,8.92415850698358,10.1109081433851,0.379120277001175,30
"1872","CE","Aurora",24610,7511.26,23031,"Barro",2,"Nordeste",0,"230170",5,24,8,16,11,13,0,0,0,0,0,24,8,16,11,13,10,8.92415850698358,10.1109081433851,0.417500874179106,31
"1873","CE","Banabuiú",18256,8874.99,23019,"Sertão de Quixeramobim",2,"Nordeste",0,"230185",2,7,2,5,1,6,0,0,0,0,0,7,2,5,1,6,7,9.09099248758242,9.81224907210186,0.276950455664902,29
"1874","CE","Banabuiú",18256,8874.99,23019,"Sertão de Quixeramobim",2,"Nordeste",0,"230185",3,6,3,3,2,4,0,0,0,0,0,6,3,3,2,4,9,9.09099248758242,9.81224907210186,0.38334426072474,31
"1875","CE","Banabuiú",18256,8874.99,23019,"Sertão de Quixeramobim",2,"Nordeste",0,"230185",4,4,3,1,3,1,0,0,0,0,0,4,3,1,3,1,8,9.09099248758242,9.81224907210186,0.423813719679826,30
"1876","CE","Banabuiú",18256,8874.99,23019,"Sertão de Quixeramobim",2,"Nordeste",0,"230185",5,3,1,2,1,2,0,0,0,0,0,3,1,2,1,2,6,9.09099248758242,9.81224907210186,0.438508357403494,31
"1877","CE","Barbalha",61228,14320.84,23032,"Cariri",2,"Nordeste",1,"230190",2,108,19,89,39,69,1,0,1,0,1,109,19,90,39,70,35,9.56947109801213,11.0223598802116,0.278753666236301,29
"1878","CE","Barbalha",61228,14320.84,23032,"Cariri",2,"Nordeste",1,"230190",3,94,19,75,35,59,0,0,0,0,0,94,19,75,35,59,49,9.56947109801213,11.0223598802116,0.392784475510769,31
"1879","CE","Barbalha",61228,14320.84,23032,"Cariri",2,"Nordeste",1,"230190",4,91,21,70,36,55,1,0,1,0,1,92,21,71,36,56,41,9.56947109801213,11.0223598802116,0.430796966133914,30
"1880","CE","Barbalha",61228,14320.84,23032,"Cariri",2,"Nordeste",1,"230190",5,98,27,71,33,65,0,0,0,0,0,98,27,71,33,65,34,9.56947109801213,11.0223598802116,0.412701012983956,31
"1881","CE","Barreira",22573,6958.94,23014,"Chorozinho",2,"Nordeste",0,"230195",2,17,8,9,10,7,0,0,0,0,0,17,8,9,10,7,10,8.84778244287924,10.0245097807836,0.295586528771969,29
"1882","CE","Barreira",22573,6958.94,23014,"Chorozinho",2,"Nordeste",0,"230195",3,23,7,16,10,13,0,0,0,0,0,23,7,16,10,13,17,8.84778244287924,10.0245097807836,0.412465554554822,31
"1883","CE","Barreira",22573,6958.94,23014,"Chorozinho",2,"Nordeste",0,"230195",4,19,5,14,5,14,0,0,0,0,0,19,5,14,5,14,15,8.84778244287924,10.0245097807836,0.460495093889397,30
"1884","CE","Barreira",22573,6958.94,23014,"Chorozinho",2,"Nordeste",0,"230195",5,22,6,16,10,12,0,0,0,0,0,22,6,16,10,12,33,8.84778244287924,10.0245097807836,0.467520316413821,31
"1885","CE","Barro",22758,7674.21,23031,"Barro",2,"Nordeste",0,"230200",2,17,6,11,5,12,0,0,0,0,0,17,6,11,5,12,13,8.94562063556149,10.032672010917,0.242489239671392,29
"1886","CE","Barro",22758,7674.21,23031,"Barro",2,"Nordeste",0,"230200",3,14,5,9,5,9,0,0,0,0,0,14,5,9,5,9,18,8.94562063556149,10.032672010917,0.374750244245078,31
"1887","CE","Barro",22758,7674.21,23031,"Barro",2,"Nordeste",0,"230200",4,19,6,13,8,11,0,0,0,0,0,19,6,13,8,11,8,8.94562063556149,10.032672010917,0.378763314527909,30
"1888","CE","Barro",22758,7674.21,23031,"Barro",2,"Nordeste",0,"230200",5,21,6,15,6,15,0,0,0,0,0,21,6,15,6,15,12,8.94562063556149,10.032672010917,0.436050231062597,31
"1889","CE","Barroquinha",15044,6662.58,23001,"Litoral de Camocim e Acaraú",2,"Nordeste",0,"230205",2,23,7,16,9,14,0,0,0,0,0,23,7,16,9,14,12,8.8042620759067,9.61873451959023,0.28763262508052,29
"1890","CE","Barroquinha",15044,6662.58,23001,"Litoral de Camocim e Acaraú",2,"Nordeste",0,"230205",3,11,5,6,5,6,0,0,0,0,0,11,5,6,5,6,6,8.8042620759067,9.61873451959023,0.412227677740854,31
"1891","CE","Barroquinha",15044,6662.58,23001,"Litoral de Camocim e Acaraú",2,"Nordeste",0,"230205",4,16,4,12,9,7,0,0,0,0,0,16,4,12,9,7,4,8.8042620759067,9.61873451959023,0.447379103567,30
"1892","CE","Barroquinha",15044,6662.58,23001,"Litoral de Camocim e Acaraú",2,"Nordeste",0,"230205",5,16,7,9,8,8,0,0,0,0,0,16,7,9,8,8,15,8.8042620759067,9.61873451959023,0.456658288442249,31
"1893","CE","Baturité",35941,9114.77,23013,"Baturité",2,"Nordeste",0,"230210",2,35,14,21,11,24,1,0,1,0,1,36,14,22,11,25,18,9.1176514536622,10.4896339841018,0.297753975176919,29
"1894","CE","Baturité",35941,9114.77,23013,"Baturité",2,"Nordeste",0,"230210",3,26,7,19,12,14,1,1,0,0,1,27,8,19,12,15,21,9.1176514536622,10.4896339841018,0.409057021697268,31
"1895","CE","Baturité",35941,9114.77,23013,"Baturité",2,"Nordeste",0,"230210",4,28,14,14,8,20,0,0,0,0,0,28,14,14,8,20,25,9.1176514536622,10.4896339841018,0.460700013439463,30
"1896","CE","Baturité",35941,9114.77,23013,"Baturité",2,"Nordeste",0,"230210",5,29,8,21,12,17,0,0,0,0,0,29,8,21,12,17,50,9.1176514536622,10.4896339841018,0.49123764970778,31
"1897","CE","Beberibe",53949,13744.68,23015,"Cascavel",2,"Nordeste",0,"230220",2,29,9,20,13,16,0,0,0,0,0,29,9,20,13,16,32,9.52840711913517,10.8957944348333,0.305771483391078,29
"1898","CE","Beberibe",53949,13744.68,23015,"Cascavel",2,"Nordeste",0,"230220",3,24,8,16,11,13,0,0,0,0,0,24,8,16,11,13,29,9.52840711913517,10.8957944348333,0.41843398461606,31
"1899","CE","Beberibe",53949,13744.68,23015,"Cascavel",2,"Nordeste",0,"230220",4,37,15,22,15,22,0,0,0,0,0,37,15,22,15,22,31,9.52840711913517,10.8957944348333,0.475018600515962,30
"1900","CE","Beberibe",53949,13744.68,23015,"Cascavel",2,"Nordeste",0,"230220",5,38,7,31,17,21,0,0,0,0,0,38,7,31,17,21,46,9.52840711913517,10.8957944348333,0.48752835946407,31
"1901","CE","Bela Cruz",32722,7322.64,23001,"Litoral de Camocim e Acaraú",2,"Nordeste",0,"230230",2,41,17,24,16,25,1,1,0,1,0,42,18,24,17,25,15,8.89872619767242,10.395802913543,0.34001268099004,29
"1902","CE","Bela Cruz",32722,7322.64,23001,"Litoral de Camocim e Acaraú",2,"Nordeste",0,"230230",3,26,8,18,15,11,1,0,1,0,1,27,8,19,15,12,21,8.89872619767242,10.395802913543,0.467600909848446,31
"1903","CE","Bela Cruz",32722,7322.64,23001,"Litoral de Camocim e Acaraú",2,"Nordeste",0,"230230",4,21,5,16,9,12,0,0,0,0,0,21,5,16,9,12,17,8.89872619767242,10.395802913543,0.52368517581056,30
"1904","CE","Bela Cruz",32722,7322.64,23001,"Litoral de Camocim e Acaraú",2,"Nordeste",0,"230230",5,24,6,18,9,15,0,0,0,0,0,24,6,18,9,15,23,8.89872619767242,10.395802913543,0.526115666624201,31
"1905","CE","Boa Viagem",54577,7031.15,23019,"Sertão de Quixeramobim",2,"Nordeste",0,"230240",2,41,13,28,19,22,0,0,0,0,0,41,13,28,19,22,32,8.85810555606347,10.907367827563,0.310590399617967,29
"1906","CE","Boa Viagem",54577,7031.15,23019,"Sertão de Quixeramobim",2,"Nordeste",0,"230240",3,42,14,28,16,26,0,0,0,0,0,42,14,28,16,26,30,8.85810555606347,10.907367827563,0.384029391772975,31
"1907","CE","Boa Viagem",54577,7031.15,23019,"Sertão de Quixeramobim",2,"Nordeste",0,"230240",4,53,17,36,21,32,1,0,1,0,1,54,17,37,21,33,43,8.85810555606347,10.907367827563,0.408367827181978,30
"1908","CE","Boa Viagem",54577,7031.15,23019,"Sertão de Quixeramobim",2,"Nordeste",0,"230240",5,38,18,20,19,19,3,3,0,1,2,41,21,20,20,21,40,8.85810555606347,10.907367827563,0.44894962401506,31
"1909","CE","Brejo Santo",49842,10248.61,23033,"Brejo Santo",2,"Nordeste",1,"230250",2,47,13,34,18,29,1,0,1,1,0,48,13,35,19,29,27,9.23489736561462,10.8166132810671,0.27046292036774,29
"1910","CE","Brejo Santo",49842,10248.61,23033,"Brejo Santo",2,"Nordeste",1,"230250",3,61,21,40,26,35,1,0,1,0,1,62,21,41,26,36,21,9.23489736561462,10.8166132810671,0.390067222453131,31
"1911","CE","Brejo Santo",49842,10248.61,23033,"Brejo Santo",2,"Nordeste",1,"230250",4,57,9,48,30,27,0,0,0,0,0,57,9,48,30,27,32,9.23489736561462,10.8166132810671,0.411520816100482,30
"1912","CE","Brejo Santo",49842,10248.61,23033,"Brejo Santo",2,"Nordeste",1,"230250",5,59,20,39,24,35,0,0,0,0,0,59,20,39,24,35,22,9.23489736561462,10.8166132810671,0.39990935692081,31
"1913","CE","Camocim",63907,9005.04,23001,"Litoral de Camocim e Acaraú",2,"Nordeste",1,"230260",2,73,30,43,37,36,1,1,0,0,1,74,31,43,37,37,36,9.10553969957687,11.0651841805318,0.284629508466964,29
"1914","CE","Camocim",63907,9005.04,23001,"Litoral de Camocim e Acaraú",2,"Nordeste",1,"230260",3,83,31,52,35,48,0,0,0,0,0,83,31,52,35,48,37,9.10553969957687,11.0651841805318,0.393307930169582,31
"1915","CE","Camocim",63907,9005.04,23001,"Litoral de Camocim e Acaraú",2,"Nordeste",1,"230260",4,77,31,46,34,43,2,0,2,1,1,79,31,48,35,44,26,9.10553969957687,11.0651841805318,0.427815193349384,30
"1916","CE","Camocim",63907,9005.04,23001,"Litoral de Camocim e Acaraú",2,"Nordeste",1,"230260",5,62,24,38,30,32,0,0,0,0,0,62,24,38,30,32,65,9.10553969957687,11.0651841805318,0.456443414473084,31
"1917","CE","Campos Sales",27470,6896.85,23029,"Chapada do Araripe",2,"Nordeste",0,"230270",2,29,9,20,8,21,1,0,1,0,1,30,9,21,8,22,27,8.83882006460844,10.2208497790893,0.246907223939324,29
"1918","CE","Campos Sales",27470,6896.85,23029,"Chapada do Araripe",2,"Nordeste",0,"230270",3,16,5,11,8,8,1,0,1,1,0,17,5,12,9,8,20,8.83882006460844,10.2208497790893,0.335449630707805,31
"1919","CE","Campos Sales",27470,6896.85,23029,"Chapada do Araripe",2,"Nordeste",0,"230270",4,32,9,23,12,20,0,0,0,0,0,32,9,23,12,20,20,8.83882006460844,10.2208497790893,0.350687272398535,30
"1920","CE","Campos Sales",27470,6896.85,23029,"Chapada do Araripe",2,"Nordeste",0,"230270",5,21,7,14,7,14,0,0,0,0,0,21,7,14,7,14,18,8.83882006460844,10.2208497790893,0.387482467875305,31
"1921","CE","Canindé",77244,8106.88,23012,"Canindé",2,"Nordeste",1,"230280",2,80,31,49,39,41,1,1,0,0,1,81,32,49,39,42,48,9.00046836285521,11.2547245218406,0.28969937696288,29
"1922","CE","Canindé",77244,8106.88,23012,"Canindé",2,"Nordeste",1,"230280",3,72,25,47,33,39,0,0,0,0,0,72,25,47,33,39,64,9.00046836285521,11.2547245218406,0.401459238377117,31
"1923","CE","Canindé",77244,8106.88,23012,"Canindé",2,"Nordeste",1,"230280",4,77,25,52,36,41,1,0,1,0,1,78,25,53,36,42,44,9.00046836285521,11.2547245218406,0.424173479069757,30
"1924","CE","Canindé",77244,8106.88,23012,"Canindé",2,"Nordeste",1,"230280",5,83,23,60,38,45,0,0,0,0,0,83,23,60,38,45,71,9.00046836285521,11.2547245218406,0.446705370099903,31
"1925","CE","Capistrano",17786,9827.07,23013,"Baturité",2,"Nordeste",0,"230290",2,18,5,13,5,13,0,0,0,0,0,18,5,13,5,13,7,9.19289610156897,9.78616690995958,0.323585758211605,29
"1926","CE","Capistrano",17786,9827.07,23013,"Baturité",2,"Nordeste",0,"230290",3,13,2,11,5,8,0,0,0,0,0,13,2,11,5,8,21,9.19289610156897,9.78616690995958,0.427636731807861,31
"1927","CE","Capistrano",17786,9827.07,23013,"Baturité",2,"Nordeste",0,"230290",4,15,6,9,8,7,0,0,0,0,0,15,6,9,8,7,10,9.19289610156897,9.78616690995958,0.476640797643157,30
"1928","CE","Capistrano",17786,9827.07,23013,"Baturité",2,"Nordeste",0,"230290",5,14,5,9,6,8,0,0,0,0,0,14,5,9,6,8,17,9.19289610156897,9.78616690995958,0.514151248217758,31
"1929","CE","Caridade",22782,5631.24,23012,"Canindé",2,"Nordeste",0,"230300",2,12,8,4,4,8,0,0,0,0,0,12,8,4,4,8,7,8.63608494555041,10.0337260294599,0.340563823242129,29
"1930","CE","Caridade",22782,5631.24,23012,"Canindé",2,"Nordeste",0,"230300",3,16,10,6,7,9,0,0,0,0,0,16,10,6,7,9,7,8.63608494555041,10.0337260294599,0.432283531343495,31
"1931","CE","Caridade",22782,5631.24,23012,"Canindé",2,"Nordeste",0,"230300",4,20,11,9,10,10,0,0,0,0,0,20,11,9,10,10,13,8.63608494555041,10.0337260294599,0.479449405757405,30
"1932","CE","Caridade",22782,5631.24,23012,"Canindé",2,"Nordeste",0,"230300",5,19,9,10,3,16,0,0,0,0,0,19,9,10,3,16,15,8.63608494555041,10.0337260294599,0.497812109432463,31
"1933","CE","Cariré",18459,8062.68,23005,"Sobral",2,"Nordeste",0,"230310",2,26,7,19,11,15,0,0,0,0,0,26,7,19,11,15,9,8.99500128643621,9.8233073354086,0.294648331579684,29
"1934","CE","Cariré",18459,8062.68,23005,"Sobral",2,"Nordeste",0,"230310",3,27,8,19,13,14,0,0,0,0,0,27,8,19,13,14,12,8.99500128643621,9.8233073354086,0.396159076352712,31
"1935","CE","Cariré",18459,8062.68,23005,"Sobral",2,"Nordeste",0,"230310",4,12,3,9,6,6,0,0,0,0,0,12,3,9,6,6,8,8.99500128643621,9.8233073354086,0.405436369978589,30
"1936","CE","Cariré",18459,8062.68,23005,"Sobral",2,"Nordeste",0,"230310",5,16,3,13,5,11,0,0,0,0,0,16,3,13,5,11,14,8.99500128643621,9.8233073354086,0.475504383661314,31
"1937","CE","Caririaçu",26987,7476.01,23030,"Caririaçu",2,"Nordeste",0,"230320",2,29,11,18,14,15,1,0,1,0,1,30,11,19,14,16,14,8.91945450618826,10.2031105475556,0.265811509919071,29
"1938","CE","Caririaçu",26987,7476.01,23030,"Caririaçu",2,"Nordeste",0,"230320",3,33,11,22,15,18,1,0,1,1,0,34,11,23,16,18,26,8.91945450618826,10.2031105475556,0.354646070479979,31
"1939","CE","Caririaçu",26987,7476.01,23030,"Caririaçu",2,"Nordeste",0,"230320",4,22,7,15,14,8,0,0,0,0,0,22,7,15,14,8,19,8.91945450618826,10.2031105475556,0.405832600806539,30
"1940","CE","Caririaçu",26987,7476.01,23030,"Caririaçu",2,"Nordeste",0,"230320",5,31,6,25,13,18,0,0,0,0,0,31,6,25,13,18,20,8.91945450618826,10.2031105475556,0.407745654205393,31
"1941","CE","Cariús",18699,7267.16,23027,"Várzea Alegre",2,"Nordeste",0,"230330",2,7,2,5,5,2,0,0,0,0,0,7,2,5,5,2,12,8.89112084771291,9.83622532547696,0.290919527460932,29
"1942","CE","Cariús",18699,7267.16,23027,"Várzea Alegre",2,"Nordeste",0,"230330",3,17,6,11,5,12,2,1,1,1,1,19,7,12,6,13,18,8.89112084771291,9.83622532547696,0.395825515303312,31
"1943","CE","Cariús",18699,7267.16,23027,"Várzea Alegre",2,"Nordeste",0,"230330",4,11,4,7,6,5,0,0,0,0,0,11,4,7,6,5,13,8.89112084771291,9.83622532547696,0.437934011642013,30
"1944","CE","Cariús",18699,7267.16,23027,"Várzea Alegre",2,"Nordeste",0,"230330",5,8,3,5,4,4,0,0,0,0,0,8,3,5,4,4,11,8.89112084771291,9.83622532547696,0.447246737462362,31
"1945","CE","Carnaubal",17685,6609.89,23002,"Ibiapaba",2,"Nordeste",0,"230340",2,19,8,11,5,14,0,0,0,0,0,19,8,11,5,14,8,8.79632229125492,9.78047210163958,0.283156862499781,29
"1946","CE","Carnaubal",17685,6609.89,23002,"Ibiapaba",2,"Nordeste",0,"230340",3,14,7,7,7,7,0,0,0,0,0,14,7,7,7,7,3,8.79632229125492,9.78047210163958,0.413227627848718,31
"1947","CE","Carnaubal",17685,6609.89,23002,"Ibiapaba",2,"Nordeste",0,"230340",4,8,3,5,7,1,0,0,0,0,0,8,3,5,7,1,13,8.79632229125492,9.78047210163958,0.446875163788842,30
"1948","CE","Carnaubal",17685,6609.89,23002,"Ibiapaba",2,"Nordeste",0,"230340",5,21,3,18,12,9,0,0,0,0,0,21,3,18,12,9,9,8.79632229125492,9.78047210163958,0.430788724064131,31
"1949","CE","Cascavel",72232,10317.32,23015,"Cascavel",2,"Nordeste",1,"230350",2,64,29,35,29,35,0,0,0,0,0,64,29,35,29,35,41,9.24157931538781,11.1876384399873,0.288740135777243,29
"1950","CE","Cascavel",72232,10317.32,23015,"Cascavel",2,"Nordeste",1,"230350",3,55,18,37,25,30,1,0,1,1,0,56,18,38,26,30,48,9.24157931538781,11.1876384399873,0.397117645402008,31
"1951","CE","Cascavel",72232,10317.32,23015,"Cascavel",2,"Nordeste",1,"230350",4,57,22,35,34,23,1,1,0,0,1,58,23,35,34,24,51,9.24157931538781,11.1876384399873,0.442636833542978,30
"1952","CE","Cascavel",72232,10317.32,23015,"Cascavel",2,"Nordeste",1,"230350",5,72,19,53,34,38,2,0,2,0,2,74,19,55,34,40,122,9.24157931538781,11.1876384399873,0.4677714507863,31
"1953","CE","Catarina",20871,5797.02,23020,"Sertão de Inhamuns",2,"Nordeste",0,"230360",2,13,6,7,6,7,0,0,0,0,0,13,6,7,6,7,5,8.66509927139416,9.94611591459175,0.271561208693406,29
"1954","CE","Catarina",20871,5797.02,23020,"Sertão de Inhamuns",2,"Nordeste",0,"230360",3,12,5,7,4,8,0,0,0,0,0,12,5,7,4,8,2,8.66509927139416,9.94611591459175,0.331191373153991,31
"1955","CE","Catarina",20871,5797.02,23020,"Sertão de Inhamuns",2,"Nordeste",0,"230360",4,7,2,5,4,3,0,0,0,0,0,7,2,5,4,3,11,8.66509927139416,9.94611591459175,0.376662202733863,30
"1956","CE","Catarina",20871,5797.02,23020,"Sertão de Inhamuns",2,"Nordeste",0,"230360",5,10,3,7,5,5,0,0,0,0,0,10,3,7,5,5,8,8.66509927139416,9.94611591459175,0.390514338606697,31
"1957","CE","Catunda",10376,7723.1,23007,"Santa Quitéria",2,"Nordeste",0,"230365",2,9,5,4,4,5,0,0,0,0,0,9,5,4,4,5,6,8.95197111682157,9.24725072599628,0.290953703839297,29
"1958","CE","Catunda",10376,7723.1,23007,"Santa Quitéria",2,"Nordeste",0,"230365",3,10,2,8,5,5,0,0,0,0,0,10,2,8,5,5,10,8.95197111682157,9.24725072599628,0.385411394361189,31
"1959","CE","Catunda",10376,7723.1,23007,"Santa Quitéria",2,"Nordeste",0,"230365",4,6,3,3,0,6,0,0,0,0,0,6,3,3,0,6,7,8.95197111682157,9.24725072599628,0.422338203870323,30
"1960","CE","Catunda",10376,7723.1,23007,"Santa Quitéria",2,"Nordeste",0,"230365",5,11,4,7,4,7,0,0,0,0,0,11,4,7,4,7,4,8.95197111682157,9.24725072599628,0.485192266983207,31
"1961","CE","Caucaia",365212,13944.16,23016,"Fortaleza",2,"Nordeste",1,"230370",2,359,110,249,153,206,5,2,3,4,1,364,112,252,157,207,175,9.54281606160333,12.8082332858707,0.315240534412851,29
"1962","CE","Caucaia",365212,13944.16,23016,"Fortaleza",2,"Nordeste",1,"230370",3,335,84,251,132,203,1,1,0,1,0,336,85,251,133,203,210,9.54281606160333,12.8082332858707,0.432131658629937,31
"1963","CE","Caucaia",365212,13944.16,23016,"Fortaleza",2,"Nordeste",1,"230370",4,332,107,225,135,197,6,3,3,2,4,338,110,228,137,201,234,9.54281606160333,12.8082332858707,0.49309872976289,30
"1964","CE","Caucaia",365212,13944.16,23016,"Fortaleza",2,"Nordeste",1,"230370",5,362,89,273,148,214,3,1,2,2,1,365,90,275,150,215,464,9.54281606160333,12.8082332858707,0.48986032383342,31
"1965","CE","Cedro",25585,7130.37,23026,"Iguatu",2,"Nordeste",0,"230380",2,25,7,18,12,13,0,0,0,0,0,25,7,18,12,13,24,8.87211840547006,10.1497615212392,0.263849580527409,29
"1966","CE","Cedro",25585,7130.37,23026,"Iguatu",2,"Nordeste",0,"230380",3,19,9,10,10,9,1,0,1,0,1,20,9,11,10,10,26,8.87211840547006,10.1497615212392,0.358422216045885,31
"1967","CE","Cedro",25585,7130.37,23026,"Iguatu",2,"Nordeste",0,"230380",4,14,8,6,5,9,0,0,0,0,0,14,8,6,5,9,14,8.87211840547006,10.1497615212392,0.393890011175743,30
"1968","CE","Cedro",25585,7130.37,23026,"Iguatu",2,"Nordeste",0,"230380",5,18,6,12,7,11,0,0,0,0,0,18,6,12,7,11,23,8.87211840547006,10.1497615212392,0.396773045609464,31
"1969","CE","Chaval",13091,6202.22,23001,"Litoral de Camocim e Acaraú",2,"Nordeste",0,"230390",2,21,2,19,8,13,1,0,1,1,0,22,2,20,9,13,9,8.73266257145951,9.4796802501801,0.303622743836971,29
"1970","CE","Chaval",13091,6202.22,23001,"Litoral de Camocim e Acaraú",2,"Nordeste",0,"230390",3,10,5,5,4,6,0,0,0,0,0,10,5,5,4,6,7,8.73266257145951,9.4796802501801,0.415389107287856,31
"1971","CE","Chaval",13091,6202.22,23001,"Litoral de Camocim e Acaraú",2,"Nordeste",0,"230390",4,9,3,6,5,4,0,0,0,0,0,9,3,6,5,4,6,8.73266257145951,9.4796802501801,0.416695305545752,30
"1972","CE","Chaval",13091,6202.22,23001,"Litoral de Camocim e Acaraú",2,"Nordeste",0,"230390",5,9,4,5,5,4,0,0,0,0,0,9,4,5,5,4,11,8.73266257145951,9.4796802501801,0.454465505935691,31
"1973","CE","Chorozinho",20274,18237.69,23014,"Chorozinho",2,"Nordeste",0,"230395",2,17,6,11,7,10,0,0,0,0,0,17,6,11,7,10,8,9.81124561087136,9.91709455594235,0.286646090001614,29
"1974","CE","Chorozinho",20274,18237.69,23014,"Chorozinho",2,"Nordeste",0,"230395",3,26,13,13,14,12,0,0,0,0,0,26,13,13,14,12,16,9.81124561087136,9.91709455594235,0.401981049071779,31
"1975","CE","Chorozinho",20274,18237.69,23014,"Chorozinho",2,"Nordeste",0,"230395",4,9,3,6,3,6,1,0,1,0,1,10,3,7,3,7,15,9.81124561087136,9.91709455594235,0.453424690365171,30
"1976","CE","Chorozinho",20274,18237.69,23014,"Chorozinho",2,"Nordeste",0,"230395",5,24,7,17,9,15,0,0,0,0,0,24,7,17,9,15,30,9.81124561087136,9.91709455594235,0.486349301399205,31
"1977","CE","Coreaú",23239,6233.8,23003,"Coreaú",2,"Nordeste",0,"230400",2,28,11,17,10,18,0,0,0,0,0,28,11,17,10,18,7,8.73774137768239,10.0535871807802,0.293841631303813,29
"1978","CE","Coreaú",23239,6233.8,23003,"Coreaú",2,"Nordeste",0,"230400",3,18,2,16,5,13,0,0,0,0,0,18,2,16,5,13,11,8.73774137768239,10.0535871807802,0.409476759396987,31
"1979","CE","Coreaú",23239,6233.8,23003,"Coreaú",2,"Nordeste",0,"230400",4,24,12,12,10,14,0,0,0,0,0,24,12,12,10,14,17,8.73774137768239,10.0535871807802,0.472898866433848,30
"1980","CE","Coreaú",23239,6233.8,23003,"Coreaú",2,"Nordeste",0,"230400",5,28,10,18,8,20,0,0,0,0,0,28,10,18,8,20,14,8.73774137768239,10.0535871807802,0.492257018564697,31
"1981","CE","Crateús",75159,9105.67,23018,"Sertão de Cratéus",2,"Nordeste",1,"230410",2,2,1,1,1,1,0,0,0,0,0,2,1,1,1,1,49,9.11665257539619,11.2273611484894,0.276558702660799,29
"1982","CE","Crateús",75159,9105.67,23018,"Sertão de Cratéus",2,"Nordeste",1,"230410",3,2,1,1,2,0,0,0,0,0,0,2,1,1,2,0,54,9.11665257539619,11.2273611484894,0.38329087873959,31
"1983","CE","Crateús",75159,9105.67,23018,"Sertão de Cratéus",2,"Nordeste",1,"230410",4,4,1,3,0,4,1,0,1,0,1,5,1,4,0,5,54,9.11665257539619,11.2273611484894,0.427604801471542,30
"1984","CE","Crateús",75159,9105.67,23018,"Sertão de Cratéus",2,"Nordeste",1,"230410",5,11,3,8,5,6,0,0,0,0,0,11,3,8,5,6,55,9.11665257539619,11.2273611484894,0.424394662521117,31
"1985","CE","Crato",133031,10262.41,23032,"Cariri",2,"Nordeste",1,"230420",2,167,42,125,59,108,1,0,1,0,1,168,42,126,59,109,94,9.23624298392929,11.7983374627511,0.283787508629116,29
"1986","CE","Crato",133031,10262.41,23032,"Cariri",2,"Nordeste",1,"230420",3,171,43,128,71,100,2,0,2,0,2,173,43,130,71,102,64,9.23624298392929,11.7983374627511,0.399939437853426,31
"1987","CE","Crato",133031,10262.41,23032,"Cariri",2,"Nordeste",1,"230420",4,153,33,120,70,83,1,1,0,0,1,154,34,120,70,84,65,9.23624298392929,11.7983374627511,0.457173804103609,30
"1988","CE","Crato",133031,10262.41,23032,"Cariri",2,"Nordeste",1,"230420",5,165,47,118,67,98,5,2,3,2,3,170,49,121,69,101,87,9.23624298392929,11.7983374627511,0.427588385528531,31
"1989","CE","Croatá",18133,7696.46,23002,"Ibiapaba",2,"Nordeste",0,"230423",2,24,5,19,10,14,0,0,0,0,0,24,5,19,10,14,12,8.94851576186908,9.80548876165403,0.326345206713473,29
"1990","CE","Croatá",18133,7696.46,23002,"Ibiapaba",2,"Nordeste",0,"230423",3,12,3,9,4,8,0,0,0,0,0,12,3,9,4,8,19,8.94851576186908,9.80548876165403,0.412646863726562,31
"1991","CE","Croatá",18133,7696.46,23002,"Ibiapaba",2,"Nordeste",0,"230423",4,16,4,12,7,9,1,0,1,0,1,17,4,13,7,10,6,8.94851576186908,9.80548876165403,0.435685875784159,30
"1992","CE","Croatá",18133,7696.46,23002,"Ibiapaba",2,"Nordeste",0,"230423",5,18,7,11,12,6,0,0,0,0,0,18,7,11,12,6,15,8.94851576186908,9.80548876165403,0.439756994725858,31
"1993","CE","Cruz",24977,8946,23001,"Litoral de Camocim e Acaraú",2,"Nordeste",0,"230425",2,36,13,23,10,26,0,0,0,0,0,36,13,23,10,26,15,9.09896178399279,10.1257106803906,0.292556428410506,29
"1994","CE","Cruz",24977,8946,23001,"Litoral de Camocim e Acaraú",2,"Nordeste",0,"230425",3,36,10,26,11,25,0,0,0,0,0,36,10,26,11,25,10,9.09896178399279,10.1257106803906,0.402497686275443,31
"1995","CE","Cruz",24977,8946,23001,"Litoral de Camocim e Acaraú",2,"Nordeste",0,"230425",4,30,8,22,13,17,0,0,0,0,0,30,8,22,13,17,10,9.09896178399279,10.1257106803906,0.449427069199698,30
"1996","CE","Cruz",24977,8946,23001,"Litoral de Camocim e Acaraú",2,"Nordeste",0,"230425",5,55,17,38,18,37,0,0,0,0,0,55,17,38,18,37,15,9.09896178399279,10.1257106803906,0.463604918624421,31
"1997","CE","Deputado Irapuan Pinheiro",9662,6413.75,23021,"Sertão de Senador Pompeu",2,"Nordeste",0,"230426",2,1,0,1,0,1,0,0,0,0,0,1,0,1,0,1,2,8.76619940225618,9.17595594511435,0.310198848706073,29
"1998","CE","Deputado Irapuan Pinheiro",9662,6413.75,23021,"Sertão de Senador Pompeu",2,"Nordeste",0,"230426",3,4,2,2,1,3,0,0,0,0,0,4,2,2,1,3,9,8.76619940225618,9.17595594511435,0.39473334759803,31
"1999","CE","Deputado Irapuan Pinheiro",9662,6413.75,23021,"Sertão de Senador Pompeu",2,"Nordeste",0,"230426",4,3,1,2,2,1,0,0,0,0,0,3,1,2,2,1,5,8.76619940225618,9.17595594511435,0.386063271679187,30
"2000","CE","Deputado Irapuan Pinheiro",9662,6413.75,23021,"Sertão de Senador Pompeu",2,"Nordeste",0,"230426",5,6,0,6,1,5,0,0,0,0,0,6,0,6,1,5,5,8.76619940225618,9.17595594511435,0.388852431896629,31
"2001","CE","Ereré",7225,6983.79,23025,"Serra do Pereiro",2,"Nordeste",0,"230427",2,3,0,3,3,0,0,0,0,0,0,3,0,3,3,0,3,8.85134702833884,8.88530251298063,0.260933385670139,29
"2002","CE","Ereré",7225,6983.79,23025,"Serra do Pereiro",2,"Nordeste",0,"230427",3,3,1,2,2,1,0,0,0,0,0,3,1,2,2,1,4,8.85134702833884,8.88530251298063,0.33517475719274,31
"2003","CE","Ereré",7225,6983.79,23025,"Serra do Pereiro",2,"Nordeste",0,"230427",4,4,1,3,1,3,0,0,0,0,0,4,1,3,1,3,5,8.85134702833884,8.88530251298063,0.380678650615134,30
"2004","CE","Ereré",7225,6983.79,23025,"Serra do Pereiro",2,"Nordeste",0,"230427",5,3,1,2,0,3,0,0,0,0,0,3,1,2,0,3,4,8.85134702833884,8.88530251298063,0.451220921120826,31
"2005","CE","Eusébio",54337,46830.08,23016,"Fortaleza",2,"Nordeste",1,"230428",2,26,0,26,4,22,1,1,0,0,1,27,1,26,4,23,22,10.7542810104828,10.9029606735064,0.293898021571203,29
"2006","CE","Eusébio",54337,46830.08,23016,"Fortaleza",2,"Nordeste",1,"230428",3,34,2,32,9,25,0,0,0,0,0,34,2,32,9,25,33,10.7542810104828,10.9029606735064,0.415732164573308,31
"2007","CE","Eusébio",54337,46830.08,23016,"Fortaleza",2,"Nordeste",1,"230428",4,23,2,21,3,20,1,0,1,1,0,24,2,22,4,20,50,10.7542810104828,10.9029606735064,0.489352700173375,30
"2008","CE","Eusébio",54337,46830.08,23016,"Fortaleza",2,"Nordeste",1,"230428",5,24,4,20,8,16,0,0,0,0,0,24,4,20,8,16,69,10.7542810104828,10.9029606735064,0.490469127643261,31
"2009","CE","Farias Brito",19389,8195.13,23030,"Caririaçu",2,"Nordeste",0,"230430",2,20,5,15,10,10,0,0,0,0,0,20,5,15,10,10,16,9.01129535438341,9.87246117393101,0.294102121541917,29
"2010","CE","Farias Brito",19389,8195.13,23030,"Caririaçu",2,"Nordeste",0,"230430",3,16,8,8,7,9,0,0,0,0,0,16,8,8,7,9,15,9.01129535438341,9.87246117393101,0.393379239932412,31
"2011","CE","Farias Brito",19389,8195.13,23030,"Caririaçu",2,"Nordeste",0,"230430",4,18,7,11,7,11,0,0,0,0,0,18,7,11,7,11,18,9.01129535438341,9.87246117393101,0.42779789937042,30
"2012","CE","Farias Brito",19389,8195.13,23030,"Caririaçu",2,"Nordeste",0,"230430",5,12,2,10,4,8,0,0,0,0,0,12,2,10,4,8,9,9.01129535438341,9.87246117393101,0.452222275490457,31
"2013","CE","Forquilha",24452,7698.67,23005,"Sobral",2,"Nordeste",1,"230435",2,24,1,23,5,19,0,0,0,0,0,24,1,23,5,19,15,8.94880286564998,10.1044672911486,0.31210582105292,29
"2014","CE","Forquilha",24452,7698.67,23005,"Sobral",2,"Nordeste",1,"230435",3,26,9,17,8,18,0,0,0,0,0,26,9,17,8,18,17,8.94880286564998,10.1044672911486,0.393427084602814,31
"2015","CE","Forquilha",24452,7698.67,23005,"Sobral",2,"Nordeste",1,"230435",4,22,3,19,10,12,0,0,0,0,0,22,3,19,10,12,13,8.94880286564998,10.1044672911486,0.435589657837874,30
"2016","CE","Forquilha",24452,7698.67,23005,"Sobral",2,"Nordeste",1,"230435",5,24,2,22,14,10,0,0,0,0,0,24,2,22,14,10,21,8.94880286564998,10.1044672911486,0.466815068373892,31
"2017","CE","Fortaleza",2686612,25356.73,23016,"Fortaleza",2,"Nordeste",1,"230440",2,2225,536,1689,735,1490,21,9,12,8,13,2246,545,1701,743,1503,1407,10.1407994570196,14.8037914782131,0.313266874986328,29
"2018","CE","Fortaleza",2686612,25356.73,23016,"Fortaleza",2,"Nordeste",1,"230440",3,2332,551,1781,855,1477,18,4,14,6,12,2350,555,1795,861,1489,1575,10.1407994570196,14.8037914782131,0.443115470670899,31
"2019","CE","Fortaleza",2686612,25356.73,23016,"Fortaleza",2,"Nordeste",1,"230440",4,2059,464,1595,707,1352,23,9,14,9,14,2082,473,1609,716,1366,2331,10.1407994570196,14.8037914782131,0.522573277638604,30
"2020","CE","Fortaleza",2686612,25356.73,23016,"Fortaleza",2,"Nordeste",1,"230440",5,2377,558,1819,867,1510,22,12,10,5,17,2399,570,1829,872,1527,4699,10.1407994570196,14.8037914782131,0.520505615845466,31
"2021","CE","Fortim",16631,9806.29,23022,"Litoral de Aracati",2,"Nordeste",0,"230445",2,15,2,13,8,7,0,0,0,0,0,15,2,13,8,7,5,9.19077929550425,9.71902370267014,0.299178519003929,29
"2022","CE","Fortim",16631,9806.29,23022,"Litoral de Aracati",2,"Nordeste",0,"230445",3,12,3,9,3,9,0,0,0,0,0,12,3,9,3,9,8,9.19077929550425,9.71902370267014,0.424923577928739,31
"2023","CE","Fortim",16631,9806.29,23022,"Litoral de Aracati",2,"Nordeste",0,"230445",4,12,3,9,7,5,0,0,0,0,0,12,3,9,7,5,5,9.19077929550425,9.71902370267014,0.469460327711155,30
"2024","CE","Fortim",16631,9806.29,23022,"Litoral de Aracati",2,"Nordeste",0,"230445",5,16,5,11,6,10,0,0,0,0,0,16,5,11,6,10,6,9.19077929550425,9.71902370267014,0.4795184584673,31
"2025","CE","Frecheirinha",14134,18393.96,23003,"Coreaú",2,"Nordeste",0,"230450",2,12,1,11,5,7,0,0,0,0,0,12,1,11,5,7,5,9.81977762883812,9.5563385212508,0.260592616828079,29
"2026","CE","Frecheirinha",14134,18393.96,23003,"Coreaú",2,"Nordeste",0,"230450",3,19,9,10,9,10,0,0,0,0,0,19,9,10,9,10,7,9.81977762883812,9.5563385212508,0.384575185785767,31
"2027","CE","Frecheirinha",14134,18393.96,23003,"Coreaú",2,"Nordeste",0,"230450",4,14,5,9,8,6,0,0,0,0,0,14,5,9,8,6,10,9.81977762883812,9.5563385212508,0.411957812992612,30
"2028","CE","Frecheirinha",14134,18393.96,23003,"Coreaú",2,"Nordeste",0,"230450",5,14,3,11,3,11,2,1,1,2,0,16,4,12,5,11,15,9.81977762883812,9.5563385212508,0.430797566318175,31
"2029","CE","General Sampaio",7694,8336.85,23011,"Médio Curu",2,"Nordeste",0,"230460",2,8,0,8,5,3,0,0,0,0,0,8,0,8,5,3,7,9.02844072616527,8.94819608331224,0.309876715338675,29
"2030","CE","General Sampaio",7694,8336.85,23011,"Médio Curu",2,"Nordeste",0,"230460",3,6,0,6,3,3,0,0,0,0,0,6,0,6,3,3,5,9.02844072616527,8.94819608331224,0.401810326768332,31
"2031","CE","General Sampaio",7694,8336.85,23011,"Médio Curu",2,"Nordeste",0,"230460",4,2,2,0,1,1,0,0,0,0,0,2,2,0,1,1,6,9.02844072616527,8.94819608331224,0.43359881320312,30
"2032","CE","General Sampaio",7694,8336.85,23011,"Médio Curu",2,"Nordeste",0,"230460",5,7,2,5,5,2,0,0,0,0,0,7,2,5,5,2,10,9.02844072616527,8.94819608331224,0.471285366892244,31
"2033","CE","Graça",14407,6616.29,23005,"Sobral",2,"Nordeste",0,"230465",2,12,4,8,4,8,0,0,0,0,0,12,4,8,4,8,9,8.79729006887469,9.57546947856147,0.346007618138391,29
"2034","CE","Graça",14407,6616.29,23005,"Sobral",2,"Nordeste",0,"230465",3,13,4,9,6,7,1,1,0,0,1,14,5,9,6,8,7,8.79729006887469,9.57546947856147,0.441099384669561,31
"2035","CE","Graça",14407,6616.29,23005,"Sobral",2,"Nordeste",0,"230465",4,17,2,15,8,9,0,0,0,0,0,17,2,15,8,9,11,8.79729006887469,9.57546947856147,0.482904331530271,30
"2036","CE","Graça",14407,6616.29,23005,"Sobral",2,"Nordeste",0,"230465",5,12,4,8,2,10,0,0,0,0,0,12,4,8,2,10,8,8.79729006887469,9.57546947856147,0.474366970916223,31
"2037","CE","Granja",54962,6692.4,23001,"Litoral de Camocim e Acaraú",2,"Nordeste",0,"230470",2,68,21,47,38,30,1,0,1,1,0,69,21,48,39,30,32,8.80872783318351,10.914397316336,0.316997712418238,29
"2038","CE","Granja",54962,6692.4,23001,"Litoral de Camocim e Acaraú",2,"Nordeste",0,"230470",3,62,18,44,29,33,0,0,0,0,0,62,18,44,29,33,33,8.80872783318351,10.914397316336,0.431974797963801,31
"2039","CE","Granja",54962,6692.4,23001,"Litoral de Camocim e Acaraú",2,"Nordeste",0,"230470",4,52,17,35,17,35,1,1,0,0,1,53,18,35,17,36,26,8.80872783318351,10.914397316336,0.462931843672865,30
"2040","CE","Granja",54962,6692.4,23001,"Litoral de Camocim e Acaraú",2,"Nordeste",0,"230470",5,64,31,33,33,31,2,1,1,0,2,66,32,34,33,33,33,8.80872783318351,10.914397316336,0.479130771546888,31
"2041","CE","Groaíras",11144,7025.19,23005,"Sobral",2,"Nordeste",0,"230490",2,12,1,11,7,5,0,0,0,0,0,12,1,11,7,5,5,8.85725754009955,9.31865651545964,0.320476319824339,29
"2042","CE","Groaíras",11144,7025.19,23005,"Sobral",2,"Nordeste",0,"230490",3,7,0,7,4,3,0,0,0,0,0,7,0,7,4,3,5,8.85725754009955,9.31865651545964,0.415094965254505,31
"2043","CE","Groaíras",11144,7025.19,23005,"Sobral",2,"Nordeste",0,"230490",4,11,3,8,6,5,0,0,0,0,0,11,3,8,6,5,6,8.85725754009955,9.31865651545964,0.469753143383259,30
"2044","CE","Groaíras",11144,7025.19,23005,"Sobral",2,"Nordeste",0,"230490",5,10,1,9,4,6,0,0,0,0,0,10,1,9,4,6,10,8.85725754009955,9.31865651545964,0.472731155763041,31
"2045","CE","Guaiúba",26290,7684.11,23016,"Fortaleza",2,"Nordeste",0,"230495",2,26,3,23,15,11,0,0,0,0,0,26,3,23,15,11,14,8.94690983924668,10.1769439177239,0.300214611447905,29
"2046","CE","Guaiúba",26290,7684.11,23016,"Fortaleza",2,"Nordeste",0,"230495",3,24,12,12,9,15,0,0,0,0,0,24,12,12,9,15,22,8.94690983924668,10.1769439177239,0.428645440734943,31
"2047","CE","Guaiúba",26290,7684.11,23016,"Fortaleza",2,"Nordeste",0,"230495",4,14,4,10,3,11,0,0,0,0,0,14,4,10,3,11,15,8.94690983924668,10.1769439177239,0.458260385850733,30
"2048","CE","Guaiúba",26290,7684.11,23016,"Fortaleza",2,"Nordeste",0,"230495",5,30,11,19,16,14,0,0,0,0,0,30,11,19,16,14,39,8.94690983924668,10.1769439177239,0.461219246102614,31
"2049","CE","Guaraciaba do Norte",40784,11978.47,23002,"Ibiapaba",2,"Nordeste",0,"230500",2,50,13,37,23,27,0,0,0,0,0,50,13,37,23,27,23,9.3908661506587,10.6160451266159,0.292983708120833,29
"2050","CE","Guaraciaba do Norte",40784,11978.47,23002,"Ibiapaba",2,"Nordeste",0,"230500",3,45,17,28,17,28,0,0,0,0,0,45,17,28,17,28,27,9.3908661506587,10.6160451266159,0.404236780552444,31
"2051","CE","Guaraciaba do Norte",40784,11978.47,23002,"Ibiapaba",2,"Nordeste",0,"230500",4,33,17,16,11,22,3,0,3,3,0,36,17,19,14,22,19,9.3908661506587,10.6160451266159,0.467540052640303,30
"2052","CE","Guaraciaba do Norte",40784,11978.47,23002,"Ibiapaba",2,"Nordeste",0,"230500",5,44,14,30,18,26,0,0,0,0,0,44,14,30,18,26,30,9.3908661506587,10.6160451266159,0.447669040809027,31
"2053","CE","Guaramiranga",5132,16087.25,23013,"Baturité",2,"Nordeste",0,"230510",2,3,0,3,2,1,0,0,0,0,0,3,0,3,2,1,3,9.6857823117681,8.54325072573553,0.304953794134481,29
"2054","CE","Guaramiranga",5132,16087.25,23013,"Baturité",2,"Nordeste",0,"230510",3,1,0,1,1,0,0,0,0,0,0,1,0,1,1,0,2,9.6857823117681,8.54325072573553,0.442718605795891,31
"2055","CE","Guaramiranga",5132,16087.25,23013,"Baturité",2,"Nordeste",0,"230510",4,4,2,2,1,3,1,1,0,1,0,5,3,2,2,3,1,9.6857823117681,8.54325072573553,0.460718820185192,30
"2056","CE","Guaramiranga",5132,16087.25,23013,"Baturité",2,"Nordeste",0,"230510",5,5,3,2,3,2,0,0,0,0,0,5,3,2,3,2,2,9.6857823117681,8.54325072573553,0.482244830706299,31
"2057","CE","Hidrolândia",20053,7036.69,23007,"Santa Quitéria",2,"Nordeste",0,"230520",2,19,6,13,13,6,0,0,0,0,0,19,6,13,13,6,13,8.85889316813276,9.90613404747703,0.261714246857173,29
"2058","CE","Hidrolândia",20053,7036.69,23007,"Santa Quitéria",2,"Nordeste",0,"230520",3,19,9,10,8,11,0,0,0,0,0,19,9,10,8,11,16,8.85889316813276,9.90613404747703,0.397324248743255,31
"2059","CE","Hidrolândia",20053,7036.69,23007,"Santa Quitéria",2,"Nordeste",0,"230520",4,12,6,6,5,7,0,0,0,0,0,12,6,6,5,7,17,8.85889316813276,9.90613404747703,0.414212511477702,30
"2060","CE","Hidrolândia",20053,7036.69,23007,"Santa Quitéria",2,"Nordeste",0,"230520",5,14,7,7,9,5,0,0,0,0,0,14,7,7,9,5,11,8.85889316813276,9.90613404747703,0.432346711775435,31
"2061","CE","Horizonte",68529,25783.29,23017,"Pacajus",2,"Nordeste",1,"230523",2,79,24,55,37,42,0,0,0,0,0,79,24,55,37,42,36,10.1574818866594,11.135012292324,0.315252920140174,29
"2062","CE","Horizonte",68529,25783.29,23017,"Pacajus",2,"Nordeste",1,"230523",3,70,16,54,21,49,2,0,2,0,2,72,16,56,21,51,46,10.1574818866594,11.135012292324,0.428930751356763,31
"2063","CE","Horizonte",68529,25783.29,23017,"Pacajus",2,"Nordeste",1,"230523",4,69,19,50,26,43,0,0,0,0,0,69,19,50,26,43,58,10.1574818866594,11.135012292324,0.485810289465674,30
"2064","CE","Horizonte",68529,25783.29,23017,"Pacajus",2,"Nordeste",1,"230523",5,84,36,48,34,50,0,0,0,0,0,84,36,48,34,50,76,10.1574818866594,11.135012292324,0.497035236971955,31
"2065","CE","Ibiapina",25082,11277.09,23002,"Ibiapaba",2,"Nordeste",0,"230530",2,25,6,19,7,18,0,0,0,0,0,25,6,19,7,18,12,9.33052851304641,10.129905736384,0.272565760163264,29
"2066","CE","Ibiapina",25082,11277.09,23002,"Ibiapaba",2,"Nordeste",0,"230530",3,24,8,16,6,18,0,0,0,0,0,24,8,16,6,18,8,9.33052851304641,10.129905736384,0.405131807839136,31
"2067","CE","Ibiapina",25082,11277.09,23002,"Ibiapaba",2,"Nordeste",0,"230530",4,27,10,17,14,13,0,0,0,0,0,27,10,17,14,13,7,9.33052851304641,10.129905736384,0.45714183434231,30
"2068","CE","Ibiapina",25082,11277.09,23002,"Ibiapaba",2,"Nordeste",0,"230530",5,27,10,17,7,20,0,0,0,0,0,27,10,17,7,20,17,9.33052851304641,10.129905736384,0.462652320011027,31
"2069","CE","Ibicuitinga",12629,7109.47,23023,"Baixo Jaguaribe",2,"Nordeste",0,"230533",2,2,0,2,0,2,0,0,0,0,0,2,0,2,0,2,3,8.8691829771215,9.44375103564617,0.326918761086312,29
"2070","CE","Ibicuitinga",12629,7109.47,23023,"Baixo Jaguaribe",2,"Nordeste",0,"230533",3,2,1,1,1,1,0,0,0,0,0,2,1,1,1,1,6,8.8691829771215,9.44375103564617,0.428904695848415,31
"2071","CE","Ibicuitinga",12629,7109.47,23023,"Baixo Jaguaribe",2,"Nordeste",0,"230533",4,1,0,1,1,0,0,0,0,0,0,1,0,1,1,0,5,8.8691829771215,9.44375103564617,0.454711208948402,30
"2072","CE","Ibicuitinga",12629,7109.47,23023,"Baixo Jaguaribe",2,"Nordeste",0,"230533",5,3,2,1,1,2,0,0,0,0,0,3,2,1,1,2,11,8.8691829771215,9.44375103564617,0.472277065846204,31
"2073","CE","Icapuí",20060,17060.8,23022,"Litoral de Aracati",2,"Nordeste",0,"230535",2,17,2,15,8,9,0,0,0,0,0,17,2,15,8,9,12,9.74453871326392,9.90648306151593,0.30782140812185,29
"2074","CE","Icapuí",20060,17060.8,23022,"Litoral de Aracati",2,"Nordeste",0,"230535",3,20,8,12,8,12,0,0,0,0,0,20,8,12,8,12,13,9.74453871326392,9.90648306151593,0.417787552475952,31
"2075","CE","Icapuí",20060,17060.8,23022,"Litoral de Aracati",2,"Nordeste",0,"230535",4,19,8,11,8,11,0,0,0,0,0,19,8,11,8,11,15,9.74453871326392,9.90648306151593,0.451753423429685,30
"2076","CE","Icapuí",20060,17060.8,23022,"Litoral de Aracati",2,"Nordeste",0,"230535",5,15,5,10,8,7,0,0,0,0,0,15,5,10,8,7,17,9.74453871326392,9.90648306151593,0.449225202200882,31
"2077","CE","Icó",68162,8126.78,23026,"Iguatu",2,"Nordeste",0,"230540",2,53,18,35,26,27,0,0,0,0,0,53,18,35,26,27,37,9.00292006012717,11.1296425037957,0.300658129147238,29
"2078","CE","Icó",68162,8126.78,23026,"Iguatu",2,"Nordeste",0,"230540",3,58,22,36,24,34,0,0,0,0,0,58,22,36,24,34,40,9.00292006012717,11.1296425037957,0.396927392608315,31
"2079","CE","Icó",68162,8126.78,23026,"Iguatu",2,"Nordeste",0,"230540",4,55,23,32,27,28,1,0,1,0,1,56,23,33,27,29,37,9.00292006012717,11.1296425037957,0.441948752593077,30
"2080","CE","Icó",68162,8126.78,23026,"Iguatu",2,"Nordeste",0,"230540",5,44,15,29,16,28,0,0,0,0,0,44,15,29,16,28,39,9.00292006012717,11.1296425037957,0.442133224700435,31
"2081","CE","Iguatu",103074,15624.21,23026,"Iguatu",2,"Nordeste",1,"230550",2,99,30,69,43,56,2,2,0,1,1,101,32,69,44,57,76,9.6565769133264,11.5432024558545,0.27831843409671,29
"2082","CE","Iguatu",103074,15624.21,23026,"Iguatu",2,"Nordeste",1,"230550",3,106,25,81,38,68,0,0,0,0,0,106,25,81,38,68,59,9.6565769133264,11.5432024558545,0.385211068531858,31
"2083","CE","Iguatu",103074,15624.21,23026,"Iguatu",2,"Nordeste",1,"230550",4,113,29,84,44,69,1,1,0,0,1,114,30,84,44,70,51,9.6565769133264,11.5432024558545,0.438021429294245,30
"2084","CE","Iguatu",103074,15624.21,23026,"Iguatu",2,"Nordeste",1,"230550",5,115,31,84,51,64,1,0,1,0,1,116,31,85,51,65,70,9.6565769133264,11.5432024558545,0.412773984188725,31
"2085","CE","Independência",26187,8950.81,23018,"Sertão de Cratéus",2,"Nordeste",0,"230560",2,4,1,3,3,1,0,0,0,0,0,4,1,3,3,1,22,9.09949930996707,10.1730183834035,0.300415426589595,29
"2086","CE","Independência",26187,8950.81,23018,"Sertão de Cratéus",2,"Nordeste",0,"230560",3,7,4,3,1,6,0,0,0,0,0,7,4,3,1,6,18,9.09949930996707,10.1730183834035,0.40106770345129,31
"2087","CE","Independência",26187,8950.81,23018,"Sertão de Cratéus",2,"Nordeste",0,"230560",4,9,3,6,1,8,1,1,0,0,1,10,4,6,1,9,15,9.09949930996707,10.1730183834035,0.409924043539957,30
"2088","CE","Independência",26187,8950.81,23018,"Sertão de Cratéus",2,"Nordeste",0,"230560",5,6,2,4,2,4,0,0,0,0,0,6,2,4,2,4,19,9.09949930996707,10.1730183834035,0.459107665229616,31
"2089","CE","Ipaporanga",11596,6478.06,23018,"Sertão de Cratéus",2,"Nordeste",0,"230565",2,0,0,0,0,0,0,0,0,0,0,0,0,0,0,0,7,8.77617636180632,9.35841549004155,0.299501662638829,29
"2090","CE","Ipaporanga",11596,6478.06,23018,"Sertão de Cratéus",2,"Nordeste",0,"230565",3,1,0,1,0,1,0,0,0,0,0,1,0,1,0,1,9,8.77617636180632,9.35841549004155,0.43425015527312,31
"2091","CE","Ipaporanga",11596,6478.06,23018,"Sertão de Cratéus",2,"Nordeste",0,"230565",4,1,0,1,0,1,0,0,0,0,0,1,0,1,0,1,12,8.77617636180632,9.35841549004155,0.485509924121817,30
"2092","CE","Ipaporanga",11596,6478.06,23018,"Sertão de Cratéus",2,"Nordeste",0,"230565",5,0,0,0,0,0,0,0,0,0,0,0,0,0,0,0,11,8.77617636180632,9.35841549004155,0.491933866900966,31
"2093","CE","Ipaumirim",12485,9122.59,23028,"Lavras da Mangabeira",2,"Nordeste",0,"230570",2,14,5,9,5,9,0,0,0,0,0,14,5,9,5,9,3,9.11850903397857,9.43228320271387,0.285214500301805,29
"2094","CE","Ipaumirim",12485,9122.59,23028,"Lavras da Mangabeira",2,"Nordeste",0,"230570",3,5,1,4,2,3,0,0,0,0,0,5,1,4,2,3,6,9.11850903397857,9.43228320271387,0.397966676974205,31
"2095","CE","Ipaumirim",12485,9122.59,23028,"Lavras da Mangabeira",2,"Nordeste",0,"230570",4,6,1,5,3,3,0,0,0,0,0,6,1,5,3,3,6,9.11850903397857,9.43228320271387,0.434028091865857,30
"2096","CE","Ipaumirim",12485,9122.59,23028,"Lavras da Mangabeira",2,"Nordeste",0,"230570",5,6,5,1,4,2,0,0,0,0,0,6,5,1,4,2,12,9.11850903397857,9.43228320271387,0.445235431052654,31
"2097","CE","Ipu",42058,9341.6,23006,"Ipu",2,"Nordeste",0,"230580",2,51,19,32,15,36,2,1,1,1,1,53,20,33,16,37,36,9.14223282276151,10.6468048970086,0.305297220192966,29
"2098","CE","Ipu",42058,9341.6,23006,"Ipu",2,"Nordeste",0,"230580",3,38,10,28,17,21,0,0,0,0,0,38,10,28,17,21,28,9.14223282276151,10.6468048970086,0.417523668766437,31
"2099","CE","Ipu",42058,9341.6,23006,"Ipu",2,"Nordeste",0,"230580",4,8,4,4,4,4,1,0,1,1,0,9,4,5,5,4,31,9.14223282276151,10.6468048970086,0.451356094496372,30
"2100","CE","Ipu",42058,9341.6,23006,"Ipu",2,"Nordeste",0,"230580",5,10,2,8,4,6,0,0,0,0,0,10,2,8,4,6,27,9.14223282276151,10.6468048970086,0.459688467650905,31
"2101","CE","Ipueiras",38114,6430.39,23006,"Ipu",2,"Nordeste",0,"230590",2,20,12,8,9,11,0,0,0,0,0,20,12,8,9,11,20,8.76879046858052,10.5483369476883,0.287394066771779,29
"2102","CE","Ipueiras",38114,6430.39,23006,"Ipu",2,"Nordeste",0,"230590",3,21,11,10,10,11,0,0,0,0,0,21,11,10,10,11,21,8.76879046858052,10.5483369476883,0.395812195421983,31
"2103","CE","Ipueiras",38114,6430.39,23006,"Ipu",2,"Nordeste",0,"230590",4,11,8,3,3,8,1,0,1,1,0,12,8,4,4,8,41,8.76879046858052,10.5483369476883,0.44544369473965,30
"2104","CE","Ipueiras",38114,6430.39,23006,"Ipu",2,"Nordeste",0,"230590",5,17,7,10,7,10,1,1,0,0,1,18,8,10,7,11,21,8.76879046858052,10.5483369476883,0.45307462621788,31
"2105","CE","Iracema",14326,9756.96,23025,"Serra do Pereiro",2,"Nordeste",0,"230600",2,15,3,12,7,8,0,0,0,0,0,15,3,12,7,8,8,9.18573615547876,9.5698313471744,0.270511944376511,29
"2106","CE","Iracema",14326,9756.96,23025,"Serra do Pereiro",2,"Nordeste",0,"230600",3,10,2,8,3,7,0,0,0,0,0,10,2,8,3,7,4,9.18573615547876,9.5698313471744,0.359108723735187,31
"2107","CE","Iracema",14326,9756.96,23025,"Serra do Pereiro",2,"Nordeste",0,"230600",4,11,2,9,6,5,1,1,0,0,1,12,3,9,6,6,8,9.18573615547876,9.5698313471744,0.39523529118797,30
"2108","CE","Iracema",14326,9756.96,23025,"Serra do Pereiro",2,"Nordeste",0,"230600",5,12,2,10,6,6,0,0,0,0,0,12,2,10,6,6,10,9.18573615547876,9.5698313471744,0.407700961714477,31
"2109","CE","Irauçuba",24305,6665.39,23005,"Sobral",2,"Nordeste",0,"230610",2,26,5,21,12,14,0,0,0,0,0,26,5,21,12,14,10,8.80468374552955,10.0984373694796,0.281068526062589,29
"2110","CE","Irauçuba",24305,6665.39,23005,"Sobral",2,"Nordeste",0,"230610",3,19,3,16,10,9,0,0,0,0,0,19,3,16,10,9,11,8.80468374552955,10.0984373694796,0.392041684823405,31
"2111","CE","Irauçuba",24305,6665.39,23005,"Sobral",2,"Nordeste",0,"230610",4,10,2,8,4,6,1,0,1,0,1,11,2,9,4,7,10,8.80468374552955,10.0984373694796,0.421573270767893,30
"2112","CE","Irauçuba",24305,6665.39,23005,"Sobral",2,"Nordeste",0,"230610",5,17,3,14,8,9,0,0,0,0,0,17,3,14,8,9,16,8.80468374552955,10.0984373694796,0.474943586670905,31
"2113","CE","Itaiçaba",7866,8245.31,23022,"Litoral de Aracati",2,"Nordeste",0,"230620",2,4,1,3,2,2,0,0,0,0,0,4,1,3,2,2,5,9.01739983283146,8.97030495299176,0.289354038782322,29
"2114","CE","Itaiçaba",7866,8245.31,23022,"Litoral de Aracati",2,"Nordeste",0,"230620",3,10,2,8,3,7,0,0,0,0,0,10,2,8,3,7,6,9.01739983283146,8.97030495299176,0.41031493908494,31
"2115","CE","Itaiçaba",7866,8245.31,23022,"Litoral de Aracati",2,"Nordeste",0,"230620",4,4,2,2,1,3,0,0,0,0,0,4,2,2,1,3,2,9.01739983283146,8.97030495299176,0.410643684044205,30
"2116","CE","Itaiçaba",7866,8245.31,23022,"Litoral de Aracati",2,"Nordeste",0,"230620",5,3,1,2,0,3,0,0,0,0,0,3,1,2,0,3,8,9.01739983283146,8.97030495299176,0.43550584608933,31
"2117","CE","Itaitinga",38325,17804.8,23016,"Fortaleza",2,"Nordeste",1,"230625",2,17,3,14,3,14,1,0,1,1,0,18,3,15,4,14,26,9.78722336284901,10.55385770374,0.295458723988755,29
"2118","CE","Itaitinga",38325,17804.8,23016,"Fortaleza",2,"Nordeste",1,"230625",3,18,2,16,3,15,1,1,0,1,0,19,3,16,4,15,17,9.78722336284901,10.55385770374,0.410472792623824,31
"2119","CE","Itaitinga",38325,17804.8,23016,"Fortaleza",2,"Nordeste",1,"230625",4,30,7,23,11,19,1,0,1,1,0,31,7,24,12,19,34,9.78722336284901,10.55385770374,0.45941288705878,30
"2120","CE","Itaitinga",38325,17804.8,23016,"Fortaleza",2,"Nordeste",1,"230625",5,32,9,23,10,22,0,0,0,0,0,32,9,23,10,22,57,9.78722336284901,10.55385770374,0.457683298565217,31
"2121","CE","Itapajé",53067,10664.27,23010,"Uruburetama",2,"Nordeste",1,"230630",2,54,21,33,26,28,1,1,0,0,1,55,22,33,26,29,29,9.27465418036774,10.8793105451116,0.287086522484245,29
"2122","CE","Itapajé",53067,10664.27,23010,"Uruburetama",2,"Nordeste",1,"230630",3,42,14,28,17,25,1,0,1,1,0,43,14,29,18,25,28,9.27465418036774,10.8793105451116,0.392112558263453,31
"2123","CE","Itapajé",53067,10664.27,23010,"Uruburetama",2,"Nordeste",1,"230630",4,55,18,37,30,25,1,0,1,0,1,56,18,38,30,26,28,9.27465418036774,10.8793105451116,0.431623246096575,30
"2124","CE","Itapajé",53067,10664.27,23010,"Uruburetama",2,"Nordeste",1,"230630",5,54,20,34,20,34,0,0,0,0,0,54,20,34,20,34,98,9.27465418036774,10.8793105451116,0.474415099847512,31
"2125","CE","Itapipoca",130539,12863.49,23008,"Itapipoca",2,"Nordeste",1,"230640",2,156,41,115,61,95,7,5,2,5,2,163,46,117,66,97,51,9.46214834511045,11.7794273116727,0.295145262617868,29
"2126","CE","Itapipoca",130539,12863.49,23008,"Itapipoca",2,"Nordeste",1,"230640",3,156,43,113,74,82,1,1,0,0,1,157,44,113,74,83,62,9.46214834511045,11.7794273116727,0.417736504607119,31
"2127","CE","Itapipoca",130539,12863.49,23008,"Itapipoca",2,"Nordeste",1,"230640",4,158,48,110,69,89,1,0,1,1,0,159,48,111,70,89,68,9.46214834511045,11.7794273116727,0.468035815970336,30
"2128","CE","Itapipoca",130539,12863.49,23008,"Itapipoca",2,"Nordeste",1,"230640",5,81,18,63,31,50,2,0,2,0,2,83,18,65,31,52,137,9.46214834511045,11.7794273116727,0.519436972392428,31
"2129","CE","Itapiúna",20520,6523.57,23013,"Baturité",2,"Nordeste",0,"230650",2,16,6,10,6,10,0,0,0,0,0,16,6,10,6,10,13,8.78317705108435,9.92915529928471,0.329112626787473,29
"2130","CE","Itapiúna",20520,6523.57,23013,"Baturité",2,"Nordeste",0,"230650",3,10,1,9,4,6,0,0,0,0,0,10,1,9,4,6,11,8.78317705108435,9.92915529928471,0.431964972092084,31
"2131","CE","Itapiúna",20520,6523.57,23013,"Baturité",2,"Nordeste",0,"230650",4,13,3,10,3,10,1,0,1,0,1,14,3,11,3,11,4,8.78317705108435,9.92915529928471,0.484520969536631,30
"2132","CE","Itapiúna",20520,6523.57,23013,"Baturité",2,"Nordeste",0,"230650",5,26,8,18,8,18,0,0,0,0,0,26,8,18,8,18,15,8.78317705108435,9.92915529928471,0.494027706975458,31
"2133","CE","Itarema",42215,17804.2,23001,"Litoral de Camocim e Acaraú",2,"Nordeste",0,"230655",2,63,13,50,23,40,1,1,0,1,0,64,14,50,24,40,19,9.78718966350334,10.6505308871036,0.317032850383021,29
"2134","CE","Itarema",42215,17804.2,23001,"Litoral de Camocim e Acaraú",2,"Nordeste",0,"230655",3,45,14,31,17,28,1,1,0,0,1,46,15,31,17,29,26,9.78718966350334,10.6505308871036,0.443779628060083,31
"2135","CE","Itarema",42215,17804.2,23001,"Litoral de Camocim e Acaraú",2,"Nordeste",0,"230655",4,59,18,41,25,34,0,0,0,0,0,59,18,41,25,34,26,9.78718966350334,10.6505308871036,0.461965836613176,30
"2136","CE","Itarema",42215,17804.2,23001,"Litoral de Camocim e Acaraú",2,"Nordeste",0,"230655",5,57,6,51,24,33,1,0,1,1,0,58,6,52,25,33,44,9.78718966350334,10.6505308871036,0.485004879843199,31
"2137","CE","Itatira",21836,5888.14,23012,"Canindé",2,"Nordeste",0,"230660",2,31,11,20,17,14,1,1,0,0,1,32,12,20,17,15,9,8.68069543729995,9.99131526290165,0.323776543746599,29
"2138","CE","Itatira",21836,5888.14,23012,"Canindé",2,"Nordeste",0,"230660",3,22,8,14,6,16,0,0,0,0,0,22,8,14,6,16,17,8.68069543729995,9.99131526290165,0.42477784692596,31
"2139","CE","Itatira",21836,5888.14,23012,"Canindé",2,"Nordeste",0,"230660",4,23,7,16,13,10,0,0,0,0,0,23,7,16,13,10,15,8.68069543729995,9.99131526290165,0.44779731709166,30
"2140","CE","Itatira",21836,5888.14,23012,"Canindé",2,"Nordeste",0,"230660",5,16,7,9,9,7,0,0,0,0,0,16,7,9,9,7,14,8.68069543729995,9.99131526290165,0.460267401232047,31
"2141","CE","Jaguaretama",18147,8548.15,23024,"Médio Jaguaribe",2,"Nordeste",0,"230670",2,19,10,9,10,9,0,0,0,0,0,19,10,9,10,9,4,9.05347016424951,9.80626053677502,0.256400246198306,29
"2142","CE","Jaguaretama",18147,8548.15,23024,"Médio Jaguaribe",2,"Nordeste",0,"230670",3,8,2,6,1,7,0,0,0,0,0,8,2,6,1,7,15,9.05347016424951,9.80626053677502,0.338101887241621,31
"2143","CE","Jaguaretama",18147,8548.15,23024,"Médio Jaguaribe",2,"Nordeste",0,"230670",4,24,9,15,7,17,0,0,0,0,0,24,9,15,7,17,12,9.05347016424951,9.80626053677502,0.364050344194619,30
"2144","CE","Jaguaretama",18147,8548.15,23024,"Médio Jaguaribe",2,"Nordeste",0,"230670",5,15,4,11,6,9,0,0,0,0,0,15,4,11,6,9,20,9.05347016424951,9.80626053677502,0.409716983309897,31
"2145","CE","Jaguaribara",11492,11343.44,23024,"Médio Jaguaribe",2,"Nordeste",0,"230680",2,10,3,7,6,4,0,0,0,0,0,10,3,7,6,4,8,9.33639488225016,9.34940642009918,0.289895251064763,29
"2146","CE","Jaguaribara",11492,11343.44,23024,"Médio Jaguaribe",2,"Nordeste",0,"230680",3,8,1,7,5,3,0,0,0,0,0,8,1,7,5,3,6,9.33639488225016,9.34940642009918,0.380479606008146,31
"2147","CE","Jaguaribara",11492,11343.44,23024,"Médio Jaguaribe",2,"Nordeste",0,"230680",4,10,6,4,4,6,0,0,0,0,0,10,6,4,4,6,4,9.33639488225016,9.34940642009918,0.411130833948867,30
"2148","CE","Jaguaribara",11492,11343.44,23024,"Médio Jaguaribe",2,"Nordeste",0,"230680",5,6,2,4,2,4,0,0,0,0,0,6,2,4,2,4,8,9.33639488225016,9.34940642009918,0.436314685724754,31
"2149","CE","Jaguaribe",34636,16763.71,23024,"Médio Jaguaribe",2,"Nordeste",0,"230690",2,31,6,25,17,14,0,0,0,0,0,31,6,25,17,14,18,9.72697170992134,10.4526488825677,0.2614810445107,29
"2150","CE","Jaguaribe",34636,16763.71,23024,"Médio Jaguaribe",2,"Nordeste",0,"230690",3,33,14,19,8,25,0,0,0,0,0,33,14,19,8,25,20,9.72697170992134,10.4526488825677,0.352242387298539,31
"2151","CE","Jaguaribe",34636,16763.71,23024,"Médio Jaguaribe",2,"Nordeste",0,"230690",4,20,4,16,7,13,0,0,0,0,0,20,4,16,7,13,20,9.72697170992134,10.4526488825677,0.392566259556087,30
"2152","CE","Jaguaribe",34636,16763.71,23024,"Médio Jaguaribe",2,"Nordeste",0,"230690",5,37,9,28,19,18,0,0,0,0,0,37,9,28,19,18,28,9.72697170992134,10.4526488825677,0.40487670977769,31
"2153","CE","Jaguaruana",33834,11683.11,23023,"Baixo Jaguaribe",2,"Nordeste",0,"230700",2,29,10,19,12,17,0,0,0,0,0,29,10,19,12,17,21,9.36589948806271,10.4292214930352,0.265363876120366,29
"2154","CE","Jaguaruana",33834,11683.11,23023,"Baixo Jaguaribe",2,"Nordeste",0,"230700",3,24,14,10,10,14,1,1,0,0,1,25,15,10,10,15,17,9.36589948806271,10.4292214930352,0.376694345285906,31
"2155","CE","Jaguaruana",33834,11683.11,23023,"Baixo Jaguaribe",2,"Nordeste",0,"230700",4,26,10,16,13,13,2,0,2,2,0,28,10,18,15,13,29,9.36589948806271,10.4292214930352,0.395270218427805,30
"2156","CE","Jaguaruana",33834,11683.11,23023,"Baixo Jaguaribe",2,"Nordeste",0,"230700",5,30,6,24,17,13,1,1,0,0,1,31,7,24,17,14,26,9.36589948806271,10.4292214930352,0.398441022184424,31
"2157","CE","Jardim",27181,7529.39,23032,"Cariri",2,"Nordeste",0,"230710",2,24,10,14,10,14,0,0,0,0,0,24,10,14,10,14,13,8.92656930821636,10.210273478787,0.299599664403627,29
"2158","CE","Jardim",27181,7529.39,23032,"Cariri",2,"Nordeste",0,"230710",3,32,13,19,16,16,1,0,1,1,0,33,13,20,17,16,24,8.92656930821636,10.210273478787,0.406503102816496,31
"2159","CE","Jardim",27181,7529.39,23032,"Cariri",2,"Nordeste",0,"230710",4,28,6,22,15,13,0,0,0,0,0,28,6,22,15,13,18,8.92656930821636,10.210273478787,0.453294989714085,30
"2160","CE","Jardim",27181,7529.39,23032,"Cariri",2,"Nordeste",0,"230710",5,28,10,18,7,21,1,0,1,1,0,29,10,19,8,21,14,8.92656930821636,10.210273478787,0.452894423365225,31
"2161","CE","Jati",8130,12184.14,23033,"Brejo Santo",2,"Nordeste",0,"230720",2,8,1,7,5,3,0,0,0,0,0,8,1,7,5,3,7,9.4078903849883,9.00331620254186,0.286464875735153,29
"2162","CE","Jati",8130,12184.14,23033,"Brejo Santo",2,"Nordeste",0,"230720",3,10,2,8,3,7,1,0,1,0,1,11,2,9,3,8,5,9.4078903849883,9.00331620254186,0.364177476874829,31
"2163","CE","Jati",8130,12184.14,23033,"Brejo Santo",2,"Nordeste",0,"230720",4,8,1,7,2,6,0,0,0,0,0,8,1,7,2,6,3,9.4078903849883,9.00331620254186,0.403715422489069,30
"2164","CE","Jati",8130,12184.14,23033,"Brejo Santo",2,"Nordeste",0,"230720",5,5,1,4,4,1,0,0,0,0,0,5,1,4,4,1,8,9.4078903849883,9.00331620254186,0.414350476120548,31
"2165","CE","Jijoca de Jericoacoara",20087,17740.75,23001,"Litoral de Camocim e Acaraú",2,"Nordeste",0,"230725",2,29,3,26,15,14,0,0,0,0,0,29,3,26,15,14,11,9.78361953230925,9.90782811863455,0.275973827961541,29
"2166","CE","Jijoca de Jericoacoara",20087,17740.75,23001,"Litoral de Camocim e Acaraú",2,"Nordeste",0,"230725",3,25,6,19,10,15,2,1,1,1,1,27,7,20,11,16,11,9.78361953230925,9.90782811863455,0.402134697890102,31
"2167","CE","Jijoca de Jericoacoara",20087,17740.75,23001,"Litoral de Camocim e Acaraú",2,"Nordeste",0,"230725",4,25,9,16,9,16,2,2,0,1,1,27,11,16,10,17,8,9.78361953230925,9.90782811863455,0.466277160431682,30
"2168","CE","Jijoca de Jericoacoara",20087,17740.75,23001,"Litoral de Camocim e Acaraú",2,"Nordeste",0,"230725",5,23,5,18,6,17,0,0,0,0,0,23,5,18,6,17,16,9.78361953230925,9.90782811863455,0.492510635518514,31
"2169","CE","Juazeiro do Norte",276264,17725.62,23032,"Cariri",2,"Nordeste",1,"230730",2,269,73,196,114,155,2,1,1,0,2,271,74,197,114,157,158,9.78276632963202,12.529112209263,0.291032461381888,29
"2170","CE","Juazeiro do Norte",276264,17725.62,23032,"Cariri",2,"Nordeste",1,"230730",3,307,83,224,103,204,5,1,4,2,3,312,84,228,105,207,192,9.78276632963202,12.529112209263,0.409597149837655,31
"2171","CE","Juazeiro do Norte",276264,17725.62,23032,"Cariri",2,"Nordeste",1,"230730",4,306,74,232,116,190,5,3,2,4,1,311,77,234,120,191,167,9.78276632963202,12.529112209263,0.461632853026431,30
"2172","CE","Juazeiro do Norte",276264,17725.62,23032,"Cariri",2,"Nordeste",1,"230730",5,316,83,233,119,197,5,1,4,4,1,321,84,237,123,198,168,9.78276632963202,12.529112209263,0.442893728388534,31
"2173","CE","Jucás",24892,9024.13,23027,"Várzea Alegre",2,"Nordeste",0,"230740",2,26,13,13,5,21,1,0,1,1,0,27,13,14,6,21,12,9.10765737966244,10.1223017456891,0.303222887356803,29
"2174","CE","Jucás",24892,9024.13,23027,"Várzea Alegre",2,"Nordeste",0,"230740",3,26,7,19,13,13,0,0,0,0,0,26,7,19,13,13,19,9.10765737966244,10.1223017456891,0.431184182618439,31
"2175","CE","Jucás",24892,9024.13,23027,"Várzea Alegre",2,"Nordeste",0,"230740",4,22,11,11,7,15,0,0,0,0,0,22,11,11,7,15,15,9.10765737966244,10.1223017456891,0.442977327579461,30
"2176","CE","Jucás",24892,9024.13,23027,"Várzea Alegre",2,"Nordeste",0,"230740",5,30,10,20,17,13,0,0,0,0,0,30,10,20,17,13,19,9.10765737966244,10.1223017456891,0.399850156223628,31
"2177","CE","Lavras da Mangabeira",31492,8139.37,23028,"Lavras da Mangabeira",2,"Nordeste",0,"230750",2,28,11,17,12,16,0,0,0,0,0,28,11,17,12,16,14,9.004468060424,10.3574888243044,0.270889919830757,29
"2178","CE","Lavras da Mangabeira",31492,8139.37,23028,"Lavras da Mangabeira",2,"Nordeste",0,"230750",3,26,8,18,14,12,0,0,0,0,0,26,8,18,14,12,12,9.004468060424,10.3574888243044,0.38738371654888,31
"2179","CE","Lavras da Mangabeira",31492,8139.37,23028,"Lavras da Mangabeira",2,"Nordeste",0,"230750",4,27,10,17,12,15,0,0,0,0,0,27,10,17,12,15,17,9.004468060424,10.3574888243044,0.40643285164507,30
"2180","CE","Lavras da Mangabeira",31492,8139.37,23028,"Lavras da Mangabeira",2,"Nordeste",0,"230750",5,22,4,18,10,12,0,0,0,0,0,22,4,18,10,12,18,9.004468060424,10.3574888243044,0.43821163787495,31
"2181","CE","Limoeiro do Norte",59890,15961.09,23023,"Baixo Jaguaribe",2,"Nordeste",1,"230760",2,48,15,33,14,34,1,0,1,0,1,49,15,34,14,35,31,9.6779091644111,11.0002648252585,0.296629511223829,29
"2182","CE","Limoeiro do Norte",59890,15961.09,23023,"Baixo Jaguaribe",2,"Nordeste",1,"230760",3,56,18,38,18,38,0,0,0,0,0,56,18,38,18,38,37,9.6779091644111,11.0002648252585,0.406897386706015,31
"2183","CE","Limoeiro do Norte",59890,15961.09,23023,"Baixo Jaguaribe",2,"Nordeste",1,"230760",4,43,8,35,15,28,0,0,0,0,0,43,8,35,15,28,36,9.6779091644111,11.0002648252585,0.446951936142659,30
"2184","CE","Limoeiro do Norte",59890,15961.09,23023,"Baixo Jaguaribe",2,"Nordeste",1,"230760",5,45,13,32,17,28,0,0,0,0,0,45,13,32,17,28,33,9.6779091644111,11.0002648252585,0.43896631240906,31
"2185","CE","Madalena",19864,6435.63,23019,"Sertão de Quixeramobim",2,"Nordeste",0,"230763",2,10,5,5,7,3,0,0,0,0,0,10,5,5,7,3,11,8.76960501733603,9.896664327188,0.267808142827182,29
"2186","CE","Madalena",19864,6435.63,23019,"Sertão de Quixeramobim",2,"Nordeste",0,"230763",3,10,5,5,8,2,0,0,0,0,0,10,5,5,8,2,16,8.76960501733603,9.896664327188,0.367210668597424,31
"2187","CE","Madalena",19864,6435.63,23019,"Sertão de Quixeramobim",2,"Nordeste",0,"230763",4,10,3,7,3,7,1,0,1,0,1,11,3,8,3,8,4,8.76960501733603,9.896664327188,0.418199876540058,30
"2188","CE","Madalena",19864,6435.63,23019,"Sertão de Quixeramobim",2,"Nordeste",0,"230763",5,12,6,6,6,6,0,0,0,0,0,12,6,6,6,6,15,8.76960501733603,9.896664327188,0.453751481044189,31
"2189","CE","Maracanaú",229458,46240.54,23016,"Fortaleza",2,"Nordeste",1,"230765",2,316,63,253,125,191,2,0,2,1,1,318,63,255,126,192,121,10.7416121814788,12.343475285199,0.319791177984717,29
"2190","CE","Maracanaú",229458,46240.54,23016,"Fortaleza",2,"Nordeste",1,"230765",3,273,66,207,115,158,5,0,5,2,3,278,66,212,117,161,115,10.7416121814788,12.343475285199,0.437313611163127,31
"2191","CE","Maracanaú",229458,46240.54,23016,"Fortaleza",2,"Nordeste",1,"230765",4,257,70,187,95,162,0,0,0,0,0,257,70,187,95,162,175,10.7416121814788,12.343475285199,0.494313244320242,30
"2192","CE","Maracanaú",229458,46240.54,23016,"Fortaleza",2,"Nordeste",1,"230765",5,314,90,224,134,180,4,0,4,1,3,318,90,228,135,183,338,10.7416121814788,12.343475285199,0.491522728427471,31
"2193","CE","Maranguape",130346,11788.59,23016,"Fortaleza",2,"Nordeste",1,"230770",2,89,19,70,29,60,2,1,1,1,1,91,20,71,30,61,59,9.3748873935043,11.7779477322778,0.312022677880738,29
"2194","CE","Maranguape",130346,11788.59,23016,"Fortaleza",2,"Nordeste",1,"230770",3,86,22,64,37,49,0,0,0,0,0,86,22,64,37,49,69,9.3748873935043,11.7779477322778,0.424880865074029,31
"2195","CE","Maranguape",130346,11788.59,23016,"Fortaleza",2,"Nordeste",1,"230770",4,56,15,41,22,34,0,0,0,0,0,56,15,41,22,34,85,9.3748873935043,11.7779477322778,0.48054530020782,30
"2196","CE","Maranguape",130346,11788.59,23016,"Fortaleza",2,"Nordeste",1,"230770",5,103,26,77,36,67,2,1,1,1,1,105,27,78,37,68,162,9.3748873935043,11.7779477322778,0.488607808112933,31
"2197","CE","Marco",27595,11895.32,23001,"Litoral de Camocim e Acaraú",2,"Nordeste",0,"230780",2,35,19,16,12,23,0,0,0,0,0,35,19,16,12,23,14,9.38390032443489,10.2253898758736,0.334563379350262,29
"2198","CE","Marco",27595,11895.32,23001,"Litoral de Camocim e Acaraú",2,"Nordeste",0,"230780",3,42,17,25,17,25,0,0,0,0,0,42,17,25,17,25,14,9.38390032443489,10.2253898758736,0.45326719250085,31
"2199","CE","Marco",27595,11895.32,23001,"Litoral de Camocim e Acaraú",2,"Nordeste",0,"230780",4,40,18,22,17,23,2,1,1,1,1,42,19,23,18,24,19,9.38390032443489,10.2253898758736,0.460219158633324,30
"2200","CE","Marco",27595,11895.32,23001,"Litoral de Camocim e Acaraú",2,"Nordeste",0,"230780",5,48,18,30,21,27,0,0,0,0,0,48,18,30,21,27,33,9.38390032443489,10.2253898758736,0.468279755525956,31
"2201","CE","Martinópole",11321,6793.18,23001,"Litoral de Camocim e Acaraú",2,"Nordeste",0,"230790",2,10,4,6,4,6,0,0,0,0,0,10,4,6,4,6,9,8.82367444670569,9.33441468707811,0.270586852043017,29
"2202","CE","Martinópole",11321,6793.18,23001,"Litoral de Camocim e Acaraú",2,"Nordeste",0,"230790",3,17,9,8,7,10,0,0,0,0,0,17,9,8,7,10,4,8.82367444670569,9.33441468707811,0.381323860284976,31
"2203","CE","Martinópole",11321,6793.18,23001,"Litoral de Camocim e Acaraú",2,"Nordeste",0,"230790",4,16,9,7,4,12,0,0,0,0,0,16,9,7,4,12,9,8.82367444670569,9.33441468707811,0.43828563924629,30
"2204","CE","Martinópole",11321,6793.18,23001,"Litoral de Camocim e Acaraú",2,"Nordeste",0,"230790",5,12,5,7,4,8,1,0,1,0,1,13,5,8,4,9,6,8.82367444670569,9.33441468707811,0.424205957181683,31
"2205","CE","Massapê",39044,7143.58,23005,"Sobral",2,"Nordeste",0,"230800",2,45,12,33,20,25,1,0,1,1,0,46,12,34,21,25,19,8.8739693302346,10.5724444942949,0.286352929129593,29
"2206","CE","Massapê",39044,7143.58,23005,"Sobral",2,"Nordeste",0,"230800",3,41,14,27,18,23,0,0,0,0,0,41,14,27,18,23,24,8.8739693302346,10.5724444942949,0.39559424284735,31
"2207","CE","Massapê",39044,7143.58,23005,"Sobral",2,"Nordeste",0,"230800",4,37,9,28,20,17,0,0,0,0,0,37,9,28,20,17,27,8.8739693302346,10.5724444942949,0.433567905278607,30
"2208","CE","Massapê",39044,7143.58,23005,"Sobral",2,"Nordeste",0,"230800",5,45,13,32,20,25,0,0,0,0,0,45,13,32,20,25,42,8.8739693302346,10.5724444942949,0.473680233445406,31
"2209","CE","Mauriti",48168,8624.33,23031,"Barro",2,"Nordeste",0,"230810",2,37,14,23,13,24,0,0,0,0,0,37,14,23,13,24,17,9.0623425577228,10.7824501791443,0.262133608601227,29
"2210","CE","Mauriti",48168,8624.33,23031,"Barro",2,"Nordeste",0,"230810",3,50,19,31,23,27,2,1,1,1,1,52,20,32,24,28,17,9.0623425577228,10.7824501791443,0.390473948029517,31
"2211","CE","Mauriti",48168,8624.33,23031,"Barro",2,"Nordeste",0,"230810",4,49,18,31,19,30,1,1,0,0,1,50,19,31,19,31,24,9.0623425577228,10.7824501791443,0.40135652907853,30
"2212","CE","Mauriti",48168,8624.33,23031,"Barro",2,"Nordeste",0,"230810",5,45,11,34,21,24,0,0,0,0,0,45,11,34,21,24,30,9.0623425577228,10.7824501791443,0.405840361240423,31
"2213","CE","Meruoca",15185,6681.85,23004,"Meruoca",2,"Nordeste",0,"230820",2,17,5,12,5,12,0,0,0,0,0,17,5,12,5,12,8,8.80715017429598,9.62806337747985,0.287847870933001,29
"2214","CE","Meruoca",15185,6681.85,23004,"Meruoca",2,"Nordeste",0,"230820",3,10,1,9,0,10,0,0,0,0,0,10,1,9,0,10,8,8.80715017429598,9.62806337747985,0.40878111630595,31
"2215","CE","Meruoca",15185,6681.85,23004,"Meruoca",2,"Nordeste",0,"230820",4,12,6,6,3,9,0,0,0,0,0,12,6,6,3,9,8,8.80715017429598,9.62806337747985,0.474660084433451,30
"2216","CE","Meruoca",15185,6681.85,23004,"Meruoca",2,"Nordeste",0,"230820",5,14,4,10,5,9,0,0,0,0,0,14,4,10,5,9,11,8.80715017429598,9.62806337747985,0.473066992800698,31
"2217","CE","Milagres",27462,7955.64,23033,"Brejo Santo",2,"Nordeste",0,"230830",2,22,4,18,7,15,0,0,0,0,0,22,4,18,7,15,19,8.98163639008132,10.2205585098817,0.287840845368171,29
"2218","CE","Milagres",27462,7955.64,23033,"Brejo Santo",2,"Nordeste",0,"230830",3,25,11,14,15,10,0,0,0,0,0,25,11,14,15,10,14,8.98163639008132,10.2205585098817,0.412376467074695,31
"2219","CE","Milagres",27462,7955.64,23033,"Brejo Santo",2,"Nordeste",0,"230830",4,30,12,18,9,21,0,0,0,0,0,30,12,18,9,21,20,8.98163639008132,10.2205585098817,0.43716113019502,30
"2220","CE","Milagres",27462,7955.64,23033,"Brejo Santo",2,"Nordeste",0,"230830",5,24,12,12,8,16,0,0,0,0,0,24,12,12,8,16,14,8.98163639008132,10.2205585098817,0.442641948979593,31
"2221","CE","Milhã",13142,9674.79,23021,"Sertão de Senador Pompeu",2,"Nordeste",0,"230835",2,3,2,1,0,3,0,0,0,0,0,3,2,1,0,3,7,9.17727881223606,9.48356848745781,0.260464370795107,29
"2222","CE","Milhã",13142,9674.79,23021,"Sertão de Senador Pompeu",2,"Nordeste",0,"230835",3,4,1,3,2,2,0,0,0,0,0,4,1,3,2,2,9,9.17727881223606,9.48356848745781,0.338367480610149,31
"2223","CE","Milhã",13142,9674.79,23021,"Sertão de Senador Pompeu",2,"Nordeste",0,"230835",4,4,0,4,0,4,0,0,0,0,0,4,0,4,0,4,5,9.17727881223606,9.48356848745781,0.361463044819674,30
"2224","CE","Milhã",13142,9674.79,23021,"Sertão de Senador Pompeu",2,"Nordeste",0,"230835",5,2,1,1,1,1,0,0,0,0,0,2,1,1,1,1,8,9.17727881223606,9.48356848745781,0.362141706789961,31
"2225","CE","Miraíma",13894,6253.17,23005,"Sobral",2,"Nordeste",0,"230837",2,11,1,10,4,7,0,0,0,0,0,11,1,10,4,7,4,8.740843814148,9.53921237125283,0.288925973400488,29
"2226","CE","Miraíma",13894,6253.17,23005,"Sobral",2,"Nordeste",0,"230837",3,19,6,13,9,10,0,0,0,0,0,19,6,13,9,10,6,8.740843814148,9.53921237125283,0.420959469562642,31
"2227","CE","Miraíma",13894,6253.17,23005,"Sobral",2,"Nordeste",0,"230837",4,10,5,5,5,5,1,1,0,0,1,11,6,5,5,6,6,8.740843814148,9.53921237125283,0.441303686834484,30
"2228","CE","Miraíma",13894,6253.17,23005,"Sobral",2,"Nordeste",0,"230837",5,7,5,2,1,6,0,0,0,0,0,7,5,2,1,6,12,8.740843814148,9.53921237125283,0.497338246424552,31
"2229","CE","Missão Velha",35480,13585.53,23032,"Cariri",2,"Nordeste",0,"230840",2,47,16,31,23,24,0,0,0,0,0,47,16,31,23,24,19,9.5167605347174,10.4767244364235,0.311430111036955,29
"2230","CE","Missão Velha",35480,13585.53,23032,"Cariri",2,"Nordeste",0,"230840",3,53,16,37,23,30,0,0,0,0,0,53,16,37,23,30,24,9.5167605347174,10.4767244364235,0.41578149301293,31
"2231","CE","Missão Velha",35480,13585.53,23032,"Cariri",2,"Nordeste",0,"230840",4,43,14,29,19,24,0,0,0,0,0,43,14,29,19,24,22,9.5167605347174,10.4767244364235,0.423553536925134,30
"2232","CE","Missão Velha",35480,13585.53,23032,"Cariri",2,"Nordeste",0,"230840",5,49,19,30,20,29,1,1,0,0,1,50,20,30,20,30,26,9.5167605347174,10.4767244364235,0.429983949359303,31
"2233","CE","Mombaça",43858,7369.18,23021,"Sertão de Senador Pompeu",2,"Nordeste",0,"230850",2,36,14,22,17,19,1,0,1,1,0,37,14,23,18,19,25,8.90506171712087,10.688712421297,0.263275351460319,29
"2234","CE","Mombaça",43858,7369.18,23021,"Sertão de Senador Pompeu",2,"Nordeste",0,"230850",3,37,14,23,21,16,0,0,0,0,0,37,14,23,21,16,31,8.90506171712087,10.688712421297,0.373613178187923,31
"2235","CE","Mombaça",43858,7369.18,23021,"Sertão de Senador Pompeu",2,"Nordeste",0,"230850",4,31,12,19,12,19,0,0,0,0,0,31,12,19,12,19,31,8.90506171712087,10.688712421297,0.436843920452817,30
"2236","CE","Mombaça",43858,7369.18,23021,"Sertão de Senador Pompeu",2,"Nordeste",0,"230850",5,40,15,25,19,21,1,0,1,0,1,41,15,26,19,22,28,8.90506171712087,10.688712421297,0.428464280061044,31
"2237","CE","Monsenhor Tabosa",17249,7436.65,23018,"Sertão de Cratéus",2,"Nordeste",0,"230860",2,8,3,5,4,4,0,0,0,0,0,8,3,5,4,4,15,8.91417575760849,9.75550944976463,0.300585405784148,29
"2238","CE","Monsenhor Tabosa",17249,7436.65,23018,"Sertão de Cratéus",2,"Nordeste",0,"230860",3,6,2,4,0,6,0,0,0,0,0,6,2,4,0,6,14,8.91417575760849,9.75550944976463,0.391803110418568,31
"2239","CE","Monsenhor Tabosa",17249,7436.65,23018,"Sertão de Cratéus",2,"Nordeste",0,"230860",4,9,4,5,3,6,0,0,0,0,0,9,4,5,3,6,15,8.91417575760849,9.75550944976463,0.418725111055781,30
"2240","CE","Monsenhor Tabosa",17249,7436.65,23018,"Sertão de Cratéus",2,"Nordeste",0,"230860",5,5,4,1,2,3,0,0,0,0,0,5,4,1,2,3,20,8.91417575760849,9.75550944976463,0.46681161772509,31
"2241","CE","Morada Nova",61738,15430.56,23023,"Baixo Jaguaribe",2,"Nordeste",0,"230870",2,36,10,26,16,20,0,0,0,0,0,36,10,26,16,20,34,9.64410523763447,11.0306549036215,0.310204261559193,29
"2242","CE","Morada Nova",61738,15430.56,23023,"Baixo Jaguaribe",2,"Nordeste",0,"230870",3,56,17,39,23,33,1,0,1,0,1,57,17,40,23,34,40,9.64410523763447,11.0306549036215,0.414840677287318,31
"2243","CE","Morada Nova",61738,15430.56,23023,"Baixo Jaguaribe",2,"Nordeste",0,"230870",4,49,16,33,9,40,2,1,1,0,2,51,17,34,9,42,39,9.64410523763447,11.0306549036215,0.447429882891087,30
"2244","CE","Morada Nova",61738,15430.56,23023,"Baixo Jaguaribe",2,"Nordeste",0,"230870",5,70,28,42,28,42,0,0,0,0,0,70,28,42,28,42,55,9.64410523763447,11.0306549036215,0.484159865972499,31
"2245","CE","Moraújo",8779,7141.58,23003,"Coreaú",2,"Nordeste",0,"230880",2,8,2,6,4,4,0,0,0,0,0,8,2,6,4,4,4,8.87368931936834,9.08011778492621,0.323836706625925,29
"2246","CE","Moraújo",8779,7141.58,23003,"Coreaú",2,"Nordeste",0,"230880",3,5,1,4,2,3,0,0,0,0,0,5,1,4,2,3,2,8.87368931936834,9.08011778492621,0.473671384151219,31
"2247","CE","Moraújo",8779,7141.58,23003,"Coreaú",2,"Nordeste",0,"230880",4,9,3,6,5,4,0,0,0,0,0,9,3,6,5,4,4,8.87368931936834,9.08011778492621,0.53850554745851,30
"2248","CE","Moraújo",8779,7141.58,23003,"Coreaú",2,"Nordeste",0,"230880",5,7,1,6,3,4,0,0,0,0,0,7,1,6,3,4,5,8.87368931936834,9.08011778492621,0.542335993161113,31
"2249","CE","Morrinhos",22685,6198.22,23001,"Litoral de Camocim e Acaraú",2,"Nordeste",0,"230890",2,21,5,16,5,16,0,0,0,0,0,21,5,16,5,16,6,8.73201743303882,10.0294591920981,0.317453907142965,29
"2250","CE","Morrinhos",22685,6198.22,23001,"Litoral de Camocim e Acaraú",2,"Nordeste",0,"230890",3,22,6,16,10,12,0,0,0,0,0,22,6,16,10,12,8,8.73201743303882,10.0294591920981,0.423231544732417,31
"2251","CE","Morrinhos",22685,6198.22,23001,"Litoral de Camocim e Acaraú",2,"Nordeste",0,"230890",4,19,7,12,8,11,1,0,1,1,0,20,7,13,9,11,12,8.73201743303882,10.0294591920981,0.447609141902747,30
"2252","CE","Morrinhos",22685,6198.22,23001,"Litoral de Camocim e Acaraú",2,"Nordeste",0,"230890",5,25,9,16,15,10,0,0,0,0,0,25,9,16,15,10,12,8.73201743303882,10.0294591920981,0.49620380193689,31
"2253","CE","Mucambo",14549,6687.03,23005,"Sobral",2,"Nordeste",0,"230900",2,12,3,9,6,6,0,0,0,0,0,12,3,9,6,6,12,8.80792510836065,9.58527754171539,0.292295874732856,29
"2254","CE","Mucambo",14549,6687.03,23005,"Sobral",2,"Nordeste",0,"230900",3,15,1,14,7,8,0,0,0,0,0,15,1,14,7,8,10,8.80792510836065,9.58527754171539,0.387001322840926,31
"2255","CE","Mucambo",14549,6687.03,23005,"Sobral",2,"Nordeste",0,"230900",4,8,3,5,3,5,0,0,0,0,0,8,3,5,3,5,9,8.80792510836065,9.58527754171539,0.397827558880226,30
"2256","CE","Mucambo",14549,6687.03,23005,"Sobral",2,"Nordeste",0,"230900",5,9,4,5,3,6,0,0,0,0,0,9,4,5,3,6,11,8.80792510836065,9.58527754171539,0.459199057163483,31
"2257","CE","Mulungu",10941,9079.87,23013,"Baturité",2,"Nordeste",0,"230910",2,9,4,5,4,5,0,0,0,0,0,9,4,5,4,5,3,9.11381515431223,9.30027247947679,0.288701075016527,29
"2258","CE","Mulungu",10941,9079.87,23013,"Baturité",2,"Nordeste",0,"230910",3,8,4,4,2,6,0,0,0,0,0,8,4,4,2,6,1,9.11381515431223,9.30027247947679,0.410612259874889,31
"2259","CE","Mulungu",10941,9079.87,23013,"Baturité",2,"Nordeste",0,"230910",4,10,2,8,4,6,1,1,0,0,1,11,3,8,4,7,4,9.11381515431223,9.30027247947679,0.425796546471817,30
"2260","CE","Mulungu",10941,9079.87,23013,"Baturité",2,"Nordeste",0,"230910",5,13,4,9,8,5,0,0,0,0,0,13,4,9,8,5,11,9.11381515431223,9.30027247947679,0.463781411928753,31
"2261","CE","Nova Olinda",15684,8311.8,23032,"Cariri",2,"Nordeste",0,"230920",2,20,10,10,8,12,0,0,0,0,0,20,10,10,8,12,6,9.02543147089189,9.66039636341222,0.254564721956939,29
"2262","CE","Nova Olinda",15684,8311.8,23032,"Cariri",2,"Nordeste",0,"230920",3,22,5,17,8,14,0,0,0,0,0,22,5,17,8,14,12,9.02543147089189,9.66039636341222,0.341548782097778,31
"2263","CE","Nova Olinda",15684,8311.8,23032,"Cariri",2,"Nordeste",0,"230920",4,14,4,10,8,6,1,0,1,1,0,15,4,11,9,6,14,9.02543147089189,9.66039636341222,0.353941773336812,30
"2264","CE","Nova Olinda",15684,8311.8,23032,"Cariri",2,"Nordeste",0,"230920",5,23,5,18,5,18,0,0,0,0,0,23,5,18,5,18,10,9.02543147089189,9.66039636341222,0.379728661217887,31
"2265","CE","Nova Russas",32408,8305.82,23018,"Sertão de Cratéus",2,"Nordeste",0,"230930",2,19,7,12,5,14,0,0,0,0,0,19,7,12,5,14,14,9.02471175287473,10.3861605848825,0.28144160696185,29
"2266","CE","Nova Russas",32408,8305.82,23018,"Sertão de Cratéus",2,"Nordeste",0,"230930",3,17,8,9,6,11,1,1,0,1,0,18,9,9,7,11,20,9.02471175287473,10.3861605848825,0.382007627433323,31
"2267","CE","Nova Russas",32408,8305.82,23018,"Sertão de Cratéus",2,"Nordeste",0,"230930",4,13,3,10,8,5,0,0,0,0,0,13,3,10,8,5,18,9.02471175287473,10.3861605848825,0.419363515341914,30
"2268","CE","Nova Russas",32408,8305.82,23018,"Sertão de Cratéus",2,"Nordeste",0,"230930",5,20,7,13,6,14,1,1,0,0,1,21,8,13,6,15,29,9.02471175287473,10.3861605848825,0.430192829719762,31
"2269","CE","Novo Oriente",28673,7018.68,23018,"Sertão de Cratéus",2,"Nordeste",0,"230940",2,8,2,6,3,5,0,0,0,0,0,8,2,6,3,5,16,8.85633044515118,10.2637111923986,0.302318115222602,29
"2270","CE","Novo Oriente",28673,7018.68,23018,"Sertão de Cratéus",2,"Nordeste",0,"230940",3,6,3,3,3,3,0,0,0,0,0,6,3,3,3,3,27,8.85633044515118,10.2637111923986,0.403335536357586,31
"2271","CE","Novo Oriente",28673,7018.68,23018,"Sertão de Cratéus",2,"Nordeste",0,"230940",4,5,3,2,2,3,1,1,0,0,1,6,4,2,2,4,14,8.85633044515118,10.2637111923986,0.431282938183932,30
"2272","CE","Novo Oriente",28673,7018.68,23018,"Sertão de Cratéus",2,"Nordeste",0,"230940",5,6,3,3,0,6,1,1,0,0,1,7,4,3,0,7,24,8.85633044515118,10.2637111923986,0.416299076295542,31
"2273","CE","Ocara",25833,6918.38,23014,"Chorozinho",2,"Nordeste",0,"230945",2,12,7,5,4,8,0,0,0,0,0,12,7,5,4,8,15,8.84193691715884,10.1594080233643,0.313930755305676,29
"2274","CE","Ocara",25833,6918.38,23014,"Chorozinho",2,"Nordeste",0,"230945",3,22,10,12,10,12,0,0,0,0,0,22,10,12,10,12,14,8.84193691715884,10.1594080233643,0.420682585157493,31
"2275","CE","Ocara",25833,6918.38,23014,"Chorozinho",2,"Nordeste",0,"230945",4,16,7,9,6,10,1,0,1,0,1,17,7,10,6,11,21,8.84193691715884,10.1594080233643,0.461853966145424,30
"2276","CE","Ocara",25833,6918.38,23014,"Chorozinho",2,"Nordeste",0,"230945",5,20,6,14,11,9,0,0,0,0,0,20,6,14,11,9,27,8.84193691715884,10.1594080233643,0.486029758248762,31
"2277","CE","Orós",21384,8000.89,23026,"Iguatu",2,"Nordeste",0,"230950",2,18,4,14,7,11,0,0,0,0,0,18,4,14,7,11,13,8.98730806447415,9.97039825781875,0.300028746735148,29
"2278","CE","Orós",21384,8000.89,23026,"Iguatu",2,"Nordeste",0,"230950",3,14,7,7,4,10,0,0,0,0,0,14,7,7,4,10,11,8.98730806447415,9.97039825781875,0.395470955342089,31
"2279","CE","Orós",21384,8000.89,23026,"Iguatu",2,"Nordeste",0,"230950",4,17,8,9,7,10,0,0,0,0,0,17,8,9,7,10,9,8.98730806447415,9.97039825781875,0.424765371762181,30
"2280","CE","Orós",21384,8000.89,23026,"Iguatu",2,"Nordeste",0,"230950",5,30,13,17,13,17,0,0,0,0,0,30,13,17,13,17,17,8.98730806447415,9.97039825781875,0.448337417380421,31
"2281","CE","Pacajus",73188,16046.29,23017,"Pacajus",2,"Nordeste",1,"230960",2,45,14,31,21,24,0,0,0,0,0,45,14,31,21,24,41,9.6832329491903,11.2007867520845,0.294432427228916,29
"2282","CE","Pacajus",73188,16046.29,23017,"Pacajus",2,"Nordeste",1,"230960",3,67,16,51,25,42,1,0,1,1,0,68,16,52,26,42,43,9.6832329491903,11.2007867520845,0.410756871950938,31
"2283","CE","Pacajus",73188,16046.29,23017,"Pacajus",2,"Nordeste",1,"230960",4,65,22,43,25,40,0,0,0,0,0,65,22,43,25,40,31,9.6832329491903,11.2007867520845,0.462214989100529,30
"2284","CE","Pacajus",73188,16046.29,23017,"Pacajus",2,"Nordeste",1,"230960",5,61,20,41,21,40,2,0,2,0,2,63,20,43,21,42,57,9.6832329491903,11.2007867520845,0.46882181897457,31
"2285","CE","Pacatuba",84554,14015.57,23016,"Fortaleza",2,"Nordeste",1,"230970",2,83,22,61,31,52,1,0,1,0,1,84,22,62,31,53,42,9.54792413348181,11.3451456624921,0.315376894652799,29
"2286","CE","Pacatuba",84554,14015.57,23016,"Fortaleza",2,"Nordeste",1,"230970",3,77,14,63,31,46,0,0,0,0,0,77,14,63,31,46,32,9.54792413348181,11.3451456624921,0.433537731123514,31
"2287","CE","Pacatuba",84554,14015.57,23016,"Fortaleza",2,"Nordeste",1,"230970",4,61,16,45,18,43,1,1,0,0,1,62,17,45,18,44,55,9.54792413348181,11.3451456624921,0.493179501686722,30
"2288","CE","Pacatuba",84554,14015.57,23016,"Fortaleza",2,"Nordeste",1,"230970",5,90,25,65,40,50,1,1,0,1,0,91,26,65,41,50,84,9.54792413348181,11.3451456624921,0.495314725419851,31
"2289","CE","Pacoti",12288,8863.39,23013,"Baturité",2,"Nordeste",0,"230980",2,10,4,6,3,7,0,0,0,0,0,10,4,6,3,7,6,9.08968458892949,9.41637845538745,0.285332567941087,29
"2290","CE","Pacoti",12288,8863.39,23013,"Baturité",2,"Nordeste",0,"230980",3,3,1,2,1,2,0,0,0,0,0,3,1,2,1,2,13,9.08968458892949,9.41637845538745,0.419215054649142,31
"2291","CE","Pacoti",12288,8863.39,23013,"Baturité",2,"Nordeste",0,"230980",4,5,1,4,2,3,0,0,0,0,0,5,1,4,2,3,6,9.08968458892949,9.41637845538745,0.465131732751461,30
"2292","CE","Pacoti",12288,8863.39,23013,"Baturité",2,"Nordeste",0,"230980",5,8,2,6,3,5,0,0,0,0,0,8,2,6,3,5,11,9.08968458892949,9.41637845538745,0.475474472636317,31
"2293","CE","Palhano",9422,8245.56,23023,"Baixo Jaguaribe",2,"Nordeste",0,"231000",2,14,4,10,5,9,0,0,0,0,0,14,4,10,5,9,9,9.01743015263873,9.15080265925999,0.312576561202069,29
"2294","CE","Palhano",9422,8245.56,23023,"Baixo Jaguaribe",2,"Nordeste",0,"231000",3,6,2,4,2,4,0,0,0,0,0,6,2,4,2,4,4,9.01743015263873,9.15080265925999,0.436647634164658,31
"2295","CE","Palhano",9422,8245.56,23023,"Baixo Jaguaribe",2,"Nordeste",0,"231000",4,8,4,4,2,6,0,0,0,0,0,8,4,4,2,6,9,9.01743015263873,9.15080265925999,0.447333449241914,30
"2296","CE","Palhano",9422,8245.56,23023,"Baixo Jaguaribe",2,"Nordeste",0,"231000",5,8,3,5,4,4,0,0,0,0,0,8,3,5,4,4,5,9.01743015263873,9.15080265925999,0.452419775517504,31
"2297","CE","Palmácia",13439,7017.58,23013,"Baturité",2,"Nordeste",0,"231010",2,4,2,2,2,2,0,0,0,0,0,4,2,2,2,2,2,8.85617370824231,9.50591620654706,0.295183411463393,29
"2298","CE","Palmácia",13439,7017.58,23013,"Baturité",2,"Nordeste",0,"231010",3,8,3,5,1,7,0,0,0,0,0,8,3,5,1,7,8,8.85617370824231,9.50591620654706,0.40570622006071,31
"2299","CE","Palmácia",13439,7017.58,23013,"Baturité",2,"Nordeste",0,"231010",4,13,5,8,7,6,0,0,0,0,0,13,5,8,7,6,4,8.85617370824231,9.50591620654706,0.445314303684851,30
"2300","CE","Palmácia",13439,7017.58,23013,"Baturité",2,"Nordeste",0,"231010",5,10,4,6,6,4,0,0,0,0,0,10,4,6,6,4,7,8.85617370824231,9.50591620654706,0.505108089968535,31
"2301","CE","Paracuru",35304,14316.98,23009,"Baixo Curu",2,"Nordeste",0,"231020",2,56,14,42,23,33,0,0,0,0,0,56,14,42,23,33,27,9.56920152441865,10.4717515509494,0.279495371643413,29
"2302","CE","Paracuru",35304,14316.98,23009,"Baixo Curu",2,"Nordeste",0,"231020",3,37,9,28,18,19,0,0,0,0,0,37,9,28,18,19,19,9.56920152441865,10.4717515509494,0.383131954491476,31
"2303","CE","Paracuru",35304,14316.98,23009,"Baixo Curu",2,"Nordeste",0,"231020",4,34,8,26,12,22,1,1,0,0,1,35,9,26,12,23,18,9.56920152441865,10.4717515509494,0.442296773169265,30
"2304","CE","Paracuru",35304,14316.98,23009,"Baixo Curu",2,"Nordeste",0,"231020",5,42,12,30,17,25,2,1,1,0,2,44,13,31,17,27,32,9.56920152441865,10.4717515509494,0.451696285621228,31
"2305","CE","Paraipaba",32992,11941.7,23009,"Baixo Curu",2,"Nordeste",0,"231025",2,33,6,27,15,18,0,0,0,0,0,33,6,27,15,18,12,9.38779175537119,10.4040203868167,0.296953824306907,29
"2306","CE","Paraipaba",32992,11941.7,23009,"Baixo Curu",2,"Nordeste",0,"231025",3,37,12,25,11,26,0,0,0,0,0,37,12,25,11,26,21,9.38779175537119,10.4040203868167,0.412538205426415,31
"2307","CE","Paraipaba",32992,11941.7,23009,"Baixo Curu",2,"Nordeste",0,"231025",4,23,6,17,11,12,0,0,0,0,0,23,6,17,11,12,17,9.38779175537119,10.4040203868167,0.469896950972453,30
"2308","CE","Paraipaba",32992,11941.7,23009,"Baixo Curu",2,"Nordeste",0,"231025",5,17,4,13,3,14,0,0,0,0,0,17,4,13,3,14,37,9.38779175537119,10.4040203868167,0.480058396190285,31
"2309","CE","Parambu",31455,6709.78,23020,"Sertão de Inhamuns",2,"Nordeste",0,"231030",2,27,8,19,15,12,0,0,0,0,0,27,8,19,15,12,10,8.81132144254298,10.3563132320041,0.267012588654741,29
"2310","CE","Parambu",31455,6709.78,23020,"Sertão de Inhamuns",2,"Nordeste",0,"231030",3,37,19,18,15,22,1,0,1,1,0,38,19,19,16,22,20,8.81132144254298,10.3563132320041,0.324804440194784,31
"2311","CE","Parambu",31455,6709.78,23020,"Sertão de Inhamuns",2,"Nordeste",0,"231030",4,39,13,26,10,29,0,0,0,0,0,39,13,26,10,29,20,8.81132144254298,10.3563132320041,0.358086102320959,30
"2312","CE","Parambu",31455,6709.78,23020,"Sertão de Inhamuns",2,"Nordeste",0,"231030",5,42,13,29,15,27,1,1,0,0,1,43,14,29,15,28,35,8.81132144254298,10.3563132320041,0.420892941017854,31
"2313","CE","Paramoti",12252,7997.84,23012,"Canindé",2,"Nordeste",0,"231040",2,3,0,3,1,2,0,0,0,0,0,3,0,3,1,2,7,8.98692678420541,9.41344446795267,0.308838817088287,29
"2314","CE","Paramoti",12252,7997.84,23012,"Canindé",2,"Nordeste",0,"231040",3,7,2,5,6,1,0,0,0,0,0,7,2,5,6,1,5,8.98692678420541,9.41344446795267,0.413960707884218,31
"2315","CE","Paramoti",12252,7997.84,23012,"Canindé",2,"Nordeste",0,"231040",4,5,3,2,5,0,0,0,0,0,0,5,3,2,5,0,5,8.98692678420541,9.41344446795267,0.49104574158343,30
"2316","CE","Paramoti",12252,7997.84,23012,"Canindé",2,"Nordeste",0,"231040",5,4,2,2,2,2,0,0,0,0,0,4,2,2,2,2,7,8.98692678420541,9.41344446795267,0.489131375177996,31
"2317","CE","Pedra Branca",43309,6723.4,23021,"Sertão de Senador Pompeu",2,"Nordeste",0,"231050",2,22,10,12,11,11,0,0,0,0,0,22,10,12,11,11,23,8.8133492579474,10.6761157445863,0.294905678679266,29
"2318","CE","Pedra Branca",43309,6723.4,23021,"Sertão de Senador Pompeu",2,"Nordeste",0,"231050",3,23,11,12,5,18,0,0,0,0,0,23,11,12,5,18,34,8.8133492579474,10.6761157445863,0.389810624429089,31
"2319","CE","Pedra Branca",43309,6723.4,23021,"Sertão de Senador Pompeu",2,"Nordeste",0,"231050",4,18,5,13,4,14,0,0,0,0,0,18,5,13,4,14,24,8.8133492579474,10.6761157445863,0.430282179229706,30
"2320","CE","Pedra Branca",43309,6723.4,23021,"Sertão de Senador Pompeu",2,"Nordeste",0,"231050",5,29,10,19,10,19,1,1,0,0,1,30,11,19,10,20,29,8.8133492579474,10.6761157445863,0.434715937196699,31
"2321","CE","Penaforte",9143,23504.33,23033,"Brejo Santo",2,"Nordeste",0,"231060",2,12,4,8,3,9,0,0,0,0,0,12,4,8,3,9,3,10.0649399384785,9.12074383816443,0.246783602155468,29
"2322","CE","Penaforte",9143,23504.33,23033,"Brejo Santo",2,"Nordeste",0,"231060",3,15,3,12,6,9,0,0,0,0,0,15,3,12,6,9,5,10.0649399384785,9.12074383816443,0.347415964106757,31
"2323","CE","Penaforte",9143,23504.33,23033,"Brejo Santo",2,"Nordeste",0,"231060",4,9,1,8,8,1,0,0,0,0,0,9,1,8,8,1,6,10.0649399384785,9.12074383816443,0.359696985802735,30
"2324","CE","Penaforte",9143,23504.33,23033,"Brejo Santo",2,"Nordeste",0,"231060",5,12,2,10,4,8,0,0,0,0,0,12,2,10,4,8,6,10.0649399384785,9.12074383816443,0.379267966487495,31
"2325","CE","Pentecoste",37900,10924.95,23011,"Médio Curu",2,"Nordeste",0,"231070",2,40,11,29,22,18,0,0,0,0,0,40,11,29,22,18,26,9.29880444329428,10.5427063910705,0.280992669210208,29
"2326","CE","Pentecoste",37900,10924.95,23011,"Médio Curu",2,"Nordeste",0,"231070",3,41,12,29,12,29,0,0,0,0,0,41,12,29,12,29,29,9.29880444329428,10.5427063910705,0.390140902254158,31
"2327","CE","Pentecoste",37900,10924.95,23011,"Médio Curu",2,"Nordeste",0,"231070",4,29,8,21,16,13,0,0,0,0,0,29,8,21,16,13,16,9.29880444329428,10.5427063910705,0.443150131327096,30
"2328","CE","Pentecoste",37900,10924.95,23011,"Médio Curu",2,"Nordeste",0,"231070",5,35,12,23,19,16,0,0,0,0,0,35,12,23,19,16,30,9.29880444329428,10.5427063910705,0.476686559122594,31
"2329","CE","Pereiro",16331,18931.91,23025,"Serra do Pereiro",2,"Nordeste",0,"231080",2,9,1,8,2,7,0,0,0,0,0,9,1,8,2,7,11,9.84860413715893,9.70082042107674,0.30088546160602,29
"2330","CE","Pereiro",16331,18931.91,23025,"Serra do Pereiro",2,"Nordeste",0,"231080",3,10,6,4,2,8,0,0,0,0,0,10,6,4,2,8,12,9.84860413715893,9.70082042107674,0.409046324512734,31
"2331","CE","Pereiro",16331,18931.91,23025,"Serra do Pereiro",2,"Nordeste",0,"231080",4,20,4,16,8,12,0,0,0,0,0,20,4,16,8,12,5,9.84860413715893,9.70082042107674,0.443642019976744,30
"2332","CE","Pereiro",16331,18931.91,23025,"Serra do Pereiro",2,"Nordeste",0,"231080",5,16,5,11,5,11,0,0,0,0,0,16,5,11,5,11,8,9.84860413715893,9.70082042107674,0.431712768290773,31
"2333","CE","Pindoretama",20769,11747.62,23015,"Cascavel",2,"Nordeste",0,"231085",2,17,6,11,10,7,0,0,0,0,0,17,6,11,10,7,14,9.37140594586415,9.94121676934614,0.310412162948298,29
"2334","CE","Pindoretama",20769,11747.62,23015,"Cascavel",2,"Nordeste",0,"231085",3,9,2,7,2,7,0,0,0,0,0,9,2,7,2,7,14,9.37140594586415,9.94121676934614,0.413726913202404,31
"2335","CE","Pindoretama",20769,11747.62,23015,"Cascavel",2,"Nordeste",0,"231085",4,21,6,15,7,14,1,1,0,0,1,22,7,15,7,15,15,9.37140594586415,9.94121676934614,0.457995019591344,30
"2336","CE","Pindoretama",20769,11747.62,23015,"Cascavel",2,"Nordeste",0,"231085",5,22,5,17,6,16,0,0,0,0,0,22,5,17,6,16,31,9.37140594586415,9.94121676934614,0.461906530117231,31
"2337","CE","Piquet Carneiro",17086,7262.42,23021,"Sertão de Senador Pompeu",2,"Nordeste",0,"231090",2,8,5,3,5,3,0,0,0,0,0,8,5,3,5,3,10,8.89046838560896,9.74601469371156,0.298246960454025,29
"2338","CE","Piquet Carneiro",17086,7262.42,23021,"Sertão de Senador Pompeu",2,"Nordeste",0,"231090",3,9,4,5,4,5,1,1,0,1,0,10,5,5,5,5,13,8.89046838560896,9.74601469371156,0.393993018935443,31
"2339","CE","Piquet Carneiro",17086,7262.42,23021,"Sertão de Senador Pompeu",2,"Nordeste",0,"231090",4,8,2,6,5,3,0,0,0,0,0,8,2,6,5,3,7,8.89046838560896,9.74601469371156,0.41215112134259,30
"2340","CE","Piquet Carneiro",17086,7262.42,23021,"Sertão de Senador Pompeu",2,"Nordeste",0,"231090",5,12,4,8,7,5,0,0,0,0,0,12,4,8,7,5,9,8.89046838560896,9.74601469371156,0.42686972011035,31
"2341","CE","Poranga",12347,6103.61,23006,"Ipu",2,"Nordeste",0,"231100",2,3,2,1,1,2,0,0,0,0,0,3,2,1,1,2,9,8.71663567839359,9.42116839756774,0.320088454975118,29
"2342","CE","Poranga",12347,6103.61,23006,"Ipu",2,"Nordeste",0,"231100",3,2,1,1,1,1,1,1,0,1,0,3,2,1,2,1,13,8.71663567839359,9.42116839756774,0.431304180471516,31
"2343","CE","Poranga",12347,6103.61,23006,"Ipu",2,"Nordeste",0,"231100",4,4,1,3,2,2,1,1,0,1,0,5,2,3,3,2,5,8.71663567839359,9.42116839756774,0.429638101737936,30
"2344","CE","Poranga",12347,6103.61,23006,"Ipu",2,"Nordeste",0,"231100",5,3,2,1,0,3,0,0,0,0,0,3,2,1,0,3,10,8.71663567839359,9.42116839756774,0.442337591816484,31
"2345","CE","Porteiras",14958,9841.9,23032,"Cariri",2,"Nordeste",0,"231110",2,16,3,13,5,11,1,0,1,1,0,17,3,14,6,11,5,9.19440406083783,9.61300155275161,0.240400764163421,29
"2346","CE","Porteiras",14958,9841.9,23032,"Cariri",2,"Nordeste",0,"231110",3,21,8,13,6,15,1,0,1,1,0,22,8,14,7,15,14,9.19440406083783,9.61300155275161,0.359306231129491,31
"2347","CE","Porteiras",14958,9841.9,23032,"Cariri",2,"Nordeste",0,"231110",4,20,11,9,10,10,0,0,0,0,0,20,11,9,10,10,15,9.19440406083783,9.61300155275161,0.383848431804995,30
"2348","CE","Porteiras",14958,9841.9,23032,"Cariri",2,"Nordeste",0,"231110",5,17,7,10,9,8,0,0,0,0,0,17,7,10,9,8,11,9.19440406083783,9.61300155275161,0.37641968118741,31
"2349","CE","Potengi",11106,7955.5,23029,"Chapada do Araripe",2,"Nordeste",0,"231120",2,6,4,2,2,4,0,0,0,0,0,6,4,2,2,4,7,8.98161879234791,9.31524078180155,0.267775549094106,29
"2350","CE","Potengi",11106,7955.5,23029,"Chapada do Araripe",2,"Nordeste",0,"231120",3,16,8,8,9,7,0,0,0,0,0,16,8,8,9,7,4,8.98161879234791,9.31524078180155,0.345384884345438,31
"2351","CE","Potengi",11106,7955.5,23029,"Chapada do Araripe",2,"Nordeste",0,"231120",4,10,4,6,4,6,0,0,0,0,0,10,4,6,4,6,1,8.98161879234791,9.31524078180155,0.410886912285262,30
"2352","CE","Potengi",11106,7955.5,23029,"Chapada do Araripe",2,"Nordeste",0,"231120",5,17,10,7,9,8,0,0,0,0,0,17,10,7,9,8,6,8.98161879234791,9.31524078180155,0.412987232164397,31
"2353","CE","Potiretama",6437,8804.47,23025,"Serra do Pereiro",2,"Nordeste",0,"231123",2,4,0,4,1,3,0,0,0,0,0,4,0,4,1,3,2,9.08301482604651,8.76981787205262,0.259396561295514,29
"2354","CE","Potiretama",6437,8804.47,23025,"Serra do Pereiro",2,"Nordeste",0,"231123",3,4,2,2,0,4,0,0,0,0,0,4,2,2,0,4,3,9.08301482604651,8.76981787205262,0.35428383426755,31
"2355","CE","Potiretama",6437,8804.47,23025,"Serra do Pereiro",2,"Nordeste",0,"231123",4,4,3,1,2,2,0,0,0,0,0,4,3,1,2,2,4,9.08301482604651,8.76981787205262,0.392890945187663,30
"2356","CE","Potiretama",6437,8804.47,23025,"Serra do Pereiro",2,"Nordeste",0,"231123",5,5,1,4,0,5,0,0,0,0,0,5,1,4,0,5,1,9.08301482604651,8.76981787205262,0.464240622208109,31
"2357","CE","Quiterianópolis",21166,6913.59,23018,"Sertão de Cratéus",2,"Nordeste",0,"231126",2,6,2,4,0,6,0,0,0,0,0,6,2,4,0,6,12,8.84124431875218,9.96015139965367,0.31780405245092,29
"2358","CE","Quiterianópolis",21166,6913.59,23018,"Sertão de Cratéus",2,"Nordeste",0,"231126",3,8,1,7,3,5,0,0,0,0,0,8,1,7,3,5,15,8.84124431875218,9.96015139965367,0.409581362560556,31
"2359","CE","Quiterianópolis",21166,6913.59,23018,"Sertão de Cratéus",2,"Nordeste",0,"231126",4,2,1,1,0,2,0,0,0,0,0,2,1,1,0,2,9,8.84124431875218,9.96015139965367,0.430034619616742,30
"2360","CE","Quiterianópolis",21166,6913.59,23018,"Sertão de Cratéus",2,"Nordeste",0,"231126",5,8,4,4,7,1,0,0,0,0,0,8,4,4,7,1,8,8.84124431875218,9.96015139965367,0.436194988876474,31
"2361","CE","Quixadá",88321,11927.82,23019,"Sertão de Quixeramobim",2,"Nordeste",1,"231130",2,9,3,6,2,7,0,0,0,0,0,9,3,6,2,7,33,9.38662876578745,11.3887331839106,0.292935539635898,29
"2362","CE","Quixadá",88321,11927.82,23019,"Sertão de Quixeramobim",2,"Nordeste",1,"231130",3,14,2,12,6,8,0,0,0,0,0,14,2,12,6,8,49,9.38662876578745,11.3887331839106,0.412851498474714,31
"2363","CE","Quixadá",88321,11927.82,23019,"Sertão de Quixeramobim",2,"Nordeste",1,"231130",4,4,1,3,2,2,3,0,3,2,1,7,1,6,4,3,61,9.38662876578745,11.3887331839106,0.451694279670333,30
"2364","CE","Quixadá",88321,11927.82,23019,"Sertão de Quixeramobim",2,"Nordeste",1,"231130",5,10,4,6,4,6,1,0,1,1,0,11,4,7,5,6,73,9.38662876578745,11.3887331839106,0.465567207469692,31
"2365","CE","Quixelô",16147,7905.03,23026,"Iguatu",2,"Nordeste",0,"231135",2,11,5,6,4,7,0,0,0,0,0,11,5,6,4,7,10,8.97525454470279,9.68948955288162,0.295608226725501,29
"2366","CE","Quixelô",16147,7905.03,23026,"Iguatu",2,"Nordeste",0,"231135",3,6,0,6,6,0,0,0,0,0,0,6,0,6,6,0,10,8.97525454470279,9.68948955288162,0.395226204117966,31
"2367","CE","Quixelô",16147,7905.03,23026,"Iguatu",2,"Nordeste",0,"231135",4,18,6,12,7,11,0,0,0,0,0,18,6,12,7,11,10,8.97525454470279,9.68948955288162,0.441563091112568,30
"2368","CE","Quixelô",16147,7905.03,23026,"Iguatu",2,"Nordeste",0,"231135",5,17,10,7,7,10,0,0,0,0,0,17,10,7,7,10,5,8.97525454470279,9.68948955288162,0.457760186664902,31
"2369","CE","Quixeramobim",81778,13420.15,23019,"Sertão de Quixeramobim",2,"Nordeste",1,"231140",2,95,35,60,27,68,1,1,0,0,1,96,36,60,27,69,42,9.50451258781045,11.3117635377624,0.295959425578835,29
"2370","CE","Quixeramobim",81778,13420.15,23019,"Sertão de Quixeramobim",2,"Nordeste",1,"231140",3,79,22,57,30,49,1,0,1,0,1,80,22,58,30,50,53,9.50451258781045,11.3117635377624,0.39549901067927,31
"2371","CE","Quixeramobim",81778,13420.15,23019,"Sertão de Quixeramobim",2,"Nordeste",1,"231140",4,72,22,50,32,40,0,0,0,0,0,72,22,50,32,40,54,9.50451258781045,11.3117635377624,0.454016197626002,30
"2372","CE","Quixeramobim",81778,13420.15,23019,"Sertão de Quixeramobim",2,"Nordeste",1,"231140",5,82,25,57,36,46,1,0,1,0,1,83,25,58,36,47,56,9.50451258781045,11.3117635377624,0.457155532969632,31
"2373","CE","Quixeré",22293,19154.79,23023,"Baixo Jaguaribe",2,"Nordeste",0,"231150",2,17,7,10,6,11,0,0,0,0,0,17,7,10,6,11,9,9.86030809387966,10.0120280068256,0.293730264093452,29
"2374","CE","Quixeré",22293,19154.79,23023,"Baixo Jaguaribe",2,"Nordeste",0,"231150",3,12,3,9,8,4,0,0,0,0,0,12,3,9,8,4,10,9.86030809387966,10.0120280068256,0.388968960717235,31
"2375","CE","Quixeré",22293,19154.79,23023,"Baixo Jaguaribe",2,"Nordeste",0,"231150",4,14,0,14,8,6,0,0,0,0,0,14,0,14,8,6,17,9.86030809387966,10.0120280068256,0.413140052020826,30
"2376","CE","Quixeré",22293,19154.79,23023,"Baixo Jaguaribe",2,"Nordeste",0,"231150",5,29,11,18,9,20,0,0,0,0,0,29,11,18,9,20,14,9.86030809387966,10.0120280068256,0.405881047490816,31
"2377","CE","Redenção",29146,16423.12,23013,"Baturité",2,"Nordeste",0,"231160",2,25,11,14,10,15,0,0,0,0,0,25,11,14,10,15,18,9.70644537713666,10.2800729610936,0.298386632321906,29
"2378","CE","Redenção",29146,16423.12,23013,"Baturité",2,"Nordeste",0,"231160",3,35,9,26,17,18,0,0,0,0,0,35,9,26,17,18,23,9.70644537713666,10.2800729610936,0.405156812226565,31
"2379","CE","Redenção",29146,16423.12,23013,"Baturité",2,"Nordeste",0,"231160",4,33,14,19,22,11,0,0,0,0,0,33,14,19,22,11,17,9.70644537713666,10.2800729610936,0.473982918561734,30
"2380","CE","Redenção",29146,16423.12,23013,"Baturité",2,"Nordeste",0,"231160",5,32,12,20,14,18,0,0,0,0,0,32,12,20,14,18,29,9.70644537713666,10.2800729610936,0.502454600033332,31
"2381","CE","Reriutaba",18385,9859.88,23006,"Ipu",2,"Nordeste",0,"231170",2,22,7,15,9,13,0,0,0,0,0,22,7,15,9,13,12,9.19622927713723,9.81929039373537,0.264746772742787,29
"2382","CE","Reriutaba",18385,9859.88,23006,"Ipu",2,"Nordeste",0,"231170",3,17,5,12,6,11,1,0,1,0,1,18,5,13,6,12,8,9.19622927713723,9.81929039373537,0.377955833960034,31
"2383","CE","Reriutaba",18385,9859.88,23006,"Ipu",2,"Nordeste",0,"231170",4,5,0,5,2,3,1,0,1,0,1,6,0,6,2,4,7,9.19622927713723,9.81929039373537,0.416387114575157,30
"2384","CE","Reriutaba",18385,9859.88,23006,"Ipu",2,"Nordeste",0,"231170",5,8,1,7,3,5,0,0,0,0,0,8,1,7,3,5,17,9.19622927713723,9.81929039373537,0.418399180115151,31
"2385","CE","Russas",78882,14304.44,23023,"Baixo Jaguaribe",2,"Nordeste",1,"231180",2,71,28,43,28,43,0,0,0,0,0,71,28,43,28,43,29,9.5683252575666,11.2757083439247,0.297014114433233,29
"2386","CE","Russas",78882,14304.44,23023,"Baixo Jaguaribe",2,"Nordeste",1,"231180",3,81,18,63,37,44,0,0,0,0,0,81,18,63,37,44,49,9.5683252575666,11.2757083439247,0.398017885734308,31
"2387","CE","Russas",78882,14304.44,23023,"Baixo Jaguaribe",2,"Nordeste",1,"231180",4,63,21,42,27,36,0,0,0,0,0,63,21,42,27,36,45,9.5683252575666,11.2757083439247,0.424743276378471,30
"2388","CE","Russas",78882,14304.44,23023,"Baixo Jaguaribe",2,"Nordeste",1,"231180",5,69,23,46,25,44,0,0,0,0,0,69,23,46,25,44,44,9.5683252575666,11.2757083439247,0.416486889117923,31
"2389","CE","Saboeiro",15788,8035.33,23020,"Sertão de Inhamuns",2,"Nordeste",0,"231190",2,13,2,11,6,7,0,0,0,0,0,13,2,11,6,7,9,8.99160334764561,9.66700543678274,0.31600583412167,29
"2390","CE","Saboeiro",15788,8035.33,23020,"Sertão de Inhamuns",2,"Nordeste",0,"231190",3,8,2,6,4,4,0,0,0,0,0,8,2,6,4,4,9,8.99160334764561,9.66700543678274,0.388266032165029,31
"2391","CE","Saboeiro",15788,8035.33,23020,"Sertão de Inhamuns",2,"Nordeste",0,"231190",4,17,12,5,8,9,0,0,0,0,0,17,12,5,8,9,11,8.99160334764561,9.66700543678274,0.409872907697309,30
"2392","CE","Saboeiro",15788,8035.33,23020,"Sertão de Inhamuns",2,"Nordeste",0,"231190",5,16,5,11,7,9,0,0,0,0,0,16,5,11,7,9,17,8.99160334764561,9.66700543678274,0.423588110428928,31
"2393","CE","Salitre",16635,6602.19,23029,"Chapada do Araripe",2,"Nordeste",0,"231195",2,32,13,19,14,18,0,0,0,0,0,32,13,19,14,18,8,8.79515669115686,9.71926418845258,0.277177991395847,29
"2394","CE","Salitre",16635,6602.19,23029,"Chapada do Araripe",2,"Nordeste",0,"231195",3,21,11,10,10,11,0,0,0,0,0,21,11,10,10,11,11,8.79515669115686,9.71926418845258,0.36475305695889,31
"2395","CE","Salitre",16635,6602.19,23029,"Chapada do Araripe",2,"Nordeste",0,"231195",4,21,8,13,13,8,0,0,0,0,0,21,8,13,13,8,16,8.79515669115686,9.71926418845258,0.375643120148774,30
"2396","CE","Salitre",16635,6602.19,23029,"Chapada do Araripe",2,"Nordeste",0,"231195",5,27,11,16,15,12,0,0,0,0,0,27,11,16,15,12,4,8.79515669115686,9.71926418845258,0.39047797418812,31
"2397","CE","Santana do Acaraú",32654,6705.45,23005,"Sobral",2,"Nordeste",0,"231200",2,42,23,19,18,24,0,0,0,0,0,42,23,19,18,24,11,8.81067590755769,10.3937226386861,0.316820464394699,29
"2398","CE","Santana do Acaraú",32654,6705.45,23005,"Sobral",2,"Nordeste",0,"231200",3,31,11,20,15,16,0,0,0,0,0,31,11,20,15,16,23,8.81067590755769,10.3937226386861,0.429367473514765,31
"2399","CE","Santana do Acaraú",32654,6705.45,23005,"Sobral",2,"Nordeste",0,"231200",4,37,17,20,14,23,0,0,0,0,0,37,17,20,14,23,17,8.81067590755769,10.3937226386861,0.474939786365212,30
"2400","CE","Santana do Acaraú",32654,6705.45,23005,"Sobral",2,"Nordeste",0,"231200",5,37,15,22,19,18,0,0,0,0,0,37,15,22,19,18,30,8.81067590755769,10.3937226386861,0.500956239198294,31
"2401","CE","Santana do Cariri",17712,6921.76,23032,"Cariri",2,"Nordeste",0,"231210",2,14,3,11,3,11,0,0,0,0,0,14,3,11,3,11,9,8.8424253515341,9.78199765494842,0.277653445248266,29
"2402","CE","Santana do Cariri",17712,6921.76,23032,"Cariri",2,"Nordeste",0,"231210",3,23,9,14,11,12,0,0,0,0,0,23,9,14,11,12,8,8.8424253515341,9.78199765494842,0.386052419503038,31
"2403","CE","Santana do Cariri",17712,6921.76,23032,"Cariri",2,"Nordeste",0,"231210",4,21,5,16,7,14,0,0,0,0,0,21,5,16,7,14,9,8.8424253515341,9.78199765494842,0.396936994534381,30
"2404","CE","Santana do Cariri",17712,6921.76,23032,"Cariri",2,"Nordeste",0,"231210",5,24,12,12,11,13,1,1,0,0,1,25,13,12,11,14,8,8.8424253515341,9.78199765494842,0.446369674909487,31
"2405","CE","Santa Quitéria",43711,10095.69,23007,"Santa Quitéria",2,"Nordeste",0,"231220",2,50,9,41,23,27,1,0,1,0,1,51,9,42,23,28,19,9.21986387907979,10.6853550656556,0.283998023471142,29
"2406","CE","Santa Quitéria",43711,10095.69,23007,"Santa Quitéria",2,"Nordeste",0,"231220",3,42,13,29,21,21,0,0,0,0,0,42,13,29,21,21,38,9.21986387907979,10.6853550656556,0.401668295886813,31
"2407","CE","Santa Quitéria",43711,10095.69,23007,"Santa Quitéria",2,"Nordeste",0,"231220",4,30,9,21,10,20,0,0,0,0,0,30,9,21,10,20,27,9.21986387907979,10.6853550656556,0.442593987520534,30
"2408","CE","Santa Quitéria",43711,10095.69,23007,"Santa Quitéria",2,"Nordeste",0,"231220",5,33,9,24,11,22,0,0,0,0,0,33,9,24,11,22,38,9.21986387907979,10.6853550656556,0.45843573265727,31
"2409","CE","São Benedito",48131,10796.05,23002,"Ibiapaba",2,"Nordeste",0,"231230",2,58,18,40,23,35,0,0,0,0,0,58,18,40,23,35,36,9.28693560547211,10.7816817391434,0.300785976711356,29
"2410","CE","São Benedito",48131,10796.05,23002,"Ibiapaba",2,"Nordeste",0,"231230",3,61,26,35,23,38,2,0,2,0,2,63,26,37,23,40,27,9.28693560547211,10.7816817391434,0.411147194594284,31
"2411","CE","São Benedito",48131,10796.05,23002,"Ibiapaba",2,"Nordeste",0,"231230",4,50,16,34,24,26,0,0,0,0,0,50,16,34,24,26,20,9.28693560547211,10.7816817391434,0.463100477357471,30
"2412","CE","São Benedito",48131,10796.05,23002,"Ibiapaba",2,"Nordeste",0,"231230",5,45,17,28,25,20,0,0,0,0,0,45,17,28,25,20,29,9.28693560547211,10.7816817391434,0.466467955916102,31
"2413","CE","São Gonçalo do Amarante",48869,87086.02,23009,"Baixo Curu",2,"Nordeste",0,"231240",2,59,9,50,28,31,0,0,0,0,0,59,9,50,28,31,24,11.3746516447918,10.7968985276034,0.292111527200586,29
"2414","CE","São Gonçalo do Amarante",48869,87086.02,23009,"Baixo Curu",2,"Nordeste",0,"231240",3,73,21,52,27,46,1,0,1,0,1,74,21,53,27,47,30,11.3746516447918,10.7968985276034,0.376493331287653,31
"2415","CE","São Gonçalo do Amarante",48869,87086.02,23009,"Baixo Curu",2,"Nordeste",0,"231240",4,72,12,60,24,48,0,0,0,0,0,72,12,60,24,48,31,11.3746516447918,10.7968985276034,0.430853768003775,30
"2416","CE","São Gonçalo do Amarante",48869,87086.02,23009,"Baixo Curu",2,"Nordeste",0,"231240",5,55,13,42,27,28,0,0,0,0,0,55,13,42,27,28,49,11.3746516447918,10.7968985276034,0.442058356567215,31
"2417","CE","São João do Jaguaribe",7601,11662.2,23023,"Baixo Jaguaribe",2,"Nordeste",0,"231250",2,1,0,1,1,0,0,0,0,0,0,1,0,1,1,0,5,9.36410812135208,8.93603509656604,0.308035039898676,29
"2418","CE","São João do Jaguaribe",7601,11662.2,23023,"Baixo Jaguaribe",2,"Nordeste",0,"231250",3,7,0,7,2,5,0,0,0,0,0,7,0,7,2,5,4,9.36410812135208,8.93603509656604,0.424993558962228,31
"2419","CE","São João do Jaguaribe",7601,11662.2,23023,"Baixo Jaguaribe",2,"Nordeste",0,"231250",4,2,0,2,0,2,0,0,0,0,0,2,0,2,0,2,8,9.36410812135208,8.93603509656604,0.416929406299026,30
"2420","CE","São João do Jaguaribe",7601,11662.2,23023,"Baixo Jaguaribe",2,"Nordeste",0,"231250",5,4,2,2,0,4,0,0,0,0,0,4,2,2,0,4,7,9.36410812135208,8.93603509656604,0.419369543973614,31
"2421","CE","São Luís do Curu",13044,8042.9,23011,"Médio Curu",2,"Nordeste",0,"231260",2,9,4,5,3,6,0,0,0,0,0,9,4,5,3,6,12,8.99254499365508,9.47608353690921,0.330198140499855,29
"2422","CE","São Luís do Curu",13044,8042.9,23011,"Médio Curu",2,"Nordeste",0,"231260",3,11,3,8,7,4,0,0,0,0,0,11,3,8,7,4,6,8.99254499365508,9.47608353690921,0.428523277342764,31
"2423","CE","São Luís do Curu",13044,8042.9,23011,"Médio Curu",2,"Nordeste",0,"231260",4,13,4,9,10,3,0,0,0,0,0,13,4,9,10,3,5,8.99254499365508,9.47608353690921,0.475056022302212,30
"2424","CE","São Luís do Curu",13044,8042.9,23011,"Médio Curu",2,"Nordeste",0,"231260",5,7,4,3,5,2,0,0,0,0,0,7,4,3,5,2,19,8.99254499365508,9.47608353690921,0.493325053773968,31
"2425","CE","Senador Pompeu",25456,11443.71,23021,"Sertão de Senador Pompeu",2,"Nordeste",0,"231270",2,6,0,6,3,3,0,0,0,0,0,6,0,6,3,3,13,9.34519551305898,10.1447067505776,0.286451994444663,29
"2426","CE","Senador Pompeu",25456,11443.71,23021,"Sertão de Senador Pompeu",2,"Nordeste",0,"231270",3,5,1,4,3,2,0,0,0,0,0,5,1,4,3,2,15,9.34519551305898,10.1447067505776,0.386929365515155,31
"2427","CE","Senador Pompeu",25456,11443.71,23021,"Sertão de Senador Pompeu",2,"Nordeste",0,"231270",4,6,3,3,2,4,1,1,0,0,1,7,4,3,2,5,18,9.34519551305898,10.1447067505776,0.4365797964659,30
"2428","CE","Senador Pompeu",25456,11443.71,23021,"Sertão de Senador Pompeu",2,"Nordeste",0,"231270",5,12,7,5,3,9,0,0,0,0,0,12,7,5,3,9,13,9.34519551305898,10.1447067505776,0.448762960682655,31
"2429","CE","Senador Sá",7691,6992.89,23005,"Sobral",2,"Nordeste",0,"231280",2,4,2,2,0,4,0,0,0,0,0,4,2,2,0,4,2,8.85264919756442,8.94780609305705,0.364983903464531,29
"2430","CE","Senador Sá",7691,6992.89,23005,"Sobral",2,"Nordeste",0,"231280",3,12,7,5,11,1,0,0,0,0,0,12,7,5,11,1,6,8.85264919756442,8.94780609305705,0.434516695602512,31
"2431","CE","Senador Sá",7691,6992.89,23005,"Sobral",2,"Nordeste",0,"231280",4,13,2,11,7,6,0,0,0,0,0,13,2,11,7,6,6,8.85264919756442,8.94780609305705,0.464402031975695,30
"2432","CE","Senador Sá",7691,6992.89,23005,"Sobral",2,"Nordeste",0,"231280",5,8,3,5,2,6,0,0,0,0,0,8,3,5,2,6,6,8.85264919756442,8.94780609305705,0.471546182911921,31
"2433","CE","Sobral",210711,23104.7,23005,"Sobral",2,"Nordeste",1,"231290",2,258,39,219,79,179,4,0,4,2,2,262,39,223,81,181,114,10.0477913390175,12.2582428053588,0.305319144054773,29
"2434","CE","Sobral",210711,23104.7,23005,"Sobral",2,"Nordeste",1,"231290",3,235,31,204,84,151,0,0,0,0,0,235,31,204,84,151,124,10.0477913390175,12.2582428053588,0.434177061893863,31
"2435","CE","Sobral",210711,23104.7,23005,"Sobral",2,"Nordeste",1,"231290",4,227,32,195,79,148,0,0,0,0,0,227,32,195,79,148,114,10.0477913390175,12.2582428053588,0.49054110869067,30
"2436","CE","Sobral",210711,23104.7,23005,"Sobral",2,"Nordeste",1,"231290",5,257,52,205,96,161,4,0,4,3,1,261,52,209,99,162,220,10.0477913390175,12.2582428053588,0.513034001866297,31
"2437","CE","Solonópole",18357,10514.05,23021,"Sertão de Senador Pompeu",2,"Nordeste",0,"231300",2,4,1,3,1,3,0,0,0,0,0,4,1,3,1,3,5,9.2604677369321,9.81776625213065,0.248098224258717,29
"2438","CE","Solonópole",18357,10514.05,23021,"Sertão de Senador Pompeu",2,"Nordeste",0,"231300",3,3,0,3,0,3,0,0,0,0,0,3,0,3,0,3,13,9.2604677369321,9.81776625213065,0.335764249272529,31
"2439","CE","Solonópole",18357,10514.05,23021,"Sertão de Senador Pompeu",2,"Nordeste",0,"231300",4,4,0,4,2,2,0,0,0,0,0,4,0,4,2,2,16,9.2604677369321,9.81776625213065,0.387424861867797,30
"2440","CE","Solonópole",18357,10514.05,23021,"Sertão de Senador Pompeu",2,"Nordeste",0,"231300",5,15,4,11,4,11,0,0,0,0,0,15,4,11,4,11,10,9.2604677369321,9.81776625213065,0.394575586444654,31
"2441","CE","Tabuleiro do Norte",30807,10276.06,23023,"Baixo Jaguaribe",2,"Nordeste",0,"231310",2,25,5,20,7,18,1,1,0,0,1,26,6,20,7,19,15,9.23757219706053,10.3354972158664,0.28689372858005,29
"2442","CE","Tabuleiro do Norte",30807,10276.06,23023,"Baixo Jaguaribe",2,"Nordeste",0,"231310",3,21,6,15,10,11,0,0,0,0,0,21,6,15,10,11,19,9.23757219706053,10.3354972158664,0.387523013666958,31
"2443","CE","Tabuleiro do Norte",30807,10276.06,23023,"Baixo Jaguaribe",2,"Nordeste",0,"231310",4,20,4,16,5,15,0,0,0,0,0,20,4,16,5,15,26,9.23757219706053,10.3354972158664,0.41918239495811,30
"2444","CE","Tabuleiro do Norte",30807,10276.06,23023,"Baixo Jaguaribe",2,"Nordeste",0,"231310",5,27,6,21,10,17,1,0,1,1,0,28,6,22,11,17,21,9.23757219706053,10.3354972158664,0.415720853144383,31
"2445","CE","Tamboril",26225,7947.74,23018,"Sertão de Cratéus",2,"Nordeste",0,"231320",2,3,2,1,2,1,0,0,0,0,0,3,2,1,2,1,11,8.98064289050453,10.1744684332645,0.25505601532198,29
"2446","CE","Tamboril",26225,7947.74,23018,"Sertão de Cratéus",2,"Nordeste",0,"231320",3,4,2,2,0,4,2,1,1,1,1,6,3,3,1,5,16,8.98064289050453,10.1744684332645,0.362205984741457,31
"2447","CE","Tamboril",26225,7947.74,23018,"Sertão de Cratéus",2,"Nordeste",0,"231320",4,4,2,2,1,3,0,0,0,0,0,4,2,2,1,3,19,8.98064289050453,10.1744684332645,0.400360866958335,30
"2448","CE","Tamboril",26225,7947.74,23018,"Sertão de Cratéus",2,"Nordeste",0,"231320",5,2,1,1,1,1,0,0,0,0,0,2,1,1,1,1,16,8.98064289050453,10.1744684332645,0.433783527430867,31
"2449","CE","Tarrafas",8573,6788.95,23027,"Várzea Alegre",2,"Nordeste",0,"231325",2,12,2,10,5,7,0,0,0,0,0,12,2,10,5,7,2,8.82305156941961,9.05637300867876,0.309239023721088,29
"2450","CE","Tarrafas",8573,6788.95,23027,"Várzea Alegre",2,"Nordeste",0,"231325",3,8,2,6,3,5,0,0,0,0,0,8,2,6,3,5,5,8.82305156941961,9.05637300867876,0.394417198053556,31
"2451","CE","Tarrafas",8573,6788.95,23027,"Várzea Alegre",2,"Nordeste",0,"231325",4,4,2,2,1,3,0,0,0,0,0,4,2,2,1,3,5,8.82305156941961,9.05637300867876,0.40618042502224,30
"2452","CE","Tarrafas",8573,6788.95,23027,"Várzea Alegre",2,"Nordeste",0,"231325",5,7,1,6,5,2,0,0,0,0,0,7,1,6,5,2,3,8.82305156941961,9.05637300867876,0.424154759899077,31
"2453","CE","Tauá",59062,10253.8,23020,"Sertão de Inhamuns",2,"Nordeste",0,"231330",2,65,15,50,25,40,1,1,0,1,0,66,16,50,26,40,38,9.23540364756985,10.9863430185918,0.273638269672278,29
"2454","CE","Tauá",59062,10253.8,23020,"Sertão de Inhamuns",2,"Nordeste",0,"231330",3,57,16,41,24,33,0,0,0,0,0,57,16,41,24,33,49,9.23540364756985,10.9863430185918,0.374219263608406,31
"2455","CE","Tauá",59062,10253.8,23020,"Sertão de Inhamuns",2,"Nordeste",0,"231330",4,57,15,42,25,32,1,0,1,1,0,58,15,43,26,32,36,9.23540364756985,10.9863430185918,0.409158865747382,30
"2456","CE","Tauá",59062,10253.8,23020,"Sertão de Inhamuns",2,"Nordeste",0,"231330",5,51,14,37,25,26,2,1,1,0,2,53,15,38,25,28,23,9.23540364756985,10.9863430185918,0.418024318171592,31
"2457","CE","Tejuçuoca",19371,5555.49,23011,"Médio Curu",2,"Nordeste",0,"231335",2,17,8,9,10,7,0,0,0,0,0,17,8,9,10,7,7,8.62254190700444,9.87153238129458,0.296767103728,29
"2458","CE","Tejuçuoca",19371,5555.49,23011,"Médio Curu",2,"Nordeste",0,"231335",3,14,9,5,9,5,0,0,0,0,0,14,9,5,9,5,15,8.62254190700444,9.87153238129458,0.402079248351308,31
"2459","CE","Tejuçuoca",19371,5555.49,23011,"Médio Curu",2,"Nordeste",0,"231335",4,18,6,12,10,8,1,1,0,1,0,19,7,12,11,8,8,8.62254190700444,9.87153238129458,0.440109003463183,30
"2460","CE","Tejuçuoca",19371,5555.49,23011,"Médio Curu",2,"Nordeste",0,"231335",5,21,12,9,12,9,1,1,0,0,1,22,13,9,12,10,13,8.62254190700444,9.87153238129458,0.505276158798544,31
"2461","CE","Tianguá",76537,17463.86,23002,"Ibiapaba",2,"Nordeste",1,"231340",2,92,26,66,35,57,0,0,0,0,0,92,26,66,35,57,33,9.76788888170658,11.2455295630195,0.283208378427049,29
"2462","CE","Tianguá",76537,17463.86,23002,"Ibiapaba",2,"Nordeste",1,"231340",3,101,21,80,37,64,0,0,0,0,0,101,21,80,37,64,33,9.76788888170658,11.2455295630195,0.396440687285382,31
"2463","CE","Tianguá",76537,17463.86,23002,"Ibiapaba",2,"Nordeste",1,"231340",4,108,30,78,49,59,2,1,1,1,1,110,31,79,50,60,30,9.76788888170658,11.2455295630195,0.432746435657502,30
"2464","CE","Tianguá",76537,17463.86,23002,"Ibiapaba",2,"Nordeste",1,"231340",5,105,36,69,36,69,3,2,1,2,1,108,38,70,38,70,53,9.76788888170658,11.2455295630195,0.425426236676081,31
"2465","CE","Trairi",56291,14855.42,23008,"Itapipoca",2,"Nordeste",0,"231350",2,59,25,34,28,31,1,1,0,0,1,60,26,34,28,32,21,9.60612006080568,10.9382899434451,0.307255612243509,29
"2466","CE","Trairi",56291,14855.42,23008,"Itapipoca",2,"Nordeste",0,"231350",3,61,18,43,28,33,0,0,0,0,0,61,18,43,28,33,29,9.60612006080568,10.9382899434451,0.39882322654286,31
"2467","CE","Trairi",56291,14855.42,23008,"Itapipoca",2,"Nordeste",0,"231350",4,38,16,22,12,26,1,1,0,0,1,39,17,22,12,27,33,9.60612006080568,10.9382899434451,0.437827518348102,30
"2468","CE","Trairi",56291,14855.42,23008,"Itapipoca",2,"Nordeste",0,"231350",5,43,13,30,23,20,0,0,0,0,0,43,13,30,23,20,57,9.60612006080568,10.9382899434451,0.458122889797361,31
"2469","CE","Tururu",16431,6539.47,23010,"Uruburetama",2,"Nordeste",0,"231355",2,22,8,14,8,14,0,0,0,0,0,22,8,14,8,14,11,8.78561140141199,9.70692507345183,0.324707181353913,29
"2470","CE","Tururu",16431,6539.47,23010,"Uruburetama",2,"Nordeste",0,"231355",3,17,3,14,8,9,1,0,1,0,1,18,3,15,8,10,10,8.78561140141199,9.70692507345183,0.398916249187346,31
"2471","CE","Tururu",16431,6539.47,23010,"Uruburetama",2,"Nordeste",0,"231355",4,8,2,6,2,6,0,0,0,0,0,8,2,6,2,6,12,8.78561140141199,9.70692507345183,0.448679610707241,30
"2472","CE","Tururu",16431,6539.47,23010,"Uruburetama",2,"Nordeste",0,"231355",5,7,2,5,2,5,0,0,0,0,0,7,2,5,2,5,20,8.78561140141199,9.70692507345183,0.527484119349459,31
"2473","CE","Ubajara",35047,16719.18,23002,"Ibiapaba",2,"Nordeste",0,"231360",2,33,6,27,10,23,0,0,0,0,0,33,6,27,10,23,19,9.72431184237384,10.4644452967881,0.274070096909881,29
"2474","CE","Ubajara",35047,16719.18,23002,"Ibiapaba",2,"Nordeste",0,"231360",3,31,7,24,10,21,0,0,0,0,0,31,7,24,10,21,32,9.72431184237384,10.4644452967881,0.400236643490147,31
"2475","CE","Ubajara",35047,16719.18,23002,"Ibiapaba",2,"Nordeste",0,"231360",4,37,16,21,11,26,1,0,1,0,1,38,16,22,11,27,23,9.72431184237384,10.4644452967881,0.443344434017308,30
"2476","CE","Ubajara",35047,16719.18,23002,"Ibiapaba",2,"Nordeste",0,"231360",5,31,14,17,13,18,0,0,0,0,0,31,14,17,13,18,17,9.72431184237384,10.4644452967881,0.45456759146969,31
"2477","CE","Umari",7736,6863.11,23028,"Lavras da Mangabeira",2,"Nordeste",0,"231370",2,3,2,1,2,1,0,0,0,0,0,3,2,1,2,1,6,8.83391597075629,8.95364003713313,0.291309647506883,29
"2478","CE","Umari",7736,6863.11,23028,"Lavras da Mangabeira",2,"Nordeste",0,"231370",3,4,1,3,2,2,0,0,0,0,0,4,1,3,2,2,2,8.83391597075629,8.95364003713313,0.427821227740532,31
"2479","CE","Umari",7736,6863.11,23028,"Lavras da Mangabeira",2,"Nordeste",0,"231370",4,2,2,0,0,2,1,1,0,1,0,3,3,0,1,2,2,8.83391597075629,8.95364003713313,0.461655698159152,30
"2480","CE","Umari",7736,6863.11,23028,"Lavras da Mangabeira",2,"Nordeste",0,"231370",5,5,0,5,3,2,0,0,0,0,0,5,0,5,3,2,4,8.83391597075629,8.95364003713313,0.433097818484326,31
"2481","CE","Umirim",19903,7754.01,23010,"Uruburetama",2,"Nordeste",0,"231375",2,20,8,12,9,11,1,1,0,0,1,21,9,12,9,12,8,8.95596540788699,9.89862575311922,0.309499363336966,29
"2482","CE","Umirim",19903,7754.01,23010,"Uruburetama",2,"Nordeste",0,"231375",3,14,6,8,4,10,0,0,0,0,0,14,6,8,4,10,17,8.95596540788699,9.89862575311922,0.431087406168554,31
"2483","CE","Umirim",19903,7754.01,23010,"Uruburetama",2,"Nordeste",0,"231375",4,10,4,6,4,6,0,0,0,0,0,10,4,6,4,6,14,8.95596540788699,9.89862575311922,0.451724936505072,30
"2484","CE","Umirim",19903,7754.01,23010,"Uruburetama",2,"Nordeste",0,"231375",5,7,4,3,2,5,0,0,0,0,0,7,4,3,2,5,20,8.95596540788699,9.89862575311922,0.506622336978059,31
"2485","CE","Uruburetama",22040,16358.24,23010,"Uruburetama",2,"Nordeste",0,"231380",2,33,9,24,14,19,0,0,0,0,0,33,9,24,14,19,9,9.70248702490755,10.0006142632669,0.290276677896872,29
"2486","CE","Uruburetama",22040,16358.24,23010,"Uruburetama",2,"Nordeste",0,"231380",3,12,2,10,2,10,1,0,1,1,0,13,2,11,3,10,15,9.70248702490755,10.0006142632669,0.410542923141885,31
"2487","CE","Uruburetama",22040,16358.24,23010,"Uruburetama",2,"Nordeste",0,"231380",4,23,7,16,11,12,0,0,0,0,0,23,7,16,11,12,10,9.70248702490755,10.0006142632669,0.449875561940651,30
"2488","CE","Uruburetama",22040,16358.24,23010,"Uruburetama",2,"Nordeste",0,"231380",5,10,3,7,4,6,0,0,0,0,0,10,3,7,4,6,16,9.70248702490755,10.0006142632669,0.49408243346499,31
"2489","CE","Uruoca",13915,12289.43,23003,"Coreaú",2,"Nordeste",0,"231390",2,18,4,14,5,13,0,0,0,0,0,18,4,14,5,13,7,9.41649482231448,9.54072267395999,0.343389638684631,29
"2490","CE","Uruoca",13915,12289.43,23003,"Coreaú",2,"Nordeste",0,"231390",3,13,8,5,5,8,0,0,0,0,0,13,8,5,5,8,5,9.41649482231448,9.54072267395999,0.43631699434326,31
"2491","CE","Uruoca",13915,12289.43,23003,"Coreaú",2,"Nordeste",0,"231390",4,13,6,7,2,11,0,0,0,0,0,13,6,7,2,11,6,9.41649482231448,9.54072267395999,0.479450325946495,30
"2492","CE","Uruoca",13915,12289.43,23003,"Coreaú",2,"Nordeste",0,"231390",5,16,4,12,4,12,1,0,1,1,0,17,4,13,5,12,5,9.41649482231448,9.54072267395999,0.459026791768652,31
"2493","CE","Varjota",18471,14244.64,23006,"Ipu",2,"Nordeste",0,"231395",2,21,8,13,8,13,0,0,0,0,0,21,8,13,8,13,16,9.56413597458739,9.82395721357932,0.287441788390335,29
"2494","CE","Varjota",18471,14244.64,23006,"Ipu",2,"Nordeste",0,"231395",3,22,7,15,13,9,0,0,0,0,0,22,7,15,13,9,14,9.56413597458739,9.82395721357932,0.407528766932283,31
"2495","CE","Varjota",18471,14244.64,23006,"Ipu",2,"Nordeste",0,"231395",4,10,3,7,4,6,0,0,0,0,0,10,3,7,4,6,8,9.56413597458739,9.82395721357932,0.424664087417478,30
"2496","CE","Varjota",18471,14244.64,23006,"Ipu",2,"Nordeste",0,"231395",5,15,2,13,3,12,0,0,0,0,0,15,2,13,3,12,16,9.56413597458739,9.82395721357932,0.444363422097222,31
"2497","CE","Várzea Alegre",40903,8756.89,23027,"Várzea Alegre",2,"Nordeste",0,"231400",2,39,10,29,16,23,0,0,0,0,0,39,10,29,16,23,22,9.07759609806386,10.6189586889742,0.271946329897514,29
"2498","CE","Várzea Alegre",40903,8756.89,23027,"Várzea Alegre",2,"Nordeste",0,"231400",3,45,15,30,22,23,1,0,1,0,1,46,15,31,22,24,25,9.07759609806386,10.6189586889742,0.37884259754077,31
"2499","CE","Várzea Alegre",40903,8756.89,23027,"Várzea Alegre",2,"Nordeste",0,"231400",4,32,10,22,9,23,0,0,0,0,0,32,10,22,9,23,21,9.07759609806386,10.6189586889742,0.424827105097938,30
"2500","CE","Várzea Alegre",40903,8756.89,23027,"Várzea Alegre",2,"Nordeste",0,"231400",5,30,6,24,10,20,1,1,0,0,1,31,7,24,10,21,21,9.07759609806386,10.6189586889742,0.412147337453963,31
"2501","CE","Viçosa do Ceará",61410,7202.63,23002,"Ibiapaba",2,"Nordeste",0,"231410",2,81,32,49,38,43,0,0,0,0,0,81,32,49,38,43,30,8.88220151608424,11.0253279673234,0.296981514098618,29
"2502","CE","Viçosa do Ceará",61410,7202.63,23002,"Ibiapaba",2,"Nordeste",0,"231410",3,74,31,43,36,38,0,0,0,0,0,74,31,43,36,38,43,8.88220151608424,11.0253279673234,0.428880995251163,31
"2503","CE","Viçosa do Ceará",61410,7202.63,23002,"Ibiapaba",2,"Nordeste",0,"231410",4,46,22,24,16,30,2,1,1,1,1,48,23,25,17,31,33,8.88220151608424,11.0253279673234,0.462423583079731,30
"2504","CE","Viçosa do Ceará",61410,7202.63,23002,"Ibiapaba",2,"Nordeste",0,"231410",5,72,28,44,32,40,0,0,0,0,0,72,28,44,32,40,39,8.88220151608424,11.0253279673234,0.501975234378627,31
"2505","RN","Acari",11121,10388.03,24012,"Seridó Oriental",2,"Nordeste",0,"240010",2,8,1,7,2,6,0,0,0,0,0,8,1,7,2,6,5,9.2484094607261,9.31659049181884,0.27262863171052,29
"2506","RN","Acari",11121,10388.03,24012,"Seridó Oriental",2,"Nordeste",0,"240010",3,7,2,5,2,5,0,0,0,0,0,7,2,5,2,5,6,9.2484094607261,9.31659049181884,0.356091697425923,31
"2507","RN","Acari",11121,10388.03,24012,"Seridó Oriental",2,"Nordeste",0,"240010",4,7,0,7,4,3,0,0,0,0,0,7,0,7,4,3,6,9.2484094607261,9.31659049181884,0.369087822277194,30
"2508","RN","Acari",11121,10388.03,24012,"Seridó Oriental",2,"Nordeste",0,"240010",5,16,6,10,6,10,0,0,0,0,0,16,6,10,6,10,11,9.2484094607261,9.31659049181884,0.358828765024741,31
"2509","RN","Açu",58384,19009.95,24004,"Vale do Açu",2,"Nordeste",1,"240020",2,59,17,42,24,35,1,0,1,0,1,60,17,43,24,36,33,9.85271780528438,10.9747971586762,0.273529912279948,29
"2510","RN","Açu",58384,19009.95,24004,"Vale do Açu",2,"Nordeste",1,"240020",3,51,14,37,21,30,0,0,0,0,0,51,14,37,21,30,35,9.85271780528438,10.9747971586762,0.361518662255611,31
"2511","RN","Açu",58384,19009.95,24004,"Vale do Açu",2,"Nordeste",1,"240020",4,36,19,17,20,16,0,0,0,0,0,36,19,17,20,16,33,9.85271780528438,10.9747971586762,0.400620329088498,30
"2512","RN","Açu",58384,19009.95,24004,"Vale do Açu",2,"Nordeste",1,"240020",5,58,25,33,25,33,0,0,0,0,0,58,25,33,25,33,35,9.85271780528438,10.9747971586762,0.383640565847968,31
"2513","RN","Afonso Bezerra",11029,8595.97,24009,"Angicos",2,"Nordeste",0,"240030",2,9,3,6,4,5,0,0,0,0,0,9,3,6,4,5,2,9.05904876776096,9.30828344630615,0.3063154028366,29
"2514","RN","Afonso Bezerra",11029,8595.97,24009,"Angicos",2,"Nordeste",0,"240030",3,2,0,2,0,2,0,0,0,0,0,2,0,2,0,2,4,9.05904876776096,9.30828344630615,0.381201441497352,31
"2515","RN","Afonso Bezerra",11029,8595.97,24009,"Angicos",2,"Nordeste",0,"240030",4,6,2,4,2,4,0,0,0,0,0,6,2,4,2,4,6,9.05904876776096,9.30828344630615,0.409964663577712,30
"2516","RN","Afonso Bezerra",11029,8595.97,24009,"Angicos",2,"Nordeste",0,"240030",5,8,2,6,6,2,0,0,0,0,0,8,2,6,6,2,4,9.05904876776096,9.30828344630615,0.395423887308544,31
"2517","RN","Alexandria",13553,9600.68,24006,"Pau dos Ferros",2,"Nordeste",0,"240050",2,9,5,4,2,7,0,0,0,0,0,9,5,4,2,7,6,9.1695892082807,9.51436320401602,0.27063377501033,29
"2518","RN","Alexandria",13553,9600.68,24006,"Pau dos Ferros",2,"Nordeste",0,"240050",3,14,9,5,9,5,0,0,0,0,0,14,9,5,9,5,9,9.1695892082807,9.51436320401602,0.362363811919575,31
"2519","RN","Alexandria",13553,9600.68,24006,"Pau dos Ferros",2,"Nordeste",0,"240050",4,15,5,10,6,9,0,0,0,0,0,15,5,10,6,9,17,9.1695892082807,9.51436320401602,0.392113890272531,30
"2520","RN","Alexandria",13553,9600.68,24006,"Pau dos Ferros",2,"Nordeste",0,"240050",5,15,9,6,8,7,0,0,0,0,0,15,9,6,8,7,7,9.1695892082807,9.51436320401602,0.365523798706565,31
"2521","RN","Almino Afonso",4710,7775.43,24007,"Umarizal",2,"Nordeste",0,"240060",2,4,2,2,0,4,0,0,0,0,0,4,2,2,0,4,2,8.95872404098438,8.45744318701046,0.287404351872371,29
"2522","RN","Almino Afonso",4710,7775.43,24007,"Umarizal",2,"Nordeste",0,"240060",3,1,0,1,0,1,0,0,0,0,0,1,0,1,0,1,1,8.95872404098438,8.45744318701046,0.363926673332604,31
"2523","RN","Almino Afonso",4710,7775.43,24007,"Umarizal",2,"Nordeste",0,"240060",4,2,0,2,2,0,0,0,0,0,0,2,0,2,2,0,4,8.95872404098438,8.45744318701046,0.449320028760699,30
"2524","RN","Almino Afonso",4710,7775.43,24007,"Umarizal",2,"Nordeste",0,"240060",5,3,2,1,1,2,0,0,0,0,0,3,2,1,1,2,2,8.95872404098438,8.45744318701046,0.422119563179652,31
"2525","RN","Alto do Rodrigues",14728,33684.54,24004,"Vale do Açu",2,"Nordeste",0,"240070",2,8,2,6,0,8,0,0,0,0,0,8,2,6,0,8,4,10.4247942573716,9.59750572291291,0.285688035490882,29
"2526","RN","Alto do Rodrigues",14728,33684.54,24004,"Vale do Açu",2,"Nordeste",0,"240070",3,21,7,14,8,13,0,0,0,0,0,21,7,14,8,13,6,10.4247942573716,9.59750572291291,0.362687731085638,31
"2527","RN","Alto do Rodrigues",14728,33684.54,24004,"Vale do Açu",2,"Nordeste",0,"240070",4,9,4,5,2,7,0,0,0,0,0,9,4,5,2,7,5,10.4247942573716,9.59750572291291,0.382762723281357,30
"2528","RN","Alto do Rodrigues",14728,33684.54,24004,"Vale do Açu",2,"Nordeste",0,"240070",5,15,3,12,7,8,0,0,0,0,0,15,3,12,7,8,16,10.4247942573716,9.59750572291291,0.390000552286762,31
"2529","RN","Angicos",11705,11692.68,24009,"Angicos",2,"Nordeste",0,"240080",2,12,4,8,3,9,0,0,0,0,0,12,4,8,3,9,6,9.36671828396519,9.36777137992501,0.272430469386187,29
"2530","RN","Angicos",11705,11692.68,24009,"Angicos",2,"Nordeste",0,"240080",3,10,2,8,2,8,0,0,0,0,0,10,2,8,2,8,7,9.36671828396519,9.36777137992501,0.350968379001859,31
"2531","RN","Angicos",11705,11692.68,24009,"Angicos",2,"Nordeste",0,"240080",4,6,1,5,1,5,0,0,0,0,0,6,1,5,1,5,7,9.36671828396519,9.36777137992501,0.376989447760003,30
"2532","RN","Angicos",11705,11692.68,24009,"Angicos",2,"Nordeste",0,"240080",5,13,4,9,5,8,0,0,0,0,0,13,4,9,5,8,8,9.36671828396519,9.36777137992501,0.368748365424479,31
"2533","RN","Antônio Martins",7154,7678.86,24007,"Umarizal",2,"Nordeste",0,"240090",2,4,2,2,1,3,0,0,0,0,0,4,2,2,1,3,7,8.94622637762378,8.87542691981896,0.33001961102181,29
"2534","RN","Antônio Martins",7154,7678.86,24007,"Umarizal",2,"Nordeste",0,"240090",3,9,4,5,5,4,0,0,0,0,0,9,4,5,5,4,5,8.94622637762378,8.87542691981896,0.411802221040219,31
"2535","RN","Antônio Martins",7154,7678.86,24007,"Umarizal",2,"Nordeste",0,"240090",4,7,3,4,2,5,0,0,0,0,0,7,3,4,2,5,3,8.94622637762378,8.87542691981896,0.453125007497454,30
"2536","RN","Antônio Martins",7154,7678.86,24007,"Umarizal",2,"Nordeste",0,"240090",5,6,2,4,1,5,0,0,0,0,0,6,2,4,1,5,6,8.94622637762378,8.87542691981896,0.444946089361272,31
"2537","RN","Apodi",35874,13736.01,24002,"Chapada do Apodi",2,"Nordeste",0,"240100",2,27,7,20,8,19,0,0,0,0,0,27,7,20,8,19,18,9.52777613059102,10.487768078109,0.283126569456452,29
"2538","RN","Apodi",35874,13736.01,24002,"Chapada do Apodi",2,"Nordeste",0,"240100",3,33,10,23,11,22,0,0,0,0,0,33,10,23,11,22,14,9.52777613059102,10.487768078109,0.383253473737062,31
"2539","RN","Apodi",35874,13736.01,24002,"Chapada do Apodi",2,"Nordeste",0,"240100",4,27,7,20,9,18,0,0,0,0,0,27,7,20,9,18,22,9.52777613059102,10.487768078109,0.436456538166717,30
"2540","RN","Apodi",35874,13736.01,24002,"Chapada do Apodi",2,"Nordeste",0,"240100",5,32,9,23,14,18,0,0,0,0,0,32,9,23,14,18,21,9.52777613059102,10.487768078109,0.452276405299845,31
"2541","RN","Areia Branca",27967,24877.33,24001,"Mossoró",2,"Nordeste",1,"240110",2,27,6,21,9,18,0,0,0,0,0,27,6,21,9,18,18,10.1217122259819,10.2387805226673,0.280790468661123,29
"2542","RN","Areia Branca",27967,24877.33,24001,"Mossoró",2,"Nordeste",1,"240110",3,23,5,18,10,13,0,0,0,0,0,23,5,18,10,13,22,10.1217122259819,10.2387805226673,0.38105879809484,31
"2543","RN","Areia Branca",27967,24877.33,24001,"Mossoró",2,"Nordeste",1,"240110",4,17,4,13,14,3,0,0,0,0,0,17,4,13,14,3,11,10.1217122259819,10.2387805226673,0.420833313019263,30
"2544","RN","Areia Branca",27967,24877.33,24001,"Mossoró",2,"Nordeste",1,"240110",5,17,8,9,7,10,0,0,0,0,0,17,8,9,7,10,48,10.1217122259819,10.2387805226673,0.448164428136732,31
"2545","RN","Arês",14417,31547.93,24019,"Litoral Sul",2,"Nordeste",0,"240120",2,10,4,6,3,7,0,0,0,0,0,10,4,6,3,7,7,10.3592632556743,9.5761633448119,0.293188890203577,29
"2546","RN","Arês",14417,31547.93,24019,"Litoral Sul",2,"Nordeste",0,"240120",3,16,8,8,13,3,0,0,0,0,0,16,8,8,13,3,7,10.3592632556743,9.5761633448119,0.415973500939779,31
"2547","RN","Arês",14417,31547.93,24019,"Litoral Sul",2,"Nordeste",0,"240120",4,10,3,7,2,8,0,0,0,0,0,10,3,7,2,8,5,10.3592632556743,9.5761633448119,0.425334338907203,30
"2548","RN","Arês",14417,31547.93,24019,"Litoral Sul",2,"Nordeste",0,"240120",5,17,10,7,6,11,0,0,0,0,0,17,10,7,6,11,7,10.3592632556743,9.5761633448119,0.423124928539975,31
"2549","RN","Campo Grande",9670,8736.18,24003,"Médio Oeste",2,"Nordeste",0,"240130",2,7,3,4,0,7,0,0,0,0,0,7,3,4,0,7,6,9.07522830216802,9.17678358844734,0.282344072597863,29
"2550","RN","Campo Grande",9670,8736.18,24003,"Médio Oeste",2,"Nordeste",0,"240130",3,7,3,4,2,5,0,0,0,0,0,7,3,4,2,5,8,9.07522830216802,9.17678358844734,0.347569933704823,31
"2551","RN","Campo Grande",9670,8736.18,24003,"Médio Oeste",2,"Nordeste",0,"240130",4,8,2,6,4,4,0,0,0,0,0,8,2,6,4,4,8,9.07522830216802,9.17678358844734,0.359810931740052,30
"2552","RN","Campo Grande",9670,8736.18,24003,"Médio Oeste",2,"Nordeste",0,"240130",5,10,6,4,3,7,0,0,0,0,0,10,6,4,3,7,5,9.07522830216802,9.17678358844734,0.37201160187843,31
"2553","RN","Baía Formosa",9322,16170.82,24019,"Litoral Sul",2,"Nordeste",0,"240140",2,6,2,4,1,5,0,0,0,0,0,6,2,4,1,5,4,9.69096366247895,9.14013247693269,0.269370990451234,29
"2554","RN","Baía Formosa",9322,16170.82,24019,"Litoral Sul",2,"Nordeste",0,"240140",3,6,2,4,2,4,0,0,0,0,0,6,2,4,2,4,6,9.69096366247895,9.14013247693269,0.370119647291314,31
"2555","RN","Baía Formosa",9322,16170.82,24019,"Litoral Sul",2,"Nordeste",0,"240140",4,5,3,2,2,3,0,0,0,0,0,5,3,2,2,3,7,9.69096366247895,9.14013247693269,0.435684922212466,30
"2556","RN","Baía Formosa",9322,16170.82,24019,"Litoral Sul",2,"Nordeste",0,"240140",5,9,4,5,3,6,0,0,0,0,0,9,4,5,3,6,6,9.69096366247895,9.14013247693269,0.425581098771552,31
"2557","RN","Baraúna",28747,19514.31,24001,"Mossoró",2,"Nordeste",0,"240145",2,29,16,13,14,15,0,0,0,0,0,29,16,13,14,15,16,9.87890332157226,10.2662886929548,0.278300307829114,29
"2558","RN","Baraúna",28747,19514.31,24001,"Mossoró",2,"Nordeste",0,"240145",3,27,14,13,15,12,1,0,1,0,1,28,14,14,15,13,13,9.87890332157226,10.2662886929548,0.368896874913188,31
"2559","RN","Baraúna",28747,19514.31,24001,"Mossoró",2,"Nordeste",0,"240145",4,19,10,9,7,12,0,0,0,0,0,19,10,9,7,12,13,9.87890332157226,10.2662886929548,0.383276132949545,30
"2560","RN","Baraúna",28747,19514.31,24001,"Mossoró",2,"Nordeste",0,"240145",5,22,9,13,10,12,0,0,0,0,0,22,9,13,10,12,24,9.87890332157226,10.2662886929548,0.414930080710587,31
"2561","RN","Barcelona",3994,9197.51,24014,"Borborema Potiguar",2,"Nordeste",0,"240150",2,2,1,1,1,1,0,0,0,0,0,2,1,1,1,1,2,9.12668807423031,8.29254851397576,0.315868323756169,29
"2562","RN","Barcelona",3994,9197.51,24014,"Borborema Potiguar",2,"Nordeste",0,"240150",3,7,2,5,2,5,0,0,0,0,0,7,2,5,2,5,3,9.12668807423031,8.29254851397576,0.425720279046159,31
"2563","RN","Barcelona",3994,9197.51,24014,"Borborema Potiguar",2,"Nordeste",0,"240150",4,3,1,2,0,3,0,0,0,0,0,3,1,2,0,3,2,9.12668807423031,8.29254851397576,0.416426600404053,30
"2564","RN","Barcelona",3994,9197.51,24014,"Borborema Potiguar",2,"Nordeste",0,"240150",5,3,1,2,1,2,0,0,0,0,0,3,1,2,1,2,3,9.12668807423031,8.29254851397576,0.453472825264906,31
"2565","RN","Bento Fernandes",5525,8670.25,24013,"Baixa Verde",2,"Nordeste",0,"240160",2,4,0,4,2,2,0,0,0,0,0,4,0,4,2,2,2,9.0676529044223,8.61703852638595,0.315722117587244,29
"2566","RN","Bento Fernandes",5525,8670.25,24013,"Baixa Verde",2,"Nordeste",0,"240160",3,7,1,6,4,3,0,0,0,0,0,7,1,6,4,3,2,9.0676529044223,8.61703852638595,0.422136885724004,31
"2567","RN","Bento Fernandes",5525,8670.25,24013,"Baixa Verde",2,"Nordeste",0,"240160",4,1,0,1,0,1,0,0,0,0,0,1,0,1,0,1,1,9.0676529044223,8.61703852638595,0.450702542038319,30
"2568","RN","Bento Fernandes",5525,8670.25,24013,"Baixa Verde",2,"Nordeste",0,"240160",5,5,3,2,3,2,0,0,0,0,0,5,3,2,3,2,2,9.0676529044223,8.61703852638595,0.435523489079652,31
"2569","RN","Bom Jesus",10267,8148.63,24015,"Agreste Potiguar",2,"Nordeste",0,"240170",2,8,3,5,1,7,0,0,0,0,0,8,3,5,1,7,7,9.00560509394532,9.23669014729897,0.283123191416888,29
"2570","RN","Bom Jesus",10267,8148.63,24015,"Agreste Potiguar",2,"Nordeste",0,"240170",3,9,3,6,4,5,1,1,0,1,0,10,4,6,5,5,5,9.00560509394532,9.23669014729897,0.373649203233265,31
"2571","RN","Bom Jesus",10267,8148.63,24015,"Agreste Potiguar",2,"Nordeste",0,"240170",4,13,8,5,5,8,0,0,0,0,0,13,8,5,5,8,13,9.00560509394532,9.23669014729897,0.385989741625303,30
"2572","RN","Bom Jesus",10267,8148.63,24015,"Agreste Potiguar",2,"Nordeste",0,"240170",5,11,3,8,3,8,0,0,0,0,0,11,3,8,3,8,3,9.00560509394532,9.23669014729897,0.395590452733816,31
"2573","RN","Brejinho",12787,12028.7,24015,"Agreste Potiguar",2,"Nordeste",0,"240180",2,16,5,11,6,10,0,0,0,0,0,16,5,11,6,10,9,9.39505073995409,9.45618430881117,0.261201558916314,29
"2574","RN","Brejinho",12787,12028.7,24015,"Agreste Potiguar",2,"Nordeste",0,"240180",3,14,9,5,8,6,0,0,0,0,0,14,9,5,8,6,12,9.39505073995409,9.45618430881117,0.348817891222397,31
"2575","RN","Brejinho",12787,12028.7,24015,"Agreste Potiguar",2,"Nordeste",0,"240180",4,12,7,5,2,10,0,0,0,0,0,12,7,5,2,10,9,9.39505073995409,9.45618430881117,0.375473263179421,30
"2576","RN","Brejinho",12787,12028.7,24015,"Agreste Potiguar",2,"Nordeste",0,"240180",5,12,6,6,4,8,0,0,0,0,0,12,6,6,4,8,8,9.39505073995409,9.45618430881117,0.378633344748548,31
"2577","RN","Caiçara do Norte",6561,11257.31,24008,"Macau",2,"Nordeste",0,"240185",2,9,6,3,3,6,0,0,0,0,0,9,6,3,3,6,2,9.32877297439617,8.78889830934488,0.265817656570676,29
"2578","RN","Caiçara do Norte",6561,11257.31,24008,"Macau",2,"Nordeste",0,"240185",3,7,3,4,5,2,0,0,0,0,0,7,3,4,5,2,1,9.32877297439617,8.78889830934488,0.302173343772571,31
"2579","RN","Caiçara do Norte",6561,11257.31,24008,"Macau",2,"Nordeste",0,"240185",4,3,3,0,1,2,0,0,0,0,0,3,3,0,1,2,1,9.32877297439617,8.78889830934488,0.295741003793341,30
"2580","RN","Caiçara do Norte",6561,11257.31,24008,"Macau",2,"Nordeste",0,"240185",5,6,4,2,5,1,0,0,0,0,0,6,4,2,5,1,5,9.32877297439617,8.78889830934488,0.275076817532899,31
"2581","RN","Caiçara do Rio do Vento",3715,9510.31,24009,"Angicos",2,"Nordeste",0,"240190",2,4,2,2,3,1,1,1,0,0,1,5,3,2,3,2,0,9.16013175227419,8.22013395715186,0.307296344126757,29
"2582","RN","Caiçara do Rio do Vento",3715,9510.31,24009,"Angicos",2,"Nordeste",0,"240190",3,6,4,2,4,2,0,0,0,0,0,6,4,2,4,2,2,9.16013175227419,8.22013395715186,0.38588649704602,31
"2583","RN","Caiçara do Rio do Vento",3715,9510.31,24009,"Angicos",2,"Nordeste",0,"240190",4,1,0,1,1,0,1,1,0,0,1,2,1,1,1,1,2,9.16013175227419,8.22013395715186,0.404485886105895,30
"2584","RN","Caiçara do Rio do Vento",3715,9510.31,24009,"Angicos",2,"Nordeste",0,"240190",5,3,0,3,1,2,0,0,0,0,0,3,0,3,1,2,3,9.16013175227419,8.22013395715186,0.435739382733031,31
"2585","RN","Caicó",68343,17533.57,24011,"Seridó Ocidental",2,"Nordeste",1,"240200",2,39,13,26,11,28,0,0,0,0,0,39,13,26,11,28,33,9.77187260806545,11.1322944228621,0.25736210471288,29
"2586","RN","Caicó",68343,17533.57,24011,"Seridó Ocidental",2,"Nordeste",1,"240200",3,62,13,49,19,43,1,0,1,1,0,63,13,50,20,43,42,9.77187260806545,11.1322944228621,0.344353665292416,31
"2587","RN","Caicó",68343,17533.57,24011,"Seridó Ocidental",2,"Nordeste",1,"240200",4,49,17,32,21,28,2,0,2,0,2,51,17,34,21,30,37,9.77187260806545,11.1322944228621,0.380664267751527,30
"2588","RN","Caicó",68343,17533.57,24011,"Seridó Ocidental",2,"Nordeste",1,"240200",5,76,13,63,27,49,0,0,0,0,0,76,13,63,27,49,40,9.77187260806545,11.1322944228621,0.389249968987664,31
"2589","RN","Campo Redondo",11291,7356.92,24014,"Borborema Potiguar",2,"Nordeste",0,"240210",2,3,0,3,1,2,0,0,0,0,0,3,0,3,1,2,4,8.90339664587559,9.33176122718052,0.319447906198085,29
"2590","RN","Campo Redondo",11291,7356.92,24014,"Borborema Potiguar",2,"Nordeste",0,"240210",3,13,3,10,6,7,0,0,0,0,0,13,3,10,6,7,8,8.90339664587559,9.33176122718052,0.400704593593083,31
"2591","RN","Campo Redondo",11291,7356.92,24014,"Borborema Potiguar",2,"Nordeste",0,"240210",4,8,5,3,4,4,0,0,0,0,0,8,5,3,4,4,6,8.90339664587559,9.33176122718052,0.450878634361765,30
"2592","RN","Campo Redondo",11291,7356.92,24014,"Borborema Potiguar",2,"Nordeste",0,"240210",5,7,1,6,3,4,1,0,1,1,0,8,1,7,4,4,3,8.90339664587559,9.33176122718052,0.450533891489148,31
"2593","RN","Canguaretama",34548,15424.27,24019,"Litoral Sul",2,"Nordeste",1,"240220",2,34,15,19,13,21,0,0,0,0,0,34,15,19,13,21,14,9.64369752188384,10.4501049404002,0.295197786691287,29
"2594","RN","Canguaretama",34548,15424.27,24019,"Litoral Sul",2,"Nordeste",1,"240220",3,45,25,20,24,21,0,0,0,0,0,45,25,20,24,21,16,9.64369752188384,10.4501049404002,0.387507289077137,31
"2595","RN","Canguaretama",34548,15424.27,24019,"Litoral Sul",2,"Nordeste",1,"240220",4,35,18,17,19,16,0,0,0,0,0,35,18,17,19,16,16,9.64369752188384,10.4501049404002,0.426852928328549,30
"2596","RN","Canguaretama",34548,15424.27,24019,"Litoral Sul",2,"Nordeste",1,"240220",5,51,17,34,18,33,0,0,0,0,0,51,17,34,18,33,16,9.64369752188384,10.4501049404002,0.417053129785354,31
"2597","RN","Caraúbas",20541,17410.77,24002,"Chapada do Apodi",2,"Nordeste",0,"240230",2,20,7,13,7,13,0,0,0,0,0,20,7,13,7,13,12,9.76484425923971,9.93017816778917,0.266975392713396,29
"2598","RN","Caraúbas",20541,17410.77,24002,"Chapada do Apodi",2,"Nordeste",0,"240230",3,16,3,13,4,12,0,0,0,0,0,16,3,13,4,12,23,9.76484425923971,9.93017816778917,0.369031438177023,31
"2599","RN","Caraúbas",20541,17410.77,24002,"Chapada do Apodi",2,"Nordeste",0,"240230",4,12,2,10,7,5,0,0,0,0,0,12,2,10,7,5,13,9.76484425923971,9.93017816778917,0.39415632934623,30
"2600","RN","Caraúbas",20541,17410.77,24002,"Chapada do Apodi",2,"Nordeste",0,"240230",5,13,4,9,4,9,0,0,0,0,0,13,4,9,4,9,8,9.76484425923971,9.93017816778917,0.387381220317878,31
"2601","RN","Carnaúba dos Dantas",8239,10191.51,24012,"Seridó Oriental",2,"Nordeste",0,"240240",2,4,0,4,1,3,0,0,0,0,0,4,0,4,1,3,5,9.22931029973314,9.01663425631559,0.266644546709877,29
"2602","RN","Carnaúba dos Dantas",8239,10191.51,24012,"Seridó Oriental",2,"Nordeste",0,"240240",3,8,4,4,3,5,0,0,0,0,0,8,4,4,3,5,4,9.22931029973314,9.01663425631559,0.324305782248462,31
"2603","RN","Carnaúba dos Dantas",8239,10191.51,24012,"Seridó Oriental",2,"Nordeste",0,"240240",4,10,0,10,1,9,0,0,0,0,0,10,0,10,1,9,4,9.22931029973314,9.01663425631559,0.35742499197224,30
"2604","RN","Carnaúba dos Dantas",8239,10191.51,24012,"Seridó Oriental",2,"Nordeste",0,"240240",5,10,1,9,1,9,0,0,0,0,0,10,1,9,1,9,7,9.22931029973314,9.01663425631559,0.355503619265041,31
"2605","RN","Carnaubais",10867,15370.65,24004,"Vale do Açu",2,"Nordeste",0,"240250",2,10,1,9,5,5,0,0,0,0,0,10,1,9,5,5,5,9.6402151258141,9.29348595306285,0.275607623419511,29
"2606","RN","Carnaubais",10867,15370.65,24004,"Vale do Açu",2,"Nordeste",0,"240250",3,6,1,5,1,5,0,0,0,0,0,6,1,5,1,5,6,9.6402151258141,9.29348595306285,0.384006422794654,31
"2607","RN","Carnaubais",10867,15370.65,24004,"Vale do Açu",2,"Nordeste",0,"240250",4,8,4,4,3,5,0,0,0,0,0,8,4,4,3,5,5,9.6402151258141,9.29348595306285,0.408427660756934,30
"2608","RN","Carnaubais",10867,15370.65,24004,"Vale do Açu",2,"Nordeste",0,"240250",5,15,7,8,10,5,0,0,0,0,0,15,7,8,10,5,6,9.6402151258141,9.29348595306285,0.396753945035435,31
"2609","RN","Ceará-Mirim",73886,11617.19,24017,"Macaíba",2,"Nordeste",1,"240260",2,83,31,52,37,46,2,0,2,1,1,85,31,54,38,47,44,9.36024117672104,11.2102786437931,0.276218072396437,29
"2610","RN","Ceará-Mirim",73886,11617.19,24017,"Macaíba",2,"Nordeste",1,"240260",3,89,40,49,32,57,1,1,0,0,1,90,41,49,32,58,39,9.36024117672104,11.2102786437931,0.365042764000513,31
"2611","RN","Ceará-Mirim",73886,11617.19,24017,"Macaíba",2,"Nordeste",1,"240260",4,76,41,35,28,48,1,1,0,1,0,77,42,35,29,48,48,9.36024117672104,11.2102786437931,0.408088182046825,30
"2612","RN","Ceará-Mirim",73886,11617.19,24017,"Macaíba",2,"Nordeste",1,"240260",5,89,33,56,33,56,0,0,0,0,0,89,33,56,33,56,58,9.36024117672104,11.2102786437931,0.396670129428631,31
"2613","RN","Cerro Corá",11181,13788.61,24010,"Serra de Santana",2,"Nordeste",0,"240270",2,6,1,5,3,3,0,0,0,0,0,6,1,5,3,3,2,9.53159816802744,9.32197118814737,0.303294394880509,29
"2614","RN","Cerro Corá",11181,13788.61,24010,"Serra de Santana",2,"Nordeste",0,"240270",3,9,3,6,3,6,0,0,0,0,0,9,3,6,3,6,3,9.53159816802744,9.32197118814737,0.389793153460562,31
"2615","RN","Cerro Corá",11181,13788.61,24010,"Serra de Santana",2,"Nordeste",0,"240270",4,9,5,4,3,6,0,0,0,0,0,9,5,4,3,6,5,9.53159816802744,9.32197118814737,0.395258570230301,30
"2616","RN","Cerro Corá",11181,13788.61,24010,"Serra de Santana",2,"Nordeste",0,"240270",5,16,6,10,6,10,1,1,0,1,0,17,7,10,7,10,5,9.53159816802744,9.32197118814737,0.392882327251397,31
"2617","RN","Cruzeta",7983,12123.7,24012,"Seridó Oriental",2,"Nordeste",0,"240300",2,10,3,7,4,6,0,0,0,0,0,10,3,7,4,6,2,9.40291749356274,8.9850695596458,0.272495257320262,29
"2618","RN","Cruzeta",7983,12123.7,24012,"Seridó Oriental",2,"Nordeste",0,"240300",3,5,0,5,3,2,0,0,0,0,0,5,0,5,3,2,6,9.40291749356274,8.9850695596458,0.342685715833033,31
"2619","RN","Cruzeta",7983,12123.7,24012,"Seridó Oriental",2,"Nordeste",0,"240300",4,9,3,6,5,4,0,0,0,0,0,9,3,6,5,4,8,9.40291749356274,8.9850695596458,0.353117768309256,30
"2620","RN","Cruzeta",7983,12123.7,24012,"Seridó Oriental",2,"Nordeste",0,"240300",5,9,1,8,2,7,0,0,0,0,0,9,1,8,2,7,3,9.40291749356274,8.9850695596458,0.36545031818248,31
"2621","RN","Currais Novos",44905,15575.8,24012,"Seridó Oriental",2,"Nordeste",1,"240310",2,37,6,31,14,23,0,0,0,0,0,37,6,31,14,23,29,9.65347370670252,10.712304426105,0.258340524076195,29
"2622","RN","Currais Novos",44905,15575.8,24012,"Seridó Oriental",2,"Nordeste",1,"240310",3,32,7,25,11,21,1,1,0,0,1,33,8,25,11,22,37,9.65347370670252,10.712304426105,0.346830277928785,31
"2623","RN","Currais Novos",44905,15575.8,24012,"Seridó Oriental",2,"Nordeste",1,"240310",4,36,6,30,12,24,0,0,0,0,0,36,6,30,12,24,30,9.65347370670252,10.712304426105,0.402575429239442,30
"2624","RN","Currais Novos",44905,15575.8,24012,"Seridó Oriental",2,"Nordeste",1,"240310",5,45,7,38,14,31,0,0,0,0,0,45,7,38,14,31,37,9.65347370670252,10.712304426105,0.383741888242708,31
"2625","RN","Doutor Severiano",7072,8089.54,24005,"Serra de São Miguel",2,"Nordeste",0,"240320",2,4,1,3,3,1,0,0,0,0,0,4,1,3,3,1,5,8.99832714811454,8.86389860431748,0.292392183015002,29
"2626","RN","Doutor Severiano",7072,8089.54,24005,"Serra de São Miguel",2,"Nordeste",0,"240320",3,12,4,8,5,7,0,0,0,0,0,12,4,8,5,7,1,8.99832714811454,8.86389860431748,0.358372557398948,31
"2627","RN","Doutor Severiano",7072,8089.54,24005,"Serra de São Miguel",2,"Nordeste",0,"240320",4,10,3,7,7,3,0,0,0,0,0,10,3,7,7,3,1,8.99832714811454,8.86389860431748,0.411053066751345,30
"2628","RN","Doutor Severiano",7072,8089.54,24005,"Serra de São Miguel",2,"Nordeste",0,"240320",5,7,0,7,3,4,0,0,0,0,0,7,0,7,3,4,2,8.99832714811454,8.86389860431748,0.431684468513857,31
"2629","RN","Parnamirim",267036,20317.98,24018,"Natal",2,"Nordeste",1,"240325",2,280,65,215,75,205,4,2,2,0,4,284,67,217,75,209,109,9.91926148730215,12.4951387597541,0.281257250751359,29
"2630","RN","Parnamirim",267036,20317.98,24018,"Natal",2,"Nordeste",1,"240325",3,231,61,170,60,171,0,0,0,0,0,231,61,170,60,171,99,9.91926148730215,12.4951387597541,0.387625868505534,31
"2631","RN","Parnamirim",267036,20317.98,24018,"Natal",2,"Nordeste",1,"240325",4,230,55,175,67,163,3,1,2,2,1,233,56,177,69,164,96,9.91926148730215,12.4951387597541,0.460102910277402,30
"2632","RN","Parnamirim",267036,20317.98,24018,"Natal",2,"Nordeste",1,"240325",5,246,45,201,75,171,2,1,1,0,2,248,46,202,75,173,105,9.91926148730215,12.4951387597541,0.435769052749882,31
"2633","RN","Encanto",5668,7779.9,24005,"Serra de São Miguel",2,"Nordeste",0,"240330",2,2,1,1,1,1,0,0,0,0,0,2,1,1,1,1,5,8.95929876361939,8.64259160081057,0.268725305312425,29
"2634","RN","Encanto",5668,7779.9,24005,"Serra de São Miguel",2,"Nordeste",0,"240330",3,9,3,6,3,6,0,0,0,0,0,9,3,6,3,6,5,8.95929876361939,8.64259160081057,0.36320327956439,31
"2635","RN","Encanto",5668,7779.9,24005,"Serra de São Miguel",2,"Nordeste",0,"240330",4,9,4,5,6,3,0,0,0,0,0,9,4,5,6,3,5,8.95929876361939,8.64259160081057,0.462286608963425,30
"2636","RN","Encanto",5668,7779.9,24005,"Serra de São Miguel",2,"Nordeste",0,"240330",5,7,5,2,5,2,0,0,0,0,0,7,5,2,5,2,8,8.95929876361939,8.64259160081057,0.464550169311695,31
"2637","RN","Equador",6054,10581.62,24012,"Seridó Oriental",2,"Nordeste",0,"240340",2,3,3,0,2,1,0,0,0,0,0,3,3,0,2,1,1,9.26687381278339,8.70847448958166,0.289227433925078,29
"2638","RN","Equador",6054,10581.62,24012,"Seridó Oriental",2,"Nordeste",0,"240340",3,3,1,2,0,3,1,1,0,0,1,4,2,2,0,4,2,9.26687381278339,8.70847448958166,0.375729056936212,31
"2639","RN","Equador",6054,10581.62,24012,"Seridó Oriental",2,"Nordeste",0,"240340",4,3,2,1,0,3,0,0,0,0,0,3,2,1,0,3,2,9.26687381278339,8.70847448958166,0.416346138376514,30
"2640","RN","Equador",6054,10581.62,24012,"Seridó Oriental",2,"Nordeste",0,"240340",5,8,1,7,3,5,0,0,0,0,0,8,1,7,3,5,1,9.26687381278339,8.70847448958166,0.383012483416979,31
"2641","RN","Espírito Santo",10484,7123.1,24019,"Litoral Sul",2,"Nordeste",0,"240350",2,4,2,2,1,3,1,1,0,0,1,5,3,2,1,4,3,8.87109830290831,9.2576055644433,0.291209629461519,29
"2642","RN","Espírito Santo",10484,7123.1,24019,"Litoral Sul",2,"Nordeste",0,"240350",3,9,5,4,4,5,0,0,0,0,0,9,5,4,4,5,6,8.87109830290831,9.2576055644433,0.396058983044017,31
"2643","RN","Espírito Santo",10484,7123.1,24019,"Litoral Sul",2,"Nordeste",0,"240350",4,4,3,1,2,2,0,0,0,0,0,4,3,1,2,2,2,8.87109830290831,9.2576055644433,0.421006198919518,30
"2644","RN","Espírito Santo",10484,7123.1,24019,"Litoral Sul",2,"Nordeste",0,"240350",5,8,7,1,5,3,0,0,0,0,0,8,7,1,5,3,4,8.87109830290831,9.2576055644433,0.423803511635421,31
"2645","RN","Extremoz",28936,14409.49,24018,"Natal",2,"Nordeste",1,"240360",2,38,17,21,14,24,2,1,1,0,2,40,18,22,14,26,28,9.57564229627843,10.2728417736319,0.278048137417203,29
"2646","RN","Extremoz",28936,14409.49,24018,"Natal",2,"Nordeste",1,"240360",3,42,8,34,13,29,1,0,1,0,1,43,8,35,13,30,10,9.57564229627843,10.2728417736319,0.378637490501846,31
"2647","RN","Extremoz",28936,14409.49,24018,"Natal",2,"Nordeste",1,"240360",4,34,10,24,14,20,0,0,0,0,0,34,10,24,14,20,28,9.57564229627843,10.2728417736319,0.442015173083617,30
"2648","RN","Extremoz",28936,14409.49,24018,"Natal",2,"Nordeste",1,"240360",5,44,10,34,16,28,0,0,0,0,0,44,10,34,16,28,20,9.57564229627843,10.2728417736319,0.42580323021587,31
"2649","RN","Felipe Guerra",5997,16532.41,24002,"Chapada do Apodi",2,"Nordeste",0,"240370",2,5,3,2,5,0,0,0,0,0,0,5,3,2,5,0,3,9.71307797571123,8.69901462316851,0.248701969872874,29
"2650","RN","Felipe Guerra",5997,16532.41,24002,"Chapada do Apodi",2,"Nordeste",0,"240370",3,6,2,4,1,5,0,0,0,0,0,6,2,4,1,5,3,9.71307797571123,8.69901462316851,0.363675834823218,31
"2651","RN","Felipe Guerra",5997,16532.41,24002,"Chapada do Apodi",2,"Nordeste",0,"240370",4,2,1,1,1,1,0,0,0,0,0,2,1,1,1,1,5,9.71307797571123,8.69901462316851,0.375478568814297,30
"2652","RN","Felipe Guerra",5997,16532.41,24002,"Chapada do Apodi",2,"Nordeste",0,"240370",5,6,1,5,3,3,0,0,0,0,0,6,1,5,3,3,5,9.71307797571123,8.69901462316851,0.406661475383216,31
"2653","RN","Florânia",9786,9653.16,24010,"Serra de Santana",2,"Nordeste",0,"240380",2,12,5,7,7,5,0,0,0,0,0,12,5,7,7,5,4,9.17504060186923,9.18870807184907,0.274328192358984,29
"2654","RN","Florânia",9786,9653.16,24010,"Serra de Santana",2,"Nordeste",0,"240380",3,10,1,9,4,6,0,0,0,0,0,10,1,9,4,6,4,9.17504060186923,9.18870807184907,0.341259666245433,31
"2655","RN","Florânia",9786,9653.16,24010,"Serra de Santana",2,"Nordeste",0,"240380",4,10,1,9,3,7,0,0,0,0,0,10,1,9,3,7,9,9.17504060186923,9.18870807184907,0.366508010913636,30
"2656","RN","Florânia",9786,9653.16,24010,"Serra de Santana",2,"Nordeste",0,"240380",5,7,0,7,3,4,0,0,0,0,0,7,0,7,3,4,9,9.17504060186923,9.18870807184907,0.378950913343258,31
"2657","RN","Frutuoso Gomes",4041,8890.17,24007,"Umarizal",2,"Nordeste",0,"240400",2,7,4,3,2,5,0,0,0,0,0,7,4,3,2,5,1,9.09270145093479,8.30424746507847,0.280002005900162,29
"2658","RN","Frutuoso Gomes",4041,8890.17,24007,"Umarizal",2,"Nordeste",0,"240400",3,5,1,4,1,4,0,0,0,0,0,5,1,4,1,4,3,9.09270145093479,8.30424746507847,0.374126441693105,31
"2659","RN","Frutuoso Gomes",4041,8890.17,24007,"Umarizal",2,"Nordeste",0,"240400",4,0,0,0,0,0,0,0,0,0,0,0,0,0,0,0,3,9.09270145093479,8.30424746507847,0.415483123690752,30
"2660","RN","Frutuoso Gomes",4041,8890.17,24007,"Umarizal",2,"Nordeste",0,"240400",5,5,5,0,3,2,0,0,0,0,0,5,5,0,3,2,7,9.09270145093479,8.30424746507847,0.422752998252568,31
"2661","RN","Goianinha",26669,14575.26,24019,"Litoral Sul",2,"Nordeste",1,"240420",2,37,17,20,19,18,1,1,0,1,0,38,18,20,20,18,13,9.58708084982459,10.19125712116,0.289037286828166,29
"2662","RN","Goianinha",26669,14575.26,24019,"Litoral Sul",2,"Nordeste",1,"240420",3,40,15,25,21,19,1,0,1,0,1,41,15,26,21,20,13,9.58708084982459,10.19125712116,0.385544440113306,31
"2663","RN","Goianinha",26669,14575.26,24019,"Litoral Sul",2,"Nordeste",1,"240420",4,40,19,21,17,23,0,0,0,0,0,40,19,21,17,23,16,9.58708084982459,10.19125712116,0.408140818552616,30
"2664","RN","Goianinha",26669,14575.26,24019,"Litoral Sul",2,"Nordeste",1,"240420",5,31,13,18,18,13,1,0,1,0,1,32,13,19,18,14,16,9.58708084982459,10.19125712116,0.405028242840326,31
"2665","RN","Governador Dix-Sept Rosado",13076,20229.67,24002,"Chapada do Apodi",2,"Nordeste",0,"240430",2,4,3,1,2,2,0,0,0,0,0,4,3,1,2,2,11,9.91490561762143,9.4785337678441,0.290765477888632,29
"2666","RN","Governador Dix-Sept Rosado",13076,20229.67,24002,"Chapada do Apodi",2,"Nordeste",0,"240430",3,10,6,4,6,4,0,0,0,0,0,10,6,4,6,4,7,9.91490561762143,9.4785337678441,0.384854360964319,31
"2667","RN","Governador Dix-Sept Rosado",13076,20229.67,24002,"Chapada do Apodi",2,"Nordeste",0,"240430",4,12,3,9,7,5,0,0,0,0,0,12,3,9,7,5,10,9.91490561762143,9.4785337678441,0.418783330348352,30
"2668","RN","Governador Dix-Sept Rosado",13076,20229.67,24002,"Chapada do Apodi",2,"Nordeste",0,"240430",5,17,8,9,9,8,0,0,0,0,0,17,8,9,9,8,11,9.91490561762143,9.4785337678441,0.418446278843927,31
"2669","RN","Grossos",10463,14933.57,24001,"Mossoró",2,"Nordeste",0,"240440",2,5,2,3,1,4,0,0,0,0,0,5,2,3,1,4,10,9.61136697782367,9.25560050338105,0.270352804868754,29
"2670","RN","Grossos",10463,14933.57,24001,"Mossoró",2,"Nordeste",0,"240440",3,4,1,3,1,3,0,0,0,0,0,4,1,3,1,3,5,9.61136697782367,9.25560050338105,0.370372211175632,31
"2671","RN","Grossos",10463,14933.57,24001,"Mossoró",2,"Nordeste",0,"240440",4,3,1,2,1,2,0,0,0,0,0,3,1,2,1,2,5,9.61136697782367,9.25560050338105,0.418026575702398,30
"2672","RN","Grossos",10463,14933.57,24001,"Mossoró",2,"Nordeste",0,"240440",5,13,4,9,6,7,0,0,0,0,0,13,4,9,6,7,13,9.61136697782367,9.25560050338105,0.423392212938436,31
"2673","RN","Guamaré",15963,90678.84,24008,"Macau",2,"Nordeste",0,"240450",2,23,9,14,12,11,0,0,0,0,0,23,9,14,12,11,7,11.4150793123032,9.67802882326448,0.272510508724637,29
"2674","RN","Guamaré",15963,90678.84,24008,"Macau",2,"Nordeste",0,"240450",3,18,9,9,9,9,0,0,0,0,0,18,9,9,9,9,9,11.4150793123032,9.67802882326448,0.348350842676974,31
"2675","RN","Guamaré",15963,90678.84,24008,"Macau",2,"Nordeste",0,"240450",4,15,7,8,4,11,1,0,1,0,1,16,7,9,4,12,8,11.4150793123032,9.67802882326448,0.400081549992754,30
"2676","RN","Guamaré",15963,90678.84,24008,"Macau",2,"Nordeste",0,"240450",5,25,11,14,9,16,0,0,0,0,0,25,11,14,9,16,8,11.4150793123032,9.67802882326448,0.412604629916141,31
"2677","RN","Ielmo Marinho",13901,7740.82,24015,"Agreste Potiguar",2,"Nordeste",0,"240460",2,8,5,3,4,4,0,0,0,0,0,8,5,3,4,4,4,8.95426290412465,9.53971605897709,0.341757508767343,29
"2678","RN","Ielmo Marinho",13901,7740.82,24015,"Agreste Potiguar",2,"Nordeste",0,"240460",3,10,7,3,6,4,0,0,0,0,0,10,7,3,6,4,7,8.95426290412465,9.53971605897709,0.438119412117092,31
"2679","RN","Ielmo Marinho",13901,7740.82,24015,"Agreste Potiguar",2,"Nordeste",0,"240460",4,10,3,7,6,4,0,0,0,0,0,10,3,7,6,4,3,8.95426290412465,9.53971605897709,0.442693166441792,30
"2680","RN","Ielmo Marinho",13901,7740.82,24015,"Agreste Potiguar",2,"Nordeste",0,"240460",5,12,6,6,5,7,1,0,1,0,1,13,6,7,5,8,6,8.95426290412465,9.53971605897709,0.445066606445512,31
"2681","RN","Ipanguaçu",15626,8819.39,24004,"Vale do Açu",2,"Nordeste",0,"240470",2,25,6,19,14,11,0,0,0,0,0,25,6,19,14,11,11,9.08470798561137,9.65669147255669,0.280647022664486,29
"2682","RN","Ipanguaçu",15626,8819.39,24004,"Vale do Açu",2,"Nordeste",0,"240470",3,13,6,7,5,8,0,0,0,0,0,13,6,7,5,8,6,9.08470798561137,9.65669147255669,0.381025891500087,31
"2683","RN","Ipanguaçu",15626,8819.39,24004,"Vale do Açu",2,"Nordeste",0,"240470",4,6,2,4,3,3,0,0,0,0,0,6,2,4,3,3,13,9.08470798561137,9.65669147255669,0.400326895215067,30
"2684","RN","Ipanguaçu",15626,8819.39,24004,"Vale do Açu",2,"Nordeste",0,"240470",5,13,6,7,5,8,0,0,0,0,0,13,6,7,5,8,9,9.08470798561137,9.65669147255669,0.37950806726152,31
"2685","RN","Itajá",7595,10937.11,24004,"Vale do Açu",2,"Nordeste",0,"240485",2,6,0,6,3,3,0,0,0,0,0,6,0,6,3,3,4,9.29991687288728,8.93524541502987,0.226925360318461,29
"2686","RN","Itajá",7595,10937.11,24004,"Vale do Açu",2,"Nordeste",0,"240485",3,4,0,4,1,3,0,0,0,0,0,4,0,4,1,3,3,9.29991687288728,8.93524541502987,0.295313007889171,31
"2687","RN","Itajá",7595,10937.11,24004,"Vale do Açu",2,"Nordeste",0,"240485",4,7,3,4,2,5,0,0,0,0,0,7,3,4,2,5,3,9.29991687288728,8.93524541502987,0.327226673213451,30
"2688","RN","Itajá",7595,10937.11,24004,"Vale do Açu",2,"Nordeste",0,"240485",5,10,4,6,6,4,0,0,0,0,0,10,4,6,6,4,5,9.29991687288728,8.93524541502987,0.305489519603991,31
"2689","RN","Itaú",5897,9197.21,24006,"Pau dos Ferros",2,"Nordeste",0,"240490",2,6,1,5,3,3,0,0,0,0,0,6,1,5,3,3,2,9.12665545617469,8.6821990260005,0.232351537631284,29
"2690","RN","Itaú",5897,9197.21,24006,"Pau dos Ferros",2,"Nordeste",0,"240490",3,7,5,2,3,4,1,0,1,0,1,8,5,3,3,5,5,9.12665545617469,8.6821990260005,0.335232444014393,31
"2691","RN","Itaú",5897,9197.21,24006,"Pau dos Ferros",2,"Nordeste",0,"240490",4,2,2,0,1,1,0,0,0,0,0,2,2,0,1,1,1,9.12665545617469,8.6821990260005,0.354160142806433,30
"2692","RN","Itaú",5897,9197.21,24006,"Pau dos Ferros",2,"Nordeste",0,"240490",5,7,3,4,5,2,0,0,0,0,0,7,3,4,5,2,5,9.12665545617469,8.6821990260005,0.37331337726022,31
"2693","RN","Jaçanã",9238,6873.49,24014,"Borborema Potiguar",2,"Nordeste",0,"240500",2,8,3,5,5,3,0,0,0,0,0,8,3,5,5,3,6,8.83542726204754,9.13108069099055,0.295081944395561,29
"2694","RN","Jaçanã",9238,6873.49,24014,"Borborema Potiguar",2,"Nordeste",0,"240500",3,10,4,6,5,5,1,0,1,0,1,11,4,7,5,6,4,8.83542726204754,9.13108069099055,0.397772102886673,31
"2695","RN","Jaçanã",9238,6873.49,24014,"Borborema Potiguar",2,"Nordeste",0,"240500",4,7,2,5,4,3,0,0,0,0,0,7,2,5,4,3,3,8.83542726204754,9.13108069099055,0.41812334941026,30
"2696","RN","Jaçanã",9238,6873.49,24014,"Borborema Potiguar",2,"Nordeste",0,"240500",5,10,3,7,2,8,0,0,0,0,0,10,3,7,2,8,6,8.83542726204754,9.13108069099055,0.415167016895296,31
"2697","RN","Jandaíra",6893,10084.08,24013,"Baixa Verde",2,"Nordeste",0,"240510",2,8,3,5,5,3,0,0,0,0,0,8,3,5,5,3,2,9.21871322163612,8.83826168288565,0.321794491246319,29
"2698","RN","Jandaíra",6893,10084.08,24013,"Baixa Verde",2,"Nordeste",0,"240510",3,9,4,5,2,7,0,0,0,0,0,9,4,5,2,7,5,9.21871322163612,8.83826168288565,0.403887157480272,31
"2699","RN","Jandaíra",6893,10084.08,24013,"Baixa Verde",2,"Nordeste",0,"240510",4,5,3,2,4,1,0,0,0,0,0,5,3,2,4,1,2,9.21871322163612,8.83826168288565,0.391620879744654,30
"2700","RN","Jandaíra",6893,10084.08,24013,"Baixa Verde",2,"Nordeste",0,"240510",5,4,2,2,0,4,0,0,0,0,0,4,2,2,0,4,0,9.21871322163612,8.83826168288565,0.372449638381844,31
"2701","RN","Janduís",5248,12455.4,24003,"Médio Oeste",2,"Nordeste",0,"240520",2,3,0,3,0,3,0,0,0,0,0,3,0,3,0,3,4,9.4299095427968,8.56560233062392,0.248480780924171,29
"2702","RN","Janduís",5248,12455.4,24003,"Médio Oeste",2,"Nordeste",0,"240520",3,4,2,2,2,2,0,0,0,0,0,4,2,2,2,2,2,9.4299095427968,8.56560233062392,0.33432502441428,31
"2703","RN","Janduís",5248,12455.4,24003,"Médio Oeste",2,"Nordeste",0,"240520",4,7,2,5,0,7,0,0,0,0,0,7,2,5,0,7,4,9.4299095427968,8.56560233062392,0.354697817979441,30
"2704","RN","Janduís",5248,12455.4,24003,"Médio Oeste",2,"Nordeste",0,"240520",5,2,0,2,0,2,0,0,0,0,0,2,0,2,0,2,4,9.4299095427968,8.56560233062392,0.374749103339468,31
"2705","RN","Januário Cicco",10275,6660.62,24015,"Agreste Potiguar",2,"Nordeste",0,"240530",2,9,6,3,8,1,0,0,0,0,0,9,6,3,8,1,8,8.80396785229463,9.23746903936444,0.296018557541514,29
"2706","RN","Januário Cicco",10275,6660.62,24015,"Agreste Potiguar",2,"Nordeste",0,"240530",3,13,5,8,4,9,0,0,0,0,0,13,5,8,4,9,8,8.80396785229463,9.23746903936444,0.367130304828595,31
"2707","RN","Januário Cicco",10275,6660.62,24015,"Agreste Potiguar",2,"Nordeste",0,"240530",4,7,4,3,1,6,0,0,0,0,0,7,4,3,1,6,3,8.80396785229463,9.23746903936444,0.401783436534112,30
"2708","RN","Januário Cicco",10275,6660.62,24015,"Agreste Potiguar",2,"Nordeste",0,"240530",5,10,5,5,6,4,0,0,0,0,0,10,5,5,6,4,4,8.80396785229463,9.23746903936444,0.420463907868194,31
"2709","RN","Japi",4995,7581.1,24014,"Borborema Potiguar",2,"Nordeste",0,"240540",2,5,3,2,3,2,0,0,0,0,0,5,3,2,3,2,4,8.93341358684122,8.51619269108265,0.284524518827965,29
"2710","RN","Japi",4995,7581.1,24014,"Borborema Potiguar",2,"Nordeste",0,"240540",3,2,1,1,1,1,0,0,0,0,0,2,1,1,1,1,2,8.93341358684122,8.51619269108265,0.337132570534993,31
"2711","RN","Japi",4995,7581.1,24014,"Borborema Potiguar",2,"Nordeste",0,"240540",4,6,1,5,2,4,1,0,1,1,0,7,1,6,3,4,5,8.93341358684122,8.51619269108265,0.410240918889856,30
"2712","RN","Japi",4995,7581.1,24014,"Borborema Potiguar",2,"Nordeste",0,"240540",5,5,1,4,3,2,0,0,0,0,0,5,1,4,3,2,4,8.93341358684122,8.51619269108265,0.399051694323068,31
"2713","RN","Jardim de Piranhas",14942,9106.49,24011,"Seridó Ocidental",2,"Nordeste",1,"240560",2,12,6,6,7,5,0,0,0,0,0,12,6,6,7,5,7,9.11674262512127,9.61193131853575,0.234224596774722,29
"2714","RN","Jardim de Piranhas",14942,9106.49,24011,"Seridó Ocidental",2,"Nordeste",1,"240560",3,17,9,8,2,15,0,0,0,0,0,17,9,8,2,15,11,9.11674262512127,9.61193131853575,0.318153885909477,31
"2715","RN","Jardim de Piranhas",14942,9106.49,24011,"Seridó Ocidental",2,"Nordeste",1,"240560",4,13,8,5,6,7,0,0,0,0,0,13,8,5,6,7,10,9.11674262512127,9.61193131853575,0.34248111353037,30
"2716","RN","Jardim de Piranhas",14942,9106.49,24011,"Seridó Ocidental",2,"Nordeste",1,"240560",5,7,3,4,3,4,0,0,0,0,0,7,3,4,3,4,10,9.11674262512127,9.61193131853575,0.355832451789125,31
"2717","RN","Jardim do Seridó",12396,12874.17,24012,"Seridó Oriental",2,"Nordeste",0,"240570",2,5,2,3,2,3,0,0,0,0,0,5,2,3,2,3,7,9.4629782574345,9.42512911890764,0.253511322594952,29
"2718","RN","Jardim do Seridó",12396,12874.17,24012,"Seridó Oriental",2,"Nordeste",0,"240570",3,8,2,6,2,6,0,0,0,0,0,8,2,6,2,6,6,9.4629782574345,9.42512911890764,0.323909287672682,31
"2719","RN","Jardim do Seridó",12396,12874.17,24012,"Seridó Oriental",2,"Nordeste",0,"240570",4,6,2,4,1,5,0,0,0,0,0,6,2,4,1,5,8,9.4629782574345,9.42512911890764,0.339094027143622,30
"2720","RN","Jardim do Seridó",12396,12874.17,24012,"Seridó Oriental",2,"Nordeste",0,"240570",5,12,3,9,1,11,0,0,0,0,0,12,3,9,1,11,9,9.4629782574345,9.42512911890764,0.356175885059584,31
"2721","RN","João Câmara",35160,29528.28,24013,"Baixa Verde",2,"Nordeste",0,"240580",2,34,20,14,18,16,0,0,0,0,0,34,20,14,18,16,20,10.2931037271899,10.4676643517991,0.272072031071622,29
"2722","RN","João Câmara",35160,29528.28,24013,"Baixa Verde",2,"Nordeste",0,"240580",3,28,13,15,15,13,0,0,0,0,0,28,13,15,15,13,18,10.2931037271899,10.4676643517991,0.356624815264837,31
"2723","RN","João Câmara",35160,29528.28,24013,"Baixa Verde",2,"Nordeste",0,"240580",4,34,19,15,14,20,0,0,0,0,0,34,19,15,14,20,17,10.2931037271899,10.4676643517991,0.385802820054812,30
"2724","RN","João Câmara",35160,29528.28,24013,"Baixa Verde",2,"Nordeste",0,"240580",5,33,14,19,19,14,2,1,1,1,1,35,15,20,20,15,20,10.2931037271899,10.4676643517991,0.381539903150018,31
"2725","RN","José da Penha",5946,8763.65,24006,"Pau dos Ferros",2,"Nordeste",0,"240600",2,5,0,5,4,1,0,0,0,0,0,5,0,5,4,1,7,9.07836776381565,8.69047400355804,0.308987566272364,29
"2726","RN","José da Penha",5946,8763.65,24006,"Pau dos Ferros",2,"Nordeste",0,"240600",3,1,0,1,1,0,0,0,0,0,0,1,0,1,1,0,10,9.07836776381565,8.69047400355804,0.423865237439829,31
"2727","RN","José da Penha",5946,8763.65,24006,"Pau dos Ferros",2,"Nordeste",0,"240600",4,3,0,3,2,1,0,0,0,0,0,3,0,3,2,1,6,9.07836776381565,8.69047400355804,0.463302556327089,30
"2728","RN","José da Penha",5946,8763.65,24006,"Pau dos Ferros",2,"Nordeste",0,"240600",5,10,4,6,5,5,0,0,0,0,0,10,4,6,5,5,3,9.07836776381565,8.69047400355804,0.424084217578525,31
"2729","RN","Jucurutu",18315,12240.79,24004,"Vale do Açu",2,"Nordeste",0,"240610",2,10,7,3,3,7,0,0,0,0,0,10,7,3,3,7,9,9.4125290964672,9.81547567521291,0.26605574690812,29
"2730","RN","Jucurutu",18315,12240.79,24004,"Vale do Açu",2,"Nordeste",0,"240610",3,14,5,9,7,7,0,0,0,0,0,14,5,9,7,7,15,9.4125290964672,9.81547567521291,0.35339314615786,31
"2731","RN","Jucurutu",18315,12240.79,24004,"Vale do Açu",2,"Nordeste",0,"240610",4,13,5,8,6,7,0,0,0,0,0,13,5,8,6,7,9,9.4125290964672,9.81547567521291,0.380556429106825,30
"2732","RN","Jucurutu",18315,12240.79,24004,"Vale do Açu",2,"Nordeste",0,"240610",5,17,7,10,10,7,0,0,0,0,0,17,7,10,10,7,10,9.4125290964672,9.81547567521291,0.399457295703732,31
"2733","RN","Jundiá",3922,8611.06,24015,"Agreste Potiguar",2,"Nordeste",0,"240615",2,2,1,1,1,1,0,0,0,0,0,2,1,1,1,1,0,9.06080270250373,8.27435700675629,0.295354703889929,29
"2734","RN","Jundiá",3922,8611.06,24015,"Agreste Potiguar",2,"Nordeste",0,"240615",3,3,2,1,0,3,0,0,0,0,0,3,2,1,0,3,2,9.06080270250373,8.27435700675629,0.413306734534568,31
"2735","RN","Jundiá",3922,8611.06,24015,"Agreste Potiguar",2,"Nordeste",0,"240615",4,1,0,1,0,1,0,0,0,0,0,1,0,1,0,1,3,9.06080270250373,8.27435700675629,0.459499383732386,30
"2736","RN","Jundiá",3922,8611.06,24015,"Agreste Potiguar",2,"Nordeste",0,"240615",5,1,1,0,0,1,0,0,0,0,0,1,1,0,0,1,0,9.06080270250373,8.27435700675629,0.448381726929274,31
"2737","RN","Lagoa d'Anta",6811,8178.86,24015,"Agreste Potiguar",2,"Nordeste",0,"240620",2,5,3,2,1,4,0,0,0,0,0,5,3,2,1,4,3,9.00930805558151,8.82629423124132,0.279905620178456,29
"2738","RN","Lagoa d'Anta",6811,8178.86,24015,"Agreste Potiguar",2,"Nordeste",0,"240620",3,8,4,4,1,7,0,0,0,0,0,8,4,4,1,7,2,9.00930805558151,8.82629423124132,0.334315113675505,31
"2739","RN","Lagoa d'Anta",6811,8178.86,24015,"Agreste Potiguar",2,"Nordeste",0,"240620",4,2,1,1,1,1,0,0,0,0,0,2,1,1,1,1,5,9.00930805558151,8.82629423124132,0.327417518238521,30
"2740","RN","Lagoa d'Anta",6811,8178.86,24015,"Agreste Potiguar",2,"Nordeste",0,"240620",5,8,5,3,5,3,0,0,0,0,0,8,5,3,5,3,2,9.00930805558151,8.82629423124132,0.351111633373602,31
"2741","RN","Lagoa de Pedras",7584,8082.07,24015,"Agreste Potiguar",2,"Nordeste",0,"240630",2,7,4,3,1,6,0,0,0,0,0,7,4,3,1,6,3,8.99740330682338,8.93379604393486,0.325249771753939,29
"2742","RN","Lagoa de Pedras",7584,8082.07,24015,"Agreste Potiguar",2,"Nordeste",0,"240630",3,3,2,1,2,1,0,0,0,0,0,3,2,1,2,1,8,8.99740330682338,8.93379604393486,0.406786512937623,31
"2743","RN","Lagoa de Pedras",7584,8082.07,24015,"Agreste Potiguar",2,"Nordeste",0,"240630",4,7,3,4,2,5,1,1,0,1,0,8,4,4,3,5,4,8.99740330682338,8.93379604393486,0.451921236964522,30
"2744","RN","Lagoa de Pedras",7584,8082.07,24015,"Agreste Potiguar",2,"Nordeste",0,"240630",5,7,3,4,1,6,1,0,1,1,0,8,3,5,2,6,2,8.99740330682338,8.93379604393486,0.428600140242672,31
"2745","RN","Lagoa de Velhos",2732,11774.9,24014,"Borborema Potiguar",2,"Nordeste",0,"240640",2,3,1,2,2,1,0,0,0,0,0,3,1,2,2,1,2,9.37372542627955,7.91278922069068,0.29829639705873,29
"2746","RN","Lagoa de Velhos",2732,11774.9,24014,"Borborema Potiguar",2,"Nordeste",0,"240640",3,6,5,1,4,2,0,0,0,0,0,6,5,1,4,2,0,9.37372542627955,7.91278922069068,0.40698071680865,31
"2747","RN","Lagoa de Velhos",2732,11774.9,24014,"Borborema Potiguar",2,"Nordeste",0,"240640",4,6,4,2,3,3,0,0,0,0,0,6,4,2,3,3,1,9.37372542627955,7.91278922069068,0.434546840023964,30
"2748","RN","Lagoa de Velhos",2732,11774.9,24014,"Borborema Potiguar",2,"Nordeste",0,"240640",5,2,1,1,1,1,0,0,0,0,0,2,1,1,1,1,2,9.37372542627955,7.91278922069068,0.394906000714023,31
"2749","RN","Lagoa Nova",15749,19902.35,24010,"Serra de Santana",2,"Nordeste",0,"240650",2,23,8,15,6,17,0,0,0,0,0,23,8,15,6,17,11,9.89859309419272,9.66453215017458,0.294453079485532,29
"2750","RN","Lagoa Nova",15749,19902.35,24010,"Serra de Santana",2,"Nordeste",0,"240650",3,15,7,8,8,7,0,0,0,0,0,15,7,8,8,7,6,9.89859309419272,9.66453215017458,0.376803694240631,31
"2751","RN","Lagoa Nova",15749,19902.35,24010,"Serra de Santana",2,"Nordeste",0,"240650",4,13,3,10,7,6,0,0,0,0,0,13,3,10,7,6,9,9.89859309419272,9.66453215017458,0.388803132415258,30
"2752","RN","Lagoa Nova",15749,19902.35,24010,"Serra de Santana",2,"Nordeste",0,"240650",5,18,8,10,9,9,1,1,0,1,0,19,9,10,10,9,11,9.89859309419272,9.66453215017458,0.390516542592538,31
"2753","RN","Lagoa Salgada",8297,8601.65,24015,"Agreste Potiguar",2,"Nordeste",0,"240660",2,7,6,1,3,4,0,0,0,0,0,7,6,1,3,4,3,9.05970932430385,9.02364928266429,0.271324913268686,29
"2754","RN","Lagoa Salgada",8297,8601.65,24015,"Agreste Potiguar",2,"Nordeste",0,"240660",3,11,5,6,5,6,0,0,0,0,0,11,5,6,5,6,6,9.05970932430385,9.02364928266429,0.355054423336152,31
"2755","RN","Lagoa Salgada",8297,8601.65,24015,"Agreste Potiguar",2,"Nordeste",0,"240660",4,14,10,4,8,6,0,0,0,0,0,14,10,4,8,6,5,9.05970932430385,9.02364928266429,0.371807190596345,30
"2756","RN","Lagoa Salgada",8297,8601.65,24015,"Agreste Potiguar",2,"Nordeste",0,"240660",5,11,6,5,3,8,1,1,0,0,1,12,7,5,3,9,4,9.05970932430385,9.02364928266429,0.364247247743333,31
"2757","RN","Lajes",11344,10716.94,24009,"Angicos",2,"Nordeste",0,"240670",2,11,3,8,2,9,0,0,0,0,0,11,3,8,2,9,8,9.27958094611563,9.33644424877191,0.255667852736705,29
"2758","RN","Lajes",11344,10716.94,24009,"Angicos",2,"Nordeste",0,"240670",3,6,2,4,2,4,0,0,0,0,0,6,2,4,2,4,11,9.27958094611563,9.33644424877191,0.356239498623747,31
"2759","RN","Lajes",11344,10716.94,24009,"Angicos",2,"Nordeste",0,"240670",4,13,6,7,9,4,0,0,0,0,0,13,6,7,9,4,4,9.27958094611563,9.33644424877191,0.366037427172241,30
"2760","RN","Lajes",11344,10716.94,24009,"Angicos",2,"Nordeste",0,"240670",5,9,6,3,3,6,0,0,0,0,0,9,6,3,3,6,4,9.27958094611563,9.33644424877191,0.358733560848714,31
"2761","RN","Lajes Pintadas",4763,8830.48,24014,"Borborema Potiguar",2,"Nordeste",0,"240680",2,5,1,4,2,3,0,0,0,0,0,5,1,4,2,3,4,9.08596465225645,8.46863300080086,0.262399927867513,29
"2762","RN","Lajes Pintadas",4763,8830.48,24014,"Borborema Potiguar",2,"Nordeste",0,"240680",3,6,1,5,2,4,0,0,0,0,0,6,1,5,2,4,3,9.08596465225645,8.46863300080086,0.363110260565956,31
"2763","RN","Lajes Pintadas",4763,8830.48,24014,"Borborema Potiguar",2,"Nordeste",0,"240680",4,3,1,2,3,0,0,0,0,0,0,3,1,2,3,0,6,9.08596465225645,8.46863300080086,0.407680909715073,30
"2764","RN","Lajes Pintadas",4763,8830.48,24014,"Borborema Potiguar",2,"Nordeste",0,"240680",5,5,3,2,2,3,0,0,0,0,0,5,3,2,2,3,3,9.08596465225645,8.46863300080086,0.39847181155904,31
"2765","RN","Luís Gomes",10146,7090.04,24005,"Serra de São Miguel",2,"Nordeste",0,"240700",2,10,4,6,6,4,0,0,0,0,0,10,4,6,6,4,9,8.8664462612592,9.22483481812663,0.271902470601521,29
"2766","RN","Luís Gomes",10146,7090.04,24005,"Serra de São Miguel",2,"Nordeste",0,"240700",3,10,5,5,6,4,0,0,0,0,0,10,5,5,6,4,6,8.8664462612592,9.22483481812663,0.381688487214953,31
"2767","RN","Luís Gomes",10146,7090.04,24005,"Serra de São Miguel",2,"Nordeste",0,"240700",4,8,4,4,7,1,0,0,0,0,0,8,4,4,7,1,5,8.8664462612592,9.22483481812663,0.425820751643523,30
"2768","RN","Luís Gomes",10146,7090.04,24005,"Serra de São Miguel",2,"Nordeste",0,"240700",5,8,4,4,6,2,0,0,0,0,0,8,4,4,6,2,4,8.8664462612592,9.22483481812663,0.377351717045447,31
"2769","RN","Macaíba",81821,19021.36,24017,"Macaíba",2,"Nordeste",1,"240710",2,73,23,50,28,45,1,0,1,1,0,74,23,51,29,45,48,9.85331783722345,11.3122892133593,0.272587197099183,29
"2770","RN","Macaíba",81821,19021.36,24017,"Macaíba",2,"Nordeste",1,"240710",3,59,19,40,27,32,0,0,0,0,0,59,19,40,27,32,46,9.85331783722345,11.3122892133593,0.363383041841888,31
"2771","RN","Macaíba",81821,19021.36,24017,"Macaíba",2,"Nordeste",1,"240710",4,69,28,41,33,36,2,1,1,1,1,71,29,42,34,37,44,9.85331783722345,11.3122892133593,0.414089779782821,30
"2772","RN","Macaíba",81821,19021.36,24017,"Macaíba",2,"Nordeste",1,"240710",5,87,23,64,33,54,0,0,0,0,0,87,23,64,33,54,61,9.85331783722345,11.3122892133593,0.397947414881869,31
"2773","RN","Macau",32039,24034.97,24008,"Macau",2,"Nordeste",0,"240720",2,20,6,14,8,12,2,1,1,0,2,22,7,15,8,14,11,10.0872651321475,10.374709189709,0.316891614790154,29
"2774","RN","Macau",32039,24034.97,24008,"Macau",2,"Nordeste",0,"240720",3,23,7,16,11,12,0,0,0,0,0,23,7,16,11,12,24,10.0872651321475,10.374709189709,0.401037642413914,31
"2775","RN","Macau",32039,24034.97,24008,"Macau",2,"Nordeste",0,"240720",4,17,8,9,9,8,0,0,0,0,0,17,8,9,9,8,16,10.0872651321475,10.374709189709,0.434419068996652,30
"2776","RN","Macau",32039,24034.97,24008,"Macau",2,"Nordeste",0,"240720",5,13,6,7,8,5,0,0,0,0,0,13,6,7,8,5,10,10.0872651321475,10.374709189709,0.44400031478404,31
"2777","RN","Marcelino Vieira",8336,7757.89,24006,"Pau dos Ferros",2,"Nordeste",0,"240730",2,5,2,3,3,2,0,0,0,0,0,5,2,3,3,2,6,8.9564656689873,9.02833876399315,0.283790597395562,29
"2778","RN","Marcelino Vieira",8336,7757.89,24006,"Pau dos Ferros",2,"Nordeste",0,"240730",3,10,6,4,5,5,0,0,0,0,0,10,6,4,5,5,2,8.9564656689873,9.02833876399315,0.360285007184248,31
"2779","RN","Marcelino Vieira",8336,7757.89,24006,"Pau dos Ferros",2,"Nordeste",0,"240730",4,9,6,3,6,3,0,0,0,0,0,9,6,3,6,3,7,8.9564656689873,9.02833876399315,0.379030358220912,30
"2780","RN","Marcelino Vieira",8336,7757.89,24006,"Pau dos Ferros",2,"Nordeste",0,"240730",5,9,3,6,4,5,0,0,0,0,0,9,3,6,4,5,1,8.9564656689873,9.02833876399315,0.371649084916038,31
"2781","RN","Martins",8758,9018.77,24007,"Umarizal",2,"Nordeste",0,"240740",2,12,1,11,6,6,0,0,0,0,0,12,1,11,6,6,2,9.10706324012194,9.07772284736134,0.274176231476366,29
"2782","RN","Martins",8758,9018.77,24007,"Umarizal",2,"Nordeste",0,"240740",3,9,4,5,2,7,0,0,0,0,0,9,4,5,2,7,9,9.10706324012194,9.07772284736134,0.358700217487982,31
"2783","RN","Martins",8758,9018.77,24007,"Umarizal",2,"Nordeste",0,"240740",4,9,1,8,3,6,1,0,1,0,1,10,1,9,3,7,8,9.10706324012194,9.07772284736134,0.370003918654108,30
"2784","RN","Martins",8758,9018.77,24007,"Umarizal",2,"Nordeste",0,"240740",5,10,4,6,5,5,0,0,0,0,0,10,4,6,5,5,4,9.10706324012194,9.07772284736134,0.368515349799655,31
"2785","RN","Maxaranguape",12544,9767.33,24016,"Litoral Nordeste",2,"Nordeste",0,"240750",2,8,4,4,2,6,0,0,0,0,0,8,4,4,2,6,7,9.18679842211946,9.43699774259019,0.329224775265273,29
"2786","RN","Maxaranguape",12544,9767.33,24016,"Litoral Nordeste",2,"Nordeste",0,"240750",3,12,5,7,5,7,0,0,0,0,0,12,5,7,5,7,6,9.18679842211946,9.43699774259019,0.426999560118179,31
"2787","RN","Maxaranguape",12544,9767.33,24016,"Litoral Nordeste",2,"Nordeste",0,"240750",4,10,3,7,4,6,0,0,0,0,0,10,3,7,4,6,5,9.18679842211946,9.43699774259019,0.46890840966615,30
"2788","RN","Maxaranguape",12544,9767.33,24016,"Litoral Nordeste",2,"Nordeste",0,"240750",5,8,4,4,4,4,1,0,1,0,1,9,4,5,4,5,6,9.18679842211946,9.43699774259019,0.475359893050274,31
"2789","RN","Messias Targino",4634,17547.52,24003,"Médio Oeste",2,"Nordeste",0,"240760",2,4,2,2,2,2,0,0,0,0,0,4,2,2,2,2,3,9.77266790836743,8.44117570499232,0.236621789834109,29
"2790","RN","Messias Targino",4634,17547.52,24003,"Médio Oeste",2,"Nordeste",0,"240760",3,3,2,1,0,3,0,0,0,0,0,3,2,1,0,3,1,9.77266790836743,8.44117570499232,0.310968752841388,31
"2791","RN","Messias Targino",4634,17547.52,24003,"Médio Oeste",2,"Nordeste",0,"240760",4,3,0,3,0,3,0,0,0,0,0,3,0,3,0,3,6,9.77266790836743,8.44117570499232,0.340389738111427,30
"2792","RN","Messias Targino",4634,17547.52,24003,"Médio Oeste",2,"Nordeste",0,"240760",5,4,2,2,1,3,0,0,0,0,0,4,2,2,1,3,1,9.77266790836743,8.44117570499232,0.358084038868374,31
"2793","RN","Montanhas",11208,8155.25,24019,"Litoral Sul",2,"Nordeste",0,"240770",2,9,6,3,6,3,1,1,0,1,0,10,7,3,7,3,5,9.00641717062447,9.32438308801684,0.27046802159754,29
"2794","RN","Montanhas",11208,8155.25,24019,"Litoral Sul",2,"Nordeste",0,"240770",3,18,10,8,10,8,0,0,0,0,0,18,10,8,10,8,8,9.00641717062447,9.32438308801684,0.369634343634809,31
"2795","RN","Montanhas",11208,8155.25,24019,"Litoral Sul",2,"Nordeste",0,"240770",4,19,6,13,7,12,0,0,0,0,0,19,6,13,7,12,8,9.00641717062447,9.32438308801684,0.375307887683932,30
"2796","RN","Montanhas",11208,8155.25,24019,"Litoral Sul",2,"Nordeste",0,"240770",5,24,17,7,12,12,0,0,0,0,0,24,17,7,12,12,9,9.00641717062447,9.32438308801684,0.380694953491716,31
"2797","RN","Monte Alegre",22576,9510.79,24015,"Agreste Potiguar",2,"Nordeste",0,"240780",2,23,8,15,13,10,0,0,0,0,0,23,8,15,13,10,11,9.16018222254143,10.0246426740926,0.281729600657906,29
"2798","RN","Monte Alegre",22576,9510.79,24015,"Agreste Potiguar",2,"Nordeste",0,"240780",3,27,15,12,14,13,0,0,0,0,0,27,15,12,14,13,10,9.16018222254143,10.0246426740926,0.360041225107976,31
"2799","RN","Monte Alegre",22576,9510.79,24015,"Agreste Potiguar",2,"Nordeste",0,"240780",4,16,8,8,8,8,0,0,0,0,0,16,8,8,8,8,11,9.16018222254143,10.0246426740926,0.388380610235983,30
"2800","RN","Monte Alegre",22576,9510.79,24015,"Agreste Potiguar",2,"Nordeste",0,"240780",5,21,6,15,9,12,0,0,0,0,0,21,6,15,9,12,20,9.16018222254143,10.0246426740926,0.406136532521683,31
"2801","RN","Mossoró",300618,22185.02,24001,"Mossoró",2,"Nordeste",1,"240800",2,256,47,209,89,167,7,2,5,4,3,263,49,214,93,170,137,10.0071725653226,12.6135956347478,0.297840139524957,29
"2802","RN","Mossoró",300618,22185.02,24001,"Mossoró",2,"Nordeste",1,"240800",3,281,61,220,86,195,2,0,2,1,1,283,61,222,87,196,165,10.0071725653226,12.6135956347478,0.404287329417796,31
"2803","RN","Mossoró",300618,22185.02,24001,"Mossoró",2,"Nordeste",1,"240800",4,236,44,192,90,146,2,1,1,2,0,238,45,193,92,146,194,10.0071725653226,12.6135956347478,0.45794983419738,30
"2804","RN","Mossoró",300618,22185.02,24001,"Mossoró",2,"Nordeste",1,"240800",5,273,65,208,97,176,3,0,3,1,2,276,65,211,98,178,200,10.0071725653226,12.6135956347478,0.437265077229382,31
"2805","RN","Natal",890480,27122.37,24018,"Natal",2,"Nordeste",1,"240810",2,772,191,581,259,513,2,1,1,0,2,774,192,582,259,515,434,10.2081141276166,13.6995159221671,0.287229296218183,29
"2806","RN","Natal",890480,27122.37,24018,"Natal",2,"Nordeste",1,"240810",3,796,225,571,307,489,8,4,4,4,4,804,229,575,311,493,487,10.2081141276166,13.6995159221671,0.395533652602295,31
"2807","RN","Natal",890480,27122.37,24018,"Natal",2,"Nordeste",1,"240810",4,806,234,572,279,527,6,4,2,4,2,812,238,574,283,529,434,10.2081141276166,13.6995159221671,0.470994514217831,30
"2808","RN","Natal",890480,27122.37,24018,"Natal",2,"Nordeste",1,"240810",5,817,231,586,284,533,7,3,4,1,6,824,234,590,285,539,616,10.2081141276166,13.6995159221671,0.449075323871306,31
"2809","RN","Nísia Floresta",27938,15066.81,24017,"Macaíba",2,"Nordeste",0,"240820",2,29,17,12,8,21,0,0,0,0,0,29,17,12,8,21,7,9.6202495903813,10.2377430482875,0.270626335242079,29
"2810","RN","Nísia Floresta",27938,15066.81,24017,"Macaíba",2,"Nordeste",0,"240820",3,25,14,11,8,17,0,0,0,0,0,25,14,11,8,17,11,9.6202495903813,10.2377430482875,0.38052790405643,31
"2811","RN","Nísia Floresta",27938,15066.81,24017,"Macaíba",2,"Nordeste",0,"240820",4,25,14,11,11,14,0,0,0,0,0,25,14,11,11,14,14,9.6202495903813,10.2377430482875,0.416007560203018,30
"2812","RN","Nísia Floresta",27938,15066.81,24017,"Macaíba",2,"Nordeste",0,"240820",5,27,13,14,8,19,1,0,1,0,1,28,13,15,8,20,9,9.6202495903813,10.2377430482875,0.418203691042236,31
"2813","RN","Nova Cruz",37450,12793.93,24015,"Agreste Potiguar",2,"Nordeste",0,"240830",2,33,16,17,12,21,1,0,1,0,1,34,16,18,12,22,13,9.45672611868044,10.5307619889454,0.287415804492679,29
"2814","RN","Nova Cruz",37450,12793.93,24015,"Agreste Potiguar",2,"Nordeste",0,"240830",3,29,15,14,10,19,1,0,1,0,1,30,15,15,10,20,14,9.45672611868044,10.5307619889454,0.370859761283115,31
"2815","RN","Nova Cruz",37450,12793.93,24015,"Agreste Potiguar",2,"Nordeste",0,"240830",4,40,19,21,13,27,1,1,0,0,1,41,20,21,13,28,19,9.45672611868044,10.5307619889454,0.393986508341619,30
"2816","RN","Nova Cruz",37450,12793.93,24015,"Agreste Potiguar",2,"Nordeste",0,"240830",5,46,17,29,15,31,0,0,0,0,0,46,17,29,15,31,21,9.45672611868044,10.5307619889454,0.402811513720164,31
"2817","RN","Ouro Branco",4813,10086.47,24012,"Seridó Oriental",2,"Nordeste",0,"240850",2,6,1,5,2,4,0,0,0,0,0,6,1,5,2,4,0,9.21895020079744,8.47907586930311,0.320929744557588,29
"2818","RN","Ouro Branco",4813,10086.47,24012,"Seridó Oriental",2,"Nordeste",0,"240850",3,2,1,1,1,1,0,0,0,0,0,2,1,1,1,1,2,9.21895020079744,8.47907586930311,0.410462228307541,31
"2819","RN","Ouro Branco",4813,10086.47,24012,"Seridó Oriental",2,"Nordeste",0,"240850",4,2,0,2,1,1,0,0,0,0,0,2,0,2,1,1,4,9.21895020079744,8.47907586930311,0.428037956594003,30
"2820","RN","Ouro Branco",4813,10086.47,24012,"Seridó Oriental",2,"Nordeste",0,"240850",5,5,1,4,0,5,0,0,0,0,0,5,1,4,0,5,1,9.21895020079744,8.47907586930311,0.427004523436066,31
"2821","RN","Parelhas",21545,15402.14,24012,"Seridó Oriental",2,"Nordeste",1,"240890",2,17,5,12,5,12,1,1,0,1,0,18,6,12,6,12,14,9.64226173978649,9.97789905004994,0.266613832508802,29
"2822","RN","Parelhas",21545,15402.14,24012,"Seridó Oriental",2,"Nordeste",1,"240890",3,23,5,18,5,18,1,0,1,1,0,24,5,19,6,18,15,9.64226173978649,9.97789905004994,0.350700817593007,31
"2823","RN","Parelhas",21545,15402.14,24012,"Seridó Oriental",2,"Nordeste",1,"240890",4,15,4,11,7,8,0,0,0,0,0,15,4,11,7,8,25,9.64226173978649,9.97789905004994,0.38291600815464,30
"2824","RN","Parelhas",21545,15402.14,24012,"Seridó Oriental",2,"Nordeste",1,"240890",5,18,6,12,9,9,1,1,0,0,1,19,7,12,9,10,10,9.64226173978649,9.97789905004994,0.382852580626116,31
"2825","RN","Rio do Fogo",10905,15443.72,24016,"Litoral Nordeste",2,"Nordeste",0,"240895",2,13,4,9,8,5,0,0,0,0,0,13,4,9,8,5,5,9.64495772720165,9.29697667863573,0.332867555758008,29
"2826","RN","Rio do Fogo",10905,15443.72,24016,"Litoral Nordeste",2,"Nordeste",0,"240895",3,8,5,3,5,3,0,0,0,0,0,8,5,3,5,3,8,9.64495772720165,9.29697667863573,0.398607521213773,31
"2827","RN","Rio do Fogo",10905,15443.72,24016,"Litoral Nordeste",2,"Nordeste",0,"240895",4,6,4,2,3,3,0,0,0,0,0,6,4,2,3,3,10,9.64495772720165,9.29697667863573,0.433500855939161,30
"2828","RN","Rio do Fogo",10905,15443.72,24016,"Litoral Nordeste",2,"Nordeste",0,"240895",5,12,4,8,6,6,0,0,0,0,0,12,4,8,6,6,9,9.64495772720165,9.29697667863573,0.45180388881027,31
"2829","RN","Passa e Fica",13474,8197.45,24015,"Agreste Potiguar",2,"Nordeste",0,"240910",2,17,7,10,10,7,1,1,0,0,1,18,8,10,10,8,4,9.01157840927965,9.50851718152061,0.255668268548469,29
"2830","RN","Passa e Fica",13474,8197.45,24015,"Agreste Potiguar",2,"Nordeste",0,"240910",3,9,5,4,5,4,0,0,0,0,0,9,5,4,5,4,3,9.01157840927965,9.50851718152061,0.336139839202817,31
"2831","RN","Passa e Fica",13474,8197.45,24015,"Agreste Potiguar",2,"Nordeste",0,"240910",4,15,3,12,9,6,0,0,0,0,0,15,3,12,9,6,8,9.01157840927965,9.50851718152061,0.362624175361628,30
"2832","RN","Passa e Fica",13474,8197.45,24015,"Agreste Potiguar",2,"Nordeste",0,"240910",5,18,6,12,9,9,0,0,0,0,0,18,6,12,9,9,8,9.01157840927965,9.50851718152061,0.338952067504555,31
"2833","RN","Passagem",3102,10416.02,24015,"Agreste Potiguar",2,"Nordeste",0,"240920",2,3,2,1,3,0,0,0,0,0,0,3,2,1,3,0,5,9.25110028456939,8.03980234373648,0.282383522813257,29
"2834","RN","Passagem",3102,10416.02,24015,"Agreste Potiguar",2,"Nordeste",0,"240920",3,4,0,4,1,3,0,0,0,0,0,4,0,4,1,3,2,9.25110028456939,8.03980234373648,0.401531562706192,31
"2835","RN","Passagem",3102,10416.02,24015,"Agreste Potiguar",2,"Nordeste",0,"240920",4,2,0,2,0,2,0,0,0,0,0,2,0,2,0,2,2,9.25110028456939,8.03980234373648,0.418666215405993,30
"2836","RN","Passagem",3102,10416.02,24015,"Agreste Potiguar",2,"Nordeste",0,"240920",5,1,1,0,1,0,0,0,0,0,0,1,1,0,1,0,1,9.25110028456939,8.03980234373648,0.418904802132223,31
"2837","RN","Patu",12809,10701.76,24007,"Umarizal",2,"Nordeste",0,"240930",2,10,5,5,8,2,0,0,0,0,0,10,5,5,8,2,5,9.27816349290497,9.45790332783114,0.242084043238388,29
"2838","RN","Patu",12809,10701.76,24007,"Umarizal",2,"Nordeste",0,"240930",3,8,3,5,6,2,0,0,0,0,0,8,3,5,6,2,11,9.27816349290497,9.45790332783114,0.340333234118809,31
"2839","RN","Patu",12809,10701.76,24007,"Umarizal",2,"Nordeste",0,"240930",4,7,4,3,5,2,0,0,0,0,0,7,4,3,5,2,8,9.27816349290497,9.45790332783114,0.343527654777564,30
"2840","RN","Patu",12809,10701.76,24007,"Umarizal",2,"Nordeste",0,"240930",5,8,4,4,4,4,0,0,0,0,0,8,4,4,4,4,4,9.27816349290497,9.45790332783114,0.355799409039342,31
"2841","RN","Santa Maria",5621,12357.75,24015,"Agreste Potiguar",2,"Nordeste",0,"240933",2,3,1,2,1,2,1,0,1,1,0,4,1,3,2,2,1,9.42203867560565,8.63426486300208,0.290935792423942,29
"2842","RN","Santa Maria",5621,12357.75,24015,"Agreste Potiguar",2,"Nordeste",0,"240933",3,6,1,5,2,4,0,0,0,0,0,6,1,5,2,4,4,9.42203867560565,8.63426486300208,0.374747943599113,31
"2843","RN","Santa Maria",5621,12357.75,24015,"Agreste Potiguar",2,"Nordeste",0,"240933",4,6,2,4,3,3,0,0,0,0,0,6,2,4,3,3,0,9.42203867560565,8.63426486300208,0.417576472494573,30
"2844","RN","Santa Maria",5621,12357.75,24015,"Agreste Potiguar",2,"Nordeste",0,"240933",5,6,4,2,2,4,0,0,0,0,0,6,4,2,2,4,2,9.42203867560565,8.63426486300208,0.380163996578947,31
"2845","RN","Pau dos Ferros",30600,17016.15,24006,"Pau dos Ferros",2,"Nordeste",1,"240940",2,23,11,12,13,10,0,0,0,0,0,23,11,12,13,10,17,9.74191817207394,10.3287552879405,0.267873837672994,29
"2846","RN","Pau dos Ferros",30600,17016.15,24006,"Pau dos Ferros",2,"Nordeste",1,"240940",3,32,13,19,13,19,0,0,0,0,0,32,13,19,13,19,21,9.74191817207394,10.3287552879405,0.353706716291988,31
"2847","RN","Pau dos Ferros",30600,17016.15,24006,"Pau dos Ferros",2,"Nordeste",1,"240940",4,33,5,28,10,23,0,0,0,0,0,33,5,28,10,23,19,9.74191817207394,10.3287552879405,0.395852066174233,30
"2848","RN","Pau dos Ferros",30600,17016.15,24006,"Pau dos Ferros",2,"Nordeste",1,"240940",5,32,8,24,8,24,0,0,0,0,0,32,8,24,8,24,28,9.74191817207394,10.3287552879405,0.38684102637408,31
"2849","RN","Pedra Grande",3199,65310.13,24016,"Litoral Nordeste",2,"Nordeste",0,"240950",2,1,0,1,0,1,0,0,0,0,0,1,0,1,0,1,0,11.0869024334015,8.07059353994952,0.327862229077122,29
"2850","RN","Pedra Grande",3199,65310.13,24016,"Litoral Nordeste",2,"Nordeste",0,"240950",3,3,1,2,1,2,0,0,0,0,0,3,1,2,1,2,1,11.0869024334015,8.07059353994952,0.38743610283469,31
"2851","RN","Pedra Grande",3199,65310.13,24016,"Litoral Nordeste",2,"Nordeste",0,"240950",4,4,2,2,2,2,0,0,0,0,0,4,2,2,2,2,2,11.0869024334015,8.07059353994952,0.383981277152739,30
"2852","RN","Pedra Grande",3199,65310.13,24016,"Litoral Nordeste",2,"Nordeste",0,"240950",5,5,0,5,2,3,0,0,0,0,0,5,0,5,2,3,0,11.0869024334015,8.07059353994952,0.402440171470985,31
"2853","RN","Pedro Avelino",6653,8202.59,24009,"Angicos",2,"Nordeste",0,"240970",2,8,5,3,2,6,0,0,0,0,0,8,5,3,2,6,2,9.01220523703962,8.80282315974189,0.300399563254449,29
"2854","RN","Pedro Avelino",6653,8202.59,24009,"Angicos",2,"Nordeste",0,"240970",3,5,3,2,2,3,0,0,0,0,0,5,3,2,2,3,1,9.01220523703962,8.80282315974189,0.344177998393314,31
"2855","RN","Pedro Avelino",6653,8202.59,24009,"Angicos",2,"Nordeste",0,"240970",4,7,3,4,4,3,0,0,0,0,0,7,3,4,4,3,2,9.01220523703962,8.80282315974189,0.407842953551438,30
"2856","RN","Pedro Avelino",6653,8202.59,24009,"Angicos",2,"Nordeste",0,"240970",5,5,1,4,2,3,0,0,0,0,0,5,1,4,2,3,2,9.01220523703962,8.80282315974189,0.426531194138199,31
"2857","RN","Pedro Velho",14844,8366.95,24019,"Litoral Sul",2,"Nordeste",0,"240980",2,12,6,6,7,5,0,0,0,0,0,12,6,6,7,5,8,9.03204470042021,9.60535102218049,0.289743177621254,29
"2858","RN","Pedro Velho",14844,8366.95,24019,"Litoral Sul",2,"Nordeste",0,"240980",3,13,5,8,9,4,0,0,0,0,0,13,5,8,9,4,16,9.03204470042021,9.60535102218049,0.383845717076987,31
"2859","RN","Pedro Velho",14844,8366.95,24019,"Litoral Sul",2,"Nordeste",0,"240980",4,14,7,7,5,9,0,0,0,0,0,14,7,7,5,9,4,9.03204470042021,9.60535102218049,0.398666849524294,30
"2860","RN","Pedro Velho",14844,8366.95,24019,"Litoral Sul",2,"Nordeste",0,"240980",5,16,11,5,11,5,1,0,1,1,0,17,11,6,12,5,7,9.03204470042021,9.60535102218049,0.412976575266097,31
"2861","RN","Pendências",15272,32065.62,24004,"Vale do Açu",2,"Nordeste",0,"240990",2,8,1,7,6,2,0,0,0,0,0,8,1,7,6,2,8,10.3755397071203,9.63377636540558,0.294584472659589,29
"2862","RN","Pendências",15272,32065.62,24004,"Vale do Açu",2,"Nordeste",0,"240990",3,10,3,7,7,3,1,1,0,1,0,11,4,7,8,3,11,10.3755397071203,9.63377636540558,0.383186697111232,31
"2863","RN","Pendências",15272,32065.62,24004,"Vale do Açu",2,"Nordeste",0,"240990",4,12,3,9,2,10,0,0,0,0,0,12,3,9,2,10,3,10.3755397071203,9.63377636540558,0.41717985581932,30
"2864","RN","Pendências",15272,32065.62,24004,"Vale do Açu",2,"Nordeste",0,"240990",5,10,2,8,6,4,0,0,0,0,0,10,2,8,6,4,12,10.3755397071203,9.63377636540558,0.41586945911239,31
"2865","RN","Poço Branco",15531,7090.78,24013,"Baixa Verde",2,"Nordeste",0,"241010",2,11,3,8,6,5,2,2,0,2,0,13,5,8,8,5,2,8.86655062757944,9.65059330557001,0.30067035116582,29
"2866","RN","Poço Branco",15531,7090.78,24013,"Baixa Verde",2,"Nordeste",0,"241010",3,12,2,10,3,9,0,0,0,0,0,12,2,10,3,9,9,8.86655062757944,9.65059330557001,0.425002607476552,31
"2867","RN","Poço Branco",15531,7090.78,24013,"Baixa Verde",2,"Nordeste",0,"241010",4,14,6,8,6,8,0,0,0,0,0,14,6,8,6,8,7,8.86655062757944,9.65059330557001,0.454199405145471,30
"2868","RN","Poço Branco",15531,7090.78,24013,"Baixa Verde",2,"Nordeste",0,"241010",5,15,5,10,5,10,0,0,0,0,0,15,5,10,5,10,10,8.86655062757944,9.65059330557001,0.467387968274108,31
"2869","RN","Portalegre",7906,7736.42,24006,"Pau dos Ferros",2,"Nordeste",0,"241020",2,9,5,4,3,6,0,0,0,0,0,9,5,4,3,6,4,8.95369432728297,8.97537724385663,0.243386153537983,29
"2870","RN","Portalegre",7906,7736.42,24006,"Pau dos Ferros",2,"Nordeste",0,"241020",3,5,2,3,3,2,0,0,0,0,0,5,2,3,3,2,6,8.95369432728297,8.97537724385663,0.353134749075345,31
"2871","RN","Portalegre",7906,7736.42,24006,"Pau dos Ferros",2,"Nordeste",0,"241020",4,8,1,7,2,6,0,0,0,0,0,8,1,7,2,6,5,8.95369432728297,8.97537724385663,0.394007479000169,30
"2872","RN","Portalegre",7906,7736.42,24006,"Pau dos Ferros",2,"Nordeste",0,"241020",5,9,4,5,5,4,0,0,0,0,0,9,4,5,5,4,5,8.95369432728297,8.97537724385663,0.368649791531752,31
"2873","RN","Porto do Mangue",6522,22960.2,24004,"Vale do Açu",2,"Nordeste",0,"241025",2,9,6,3,5,4,0,0,0,0,0,9,6,3,5,4,1,10.041517561197,8.78293635634926,0.296002651897671,29
"2874","RN","Porto do Mangue",6522,22960.2,24004,"Vale do Açu",2,"Nordeste",0,"241025",3,5,1,4,0,5,0,0,0,0,0,5,1,4,0,5,2,10.041517561197,8.78293635634926,0.358602839455302,31
"2875","RN","Porto do Mangue",6522,22960.2,24004,"Vale do Açu",2,"Nordeste",0,"241025",4,5,3,2,4,1,0,0,0,0,0,5,3,2,4,1,7,10.041517561197,8.78293635634926,0.415968039548569,30
"2876","RN","Porto do Mangue",6522,22960.2,24004,"Vale do Açu",2,"Nordeste",0,"241025",5,7,4,3,5,2,0,0,0,0,0,7,4,3,5,2,3,10.041517561197,8.78293635634926,0.407209046284366,31
"2877","RN","Serra Caiada",10522,7653.36,24015,"Agreste Potiguar",2,"Nordeste",0,"241030",2,6,5,1,4,2,0,0,0,0,0,6,5,1,4,2,3,8.94290004607988,9.26122358229075,0.310979918349786,29
"2878","RN","Serra Caiada",10522,7653.36,24015,"Agreste Potiguar",2,"Nordeste",0,"241030",3,11,6,5,6,5,1,1,0,0,1,12,7,5,6,6,6,8.94290004607988,9.26122358229075,0.377939615996241,31
"2879","RN","Serra Caiada",10522,7653.36,24015,"Agreste Potiguar",2,"Nordeste",0,"241030",4,13,7,6,6,7,0,0,0,0,0,13,7,6,6,7,2,8.94290004607988,9.26122358229075,0.386975832980773,30
"2880","RN","Serra Caiada",10522,7653.36,24015,"Agreste Potiguar",2,"Nordeste",0,"241030",5,15,8,7,7,8,0,0,0,0,0,15,8,7,7,8,7,8.94290004607988,9.26122358229075,0.406925080692172,31
"2881","RN","Pureza",9724,12508.1,24016,"Litoral Nordeste",2,"Nordeste",0,"241040",2,12,5,7,5,7,0,0,0,0,0,12,5,7,5,7,3,9.43413171342905,9.18235233543601,0.302381201450611,29
"2882","RN","Pureza",9724,12508.1,24016,"Litoral Nordeste",2,"Nordeste",0,"241040",3,10,6,4,6,4,0,0,0,0,0,10,6,4,6,4,4,9.43413171342905,9.18235233543601,0.396909245969213,31
"2883","RN","Pureza",9724,12508.1,24016,"Litoral Nordeste",2,"Nordeste",0,"241040",4,9,3,6,6,3,0,0,0,0,0,9,3,6,6,3,1,9.43413171342905,9.18235233543601,0.408811563878179,30
"2884","RN","Pureza",9724,12508.1,24016,"Litoral Nordeste",2,"Nordeste",0,"241040",5,3,2,1,2,1,0,0,0,0,0,3,2,1,2,1,7,9.43413171342905,9.18235233543601,0.444654267067235,31
"2885","RN","Rafael Fernandes",5128,8352.04,24006,"Pau dos Ferros",2,"Nordeste",0,"241050",2,3,2,1,1,2,0,0,0,0,0,3,2,1,1,2,2,9.03026109938298,8.54247099860051,0.278703468903311,29
"2886","RN","Rafael Fernandes",5128,8352.04,24006,"Pau dos Ferros",2,"Nordeste",0,"241050",3,5,3,2,3,2,0,0,0,0,0,5,3,2,3,2,2,9.03026109938298,8.54247099860051,0.374393164528538,31
"2887","RN","Rafael Fernandes",5128,8352.04,24006,"Pau dos Ferros",2,"Nordeste",0,"241050",4,2,2,0,1,1,1,1,0,1,0,3,3,0,2,1,3,9.03026109938298,8.54247099860051,0.379987493092851,30
"2888","RN","Rafael Fernandes",5128,8352.04,24006,"Pau dos Ferros",2,"Nordeste",0,"241050",5,5,2,3,0,5,0,0,0,0,0,5,2,3,0,5,2,9.03026109938298,8.54247099860051,0.38435468133835,31
"2889","RN","Riacho da Cruz",3614,8734.2,24006,"Pau dos Ferros",2,"Nordeste",0,"241070",2,2,1,1,0,2,0,0,0,0,0,2,1,1,0,2,0,9.07500163279867,8.19257047115217,0.249126977188195,29
"2890","RN","Riacho da Cruz",3614,8734.2,24006,"Pau dos Ferros",2,"Nordeste",0,"241070",3,3,1,2,2,1,1,0,1,1,0,4,1,3,3,1,2,9.07500163279867,8.19257047115217,0.359485238894941,31
"2891","RN","Riacho da Cruz",3614,8734.2,24006,"Pau dos Ferros",2,"Nordeste",0,"241070",4,2,1,1,2,0,0,0,0,0,0,2,1,1,2,0,1,9.07500163279867,8.19257047115217,0.41224100692939,30
"2892","RN","Riacho da Cruz",3614,8734.2,24006,"Pau dos Ferros",2,"Nordeste",0,"241070",5,0,0,0,0,0,0,0,0,0,0,0,0,0,0,0,3,9.07500163279867,8.19257047115217,0.421447775505195,31
"2893","RN","Riachuelo",8220,8398.14,24015,"Agreste Potiguar",2,"Nordeste",0,"241090",2,4,1,3,3,1,0,0,0,0,0,4,1,3,3,1,4,9.03576553174105,9.01432548805023,0.29879727313378,29
"2894","RN","Riachuelo",8220,8398.14,24015,"Agreste Potiguar",2,"Nordeste",0,"241090",3,9,3,6,5,4,0,0,0,0,0,9,3,6,5,4,5,9.03576553174105,9.01432548805023,0.401620146542475,31
"2895","RN","Riachuelo",8220,8398.14,24015,"Agreste Potiguar",2,"Nordeste",0,"241090",4,6,2,4,3,3,0,0,0,0,0,6,2,4,3,3,3,9.03576553174105,9.01432548805023,0.389055807876215,30
"2896","RN","Riachuelo",8220,8398.14,24015,"Agreste Potiguar",2,"Nordeste",0,"241090",5,6,2,4,2,4,0,0,0,0,0,6,2,4,2,4,4,9.03576553174105,9.01432548805023,0.383302666393802,31
"2897","RN","Rodolfo Fernandes",4462,9161.2,24006,"Pau dos Ferros",2,"Nordeste",0,"241100",2,2,1,1,0,2,0,0,0,0,0,2,1,1,0,2,2,9.12273245345466,8.40335237499248,0.242823831740329,29
"2898","RN","Rodolfo Fernandes",4462,9161.2,24006,"Pau dos Ferros",2,"Nordeste",0,"241100",3,7,2,5,3,4,0,0,0,0,0,7,2,5,3,4,2,9.12273245345466,8.40335237499248,0.331906357164782,31
"2899","RN","Rodolfo Fernandes",4462,9161.2,24006,"Pau dos Ferros",2,"Nordeste",0,"241100",4,6,2,4,4,2,0,0,0,0,0,6,2,4,4,2,4,9.12273245345466,8.40335237499248,0.356368750238596,30
"2900","RN","Rodolfo Fernandes",4462,9161.2,24006,"Pau dos Ferros",2,"Nordeste",0,"241100",5,3,0,3,2,1,0,0,0,0,0,3,0,3,2,1,2,9.12273245345466,8.40335237499248,0.381548032794429,31
"2901","RN","Tibau",4140,23498.9,24001,"Mossoró",2,"Nordeste",0,"241105",2,8,4,4,4,4,0,0,0,0,0,8,4,4,4,4,4,10.0647088905261,8.32845106681936,0.277631463182825,29
"2902","RN","Tibau",4140,23498.9,24001,"Mossoró",2,"Nordeste",0,"241105",3,6,3,3,2,4,1,0,1,1,0,7,3,4,3,4,4,10.0647088905261,8.32845106681936,0.380586182039336,31
"2903","RN","Tibau",4140,23498.9,24001,"Mossoró",2,"Nordeste",0,"241105",4,4,1,3,1,3,0,0,0,0,0,4,1,3,1,3,3,10.0647088905261,8.32845106681936,0.399912049507071,30
"2904","RN","Tibau",4140,23498.9,24001,"Mossoró",2,"Nordeste",0,"241105",5,8,3,5,3,5,0,0,0,0,0,8,3,5,3,5,7,10.0647088905261,8.32845106681936,0.412507695080056,31
"2905","RN","Ruy Barbosa",3592,8799.68,24014,"Borborema Potiguar",2,"Nordeste",0,"241110",2,1,0,1,1,0,0,0,0,0,0,1,0,1,1,0,0,9.08247063616876,8.18646442942209,0.317067430314878,29
"2906","RN","Ruy Barbosa",3592,8799.68,24014,"Borborema Potiguar",2,"Nordeste",0,"241110",3,2,0,2,1,1,1,0,1,0,1,3,0,3,1,2,1,9.08247063616876,8.18646442942209,0.378766033380801,31
"2907","RN","Ruy Barbosa",3592,8799.68,24014,"Borborema Potiguar",2,"Nordeste",0,"241110",4,6,3,3,1,5,0,0,0,0,0,6,3,3,1,5,0,9.08247063616876,8.18646442942209,0.394599769036657,30
"2908","RN","Ruy Barbosa",3592,8799.68,24014,"Borborema Potiguar",2,"Nordeste",0,"241110",5,3,1,2,1,2,0,0,0,0,0,3,1,2,1,2,0,9.08247063616876,8.18646442942209,0.409788496521467,31
"2909","RN","Santa Cruz",39988,14489.25,24014,"Borborema Potiguar",2,"Nordeste",1,"241120",2,40,16,24,18,22,0,0,0,0,0,40,16,24,18,22,15,9.58116227414077,10.5963346880871,0.256088382790392,29
"2910","RN","Santa Cruz",39988,14489.25,24014,"Borborema Potiguar",2,"Nordeste",1,"241120",3,47,19,28,20,27,0,0,0,0,0,47,19,28,20,27,22,9.58116227414077,10.5963346880871,0.347874251603917,31
"2911","RN","Santa Cruz",39988,14489.25,24014,"Borborema Potiguar",2,"Nordeste",1,"241120",4,37,13,24,15,22,0,0,0,0,0,37,13,24,15,22,25,9.58116227414077,10.5963346880871,0.378188483388331,30
"2912","RN","Santa Cruz",39988,14489.25,24014,"Borborema Potiguar",2,"Nordeste",1,"241120",5,33,16,17,13,20,1,0,1,1,0,34,16,18,14,20,23,9.58116227414077,10.5963346880871,0.36753916283173,31
"2913","RN","Santana do Matos",11956,9346.7,24010,"Serra de Santana",2,"Nordeste",0,"241140",2,8,1,7,2,6,0,0,0,0,0,8,1,7,2,6,9,9.14277861880787,9.38898852340383,0.275771458531683,29
"2914","RN","Santana do Matos",11956,9346.7,24010,"Serra de Santana",2,"Nordeste",0,"241140",3,6,4,2,3,3,0,0,0,0,0,6,4,2,3,3,7,9.14277861880787,9.38898852340383,0.354818573875945,31
"2915","RN","Santana do Matos",11956,9346.7,24010,"Serra de Santana",2,"Nordeste",0,"241140",4,6,0,6,2,4,0,0,0,0,0,6,0,6,2,4,14,9.14277861880787,9.38898852340383,0.38030842558625,30
"2916","RN","Santana do Matos",11956,9346.7,24010,"Serra de Santana",2,"Nordeste",0,"241140",5,11,7,4,3,8,0,0,0,0,0,11,7,4,3,8,7,9.14277861880787,9.38898852340383,0.425169154223618,31
"2917","RN","Santo Antônio",24280,9355.26,24015,"Agreste Potiguar",2,"Nordeste",0,"241150",2,21,7,14,8,13,0,0,0,0,0,21,7,14,8,13,15,9.14369403094625,10.0974082451734,0.268483126500718,29
"2918","RN","Santo Antônio",24280,9355.26,24015,"Agreste Potiguar",2,"Nordeste",0,"241150",3,21,6,15,9,12,1,1,0,0,1,22,7,15,9,13,12,9.14369403094625,10.0974082451734,0.358086328317768,31
"2919","RN","Santo Antônio",24280,9355.26,24015,"Agreste Potiguar",2,"Nordeste",0,"241150",4,36,18,18,14,22,0,0,0,0,0,36,18,18,14,22,7,9.14369403094625,10.0974082451734,0.369898184647879,30
"2920","RN","Santo Antônio",24280,9355.26,24015,"Agreste Potiguar",2,"Nordeste",0,"241150",5,28,13,15,13,15,0,0,0,0,0,28,13,15,13,15,10,9.14369403094625,10.0974082451734,0.371174121578946,31
"2921","RN","São Bento do Norte",2717,71914,24008,"Macau",2,"Nordeste",0,"241160",2,2,2,0,2,0,0,0,0,0,0,2,2,0,2,0,1,11.1832262396364,7.90728360942635,0.278928450645354,29
"2922","RN","São Bento do Norte",2717,71914,24008,"Macau",2,"Nordeste",0,"241160",3,5,2,3,1,4,0,0,0,0,0,5,2,3,1,4,3,11.1832262396364,7.90728360942635,0.364510586758128,31
"2923","RN","São Bento do Norte",2717,71914,24008,"Macau",2,"Nordeste",0,"241160",4,6,2,4,2,4,0,0,0,0,0,6,2,4,2,4,2,11.1832262396364,7.90728360942635,0.370214892193616,30
"2924","RN","São Bento do Norte",2717,71914,24008,"Macau",2,"Nordeste",0,"241160",5,7,1,6,2,5,0,0,0,0,0,7,1,6,2,5,0,11.1832262396364,7.90728360942635,0.362164064862218,31
"2925","RN","São Fernando",3595,13671,24011,"Seridó Ocidental",2,"Nordeste",0,"241180",2,1,0,1,1,0,0,0,0,0,0,1,0,1,1,0,1,9.52303207993199,8.18729927015515,0.244426915395858,29
"2926","RN","São Fernando",3595,13671,24011,"Seridó Ocidental",2,"Nordeste",0,"241180",3,2,1,1,1,1,0,0,0,0,0,2,1,1,1,1,2,9.52303207993199,8.18729927015515,0.362534592424714,31
"2927","RN","São Fernando",3595,13671,24011,"Seridó Ocidental",2,"Nordeste",0,"241180",4,3,1,2,0,3,0,0,0,0,0,3,1,2,0,3,0,9.52303207993199,8.18729927015515,0.373555054824879,30
"2928","RN","São Fernando",3595,13671,24011,"Seridó Ocidental",2,"Nordeste",0,"241180",5,3,2,1,1,2,0,0,0,0,0,3,2,1,1,2,0,9.52303207993199,8.18729927015515,0.412713451872103,31
"2929","RN","São Gonçalo do Amarante",103672,14666.66,24017,"Macaíba",2,"Nordeste",1,"241200",2,109,33,76,26,83,0,0,0,0,0,109,33,76,26,83,47,9.59333216968673,11.5489873481153,0.272786604202409,29
"2930","RN","São Gonçalo do Amarante",103672,14666.66,24017,"Macaíba",2,"Nordeste",1,"241200",3,81,19,62,27,54,4,3,1,2,2,85,22,63,29,56,60,9.59333216968673,11.5489873481153,0.370980888756113,31
"2931","RN","São Gonçalo do Amarante",103672,14666.66,24017,"Macaíba",2,"Nordeste",1,"241200",4,90,21,69,29,61,1,1,0,1,0,91,22,69,30,61,40,9.59333216968673,11.5489873481153,0.439380528317523,30
"2932","RN","São Gonçalo do Amarante",103672,14666.66,24017,"Macaíba",2,"Nordeste",1,"241200",5,98,21,77,33,65,0,0,0,0,0,98,21,77,33,65,57,9.59333216968673,11.5489873481153,0.42024524284171,31
"2933","RN","São João do Sabugi",6207,9612.68,24011,"Seridó Ocidental",2,"Nordeste",0,"241210",2,7,4,3,3,4,0,0,0,0,0,7,4,3,3,4,3,9.17083833925626,8.73343296641365,0.273660824244726,29
"2934","RN","São João do Sabugi",6207,9612.68,24011,"Seridó Ocidental",2,"Nordeste",0,"241210",3,6,1,5,3,3,0,0,0,0,0,6,1,5,3,3,3,9.17083833925626,8.73343296641365,0.371277141923304,31
"2935","RN","São João do Sabugi",6207,9612.68,24011,"Seridó Ocidental",2,"Nordeste",0,"241210",4,4,0,4,0,4,0,0,0,0,0,4,0,4,0,4,5,9.17083833925626,8.73343296641365,0.385340549592715,30
"2936","RN","São João do Sabugi",6207,9612.68,24011,"Seridó Ocidental",2,"Nordeste",0,"241210",5,5,2,3,1,4,0,0,0,0,0,5,2,3,1,4,3,9.17083833925626,8.73343296641365,0.420423247966025,31
"2937","RN","São José de Mipibu",44236,17715.29,24017,"Macaíba",2,"Nordeste",0,"241220",2,40,18,22,17,23,0,0,0,0,0,40,18,22,17,23,23,9.78218338747323,10.6972942161953,0.27938775614437,29
"2938","RN","São José de Mipibu",44236,17715.29,24017,"Macaíba",2,"Nordeste",0,"241220",3,58,27,31,26,32,1,1,0,0,1,59,28,31,26,33,31,9.78218338747323,10.6972942161953,0.368256430922619,31
"2939","RN","São José de Mipibu",44236,17715.29,24017,"Macaíba",2,"Nordeste",0,"241220",4,64,28,36,27,37,1,0,1,0,1,65,28,37,27,38,24,9.78218338747323,10.6972942161953,0.403154300400235,30
"2940","RN","São José de Mipibu",44236,17715.29,24017,"Macaíba",2,"Nordeste",0,"241220",5,61,29,32,25,36,0,0,0,0,0,61,29,32,25,36,27,9.78218338747323,10.6972942161953,0.400188299280465,31
"2941","RN","São José do Campestre",12879,7228.09,24014,"Borborema Potiguar",2,"Nordeste",1,"241230",2,6,3,3,3,3,0,0,0,0,0,6,3,3,3,3,6,8.8857301032118,9.46335335689267,0.273405791346394,29
"2942","RN","São José do Campestre",12879,7228.09,24014,"Borborema Potiguar",2,"Nordeste",1,"241230",3,11,4,7,4,7,0,0,0,0,0,11,4,7,4,7,6,8.8857301032118,9.46335335689267,0.346475572774636,31
"2943","RN","São José do Campestre",12879,7228.09,24014,"Borborema Potiguar",2,"Nordeste",1,"241230",4,4,2,2,3,1,0,0,0,0,0,4,2,2,3,1,6,8.8857301032118,9.46335335689267,0.361085286870314,30
"2944","RN","São José do Campestre",12879,7228.09,24014,"Borborema Potiguar",2,"Nordeste",1,"241230",5,14,7,7,6,8,0,0,0,0,0,14,7,7,6,8,9,8.8857301032118,9.46335335689267,0.361128407568044,31
"2945","RN","São José do Seridó",4665,23186.58,24012,"Seridó Oriental",2,"Nordeste",0,"241240",2,3,3,0,3,0,0,0,0,0,0,3,3,0,3,0,5,10.0513289420128,8.44784311328144,0.291211493038162,29
"2946","RN","São José do Seridó",4665,23186.58,24012,"Seridó Oriental",2,"Nordeste",0,"241240",3,6,1,5,3,3,0,0,0,0,0,6,1,5,3,3,5,10.0513289420128,8.44784311328144,0.384011948731713,31
"2947","RN","São José do Seridó",4665,23186.58,24012,"Seridó Oriental",2,"Nordeste",0,"241240",4,3,2,1,2,1,0,0,0,0,0,3,2,1,2,1,5,10.0513289420128,8.44784311328144,0.406166286219908,30
"2948","RN","São José do Seridó",4665,23186.58,24012,"Seridó Oriental",2,"Nordeste",0,"241240",5,2,0,2,0,2,0,0,0,0,0,2,0,2,0,2,2,10.0513289420128,8.44784311328144,0.366414542530628,31
"2949","RN","São Miguel",23655,9623.12,24005,"Serra de São Miguel",2,"Nordeste",0,"241250",2,21,11,10,10,11,0,0,0,0,0,21,11,10,10,11,14,9.17192381540231,10.0713297880652,0.279909650885814,29
"2950","RN","São Miguel",23655,9623.12,24005,"Serra de São Miguel",2,"Nordeste",0,"241250",3,21,11,10,11,10,0,0,0,0,0,21,11,10,11,10,12,9.17192381540231,10.0713297880652,0.365332863429253,31
"2951","RN","São Miguel",23655,9623.12,24005,"Serra de São Miguel",2,"Nordeste",0,"241250",4,17,11,6,8,9,1,0,1,1,0,18,11,7,9,9,11,9.17192381540231,10.0713297880652,0.428640289752177,30
"2952","RN","São Miguel",23655,9623.12,24005,"Serra de São Miguel",2,"Nordeste",0,"241250",5,13,7,6,6,7,0,0,0,0,0,13,7,6,6,7,23,9.17192381540231,10.0713297880652,0.422147451861367,31
"2953","RN","São Miguel do Gostoso",10362,44082.85,24016,"Litoral Nordeste",2,"Nordeste",0,"241255",2,8,1,7,5,3,0,0,0,0,0,8,1,7,5,3,2,10.6938260969092,9.24590054737473,0.280372998014303,29
"2954","RN","São Miguel do Gostoso",10362,44082.85,24016,"Litoral Nordeste",2,"Nordeste",0,"241255",3,3,0,3,1,2,0,0,0,0,0,3,0,3,1,2,4,10.6938260969092,9.24590054737473,0.362387139796652,31
"2955","RN","São Miguel do Gostoso",10362,44082.85,24016,"Litoral Nordeste",2,"Nordeste",0,"241255",4,8,3,5,3,5,0,0,0,0,0,8,3,5,3,5,2,10.6938260969092,9.24590054737473,0.37908305905105,30
"2956","RN","São Miguel do Gostoso",10362,44082.85,24016,"Litoral Nordeste",2,"Nordeste",0,"241255",5,9,5,4,4,5,0,0,0,0,0,9,5,4,4,5,6,10.6938260969092,9.24590054737473,0.399927289566707,31
"2957","RN","São Paulo do Potengi",17720,9581.67,24015,"Agreste Potiguar",2,"Nordeste",0,"241260",2,13,4,9,3,10,1,0,1,0,1,14,4,10,3,11,7,9.16760717727581,9.78244922415907,0.255316256560904,29
"2958","RN","São Paulo do Potengi",17720,9581.67,24015,"Agreste Potiguar",2,"Nordeste",0,"241260",3,19,8,11,11,8,0,0,0,0,0,19,8,11,11,8,10,9.16760717727581,9.78244922415907,0.335918773036973,31
"2959","RN","São Paulo do Potengi",17720,9581.67,24015,"Agreste Potiguar",2,"Nordeste",0,"241260",4,10,2,8,1,9,1,1,0,0,1,11,3,8,1,10,4,9.16760717727581,9.78244922415907,0.350963394754198,30
"2960","RN","São Paulo do Potengi",17720,9581.67,24015,"Agreste Potiguar",2,"Nordeste",0,"241260",5,12,5,7,3,9,0,0,0,0,0,12,5,7,3,9,11,9.16760717727581,9.78244922415907,0.351939262597393,31
"2961","RN","São Pedro",5930,9837.78,24015,"Agreste Potiguar",2,"Nordeste",0,"241270",2,4,1,3,3,1,0,0,0,0,0,4,1,3,3,1,4,9.19398535483649,8.68777949199177,0.310837823246994,29
"2962","RN","São Pedro",5930,9837.78,24015,"Agreste Potiguar",2,"Nordeste",0,"241270",3,9,3,6,3,6,0,0,0,0,0,9,3,6,3,6,3,9.19398535483649,8.68777949199177,0.415306093181846,31
"2963","RN","São Pedro",5930,9837.78,24015,"Agreste Potiguar",2,"Nordeste",0,"241270",4,6,5,1,2,4,0,0,0,0,0,6,5,1,2,4,3,9.19398535483649,8.68777949199177,0.42448486667371,30
"2964","RN","São Pedro",5930,9837.78,24015,"Agreste Potiguar",2,"Nordeste",0,"241270",5,5,4,1,4,1,0,0,0,0,0,5,4,1,4,1,3,9.19398535483649,8.68777949199177,0.414070025071849,31
"2965","RN","São Rafael",8192,9075.99,24004,"Vale do Açu",2,"Nordeste",0,"241280",2,4,1,3,2,2,1,0,1,0,1,5,1,4,2,3,6,9.11338774409216,9.01091334727929,0.292294837077281,29
"2966","RN","São Rafael",8192,9075.99,24004,"Vale do Açu",2,"Nordeste",0,"241280",3,7,4,3,4,3,0,0,0,0,0,7,4,3,4,3,5,9.11338774409216,9.01091334727929,0.382567294482868,31
"2967","RN","São Rafael",8192,9075.99,24004,"Vale do Açu",2,"Nordeste",0,"241280",4,3,1,2,2,1,0,0,0,0,0,3,1,2,2,1,5,9.11338774409216,9.01091334727929,0.405967736804407,30
"2968","RN","São Rafael",8192,9075.99,24004,"Vale do Açu",2,"Nordeste",0,"241280",5,7,3,4,4,3,0,0,0,0,0,7,3,4,4,3,2,9.11338774409216,9.01091334727929,0.407385556819078,31
"2969","RN","São Tomé",11053,9037.98,24014,"Borborema Potiguar",2,"Nordeste",0,"241290",2,9,3,6,1,8,0,0,0,0,0,9,3,6,1,8,8,9.10919097708982,9.31045716331096,0.283743522972061,29
"2970","RN","São Tomé",11053,9037.98,24014,"Borborema Potiguar",2,"Nordeste",0,"241290",3,9,6,3,1,8,0,0,0,0,0,9,6,3,1,8,4,9.10919097708982,9.31045716331096,0.351576432529848,31
"2971","RN","São Tomé",11053,9037.98,24014,"Borborema Potiguar",2,"Nordeste",0,"241290",4,4,2,2,2,2,0,0,0,0,0,4,2,2,2,2,6,9.10919097708982,9.31045716331096,0.378106083055219,30
"2972","RN","São Tomé",11053,9037.98,24014,"Borborema Potiguar",2,"Nordeste",0,"241290",5,14,7,7,4,10,0,0,0,0,0,14,7,7,4,10,9,9.10919097708982,9.31045716331096,0.414403932001115,31
"2973","RN","São Vicente",6450,10701.68,24010,"Serra de Santana",2,"Nordeste",0,"241300",2,7,3,4,1,6,0,0,0,0,0,7,3,4,1,6,2,9.27815601747112,8.77183540978982,0.284512242267253,29
"2974","RN","São Vicente",6450,10701.68,24010,"Serra de Santana",2,"Nordeste",0,"241300",3,6,2,4,3,3,0,0,0,0,0,6,2,4,3,3,3,9.27815601747112,8.77183540978982,0.352189425135944,31
"2975","RN","São Vicente",6450,10701.68,24010,"Serra de Santana",2,"Nordeste",0,"241300",4,3,1,2,1,2,0,0,0,0,0,3,1,2,1,2,4,9.27815601747112,8.77183540978982,0.36817128192854,30
"2976","RN","São Vicente",6450,10701.68,24010,"Serra de Santana",2,"Nordeste",0,"241300",5,5,1,4,0,5,0,0,0,0,0,5,1,4,0,5,1,9.27815601747112,8.77183540978982,0.398468121943104,31
"2977","RN","Senador Elói de Souza",6127,7405.42,24015,"Agreste Potiguar",2,"Nordeste",0,"241310",2,5,1,4,2,3,0,0,0,0,0,5,1,4,2,3,5,8.90996744352696,8.72046051272565,0.27616533929873,29
"2978","RN","Senador Elói de Souza",6127,7405.42,24015,"Agreste Potiguar",2,"Nordeste",0,"241310",3,12,5,7,5,7,0,0,0,0,0,12,5,7,5,7,1,8.90996744352696,8.72046051272565,0.358067628613543,31
"2979","RN","Senador Elói de Souza",6127,7405.42,24015,"Agreste Potiguar",2,"Nordeste",0,"241310",4,9,3,6,3,6,0,0,0,0,0,9,3,6,3,6,4,8.90996744352696,8.72046051272565,0.412233748203128,30
"2980","RN","Senador Elói de Souza",6127,7405.42,24015,"Agreste Potiguar",2,"Nordeste",0,"241310",5,4,1,3,1,3,0,0,0,0,0,4,1,3,1,3,3,8.90996744352696,8.72046051272565,0.453272310957978,31
"2981","RN","Senador Georgino Avelino",4484,28781.96,24019,"Litoral Sul",2,"Nordeste",0,"241320",2,7,3,4,3,4,0,0,0,0,0,7,3,4,3,4,1,10.2675040809717,8.40827078419205,0.290232558434462,29
"2982","RN","Senador Georgino Avelino",4484,28781.96,24019,"Litoral Sul",2,"Nordeste",0,"241320",3,9,4,5,3,6,0,0,0,0,0,9,4,5,3,6,1,10.2675040809717,8.40827078419205,0.386920986363729,31
"2983","RN","Senador Georgino Avelino",4484,28781.96,24019,"Litoral Sul",2,"Nordeste",0,"241320",4,6,3,3,2,4,0,0,0,0,0,6,3,3,2,4,3,10.2675040809717,8.40827078419205,0.420609003541203,30
"2984","RN","Senador Georgino Avelino",4484,28781.96,24019,"Litoral Sul",2,"Nordeste",0,"241320",5,4,3,1,3,1,1,1,0,1,0,5,4,1,4,1,4,10.2675040809717,8.40827078419205,0.434707110040114,31
"2985","RN","Serra de São Bento",5751,7746.66,24014,"Borborema Potiguar",2,"Nordeste",0,"241330",2,4,2,2,2,2,0,0,0,0,0,4,2,2,2,2,5,8.95501706171217,8.65712903171375,0.280386473908789,29
"2986","RN","Serra de São Bento",5751,7746.66,24014,"Borborema Potiguar",2,"Nordeste",0,"241330",3,6,2,4,2,4,0,0,0,0,0,6,2,4,2,4,3,8.95501706171217,8.65712903171375,0.369916716054682,31
"2987","RN","Serra de São Bento",5751,7746.66,24014,"Borborema Potiguar",2,"Nordeste",0,"241330",4,2,0,2,2,0,0,0,0,0,0,2,0,2,2,0,2,8.95501706171217,8.65712903171375,0.370511899691451,30
"2988","RN","Serra de São Bento",5751,7746.66,24014,"Borborema Potiguar",2,"Nordeste",0,"241330",5,1,0,1,0,1,0,0,0,0,0,1,0,1,0,1,3,8.95501706171217,8.65712903171375,0.382254329342352,31
"2989","RN","Serra do Mel",12083,27909.59,24001,"Mossoró",2,"Nordeste",0,"241335",2,18,4,14,12,6,1,0,1,0,1,19,4,15,12,7,5,10.2367256363472,9.39955478502731,0.263872622481505,29
"2990","RN","Serra do Mel",12083,27909.59,24001,"Mossoró",2,"Nordeste",0,"241335",3,14,5,9,8,6,0,0,0,0,0,14,5,9,8,6,4,10.2367256363472,9.39955478502731,0.33178454732949,31
"2991","RN","Serra do Mel",12083,27909.59,24001,"Mossoró",2,"Nordeste",0,"241335",4,14,4,10,7,7,0,0,0,0,0,14,4,10,7,7,7,10.2367256363472,9.39955478502731,0.351876720674684,30
"2992","RN","Serra do Mel",12083,27909.59,24001,"Mossoró",2,"Nordeste",0,"241335",5,19,9,10,8,11,0,0,0,0,0,19,9,10,8,11,6,10.2367256363472,9.39955478502731,0.356873498920752,31
"2993","RN","Serra Negra do Norte",8092,9569.74,24011,"Seridó Ocidental",2,"Nordeste",0,"241340",2,3,1,2,1,2,0,0,0,0,0,3,1,2,1,2,9,9.16636131584387,8.99863119828764,0.281132091517503,29
"2994","RN","Serra Negra do Norte",8092,9569.74,24011,"Seridó Ocidental",2,"Nordeste",0,"241340",3,4,1,3,4,0,0,0,0,0,0,4,1,3,4,0,4,9.16636131584387,8.99863119828764,0.378819010513099,31
"2995","RN","Serra Negra do Norte",8092,9569.74,24011,"Seridó Ocidental",2,"Nordeste",0,"241340",4,7,4,3,5,2,0,0,0,0,0,7,4,3,5,2,5,9.16636131584387,8.99863119828764,0.372126680804691,30
"2996","RN","Serra Negra do Norte",8092,9569.74,24011,"Seridó Ocidental",2,"Nordeste",0,"241340",5,4,1,3,1,3,0,0,0,0,0,4,1,3,1,3,6,9.16636131584387,8.99863119828764,0.450576366464318,31
"2997","RN","Serrinha",6178,9122.12,24015,"Agreste Potiguar",2,"Nordeste",0,"241350",2,11,4,7,2,9,0,0,0,0,0,11,4,7,2,9,5,9.11845751219499,8.72874987347853,0.295042639314703,29
"2998","RN","Serrinha",6178,9122.12,24015,"Agreste Potiguar",2,"Nordeste",0,"241350",3,3,0,3,2,1,0,0,0,0,0,3,0,3,2,1,3,9.11845751219499,8.72874987347853,0.363821497114064,31
"2999","RN","Serrinha",6178,9122.12,24015,"Agreste Potiguar",2,"Nordeste",0,"241350",4,8,1,7,3,5,0,0,0,0,0,8,1,7,3,5,2,9.11845751219499,8.72874987347853,0.4159028655426,30
"3000","RN","Serrinha",6178,9122.12,24015,"Agreste Potiguar",2,"Nordeste",0,"241350",5,9,6,3,6,3,0,0,0,0,0,9,6,3,6,3,4,9.11845751219499,8.72874987347853,0.415671943080003,31
"3001","RN","Serrinha dos Pintos",4816,8388.85,24007,"Umarizal",2,"Nordeste",0,"241355",2,2,0,2,0,2,1,0,1,1,0,3,0,3,1,2,0,9.03465872212856,8.47969898698866,0.267620909575564,29
"3002","RN","Serrinha dos Pintos",4816,8388.85,24007,"Umarizal",2,"Nordeste",0,"241355",3,4,1,3,2,2,0,0,0,0,0,4,1,3,2,2,2,9.03465872212856,8.47969898698866,0.362972978380252,31
"3003","RN","Serrinha dos Pintos",4816,8388.85,24007,"Umarizal",2,"Nordeste",0,"241355",4,3,0,3,1,2,0,0,0,0,0,3,0,3,1,2,3,9.03465872212856,8.47969898698866,0.367579623488275,30
"3004","RN","Serrinha dos Pintos",4816,8388.85,24007,"Umarizal",2,"Nordeste",0,"241355",5,4,2,2,0,4,0,0,0,0,0,4,2,2,0,4,2,9.03465872212856,8.47969898698866,0.350272521401801,31
"3005","RN","Severiano Melo",2088,14671.68,24006,"Pau dos Ferros",2,"Nordeste",0,"241360",2,7,2,5,2,5,0,0,0,0,0,7,2,5,2,5,3,9.59367438400758,7.64396194900253,0.271595517032969,29
"3006","RN","Severiano Melo",2088,14671.68,24006,"Pau dos Ferros",2,"Nordeste",0,"241360",3,7,0,7,3,4,0,0,0,0,0,7,0,7,3,4,2,9.59367438400758,7.64396194900253,0.377249195064538,31
"3007","RN","Severiano Melo",2088,14671.68,24006,"Pau dos Ferros",2,"Nordeste",0,"241360",4,10,3,7,5,5,0,0,0,0,0,10,3,7,5,5,8,9.59367438400758,7.64396194900253,0.400719416279036,30
"3008","RN","Severiano Melo",2088,14671.68,24006,"Pau dos Ferros",2,"Nordeste",0,"241360",5,4,2,2,2,2,0,0,0,0,0,4,2,2,2,2,4,9.59367438400758,7.64396194900253,0.403825055836422,31
"3009","RN","Sítio Novo",5561,7528.4,24014,"Borborema Potiguar",2,"Nordeste",0,"241370",2,7,4,3,4,3,0,0,0,0,0,7,4,3,4,3,2,8.92643781481641,8.62353322718756,0.265885090458817,29
"3010","RN","Sítio Novo",5561,7528.4,24014,"Borborema Potiguar",2,"Nordeste",0,"241370",3,4,0,4,1,3,0,0,0,0,0,4,0,4,1,3,6,8.92643781481641,8.62353322718756,0.347972874075686,31
"3011","RN","Sítio Novo",5561,7528.4,24014,"Borborema Potiguar",2,"Nordeste",0,"241370",4,2,1,1,0,2,0,0,0,0,0,2,1,1,0,2,6,8.92643781481641,8.62353322718756,0.384058308003876,30
"3012","RN","Sítio Novo",5561,7528.4,24014,"Borborema Potiguar",2,"Nordeste",0,"241370",5,3,2,1,0,3,0,0,0,0,0,3,2,1,0,3,2,8.92643781481641,8.62353322718756,0.392624035307658,31
"3013","RN","Taipu",12297,9152.34,24016,"Litoral Nordeste",2,"Nordeste",0,"241390",2,5,3,2,2,3,0,0,0,0,0,5,3,2,2,3,2,9.12176486327917,9.41711060917245,0.310839723600363,29
"3014","RN","Taipu",12297,9152.34,24016,"Litoral Nordeste",2,"Nordeste",0,"241390",3,14,6,8,7,7,0,0,0,0,0,14,6,8,7,7,5,9.12176486327917,9.41711060917245,0.382546217001982,31
"3015","RN","Taipu",12297,9152.34,24016,"Litoral Nordeste",2,"Nordeste",0,"241390",4,10,5,5,6,4,0,0,0,0,0,10,5,5,6,4,5,9.12176486327917,9.41711060917245,0.425699745710816,30
"3016","RN","Taipu",12297,9152.34,24016,"Litoral Nordeste",2,"Nordeste",0,"241390",5,9,9,0,3,6,0,0,0,0,0,9,9,0,3,6,3,9.12176486327917,9.41711060917245,0.410981153479661,31
"3017","RN","Tangará",15869,8878.7,24014,"Borborema Potiguar",2,"Nordeste",0,"241400",2,12,5,7,6,6,0,0,0,0,0,12,5,7,6,6,7,9.09141042887282,9.67212279956284,0.273027821229281,29
"3018","RN","Tangará",15869,8878.7,24014,"Borborema Potiguar",2,"Nordeste",0,"241400",3,10,3,7,3,7,0,0,0,0,0,10,3,7,3,7,8,9.09141042887282,9.67212279956284,0.347472453080173,31
"3019","RN","Tangará",15869,8878.7,24014,"Borborema Potiguar",2,"Nordeste",0,"241400",4,12,0,12,2,10,0,0,0,0,0,12,0,12,2,10,10,9.09141042887282,9.67212279956284,0.375932510357524,30
"3020","RN","Tangará",15869,8878.7,24014,"Borborema Potiguar",2,"Nordeste",0,"241400",5,11,2,9,4,7,0,0,0,0,0,11,2,9,4,7,13,9.09141042887282,9.67212279956284,0.364426515015166,31
"3021","RN","Tenente Ananias",10855,8012.41,24006,"Pau dos Ferros",2,"Nordeste",0,"241410",2,11,4,7,6,5,0,0,0,0,0,11,4,7,6,5,10,8.98874686871654,9.29238108231239,0.285925083834807,29
"3022","RN","Tenente Ananias",10855,8012.41,24006,"Pau dos Ferros",2,"Nordeste",0,"241410",3,13,6,7,9,4,0,0,0,0,0,13,6,7,9,4,10,8.98874686871654,9.29238108231239,0.360181899012791,31
"3023","RN","Tenente Ananias",10855,8012.41,24006,"Pau dos Ferros",2,"Nordeste",0,"241410",4,11,4,7,5,6,0,0,0,0,0,11,4,7,5,6,7,8.98874686871654,9.29238108231239,0.407712829645642,30
"3024","RN","Tenente Ananias",10855,8012.41,24006,"Pau dos Ferros",2,"Nordeste",0,"241410",5,17,7,10,8,9,0,0,0,0,0,17,7,10,8,9,4,8.98874686871654,9.29238108231239,0.413857636178128,31
"3025","RN","Tenente Laurentino Cruz",6019,19058.71,24010,"Serra de Santana",2,"Nordeste",0,"241415",2,6,0,6,3,3,0,0,0,0,0,6,0,6,3,3,2,9.85527949391039,8.70267641154777,0.230547430838927,29
"3026","RN","Tenente Laurentino Cruz",6019,19058.71,24010,"Serra de Santana",2,"Nordeste",0,"241415",3,10,6,4,4,6,0,0,0,0,0,10,6,4,4,6,4,9.85527949391039,8.70267641154777,0.340222265110791,31
"3027","RN","Tenente Laurentino Cruz",6019,19058.71,24010,"Serra de Santana",2,"Nordeste",0,"241415",4,6,1,5,6,0,0,0,0,0,0,6,1,5,6,0,5,9.85527949391039,8.70267641154777,0.324468088620355,30
"3028","RN","Tenente Laurentino Cruz",6019,19058.71,24010,"Serra de Santana",2,"Nordeste",0,"241415",5,5,1,4,2,3,0,0,0,0,0,5,1,4,2,3,4,9.85527949391039,8.70267641154777,0.341440947445526,31
"3029","RN","Tibau do Sul",14440,24185.08,24019,"Litoral Sul",2,"Nordeste",0,"241420",2,15,9,6,5,10,0,0,0,0,0,15,9,6,5,10,9,10.093491193087,9.57775741244682,0.2562267221694,29
"3030","RN","Tibau do Sul",14440,24185.08,24019,"Litoral Sul",2,"Nordeste",0,"241420",3,16,8,8,10,6,0,0,0,0,0,16,8,8,10,6,7,10.093491193087,9.57775741244682,0.372748364756988,31
"3031","RN","Tibau do Sul",14440,24185.08,24019,"Litoral Sul",2,"Nordeste",0,"241420",4,16,9,7,4,12,0,0,0,0,0,16,9,7,4,12,5,10.093491193087,9.57775741244682,0.450407951334364,30
"3032","RN","Tibau do Sul",14440,24185.08,24019,"Litoral Sul",2,"Nordeste",0,"241420",5,10,5,5,4,6,0,0,0,0,0,10,5,5,4,6,8,10.093491193087,9.57775741244682,0.447258046962352,31
"3033","RN","Touros",33503,19625.73,24016,"Litoral Nordeste",2,"Nordeste",0,"241440",2,29,12,17,9,20,1,0,1,0,1,30,12,18,9,21,13,9.88459673941103,10.4193902660424,0.292484797488001,29
"3034","RN","Touros",33503,19625.73,24016,"Litoral Nordeste",2,"Nordeste",0,"241440",3,28,16,12,14,14,0,0,0,0,0,28,16,12,14,14,14,9.88459673941103,10.4193902660424,0.388638490124671,31
"3035","RN","Touros",33503,19625.73,24016,"Litoral Nordeste",2,"Nordeste",0,"241440",4,36,14,22,17,19,0,0,0,0,0,36,14,22,17,19,14,9.88459673941103,10.4193902660424,0.416792426559665,30
"3036","RN","Touros",33503,19625.73,24016,"Litoral Nordeste",2,"Nordeste",0,"241440",5,39,14,25,22,17,0,0,0,0,0,39,14,25,22,17,35,9.88459673941103,10.4193902660424,0.419325916528224,31
"3037","RN","Umarizal",10520,12114.22,24007,"Umarizal",2,"Nordeste",0,"241450",2,6,3,3,3,3,0,0,0,0,0,6,3,3,3,3,8,9.40213524818167,9.2610334862917,0.251715210825239,29
"3038","RN","Umarizal",10520,12114.22,24007,"Umarizal",2,"Nordeste",0,"241450",3,5,1,4,2,3,0,0,0,0,0,5,1,4,2,3,6,9.40213524818167,9.2610334862917,0.332577200386388,31
"3039","RN","Umarizal",10520,12114.22,24007,"Umarizal",2,"Nordeste",0,"241450",4,10,3,7,1,9,1,0,1,1,0,11,3,8,2,9,9,9.40213524818167,9.2610334862917,0.3520813506429,30
"3040","RN","Umarizal",10520,12114.22,24007,"Umarizal",2,"Nordeste",0,"241450",5,8,3,5,2,6,1,0,1,0,1,9,3,6,2,7,4,9.40213524818167,9.2610334862917,0.371508707295092,31
"3041","RN","Upanema",14800,12381.99,24003,"Médio Oeste",2,"Nordeste",0,"241460",2,14,8,6,4,10,1,1,0,0,1,15,9,6,4,11,9,9.42399827645488,9.60238245975221,0.287749961625981,29
"3042","RN","Upanema",14800,12381.99,24003,"Médio Oeste",2,"Nordeste",0,"241460",3,11,3,8,4,7,0,0,0,0,0,11,3,8,4,7,5,9.42399827645488,9.60238245975221,0.367862004991502,31
"3043","RN","Upanema",14800,12381.99,24003,"Médio Oeste",2,"Nordeste",0,"241460",4,10,4,6,4,6,0,0,0,0,0,10,4,6,4,6,11,9.42399827645488,9.60238245975221,0.373653974487787,30
"3044","RN","Upanema",14800,12381.99,24003,"Médio Oeste",2,"Nordeste",0,"241460",5,10,5,5,5,5,0,0,0,0,0,10,5,5,5,5,7,9.42399827645488,9.60238245975221,0.411502619992721,31
"3045","RN","Várzea",5515,8142.21,24015,"Agreste Potiguar",2,"Nordeste",0,"241470",2,2,1,1,2,0,0,0,0,0,0,2,1,1,2,0,2,9.00481692091896,8.6152269316876,0.244555707548035,29
"3046","RN","Várzea",5515,8142.21,24015,"Agreste Potiguar",2,"Nordeste",0,"241470",3,4,1,3,1,3,0,0,0,0,0,4,1,3,1,3,4,9.00481692091896,8.6152269316876,0.34428115715719,31
"3047","RN","Várzea",5515,8142.21,24015,"Agreste Potiguar",2,"Nordeste",0,"241470",4,4,1,3,1,3,0,0,0,0,0,4,1,3,1,3,4,9.00481692091896,8.6152269316876,0.370774397872347,30
"3048","RN","Várzea",5515,8142.21,24015,"Agreste Potiguar",2,"Nordeste",0,"241470",5,4,2,2,2,2,0,0,0,0,0,4,2,2,2,2,0,9.00481692091896,8.6152269316876,0.39948018677646,31
"3049","RN","Vera Cruz",12637,8784.43,24015,"Agreste Potiguar",2,"Nordeste",0,"241480",2,19,6,13,11,8,1,1,0,1,0,20,7,13,12,8,5,9.08073611519234,9.44438429775868,0.297210883631424,29
"3050","RN","Vera Cruz",12637,8784.43,24015,"Agreste Potiguar",2,"Nordeste",0,"241480",3,22,8,14,7,15,0,0,0,0,0,22,8,14,7,15,13,9.08073611519234,9.44438429775868,0.377496523073744,31
"3051","RN","Vera Cruz",12637,8784.43,24015,"Agreste Potiguar",2,"Nordeste",0,"241480",4,12,3,9,3,9,0,0,0,0,0,12,3,9,3,9,7,9.08073611519234,9.44438429775868,0.385673430882018,30
"3052","RN","Vera Cruz",12637,8784.43,24015,"Agreste Potiguar",2,"Nordeste",0,"241480",5,18,7,11,10,8,0,0,0,0,0,18,7,11,10,8,13,9.08073611519234,9.44438429775868,0.382716465638648,31
"3053","RN","Vila Flor",3194,12215.6,24019,"Litoral Sul",2,"Nordeste",0,"241500",2,2,1,1,0,2,0,0,0,0,0,2,1,1,0,2,0,9.41046910242,8.06902932877496,0.26457609770547,29
"3054","RN","Vila Flor",3194,12215.6,24019,"Litoral Sul",2,"Nordeste",0,"241500",3,5,1,4,2,3,0,0,0,0,0,5,1,4,2,3,0,9.41046910242,8.06902932877496,0.385618049030432,31
"3055","RN","Vila Flor",3194,12215.6,24019,"Litoral Sul",2,"Nordeste",0,"241500",4,4,2,2,3,1,0,0,0,0,0,4,2,2,3,1,0,9.41046910242,8.06902932877496,0.393835610374422,30
"3056","RN","Vila Flor",3194,12215.6,24019,"Litoral Sul",2,"Nordeste",0,"241500",5,6,1,5,2,4,0,0,0,0,0,6,1,5,2,4,2,9.41046910242,8.06902932877496,0.394591667467588,31
"3057","PB","Água Branca",10306,7902.92,25007,"Serra do Teixeira",2,"Nordeste",0,"250010",2,10,6,4,2,8,0,0,0,0,0,10,6,4,2,8,5,8.97498759041554,9.24048152888817,0.276750720828537,29
"3058","PB","Água Branca",10306,7902.92,25007,"Serra do Teixeira",2,"Nordeste",0,"250010",3,8,2,6,2,6,0,0,0,0,0,8,2,6,2,6,5,8.97498759041554,9.24048152888817,0.36298942086446,31
"3059","PB","Água Branca",10306,7902.92,25007,"Serra do Teixeira",2,"Nordeste",0,"250010",4,8,3,5,5,3,0,0,0,0,0,8,3,5,5,3,3,8.97498759041554,9.24048152888817,0.36797897760347,30
"3060","PB","Água Branca",10306,7902.92,25007,"Serra do Teixeira",2,"Nordeste",0,"250010",5,11,4,7,3,8,0,0,0,0,0,11,4,7,3,8,8,8.97498759041554,9.24048152888817,0.389985025797622,31
"3061","PB","Alagoa Grande",28439,9042.25,25015,"Brejo Paraibano",2,"Nordeste",0,"250030",2,30,16,14,14,16,0,0,0,0,0,30,16,14,14,16,12,9.10966331622261,10.255516721555,0.273829224031105,29
"3062","PB","Alagoa Grande",28439,9042.25,25015,"Brejo Paraibano",2,"Nordeste",0,"250030",3,19,7,12,10,9,0,0,0,0,0,19,7,12,10,9,27,9.10966331622261,10.255516721555,0.361511308408853,31
"3063","PB","Alagoa Grande",28439,9042.25,25015,"Brejo Paraibano",2,"Nordeste",0,"250030",4,27,12,15,13,14,1,0,1,0,1,28,12,16,13,15,16,9.10966331622261,10.255516721555,0.396081400202883,30
"3064","PB","Alagoa Grande",28439,9042.25,25015,"Brejo Paraibano",2,"Nordeste",0,"250030",5,35,19,16,11,24,0,0,0,0,0,35,19,16,11,24,12,9.10966331622261,10.255516721555,0.392079554787884,31
"3065","PB","Alagoa Nova",20921,14002.94,25015,"Brejo Paraibano",2,"Nordeste",0,"250040",2,19,11,8,7,12,0,0,0,0,0,19,11,8,7,12,12,9.54702258655048,9.94850871818365,0.284567362852263,29
"3066","PB","Alagoa Nova",20921,14002.94,25015,"Brejo Paraibano",2,"Nordeste",0,"250040",3,32,15,17,20,12,0,0,0,0,0,32,15,17,20,12,11,9.54702258655048,9.94850871818365,0.382473942875006,31
"3067","PB","Alagoa Nova",20921,14002.94,25015,"Brejo Paraibano",2,"Nordeste",0,"250040",4,21,6,15,10,11,0,0,0,0,0,21,6,15,10,11,9,9.54702258655048,9.94850871818365,0.411126763038224,30
"3068","PB","Alagoa Nova",20921,14002.94,25015,"Brejo Paraibano",2,"Nordeste",0,"250040",5,28,9,19,15,13,3,3,0,2,1,31,12,19,17,14,14,9.54702258655048,9.94850871818365,0.427232841864228,31
"3069","PB","Alagoinha",14560,7676.78,25016,"Guarabira",2,"Nordeste",0,"250050",2,3,3,0,2,1,0,0,0,0,0,3,3,0,2,1,8,8.94595546738979,9.58603332175068,0.305441649318967,29
"3070","PB","Alagoinha",14560,7676.78,25016,"Guarabira",2,"Nordeste",0,"250050",3,10,4,6,5,5,0,0,0,0,0,10,4,6,5,5,4,8.94595546738979,9.58603332175068,0.384377220636805,31
"3071","PB","Alagoinha",14560,7676.78,25016,"Guarabira",2,"Nordeste",0,"250050",4,18,8,10,11,7,0,0,0,0,0,18,8,10,11,7,9,8.94595546738979,9.58603332175068,0.424078495274268,30
"3072","PB","Alagoinha",14560,7676.78,25016,"Guarabira",2,"Nordeste",0,"250050",5,15,9,6,8,7,0,0,0,0,0,15,9,6,8,7,4,8.94595546738979,9.58603332175068,0.448395065638822,31
"3073","PB","Alcantil",5509,7746.28,25011,"Cariri Oriental",2,"Nordeste",0,"250053",2,7,2,5,3,4,0,0,0,0,0,7,2,5,3,4,2,8.95496800711052,8.61413839747272,0.336469626808432,29
"3074","PB","Alcantil",5509,7746.28,25011,"Cariri Oriental",2,"Nordeste",0,"250053",3,4,2,2,2,2,0,0,0,0,0,4,2,2,2,2,5,8.95496800711052,8.61413839747272,0.425052796774457,31
"3075","PB","Alcantil",5509,7746.28,25011,"Cariri Oriental",2,"Nordeste",0,"250053",4,8,4,4,4,4,0,0,0,0,0,8,4,4,4,4,4,8.95496800711052,8.61413839747272,0.435653735728372,30
"3076","PB","Alcantil",5509,7746.28,25011,"Cariri Oriental",2,"Nordeste",0,"250053",5,7,4,3,5,2,0,0,0,0,0,7,4,3,5,2,1,8.95496800711052,8.61413839747272,0.435878590736058,31
"3077","PB","Alhandra",19727,63198.2,25023,"Litoral Sul",2,"Nordeste",1,"250060",2,36,13,23,21,15,0,0,0,0,0,36,13,23,21,15,8,11.0540310987167,9.88974353474387,0.301737563418624,29
"3078","PB","Alhandra",19727,63198.2,25023,"Litoral Sul",2,"Nordeste",1,"250060",3,25,11,14,10,15,0,0,0,0,0,25,11,14,10,15,6,11.0540310987167,9.88974353474387,0.383439920612478,31
"3079","PB","Alhandra",19727,63198.2,25023,"Litoral Sul",2,"Nordeste",1,"250060",4,31,13,18,13,18,0,0,0,0,0,31,13,18,13,18,9,11.0540310987167,9.88974353474387,0.413176310309398,30
"3080","PB","Alhandra",19727,63198.2,25023,"Litoral Sul",2,"Nordeste",1,"250060",5,26,11,15,11,15,1,1,0,1,0,27,12,15,12,15,15,11.0540310987167,9.88974353474387,0.431750725370006,31
"3081","PB","São João do Rio do Peixe",18026,10424.95,25002,"Cajazeiras",2,"Nordeste",0,"250070",2,14,8,6,5,9,0,0,0,0,0,14,8,6,5,9,10,9.25195725049243,9.79957043911635,0.301653046557165,29
"3082","PB","São João do Rio do Peixe",18026,10424.95,25002,"Cajazeiras",2,"Nordeste",0,"250070",3,10,4,6,2,8,1,1,0,0,1,11,5,6,2,9,10,9.25195725049243,9.79957043911635,0.403532658335943,31
"3083","PB","São João do Rio do Peixe",18026,10424.95,25002,"Cajazeiras",2,"Nordeste",0,"250070",4,8,3,5,1,7,0,0,0,0,0,8,3,5,1,7,13,9.25195725049243,9.79957043911635,0.426288325794177,30
"3084","PB","São João do Rio do Peixe",18026,10424.95,25002,"Cajazeiras",2,"Nordeste",0,"250070",5,19,9,10,12,7,0,0,0,0,0,19,9,10,12,7,9,9.25195725049243,9.79957043911635,0.415611565875747,31
"3085","PB","Aparecida",8416,9412.9,25003,"Sousa",2,"Nordeste",0,"250077",2,5,3,2,2,3,0,0,0,0,0,5,3,2,2,3,6,9.14983636788514,9.03788993497749,0.262505037304708,29
"3086","PB","Aparecida",8416,9412.9,25003,"Sousa",2,"Nordeste",0,"250077",3,3,0,3,0,3,0,0,0,0,0,3,0,3,0,3,2,9.14983636788514,9.03788993497749,0.373300576946727,31
"3087","PB","Aparecida",8416,9412.9,25003,"Sousa",2,"Nordeste",0,"250077",4,5,2,3,1,4,0,0,0,0,0,5,2,3,1,4,2,9.14983636788514,9.03788993497749,0.37572665578205,30
"3088","PB","Aparecida",8416,9412.9,25003,"Sousa",2,"Nordeste",0,"250077",5,5,1,4,2,3,0,0,0,0,0,5,1,4,2,3,2,9.14983636788514,9.03788993497749,0.384615176637571,31
"3089","PB","Araçagi",16921,9138.13,25016,"Guarabira",2,"Nordeste",0,"250080",2,9,4,5,6,3,0,0,0,0,0,9,4,5,6,3,12,9.12021104832975,9.73631073306863,0.299139925131736,29
"3090","PB","Araçagi",16921,9138.13,25016,"Guarabira",2,"Nordeste",0,"250080",3,15,6,9,4,11,0,0,0,0,0,15,6,9,4,11,5,9.12021104832975,9.73631073306863,0.393216510430994,31
"3091","PB","Araçagi",16921,9138.13,25016,"Guarabira",2,"Nordeste",0,"250080",4,19,9,10,4,15,0,0,0,0,0,19,9,10,4,15,9,9.12021104832975,9.73631073306863,0.409822337511006,30
"3092","PB","Araçagi",16921,9138.13,25016,"Guarabira",2,"Nordeste",0,"250080",5,19,5,14,4,15,0,0,0,0,0,19,5,14,4,15,15,9.12021104832975,9.73631073306863,0.438381239412995,31
"3093","PB","Arara",13542,7566.77,25012,"Curimataú Ocidental",2,"Nordeste",0,"250090",2,10,4,6,5,5,0,0,0,0,0,10,4,6,5,5,9,8.9315215710958,9.51355124604559,0.306800199931399,29
"3094","PB","Arara",13542,7566.77,25012,"Curimataú Ocidental",2,"Nordeste",0,"250090",3,13,7,6,11,2,0,0,0,0,0,13,7,6,11,2,8,8.9315215710958,9.51355124604559,0.39238831693694,31
"3095","PB","Arara",13542,7566.77,25012,"Curimataú Ocidental",2,"Nordeste",0,"250090",4,11,6,5,6,5,0,0,0,0,0,11,6,5,6,5,9,8.9315215710958,9.51355124604559,0.405783690749465,30
"3096","PB","Arara",13542,7566.77,25012,"Curimataú Ocidental",2,"Nordeste",0,"250090",5,14,5,9,5,9,0,0,0,0,0,14,5,9,5,9,15,8.9315215710958,9.51355124604559,0.395330471183199,31
"3097","PB","Araruna",20463,8221.53,25013,"Curimataú Oriental",2,"Nordeste",0,"250100",2,9,6,3,2,7,0,0,0,0,0,9,6,3,2,7,11,9.01451160211679,9.92637365632283,0.283253159008394,29
"3098","PB","Araruna",20463,8221.53,25013,"Curimataú Oriental",2,"Nordeste",0,"250100",3,14,3,11,4,10,1,0,1,1,0,15,3,12,5,10,9,9.01451160211679,9.92637365632283,0.37222951556646,31
"3099","PB","Araruna",20463,8221.53,25013,"Curimataú Oriental",2,"Nordeste",0,"250100",4,13,7,6,6,7,0,0,0,0,0,13,7,6,6,7,5,9.01451160211679,9.92637365632283,0.395526738893097,30
"3100","PB","Araruna",20463,8221.53,25013,"Curimataú Oriental",2,"Nordeste",0,"250100",5,19,8,11,10,9,0,0,0,0,0,19,8,11,10,9,15,9.01451160211679,9.92637365632283,0.40853174407024,31
"3101","PB","Areia",22656,10249.84,25015,"Brejo Paraibano",2,"Nordeste",0,"250110",2,26,13,13,15,11,0,0,0,0,0,26,13,13,15,11,13,9.23501737468862,10.0281799964934,0.275501630839967,29
"3102","PB","Areia",22656,10249.84,25015,"Brejo Paraibano",2,"Nordeste",0,"250110",3,21,10,11,12,9,0,0,0,0,0,21,10,11,12,9,14,9.23501737468862,10.0281799964934,0.378767776285952,31
"3103","PB","Areia",22656,10249.84,25015,"Brejo Paraibano",2,"Nordeste",0,"250110",4,21,10,11,9,12,0,0,0,0,0,21,10,11,9,12,16,9.23501737468862,10.0281799964934,0.436609766646824,30
"3104","PB","Areia",22656,10249.84,25015,"Brejo Paraibano",2,"Nordeste",0,"250110",5,17,7,10,10,7,0,0,0,0,0,17,7,10,10,7,20,9.23501737468862,10.0281799964934,0.469458067623209,31
"3105","PB","Areial",7027,7535.95,25014,"Esperança",2,"Nordeste",0,"250120",2,12,2,10,5,7,0,0,0,0,0,12,2,10,5,7,4,8.92744018141465,8.8575151511922,0.299448861606589,29
"3106","PB","Areial",7027,7535.95,25014,"Esperança",2,"Nordeste",0,"250120",3,11,4,7,5,6,0,0,0,0,0,11,4,7,5,6,2,8.92744018141465,8.8575151511922,0.381470828067404,31
"3107","PB","Areial",7027,7535.95,25014,"Esperança",2,"Nordeste",0,"250120",4,7,3,4,2,5,0,0,0,0,0,7,3,4,2,5,8,8.92744018141465,8.8575151511922,0.415512500950785,30
"3108","PB","Areial",7027,7535.95,25014,"Esperança",2,"Nordeste",0,"250120",5,6,1,5,3,3,0,0,0,0,0,6,1,5,3,3,3,8.92744018141465,8.8575151511922,0.434992287802502,31
"3109","PB","Aroeiras",19116,8020.47,25019,"Umbuzeiro",2,"Nordeste",0,"250130",2,17,9,8,7,10,0,0,0,0,0,17,9,8,7,10,7,8.98975230263471,9.85828095969805,0.292869299821796,29
"3110","PB","Aroeiras",19116,8020.47,25019,"Umbuzeiro",2,"Nordeste",0,"250130",3,14,7,7,5,9,0,0,0,0,0,14,7,7,5,9,15,8.98975230263471,9.85828095969805,0.376220759117329,31
"3111","PB","Aroeiras",19116,8020.47,25019,"Umbuzeiro",2,"Nordeste",0,"250130",4,15,9,6,8,7,1,1,0,1,0,16,10,6,9,7,11,8.98975230263471,9.85828095969805,0.416421852593993,30
"3112","PB","Aroeiras",19116,8020.47,25019,"Umbuzeiro",2,"Nordeste",0,"250130",5,16,9,7,8,8,1,1,0,0,1,17,10,7,8,9,9,8.98975230263471,9.85828095969805,0.422742331887466,31
"3113","PB","Assunção",4029,9697.59,25010,"Cariri Ocidental",2,"Nordeste",0,"250135",2,6,0,6,4,2,0,0,0,0,0,6,0,6,4,2,3,9.17963268001352,8.30127348519135,0.2793825699889,29
"3114","PB","Assunção",4029,9697.59,25010,"Cariri Ocidental",2,"Nordeste",0,"250135",3,6,4,2,5,1,0,0,0,0,0,6,4,2,5,1,2,9.17963268001352,8.30127348519135,0.376198717963606,31
"3115","PB","Assunção",4029,9697.59,25010,"Cariri Ocidental",2,"Nordeste",0,"250135",4,8,3,5,2,6,0,0,0,0,0,8,3,5,2,6,2,9.17963268001352,8.30127348519135,0.406063615010461,30
"3116","PB","Assunção",4029,9697.59,25010,"Cariri Ocidental",2,"Nordeste",0,"250135",5,3,2,1,1,2,0,0,0,0,0,3,2,1,1,2,2,9.17963268001352,8.30127348519135,0.413578685936224,31
"3117","PB","Baía da Traição",9096,9647.7,25020,"Litoral Norte",2,"Nordeste",0,"250140",2,7,2,5,5,2,1,1,0,0,1,8,3,5,5,3,2,9.17447482395616,9.11559003543037,0.328613822086215,29
"3118","PB","Baía da Traição",9096,9647.7,25020,"Litoral Norte",2,"Nordeste",0,"250140",3,9,3,6,8,1,0,0,0,0,0,9,3,6,8,1,1,9.17447482395616,9.11559003543037,0.412006971510198,31
"3119","PB","Baía da Traição",9096,9647.7,25020,"Litoral Norte",2,"Nordeste",0,"250140",4,13,9,4,9,4,0,0,0,0,0,13,9,4,9,4,4,9.17447482395616,9.11559003543037,0.481251005469728,30
"3120","PB","Baía da Traição",9096,9647.7,25020,"Litoral Norte",2,"Nordeste",0,"250140",5,11,7,4,8,3,0,0,0,0,0,11,7,4,8,3,6,9.17447482395616,9.11559003543037,0.485850760050881,31
"3121","PB","Bananeiras",21269,11279.55,25015,"Brejo Paraibano",2,"Nordeste",1,"250150",2,8,2,6,1,7,0,0,0,0,0,8,2,6,1,7,9,9.33074663063926,9.96500589251455,0.293721202111146,29
"3122","PB","Bananeiras",21269,11279.55,25015,"Brejo Paraibano",2,"Nordeste",1,"250150",3,24,8,16,8,16,0,0,0,0,0,24,8,16,8,16,14,9.33074663063926,9.96500589251455,0.389875153164757,31
"3123","PB","Bananeiras",21269,11279.55,25015,"Brejo Paraibano",2,"Nordeste",1,"250150",4,18,9,9,8,10,0,0,0,0,0,18,9,9,8,10,10,9.33074663063926,9.96500589251455,0.433118955092435,30
"3124","PB","Bananeiras",21269,11279.55,25015,"Brejo Paraibano",2,"Nordeste",1,"250150",5,22,12,10,9,13,1,1,0,0,1,23,13,10,9,14,15,9.33074663063926,9.96500589251455,0.453948554249574,31
"3125","PB","Baraúna",4964,8738.71,25009,"Seridó Oriental Paraibano",2,"Nordeste",0,"250153",2,5,1,4,2,3,0,0,0,0,0,5,1,4,2,3,1,9.07551786050203,8.5099671463245,0.270418041942543,29
"3126","PB","Baraúna",4964,8738.71,25009,"Seridó Oriental Paraibano",2,"Nordeste",0,"250153",3,2,1,1,2,0,0,0,0,0,0,2,1,1,2,0,1,9.07551786050203,8.5099671463245,0.358666015254714,31
"3127","PB","Baraúna",4964,8738.71,25009,"Seridó Oriental Paraibano",2,"Nordeste",0,"250153",4,3,1,2,3,0,0,0,0,0,0,3,1,2,3,0,2,9.07551786050203,8.5099671463245,0.380953374976544,30
"3128","PB","Baraúna",4964,8738.71,25009,"Seridó Oriental Paraibano",2,"Nordeste",0,"250153",5,6,0,6,4,2,0,0,0,0,0,6,0,6,4,2,3,9.07551786050203,8.5099671463245,0.386271738330063,31
"3129","PB","Barra de Santana",8349,8925.13,25011,"Cariri Oriental",2,"Nordeste",0,"250157",2,6,3,3,3,3,0,0,0,0,0,6,3,3,3,3,6,9.09662617236809,9.029897050194,0.31344834250498,29
"3130","PB","Barra de Santana",8349,8925.13,25011,"Cariri Oriental",2,"Nordeste",0,"250157",3,9,4,5,5,4,0,0,0,0,0,9,4,5,5,4,2,9.09662617236809,9.029897050194,0.355546362960082,31
"3131","PB","Barra de Santana",8349,8925.13,25011,"Cariri Oriental",2,"Nordeste",0,"250157",4,6,1,5,4,2,0,0,0,0,0,6,1,5,4,2,5,9.09662617236809,9.029897050194,0.391578047295483,30
"3132","PB","Barra de Santana",8349,8925.13,25011,"Cariri Oriental",2,"Nordeste",0,"250157",5,10,0,10,0,10,0,0,0,0,0,10,0,10,0,10,2,9.09662617236809,9.029897050194,0.447193846105047,31
"3133","PB","Barra de Santa Rosa",15497,8354.37,25012,"Curimataú Ocidental",2,"Nordeste",0,"250160",2,8,3,5,2,6,0,0,0,0,0,8,3,5,2,6,6,9.03054003423674,9.64840173578733,0.269569047897654,29
"3134","PB","Barra de Santa Rosa",15497,8354.37,25012,"Curimataú Ocidental",2,"Nordeste",0,"250160",3,12,5,7,6,6,0,0,0,0,0,12,5,7,6,6,8,9.03054003423674,9.64840173578733,0.36030020872699,31
"3135","PB","Barra de Santa Rosa",15497,8354.37,25012,"Curimataú Ocidental",2,"Nordeste",0,"250160",4,13,6,7,6,7,0,0,0,0,0,13,6,7,6,7,7,9.03054003423674,9.64840173578733,0.36349716418578,30
"3136","PB","Barra de Santa Rosa",15497,8354.37,25012,"Curimataú Ocidental",2,"Nordeste",0,"250160",5,10,3,7,4,6,0,0,0,0,0,10,3,7,4,6,12,9.03054003423674,9.64840173578733,0.361775343889,31
"3137","PB","Barra de São Miguel",6065,9953.94,25011,"Cariri Oriental",2,"Nordeste",0,"250170",2,7,2,5,5,2,0,0,0,0,0,7,2,5,5,2,4,9.20572373167279,8.71028982137815,0.299616203477794,29
"3138","PB","Barra de São Miguel",6065,9953.94,25011,"Cariri Oriental",2,"Nordeste",0,"250170",3,7,2,5,2,5,0,0,0,0,0,7,2,5,2,5,4,9.20572373167279,8.71028982137815,0.38049005339578,31
"3139","PB","Barra de São Miguel",6065,9953.94,25011,"Cariri Oriental",2,"Nordeste",0,"250170",4,6,3,3,4,2,0,0,0,0,0,6,3,3,4,2,1,9.20572373167279,8.71028982137815,0.388533511470255,30
"3140","PB","Barra de São Miguel",6065,9953.94,25011,"Cariri Oriental",2,"Nordeste",0,"250170",5,7,3,4,3,4,0,0,0,0,0,7,3,4,3,4,1,9.20572373167279,8.71028982137815,0.420959713501806,31
"3141","PB","Bayeux",97203,13922.53,25022,"João Pessoa",2,"Nordeste",1,"250180",2,61,14,47,25,36,1,0,1,0,1,62,14,48,25,37,42,9.54126367024692,11.4845568541698,0.297224663274713,29
"3142","PB","Bayeux",97203,13922.53,25022,"João Pessoa",2,"Nordeste",1,"250180",3,61,13,48,22,39,2,1,1,0,2,63,14,49,22,41,63,9.54126367024692,11.4845568541698,0.396016506987746,31
"3143","PB","Bayeux",97203,13922.53,25022,"João Pessoa",2,"Nordeste",1,"250180",4,46,11,35,15,31,0,0,0,0,0,46,11,35,15,31,66,9.54126367024692,11.4845568541698,0.454017256254375,30
"3144","PB","Bayeux",97203,13922.53,25022,"João Pessoa",2,"Nordeste",1,"250180",5,56,9,47,18,38,0,0,0,0,0,56,9,47,18,38,128,9.54126367024692,11.4845568541698,0.451515238932816,31
"3145","PB","Belém",17705,10331.85,25016,"Guarabira",2,"Nordeste",0,"250190",2,9,3,6,5,4,0,0,0,0,0,9,3,6,5,4,10,9.24298663610802,9.781602364546,0.303885685124691,29
"3146","PB","Belém",17705,10331.85,25016,"Guarabira",2,"Nordeste",0,"250190",3,14,8,6,6,8,0,0,0,0,0,14,8,6,6,8,9,9.24298663610802,9.781602364546,0.394104061096321,31
"3147","PB","Belém",17705,10331.85,25016,"Guarabira",2,"Nordeste",0,"250190",4,19,4,15,8,11,0,0,0,0,0,19,4,15,8,11,9,9.24298663610802,9.781602364546,0.412534535746233,30
"3148","PB","Belém",17705,10331.85,25016,"Guarabira",2,"Nordeste",0,"250190",5,21,7,14,10,11,1,1,0,0,1,22,8,14,10,12,7,9.24298663610802,9.781602364546,0.424966296702559,31
"3149","PB","Belém do Brejo do Cruz",7349,8876.56,25001,"Catolé do Rocha",2,"Nordeste",0,"250200",2,6,2,4,2,4,0,0,0,0,0,6,2,4,2,4,6,9.09116937354495,8.90231952852887,0.290622948665273,29
"3150","PB","Belém do Brejo do Cruz",7349,8876.56,25001,"Catolé do Rocha",2,"Nordeste",0,"250200",3,6,3,3,3,3,0,0,0,0,0,6,3,3,3,3,2,9.09116937354495,8.90231952852887,0.3789830477913,31
"3151","PB","Belém do Brejo do Cruz",7349,8876.56,25001,"Catolé do Rocha",2,"Nordeste",0,"250200",4,6,2,4,6,0,1,0,1,0,1,7,2,5,6,1,4,9.09116937354495,8.90231952852887,0.397801182690276,30
"3152","PB","Belém do Brejo do Cruz",7349,8876.56,25001,"Catolé do Rocha",2,"Nordeste",0,"250200",5,6,0,6,3,3,0,0,0,0,0,6,0,6,3,3,5,9.09116937354495,8.90231952852887,0.368326622400642,31
"3153","PB","Boa Ventura",5307,8037.85,25006,"Itaporanga",2,"Nordeste",0,"250210",2,2,0,2,1,1,0,0,0,0,0,2,0,2,1,1,0,8.99191691347647,8.57678198282789,0.291281104122549,29
"3154","PB","Boa Ventura",5307,8037.85,25006,"Itaporanga",2,"Nordeste",0,"250210",3,3,2,1,1,2,0,0,0,0,0,3,2,1,1,2,3,8.99191691347647,8.57678198282789,0.383356722072156,31
"3155","PB","Boa Ventura",5307,8037.85,25006,"Itaporanga",2,"Nordeste",0,"250210",4,3,2,1,2,1,0,0,0,0,0,3,2,1,2,1,6,8.99191691347647,8.57678198282789,0.347006029571138,30
"3156","PB","Boa Ventura",5307,8037.85,25006,"Itaporanga",2,"Nordeste",0,"250210",5,4,2,2,2,2,0,0,0,0,0,4,2,2,2,2,0,8.99191691347647,8.57678198282789,0.440385603794994,31
"3157","PB","Boa Vista",7136,22414.02,25017,"Campina Grande",2,"Nordeste",0,"250215",2,8,1,7,2,6,0,0,0,0,0,8,1,7,2,6,2,10.017441934911,8.87290767425985,0.266487183558211,29
"3158","PB","Boa Vista",7136,22414.02,25017,"Campina Grande",2,"Nordeste",0,"250215",3,5,0,5,2,3,0,0,0,0,0,5,0,5,2,3,7,10.017441934911,8.87290767425985,0.360131169493723,31
"3159","PB","Boa Vista",7136,22414.02,25017,"Campina Grande",2,"Nordeste",0,"250215",4,3,0,3,3,0,0,0,0,0,0,3,0,3,3,0,4,10.017441934911,8.87290767425985,0.374758525270918,30
"3160","PB","Boa Vista",7136,22414.02,25017,"Campina Grande",2,"Nordeste",0,"250215",5,3,0,3,2,1,0,0,0,0,0,3,0,3,2,1,3,10.017441934911,8.87290767425985,0.40651972534617,31
"3161","PB","Bonito de Santa Fé",12022,7779.78,25002,"Cajazeiras",2,"Nordeste",0,"250240",2,8,5,3,6,2,0,0,0,0,0,8,5,3,6,2,6,8.95928333913766,9.39449358359911,0.29556323371106,29
"3162","PB","Bonito de Santa Fé",12022,7779.78,25002,"Cajazeiras",2,"Nordeste",0,"250240",3,9,6,3,4,5,0,0,0,0,0,9,6,3,4,5,6,8.95928333913766,9.39449358359911,0.350928845192517,31
"3163","PB","Bonito de Santa Fé",12022,7779.78,25002,"Cajazeiras",2,"Nordeste",0,"250240",4,6,2,4,3,3,0,0,0,0,0,6,2,4,3,3,10,8.95928333913766,9.39449358359911,0.388252957081279,30
"3164","PB","Bonito de Santa Fé",12022,7779.78,25002,"Cajazeiras",2,"Nordeste",0,"250240",5,21,13,8,9,12,0,0,0,0,0,21,13,8,9,12,4,8.95928333913766,9.39449358359911,0.378667678734624,31
"3165","PB","Boqueirão",17870,11674.69,25011,"Cariri Oriental",2,"Nordeste",0,"250250",2,18,9,9,5,13,0,0,0,0,0,18,9,9,5,13,13,9.36517852972205,9.79087860815347,0.277680172071479,29
"3166","PB","Boqueirão",17870,11674.69,25011,"Cariri Oriental",2,"Nordeste",0,"250250",3,18,10,8,6,12,0,0,0,0,0,18,10,8,6,12,8,9.36517852972205,9.79087860815347,0.342090732657439,31
"3167","PB","Boqueirão",17870,11674.69,25011,"Cariri Oriental",2,"Nordeste",0,"250250",4,19,10,9,7,12,0,0,0,0,0,19,10,9,7,12,12,9.36517852972205,9.79087860815347,0.371176743760186,30
"3168","PB","Boqueirão",17870,11674.69,25011,"Cariri Oriental",2,"Nordeste",0,"250250",5,20,10,10,8,12,0,0,0,0,0,20,10,10,8,12,10,9.36517852972205,9.79087860815347,0.374720616483775,31
"3169","PB","Igaracy",6105,8707.43,25005,"Piancó",2,"Nordeste",0,"250260",2,9,3,6,3,6,0,0,0,0,0,9,3,6,3,6,3,9.07193196316104,8.71686338654481,0.272857553504927,29
"3170","PB","Igaracy",6105,8707.43,25005,"Piancó",2,"Nordeste",0,"250260",3,7,1,6,2,5,0,0,0,0,0,7,1,6,2,5,5,9.07193196316104,8.71686338654481,0.354768423936104,31
"3171","PB","Igaracy",6105,8707.43,25005,"Piancó",2,"Nordeste",0,"250260",4,6,1,5,2,4,0,0,0,0,0,6,1,5,2,4,1,9.07193196316104,8.71686338654481,0.365949470430962,30
"3172","PB","Igaracy",6105,8707.43,25005,"Piancó",2,"Nordeste",0,"250260",5,6,1,5,3,3,0,0,0,0,0,6,1,5,3,3,3,9.07193196316104,8.71686338654481,0.361017727465361,31
"3173","PB","Borborema",5287,11028.17,25015,"Brejo Paraibano",2,"Nordeste",0,"250270",2,1,1,0,1,0,0,0,0,0,0,1,1,0,1,0,1,9.30820818733137,8.57300625623545,0.284434440675928,29
"3174","PB","Borborema",5287,11028.17,25015,"Brejo Paraibano",2,"Nordeste",0,"250270",3,4,1,3,3,1,0,0,0,0,0,4,1,3,3,1,1,9.30820818733137,8.57300625623545,0.370913744479684,31
"3175","PB","Borborema",5287,11028.17,25015,"Brejo Paraibano",2,"Nordeste",0,"250270",4,6,2,4,1,5,0,0,0,0,0,6,2,4,1,5,1,9.30820818733137,8.57300625623545,0.392994875781499,30
"3176","PB","Borborema",5287,11028.17,25015,"Brejo Paraibano",2,"Nordeste",0,"250270",5,2,1,1,2,0,0,0,0,0,0,2,1,1,2,0,5,9.30820818733137,8.57300625623545,0.423698345991183,31
"3177","PB","Brejo do Cruz",14206,9007.6,25001,"Catolé do Rocha",2,"Nordeste",0,"250280",2,11,6,5,5,6,0,0,0,0,0,11,6,5,5,6,9,9.10582394442018,9.56141968955776,0.284752675717859,29
"3178","PB","Brejo do Cruz",14206,9007.6,25001,"Catolé do Rocha",2,"Nordeste",0,"250280",3,13,5,8,6,7,0,0,0,0,0,13,5,8,6,7,16,9.10582394442018,9.56141968955776,0.351208544956173,31
"3179","PB","Brejo do Cruz",14206,9007.6,25001,"Catolé do Rocha",2,"Nordeste",0,"250280",4,21,10,11,12,9,0,0,0,0,0,21,10,11,12,9,4,9.10582394442018,9.56141968955776,0.361055093734065,30
"3180","PB","Brejo do Cruz",14206,9007.6,25001,"Catolé do Rocha",2,"Nordeste",0,"250280",5,25,16,9,12,13,0,0,0,0,0,25,16,9,12,13,8,9.10582394442018,9.56141968955776,0.36318335889876,31
"3181","PB","Brejo dos Santos",6464,8409.99,25001,"Catolé do Rocha",2,"Nordeste",0,"250290",2,4,2,2,1,3,0,0,0,0,0,4,2,2,1,3,3,9.03717556390565,8.77400360020093,0.268648903593759,29
"3182","PB","Brejo dos Santos",6464,8409.99,25001,"Catolé do Rocha",2,"Nordeste",0,"250290",3,6,2,4,2,4,0,0,0,0,0,6,2,4,2,4,4,9.03717556390565,8.77400360020093,0.352223515203945,31
"3183","PB","Brejo dos Santos",6464,8409.99,25001,"Catolé do Rocha",2,"Nordeste",0,"250290",4,5,2,3,2,3,0,0,0,0,0,5,2,3,2,3,6,9.03717556390565,8.77400360020093,0.393138150967807,30
"3184","PB","Brejo dos Santos",6464,8409.99,25001,"Catolé do Rocha",2,"Nordeste",0,"250290",5,4,2,2,1,3,0,0,0,0,0,4,2,2,1,3,4,9.03717556390565,8.77400360020093,0.421326047507675,31
"3185","PB","Caaporã",21955,15225.27,25023,"Litoral Sul",2,"Nordeste",1,"250300",2,24,11,13,10,14,0,0,0,0,0,24,11,13,10,14,18,9.630711826411,9.99675018299582,0.295126372368733,29
"3186","PB","Caaporã",21955,15225.27,25023,"Litoral Sul",2,"Nordeste",1,"250300",3,17,8,9,7,10,0,0,0,0,0,17,8,9,7,10,14,9.630711826411,9.99675018299582,0.382066638463559,31
"3187","PB","Caaporã",21955,15225.27,25023,"Litoral Sul",2,"Nordeste",1,"250300",4,28,11,17,12,16,0,0,0,0,0,28,11,17,12,16,8,9.630711826411,9.99675018299582,0.414462841019806,30
"3188","PB","Caaporã",21955,15225.27,25023,"Litoral Sul",2,"Nordeste",1,"250300",5,34,12,22,12,22,0,0,0,0,0,34,12,22,12,22,25,9.630711826411,9.99675018299582,0.416317776610683,31
"3189","PB","Cabaceiras",5661,10350.1,25011,"Cariri Oriental",2,"Nordeste",0,"250310",2,7,1,6,2,5,0,0,0,0,0,7,1,6,2,5,8,9.24475146048259,8.64135583403666,0.273240859309775,29
"3190","PB","Cabaceiras",5661,10350.1,25011,"Cariri Oriental",2,"Nordeste",0,"250310",3,8,5,3,2,6,0,0,0,0,0,8,5,3,2,6,3,9.24475146048259,8.64135583403666,0.321865102149114,31
"3191","PB","Cabaceiras",5661,10350.1,25011,"Cariri Oriental",2,"Nordeste",0,"250310",4,4,0,4,1,3,0,0,0,0,0,4,0,4,1,3,4,9.24475146048259,8.64135583403666,0.357214336844093,30
"3192","PB","Cabaceiras",5661,10350.1,25011,"Cariri Oriental",2,"Nordeste",0,"250310",5,5,3,2,1,4,0,0,0,0,0,5,3,2,1,4,8,9.24475146048259,8.64135583403666,0.376797395209902,31
"3193","PB","Cabedelo",68767,41104.03,25022,"João Pessoa",2,"Nordeste",1,"250320",2,100,38,62,39,61,0,0,0,0,0,100,38,62,39,61,38,10.6238614492054,11.1384792576892,0.285686208558574,29
"3194","PB","Cabedelo",68767,41104.03,25022,"João Pessoa",2,"Nordeste",1,"250320",3,63,24,39,28,35,2,0,2,0,2,65,24,41,28,37,44,10.6238614492054,11.1384792576892,0.403274792826167,31
"3195","PB","Cabedelo",68767,41104.03,25022,"João Pessoa",2,"Nordeste",1,"250320",4,64,21,43,28,36,1,1,0,1,0,65,22,43,29,36,31,10.6238614492054,11.1384792576892,0.47910469969638,30
"3196","PB","Cabedelo",68767,41104.03,25022,"João Pessoa",2,"Nordeste",1,"250320",5,82,29,53,33,49,0,0,0,0,0,82,29,53,33,49,44,10.6238614492054,11.1384792576892,0.470753404800975,31
"3197","PB","Cachoeira dos Índios",10305,11129.97,25002,"Cajazeiras",2,"Nordeste",0,"250330",2,13,6,7,9,4,0,0,0,0,0,13,6,7,9,4,9,9.31739674884817,9.24038449332456,0.259246346616324,29
"3198","PB","Cachoeira dos Índios",10305,11129.97,25002,"Cajazeiras",2,"Nordeste",0,"250330",3,9,5,4,3,6,0,0,0,0,0,9,5,4,3,6,2,9.31739674884817,9.24038449332456,0.354745166457907,31
"3199","PB","Cachoeira dos Índios",10305,11129.97,25002,"Cajazeiras",2,"Nordeste",0,"250330",4,5,1,4,0,5,1,0,1,0,1,6,1,5,0,6,6,9.31739674884817,9.24038449332456,0.413885783490618,30
"3200","PB","Cachoeira dos Índios",10305,11129.97,25002,"Cajazeiras",2,"Nordeste",0,"250330",5,16,8,8,10,6,0,0,0,0,0,16,8,8,10,6,5,9.31739674884817,9.24038449332456,0.430783437655765,31
"3201","PB","Cacimba de Dentro",17178,7510.85,25013,"Curimataú Oriental",2,"Nordeste",0,"250350",2,7,3,4,1,6,0,0,0,0,0,7,3,4,1,6,11,8.92410392077697,9.75138477432617,0.288675561021674,29
"3202","PB","Cacimba de Dentro",17178,7510.85,25013,"Curimataú Oriental",2,"Nordeste",0,"250350",3,14,8,6,5,9,0,0,0,0,0,14,8,6,5,9,11,8.92410392077697,9.75138477432617,0.382674065830183,31
"3203","PB","Cacimba de Dentro",17178,7510.85,25013,"Curimataú Oriental",2,"Nordeste",0,"250350",4,22,11,11,13,9,0,0,0,0,0,22,11,11,13,9,8,8.92410392077697,9.75138477432617,0.391842711607971,30
"3204","PB","Cacimba de Dentro",17178,7510.85,25013,"Curimataú Oriental",2,"Nordeste",0,"250350",5,17,9,8,11,6,0,0,0,0,0,17,9,8,11,6,10,8.92410392077697,9.75138477432617,0.406014674194272,31
"3205","PB","Caiçara",7191,7920.21,25016,"Guarabira",2,"Nordeste",0,"250360",2,5,3,2,1,4,0,0,0,0,0,5,3,2,1,4,2,8.97717299960847,8.88058552310249,0.302235121068278,29
"3206","PB","Caiçara",7191,7920.21,25016,"Guarabira",2,"Nordeste",0,"250360",3,6,1,5,0,6,2,1,1,0,2,8,2,6,0,8,7,8.97717299960847,8.88058552310249,0.365963413768324,31
"3207","PB","Caiçara",7191,7920.21,25016,"Guarabira",2,"Nordeste",0,"250360",4,2,1,1,0,2,0,0,0,0,0,2,1,1,0,2,0,8.97717299960847,8.88058552310249,0.419604800819928,30
"3208","PB","Caiçara",7191,7920.21,25016,"Guarabira",2,"Nordeste",0,"250360",5,9,3,6,4,5,0,0,0,0,0,9,3,6,4,5,9,8.97717299960847,8.88058552310249,0.463207014982112,31
"3209","PB","Cajazeiras",62289,17373.93,25002,"Cajazeiras",2,"Nordeste",1,"250370",2,72,20,52,18,54,0,0,0,0,0,72,20,52,18,54,37,9.76272608580289,11.0395401241781,0.26992932441197,29
"3210","PB","Cajazeiras",62289,17373.93,25002,"Cajazeiras",2,"Nordeste",1,"250370",3,84,26,58,28,56,1,0,1,1,0,85,26,59,29,56,52,9.76272608580289,11.0395401241781,0.371347481102719,31
"3211","PB","Cajazeiras",62289,17373.93,25002,"Cajazeiras",2,"Nordeste",1,"250370",4,41,11,30,18,23,0,0,0,0,0,41,11,30,18,23,43,9.76272608580289,11.0395401241781,0.409953296447844,30
"3212","PB","Cajazeiras",62289,17373.93,25002,"Cajazeiras",2,"Nordeste",1,"250370",5,67,23,44,35,32,0,0,0,0,0,67,23,44,35,32,43,9.76272608580289,11.0395401241781,0.419538507729785,31
"3213","PB","Caldas Brandão",6046,11232.84,25018,"Itabaiana",2,"Nordeste",0,"250380",2,7,3,4,4,3,0,0,0,0,0,7,3,4,4,3,2,9.32659690979402,8.7071521753394,0.336248678668202,29
"3214","PB","Caldas Brandão",6046,11232.84,25018,"Itabaiana",2,"Nordeste",0,"250380",3,6,2,4,3,3,0,0,0,0,0,6,2,4,3,3,4,9.32659690979402,8.7071521753394,0.40245245351449,31
"3215","PB","Caldas Brandão",6046,11232.84,25018,"Itabaiana",2,"Nordeste",0,"250380",4,3,1,2,2,1,0,0,0,0,0,3,1,2,2,1,5,9.32659690979402,8.7071521753394,0.451412104102693,30
"3216","PB","Caldas Brandão",6046,11232.84,25018,"Itabaiana",2,"Nordeste",0,"250380",5,5,2,3,1,4,0,0,0,0,0,5,2,3,1,4,4,9.32659690979402,8.7071521753394,0.437855516298657,31
"3217","PB","Camalaú",6031,10558.2,25010,"Cariri Ocidental",2,"Nordeste",0,"250390",2,5,4,1,1,4,0,0,0,0,0,5,4,1,1,4,5,9.26465808818577,8.70466811345099,0.240940869464006,29
"3218","PB","Camalaú",6031,10558.2,25010,"Cariri Ocidental",2,"Nordeste",0,"250390",3,8,3,5,1,7,0,0,0,0,0,8,3,5,1,7,4,9.26465808818577,8.70466811345099,0.337544546844365,31
"3219","PB","Camalaú",6031,10558.2,25010,"Cariri Ocidental",2,"Nordeste",0,"250390",4,7,5,2,2,5,0,0,0,0,0,7,5,2,2,5,4,9.26465808818577,8.70466811345099,0.363383479912435,30
"3220","PB","Camalaú",6031,10558.2,25010,"Cariri Ocidental",2,"Nordeste",0,"250390",5,11,3,8,6,5,0,0,0,0,0,11,3,8,6,5,1,9.26465808818577,8.70466811345099,0.383496148153775,31
"3221","PB","Campina Grande",411807,22583.86,25017,"Campina Grande",2,"Nordeste",1,"250400",2,498,125,373,191,307,4,2,2,0,4,502,127,375,191,311,210,10.0249907708351,12.9283100719743,0.284947648011361,29
"3222","PB","Campina Grande",411807,22583.86,25017,"Campina Grande",2,"Nordeste",1,"250400",3,429,103,326,161,268,1,0,1,0,1,430,103,327,161,269,229,10.0249907708351,12.9283100719743,0.387805208680157,31
"3223","PB","Campina Grande",411807,22583.86,25017,"Campina Grande",2,"Nordeste",1,"250400",4,418,113,305,166,252,3,0,3,1,2,421,113,308,167,254,206,10.0249907708351,12.9283100719743,0.450127700388346,30
"3224","PB","Campina Grande",411807,22583.86,25017,"Campina Grande",2,"Nordeste",1,"250400",5,445,139,306,167,278,5,3,2,3,2,450,142,308,170,280,352,10.0249907708351,12.9283100719743,0.435682706889232,31
"3225","PB","Capim",6620,9391.17,25020,"Litoral Norte",2,"Nordeste",0,"250403",2,10,4,6,8,2,0,0,0,0,0,10,4,6,8,2,1,9.14752516507927,8.79785064893105,0.287789338981131,29
"3226","PB","Capim",6620,9391.17,25020,"Litoral Norte",2,"Nordeste",0,"250403",3,7,3,4,3,4,0,0,0,0,0,7,3,4,3,4,5,9.14752516507927,8.79785064893105,0.359021229104155,31
"3227","PB","Capim",6620,9391.17,25020,"Litoral Norte",2,"Nordeste",0,"250403",4,4,3,1,1,3,0,0,0,0,0,4,3,1,1,3,5,9.14752516507927,8.79785064893105,0.362983878585439,30
"3228","PB","Capim",6620,9391.17,25020,"Litoral Norte",2,"Nordeste",0,"250403",5,6,1,5,3,3,2,1,1,2,0,8,2,6,5,3,4,9.14752516507927,8.79785064893105,0.405317251085488,31
"3229","PB","Caraúbas",4185,8799.61,25011,"Cariri Oriental",2,"Nordeste",0,"250407",2,3,1,2,1,2,0,0,0,0,0,3,1,2,1,2,2,9.0824626813024,8.33926198292358,0.274103965441039,29
"3230","PB","Caraúbas",4185,8799.61,25011,"Cariri Oriental",2,"Nordeste",0,"250407",3,3,0,3,3,0,0,0,0,0,0,3,0,3,3,0,2,9.0824626813024,8.33926198292358,0.380392030576931,31
"3231","PB","Caraúbas",4185,8799.61,25011,"Cariri Oriental",2,"Nordeste",0,"250407",4,3,2,1,2,1,0,0,0,0,0,3,2,1,2,1,2,9.0824626813024,8.33926198292358,0.392475990329945,30
"3232","PB","Caraúbas",4185,8799.61,25011,"Cariri Oriental",2,"Nordeste",0,"250407",5,6,2,4,3,3,0,0,0,0,0,6,2,4,3,3,1,9.0824626813024,8.33926198292358,0.415131651278141,31
"3233","PB","Casserengue",7499,8189.34,25013,"Curimataú Oriental",2,"Nordeste",0,"250415",2,3,2,1,0,3,0,0,0,0,0,3,2,1,0,3,2,9.0105885875193,8.92252495730139,0.323466455172095,29
"3234","PB","Casserengue",7499,8189.34,25013,"Curimataú Oriental",2,"Nordeste",0,"250415",3,4,1,3,1,3,0,0,0,0,0,4,1,3,1,3,5,9.0105885875193,8.92252495730139,0.393455145402853,31
"3235","PB","Casserengue",7499,8189.34,25013,"Curimataú Oriental",2,"Nordeste",0,"250415",4,3,1,2,1,2,0,0,0,0,0,3,1,2,1,2,6,9.0105885875193,8.92252495730139,0.401952930449776,30
"3236","PB","Casserengue",7499,8189.34,25013,"Curimataú Oriental",2,"Nordeste",0,"250415",5,7,7,0,3,4,0,0,0,0,0,7,7,0,3,4,7,9.0105885875193,8.92252495730139,0.405363738334948,31
"3237","PB","Catolé do Rocha",30684,13134.84,25001,"Catolé do Rocha",2,"Nordeste",0,"250430",2,27,10,17,7,20,0,0,0,0,0,27,10,17,7,20,14,9.48302352085017,10.3314966250792,0.263033286638196,29
"3238","PB","Catolé do Rocha",30684,13134.84,25001,"Catolé do Rocha",2,"Nordeste",0,"250430",3,29,11,18,13,16,0,0,0,0,0,29,11,18,13,16,16,9.48302352085017,10.3314966250792,0.356042315440717,31
"3239","PB","Catolé do Rocha",30684,13134.84,25001,"Catolé do Rocha",2,"Nordeste",0,"250430",4,25,7,18,7,18,0,0,0,0,0,25,7,18,7,18,13,9.48302352085017,10.3314966250792,0.383605427580411,30
"3240","PB","Catolé do Rocha",30684,13134.84,25001,"Catolé do Rocha",2,"Nordeste",0,"250430",5,33,14,19,16,17,0,0,0,0,0,33,14,19,16,17,26,9.48302352085017,10.3314966250792,0.406968504845874,31
"3241","PB","Caturité",4875,11489.11,25011,"Cariri Oriental",2,"Nordeste",0,"250435",2,5,1,4,4,1,0,0,0,0,0,5,1,4,4,1,3,9.34915490918302,8.49187538343195,0.306693920463688,29
"3242","PB","Caturité",4875,11489.11,25011,"Cariri Oriental",2,"Nordeste",0,"250435",3,6,4,2,2,4,0,0,0,0,0,6,4,2,2,4,5,9.34915490918302,8.49187538343195,0.386237175915504,31
"3243","PB","Caturité",4875,11489.11,25011,"Cariri Oriental",2,"Nordeste",0,"250435",4,5,3,2,1,4,0,0,0,0,0,5,3,2,1,4,5,9.34915490918302,8.49187538343195,0.422674920593839,30
"3244","PB","Caturité",4875,11489.11,25011,"Cariri Oriental",2,"Nordeste",0,"250435",5,3,0,3,1,2,0,0,0,0,0,3,0,3,1,2,6,9.34915490918302,8.49187538343195,0.402690883109095,31
"3245","PB","Conceição",19007,9093.78,25006,"Itaporanga",2,"Nordeste",0,"250440",2,18,10,8,8,10,0,0,0,0,0,18,10,8,8,10,7,9.11534594231753,9.85256261135084,0.248234005124562,29
"3246","PB","Conceição",19007,9093.78,25006,"Itaporanga",2,"Nordeste",0,"250440",3,16,4,12,8,8,0,0,0,0,0,16,4,12,8,8,13,9.11534594231753,9.85256261135084,0.347540100637118,31
"3247","PB","Conceição",19007,9093.78,25006,"Itaporanga",2,"Nordeste",0,"250440",4,19,3,16,10,9,1,1,0,1,0,20,4,16,11,9,12,9.11534594231753,9.85256261135084,0.367625112344258,30
"3248","PB","Conceição",19007,9093.78,25006,"Itaporanga",2,"Nordeste",0,"250440",5,15,9,6,6,9,0,0,0,0,0,15,9,6,6,9,9,9.11534594231753,9.85256261135084,0.410259212899005,31
"3249","PB","Condado",6658,9075.85,25003,"Sousa",2,"Nordeste",0,"250450",2,2,1,1,0,2,0,0,0,0,0,2,1,1,0,2,7,9.11337231865871,8.80357441813497,0.362807569831537,29
"3250","PB","Condado",6658,9075.85,25003,"Sousa",2,"Nordeste",0,"250450",3,10,5,5,7,3,0,0,0,0,0,10,5,5,7,3,6,9.11337231865871,8.80357441813497,0.456215758661846,31
"3251","PB","Condado",6658,9075.85,25003,"Sousa",2,"Nordeste",0,"250450",4,8,3,5,4,4,0,0,0,0,0,8,3,5,4,4,5,9.11337231865871,8.80357441813497,0.441209797148832,30
"3252","PB","Condado",6658,9075.85,25003,"Sousa",2,"Nordeste",0,"250450",5,4,1,3,2,2,0,0,0,0,0,4,1,3,2,2,8,9.11337231865871,8.80357441813497,0.475573578043227,31
"3253","PB","Conde",25010,28948.22,25022,"João Pessoa",2,"Nordeste",1,"250460",2,54,22,32,24,30,2,1,1,0,2,56,23,33,24,32,17,10.2732639957913,10.1270310238717,0.295632718260924,29
"3254","PB","Conde",25010,28948.22,25022,"João Pessoa",2,"Nordeste",1,"250460",3,36,18,18,13,23,0,0,0,0,0,36,18,18,13,23,12,10.2732639957913,10.1270310238717,0.391837352727816,31
"3255","PB","Conde",25010,28948.22,25022,"João Pessoa",2,"Nordeste",1,"250460",4,37,15,22,19,18,0,0,0,0,0,37,15,22,19,18,9,10.2732639957913,10.1270310238717,0.447553652447612,30
"3256","PB","Conde",25010,28948.22,25022,"João Pessoa",2,"Nordeste",1,"250460",5,50,20,30,19,31,1,0,1,0,1,51,20,31,19,32,17,10.2732639957913,10.1270310238717,0.460447728134374,31
"3257","PB","Congo",4787,10860.43,25010,"Cariri Ocidental",2,"Nordeste",0,"250470",2,3,0,3,1,2,0,0,0,0,0,3,0,3,1,2,6,9.29288118754753,8.47365918939251,0.248818620255045,29
"3258","PB","Congo",4787,10860.43,25010,"Cariri Ocidental",2,"Nordeste",0,"250470",3,10,3,7,7,3,0,0,0,0,0,10,3,7,7,3,2,9.29288118754753,8.47365918939251,0.350714422483374,31
"3259","PB","Congo",4787,10860.43,25010,"Cariri Ocidental",2,"Nordeste",0,"250470",4,7,2,5,2,5,1,0,1,0,1,8,2,6,2,6,5,9.29288118754753,8.47365918939251,0.379933813546828,30
"3260","PB","Congo",4787,10860.43,25010,"Cariri Ocidental",2,"Nordeste",0,"250470",5,6,1,5,3,3,0,0,0,0,0,6,1,5,3,3,6,9.29288118754753,8.47365918939251,0.413978192456695,31
"3261","PB","Coremas",15441,9798.57,25005,"Piancó",2,"Nordeste",0,"250480",2,14,6,8,11,3,0,0,0,0,0,14,6,8,11,3,12,9.1899917356442,9.64478158832086,0.313669615463796,29
"3262","PB","Coremas",15441,9798.57,25005,"Piancó",2,"Nordeste",0,"250480",3,11,6,5,6,5,0,0,0,0,0,11,6,5,6,5,4,9.1899917356442,9.64478158832086,0.408013231198229,31
"3263","PB","Coremas",15441,9798.57,25005,"Piancó",2,"Nordeste",0,"250480",4,15,4,11,4,11,0,0,0,0,0,15,4,11,4,11,13,9.1899917356442,9.64478158832086,0.414843737112691,30
"3264","PB","Coremas",15441,9798.57,25005,"Piancó",2,"Nordeste",0,"250480",5,23,8,15,11,12,0,0,0,0,0,23,8,15,11,12,11,9.1899917356442,9.64478158832086,0.423894080324227,31
"3265","PB","Cruz do Espírito Santo",17461,7680.78,25021,"Sapé",2,"Nordeste",0,"250490",2,19,4,15,11,8,1,0,1,0,1,20,4,16,11,9,10,8.9464763834846,9.76772510152213,0.277278294355701,29
"3266","PB","Cruz do Espírito Santo",17461,7680.78,25021,"Sapé",2,"Nordeste",0,"250490",3,27,14,13,16,11,1,0,1,1,0,28,14,14,17,11,11,8.9464763834846,9.76772510152213,0.368243347068313,31
"3267","PB","Cruz do Espírito Santo",17461,7680.78,25021,"Sapé",2,"Nordeste",0,"250490",4,9,2,7,2,7,0,0,0,0,0,9,2,7,2,7,9,8.9464763834846,9.76772510152213,0.40232130902103,30
"3268","PB","Cruz do Espírito Santo",17461,7680.78,25021,"Sapé",2,"Nordeste",0,"250490",5,6,3,3,3,3,1,1,0,1,0,7,4,3,4,3,26,8.9464763834846,9.76772510152213,0.445457713377732,31
"3269","PB","Cubati",7832,8095.86,25009,"Seridó Oriental Paraibano",2,"Nordeste",0,"250500",2,8,2,6,2,6,0,0,0,0,0,8,2,6,2,6,7,8.99910809888761,8.96597318421035,0.291468720914219,29
"3270","PB","Cubati",7832,8095.86,25009,"Seridó Oriental Paraibano",2,"Nordeste",0,"250500",3,7,3,4,4,3,0,0,0,0,0,7,3,4,4,3,4,8.99910809888761,8.96597318421035,0.344612086761145,31
"3271","PB","Cubati",7832,8095.86,25009,"Seridó Oriental Paraibano",2,"Nordeste",0,"250500",4,10,5,5,6,4,1,1,0,0,1,11,6,5,6,5,2,8.99910809888761,8.96597318421035,0.390299992488803,30
"3272","PB","Cubati",7832,8095.86,25009,"Seridó Oriental Paraibano",2,"Nordeste",0,"250500",5,7,5,2,3,4,0,0,0,0,0,7,5,2,3,4,6,8.99910809888761,8.96597318421035,0.37135127236605,31
"3273","PB","Cuité",20334,10139.34,25012,"Curimataú Ocidental",2,"Nordeste",1,"250510",2,16,5,11,7,9,0,0,0,0,0,16,5,11,7,9,4,9.22417818626941,9.92004964083511,0.255071278993542,29
"3274","PB","Cuité",20334,10139.34,25012,"Curimataú Ocidental",2,"Nordeste",1,"250510",3,17,4,13,3,14,0,0,0,0,0,17,4,13,3,14,13,9.22417818626941,9.92004964083511,0.349382514274366,31
"3275","PB","Cuité",20334,10139.34,25012,"Curimataú Ocidental",2,"Nordeste",1,"250510",4,22,8,14,9,13,0,0,0,0,0,22,8,14,9,13,8,9.22417818626941,9.92004964083511,0.396422297480015,30
"3276","PB","Cuité",20334,10139.34,25012,"Curimataú Ocidental",2,"Nordeste",1,"250510",5,23,9,14,11,12,1,0,1,1,0,24,9,15,12,12,12,9.22417818626941,9.92004964083511,0.389483731069489,31
"3277","PB","Cuitegi",6775,8370.05,25016,"Guarabira",2,"Nordeste",0,"250520",2,7,3,4,3,4,1,0,1,0,1,8,3,5,3,5,7,9.03241513718133,8.8209946457479,0.311558702837093,29
"3278","PB","Cuitegi",6775,8370.05,25016,"Guarabira",2,"Nordeste",0,"250520",3,8,3,5,5,3,0,0,0,0,0,8,3,5,5,3,2,9.03241513718133,8.8209946457479,0.387976845415048,31
"3279","PB","Cuitegi",6775,8370.05,25016,"Guarabira",2,"Nordeste",0,"250520",4,11,2,9,5,6,0,0,0,0,0,11,2,9,5,6,3,9.03241513718133,8.8209946457479,0.449544479324162,30
"3280","PB","Cuitegi",6775,8370.05,25016,"Guarabira",2,"Nordeste",0,"250520",5,5,0,5,3,2,0,0,0,0,0,5,0,5,3,2,7,9.03241513718133,8.8209946457479,0.446323083189183,31
"3281","PB","Cuité de Mamanguape",6356,9989.12,25020,"Litoral Norte",2,"Nordeste",0,"250523",2,10,4,6,4,6,0,0,0,0,0,10,4,6,4,6,2,9.20925177967453,8.75715452765661,0.306848556321782,29
"3282","PB","Cuité de Mamanguape",6356,9989.12,25020,"Litoral Norte",2,"Nordeste",0,"250523",3,12,10,2,6,6,0,0,0,0,0,12,10,2,6,6,4,9.20925177967453,8.75715452765661,0.403461914587291,31
"3283","PB","Cuité de Mamanguape",6356,9989.12,25020,"Litoral Norte",2,"Nordeste",0,"250523",4,3,3,0,2,1,0,0,0,0,0,3,3,0,2,1,6,9.20925177967453,8.75715452765661,0.434095379524267,30
"3284","PB","Cuité de Mamanguape",6356,9989.12,25020,"Litoral Norte",2,"Nordeste",0,"250523",5,5,4,1,1,4,0,0,0,0,0,5,4,1,1,4,4,9.20925177967453,8.75715452765661,0.451812635628149,31
"3285","PB","Curral de Cima",5218,9257.05,25020,"Litoral Norte",2,"Nordeste",0,"250527",2,3,1,2,2,1,0,0,0,0,0,3,1,2,2,1,6,9.13314070237054,8.55986946569667,0.345817908471894,29
"3286","PB","Curral de Cima",5218,9257.05,25020,"Litoral Norte",2,"Nordeste",0,"250527",3,3,3,0,1,2,0,0,0,0,0,3,3,0,1,2,5,9.13314070237054,8.55986946569667,0.426847813223604,31
"3287","PB","Curral de Cima",5218,9257.05,25020,"Litoral Norte",2,"Nordeste",0,"250527",4,6,4,2,4,2,0,0,0,0,0,6,4,2,4,2,4,9.13314070237054,8.55986946569667,0.476155591518323,30
"3288","PB","Curral de Cima",5218,9257.05,25020,"Litoral Norte",2,"Nordeste",0,"250527",5,6,2,4,3,3,0,0,0,0,0,6,2,4,3,3,7,9.13314070237054,8.55986946569667,0.515445322848112,31
"3289","PB","Damião",5370,7991.37,25012,"Curimataú Ocidental",2,"Nordeste",0,"250535",2,3,1,2,3,0,0,0,0,0,0,3,1,2,3,0,1,8.98611748839241,8.58858318750291,0.321937627391095,29
"3290","PB","Damião",5370,7991.37,25012,"Curimataú Ocidental",2,"Nordeste",0,"250535",3,7,3,4,2,5,0,0,0,0,0,7,3,4,2,5,1,8.98611748839241,8.58858318750291,0.393364796627849,31
"3291","PB","Damião",5370,7991.37,25012,"Curimataú Ocidental",2,"Nordeste",0,"250535",4,7,3,4,2,5,0,0,0,0,0,7,3,4,2,5,1,8.98611748839241,8.58858318750291,0.417338940786812,30
"3292","PB","Damião",5370,7991.37,25012,"Curimataú Ocidental",2,"Nordeste",0,"250535",5,1,1,0,0,1,0,0,0,0,0,1,1,0,0,1,4,8.98611748839241,8.58858318750291,0.424232644853713,31
"3293","PB","Desterro",8315,7373.61,25007,"Serra do Teixeira",2,"Nordeste",0,"250540",2,7,2,5,4,3,0,0,0,0,0,7,2,5,4,3,6,8.90566268886819,9.02581639162703,0.285517897958066,29
"3294","PB","Desterro",8315,7373.61,25007,"Serra do Teixeira",2,"Nordeste",0,"250540",3,12,4,8,8,4,0,0,0,0,0,12,4,8,8,4,5,8.90566268886819,9.02581639162703,0.388245307467386,31
"3295","PB","Desterro",8315,7373.61,25007,"Serra do Teixeira",2,"Nordeste",0,"250540",4,14,2,12,9,5,0,0,0,0,0,14,2,12,9,5,5,8.90566268886819,9.02581639162703,0.418810596777698,30
"3296","PB","Desterro",8315,7373.61,25007,"Serra do Teixeira",2,"Nordeste",0,"250540",5,10,3,7,5,5,0,0,0,0,0,10,3,7,5,5,4,8.90566268886819,9.02581639162703,0.416458765911509,31
"3297","PB","Diamante",6528,8104.65,25006,"Itaporanga",2,"Nordeste",0,"250560",2,8,3,5,4,4,0,0,0,0,0,8,3,5,4,4,1,9.00019325001712,8.78385589664394,0.320151878986537,29
"3298","PB","Diamante",6528,8104.65,25006,"Itaporanga",2,"Nordeste",0,"250560",3,5,3,2,3,2,0,0,0,0,0,5,3,2,3,2,2,9.00019325001712,8.78385589664394,0.395709135426076,31
"3299","PB","Diamante",6528,8104.65,25006,"Itaporanga",2,"Nordeste",0,"250560",4,5,1,4,1,4,0,0,0,0,0,5,1,4,1,4,5,9.00019325001712,8.78385589664394,0.416326556272933,30
"3300","PB","Diamante",6528,8104.65,25006,"Itaporanga",2,"Nordeste",0,"250560",5,7,3,4,3,4,0,0,0,0,0,7,3,4,3,4,2,9.00019325001712,8.78385589664394,0.437736175701488,31
"3301","PB","Dona Inês",10413,7743.25,25013,"Curimataú Oriental",2,"Nordeste",0,"250570",2,3,1,2,2,1,0,0,0,0,0,3,1,2,2,1,5,8.95457677509268,9.2508103045299,0.325387708928514,29
"3302","PB","Dona Inês",10413,7743.25,25013,"Curimataú Oriental",2,"Nordeste",0,"250570",3,7,4,3,4,3,0,0,0,0,0,7,4,3,4,3,6,8.95457677509268,9.2508103045299,0.39746954317597,31
"3303","PB","Dona Inês",10413,7743.25,25013,"Curimataú Oriental",2,"Nordeste",0,"250570",4,9,4,5,4,5,0,0,0,0,0,9,4,5,4,5,8,8.95457677509268,9.2508103045299,0.412589976842384,30
"3304","PB","Dona Inês",10413,7743.25,25013,"Curimataú Oriental",2,"Nordeste",0,"250570",5,8,3,5,4,4,0,0,0,0,0,8,3,5,4,4,2,8.95457677509268,9.2508103045299,0.423045097383779,31
"3305","PB","Duas Estradas",3582,10963.99,25016,"Guarabira",2,"Nordeste",0,"250580",2,1,0,1,0,1,0,0,0,0,0,1,0,1,0,1,2,9.30237154534638,8.18367658262066,0.28783152208738,29
"3306","PB","Duas Estradas",3582,10963.99,25016,"Guarabira",2,"Nordeste",0,"250580",3,5,3,2,2,3,0,0,0,0,0,5,3,2,2,3,3,9.30237154534638,8.18367658262066,0.395375566431401,31
"3307","PB","Duas Estradas",3582,10963.99,25016,"Guarabira",2,"Nordeste",0,"250580",4,2,2,0,2,0,0,0,0,0,0,2,2,0,2,0,1,9.30237154534638,8.18367658262066,0.432333487237741,30
"3308","PB","Duas Estradas",3582,10963.99,25016,"Guarabira",2,"Nordeste",0,"250580",5,1,0,1,1,0,0,0,0,0,0,1,0,1,1,0,2,9.30237154534638,8.18367658262066,0.445298872542345,31
"3309","PB","Esperança",33199,12334.99,25014,"Esperança",2,"Nordeste",0,"250600",2,41,19,22,19,22,1,0,1,0,1,42,19,23,19,23,25,9.42019521826187,10.410275033969,0.285893383237362,29
"3310","PB","Esperança",33199,12334.99,25014,"Esperança",2,"Nordeste",0,"250600",3,32,10,22,18,14,0,0,0,0,0,32,10,22,18,14,21,9.42019521826187,10.410275033969,0.375502645506913,31
"3311","PB","Esperança",33199,12334.99,25014,"Esperança",2,"Nordeste",0,"250600",4,29,13,16,13,16,0,0,0,0,0,29,13,16,13,16,20,9.42019521826187,10.410275033969,0.403527117286049,30
"3312","PB","Esperança",33199,12334.99,25014,"Esperança",2,"Nordeste",0,"250600",5,36,15,21,12,24,0,0,0,0,0,36,15,21,12,24,17,9.42019521826187,10.410275033969,0.411140769360785,31
"3313","PB","Fagundes",11215,8195.91,25017,"Campina Grande",2,"Nordeste",0,"250610",2,13,7,6,4,9,0,0,0,0,0,13,7,6,4,9,13,9.01139052833217,9.32500744695431,0.297028342815016,29
"3314","PB","Fagundes",11215,8195.91,25017,"Campina Grande",2,"Nordeste",0,"250610",3,14,8,6,4,10,0,0,0,0,0,14,8,6,4,10,7,9.01139052833217,9.32500744695431,0.391119488866759,31
"3315","PB","Fagundes",11215,8195.91,25017,"Campina Grande",2,"Nordeste",0,"250610",4,9,2,7,5,4,0,0,0,0,0,9,2,7,5,4,5,9.01139052833217,9.32500744695431,0.395070884492708,30
"3316","PB","Fagundes",11215,8195.91,25017,"Campina Grande",2,"Nordeste",0,"250610",5,18,10,8,5,13,0,0,0,0,0,18,10,8,5,13,14,9.01139052833217,9.32500744695431,0.398781496781991,31
"3317","PB","Frei Martinho",2989,9605.35,25009,"Seridó Oriental Paraibano",2,"Nordeste",0,"250620",2,0,0,0,0,0,0,0,0,0,0,0,0,0,0,0,0,9.17007551389326,8.00269416228394,0.252761080169399,29
"3318","PB","Frei Martinho",2989,9605.35,25009,"Seridó Oriental Paraibano",2,"Nordeste",0,"250620",3,3,2,1,0,3,0,0,0,0,0,3,2,1,0,3,4,9.17007551389326,8.00269416228394,0.320045364814363,31
"3319","PB","Frei Martinho",2989,9605.35,25009,"Seridó Oriental Paraibano",2,"Nordeste",0,"250620",4,2,0,2,2,0,0,0,0,0,0,2,0,2,2,0,2,9.17007551389326,8.00269416228394,0.369277185119415,30
"3320","PB","Frei Martinho",2989,9605.35,25009,"Seridó Oriental Paraibano",2,"Nordeste",0,"250620",5,3,2,1,2,1,0,0,0,0,0,3,2,1,2,1,1,9.17007551389326,8.00269416228394,0.346469744866001,31
"3321","PB","Gado Bravo",8303,7665.94,25019,"Umbuzeiro",2,"Nordeste",0,"250625",2,7,2,5,1,6,0,0,0,0,0,7,2,5,1,6,2,8.94454241914233,9.02437217426203,0.314560319293712,29
"3322","PB","Gado Bravo",8303,7665.94,25019,"Umbuzeiro",2,"Nordeste",0,"250625",3,13,5,8,9,4,0,0,0,0,0,13,5,8,9,4,9,8.94454241914233,9.02437217426203,0.389518839929256,31
"3323","PB","Gado Bravo",8303,7665.94,25019,"Umbuzeiro",2,"Nordeste",0,"250625",4,6,2,4,2,4,0,0,0,0,0,6,2,4,2,4,2,8.94454241914233,9.02437217426203,0.425870365216776,30
"3324","PB","Gado Bravo",8303,7665.94,25019,"Umbuzeiro",2,"Nordeste",0,"250625",5,9,3,6,2,7,0,0,0,0,0,9,3,6,2,7,5,8.94454241914233,9.02437217426203,0.488515273190758,31
"3325","PB","Guarabira",59115,16588.18,25016,"Guarabira",2,"Nordeste",1,"250630",2,35,7,28,17,18,0,0,0,0,0,35,7,28,17,18,36,9.71644567252515,10.9872399782972,0.278923417145563,29
"3326","PB","Guarabira",59115,16588.18,25016,"Guarabira",2,"Nordeste",1,"250630",3,41,11,30,24,17,1,0,1,1,0,42,11,31,25,17,25,9.71644567252515,10.9872399782972,0.371006208898469,31
"3327","PB","Guarabira",59115,16588.18,25016,"Guarabira",2,"Nordeste",1,"250630",4,50,15,35,18,32,0,0,0,0,0,50,15,35,18,32,36,9.71644567252515,10.9872399782972,0.407093973970699,30
"3328","PB","Guarabira",59115,16588.18,25016,"Guarabira",2,"Nordeste",1,"250630",5,60,19,41,27,33,0,0,0,0,0,60,19,41,27,33,56,9.71644567252515,10.9872399782972,0.422550383029908,31
"3329","PB","Gurinhém",14127,9452.44,25018,"Itabaiana",2,"Nordeste",0,"250640",2,10,5,5,3,7,1,0,1,1,0,11,5,6,4,7,3,9.15402818821783,9.55584313891166,0.29208626063504,29
"3330","PB","Gurinhém",14127,9452.44,25018,"Itabaiana",2,"Nordeste",0,"250640",3,11,5,6,6,5,1,1,0,0,1,12,6,6,6,6,7,9.15402818821783,9.55584313891166,0.38823369344993,31
"3331","PB","Gurinhém",14127,9452.44,25018,"Itabaiana",2,"Nordeste",0,"250640",4,7,1,6,6,1,0,0,0,0,0,7,1,6,6,1,8,9.15402818821783,9.55584313891166,0.41333603753592,30
"3332","PB","Gurinhém",14127,9452.44,25018,"Itabaiana",2,"Nordeste",0,"250640",5,19,11,8,10,9,0,0,0,0,0,19,11,8,10,9,12,9.15402818821783,9.55584313891166,0.436628574285768,31
"3333","PB","Gurjão",3453,9296.05,25011,"Cariri Oriental",2,"Nordeste",0,"250650",2,4,0,4,2,2,0,0,0,0,0,4,0,4,2,2,3,9.13734485773471,8.14699869738999,0.296474103190312,29
"3334","PB","Gurjão",3453,9296.05,25011,"Cariri Oriental",2,"Nordeste",0,"250650",3,1,0,1,0,1,0,0,0,0,0,1,0,1,0,1,2,9.13734485773471,8.14699869738999,0.371649270923097,31
"3335","PB","Gurjão",3453,9296.05,25011,"Cariri Oriental",2,"Nordeste",0,"250650",4,5,2,3,2,3,0,0,0,0,0,5,2,3,2,3,2,9.13734485773471,8.14699869738999,0.389132464487273,30
"3336","PB","Gurjão",3453,9296.05,25011,"Cariri Oriental",2,"Nordeste",0,"250650",5,3,0,3,2,1,0,0,0,0,0,3,0,3,2,1,3,9.13734485773471,8.14699869738999,0.380334541518914,31
"3337","PB","Imaculada",11848,6515.62,25007,"Serra do Teixeira",2,"Nordeste",0,"250670",2,10,6,4,5,5,0,0,0,0,0,10,6,4,5,5,8,8.78195765003488,9.37991435594764,0.300240113870003,29
"3338","PB","Imaculada",11848,6515.62,25007,"Serra do Teixeira",2,"Nordeste",0,"250670",3,12,2,10,4,8,0,0,0,0,0,12,2,10,4,8,4,8.78195765003488,9.37991435594764,0.3918755693342,31
"3339","PB","Imaculada",11848,6515.62,25007,"Serra do Teixeira",2,"Nordeste",0,"250670",4,10,2,8,3,7,1,1,0,1,0,11,3,8,4,7,4,8.78195765003488,9.37991435594764,0.408444444188113,30
"3340","PB","Imaculada",11848,6515.62,25007,"Serra do Teixeira",2,"Nordeste",0,"250670",5,11,2,9,5,6,0,0,0,0,0,11,2,9,5,6,2,8.78195765003488,9.37991435594764,0.430713051300448,31
"3341","PB","Ingá",18144,9223.54,25018,"Itabaiana",2,"Nordeste",0,"250680",2,16,6,10,9,7,0,0,0,0,0,16,6,10,9,7,10,9.12951419080075,9.80609520652748,0.290048521442062,29
"3342","PB","Ingá",18144,9223.54,25018,"Itabaiana",2,"Nordeste",0,"250680",3,15,6,9,6,9,0,0,0,0,0,15,6,9,6,9,4,9.12951419080075,9.80609520652748,0.371058828922966,31
"3343","PB","Ingá",18144,9223.54,25018,"Itabaiana",2,"Nordeste",0,"250680",4,17,7,10,9,8,1,0,1,1,0,18,7,11,10,8,8,9.12951419080075,9.80609520652748,0.391177557085764,30
"3344","PB","Ingá",18144,9223.54,25018,"Itabaiana",2,"Nordeste",0,"250680",5,15,6,9,7,8,0,0,0,0,0,15,6,9,7,8,14,9.12951419080075,9.80609520652748,0.42938868368957,31
"3345","PB","Itabaiana",24419,11812.71,25018,"Itabaiana",2,"Nordeste",1,"250690",2,41,15,26,23,18,0,0,0,0,0,41,15,26,23,18,13,9.37693134942175,10.1031167967853,0.281132945000324,29
"3346","PB","Itabaiana",24419,11812.71,25018,"Itabaiana",2,"Nordeste",1,"250690",3,29,14,15,10,19,0,0,0,0,0,29,14,15,10,19,12,9.37693134942175,10.1031167967853,0.3848379033367,31
"3347","PB","Itabaiana",24419,11812.71,25018,"Itabaiana",2,"Nordeste",1,"250690",4,30,10,20,14,16,0,0,0,0,0,30,10,20,14,16,16,9.37693134942175,10.1031167967853,0.41553275980701,30
"3348","PB","Itabaiana",24419,11812.71,25018,"Itabaiana",2,"Nordeste",1,"250690",5,27,8,19,14,13,0,0,0,0,0,27,8,19,14,13,20,9.37693134942175,10.1031167967853,0.431161895175807,31
"3349","PB","Itaporanga",24828,11443.39,25006,"Itaporanga",2,"Nordeste",1,"250700",2,26,11,15,11,15,0,0,0,0,0,26,11,15,11,15,13,9.34516754970845,10.1197273275335,0.262606257476919,29
"3350","PB","Itaporanga",24828,11443.39,25006,"Itaporanga",2,"Nordeste",1,"250700",3,20,7,13,8,12,0,0,0,0,0,20,7,13,8,12,7,9.34516754970845,10.1197273275335,0.359485839571412,31
"3351","PB","Itaporanga",24828,11443.39,25006,"Itaporanga",2,"Nordeste",1,"250700",4,23,7,16,8,15,0,0,0,0,0,23,7,16,8,15,11,9.34516754970845,10.1197273275335,0.386296347465747,30
"3352","PB","Itaporanga",24828,11443.39,25006,"Itaporanga",2,"Nordeste",1,"250700",5,31,11,20,14,17,0,0,0,0,0,31,11,20,14,17,10,9.34516754970845,10.1197273275335,0.382176311339038,31
"3353","PB","Itapororoca",18823,9395.04,25020,"Litoral Norte",2,"Nordeste",0,"250710",2,20,8,12,7,13,0,0,0,0,0,20,8,12,7,13,14,9.14793716942232,9.84283480532418,0.299380109405551,29
"3354","PB","Itapororoca",18823,9395.04,25020,"Litoral Norte",2,"Nordeste",0,"250710",3,16,5,11,8,8,0,0,0,0,0,16,5,11,8,8,14,9.14793716942232,9.84283480532418,0.378035077844988,31
"3355","PB","Itapororoca",18823,9395.04,25020,"Litoral Norte",2,"Nordeste",0,"250710",4,25,19,6,11,14,0,0,0,0,0,25,19,6,11,14,5,9.14793716942232,9.84283480532418,0.408511153328697,30
"3356","PB","Itapororoca",18823,9395.04,25020,"Litoral Norte",2,"Nordeste",0,"250710",5,22,13,9,10,12,0,0,0,0,0,22,13,9,10,12,8,9.14793716942232,9.84283480532418,0.419048609829084,31
"3357","PB","Itatuba",11016,10326.56,25018,"Itabaiana",2,"Nordeste",0,"250720",2,14,4,10,5,9,0,0,0,0,0,14,4,10,5,9,6,9.24247449600473,9.30710404040849,0.296423416354035,29
"3358","PB","Itatuba",11016,10326.56,25018,"Itabaiana",2,"Nordeste",0,"250720",3,9,4,5,8,1,0,0,0,0,0,9,4,5,8,1,4,9.24247449600473,9.30710404040849,0.377670841797988,31
"3359","PB","Itatuba",11016,10326.56,25018,"Itabaiana",2,"Nordeste",0,"250720",4,6,3,3,2,4,0,0,0,0,0,6,3,3,2,4,5,9.24247449600473,9.30710404040849,0.385075127157367,30
"3360","PB","Itatuba",11016,10326.56,25018,"Itabaiana",2,"Nordeste",0,"250720",5,12,7,5,5,7,0,0,0,0,0,12,7,5,5,7,10,9.24247449600473,9.30710404040849,0.421529886526407,31
"3361","PB","Jacaraú",14450,8821.68,25020,"Litoral Norte",2,"Nordeste",0,"250730",2,20,4,16,9,11,1,0,1,0,1,21,4,17,9,12,6,9.08496760705303,9.57844969354058,0.26983023919313,29
"3362","PB","Jacaraú",14450,8821.68,25020,"Litoral Norte",2,"Nordeste",0,"250730",3,16,10,6,7,9,1,1,0,0,1,17,11,6,7,10,5,9.08496760705303,9.57844969354058,0.333908470337488,31
"3363","PB","Jacaraú",14450,8821.68,25020,"Litoral Norte",2,"Nordeste",0,"250730",4,14,7,7,2,12,0,0,0,0,0,14,7,7,2,12,8,9.08496760705303,9.57844969354058,0.369454409715689,30
"3364","PB","Jacaraú",14450,8821.68,25020,"Litoral Norte",2,"Nordeste",0,"250730",5,20,7,13,9,11,0,0,0,0,0,20,7,13,9,11,13,9.08496760705303,9.57844969354058,0.401153613553731,31
"3365","PB","Jericó",7745,8388.3,25001,"Catolé do Rocha",2,"Nordeste",0,"250740",2,3,1,2,1,2,0,0,0,0,0,3,1,2,1,2,8,9.03459315676136,8.95480275285097,0.280414277450126,29
"3366","PB","Jericó",7745,8388.3,25001,"Catolé do Rocha",2,"Nordeste",0,"250740",3,6,2,4,3,3,0,0,0,0,0,6,2,4,3,3,8,9.03459315676136,8.95480275285097,0.353658535033427,31
"3367","PB","Jericó",7745,8388.3,25001,"Catolé do Rocha",2,"Nordeste",0,"250740",4,5,1,4,2,3,0,0,0,0,0,5,1,4,2,3,2,9.03459315676136,8.95480275285097,0.403041928721844,30
"3368","PB","Jericó",7745,8388.3,25001,"Catolé do Rocha",2,"Nordeste",0,"250740",5,8,4,4,2,6,1,1,0,1,0,9,5,4,3,6,8,9.03459315676136,8.95480275285097,0.434495976139556,31
"3369","PB","João Pessoa",817511,25035.8,25022,"João Pessoa",2,"Nordeste",1,"250750",2,843,175,668,261,582,7,0,7,3,4,850,175,675,264,586,404,10.1280620795161,13.6140196373205,0.282309374362534,29
"3370","PB","João Pessoa",817511,25035.8,25022,"João Pessoa",2,"Nordeste",1,"250750",3,826,195,631,290,536,9,3,6,3,6,835,198,637,293,542,442,10.1280620795161,13.6140196373205,0.402306584081453,31
"3371","PB","João Pessoa",817511,25035.8,25022,"João Pessoa",2,"Nordeste",1,"250750",4,720,173,547,277,443,10,5,5,2,8,730,178,552,279,451,497,10.1280620795161,13.6140196373205,0.482392577028178,30
"3372","PB","João Pessoa",817511,25035.8,25022,"João Pessoa",2,"Nordeste",1,"250750",5,836,215,621,285,551,9,6,3,3,6,845,221,624,288,557,781,10.1280620795161,13.6140196373205,0.469558791616448,31
"3373","PB","Juarez Távora",7976,7980.86,25018,"Itabaiana",2,"Nordeste",0,"250760",2,10,4,6,4,6,0,0,0,0,0,10,4,6,4,6,0,8.98480145406071,8.98419231164167,0.299358328226392,29
"3374","PB","Juarez Távora",7976,7980.86,25018,"Itabaiana",2,"Nordeste",0,"250760",3,9,4,5,4,5,0,0,0,0,0,9,4,5,4,5,4,8.98480145406071,8.98419231164167,0.381434518548012,31
"3375","PB","Juarez Távora",7976,7980.86,25018,"Itabaiana",2,"Nordeste",0,"250760",4,11,4,7,1,10,0,0,0,0,0,11,4,7,1,10,7,8.98480145406071,8.98419231164167,0.423951340216896,30
"3376","PB","Juarez Távora",7976,7980.86,25018,"Itabaiana",2,"Nordeste",0,"250760",5,16,6,10,12,4,0,0,0,0,0,16,6,10,12,4,5,8.98480145406071,8.98419231164167,0.441619566629865,31
"3377","PB","Juazeirinho",18298,9723.05,25009,"Seridó Oriental Paraibano",2,"Nordeste",0,"250770",2,25,7,18,11,14,0,0,0,0,0,25,7,18,11,14,4,9.18225463424218,9.81454704323948,0.28120529580999,29
"3378","PB","Juazeirinho",18298,9723.05,25009,"Seridó Oriental Paraibano",2,"Nordeste",0,"250770",3,15,9,6,9,6,0,0,0,0,0,15,9,6,9,6,9,9.18225463424218,9.81454704323948,0.381844694999035,31
"3379","PB","Juazeirinho",18298,9723.05,25009,"Seridó Oriental Paraibano",2,"Nordeste",0,"250770",4,28,14,14,11,17,0,0,0,0,0,28,14,14,11,17,14,9.18225463424218,9.81454704323948,0.411577652465477,30
"3380","PB","Juazeirinho",18298,9723.05,25009,"Seridó Oriental Paraibano",2,"Nordeste",0,"250770",5,20,12,8,11,9,2,1,1,0,2,22,13,9,11,11,6,9.18225463424218,9.81454704323948,0.461806117051829,31
"3381","PB","Junco do Seridó",7195,9913.62,25008,"Seridó Ocidental Paraibano",2,"Nordeste",0,"250780",2,7,3,4,4,3,0,0,0,0,0,7,3,4,4,3,2,9.20166484821106,8.88114161932147,0.332050941306572,29
"3382","PB","Junco do Seridó",7195,9913.62,25008,"Seridó Ocidental Paraibano",2,"Nordeste",0,"250780",3,7,1,6,2,5,0,0,0,0,0,7,1,6,2,5,5,9.20166484821106,8.88114161932147,0.409328268519938,31
"3383","PB","Junco do Seridó",7195,9913.62,25008,"Seridó Ocidental Paraibano",2,"Nordeste",0,"250780",4,9,3,6,2,7,0,0,0,0,0,9,3,6,2,7,2,9.20166484821106,8.88114161932147,0.490464051251015,30
"3384","PB","Junco do Seridó",7195,9913.62,25008,"Seridó Ocidental Paraibano",2,"Nordeste",0,"250780",5,9,3,6,3,6,0,0,0,0,0,9,3,6,3,6,2,9.20166484821106,8.88114161932147,0.477190759765365,31
"3385","PB","Juripiranga",10793,9178.66,25021,"Sapé",2,"Nordeste",1,"250790",2,11,7,4,8,3,1,0,1,0,1,12,7,5,8,4,6,9.12463650346104,9.28665305482535,0.285412919267417,29
"3386","PB","Juripiranga",10793,9178.66,25021,"Sapé",2,"Nordeste",1,"250790",3,15,4,11,9,6,0,0,0,0,0,15,4,11,9,6,3,9.12463650346104,9.28665305482535,0.363929316041539,31
"3387","PB","Juripiranga",10793,9178.66,25021,"Sapé",2,"Nordeste",1,"250790",4,13,4,9,6,7,0,0,0,0,0,13,4,9,6,7,2,9.12463650346104,9.28665305482535,0.399898503819324,30
"3388","PB","Juripiranga",10793,9178.66,25021,"Sapé",2,"Nordeste",1,"250790",5,18,5,13,10,8,0,0,0,0,0,18,5,13,10,8,12,9.12463650346104,9.28665305482535,0.440283992446835,31
"3389","PB","Juru",9849,7466.04,25007,"Serra do Teixeira",2,"Nordeste",0,"250800",2,3,0,3,1,2,0,0,0,0,0,3,0,3,1,2,5,8.91812001708139,9.1951252061697,0.326176657749603,29
"3390","PB","Juru",9849,7466.04,25007,"Serra do Teixeira",2,"Nordeste",0,"250800",3,4,2,2,0,4,0,0,0,0,0,4,2,2,0,4,5,8.91812001708139,9.1951252061697,0.423469323336771,31
"3391","PB","Juru",9849,7466.04,25007,"Serra do Teixeira",2,"Nordeste",0,"250800",4,8,2,6,3,5,0,0,0,0,0,8,2,6,3,5,6,8.91812001708139,9.1951252061697,0.437286343509759,30
"3392","PB","Juru",9849,7466.04,25007,"Serra do Teixeira",2,"Nordeste",0,"250800",5,10,7,3,5,5,0,0,0,0,0,10,7,3,5,5,3,8.91812001708139,9.1951252061697,0.462980252913084,31
"3393","PB","Lagoa de Dentro",7737,9565.45,25016,"Guarabira",2,"Nordeste",0,"250820",2,5,1,4,1,4,0,0,0,0,0,5,1,4,1,4,4,9.16591292729148,8.95376929454945,0.304499226759866,29
"3394","PB","Lagoa de Dentro",7737,9565.45,25016,"Guarabira",2,"Nordeste",0,"250820",3,7,3,4,3,4,0,0,0,0,0,7,3,4,3,4,5,9.16591292729148,8.95376929454945,0.405400576491658,31
"3395","PB","Lagoa de Dentro",7737,9565.45,25016,"Guarabira",2,"Nordeste",0,"250820",4,17,9,8,7,10,0,0,0,0,0,17,9,8,7,10,5,9.16591292729148,8.95376929454945,0.42357309158885,30
"3396","PB","Lagoa de Dentro",7737,9565.45,25016,"Guarabira",2,"Nordeste",0,"250820",5,8,3,5,2,6,1,1,0,0,1,9,4,5,2,7,7,9.16591292729148,8.95376929454945,0.441281618761763,31
"3397","PB","Lagoa Seca",27617,10012.27,25017,"Campina Grande",2,"Nordeste",1,"250830",2,28,11,17,8,20,0,0,0,0,0,28,11,17,8,20,12,9.21156661982688,10.2261868041198,0.285685057689942,29
"3398","PB","Lagoa Seca",27617,10012.27,25017,"Campina Grande",2,"Nordeste",1,"250830",3,29,12,17,10,19,0,0,0,0,0,29,12,17,10,19,11,9.21156661982688,10.2261868041198,0.387568312791402,31
"3399","PB","Lagoa Seca",27617,10012.27,25017,"Campina Grande",2,"Nordeste",1,"250830",4,27,13,14,18,9,0,0,0,0,0,27,13,14,18,9,12,9.21156661982688,10.2261868041198,0.430713955349558,30
"3400","PB","Lagoa Seca",27617,10012.27,25017,"Campina Grande",2,"Nordeste",1,"250830",5,40,12,28,12,28,0,0,0,0,0,40,12,28,12,28,19,9.21156661982688,10.2261868041198,0.441067021434412,31
"3401","PB","Livramento",7265,7751.67,25010,"Cariri Ocidental",2,"Nordeste",0,"250850",2,7,3,4,5,2,0,0,0,0,0,7,3,4,5,2,2,8.95566358300505,8.89082357600438,0.278607405625151,29
"3402","PB","Livramento",7265,7751.67,25010,"Cariri Ocidental",2,"Nordeste",0,"250850",3,6,4,2,4,2,0,0,0,0,0,6,4,2,4,2,6,8.95566358300505,8.89082357600438,0.389877301474761,31
"3403","PB","Livramento",7265,7751.67,25010,"Cariri Ocidental",2,"Nordeste",0,"250850",4,5,1,4,4,1,0,0,0,0,0,5,1,4,4,1,6,8.95566358300505,8.89082357600438,0.388402390579202,30
"3404","PB","Livramento",7265,7751.67,25010,"Cariri Ocidental",2,"Nordeste",0,"250850",5,7,2,5,2,5,0,0,0,0,0,7,2,5,2,5,3,8.95566358300505,8.89082357600438,0.386013140429203,31
"3405","PB","Logradouro",4369,9395.86,25016,"Guarabira",2,"Nordeste",0,"250855",2,3,0,3,3,0,1,0,1,1,0,4,0,4,4,0,4,9.14802444571037,8.38228942895144,0.26137450739605,29
"3406","PB","Logradouro",4369,9395.86,25016,"Guarabira",2,"Nordeste",0,"250855",3,2,1,1,0,2,0,0,0,0,0,2,1,1,0,2,1,9.14802444571037,8.38228942895144,0.349173788543608,31
"3407","PB","Logradouro",4369,9395.86,25016,"Guarabira",2,"Nordeste",0,"250855",4,0,0,0,0,0,0,0,0,0,0,0,0,0,0,0,3,9.14802444571037,8.38228942895144,0.409292074274084,30
"3408","PB","Logradouro",4369,9395.86,25016,"Guarabira",2,"Nordeste",0,"250855",5,6,4,2,2,4,0,0,0,0,0,6,4,2,2,4,2,9.14802444571037,8.38228942895144,0.418818604426564,31
"3409","PB","Lucena",13214,14983.82,25022,"João Pessoa",2,"Nordeste",1,"250860",2,19,9,10,14,5,0,0,0,0,0,19,9,10,14,5,5,9.6147262312381,9.48903215258983,0.30601179719553,29
"3410","PB","Lucena",13214,14983.82,25022,"João Pessoa",2,"Nordeste",1,"250860",3,14,3,11,3,11,0,0,0,0,0,14,3,11,3,11,6,9.6147262312381,9.48903215258983,0.394702811389099,31
"3411","PB","Lucena",13214,14983.82,25022,"João Pessoa",2,"Nordeste",1,"250860",4,4,1,3,3,1,0,0,0,0,0,4,1,3,3,1,4,9.6147262312381,9.48903215258983,0.437058579750732,30
"3412","PB","Lucena",13214,14983.82,25022,"João Pessoa",2,"Nordeste",1,"250860",5,3,0,3,2,1,0,0,0,0,0,3,0,3,2,1,8,9.6147262312381,9.48903215258983,0.451560269651678,31
"3413","PB","Malta",5752,9473.64,25003,"Sousa",2,"Nordeste",0,"250880",2,7,2,5,4,3,0,0,0,0,0,7,2,5,4,3,4,9.15626848402835,8.65730289940088,0.311149422527411,29
"3414","PB","Malta",5752,9473.64,25003,"Sousa",2,"Nordeste",0,"250880",3,6,4,2,3,3,0,0,0,0,0,6,4,2,3,3,3,9.15626848402835,8.65730289940088,0.409790588048549,31
"3415","PB","Malta",5752,9473.64,25003,"Sousa",2,"Nordeste",0,"250880",4,8,3,5,6,2,0,0,0,0,0,8,3,5,6,2,6,9.15626848402835,8.65730289940088,0.428591357357221,30
"3416","PB","Malta",5752,9473.64,25003,"Sousa",2,"Nordeste",0,"250880",5,9,3,6,2,7,0,0,0,0,0,9,3,6,2,7,6,9.15626848402835,8.65730289940088,0.474168117623186,31
"3417","PB","Mamanguape",45136,14387.47,25020,"Litoral Norte",2,"Nordeste",1,"250890",2,56,25,31,29,27,0,0,0,0,0,56,25,31,29,27,40,9.57411296788461,10.7174354332418,0.275108200318265,29
"3418","PB","Mamanguape",45136,14387.47,25020,"Litoral Norte",2,"Nordeste",1,"250890",3,56,28,28,28,28,0,0,0,0,0,56,28,28,28,28,31,9.57411296788461,10.7174354332418,0.363813841213521,31
"3419","PB","Mamanguape",45136,14387.47,25020,"Litoral Norte",2,"Nordeste",1,"250890",4,69,32,37,31,38,0,0,0,0,0,69,32,37,31,38,16,9.57411296788461,10.7174354332418,0.400313992234922,30
"3420","PB","Mamanguape",45136,14387.47,25020,"Litoral Norte",2,"Nordeste",1,"250890",5,57,29,28,33,24,1,1,0,1,0,58,30,28,34,24,35,9.57411296788461,10.7174354332418,0.414555071089559,31
"3421","PB","Manaíra",10972,6869.18,25007,"Serra do Teixeira",2,"Nordeste",0,"250900",2,11,2,9,3,8,0,0,0,0,0,11,2,9,3,8,4,8.83480001855827,9.30310185205749,0.30539855639897,29
"3422","PB","Manaíra",10972,6869.18,25007,"Serra do Teixeira",2,"Nordeste",0,"250900",3,9,5,4,2,7,1,1,0,0,1,10,6,4,2,8,4,8.83480001855827,9.30310185205749,0.371203798441265,31
"3423","PB","Manaíra",10972,6869.18,25007,"Serra do Teixeira",2,"Nordeste",0,"250900",4,16,6,10,8,8,0,0,0,0,0,16,6,10,8,8,7,8.83480001855827,9.30310185205749,0.412015695404603,30
"3424","PB","Manaíra",10972,6869.18,25007,"Serra do Teixeira",2,"Nordeste",0,"250900",5,11,3,8,3,8,0,0,0,0,0,11,3,8,3,8,5,8.83480001855827,9.30310185205749,0.441241458803551,31
"3425","PB","Marcação",8653,9068.88,25020,"Litoral Norte",2,"Nordeste",0,"250905",2,16,6,10,8,8,0,0,0,0,0,16,6,10,8,8,3,9.11260405147117,9.06566136060674,0.332332897633126,29
"3426","PB","Marcação",8653,9068.88,25020,"Litoral Norte",2,"Nordeste",0,"250905",3,15,9,6,6,9,0,0,0,0,0,15,9,6,6,9,5,9.11260405147117,9.06566136060674,0.425509420324395,31
"3427","PB","Marcação",8653,9068.88,25020,"Litoral Norte",2,"Nordeste",0,"250905",4,12,7,5,4,8,0,0,0,0,0,12,7,5,4,8,4,9.11260405147117,9.06566136060674,0.454560580047273,30
"3428","PB","Marcação",8653,9068.88,25020,"Litoral Norte",2,"Nordeste",0,"250905",5,14,11,3,11,3,0,0,0,0,0,14,11,3,11,3,5,9.11260405147117,9.06566136060674,0.454116568383457,31
"3429","PB","Mari",21866,9279.95,25021,"Sapé",2,"Nordeste",1,"250910",2,19,10,9,7,12,0,0,0,0,0,19,10,9,7,12,10,9.1356114378347,9.99268819799443,0.287203798201007,29
"3430","PB","Mari",21866,9279.95,25021,"Sapé",2,"Nordeste",1,"250910",3,21,8,13,12,9,0,0,0,0,0,21,8,13,12,9,11,9.1356114378347,9.99268819799443,0.359384045343609,31
"3431","PB","Mari",21866,9279.95,25021,"Sapé",2,"Nordeste",1,"250910",4,10,4,6,7,3,0,0,0,0,0,10,4,6,7,3,12,9.1356114378347,9.99268819799443,0.393152247728362,30
"3432","PB","Mari",21866,9279.95,25021,"Sapé",2,"Nordeste",1,"250910",5,7,5,2,4,3,0,0,0,0,0,7,5,2,4,3,23,9.1356114378347,9.99268819799443,0.398480613552345,31
"3433","PB","Marizópolis",6654,9573.54,25003,"Sousa",2,"Nordeste",0,"250915",2,6,1,5,1,5,0,0,0,0,0,6,1,5,1,5,3,9.16675832200477,8.80297345657842,0.306496923913697,29
"3434","PB","Marizópolis",6654,9573.54,25003,"Sousa",2,"Nordeste",0,"250915",3,8,0,8,4,4,0,0,0,0,0,8,0,8,4,4,4,9.16675832200477,8.80297345657842,0.423044984844084,31
"3435","PB","Marizópolis",6654,9573.54,25003,"Sousa",2,"Nordeste",0,"250915",4,6,0,6,2,4,0,0,0,0,0,6,0,6,2,4,3,9.16675832200477,8.80297345657842,0.434797211409022,30
"3436","PB","Marizópolis",6654,9573.54,25003,"Sousa",2,"Nordeste",0,"250915",5,9,3,6,3,6,0,0,0,0,0,9,3,6,3,6,6,9.16675832200477,8.80297345657842,0.435461749368129,31
"3437","PB","Massaranduba",13998,7868.74,25017,"Campina Grande",2,"Nordeste",1,"250920",2,18,8,10,7,11,0,0,0,0,0,18,8,10,7,11,10,8.97065322694197,9.54666974124948,0.28817162078217,29
"3438","PB","Massaranduba",13998,7868.74,25017,"Campina Grande",2,"Nordeste",1,"250920",3,12,3,9,6,6,0,0,0,0,0,12,3,9,6,6,5,8.97065322694197,9.54666974124948,0.366676707726134,31
"3439","PB","Massaranduba",13998,7868.74,25017,"Campina Grande",2,"Nordeste",1,"250920",4,10,3,7,4,6,0,0,0,0,0,10,3,7,4,6,8,8.97065322694197,9.54666974124948,0.386454964214658,30
"3440","PB","Massaranduba",13998,7868.74,25017,"Campina Grande",2,"Nordeste",1,"250920",5,10,5,5,6,4,0,0,0,0,0,10,5,5,6,4,6,8.97065322694197,9.54666974124948,0.420394535443433,31
"3441","PB","Mataraca",8539,27477.56,25020,"Litoral Norte",2,"Nordeste",0,"250930",2,11,3,8,7,4,0,0,0,0,0,11,3,8,7,4,5,10.2211249505454,9.05239918390761,0.263533030914284,29
"3442","PB","Mataraca",8539,27477.56,25020,"Litoral Norte",2,"Nordeste",0,"250930",3,9,5,4,6,3,0,0,0,0,0,9,5,4,6,3,1,10.2211249505454,9.05239918390761,0.354860617438024,31
"3443","PB","Mataraca",8539,27477.56,25020,"Litoral Norte",2,"Nordeste",0,"250930",4,17,6,11,9,8,0,0,0,0,0,17,6,11,9,8,2,10.2211249505454,9.05239918390761,0.357493340891234,30
"3444","PB","Mataraca",8539,27477.56,25020,"Litoral Norte",2,"Nordeste",0,"250930",5,10,5,5,4,6,0,0,0,0,0,10,5,5,4,6,5,10.2211249505454,9.05239918390761,0.394146386087733,31
"3445","PB","Maturéia",6630,7928.77,25007,"Serra do Teixeira",2,"Nordeste",0,"250939",2,10,2,8,2,8,1,0,1,0,1,11,2,9,2,9,5,8.97825319541064,8.79936008317991,0.312357677618061,29
"3446","PB","Maturéia",6630,7928.77,25007,"Serra do Teixeira",2,"Nordeste",0,"250939",3,13,4,9,6,7,0,0,0,0,0,13,4,9,6,7,5,8.97825319541064,8.79936008317991,0.375020267019594,31
"3447","PB","Maturéia",6630,7928.77,25007,"Serra do Teixeira",2,"Nordeste",0,"250939",4,12,3,9,8,4,0,0,0,0,0,12,3,9,8,4,1,8.97825319541064,8.79936008317991,0.381262365385037,30
"3448","PB","Maturéia",6630,7928.77,25007,"Serra do Teixeira",2,"Nordeste",0,"250939",5,10,4,6,5,5,0,0,0,0,0,10,4,6,5,5,2,8.97825319541064,8.79936008317991,0.421897106381631,31
"3449","PB","Mogeiro",13261,9666.8,25018,"Itabaiana",2,"Nordeste",0,"250940",2,18,7,11,7,11,1,0,1,0,1,19,7,12,7,12,9,9.17645261330883,9.4925826756776,0.301634841510927,29
"3450","PB","Mogeiro",13261,9666.8,25018,"Itabaiana",2,"Nordeste",0,"250940",3,14,5,9,5,9,0,0,0,0,0,14,5,9,5,9,7,9.17645261330883,9.4925826756776,0.401654974633216,31
"3451","PB","Mogeiro",13261,9666.8,25018,"Itabaiana",2,"Nordeste",0,"250940",4,15,5,10,6,9,0,0,0,0,0,15,5,10,6,9,8,9.17645261330883,9.4925826756776,0.415173535774398,30
"3452","PB","Mogeiro",13261,9666.8,25018,"Itabaiana",2,"Nordeste",0,"250940",5,22,8,14,13,9,0,0,0,0,0,22,8,14,13,9,12,9.17645261330883,9.4925826756776,0.438786005490987,31
"3453","PB","Montadas",5738,8383.09,25014,"Esperança",2,"Nordeste",0,"250950",2,3,3,0,1,2,0,0,0,0,0,3,3,0,1,2,4,9.03397186059359,8.65486599654131,0.291323712992634,29
"3454","PB","Montadas",5738,8383.09,25014,"Esperança",2,"Nordeste",0,"250950",3,8,1,7,4,4,1,0,1,0,1,9,1,8,4,5,1,9.03397186059359,8.65486599654131,0.388189334961454,31
"3455","PB","Montadas",5738,8383.09,25014,"Esperança",2,"Nordeste",0,"250950",4,9,5,4,4,5,0,0,0,0,0,9,5,4,4,5,3,9.03397186059359,8.65486599654131,0.428824349177371,30
"3456","PB","Montadas",5738,8383.09,25014,"Esperança",2,"Nordeste",0,"250950",5,8,1,7,2,6,0,0,0,0,0,8,1,7,2,6,7,9.03397186059359,8.65486599654131,0.431836768829898,31
"3457","PB","Monteiro",33433,15980.78,25010,"Cariri Ocidental",2,"Nordeste",0,"250970",2,31,11,20,12,19,1,1,0,1,0,32,12,20,13,19,13,9.67914202914281,10.4172987151425,0.267507722516228,29
"3458","PB","Monteiro",33433,15980.78,25010,"Cariri Ocidental",2,"Nordeste",0,"250970",3,32,10,22,8,24,0,0,0,0,0,32,10,22,8,24,32,9.67914202914281,10.4172987151425,0.341353207270816,31
"3459","PB","Monteiro",33433,15980.78,25010,"Cariri Ocidental",2,"Nordeste",0,"250970",4,36,16,20,18,18,1,1,0,0,1,37,17,20,18,19,28,9.67914202914281,10.4172987151425,0.369483717327089,30
"3460","PB","Monteiro",33433,15980.78,25010,"Cariri Ocidental",2,"Nordeste",0,"250970",5,45,13,32,18,27,0,0,0,0,0,45,13,32,18,27,20,9.67914202914281,10.4172987151425,0.38218509040637,31
"3461","PB","Mulungu",9932,7756.48,25016,"Guarabira",2,"Nordeste",0,"250980",2,2,0,2,0,2,0,0,0,0,0,2,0,2,0,2,6,8.9562839020185,9.20351714662806,0.278576538592219,29
"3462","PB","Mulungu",9932,7756.48,25016,"Guarabira",2,"Nordeste",0,"250980",3,7,3,4,1,6,0,0,0,0,0,7,3,4,1,6,4,8.9562839020185,9.20351714662806,0.375669152303216,31
"3463","PB","Mulungu",9932,7756.48,25016,"Guarabira",2,"Nordeste",0,"250980",4,11,3,8,4,7,0,0,0,0,0,11,3,8,4,7,5,8.9562839020185,9.20351714662806,0.414135242497797,30
"3464","PB","Mulungu",9932,7756.48,25016,"Guarabira",2,"Nordeste",0,"250980",5,9,3,6,4,5,0,0,0,0,0,9,3,6,4,5,7,8.9562839020185,9.20351714662806,0.428744185910825,31
"3465","PB","Natuba",10451,7841.76,25019,"Umbuzeiro",2,"Nordeste",0,"250990",2,3,1,2,2,1,0,0,0,0,0,3,1,2,2,1,4,8.96721857794631,9.2544529465945,0.304630903762325,29
"3466","PB","Natuba",10451,7841.76,25019,"Umbuzeiro",2,"Nordeste",0,"250990",3,3,0,3,3,0,0,0,0,0,0,3,0,3,3,0,5,8.96721857794631,9.2544529465945,0.409614662460623,31
"3467","PB","Natuba",10451,7841.76,25019,"Umbuzeiro",2,"Nordeste",0,"250990",4,4,1,3,1,3,0,0,0,0,0,4,1,3,1,3,1,8.96721857794631,9.2544529465945,0.436926691591727,30
"3468","PB","Natuba",10451,7841.76,25019,"Umbuzeiro",2,"Nordeste",0,"250990",5,5,0,5,2,3,0,0,0,0,0,5,0,5,2,3,7,8.96721857794631,9.2544529465945,0.467091528196537,31
"3469","PB","Nova Floresta",10626,8024.47,25012,"Curimataú Ocidental",2,"Nordeste",1,"251010",2,8,2,6,3,5,0,0,0,0,0,8,2,6,3,5,5,8.99025090220353,9.27105910701089,0.30956399197252,29
"3470","PB","Nova Floresta",10626,8024.47,25012,"Curimataú Ocidental",2,"Nordeste",1,"251010",3,14,8,6,3,11,0,0,0,0,0,14,8,6,3,11,6,8.99025090220353,9.27105910701089,0.381047909153565,31
"3471","PB","Nova Floresta",10626,8024.47,25012,"Curimataú Ocidental",2,"Nordeste",1,"251010",4,9,4,5,3,6,0,0,0,0,0,9,4,5,3,6,10,8.99025090220353,9.27105910701089,0.409917031965825,30
"3472","PB","Nova Floresta",10626,8024.47,25012,"Curimataú Ocidental",2,"Nordeste",1,"251010",5,8,3,5,4,4,0,0,0,0,0,8,3,5,4,4,6,8.99025090220353,9.27105910701089,0.385124784614822,31
"3473","PB","Nova Palmeira",4959,8663.13,25009,"Seridó Oriental Paraibano",2,"Nordeste",0,"251030",2,1,0,1,1,0,0,0,0,0,0,1,0,1,1,0,4,9.06683136812639,8.50895938648913,0.247640805261749,29
"3474","PB","Nova Palmeira",4959,8663.13,25009,"Seridó Oriental Paraibano",2,"Nordeste",0,"251030",3,3,1,2,1,2,0,0,0,0,0,3,1,2,1,2,2,9.06683136812639,8.50895938648913,0.329981493448337,31
"3475","PB","Nova Palmeira",4959,8663.13,25009,"Seridó Oriental Paraibano",2,"Nordeste",0,"251030",4,1,0,1,0,1,0,0,0,0,0,1,0,1,0,1,2,9.06683136812639,8.50895938648913,0.381677030089088,30
"3476","PB","Nova Palmeira",4959,8663.13,25009,"Seridó Oriental Paraibano",2,"Nordeste",0,"251030",5,2,1,1,1,1,0,0,0,0,0,2,1,1,1,1,2,9.06683136812639,8.50895938648913,0.405413065459523,31
"3477","PB","Olho d'Água",6462,8264.66,25005,"Piancó",2,"Nordeste",0,"251040",2,7,4,3,1,6,0,0,0,0,0,7,4,3,1,6,1,9.01974387208289,8.77369414638444,0.300834158707053,29
"3478","PB","Olho d'Água",6462,8264.66,25005,"Piancó",2,"Nordeste",0,"251040",3,7,2,5,3,4,0,0,0,0,0,7,2,5,3,4,5,9.01974387208289,8.77369414638444,0.385395950340401,31
"3479","PB","Olho d'Água",6462,8264.66,25005,"Piancó",2,"Nordeste",0,"251040",4,9,0,9,7,2,0,0,0,0,0,9,0,9,7,2,10,9.01974387208289,8.77369414638444,0.41116933994034,30
"3480","PB","Olho d'Água",6462,8264.66,25005,"Piancó",2,"Nordeste",0,"251040",5,11,5,6,3,8,1,1,0,1,0,12,6,6,4,8,2,9.01974387208289,8.77369414638444,0.456002629988187,31
"3481","PB","Olivedos",3961,9418.52,25012,"Curimataú Ocidental",2,"Nordeste",0,"251050",2,1,1,0,1,0,0,0,0,0,0,1,1,0,1,0,1,9.1504332427004,8.28425179762192,0.287008215038461,29
"3482","PB","Olivedos",3961,9418.52,25012,"Curimataú Ocidental",2,"Nordeste",0,"251050",3,4,0,4,0,4,0,0,0,0,0,4,0,4,0,4,2,9.1504332427004,8.28425179762192,0.364525364643301,31
"3483","PB","Olivedos",3961,9418.52,25012,"Curimataú Ocidental",2,"Nordeste",0,"251050",4,4,0,4,0,4,0,0,0,0,0,4,0,4,0,4,3,9.1504332427004,8.28425179762192,0.378592892037681,30
"3484","PB","Olivedos",3961,9418.52,25012,"Curimataú Ocidental",2,"Nordeste",0,"251050",5,4,1,3,3,1,0,0,0,0,0,4,1,3,3,1,0,9.1504332427004,8.28425179762192,0.390111844704149,31
"3485","PB","Patos",108192,16208.14,25004,"Patos",2,"Nordeste",1,"251080",2,103,20,83,35,68,0,0,0,0,0,103,20,83,35,68,45,9.69326886416093,11.5916627055076,0.277223767178807,29
"3486","PB","Patos",108192,16208.14,25004,"Patos",2,"Nordeste",1,"251080",3,107,22,85,44,63,1,1,0,0,1,108,23,85,44,64,64,9.69326886416093,11.5916627055076,0.370402905118452,31
"3487","PB","Patos",108192,16208.14,25004,"Patos",2,"Nordeste",1,"251080",4,96,14,82,42,54,1,0,1,0,1,97,14,83,42,55,59,9.69326886416093,11.5916627055076,0.418122465877943,30
"3488","PB","Patos",108192,16208.14,25004,"Patos",2,"Nordeste",1,"251080",5,116,29,87,38,78,1,1,0,1,0,117,30,87,39,78,94,9.69326886416093,11.5916627055076,0.432141969638122,31
"3489","PB","Paulista",12379,10897.58,25003,"Sousa",2,"Nordeste",0,"251090",2,18,5,13,6,12,0,0,0,0,0,18,5,13,6,12,4,9.29629602521889,9.42375676753181,0.267173198930629,29
"3490","PB","Paulista",12379,10897.58,25003,"Sousa",2,"Nordeste",0,"251090",3,19,5,14,9,10,0,0,0,0,0,19,5,14,9,10,12,9.29629602521889,9.42375676753181,0.346379256225625,31
"3491","PB","Paulista",12379,10897.58,25003,"Sousa",2,"Nordeste",0,"251090",4,10,4,6,3,7,0,0,0,0,0,10,4,6,3,7,7,9.29629602521889,9.42375676753181,0.33007930453405,30
"3492","PB","Paulista",12379,10897.58,25003,"Sousa",2,"Nordeste",0,"251090",5,9,1,8,4,5,0,0,0,0,0,9,1,8,4,5,3,9.29629602521889,9.42375676753181,0.391416198713041,31
"3493","PB","Pedra Lavrada",7899,9229.35,25009,"Seridó Oriental Paraibano",2,"Nordeste",0,"251110",2,4,1,3,3,1,0,0,0,0,0,4,1,3,3,1,3,9.1301439024819,8.97449144816442,0.309209596251766,29
"3494","PB","Pedra Lavrada",7899,9229.35,25009,"Seridó Oriental Paraibano",2,"Nordeste",0,"251110",3,4,0,4,1,3,0,0,0,0,0,4,0,4,1,3,5,9.1301439024819,8.97449144816442,0.395236116916138,31
"3495","PB","Pedra Lavrada",7899,9229.35,25009,"Seridó Oriental Paraibano",2,"Nordeste",0,"251110",4,5,0,5,2,3,0,0,0,0,0,5,0,5,2,3,5,9.1301439024819,8.97449144816442,0.415025650904365,30
"3496","PB","Pedra Lavrada",7899,9229.35,25009,"Seridó Oriental Paraibano",2,"Nordeste",0,"251110",5,6,3,3,2,4,0,0,0,0,0,6,3,3,2,4,7,9.1301439024819,8.97449144816442,0.420899210496638,31
"3497","PB","Pedras de Fogo",28533,14740.66,25023,"Litoral Sul",2,"Nordeste",1,"251120",2,30,13,17,13,17,0,0,0,0,0,30,13,17,13,17,16,9.59836494086031,10.2588165911505,0.28565114536688,29
"3498","PB","Pedras de Fogo",28533,14740.66,25023,"Litoral Sul",2,"Nordeste",1,"251120",3,35,11,24,14,21,0,0,0,0,0,35,11,24,14,21,25,9.59836494086031,10.2588165911505,0.374699514397213,31
"3499","PB","Pedras de Fogo",28533,14740.66,25023,"Litoral Sul",2,"Nordeste",1,"251120",4,16,6,10,6,10,0,0,0,0,0,16,6,10,6,10,21,9.59836494086031,10.2588165911505,0.410636493928011,30
"3500","PB","Pedras de Fogo",28533,14740.66,25023,"Litoral Sul",2,"Nordeste",1,"251120",5,13,2,11,5,8,1,1,0,0,1,14,3,11,5,9,19,9.59836494086031,10.2588165911505,0.438713022433896,31
"3501","PB","Piancó",16111,11176.75,25005,"Piancó",2,"Nordeste",0,"251130",2,14,3,11,6,8,0,0,0,0,0,14,3,11,6,8,7,9.32159100677391,9.68725754749099,0.258625180740947,29
"3502","PB","Piancó",16111,11176.75,25005,"Piancó",2,"Nordeste",0,"251130",3,18,6,12,7,11,0,0,0,0,0,18,6,12,7,11,14,9.32159100677391,9.68725754749099,0.339601414163479,31
"3503","PB","Piancó",16111,11176.75,25005,"Piancó",2,"Nordeste",0,"251130",4,5,1,4,2,3,0,0,0,0,0,5,1,4,2,3,8,9.32159100677391,9.68725754749099,0.357948133214676,30
"3504","PB","Piancó",16111,11176.75,25005,"Piancó",2,"Nordeste",0,"251130",5,18,7,11,8,10,0,0,0,0,0,18,7,11,8,10,11,9.32159100677391,9.68725754749099,0.368678345490931,31
"3505","PB","Picuí",18720,9801.58,25009,"Seridó Oriental Paraibano",2,"Nordeste",0,"251140",2,14,3,11,8,6,0,0,0,0,0,14,3,11,8,6,8,9.19029887615319,9.83734775003158,0.27850741002221,29
"3506","PB","Picuí",18720,9801.58,25009,"Seridó Oriental Paraibano",2,"Nordeste",0,"251140",3,22,6,16,7,15,0,0,0,0,0,22,6,16,7,15,16,9.19029887615319,9.83734775003158,0.348796080944117,31
"3507","PB","Picuí",18720,9801.58,25009,"Seridó Oriental Paraibano",2,"Nordeste",0,"251140",4,17,4,13,9,8,0,0,0,0,0,17,4,13,9,8,13,9.19029887615319,9.83734775003158,0.3904587702963,30
"3508","PB","Picuí",18720,9801.58,25009,"Seridó Oriental Paraibano",2,"Nordeste",0,"251140",5,23,9,14,13,10,1,0,1,0,1,24,9,15,13,11,12,9.19029887615319,9.83734775003158,0.406483780960728,31
"3509","PB","Pilar",11977,8221.63,25021,"Sapé",2,"Nordeste",0,"251150",2,15,8,7,6,9,0,0,0,0,0,15,8,7,6,9,7,9.01452376522899,9.39074342294751,0.286820950508955,29
"3510","PB","Pilar",11977,8221.63,25021,"Sapé",2,"Nordeste",0,"251150",3,14,5,9,3,11,0,0,0,0,0,14,5,9,3,11,5,9.01452376522899,9.39074342294751,0.37901049582374,31
"3511","PB","Pilar",11977,8221.63,25021,"Sapé",2,"Nordeste",0,"251150",4,9,4,5,6,3,0,0,0,0,0,9,4,5,6,3,6,9.01452376522899,9.39074342294751,0.417001409300975,30
"3512","PB","Pilar",11977,8221.63,25021,"Sapé",2,"Nordeste",0,"251150",5,18,11,7,7,11,0,0,0,0,0,18,11,7,7,11,9,9.01452376522899,9.39074342294751,0.440926676138982,31
"3513","PB","Pilões",6576,11447.82,25015,"Brejo Paraibano",2,"Nordeste",0,"251160",2,6,4,2,3,3,0,0,0,0,0,6,4,2,3,3,4,9.34555459784223,8.79118193673602,0.281428735369238,29
"3514","PB","Pilões",6576,11447.82,25015,"Brejo Paraibano",2,"Nordeste",0,"251160",3,8,7,1,3,5,0,0,0,0,0,8,7,1,3,5,3,9.34555459784223,8.79118193673602,0.381587906703015,31
"3515","PB","Pilões",6576,11447.82,25015,"Brejo Paraibano",2,"Nordeste",0,"251160",4,11,3,8,4,7,0,0,0,0,0,11,3,8,4,7,4,9.34555459784223,8.79118193673602,0.403912443755974,30
"3516","PB","Pilões",6576,11447.82,25015,"Brejo Paraibano",2,"Nordeste",0,"251160",5,13,5,8,4,9,0,0,0,0,0,13,5,8,4,9,9,9.34555459784223,8.79118193673602,0.448905705257488,31
"3517","PB","Pilõezinhos",4955,9267.89,25016,"Guarabira",2,"Nordeste",1,"251170",2,2,1,1,2,0,0,0,0,0,0,2,1,1,2,0,5,9.13431101668598,8.50815244676409,0.280019257631563,29
"3518","PB","Pilõezinhos",4955,9267.89,25016,"Guarabira",2,"Nordeste",1,"251170",3,3,0,3,3,0,0,0,0,0,0,3,0,3,3,0,3,9.13431101668598,8.50815244676409,0.401532011311768,31
"3519","PB","Pilõezinhos",4955,9267.89,25016,"Guarabira",2,"Nordeste",1,"251170",4,8,5,3,3,5,0,0,0,0,0,8,5,3,3,5,4,9.13431101668598,8.50815244676409,0.406282111128603,30
"3520","PB","Pilõezinhos",4955,9267.89,25016,"Guarabira",2,"Nordeste",1,"251170",5,9,4,5,2,7,0,0,0,0,0,9,4,5,2,7,3,9.13431101668598,8.50815244676409,0.432877941827022,31
"3521","PB","Pirpirituba",10584,8320.31,25016,"Guarabira",2,"Nordeste",0,"251180",2,5,3,2,1,4,0,0,0,0,0,5,3,2,1,4,4,9.02645479273652,9.26709870579479,0.31426785408099,29
"3522","PB","Pirpirituba",10584,8320.31,25016,"Guarabira",2,"Nordeste",0,"251180",3,9,2,7,6,3,0,0,0,0,0,9,2,7,6,3,5,9.02645479273652,9.26709870579479,0.40937739946143,31
"3523","PB","Pirpirituba",10584,8320.31,25016,"Guarabira",2,"Nordeste",0,"251180",4,13,7,6,10,3,0,0,0,0,0,13,7,6,10,3,2,9.02645479273652,9.26709870579479,0.435824186869312,30
"3524","PB","Pirpirituba",10584,8320.31,25016,"Guarabira",2,"Nordeste",0,"251180",5,8,3,5,4,4,0,0,0,0,0,8,3,5,4,4,5,9.02645479273652,9.26709870579479,0.450248086355574,31
"3525","PB","Pitimbu",19275,13555.07,25023,"Litoral Sul",2,"Nordeste",0,"251190",2,21,7,14,6,15,0,0,0,0,0,21,7,14,6,15,6,9.5145159260655,9.86656419843153,0.309158814919801,29
"3526","PB","Pitimbu",19275,13555.07,25023,"Litoral Sul",2,"Nordeste",0,"251190",3,16,6,10,6,10,0,0,0,0,0,16,6,10,6,10,10,9.5145159260655,9.86656419843153,0.398067692332733,31
"3527","PB","Pitimbu",19275,13555.07,25023,"Litoral Sul",2,"Nordeste",0,"251190",4,18,7,11,13,5,0,0,0,0,0,18,7,11,13,5,10,9.5145159260655,9.86656419843153,0.444362911860665,30
"3528","PB","Pitimbu",19275,13555.07,25023,"Litoral Sul",2,"Nordeste",0,"251190",5,23,10,13,11,12,1,0,1,0,1,24,10,14,11,13,14,9.5145159260655,9.86656419843153,0.481036493757262,31
"3529","PB","Pocinhos",18708,12589.32,25012,"Curimataú Ocidental",2,"Nordeste",0,"251200",2,26,10,16,11,15,0,0,0,0,0,26,10,16,11,15,13,9.4406041144598,9.83670651884578,0.275703503255174,29
"3530","PB","Pocinhos",18708,12589.32,25012,"Curimataú Ocidental",2,"Nordeste",0,"251200",3,19,8,11,3,16,0,0,0,0,0,19,8,11,3,16,10,9.4406041144598,9.83670651884578,0.367139939574339,31
"3531","PB","Pocinhos",18708,12589.32,25012,"Curimataú Ocidental",2,"Nordeste",0,"251200",4,16,10,6,8,8,0,0,0,0,0,16,10,6,8,8,8,9.4406041144598,9.83670651884578,0.38843901800244,30
"3532","PB","Pocinhos",18708,12589.32,25012,"Curimataú Ocidental",2,"Nordeste",0,"251200",5,19,10,9,12,7,0,0,0,0,0,19,10,9,12,7,13,9.4406041144598,9.83670651884578,0.396283897039444,31
"3533","PB","Pombal",32802,12083.64,25003,"Sousa",2,"Nordeste",1,"251210",2,31,10,21,11,20,0,0,0,0,0,31,10,21,11,20,24,9.39960775060301,10.3982447681231,0.271357019242919,29
"3534","PB","Pombal",32802,12083.64,25003,"Sousa",2,"Nordeste",1,"251210",3,29,9,20,8,21,1,0,1,0,1,30,9,21,8,22,23,9.39960775060301,10.3982447681231,0.374959182627569,31
"3535","PB","Pombal",32802,12083.64,25003,"Sousa",2,"Nordeste",1,"251210",4,28,8,20,16,12,0,0,0,0,0,28,8,20,16,12,26,9.39960775060301,10.3982447681231,0.402516019630269,30
"3536","PB","Pombal",32802,12083.64,25003,"Sousa",2,"Nordeste",1,"251210",5,25,6,19,10,15,0,0,0,0,0,25,6,19,10,15,20,9.39960775060301,10.3982447681231,0.408072520856264,31
"3537","PB","Princesa Isabel",23549,9820.07,25007,"Serra do Teixeira",2,"Nordeste",0,"251230",2,23,5,18,9,14,0,0,0,0,0,23,5,18,9,14,16,9.19218352963268,10.066838635698,0.277032671591656,29
"3538","PB","Princesa Isabel",23549,9820.07,25007,"Serra do Teixeira",2,"Nordeste",0,"251230",3,25,5,20,10,15,0,0,0,0,0,25,5,20,10,15,15,9.19218352963268,10.066838635698,0.380512800334419,31
"3539","PB","Princesa Isabel",23549,9820.07,25007,"Serra do Teixeira",2,"Nordeste",0,"251230",4,15,6,9,9,6,0,0,0,0,0,15,6,9,9,6,12,9.19218352963268,10.066838635698,0.419134761082153,30
"3540","PB","Princesa Isabel",23549,9820.07,25007,"Serra do Teixeira",2,"Nordeste",0,"251230",5,19,8,11,7,12,0,0,0,0,0,19,8,11,7,12,11,9.19218352963268,10.066838635698,0.426920069224807,31
"3541","PB","Puxinanã",13741,7605.28,25017,"Campina Grande",2,"Nordeste",1,"251240",2,19,8,11,6,13,0,0,0,0,0,19,8,11,6,13,5,8.9365980218986,9.52813934333177,0.279438444116643,29
"3542","PB","Puxinanã",13741,7605.28,25017,"Campina Grande",2,"Nordeste",1,"251240",3,21,11,10,8,13,0,0,0,0,0,21,11,10,8,13,10,8.9365980218986,9.52813934333177,0.372768948202171,31
"3543","PB","Puxinanã",13741,7605.28,25017,"Campina Grande",2,"Nordeste",1,"251240",4,24,16,8,10,14,0,0,0,0,0,24,16,8,10,14,6,8.9365980218986,9.52813934333177,0.40894082084342,30
"3544","PB","Puxinanã",13741,7605.28,25017,"Campina Grande",2,"Nordeste",1,"251240",5,21,10,11,10,11,0,0,0,0,0,21,10,11,10,11,11,8.9365980218986,9.52813934333177,0.411978799338873,31
"3545","PB","Queimadas",44179,11037.55,25017,"Campina Grande",2,"Nordeste",1,"251250",2,47,7,40,18,29,0,0,0,0,0,47,7,40,18,29,22,9.30905837491328,10.6960048420416,0.290593869432316,29
"3546","PB","Queimadas",44179,11037.55,25017,"Campina Grande",2,"Nordeste",1,"251250",3,47,19,28,18,29,1,1,0,0,1,48,20,28,18,30,32,9.30905837491328,10.6960048420416,0.382765204984473,31
"3547","PB","Queimadas",44179,11037.55,25017,"Campina Grande",2,"Nordeste",1,"251250",4,54,20,34,18,36,0,0,0,0,0,54,20,34,18,36,22,9.30905837491328,10.6960048420416,0.407931058096501,30
"3548","PB","Queimadas",44179,11037.55,25017,"Campina Grande",2,"Nordeste",1,"251250",5,59,24,35,23,36,0,0,0,0,0,59,24,35,23,36,29,9.30905837491328,10.6960048420416,0.409821876791416,31
"3549","PB","Remígio",19798,8680.42,25012,"Curimataú Ocidental",2,"Nordeste",1,"251270",2,20,5,15,5,15,0,0,0,0,0,20,5,15,5,15,10,9.06882519358055,9.89333620147975,0.278166538918407,29
"3550","PB","Remígio",19798,8680.42,25012,"Curimataú Ocidental",2,"Nordeste",1,"251270",3,18,12,6,11,7,0,0,0,0,0,18,12,6,11,7,12,9.06882519358055,9.89333620147975,0.366239801549285,31
"3551","PB","Remígio",19798,8680.42,25012,"Curimataú Ocidental",2,"Nordeste",1,"251270",4,18,8,10,11,7,1,1,0,1,0,19,9,10,12,7,15,9.06882519358055,9.89333620147975,0.39018562922505,30
"3552","PB","Remígio",19798,8680.42,25012,"Curimataú Ocidental",2,"Nordeste",1,"251270",5,16,3,13,5,11,0,0,0,0,0,16,3,13,5,11,14,9.06882519358055,9.89333620147975,0.403776773415042,31
"3553","PB","Pedro Régis",6114,7962.88,25020,"Litoral Norte",2,"Nordeste",0,"251272",2,6,1,5,2,4,0,0,0,0,0,6,1,5,2,4,1,8.98254602244655,8.71833650245078,0.291275280220825,29
"3554","PB","Pedro Régis",6114,7962.88,25020,"Litoral Norte",2,"Nordeste",0,"251272",3,6,4,2,4,2,0,0,0,0,0,6,4,2,4,2,3,8.98254602244655,8.71833650245078,0.391700413816043,31
"3555","PB","Pedro Régis",6114,7962.88,25020,"Litoral Norte",2,"Nordeste",0,"251272",4,4,0,4,1,3,0,0,0,0,0,4,0,4,1,3,3,8.98254602244655,8.71833650245078,0.433077387353201,30
"3556","PB","Pedro Régis",6114,7962.88,25020,"Litoral Norte",2,"Nordeste",0,"251272",5,6,2,4,2,4,0,0,0,0,0,6,2,4,2,4,2,8.98254602244655,8.71833650245078,0.436216936146952,31
"3557","PB","Riachão do Bacamarte",4541,9433.23,25018,"Itabaiana",2,"Nordeste",0,"251275",2,8,1,7,2,6,0,0,0,0,0,8,1,7,2,6,3,9.15199384083962,8.42090253109795,0.336017583577905,29
"3558","PB","Riachão do Bacamarte",4541,9433.23,25018,"Itabaiana",2,"Nordeste",0,"251275",3,2,1,1,0,2,0,0,0,0,0,2,1,1,0,2,3,9.15199384083962,8.42090253109795,0.403127746504569,31
"3559","PB","Riachão do Bacamarte",4541,9433.23,25018,"Itabaiana",2,"Nordeste",0,"251275",4,4,1,3,1,3,0,0,0,0,0,4,1,3,1,3,2,9.15199384083962,8.42090253109795,0.472151882036043,30
"3560","PB","Riachão do Bacamarte",4541,9433.23,25018,"Itabaiana",2,"Nordeste",0,"251275",5,3,0,3,2,1,0,0,0,0,0,3,0,3,2,1,2,9.15199384083962,8.42090253109795,0.473649571187307,31
"3561","PB","Riachão do Poço",4540,10111.15,25021,"Sapé",2,"Nordeste",0,"251276",2,7,1,6,2,5,1,0,1,1,0,8,1,7,3,5,2,9.22139405430922,8.42068229103539,0.297786839023346,29
"3562","PB","Riachão do Poço",4540,10111.15,25021,"Sapé",2,"Nordeste",0,"251276",3,4,2,2,0,4,0,0,0,0,0,4,2,2,0,4,4,9.22139405430922,8.42068229103539,0.405225013404906,31
"3563","PB","Riachão do Poço",4540,10111.15,25021,"Sapé",2,"Nordeste",0,"251276",4,4,2,2,2,2,0,0,0,0,0,4,2,2,2,2,5,9.22139405430922,8.42068229103539,0.417041905233854,30
"3564","PB","Riachão do Poço",4540,10111.15,25021,"Sapé",2,"Nordeste",0,"251276",5,3,1,2,0,3,0,0,0,0,0,3,1,2,0,3,3,9.22139405430922,8.42068229103539,0.408147052327445,31
"3565","PB","Riacho dos Cavalos",8541,8544.64,25001,"Catolé do Rocha",2,"Nordeste",0,"251280",2,9,5,4,2,7,0,0,0,0,0,9,5,4,2,7,4,9.05305946476168,9.05263337594615,0.261971846923825,29
"3566","PB","Riacho dos Cavalos",8541,8544.64,25001,"Catolé do Rocha",2,"Nordeste",0,"251280",3,7,2,5,2,5,1,1,0,0,1,8,3,5,2,6,8,9.05305946476168,9.05263337594615,0.369593283660277,31
"3567","PB","Riacho dos Cavalos",8541,8544.64,25001,"Catolé do Rocha",2,"Nordeste",0,"251280",4,10,3,7,1,9,0,0,0,0,0,10,3,7,1,9,5,9.05305946476168,9.05263337594615,0.420909254831149,30
"3568","PB","Riacho dos Cavalos",8541,8544.64,25001,"Catolé do Rocha",2,"Nordeste",0,"251280",5,14,4,10,8,6,0,0,0,0,0,14,4,10,8,6,2,9.05305946476168,9.05263337594615,0.39178187168034,31
"3569","PB","Rio Tinto",24218,10163.45,25020,"Litoral Norte",2,"Nordeste",1,"251290",2,18,10,8,8,10,0,0,0,0,0,18,10,8,8,10,17,9.22655323042181,10.0948514373143,0.299072417412229,29
"3570","PB","Rio Tinto",24218,10163.45,25020,"Litoral Norte",2,"Nordeste",1,"251290",3,24,8,16,9,15,0,0,0,0,0,24,8,16,9,15,10,9.22655323042181,10.0948514373143,0.400506985142423,31
"3571","PB","Rio Tinto",24218,10163.45,25020,"Litoral Norte",2,"Nordeste",1,"251290",4,32,19,13,11,21,1,0,1,0,1,33,19,14,11,22,16,9.22655323042181,10.0948514373143,0.43085767023859,30
"3572","PB","Rio Tinto",24218,10163.45,25020,"Litoral Norte",2,"Nordeste",1,"251290",5,33,18,15,14,19,0,0,0,0,0,33,18,15,14,19,17,9.22655323042181,10.0948514373143,0.456162444300111,31
"3573","PB","Salgado de São Félix",12131,10351.73,25018,"Itabaiana",2,"Nordeste",0,"251310",2,9,3,6,6,3,0,0,0,0,0,9,3,6,6,3,4,9.24490893448401,9.40351943877092,0.330139669769109,29
"3574","PB","Salgado de São Félix",12131,10351.73,25018,"Itabaiana",2,"Nordeste",0,"251310",3,7,3,4,3,4,0,0,0,0,0,7,3,4,3,4,5,9.24490893448401,9.40351943877092,0.418371109379489,31
"3575","PB","Salgado de São Félix",12131,10351.73,25018,"Itabaiana",2,"Nordeste",0,"251310",4,9,5,4,3,6,0,0,0,0,0,9,5,4,3,6,8,9.24490893448401,9.40351943877092,0.455471764063989,30
"3576","PB","Salgado de São Félix",12131,10351.73,25018,"Itabaiana",2,"Nordeste",0,"251310",5,10,4,6,3,7,0,0,0,0,0,10,4,6,3,7,8,9.24490893448401,9.40351943877092,0.467970253684307,31
"3577","PB","Santa Cecília",6541,8124.67,25019,"Umbuzeiro",2,"Nordeste",0,"251315",2,8,2,6,6,2,0,0,0,0,0,8,2,6,6,2,3,9.0026603909885,8.78584533796121,0.311969423166264,29
"3578","PB","Santa Cecília",6541,8124.67,25019,"Umbuzeiro",2,"Nordeste",0,"251315",3,10,3,7,3,7,0,0,0,0,0,10,3,7,3,7,3,9.0026603909885,8.78584533796121,0.417282800239488,31
"3579","PB","Santa Cecília",6541,8124.67,25019,"Umbuzeiro",2,"Nordeste",0,"251315",4,5,3,2,3,2,0,0,0,0,0,5,3,2,3,2,5,9.0026603909885,8.78584533796121,0.439574912416291,30
"3580","PB","Santa Cecília",6541,8124.67,25019,"Umbuzeiro",2,"Nordeste",0,"251315",5,8,2,6,5,3,0,0,0,0,0,8,2,6,5,3,3,9.0026603909885,8.78584533796121,0.459909078678425,31
"3581","PB","Santa Helena",5871,8801.19,25002,"Cajazeiras",2,"Nordeste",0,"251330",2,1,0,1,1,0,0,0,0,0,0,1,0,1,1,0,4,9.08264221859664,8.67778025606419,0.288629899412844,29
"3582","PB","Santa Helena",5871,8801.19,25002,"Cajazeiras",2,"Nordeste",0,"251330",3,2,1,1,1,1,0,0,0,0,0,2,1,1,1,1,5,9.08264221859664,8.67778025606419,0.414837443917314,31
"3583","PB","Santa Helena",5871,8801.19,25002,"Cajazeiras",2,"Nordeste",0,"251330",4,6,3,3,2,4,0,0,0,0,0,6,3,3,2,4,6,9.08264221859664,8.67778025606419,0.412956336788856,30
"3584","PB","Santa Helena",5871,8801.19,25002,"Cajazeiras",2,"Nordeste",0,"251330",5,6,3,3,2,4,0,0,0,0,0,6,3,3,2,4,5,9.08264221859664,8.67778025606419,0.440251794372676,31
"3585","PB","Santa Luzia",15426,15200.87,25008,"Seridó Ocidental Paraibano",2,"Nordeste",1,"251340",2,11,2,9,5,6,0,0,0,0,0,11,2,9,5,6,10,9.62910794203851,9.64380967649394,0.249335272204511,29
"3586","PB","Santa Luzia",15426,15200.87,25008,"Seridó Ocidental Paraibano",2,"Nordeste",1,"251340",3,16,2,14,4,12,0,0,0,0,0,16,2,14,4,12,3,9.62910794203851,9.64380967649394,0.339401987420193,31
"3587","PB","Santa Luzia",15426,15200.87,25008,"Seridó Ocidental Paraibano",2,"Nordeste",1,"251340",4,15,1,14,5,10,0,0,0,0,0,15,1,14,5,10,7,9.62910794203851,9.64380967649394,0.396537901587341,30
"3588","PB","Santa Luzia",15426,15200.87,25008,"Seridó Ocidental Paraibano",2,"Nordeste",1,"251340",5,13,0,13,8,5,0,0,0,0,0,13,0,13,8,5,13,9.62910794203851,9.64380967649394,0.407568443596562,31
"3589","PB","Santa Rita",137349,17596.1,25022,"João Pessoa",2,"Nordeste",1,"251370",2,162,57,105,74,88,0,0,0,0,0,162,57,105,74,88,77,9.77543256556226,11.8302804108271,0.287679261220066,29
"3590","PB","Santa Rita",137349,17596.1,25022,"João Pessoa",2,"Nordeste",1,"251370",3,148,55,93,71,77,1,0,1,1,0,149,55,94,72,77,86,9.77543256556226,11.8302804108271,0.384558869730245,31
"3591","PB","Santa Rita",137349,17596.1,25022,"João Pessoa",2,"Nordeste",1,"251370",4,52,16,36,19,33,2,1,1,1,1,54,17,37,20,34,98,9.77543256556226,11.8302804108271,0.438610342272679,30
"3592","PB","Santa Rita",137349,17596.1,25022,"João Pessoa",2,"Nordeste",1,"251370",5,64,16,48,31,33,3,3,0,2,1,67,19,48,33,34,198,9.77543256556226,11.8302804108271,0.438220873645635,31
"3593","PB","Santa Teresinha",4562,9615.28,25004,"Patos",2,"Nordeste",0,"251380",2,7,2,5,3,4,0,0,0,0,0,7,2,5,3,4,3,9.17110877876371,8.42551640284433,0.278482175625612,29
"3594","PB","Santa Teresinha",4562,9615.28,25004,"Patos",2,"Nordeste",0,"251380",3,4,2,2,3,1,0,0,0,0,0,4,2,2,3,1,2,9.17110877876371,8.42551640284433,0.363913821345188,31
"3595","PB","Santa Teresinha",4562,9615.28,25004,"Patos",2,"Nordeste",0,"251380",4,6,0,6,0,6,0,0,0,0,0,6,0,6,0,6,3,9.17110877876371,8.42551640284433,0.427336631371684,30
"3596","PB","Santa Teresinha",4562,9615.28,25004,"Patos",2,"Nordeste",0,"251380",5,1,0,1,0,1,0,0,0,0,0,1,0,1,0,1,2,9.17110877876371,8.42551640284433,0.405350619978423,31
"3597","PB","São Bento",34344,12945.68,25001,"Catolé do Rocha",2,"Nordeste",1,"251390",2,31,20,11,17,14,0,0,0,0,0,31,20,11,17,14,18,9.46851742074033,10.4441826099044,0.257478852982084,29
"3598","PB","São Bento",34344,12945.68,25001,"Catolé do Rocha",2,"Nordeste",1,"251390",3,44,29,15,22,22,0,0,0,0,0,44,29,15,22,22,13,9.46851742074033,10.4441826099044,0.325733838240716,31
"3599","PB","São Bento",34344,12945.68,25001,"Catolé do Rocha",2,"Nordeste",1,"251390",4,32,16,16,17,15,0,0,0,0,0,32,16,16,17,15,13,9.46851742074033,10.4441826099044,0.339430421969106,30
"3600","PB","São Bento",34344,12945.68,25001,"Catolé do Rocha",2,"Nordeste",1,"251390",5,35,20,15,12,23,0,0,0,0,0,35,20,15,12,23,24,9.46851742074033,10.4441826099044,0.358620915753062,31
"3601","PB","São João do Cariri",4184,10376.35,25011,"Cariri Oriental",2,"Nordeste",0,"251400",2,5,2,3,2,3,0,0,0,0,0,5,2,3,2,3,3,9.24728445711589,8.33902300574476,0.268860671083639,29
"3602","PB","São João do Cariri",4184,10376.35,25011,"Cariri Oriental",2,"Nordeste",0,"251400",3,1,0,1,0,1,0,0,0,0,0,1,0,1,0,1,1,9.24728445711589,8.33902300574476,0.343421894354103,31
"3603","PB","São João do Cariri",4184,10376.35,25011,"Cariri Oriental",2,"Nordeste",0,"251400",4,2,0,2,1,1,0,0,0,0,0,2,0,2,1,1,3,9.24728445711589,8.33902300574476,0.421348420562659,30
"3604","PB","São João do Cariri",4184,10376.35,25011,"Cariri Oriental",2,"Nordeste",0,"251400",5,8,1,7,2,6,0,0,0,0,0,8,1,7,2,6,6,9.24728445711589,8.33902300574476,0.410460970178769,31
"3605","PB","São José dos Ramos",5998,8037.11,25021,"Sapé",2,"Nordeste",0,"251445",2,5,2,3,1,4,0,0,0,0,0,5,2,3,1,4,3,8.99182484481807,8.69918135930895,0.27340370421316,29
"3606","PB","São José dos Ramos",5998,8037.11,25021,"Sapé",2,"Nordeste",0,"251445",3,5,0,5,4,1,0,0,0,0,0,5,0,5,4,1,3,8.99182484481807,8.69918135930895,0.404907021098148,31
"3607","PB","São José dos Ramos",5998,8037.11,25021,"Sapé",2,"Nordeste",0,"251445",4,6,1,5,3,3,0,0,0,0,0,6,1,5,3,3,2,8.99182484481807,8.69918135930895,0.435140819071755,30
"3608","PB","São José dos Ramos",5998,8037.11,25021,"Sapé",2,"Nordeste",0,"251445",5,6,1,5,1,5,0,0,0,0,0,6,1,5,1,5,1,8.99182484481807,8.69918135930895,0.439862519100207,31
"3609","PB","São José de Piranhas",20329,9572.42,25002,"Cajazeiras",2,"Nordeste",0,"251450",2,19,12,7,11,8,0,0,0,0,0,19,12,7,11,8,8,9.16664132604309,9.91980371702106,0.272982117971715,29
"3610","PB","São José de Piranhas",20329,9572.42,25002,"Cajazeiras",2,"Nordeste",0,"251450",3,27,12,15,10,17,0,0,0,0,0,27,12,15,10,17,11,9.16664132604309,9.91980371702106,0.348972887349545,31
"3611","PB","São José de Piranhas",20329,9572.42,25002,"Cajazeiras",2,"Nordeste",0,"251450",4,14,8,6,8,6,0,0,0,0,0,14,8,6,8,6,12,9.16664132604309,9.91980371702106,0.365688706674474,30
"3612","PB","São José de Piranhas",20329,9572.42,25002,"Cajazeiras",2,"Nordeste",0,"251450",5,17,7,10,8,9,0,0,0,0,0,17,7,10,8,9,11,9.16664132604309,9.91980371702106,0.387461260833679,31
"3613","PB","São José do Sabugi",4147,27928.06,25008,"Seridó Ocidental Paraibano",2,"Nordeste",0,"251470",2,4,1,3,1,3,0,0,0,0,0,4,1,3,1,3,2,10.2373871971641,8.33014046024638,0.270610766600335,29
"3614","PB","São José do Sabugi",4147,27928.06,25008,"Seridó Ocidental Paraibano",2,"Nordeste",0,"251470",3,4,0,4,1,3,0,0,0,0,0,4,0,4,1,3,3,10.2373871971641,8.33014046024638,0.329428656669231,31
"3615","PB","São José do Sabugi",4147,27928.06,25008,"Seridó Ocidental Paraibano",2,"Nordeste",0,"251470",4,4,2,2,3,1,0,0,0,0,0,4,2,2,3,1,2,10.2373871971641,8.33014046024638,0.367225746248631,30
"3616","PB","São José do Sabugi",4147,27928.06,25008,"Seridó Ocidental Paraibano",2,"Nordeste",0,"251470",5,1,0,1,0,1,0,0,0,0,0,1,0,1,0,1,5,10.2373871971641,8.33014046024638,0.393944047388008,31
"3617","PB","São Mamede",7702,9134.93,25008,"Seridó Ocidental Paraibano",2,"Nordeste",0,"251490",2,10,4,6,6,4,1,0,1,1,0,11,4,7,7,4,5,9.1198608059475,8.94923531437485,0.309967891224378,29
"3618","PB","São Mamede",7702,9134.93,25008,"Seridó Ocidental Paraibano",2,"Nordeste",0,"251490",3,10,2,8,5,5,0,0,0,0,0,10,2,8,5,5,4,9.1198608059475,8.94923531437485,0.434117399660305,31
"3619","PB","São Mamede",7702,9134.93,25008,"Seridó Ocidental Paraibano",2,"Nordeste",0,"251490",4,8,4,4,4,4,0,0,0,0,0,8,4,4,4,4,5,9.1198608059475,8.94923531437485,0.449132303997291,30
"3620","PB","São Mamede",7702,9134.93,25008,"Seridó Ocidental Paraibano",2,"Nordeste",0,"251490",5,8,3,5,4,4,0,0,0,0,0,8,3,5,4,4,4,9.1198608059475,8.94923531437485,0.493972345382882,31
"3621","PB","São Miguel de Taipu",7410,9151.55,25021,"Sapé",2,"Nordeste",0,"251500",2,1,0,1,1,0,0,0,0,0,0,1,0,1,1,0,5,9.1216785428303,8.91058571829013,0.289325484098526,29
"3622","PB","São Miguel de Taipu",7410,9151.55,25021,"Sapé",2,"Nordeste",0,"251500",3,9,2,7,3,6,0,0,0,0,0,9,2,7,3,6,9,9.1216785428303,8.91058571829013,0.384448977336472,31
"3623","PB","São Miguel de Taipu",7410,9151.55,25021,"Sapé",2,"Nordeste",0,"251500",4,8,2,6,7,1,0,0,0,0,0,8,2,6,7,1,2,9.1216785428303,8.91058571829013,0.419829468807419,30
"3624","PB","São Miguel de Taipu",7410,9151.55,25021,"Sapé",2,"Nordeste",0,"251500",5,7,0,7,5,2,1,0,1,0,1,8,0,8,5,3,3,9.1216785428303,8.91058571829013,0.459682328124893,31
"3625","PB","São Sebastião de Lagoa de Roça",11728,8067.95,25014,"Esperança",2,"Nordeste",0,"251510",2,13,6,7,7,6,0,0,0,0,0,13,6,7,7,6,3,8.99565470173214,9.36973442412643,0.297805832280799,29
"3626","PB","São Sebastião de Lagoa de Roça",11728,8067.95,25014,"Esperança",2,"Nordeste",0,"251510",3,16,6,10,4,12,0,0,0,0,0,16,6,10,4,12,6,8.99565470173214,9.36973442412643,0.38394964427543,31
"3627","PB","São Sebastião de Lagoa de Roça",11728,8067.95,25014,"Esperança",2,"Nordeste",0,"251510",4,4,1,3,1,3,0,0,0,0,0,4,1,3,1,3,6,8.99565470173214,9.36973442412643,0.43164890765074,30
"3628","PB","São Sebastião de Lagoa de Roça",11728,8067.95,25014,"Esperança",2,"Nordeste",0,"251510",5,9,3,6,4,5,0,0,0,0,0,9,3,6,4,5,10,8.99565470173214,9.36973442412643,0.456654616928605,31
"3629","PB","Sapé",52804,10617.86,25021,"Sapé",2,"Nordeste",1,"251530",2,45,26,19,28,17,1,1,0,0,1,46,27,19,28,18,25,9.27029276789941,10.8743422244006,0.279583600617015,29
"3630","PB","Sapé",52804,10617.86,25021,"Sapé",2,"Nordeste",1,"251530",3,34,11,23,17,17,1,0,1,1,0,35,11,24,18,17,40,9.27029276789941,10.8743422244006,0.378617298326377,31
"3631","PB","Sapé",52804,10617.86,25021,"Sapé",2,"Nordeste",1,"251530",4,45,16,29,24,21,1,1,0,1,0,46,17,29,25,21,24,9.27029276789941,10.8743422244006,0.415028973642,30
"3632","PB","Sapé",52804,10617.86,25021,"Sapé",2,"Nordeste",1,"251530",5,54,23,31,29,25,0,0,0,0,0,54,23,31,29,25,46,9.27029276789941,10.8743422244006,0.417164860842657,31
"3633","PB","São Vicente do Seridó",10848,6794.64,25009,"Seridó Oriental Paraibano",2,"Nordeste",0,"251540",2,13,5,8,5,8,0,0,0,0,0,13,5,8,5,8,4,8.8238893450493,9.29173601018018,0.327238845751122,29
"3634","PB","São Vicente do Seridó",10848,6794.64,25009,"Seridó Oriental Paraibano",2,"Nordeste",0,"251540",3,20,5,15,6,14,0,0,0,0,0,20,5,15,6,14,1,8.8238893450493,9.29173601018018,0.433807409165784,31
"3635","PB","São Vicente do Seridó",10848,6794.64,25009,"Seridó Oriental Paraibano",2,"Nordeste",0,"251540",4,13,3,10,7,6,0,0,0,0,0,13,3,10,7,6,2,8.8238893450493,9.29173601018018,0.430640546222788,30
"3636","PB","São Vicente do Seridó",10848,6794.64,25009,"Seridó Oriental Paraibano",2,"Nordeste",0,"251540",5,17,5,12,6,11,0,0,0,0,0,17,5,12,6,11,4,8.8238893450493,9.29173601018018,0.475044101047155,31
"3637","PB","Serra Branca",13754,9233.06,25010,"Cariri Ocidental",2,"Nordeste",0,"251550",2,2,0,2,2,0,0,0,0,0,0,2,0,2,2,0,12,9.13054580018106,9.52908496987978,0.254663327653295,29
"3638","PB","Serra Branca",13754,9233.06,25010,"Cariri Ocidental",2,"Nordeste",0,"251550",3,4,2,2,2,2,0,0,0,0,0,4,2,2,2,2,6,9.13054580018106,9.52908496987978,0.337070311854497,31
"3639","PB","Serra Branca",13754,9233.06,25010,"Cariri Ocidental",2,"Nordeste",0,"251550",4,5,1,4,1,4,0,0,0,0,0,5,1,4,1,4,6,9.13054580018106,9.52908496987978,0.375946362966359,30
"3640","PB","Serra Branca",13754,9233.06,25010,"Cariri Ocidental",2,"Nordeste",0,"251550",5,5,0,5,2,3,0,0,0,0,0,5,0,5,2,3,11,9.13054580018106,9.52908496987978,0.376709833656405,31
"3641","PB","Serra Redonda",7021,8559.69,25017,"Campina Grande",2,"Nordeste",0,"251580",2,5,2,3,2,3,0,0,0,0,0,5,2,3,2,3,0,9.05481925352674,8.85666093701725,0.335348424306474,29
"3642","PB","Serra Redonda",7021,8559.69,25017,"Campina Grande",2,"Nordeste",0,"251580",3,4,1,3,0,4,0,0,0,0,0,4,1,3,0,4,9,9.05481925352674,8.85666093701725,0.413681364609735,31
"3643","PB","Serra Redonda",7021,8559.69,25017,"Campina Grande",2,"Nordeste",0,"251580",4,6,2,4,6,0,0,0,0,0,0,6,2,4,6,0,4,9.05481925352674,8.85666093701725,0.461736193799933,30
"3644","PB","Serra Redonda",7021,8559.69,25017,"Campina Grande",2,"Nordeste",0,"251580",5,16,6,10,7,9,0,0,0,0,0,16,6,10,7,9,5,9.05481925352674,8.85666093701725,0.458123990605723,31
"3645","PB","Serraria",6068,9376.14,25015,"Brejo Paraibano",2,"Nordeste",0,"251590",2,2,1,1,1,1,0,0,0,0,0,2,1,1,1,1,2,9.14592344344593,8.71078434046842,0.277221810398471,29
"3646","PB","Serraria",6068,9376.14,25015,"Brejo Paraibano",2,"Nordeste",0,"251590",3,3,2,1,2,1,0,0,0,0,0,3,2,1,2,1,5,9.14592344344593,8.71078434046842,0.35911274516037,31
"3647","PB","Serraria",6068,9376.14,25015,"Brejo Paraibano",2,"Nordeste",0,"251590",4,8,5,3,2,6,0,0,0,0,0,8,5,3,2,6,8,9.14592344344593,8.71078434046842,0.423584297305051,30
"3648","PB","Serraria",6068,9376.14,25015,"Brejo Paraibano",2,"Nordeste",0,"251590",5,3,2,1,2,1,0,0,0,0,0,3,2,1,2,1,5,9.14592344344593,8.71078434046842,0.466041142642375,31
"3649","PB","Sertãozinho",5089,9606.62,25016,"Guarabira",2,"Nordeste",0,"251593",2,1,1,0,1,0,0,0,0,0,0,1,1,0,1,0,1,9.17020772313592,8.53483662658883,0.264905006090344,29
"3650","PB","Sertãozinho",5089,9606.62,25016,"Guarabira",2,"Nordeste",0,"251593",3,2,1,1,1,1,0,0,0,0,0,2,1,1,1,1,4,9.17020772313592,8.53483662658883,0.382363421764248,31
"3651","PB","Sertãozinho",5089,9606.62,25016,"Guarabira",2,"Nordeste",0,"251593",4,8,3,5,1,7,1,1,0,0,1,9,4,5,1,8,4,9.17020772313592,8.53483662658883,0.420206770323673,30
"3652","PB","Sertãozinho",5089,9606.62,25016,"Guarabira",2,"Nordeste",0,"251593",5,9,5,4,4,5,0,0,0,0,0,9,5,4,4,5,4,9.17020772313592,8.53483662658883,0.43332406808369,31
"3653","PB","Sobrado",7815,11447.1,25021,"Sapé",2,"Nordeste",0,"251597",2,11,2,9,2,9,0,0,0,0,0,11,2,9,2,9,4,9.34549170179366,8.96380024285558,0.287641714502565,29
"3654","PB","Sobrado",7815,11447.1,25021,"Sapé",2,"Nordeste",0,"251597",3,9,4,5,7,2,0,0,0,0,0,9,4,5,7,2,2,9.34549170179366,8.96380024285558,0.399757471036749,31
"3655","PB","Sobrado",7815,11447.1,25021,"Sapé",2,"Nordeste",0,"251597",4,5,2,3,3,2,1,0,1,0,1,6,2,4,3,3,3,9.34549170179366,8.96380024285558,0.4644390265617,30
"3656","PB","Sobrado",7815,11447.1,25021,"Sapé",2,"Nordeste",0,"251597",5,5,1,4,0,5,0,0,0,0,0,5,1,4,0,5,3,9.34549170179366,8.96380024285558,0.47368764090915,31
"3657","PB","Solânea",26227,10755.63,25013,"Curimataú Oriental",2,"Nordeste",1,"251600",2,16,7,9,5,11,0,0,0,0,0,16,7,9,5,11,12,9.2831846173921,10.1745446934643,0.285784740299755,29
"3658","PB","Solânea",26227,10755.63,25013,"Curimataú Oriental",2,"Nordeste",1,"251600",3,23,11,12,8,15,0,0,0,0,0,23,11,12,8,15,20,9.2831846173921,10.1745446934643,0.367961213037861,31
"3659","PB","Solânea",26227,10755.63,25013,"Curimataú Oriental",2,"Nordeste",1,"251600",4,33,12,21,18,15,0,0,0,0,0,33,12,21,18,15,15,9.2831846173921,10.1745446934643,0.398311574653351,30
"3660","PB","Solânea",26227,10755.63,25013,"Curimataú Oriental",2,"Nordeste",1,"251600",5,40,25,15,22,18,0,0,0,0,0,40,25,15,22,18,16,9.2831846173921,10.1745446934643,0.411985819148804,31
"3661","PB","Soledade",15102,11269.1,25012,"Curimataú Ocidental",2,"Nordeste",0,"251610",2,14,8,6,6,8,1,1,0,1,0,15,9,6,7,8,8,9.32981974581483,9.62258246436337,0.270953101580309,29
"3662","PB","Soledade",15102,11269.1,25012,"Curimataú Ocidental",2,"Nordeste",0,"251610",3,18,10,8,7,11,0,0,0,0,0,18,10,8,7,11,11,9.32981974581483,9.62258246436337,0.37956949246175,31
"3663","PB","Soledade",15102,11269.1,25012,"Curimataú Ocidental",2,"Nordeste",0,"251610",4,16,9,7,6,10,0,0,0,0,0,16,9,7,6,10,6,9.32981974581483,9.62258246436337,0.406493295805027,30
"3664","PB","Soledade",15102,11269.1,25012,"Curimataú Ocidental",2,"Nordeste",0,"251610",5,16,9,7,6,10,0,0,0,0,0,16,9,7,6,10,5,9.32981974581483,9.62258246436337,0.396782312882672,31
"3665","PB","Sossêgo",3594,9326.74,25012,"Curimataú Ocidental",2,"Nordeste",0,"251615",2,6,3,3,3,3,0,0,0,0,0,6,3,3,3,3,2,9.14064082227956,8.1870210673435,0.288935788116847,29
"3666","PB","Sossêgo",3594,9326.74,25012,"Curimataú Ocidental",2,"Nordeste",0,"251615",3,7,5,2,4,3,0,0,0,0,0,7,5,2,4,3,4,9.14064082227956,8.1870210673435,0.345248603381939,31
"3667","PB","Sossêgo",3594,9326.74,25012,"Curimataú Ocidental",2,"Nordeste",0,"251615",4,7,3,4,2,5,0,0,0,0,0,7,3,4,2,5,0,9.14064082227956,8.1870210673435,0.384589680040484,30
"3668","PB","Sossêgo",3594,9326.74,25012,"Curimataú Ocidental",2,"Nordeste",0,"251615",5,2,1,1,1,1,0,0,0,0,0,2,1,1,1,1,2,9.14064082227956,8.1870210673435,0.399206378261972,31
"3669","PB","Sousa",69723,16215.67,25003,"Sousa",2,"Nordeste",1,"251620",2,74,23,51,32,42,0,0,0,0,0,74,23,51,32,42,41,9.69373333765343,11.1522855279681,0.278983742663599,29
"3670","PB","Sousa",69723,16215.67,25003,"Sousa",2,"Nordeste",1,"251620",3,89,29,60,38,51,2,0,2,0,2,91,29,62,38,53,37,9.69373333765343,11.1522855279681,0.369860050783276,31
"3671","PB","Sousa",69723,16215.67,25003,"Sousa",2,"Nordeste",1,"251620",4,86,20,66,33,53,1,1,0,0,1,87,21,66,33,54,33,9.69373333765343,11.1522855279681,0.389953919468443,30
"3672","PB","Sousa",69723,16215.67,25003,"Sousa",2,"Nordeste",1,"251620",5,79,20,59,29,50,0,0,0,0,0,79,20,59,29,50,38,9.69373333765343,11.1522855279681,0.404127573774862,31
"3673","PB","Sumé",17031,10389.04,25010,"Cariri Ocidental",2,"Nordeste",0,"251630",2,13,3,10,4,9,0,0,0,0,0,13,3,10,4,9,8,9.24850668328932,9.74279049183884,0.252974347027758,29
"3674","PB","Sumé",17031,10389.04,25010,"Cariri Ocidental",2,"Nordeste",0,"251630",3,17,6,11,7,10,0,0,0,0,0,17,6,11,7,10,13,9.24850668328932,9.74279049183884,0.318299785580943,31
"3675","PB","Sumé",17031,10389.04,25010,"Cariri Ocidental",2,"Nordeste",0,"251630",4,18,3,15,6,12,0,0,0,0,0,18,3,15,6,12,6,9.24850668328932,9.74279049183884,0.3382223227872,30
"3676","PB","Sumé",17031,10389.04,25010,"Cariri Ocidental",2,"Nordeste",0,"251630",5,28,10,18,10,18,0,0,0,0,0,28,10,18,10,18,14,9.24850668328932,9.74279049183884,0.368902858362012,31
"3677","PB","Tacima",10969,7086.62,25013,"Curimataú Oriental",2,"Nordeste",0,"251640",2,5,3,2,2,3,0,0,0,0,0,5,3,2,2,3,5,8.86596377806974,9.30282839141133,0.303200161100965,29
"3678","PB","Tacima",10969,7086.62,25013,"Curimataú Oriental",2,"Nordeste",0,"251640",3,8,1,7,4,4,0,0,0,0,0,8,1,7,4,4,4,8.86596377806974,9.30282839141133,0.403643753915957,31
"3679","PB","Tacima",10969,7086.62,25013,"Curimataú Oriental",2,"Nordeste",0,"251640",4,8,3,5,3,5,1,0,1,1,0,9,3,6,4,5,7,8.86596377806974,9.30282839141133,0.422013788458457,30
"3680","PB","Tacima",10969,7086.62,25013,"Curimataú Oriental",2,"Nordeste",0,"251640",5,9,4,5,6,3,0,0,0,0,0,9,4,5,6,3,5,8.86596377806974,9.30282839141133,0.451505068059908,31
"3681","PB","Taperoá",15441,8091.77,25010,"Cariri Ocidental",2,"Nordeste",0,"251650",2,14,5,9,6,8,0,0,0,0,0,14,5,9,6,8,11,8.99860277474973,9.64478158832086,0.287852141218841,29
"3682","PB","Taperoá",15441,8091.77,25010,"Cariri Ocidental",2,"Nordeste",0,"251650",3,19,8,11,5,14,0,0,0,0,0,19,8,11,5,14,9,8.99860277474973,9.64478158832086,0.368824791153966,31
"3683","PB","Taperoá",15441,8091.77,25010,"Cariri Ocidental",2,"Nordeste",0,"251650",4,13,8,5,4,9,0,0,0,0,0,13,8,5,4,9,8,8.99860277474973,9.64478158832086,0.385921065014089,30
"3684","PB","Taperoá",15441,8091.77,25010,"Cariri Ocidental",2,"Nordeste",0,"251650",5,16,8,8,10,6,0,0,0,0,0,16,8,8,10,6,13,8.99860277474973,9.64478158832086,0.412842892868648,31
"3685","PB","Tavares",14759,7909.38,25007,"Serra do Teixeira",2,"Nordeste",0,"251660",2,11,3,8,3,8,1,1,0,1,0,12,4,8,4,8,6,8.97580467589449,9.59960834518178,0.327392954695129,29
"3686","PB","Tavares",14759,7909.38,25007,"Serra do Teixeira",2,"Nordeste",0,"251660",3,16,6,10,7,9,0,0,0,0,0,16,6,10,7,9,9,8.97580467589449,9.59960834518178,0.407207744573672,31
"3687","PB","Tavares",14759,7909.38,25007,"Serra do Teixeira",2,"Nordeste",0,"251660",4,14,5,9,5,9,0,0,0,0,0,14,5,9,5,9,4,8.97580467589449,9.59960834518178,0.425237583662695,30
"3688","PB","Tavares",14759,7909.38,25007,"Serra do Teixeira",2,"Nordeste",0,"251660",5,8,4,4,5,3,0,0,0,0,0,8,4,4,5,3,11,8.97580467589449,9.59960834518178,0.427009626690205,31
"3689","PB","Teixeira",15248,9174.29,25007,"Serra do Teixeira",2,"Nordeste",0,"251670",2,22,12,10,6,16,1,0,1,1,0,23,12,11,7,16,6,9.12416028573227,9.63220362589398,0.291351740727701,29
"3690","PB","Teixeira",15248,9174.29,25007,"Serra do Teixeira",2,"Nordeste",0,"251670",3,27,5,22,12,15,0,0,0,0,0,27,5,22,12,15,12,9.12416028573227,9.63220362589398,0.354041957352327,31
"3691","PB","Teixeira",15248,9174.29,25007,"Serra do Teixeira",2,"Nordeste",0,"251670",4,20,6,14,9,11,1,1,0,0,1,21,7,14,9,12,5,9.12416028573227,9.63220362589398,0.368514463226883,30
"3692","PB","Teixeira",15248,9174.29,25007,"Serra do Teixeira",2,"Nordeste",0,"251670",5,17,1,16,5,12,1,1,0,1,0,18,2,16,6,12,11,9.12416028573227,9.63220362589398,0.407394718577218,31
"3693","PB","Triunfo",9464,7790.28,25002,"Cajazeiras",2,"Nordeste",0,"251680",2,3,1,2,1,2,0,0,0,0,0,3,1,2,1,2,7,8.96063208173617,9.15525040565822,0.283901489989978,29
"3694","PB","Triunfo",9464,7790.28,25002,"Cajazeiras",2,"Nordeste",0,"251680",3,3,2,1,1,2,0,0,0,0,0,3,2,1,1,2,6,8.96063208173617,9.15525040565822,0.390235918705572,31
"3695","PB","Triunfo",9464,7790.28,25002,"Cajazeiras",2,"Nordeste",0,"251680",4,3,1,2,1,2,0,0,0,0,0,3,1,2,1,2,9,8.96063208173617,9.15525040565822,0.406110994118603,30
"3696","PB","Triunfo",9464,7790.28,25002,"Cajazeiras",2,"Nordeste",0,"251680",5,8,4,4,5,3,0,0,0,0,0,8,4,4,5,3,7,8.96063208173617,9.15525040565822,0.402403889580403,31
"3697","PB","Uiraúna",15300,10908.57,25002,"Cajazeiras",2,"Nordeste",0,"251690",2,16,4,12,8,8,0,0,0,0,0,16,4,12,8,8,8,9.29730399782575,9.63560810738053,0.278515257412503,29
"3698","PB","Uiraúna",15300,10908.57,25002,"Cajazeiras",2,"Nordeste",0,"251690",3,16,4,12,9,7,0,0,0,0,0,16,4,12,9,7,7,9.29730399782575,9.63560810738053,0.378575519009607,31
"3699","PB","Uiraúna",15300,10908.57,25002,"Cajazeiras",2,"Nordeste",0,"251690",4,10,1,9,6,4,0,0,0,0,0,10,1,9,6,4,11,9.29730399782575,9.63560810738053,0.424884041337921,30
"3700","PB","Uiraúna",15300,10908.57,25002,"Cajazeiras",2,"Nordeste",0,"251690",5,12,3,9,4,8,0,0,0,0,0,12,3,9,4,8,10,9.29730399782575,9.63560810738053,0.411713560548454,31
"3701","PB","Umbuzeiro",9911,7520.42,25019,"Umbuzeiro",2,"Nordeste",0,"251700",2,12,5,7,5,7,0,0,0,0,0,12,5,7,5,7,8,8.9253772664481,9.20140053040671,0.32063933805511,29
"3702","PB","Umbuzeiro",9911,7520.42,25019,"Umbuzeiro",2,"Nordeste",0,"251700",3,6,1,5,2,4,0,0,0,0,0,6,1,5,2,4,5,8.9253772664481,9.20140053040671,0.418507290607954,31
"3703","PB","Umbuzeiro",9911,7520.42,25019,"Umbuzeiro",2,"Nordeste",0,"251700",4,5,2,3,3,2,0,0,0,0,0,5,2,3,3,2,5,8.9253772664481,9.20140053040671,0.464731645038985,30
"3704","PB","Umbuzeiro",9911,7520.42,25019,"Umbuzeiro",2,"Nordeste",0,"251700",5,13,4,9,7,6,0,0,0,0,0,13,4,9,7,6,9,8.9253772664481,9.20140053040671,0.475862906240315,31
"3705","PE","Abreu e Lima",100346,17320.77,26017,"Recife",2,"Nordeste",1,"260005",2,73,15,58,27,46,1,0,1,1,0,74,15,59,28,46,51,9.75966163840306,11.5163794929417,0.309823938119289,29
"3706","PE","Abreu e Lima",100346,17320.77,26017,"Recife",2,"Nordeste",1,"260005",3,97,24,73,36,61,3,2,1,1,2,100,26,74,37,63,67,9.75966163840306,11.5163794929417,0.423380342937216,31
"3707","PE","Abreu e Lima",100346,17320.77,26017,"Recife",2,"Nordeste",1,"260005",4,85,22,63,32,53,1,1,0,0,1,86,23,63,32,54,78,9.75966163840306,11.5163794929417,0.508729825043108,30
"3708","PE","Abreu e Lima",100346,17320.77,26017,"Recife",2,"Nordeste",1,"260005",5,94,24,70,42,52,1,0,1,0,1,95,24,71,42,53,126,9.75966163840306,11.5163794929417,0.495777132420838,31
"3709","PE","Afogados da Ingazeira",37404,11753.3,26003,"Pajeú",2,"Nordeste",1,"260010",2,47,2,45,20,27,0,0,0,0,0,47,2,45,20,27,18,9.37188933120486,10.5295329295553,0.258390410797482,29
"3710","PE","Afogados da Ingazeira",37404,11753.3,26003,"Pajeú",2,"Nordeste",1,"260010",3,53,4,49,16,37,1,1,0,1,0,54,5,49,17,37,27,9.37188933120486,10.5295329295553,0.342132198613206,31
"3711","PE","Afogados da Ingazeira",37404,11753.3,26003,"Pajeú",2,"Nordeste",1,"260010",4,45,4,41,16,29,0,0,0,0,0,45,4,41,16,29,31,9.37188933120486,10.5295329295553,0.393464341403793,30
"3712","PE","Afogados da Ingazeira",37404,11753.3,26003,"Pajeú",2,"Nordeste",1,"260010",5,62,5,57,32,30,0,0,0,0,0,62,5,57,32,30,23,9.37188933120486,10.5295329295553,0.378676224311148,31
"3713","PE","Afrânio",19810,8510.74,26005,"Petrolina",2,"Nordeste",0,"260020",2,25,6,19,10,15,1,1,0,0,1,26,7,19,10,16,10,9.04908417430866,9.8939421396926,0.246027418034256,29
"3714","PE","Afrânio",19810,8510.74,26005,"Petrolina",2,"Nordeste",0,"260020",3,16,7,9,5,11,3,0,3,1,2,19,7,12,6,13,10,9.04908417430866,9.8939421396926,0.324420312191797,31
"3715","PE","Afrânio",19810,8510.74,26005,"Petrolina",2,"Nordeste",0,"260020",4,22,5,17,13,9,1,0,1,1,0,23,5,18,14,9,15,9.04908417430866,9.8939421396926,0.375187608913559,30
"3716","PE","Afrânio",19810,8510.74,26005,"Petrolina",2,"Nordeste",0,"260020",5,12,6,6,4,8,0,0,0,0,0,12,6,6,4,8,15,9.04908417430866,9.8939421396926,0.41672549323057,31
"3717","PE","Agrestina",25065,10300.13,26012,"Brejo Pernambucano",2,"Nordeste",0,"260030",2,28,11,17,15,13,0,0,0,0,0,28,11,17,15,13,24,9.2399117954973,10.1292277296976,0.288334541335454,29
"3718","PE","Agrestina",25065,10300.13,26012,"Brejo Pernambucano",2,"Nordeste",0,"260030",3,26,10,16,15,11,0,0,0,0,0,26,10,16,15,11,19,9.2399117954973,10.1292277296976,0.37197343678406,31
"3719","PE","Agrestina",25065,10300.13,26012,"Brejo Pernambucano",2,"Nordeste",0,"260030",4,20,9,11,8,12,1,0,1,0,1,21,9,12,8,13,13,9.2399117954973,10.1292277296976,0.408816134582954,30
"3720","PE","Agrestina",25065,10300.13,26012,"Brejo Pernambucano",2,"Nordeste",0,"260030",5,27,10,17,12,15,0,0,0,0,0,27,10,17,12,15,27,9.2399117954973,10.1292277296976,0.406812813388089,31
"3721","PE","Água Preta",37082,6748.57,26015,"Mata Meridional Pernambucana",2,"Nordeste",0,"260040",2,25,7,18,15,10,1,1,0,1,0,26,8,18,16,10,12,8.81708590957095,10.5208869556578,0.294414495290183,29
"3722","PE","Água Preta",37082,6748.57,26015,"Mata Meridional Pernambucana",2,"Nordeste",0,"260040",3,32,14,18,19,13,2,0,2,0,2,34,14,20,19,15,19,8.81708590957095,10.5208869556578,0.395529078577561,31
"3723","PE","Água Preta",37082,6748.57,26015,"Mata Meridional Pernambucana",2,"Nordeste",0,"260040",4,25,9,16,16,9,1,0,1,0,1,26,9,17,16,10,26,8.81708590957095,10.5208869556578,0.434067019284048,30
"3724","PE","Água Preta",37082,6748.57,26015,"Mata Meridional Pernambucana",2,"Nordeste",0,"260040",5,24,8,16,14,10,1,0,1,1,0,25,8,17,15,10,37,8.81708590957095,10.5208869556578,0.452602963021906,31
"3725","PE","Águas Belas",43686,8140.21,26007,"Vale do Ipanema",2,"Nordeste",0,"260050",2,51,21,30,22,29,0,0,0,0,0,51,21,30,22,29,31,9.00457125718961,10.6847829636228,0.276291396248346,29
"3726","PE","Águas Belas",43686,8140.21,26007,"Vale do Ipanema",2,"Nordeste",0,"260050",3,52,31,21,25,27,0,0,0,0,0,52,31,21,25,27,31,9.00457125718961,10.6847829636228,0.34166257165401,31
"3727","PE","Águas Belas",43686,8140.21,26007,"Vale do Ipanema",2,"Nordeste",0,"260050",4,48,33,15,18,30,1,1,0,0,1,49,34,15,18,31,25,9.00457125718961,10.6847829636228,0.369567779033039,30
"3728","PE","Águas Belas",43686,8140.21,26007,"Vale do Ipanema",2,"Nordeste",0,"260050",5,67,43,24,35,32,1,0,1,1,0,68,43,25,36,32,42,9.00457125718961,10.6847829636228,0.424266467097591,31
"3729","PE","Alagoinha",14718,9132.16,26008,"Vale do Ipojuca",2,"Nordeste",0,"260060",2,17,10,7,7,10,0,0,0,0,0,17,10,7,7,10,9,9.11955752830216,9.59682651348654,0.307082454502204,29
"3730","PE","Alagoinha",14718,9132.16,26008,"Vale do Ipojuca",2,"Nordeste",0,"260060",3,18,8,10,5,13,0,0,0,0,0,18,8,10,5,13,5,9.11955752830216,9.59682651348654,0.404417245572704,31
"3731","PE","Alagoinha",14718,9132.16,26008,"Vale do Ipojuca",2,"Nordeste",0,"260060",4,10,4,6,6,4,0,0,0,0,0,10,4,6,6,4,13,9.11955752830216,9.59682651348654,0.469735632045584,30
"3732","PE","Alagoinha",14718,9132.16,26008,"Vale do Ipojuca",2,"Nordeste",0,"260060",5,16,1,15,9,7,0,0,0,0,0,16,1,15,9,7,7,9.11955752830216,9.59682651348654,0.466002301260255,31
"3733","PE","Aliança",38397,8207.74,26013,"Mata Setentrional Pernambucana",2,"Nordeste",0,"260070",2,38,23,15,24,14,0,0,0,0,0,38,23,15,24,14,25,9.01283289049559,10.5557346105239,0.302714179356461,29
"3734","PE","Aliança",38397,8207.74,26013,"Mata Setentrional Pernambucana",2,"Nordeste",0,"260070",3,33,19,14,20,13,0,0,0,0,0,33,19,14,20,13,38,9.01283289049559,10.5557346105239,0.388804990701997,31
"3735","PE","Aliança",38397,8207.74,26013,"Mata Setentrional Pernambucana",2,"Nordeste",0,"260070",4,31,12,19,17,14,0,0,0,0,0,31,12,19,17,14,28,9.01283289049559,10.5557346105239,0.451444359293875,30
"3736","PE","Aliança",38397,8207.74,26013,"Mata Setentrional Pernambucana",2,"Nordeste",0,"260070",5,45,23,22,22,23,0,0,0,0,0,45,23,22,22,23,38,9.01283289049559,10.5557346105239,0.437425889735695,31
"3737","PE","Altinho",22984,7489.78,26012,"Brejo Pernambucano",2,"Nordeste",0,"260080",2,23,8,15,8,15,1,0,1,0,1,24,8,16,8,16,15,8.92129470358322,10.0425536006591,0.308656047013746,29
"3738","PE","Altinho",22984,7489.78,26012,"Brejo Pernambucano",2,"Nordeste",0,"260080",3,20,7,13,7,13,0,0,0,0,0,20,7,13,7,13,16,8.92129470358322,10.0425536006591,0.384012589850955,31
"3739","PE","Altinho",22984,7489.78,26012,"Brejo Pernambucano",2,"Nordeste",0,"260080",4,15,5,10,8,7,0,0,0,0,0,15,5,10,8,7,14,8.92129470358322,10.0425536006591,0.414398409666519,30
"3740","PE","Altinho",22984,7489.78,26012,"Brejo Pernambucano",2,"Nordeste",0,"260080",5,13,5,8,8,5,0,0,0,0,0,13,5,8,8,5,16,8.92129470358322,10.0425536006591,0.428583849334193,31
"3741","PE","Amaraji",22870,9811.16,26015,"Mata Meridional Pernambucana",2,"Nordeste",1,"260090",2,19,8,11,12,7,0,0,0,0,0,19,8,11,12,7,18,9.19127579225587,10.0375812870168,0.284475951850433,29
"3742","PE","Amaraji",22870,9811.16,26015,"Mata Meridional Pernambucana",2,"Nordeste",1,"260090",3,23,7,16,12,11,1,1,0,1,0,24,8,16,13,11,12,9.19127579225587,10.0375812870168,0.359438162997532,31
"3743","PE","Amaraji",22870,9811.16,26015,"Mata Meridional Pernambucana",2,"Nordeste",1,"260090",4,20,6,14,8,12,0,0,0,0,0,20,6,14,8,12,14,9.19127579225587,10.0375812870168,0.383809697605881,30
"3744","PE","Amaraji",22870,9811.16,26015,"Mata Meridional Pernambucana",2,"Nordeste",1,"260090",5,21,7,14,11,10,0,0,0,0,0,21,7,14,11,10,24,9.19127579225587,10.0375812870168,0.409265078892489,31
"3745","PE","Angelim",11226,10702.15,26011,"Garanhuns",2,"Nordeste",0,"260100",2,14,6,8,10,4,1,0,1,0,1,15,6,9,10,5,6,9.27819993484479,9.32598779550214,0.281102616033341,29
"3746","PE","Angelim",11226,10702.15,26011,"Garanhuns",2,"Nordeste",0,"260100",3,13,7,6,9,4,0,0,0,0,0,13,7,6,9,4,7,9.27819993484479,9.32598779550214,0.3863234256857,31
"3747","PE","Angelim",11226,10702.15,26011,"Garanhuns",2,"Nordeste",0,"260100",4,9,4,5,3,6,0,0,0,0,0,9,4,5,3,6,6,9.27819993484479,9.32598779550214,0.409464413674242,30
"3748","PE","Angelim",11226,10702.15,26011,"Garanhuns",2,"Nordeste",0,"260100",5,25,12,13,13,12,0,0,0,0,0,25,12,13,13,12,9,9.27819993484479,9.32598779550214,0.423362454402964,31
"3749","PE","Araçoiaba",20733,6877.9,26016,"Itamaracá",2,"Nordeste",1,"260105",2,16,3,13,9,7,0,0,0,0,0,16,3,13,9,7,13,8.83606865177631,9.9394819127595,0.289726665693552,29
"3750","PE","Araçoiaba",20733,6877.9,26016,"Itamaracá",2,"Nordeste",1,"260105",3,22,5,17,9,13,0,0,0,0,0,22,5,17,9,13,10,8.83606865177631,9.9394819127595,0.355865750954584,31
"3751","PE","Araçoiaba",20733,6877.9,26016,"Itamaracá",2,"Nordeste",1,"260105",4,24,8,16,13,11,0,0,0,0,0,24,8,16,13,11,20,8.83606865177631,9.9394819127595,0.417821527201904,30
"3752","PE","Araçoiaba",20733,6877.9,26016,"Itamaracá",2,"Nordeste",1,"260105",5,20,5,15,12,8,0,0,0,0,0,20,5,15,12,8,15,8.83606865177631,9.9394819127595,0.400396504051709,31
"3753","PE","Araripina",84864,12298.15,26001,"Araripina",2,"Nordeste",0,"260110",2,110,52,58,48,62,4,3,1,1,3,114,55,59,49,65,41,9.41720412354425,11.3488052541055,0.281948306427616,29
"3754","PE","Araripina",84864,12298.15,26001,"Araripina",2,"Nordeste",0,"260110",3,119,59,60,55,64,1,1,0,0,1,120,60,60,55,65,55,9.41720412354425,11.3488052541055,0.371408844755728,31
"3755","PE","Araripina",84864,12298.15,26001,"Araripina",2,"Nordeste",0,"260110",4,118,48,70,69,49,2,0,2,2,0,120,48,72,71,49,55,9.41720412354425,11.3488052541055,0.414849801958567,30
"3756","PE","Araripina",84864,12298.15,26001,"Araripina",2,"Nordeste",0,"260110",5,121,53,68,69,52,5,1,4,0,5,126,54,72,69,57,51,9.41720412354425,11.3488052541055,0.4115546207585,31
"3757","PE","Arcoverde",74822,13647.4,26004,"Sertão do Moxotó",2,"Nordeste",1,"260120",2,70,21,49,32,38,1,1,0,1,0,71,22,49,33,38,42,9.52130430627974,11.2228672383655,0.281611057383919,29
"3758","PE","Arcoverde",74822,13647.4,26004,"Sertão do Moxotó",2,"Nordeste",1,"260120",3,95,33,62,39,56,0,0,0,0,0,95,33,62,39,56,47,9.52130430627974,11.2228672383655,0.378604717074126,31
"3759","PE","Arcoverde",74822,13647.4,26004,"Sertão do Moxotó",2,"Nordeste",1,"260120",4,76,35,41,39,37,1,1,0,0,1,77,36,41,39,38,51,9.52130430627974,11.2228672383655,0.442765613027646,30
"3760","PE","Arcoverde",74822,13647.4,26004,"Sertão do Moxotó",2,"Nordeste",1,"260120",5,97,32,65,43,54,0,0,0,0,0,97,32,65,43,54,58,9.52130430627974,11.2228672383655,0.429740077645042,31
"3761","PE","Barra de Guabiraba",14510,9061.75,26012,"Brejo Pernambucano",2,"Nordeste",1,"260130",2,11,5,6,7,4,0,0,0,0,0,11,5,6,7,4,5,9.11181753711756,9.58259334587823,0.284625147953865,29
"3762","PE","Barra de Guabiraba",14510,9061.75,26012,"Brejo Pernambucano",2,"Nordeste",1,"260130",3,8,3,5,5,3,0,0,0,0,0,8,3,5,5,3,14,9.11181753711756,9.58259334587823,0.370169708635593,31
"3763","PE","Barra de Guabiraba",14510,9061.75,26012,"Brejo Pernambucano",2,"Nordeste",1,"260130",4,11,5,6,7,4,0,0,0,0,0,11,5,6,7,4,10,9.11181753711756,9.58259334587823,0.377525966582083,30
"3764","PE","Barra de Guabiraba",14510,9061.75,26012,"Brejo Pernambucano",2,"Nordeste",1,"260130",5,15,9,6,7,8,0,0,0,0,0,15,9,6,7,8,13,9.11181753711756,9.58259334587823,0.409086453127373,31
"3765","PE","Barreiros",42764,9993.08,26015,"Mata Meridional Pernambucana",2,"Nordeste",1,"260140",2,40,21,19,20,20,0,0,0,0,0,40,21,19,20,20,26,9.20964813243367,10.6634519061334,0.305600819816231,29
"3766","PE","Barreiros",42764,9993.08,26015,"Mata Meridional Pernambucana",2,"Nordeste",1,"260140",3,33,12,21,15,18,0,0,0,0,0,33,12,21,15,18,24,9.20964813243367,10.6634519061334,0.40080361564255,31
"3767","PE","Barreiros",42764,9993.08,26015,"Mata Meridional Pernambucana",2,"Nordeste",1,"260140",4,54,21,33,35,19,0,0,0,0,0,54,21,33,35,19,26,9.20964813243367,10.6634519061334,0.456056741342579,30
"3768","PE","Barreiros",42764,9993.08,26015,"Mata Meridional Pernambucana",2,"Nordeste",1,"260140",5,62,19,43,33,29,1,0,1,0,1,63,19,44,33,30,66,9.20964813243367,10.6634519061334,0.458622416047309,31
"3769","PE","Belém de Maria",12122,6659.84,26015,"Mata Meridional Pernambucana",2,"Nordeste",0,"260150",2,10,2,8,7,3,0,0,0,0,0,10,2,8,7,3,6,8.80385073922183,9.40277726251123,0.307327402851472,29
"3770","PE","Belém de Maria",12122,6659.84,26015,"Mata Meridional Pernambucana",2,"Nordeste",0,"260150",3,16,4,12,6,10,0,0,0,0,0,16,4,12,6,10,9,8.80385073922183,9.40277726251123,0.402940481569329,31
"3771","PE","Belém de Maria",12122,6659.84,26015,"Mata Meridional Pernambucana",2,"Nordeste",0,"260150",4,8,5,3,0,8,0,0,0,0,0,8,5,3,0,8,7,8.80385073922183,9.40277726251123,0.423333914111445,30
"3772","PE","Belém de Maria",12122,6659.84,26015,"Mata Meridional Pernambucana",2,"Nordeste",0,"260150",5,11,6,5,5,6,0,0,0,0,0,11,6,5,5,6,9,8.80385073922183,9.40277726251123,0.429213545030809,31
"3773","PE","Belém do São Francisco",20730,14678.52,26006,"Itaparica",2,"Nordeste",0,"260160",2,17,5,12,9,8,0,0,0,0,0,17,5,12,9,8,7,9.5941404796474,9.93933720542983,0.255082606255091,29
"3774","PE","Belém do São Francisco",20730,14678.52,26006,"Itaparica",2,"Nordeste",0,"260160",3,14,3,11,8,6,0,0,0,0,0,14,3,11,8,6,14,9.5941404796474,9.93933720542983,0.365732269081977,31
"3775","PE","Belém do São Francisco",20730,14678.52,26006,"Itaparica",2,"Nordeste",0,"260160",4,26,8,18,17,9,0,0,0,0,0,26,8,18,17,9,8,9.5941404796474,9.93933720542983,0.398045804512886,30
"3776","PE","Belém do São Francisco",20730,14678.52,26006,"Itaparica",2,"Nordeste",0,"260160",5,24,11,13,15,9,1,1,0,0,1,25,12,13,15,10,13,9.5941404796474,9.93933720542983,0.421660246513331,31
"3777","PE","Belo Jardim",76687,24720.46,26008,"Vale do Ipojuca",2,"Nordeste",1,"260170",2,77,37,40,37,40,0,0,0,0,0,77,37,40,37,40,52,10.1153865198127,11.2474874814646,0.282249050028353,29
"3778","PE","Belo Jardim",76687,24720.46,26008,"Vale do Ipojuca",2,"Nordeste",1,"260170",3,94,32,62,35,59,1,0,1,1,0,95,32,63,36,59,58,10.1153865198127,11.2474874814646,0.375304297189034,31
"3779","PE","Belo Jardim",76687,24720.46,26008,"Vale do Ipojuca",2,"Nordeste",1,"260170",4,73,36,37,31,42,1,1,0,0,1,74,37,37,31,43,40,10.1153865198127,11.2474874814646,0.405439801860491,30
"3780","PE","Belo Jardim",76687,24720.46,26008,"Vale do Ipojuca",2,"Nordeste",1,"260170",5,89,39,50,44,45,0,0,0,0,0,89,39,50,44,45,60,10.1153865198127,11.2474874814646,0.399581059562757,31
"3781","PE","Betânia",12765,6933.84,26004,"Sertão do Moxotó",2,"Nordeste",0,"260180",2,9,2,7,4,5,0,0,0,0,0,9,2,7,4,5,7,8.84416905127439,9.45446232967558,0.28187103722821,29
"3782","PE","Betânia",12765,6933.84,26004,"Sertão do Moxotó",2,"Nordeste",0,"260180",3,12,1,11,6,6,0,0,0,0,0,12,1,11,6,6,9,8.84416905127439,9.45446232967558,0.370685938404097,31
"3783","PE","Betânia",12765,6933.84,26004,"Sertão do Moxotó",2,"Nordeste",0,"260180",4,12,2,10,6,6,0,0,0,0,0,12,2,10,6,6,7,8.84416905127439,9.45446232967558,0.372061867575841,30
"3784","PE","Betânia",12765,6933.84,26004,"Sertão do Moxotó",2,"Nordeste",0,"260180",5,13,4,9,4,9,1,0,1,0,1,14,4,10,4,10,7,8.84416905127439,9.45446232967558,0.413314913701503,31
"3785","PE","Bezerros",60880,11892.04,26008,"Vale do Ipojuca",2,"Nordeste",1,"260190",2,63,24,39,23,40,0,0,0,0,0,63,24,39,23,40,42,9.38362454771812,11.0166599925356,0.285635325562627,29
"3786","PE","Bezerros",60880,11892.04,26008,"Vale do Ipojuca",2,"Nordeste",1,"260190",3,63,34,29,26,37,0,0,0,0,0,63,34,29,26,37,54,9.38362454771812,11.0166599925356,0.381257877286021,31
"3787","PE","Bezerros",60880,11892.04,26008,"Vale do Ipojuca",2,"Nordeste",1,"260190",4,51,20,31,22,29,1,1,0,0,1,52,21,31,22,30,52,9.38362454771812,11.0166599925356,0.429848104028552,30
"3788","PE","Bezerros",60880,11892.04,26008,"Vale do Ipojuca",2,"Nordeste",1,"260190",5,52,20,32,25,27,0,0,0,0,0,52,20,32,25,27,56,9.38362454771812,11.0166599925356,0.428157236780332,31
"3789","PE","Bodocó",38378,7300.54,26001,"Araripina",2,"Nordeste",0,"260200",2,44,20,24,28,16,2,0,2,0,2,46,20,26,28,18,11,8.89570359700338,10.5552396577297,0.286213095512041,29
"3790","PE","Bodocó",38378,7300.54,26001,"Araripina",2,"Nordeste",0,"260200",3,39,15,24,17,22,0,0,0,0,0,39,15,24,17,22,17,8.89570359700338,10.5552396577297,0.36230064729501,31
"3791","PE","Bodocó",38378,7300.54,26001,"Araripina",2,"Nordeste",0,"260200",4,36,15,21,19,17,0,0,0,0,0,36,15,21,19,17,21,8.89570359700338,10.5552396577297,0.40264007224982,30
"3792","PE","Bodocó",38378,7300.54,26001,"Araripina",2,"Nordeste",0,"260200",5,51,21,30,25,26,1,1,0,0,1,52,22,30,25,27,18,8.89570359700338,10.5552396577297,0.439146442301228,31
"3793","PE","Bom Conselho",48767,10422.57,26011,"Garanhuns",2,"Nordeste",1,"260210",2,32,11,21,14,18,0,0,0,0,0,32,11,21,14,18,29,9.2517289259713,10.7948091335867,0.262962220644509,29
"3794","PE","Bom Conselho",48767,10422.57,26011,"Garanhuns",2,"Nordeste",1,"260210",3,23,14,9,10,13,2,1,1,0,2,25,15,10,10,15,23,9.2517289259713,10.7948091335867,0.358054613443059,31
"3795","PE","Bom Conselho",48767,10422.57,26011,"Garanhuns",2,"Nordeste",1,"260210",4,25,13,12,13,12,0,0,0,0,0,25,13,12,13,12,26,9.2517289259713,10.7948091335867,0.393209805819631,30
"3796","PE","Bom Conselho",48767,10422.57,26011,"Garanhuns",2,"Nordeste",1,"260210",5,29,15,14,14,15,1,1,0,1,0,30,16,14,15,15,28,9.2517289259713,10.7948091335867,0.399591976649537,31
"3797","PE","Bom Jardim",39983,8362.76,26010,"Médio Capibaribe",2,"Nordeste",0,"260220",2,42,20,22,12,30,3,0,3,1,2,45,20,25,13,32,18,9.03154379513403,10.596209642758,0.305332552881004,29
"3798","PE","Bom Jardim",39983,8362.76,26010,"Médio Capibaribe",2,"Nordeste",0,"260220",3,29,15,14,10,19,0,0,0,0,0,29,15,14,10,19,37,9.03154379513403,10.596209642758,0.393579709942443,31
"3799","PE","Bom Jardim",39983,8362.76,26010,"Médio Capibaribe",2,"Nordeste",0,"260220",4,41,8,33,17,24,0,0,0,0,0,41,8,33,17,24,30,9.03154379513403,10.596209642758,0.435005282747157,30
"3800","PE","Bom Jardim",39983,8362.76,26010,"Médio Capibaribe",2,"Nordeste",0,"260220",5,33,7,26,10,23,0,0,0,0,0,33,7,26,10,23,24,9.03154379513403,10.596209642758,0.429936435801069,31
"3801","PE","Bonito",38117,10236.8,26012,"Brejo Pernambucano",2,"Nordeste",0,"260230",2,48,23,25,27,21,0,0,0,0,0,48,23,25,27,21,25,9.2337443497552,10.5484156558255,0.287221926984014,29
"3802","PE","Bonito",38117,10236.8,26012,"Brejo Pernambucano",2,"Nordeste",0,"260230",3,40,19,21,18,22,0,0,0,0,0,40,19,21,18,22,35,9.2337443497552,10.5484156558255,0.37232689452033,31
"3803","PE","Bonito",38117,10236.8,26012,"Brejo Pernambucano",2,"Nordeste",0,"260230",4,44,24,20,22,22,0,0,0,0,0,44,24,20,22,22,28,9.2337443497552,10.5484156558255,0.392513818470703,30
"3804","PE","Bonito",38117,10236.8,26012,"Brejo Pernambucano",2,"Nordeste",0,"260230",5,44,20,24,23,21,0,0,0,0,0,44,20,24,23,21,33,9.2337443497552,10.5484156558255,0.416937248844477,31
"3805","PE","Brejão",8987,16099.94,26011,"Garanhuns",2,"Nordeste",0,"260240",2,10,6,4,2,8,0,0,0,0,0,10,6,4,2,8,6,9.68657082425753,9.10353436765837,0.295112723084265,29
"3806","PE","Brejão",8987,16099.94,26011,"Garanhuns",2,"Nordeste",0,"260240",3,7,2,5,5,2,0,0,0,0,0,7,2,5,5,2,7,9.68657082425753,9.10353436765837,0.41190778763131,31
"3807","PE","Brejão",8987,16099.94,26011,"Garanhuns",2,"Nordeste",0,"260240",4,12,7,5,4,8,1,1,0,1,0,13,8,5,5,8,4,9.68657082425753,9.10353436765837,0.465950836311154,30
"3808","PE","Brejão",8987,16099.94,26011,"Garanhuns",2,"Nordeste",0,"260240",5,9,4,5,3,6,0,0,0,0,0,9,4,5,3,6,7,9.68657082425753,9.10353436765837,0.450227552289203,31
"3809","PE","Brejinho",7488,7421.27,26003,"Pajeú",2,"Nordeste",0,"260250",2,8,0,8,1,7,0,0,0,0,0,8,0,8,1,7,2,8.91210548054504,8.92105701815743,0.307296696654173,29
"3810","PE","Brejinho",7488,7421.27,26003,"Pajeú",2,"Nordeste",0,"260250",3,8,2,6,3,5,1,0,1,1,0,9,2,7,4,5,5,8.91210548054504,8.92105701815743,0.441430239508049,31
"3811","PE","Brejinho",7488,7421.27,26003,"Pajeú",2,"Nordeste",0,"260250",4,6,1,5,2,4,0,0,0,0,0,6,1,5,2,4,6,8.91210548054504,8.92105701815743,0.470375992878055,30
"3812","PE","Brejinho",7488,7421.27,26003,"Pajeú",2,"Nordeste",0,"260250",5,10,3,7,0,10,0,0,0,0,0,10,3,7,0,10,6,8.91210548054504,8.92105701815743,0.448995871610343,31
"3813","PE","Brejo da Madre de Deus",51225,7467.16,26008,"Vale do Ipojuca",2,"Nordeste",1,"260260",2,45,21,24,25,20,0,0,0,0,0,45,21,24,25,20,31,8.91827001842097,10.8439829731071,0.300404639667563,29
"3814","PE","Brejo da Madre de Deus",51225,7467.16,26008,"Vale do Ipojuca",2,"Nordeste",1,"260260",3,51,22,29,23,28,0,0,0,0,0,51,22,29,23,28,26,8.91827001842097,10.8439829731071,0.384176092916367,31
"3815","PE","Brejo da Madre de Deus",51225,7467.16,26008,"Vale do Ipojuca",2,"Nordeste",1,"260260",4,70,35,35,38,32,2,1,1,1,1,72,36,36,39,33,26,8.91827001842097,10.8439829731071,0.41971543133795,30
"3816","PE","Brejo da Madre de Deus",51225,7467.16,26008,"Vale do Ipojuca",2,"Nordeste",1,"260260",5,56,32,24,18,38,0,0,0,0,0,56,32,24,18,38,23,8.91827001842097,10.8439829731071,0.41830929967887,31
"3817","PE","Buenos Aires",13190,7885.59,26013,"Mata Setentrional Pernambucana",2,"Nordeste",0,"260270",2,12,4,8,5,7,0,0,0,0,0,12,4,8,5,7,4,8.9727923222161,9.48721424571136,0.288647122514498,29
"3818","PE","Buenos Aires",13190,7885.59,26013,"Mata Setentrional Pernambucana",2,"Nordeste",0,"260270",3,12,3,9,8,4,0,0,0,0,0,12,3,9,8,4,5,8.9727923222161,9.48721424571136,0.377733900979717,31
"3819","PE","Buenos Aires",13190,7885.59,26013,"Mata Setentrional Pernambucana",2,"Nordeste",0,"260270",4,15,4,11,7,8,0,0,0,0,0,15,4,11,7,8,13,8.9727923222161,9.48721424571136,0.421414229924364,30
"3820","PE","Buenos Aires",13190,7885.59,26013,"Mata Setentrional Pernambucana",2,"Nordeste",0,"260270",5,11,2,9,4,7,0,0,0,0,0,11,2,9,4,7,11,8.9727923222161,9.48721424571136,0.419823294249722,31
"3821","PE","Buíque",58919,7037.04,26007,"Vale do Ipanema",2,"Nordeste",0,"260280",2,65,33,32,23,42,0,0,0,0,0,65,33,32,23,42,29,8.85894290619084,10.9839188982669,0.29848734165834,29
"3822","PE","Buíque",58919,7037.04,26007,"Vale do Ipanema",2,"Nordeste",0,"260280",3,54,19,35,29,25,2,2,0,0,2,56,21,35,29,27,24,8.85894290619084,10.9839188982669,0.385583097059458,31
"3823","PE","Buíque",58919,7037.04,26007,"Vale do Ipanema",2,"Nordeste",0,"260280",4,55,31,24,26,29,2,1,1,1,1,57,32,25,27,30,18,8.85894290619084,10.9839188982669,0.413783685548794,30
"3824","PE","Buíque",58919,7037.04,26007,"Vale do Ipanema",2,"Nordeste",0,"260280",5,59,33,26,33,26,1,0,1,0,1,60,33,27,33,27,40,8.85894290619084,10.9839188982669,0.423449033268085,31
"3825","PE","Cabo de Santo Agostinho",208944,47575.16,26018,"Suape",2,"Nordeste",1,"260290",2,193,49,144,95,98,0,0,0,0,0,193,49,144,95,98,114,10.7700660552696,12.2498215524602,0.306313736473049,29
"3826","PE","Cabo de Santo Agostinho",208944,47575.16,26018,"Suape",2,"Nordeste",1,"260290",3,207,51,156,99,108,1,1,0,1,0,208,52,156,100,108,144,10.7700660552696,12.2498215524602,0.406325695853257,31
"3827","PE","Cabo de Santo Agostinho",208944,47575.16,26018,"Suape",2,"Nordeste",1,"260290",4,234,64,170,106,128,1,0,1,1,0,235,64,171,107,128,166,10.7700660552696,12.2498215524602,0.476955515130723,30
"3828","PE","Cabo de Santo Agostinho",208944,47575.16,26018,"Suape",2,"Nordeste",1,"260290",5,246,84,162,121,125,2,1,1,1,1,248,85,163,122,126,289,10.7700660552696,12.2498215524602,0.466649734228755,31
"3829","PE","Cabrobó",34503,11320.36,26005,"Petrolina",2,"Nordeste",0,"260300",2,36,9,27,14,22,2,2,0,2,0,38,11,27,16,22,15,9.33435815337164,10.4488015557607,0.283154516604289,29
"3830","PE","Cabrobó",34503,11320.36,26005,"Petrolina",2,"Nordeste",0,"260300",3,29,2,27,16,13,0,0,0,0,0,29,2,27,16,13,13,9.33435815337164,10.4488015557607,0.36735969292787,31
"3831","PE","Cabrobó",34503,11320.36,26005,"Petrolina",2,"Nordeste",0,"260300",4,35,7,28,19,16,0,0,0,0,0,35,7,28,19,16,16,9.33435815337164,10.4488015557607,0.395407776940874,30
"3832","PE","Cabrobó",34503,11320.36,26005,"Petrolina",2,"Nordeste",0,"260300",5,46,10,36,19,27,0,0,0,0,0,46,10,36,19,27,22,9.33435815337164,10.4488015557607,0.383439405569169,31
"3833","PE","Cachoeirinha",20501,10761.58,26008,"Vale do Ipojuca",2,"Nordeste",1,"260310",2,19,9,10,12,7,1,1,0,0,1,20,10,10,12,8,13,9.28373766308452,9.92822894442457,0.288441365990485,29
"3834","PE","Cachoeirinha",20501,10761.58,26008,"Vale do Ipojuca",2,"Nordeste",1,"260310",3,31,13,18,17,14,1,0,1,1,0,32,13,19,18,14,12,9.28373766308452,9.92822894442457,0.356916200204483,31
"3835","PE","Cachoeirinha",20501,10761.58,26008,"Vale do Ipojuca",2,"Nordeste",1,"260310",4,24,11,13,10,14,1,0,1,0,1,25,11,14,10,15,13,9.28373766308452,9.92822894442457,0.39685452797537,30
"3836","PE","Cachoeirinha",20501,10761.58,26008,"Vale do Ipojuca",2,"Nordeste",1,"260310",5,17,7,10,8,9,0,0,0,0,0,17,7,10,8,9,10,9.28373766308452,9.92822894442457,0.37726567210113,31
"3837","PE","Caetés",28904,17024.13,26011,"Garanhuns",2,"Nordeste",0,"260320",2,27,10,17,9,18,1,0,1,1,0,28,10,18,10,18,11,9.74238702839041,10.2717352728275,0.296885473156542,29
"3838","PE","Caetés",28904,17024.13,26011,"Garanhuns",2,"Nordeste",0,"260320",3,31,18,13,12,19,0,0,0,0,0,31,18,13,12,19,12,9.74238702839041,10.2717352728275,0.403616785414189,31
"3839","PE","Caetés",28904,17024.13,26011,"Garanhuns",2,"Nordeste",0,"260320",4,27,14,13,13,14,1,0,1,1,0,28,14,14,14,14,16,9.74238702839041,10.2717352728275,0.434361992363246,30
"3840","PE","Caetés",28904,17024.13,26011,"Garanhuns",2,"Nordeste",0,"260320",5,38,11,27,16,22,0,0,0,0,0,38,11,27,16,22,16,9.74238702839041,10.2717352728275,0.443427915702352,31
"3841","PE","Calçado",11018,8436.07,26011,"Garanhuns",2,"Nordeste",0,"260330",2,8,2,6,3,5,0,0,0,0,0,8,2,6,3,5,6,9.04027183933569,9.30728557803266,0.283130614163036,29
"3842","PE","Calçado",11018,8436.07,26011,"Garanhuns",2,"Nordeste",0,"260330",3,6,3,3,3,3,0,0,0,0,0,6,3,3,3,3,7,9.04027183933569,9.30728557803266,0.396110830219266,31
"3843","PE","Calçado",11018,8436.07,26011,"Garanhuns",2,"Nordeste",0,"260330",4,14,3,11,6,8,0,0,0,0,0,14,3,11,6,8,1,9.04027183933569,9.30728557803266,0.402719980953458,30
"3844","PE","Calçado",11018,8436.07,26011,"Garanhuns",2,"Nordeste",0,"260330",5,7,3,4,2,5,0,0,0,0,0,7,3,4,2,5,7,9.04027183933569,9.30728557803266,0.423782348559772,31
"3845","PE","Calumbi",5747,8734.25,26003,"Pajeú",2,"Nordeste",0,"260340",2,5,0,5,3,2,0,0,0,0,0,5,0,5,3,2,5,9.07500735740503,8.65643325850774,0.303369773823103,29
"3846","PE","Calumbi",5747,8734.25,26003,"Pajeú",2,"Nordeste",0,"260340",3,5,3,2,2,3,0,0,0,0,0,5,3,2,2,3,7,9.07500735740503,8.65643325850774,0.389899620440536,31
"3847","PE","Calumbi",5747,8734.25,26003,"Pajeú",2,"Nordeste",0,"260340",4,5,1,4,3,2,0,0,0,0,0,5,1,4,3,2,3,9.07500735740503,8.65643325850774,0.405194720872644,30
"3848","PE","Calumbi",5747,8734.25,26003,"Pajeú",2,"Nordeste",0,"260340",5,8,5,3,2,6,0,0,0,0,0,8,5,3,2,6,4,9.07500735740503,8.65643325850774,0.408803584359141,31
"3849","PE","Camaragibe",158899,11807.42,26017,"Recife",2,"Nordeste",1,"260345",2,160,40,120,65,95,1,0,1,1,0,161,40,121,66,95,65,9.37648342639267,11.9760240592388,0.297202274810856,29
"3850","PE","Camaragibe",158899,11807.42,26017,"Recife",2,"Nordeste",1,"260345",3,146,35,111,59,87,1,1,0,0,1,147,36,111,59,88,110,9.37648342639267,11.9760240592388,0.41465995903883,31
"3851","PE","Camaragibe",158899,11807.42,26017,"Recife",2,"Nordeste",1,"260345",4,150,38,112,49,101,3,0,3,1,2,153,38,115,50,103,146,9.37648342639267,11.9760240592388,0.511762864723023,30
"3852","PE","Camaragibe",158899,11807.42,26017,"Recife",2,"Nordeste",1,"260345",5,180,60,120,64,116,2,0,2,1,1,182,60,122,65,117,204,9.37648342639267,11.9760240592388,0.504649986156319,31
"3853","PE","Camocim de São Félix",18900,8247.04,26012,"Brejo Pernambucano",2,"Nordeste",1,"260350",2,19,10,9,11,8,0,0,0,0,0,19,10,9,11,8,4,9.01760962707017,9.84691720104773,0.286213800094409,29
"3854","PE","Camocim de São Félix",18900,8247.04,26012,"Brejo Pernambucano",2,"Nordeste",1,"260350",3,19,12,7,11,8,0,0,0,0,0,19,12,7,11,8,12,9.01760962707017,9.84691720104773,0.367601594756747,31
"3855","PE","Camocim de São Félix",18900,8247.04,26012,"Brejo Pernambucano",2,"Nordeste",1,"260350",4,16,7,9,9,7,0,0,0,0,0,16,7,9,9,7,9,9.01760962707017,9.84691720104773,0.414257215855162,30
"3856","PE","Camocim de São Félix",18900,8247.04,26012,"Brejo Pernambucano",2,"Nordeste",1,"260350",5,18,7,11,8,10,0,0,0,0,0,18,7,11,8,10,15,9.01760962707017,9.84691720104773,0.399340041419362,31
"3857","PE","Camutanga",8572,15220.35,26013,"Mata Setentrional Pernambucana",2,"Nordeste",1,"260360",2,7,3,4,4,3,0,0,0,0,0,7,3,4,4,3,3,9.63038862720909,9.05625635659347,0.330669101115527,29
"3858","PE","Camutanga",8572,15220.35,26013,"Mata Setentrional Pernambucana",2,"Nordeste",1,"260360",3,10,4,6,5,5,0,0,0,0,0,10,4,6,5,5,4,9.63038862720909,9.05625635659347,0.397461058365809,31
"3859","PE","Camutanga",8572,15220.35,26013,"Mata Setentrional Pernambucana",2,"Nordeste",1,"260360",4,9,3,6,6,3,0,0,0,0,0,9,3,6,6,3,8,9.63038862720909,9.05625635659347,0.402177977576956,30
"3860","PE","Camutanga",8572,15220.35,26013,"Mata Setentrional Pernambucana",2,"Nordeste",1,"260360",5,10,7,3,6,4,0,0,0,0,0,10,7,3,6,4,7,9.63038862720909,9.05625635659347,0.457498476982475,31
"3861","PE","Canhotinho",24773,7621.24,26011,"Garanhuns",2,"Nordeste",0,"260370",2,25,13,12,10,15,0,0,0,0,0,25,13,12,10,15,16,8.93869436510045,10.1175096294008,0.28183853968021,29
"3862","PE","Canhotinho",24773,7621.24,26011,"Garanhuns",2,"Nordeste",0,"260370",3,28,16,12,15,13,0,0,0,0,0,28,16,12,15,13,13,8.93869436510045,10.1175096294008,0.354432247062549,31
"3863","PE","Canhotinho",24773,7621.24,26011,"Garanhuns",2,"Nordeste",0,"260370",4,31,18,13,13,18,0,0,0,0,0,31,18,13,13,18,16,8.93869436510045,10.1175096294008,0.381249145890146,30
"3864","PE","Canhotinho",24773,7621.24,26011,"Garanhuns",2,"Nordeste",0,"260370",5,27,13,14,10,17,0,0,0,0,0,27,13,14,10,17,20,8.93869436510045,10.1175096294008,0.400569680541871,31
"3865","PE","Capoeiras",20048,10614.15,26008,"Vale do Ipojuca",2,"Nordeste",0,"260380",2,20,8,12,9,11,0,0,0,0,0,20,8,12,9,11,11,9.2699432955661,9.90588467713585,0.31033714890459,29
"3866","PE","Capoeiras",20048,10614.15,26008,"Vale do Ipojuca",2,"Nordeste",0,"260380",3,17,6,11,5,12,0,0,0,0,0,17,6,11,5,12,19,9.2699432955661,9.90588467713585,0.384126227021256,31
"3867","PE","Capoeiras",20048,10614.15,26008,"Vale do Ipojuca",2,"Nordeste",0,"260380",4,18,6,12,5,13,0,0,0,0,0,18,6,12,5,13,10,9.2699432955661,9.90588467713585,0.432496179990665,30
"3868","PE","Capoeiras",20048,10614.15,26008,"Vale do Ipojuca",2,"Nordeste",0,"260380",5,26,7,19,12,14,0,0,0,0,0,26,7,19,12,14,13,9.2699432955661,9.90588467713585,0.437562740408585,31
"3869","PE","Carnaíba",19609,7930.56,26003,"Pajeú",2,"Nordeste",0,"260390",2,16,1,15,9,7,0,0,0,0,0,16,1,15,9,7,6,8.97847893004225,9.88374392349952,0.281241561831241,29
"3870","PE","Carnaíba",19609,7930.56,26003,"Pajeú",2,"Nordeste",0,"260390",3,19,3,16,11,8,0,0,0,0,0,19,3,16,11,8,11,8.97847893004225,9.88374392349952,0.355124993431697,31
"3871","PE","Carnaíba",19609,7930.56,26003,"Pajeú",2,"Nordeste",0,"260390",4,13,1,12,4,9,0,0,0,0,0,13,1,12,4,9,11,8.97847893004225,9.88374392349952,0.386515520811223,30
"3872","PE","Carnaíba",19609,7930.56,26003,"Pajeú",2,"Nordeste",0,"260390",5,19,3,16,8,11,0,0,0,0,0,19,3,16,8,11,13,8.97847893004225,9.88374392349952,0.381104132900489,31
"3873","PE","Carpina",84395,17467.92,26013,"Mata Setentrional Pernambucana",2,"Nordeste",1,"260400",2,66,16,50,26,40,0,0,0,0,0,66,16,50,26,40,44,9.7681213347919,11.343263437123,0.285388207769482,29
"3874","PE","Carpina",84395,17467.92,26013,"Mata Setentrional Pernambucana",2,"Nordeste",1,"260400",3,74,25,49,34,40,0,0,0,0,0,74,25,49,34,40,55,9.7681213347919,11.343263437123,0.386861831981819,31
"3875","PE","Carpina",84395,17467.92,26013,"Mata Setentrional Pernambucana",2,"Nordeste",1,"260400",4,74,20,54,41,33,0,0,0,0,0,74,20,54,41,33,55,9.7681213347919,11.343263437123,0.444751649777052,30
"3876","PE","Carpina",84395,17467.92,26013,"Mata Setentrional Pernambucana",2,"Nordeste",1,"260400",5,86,17,69,46,40,1,0,1,0,1,87,17,70,46,41,68,9.7681213347919,11.343263437123,0.437173972614759,31
"3877","PE","Caruaru",365278,20028.26,26008,"Vale do Ipojuca",2,"Nordeste",1,"260410",2,388,141,247,151,237,3,1,2,2,1,391,142,249,153,238,195,9.90489955519102,12.8084139864968,0.294223234491047,29
"3878","PE","Caruaru",365278,20028.26,26008,"Vale do Ipojuca",2,"Nordeste",1,"260410",3,438,165,273,184,254,6,2,4,5,1,444,167,277,189,255,230,9.90489955519102,12.8084139864968,0.402769007497538,31
"3879","PE","Caruaru",365278,20028.26,26008,"Vale do Ipojuca",2,"Nordeste",1,"260410",4,401,144,257,154,247,1,1,0,1,0,402,145,257,155,247,222,9.90489955519102,12.8084139864968,0.472181268364891,30
"3880","PE","Caruaru",365278,20028.26,26008,"Vale do Ipojuca",2,"Nordeste",1,"260410",5,461,183,278,184,277,1,1,0,1,0,462,184,278,185,277,246,9.90489955519102,12.8084139864968,0.451368621683134,31
"3881","PE","Casinhas",14368,6628.6,26009,"Alto Capibaribe",2,"Nordeste",0,"260415",2,16,7,9,4,12,0,0,0,0,0,16,7,9,4,12,9,8.79914889949457,9.57275879054198,0.303308115625362,29
"3882","PE","Casinhas",14368,6628.6,26009,"Alto Capibaribe",2,"Nordeste",0,"260415",3,17,6,11,6,11,0,0,0,0,0,17,6,11,6,11,8,8.79914889949457,9.57275879054198,0.415463050840037,31
"3883","PE","Casinhas",14368,6628.6,26009,"Alto Capibaribe",2,"Nordeste",0,"260415",4,15,4,11,8,7,0,0,0,0,0,15,4,11,8,7,5,8.79914889949457,9.57275879054198,0.469009003294109,30
"3884","PE","Casinhas",14368,6628.6,26009,"Alto Capibaribe",2,"Nordeste",0,"260415",5,13,6,7,4,9,0,0,0,0,0,13,6,7,4,9,15,8.79914889949457,9.57275879054198,0.460341944485247,31
"3885","PE","Catende",43340,6734.87,26015,"Mata Meridional Pernambucana",2,"Nordeste",1,"260420",2,27,13,14,10,17,0,0,0,0,0,27,13,14,10,17,13,8.81505378650524,10.6768312750904,0.285617493674395,29
"3886","PE","Catende",43340,6734.87,26015,"Mata Meridional Pernambucana",2,"Nordeste",1,"260420",3,38,19,19,21,17,1,0,1,1,0,39,19,20,22,17,26,8.81505378650524,10.6768312750904,0.369769531184412,31
"3887","PE","Catende",43340,6734.87,26015,"Mata Meridional Pernambucana",2,"Nordeste",1,"260420",4,30,10,20,16,14,0,0,0,0,0,30,10,20,16,14,22,8.81505378650524,10.6768312750904,0.413533078984603,30
"3888","PE","Catende",43340,6734.87,26015,"Mata Meridional Pernambucana",2,"Nordeste",1,"260420",5,33,16,17,17,16,1,1,0,0,1,34,17,17,17,17,41,8.81505378650524,10.6768312750904,0.429098643965475,31
"3889","PE","Cedro",11891,7556.35,26002,"Salgueiro",2,"Nordeste",0,"260430",2,9,2,7,5,4,0,0,0,0,0,9,2,7,5,4,1,8.93014354835328,9.38353709043758,0.277457833114001,29
"3890","PE","Cedro",11891,7556.35,26002,"Salgueiro",2,"Nordeste",0,"260430",3,15,2,13,4,11,0,0,0,0,0,15,2,13,4,11,7,8.93014354835328,9.38353709043758,0.364820564095855,31
"3891","PE","Cedro",11891,7556.35,26002,"Salgueiro",2,"Nordeste",0,"260430",4,10,3,7,6,4,0,0,0,0,0,10,3,7,6,4,7,8.93014354835328,9.38353709043758,0.40498400661848,30
"3892","PE","Cedro",11891,7556.35,26002,"Salgueiro",2,"Nordeste",0,"260430",5,12,3,9,6,6,0,0,0,0,0,12,3,9,6,6,5,8.93014354835328,9.38353709043758,0.415905681454118,31
"3893","PE","Chã de Alegria",13556,11135.31,26014,"Vitória de Santo Antão",2,"Nordeste",0,"260440",2,17,7,10,3,14,0,0,0,0,0,17,7,10,3,14,8,9.31787641944763,9.51458453272694,0.295276259846569,29
"3894","PE","Chã de Alegria",13556,11135.31,26014,"Vitória de Santo Antão",2,"Nordeste",0,"260440",3,10,3,7,6,4,0,0,0,0,0,10,3,7,6,4,6,9.31787641944763,9.51458453272694,0.381045779482862,31
"3895","PE","Chã de Alegria",13556,11135.31,26014,"Vitória de Santo Antão",2,"Nordeste",0,"260440",4,13,4,9,6,7,0,0,0,0,0,13,4,9,6,7,11,9.31787641944763,9.51458453272694,0.437368412941668,30
"3896","PE","Chã de Alegria",13556,11135.31,26014,"Vitória de Santo Antão",2,"Nordeste",0,"260440",5,18,4,14,8,10,0,0,0,0,0,18,4,14,8,10,14,9.31787641944763,9.51458453272694,0.448622951720246,31
"3897","PE","Chã Grande",21815,9261.23,26014,"Vitória de Santo Antão",2,"Nordeste",0,"260450",2,25,9,16,11,14,0,0,0,0,0,25,9,16,11,14,12,9.13359214819283,9.99035308555771,0.264065396358805,29
"3898","PE","Chã Grande",21815,9261.23,26014,"Vitória de Santo Antão",2,"Nordeste",0,"260450",3,9,5,4,5,4,0,0,0,0,0,9,5,4,5,4,13,9.13359214819283,9.99035308555771,0.346754192657645,31
"3899","PE","Chã Grande",21815,9261.23,26014,"Vitória de Santo Antão",2,"Nordeste",0,"260450",4,21,8,13,11,10,0,0,0,0,0,21,8,13,11,10,14,9.13359214819283,9.99035308555771,0.399384372494978,30
"3900","PE","Chã Grande",21815,9261.23,26014,"Vitória de Santo Antão",2,"Nordeste",0,"260450",5,20,10,10,10,10,0,0,0,0,0,20,10,10,10,10,24,9.13359214819283,9.99035308555771,0.412092710186279,31
"3901","PE","Condado",26590,8460.04,26013,"Mata Setentrional Pernambucana",2,"Nordeste",1,"260460",2,25,8,17,8,17,1,1,0,1,0,26,9,17,9,17,10,9.04310918072148,10.1882904842371,0.286500180634494,29
"3902","PE","Condado",26590,8460.04,26013,"Mata Setentrional Pernambucana",2,"Nordeste",1,"260460",3,29,12,17,14,15,0,0,0,0,0,29,12,17,14,15,24,9.04310918072148,10.1882904842371,0.385873001488845,31
"3903","PE","Condado",26590,8460.04,26013,"Mata Setentrional Pernambucana",2,"Nordeste",1,"260460",4,20,8,12,14,6,0,0,0,0,0,20,8,12,14,6,17,9.04310918072148,10.1882904842371,0.418765041373129,30
"3904","PE","Condado",26590,8460.04,26013,"Mata Setentrional Pernambucana",2,"Nordeste",1,"260460",5,23,9,14,9,14,0,0,0,0,0,23,9,14,9,14,36,9.04310918072148,10.1882904842371,0.426242225083866,31
"3905","PE","Correntes",18268,8255.79,26011,"Garanhuns",2,"Nordeste",0,"260470",2,12,9,3,3,9,0,0,0,0,0,12,9,3,3,9,7,9.01867005135133,9.81290617430489,0.296521484163774,29
"3906","PE","Correntes",18268,8255.79,26011,"Garanhuns",2,"Nordeste",0,"260470",3,17,10,7,6,11,0,0,0,0,0,17,10,7,6,11,6,9.01867005135133,9.81290617430489,0.379847700605016,31
"3907","PE","Correntes",18268,8255.79,26011,"Garanhuns",2,"Nordeste",0,"260470",4,10,4,6,3,7,0,0,0,0,0,10,4,6,3,7,9,9.01867005135133,9.81290617430489,0.432201110583285,30
"3908","PE","Correntes",18268,8255.79,26011,"Garanhuns",2,"Nordeste",0,"260470",5,21,16,5,9,12,0,0,0,0,0,21,16,5,9,12,6,9.01867005135133,9.81290617430489,0.420366454419921,31
"3909","PE","Cortês",12560,9488.45,26015,"Mata Meridional Pernambucana",2,"Nordeste",0,"260480",2,11,4,7,7,4,1,1,0,0,1,12,5,7,7,5,6,9.15783054844334,9.43827244002219,0.276675808233542,29
"3910","PE","Cortês",12560,9488.45,26015,"Mata Meridional Pernambucana",2,"Nordeste",0,"260480",3,8,3,5,1,7,0,0,0,0,0,8,3,5,1,7,9,9.15783054844334,9.43827244002219,0.363602353945351,31
"3911","PE","Cortês",12560,9488.45,26015,"Mata Meridional Pernambucana",2,"Nordeste",0,"260480",4,8,1,7,8,0,0,0,0,0,0,8,1,7,8,0,11,9.15783054844334,9.43827244002219,0.393853203800276,30
"3912","PE","Cortês",12560,9488.45,26015,"Mata Meridional Pernambucana",2,"Nordeste",0,"260480",5,15,5,10,7,8,0,0,0,0,0,15,5,10,7,8,22,9.15783054844334,9.43827244002219,0.423369025739532,31
"3913","PE","Cumaru",10192,8327.21,26010,"Médio Capibaribe",2,"Nordeste",0,"260490",2,11,5,6,2,9,0,0,0,0,0,11,5,6,2,9,5,9.02728374508439,9.22935837781194,0.301722274576569,29
"3914","PE","Cumaru",10192,8327.21,26010,"Médio Capibaribe",2,"Nordeste",0,"260490",3,12,7,5,7,5,0,0,0,0,0,12,7,5,7,5,9,9.02728374508439,9.22935837781194,0.381302464459187,31
"3915","PE","Cumaru",10192,8327.21,26010,"Médio Capibaribe",2,"Nordeste",0,"260490",4,9,5,4,3,6,0,0,0,0,0,9,5,4,3,6,7,9.02728374508439,9.22935837781194,0.408849458792552,30
"3916","PE","Cumaru",10192,8327.21,26010,"Médio Capibaribe",2,"Nordeste",0,"260490",5,10,6,4,7,3,1,1,0,0,1,11,7,4,7,4,13,9.02728374508439,9.22935837781194,0.430539903772315,31
"3917","PE","Cupira",24173,10979.96,26012,"Brejo Pernambucano",2,"Nordeste",1,"260500",2,29,11,18,17,12,0,0,0,0,0,29,11,18,17,12,18,9.30382707206964,10.0929915868061,0.312188613977502,29
"3918","PE","Cupira",24173,10979.96,26012,"Brejo Pernambucano",2,"Nordeste",1,"260500",3,22,10,12,11,11,1,0,1,0,1,23,10,13,11,12,22,9.30382707206964,10.0929915868061,0.383970026389059,31
"3919","PE","Cupira",24173,10979.96,26012,"Brejo Pernambucano",2,"Nordeste",1,"260500",4,26,14,12,8,18,0,0,0,0,0,26,14,12,8,18,9,9.30382707206964,10.0929915868061,0.401302045705761,30
"3920","PE","Cupira",24173,10979.96,26012,"Brejo Pernambucano",2,"Nordeste",1,"260500",5,26,8,18,16,10,2,1,1,2,0,28,9,19,18,10,22,9.30382707206964,10.0929915868061,0.38529114340808,31
"3921","PE","Custódia",37375,13498.42,26004,"Sertão do Moxotó",2,"Nordeste",0,"260510",2,39,8,31,16,23,0,0,0,0,0,39,8,31,16,23,14,9.51032792054012,10.528757310693,0.283032567733802,29
"3922","PE","Custódia",37375,13498.42,26004,"Sertão do Moxotó",2,"Nordeste",0,"260510",3,42,15,27,19,23,1,1,0,0,1,43,16,27,19,24,13,9.51032792054012,10.528757310693,0.361683415228731,31
"3923","PE","Custódia",37375,13498.42,26004,"Sertão do Moxotó",2,"Nordeste",0,"260510",4,50,11,39,22,28,0,0,0,0,0,50,11,39,22,28,11,9.51032792054012,10.528757310693,0.388102663281272,30
"3924","PE","Custódia",37375,13498.42,26004,"Sertão do Moxotó",2,"Nordeste",0,"260510",5,49,11,38,24,25,0,0,0,0,0,49,11,38,24,25,25,9.51032792054012,10.528757310693,0.409874961983149,31
"3925","PE","Dormentes",19079,11599.49,26005,"Petrolina",2,"Nordeste",0,"260515",2,20,6,14,9,11,0,0,0,0,0,20,6,14,9,11,11,9.3587164106107,9.85634353272731,0.255753164122464,29
"3926","PE","Dormentes",19079,11599.49,26005,"Petrolina",2,"Nordeste",0,"260515",3,12,4,8,7,5,0,0,0,0,0,12,4,8,7,5,10,9.3587164106107,9.85634353272731,0.341437727623882,31
"3927","PE","Dormentes",19079,11599.49,26005,"Petrolina",2,"Nordeste",0,"260515",4,22,14,8,9,13,1,1,0,1,0,23,15,8,10,13,8,9.3587164106107,9.85634353272731,0.368332369650982,30
"3928","PE","Dormentes",19079,11599.49,26005,"Petrolina",2,"Nordeste",0,"260515",5,26,7,19,12,14,0,0,0,0,0,26,7,19,12,14,14,9.3587164106107,9.85634353272731,0.405237820325432,31
"3929","PE","Escada",69292,13976.51,26015,"Mata Meridional Pernambucana",2,"Nordeste",1,"260520",2,47,16,31,25,22,1,0,1,0,1,48,16,32,25,23,42,9.54513334227575,11.1460847383988,0.303335772791023,29
"3930","PE","Escada",69292,13976.51,26015,"Mata Meridional Pernambucana",2,"Nordeste",1,"260520",3,62,19,43,29,33,0,0,0,0,0,62,19,43,29,33,54,9.54513334227575,11.1460847383988,0.39709743098349,31
"3931","PE","Escada",69292,13976.51,26015,"Mata Meridional Pernambucana",2,"Nordeste",1,"260520",4,50,14,36,27,23,0,0,0,0,0,50,14,36,27,23,46,9.54513334227575,11.1460847383988,0.446084405624584,30
"3932","PE","Escada",69292,13976.51,26015,"Mata Meridional Pernambucana",2,"Nordeste",1,"260520",5,59,20,39,24,35,0,0,0,0,0,59,20,39,24,35,97,9.54513334227575,11.1460847383988,0.456648810858732,31
"3933","PE","Exu",31766,8417.2,26001,"Araripina",2,"Nordeste",0,"260530",2,35,9,26,12,23,0,0,0,0,0,35,9,26,12,23,16,9.03803251036447,10.3661518143951,0.285331548922712,29
"3934","PE","Exu",31766,8417.2,26001,"Araripina",2,"Nordeste",0,"260530",3,32,12,20,22,10,2,1,1,0,2,34,13,21,22,12,18,9.03803251036447,10.3661518143951,0.371504825645613,31
"3935","PE","Exu",31766,8417.2,26001,"Araripina",2,"Nordeste",0,"260530",4,33,18,15,16,17,0,0,0,0,0,33,18,15,16,17,20,9.03803251036447,10.3661518143951,0.407756050296342,30
"3936","PE","Exu",31766,8417.2,26001,"Araripina",2,"Nordeste",0,"260530",5,40,10,30,16,24,0,0,0,0,0,40,10,30,16,24,17,9.03803251036447,10.3661518143951,0.414957063814332,31
"3937","PE","Feira Nova",22247,8679.6,26010,"Médio Capibaribe",2,"Nordeste",1,"260540",2,18,5,13,9,9,1,1,0,0,1,19,6,13,9,10,9,9.06873072364323,10.0099624470431,0.282378016668074,29
"3938","PE","Feira Nova",22247,8679.6,26010,"Médio Capibaribe",2,"Nordeste",1,"260540",3,31,12,19,13,18,1,1,0,1,0,32,13,19,14,18,17,9.06873072364323,10.0099624470431,0.355471607759376,31
"3939","PE","Feira Nova",22247,8679.6,26010,"Médio Capibaribe",2,"Nordeste",1,"260540",4,24,7,17,13,11,0,0,0,0,0,24,7,17,13,11,13,9.06873072364323,10.0099624470431,0.39796642958615,30
"3940","PE","Feira Nova",22247,8679.6,26010,"Médio Capibaribe",2,"Nordeste",1,"260540",5,23,12,11,10,13,0,0,0,0,0,23,12,11,10,13,26,9.06873072364323,10.0099624470431,0.406102302831861,31
"3941","PE","Ferreiros",12170,7832.56,26013,"Mata Setentrional Pernambucana",2,"Nordeste",0,"260550",2,4,2,2,2,2,0,0,0,0,0,4,2,2,2,2,7,8.96604468318641,9.40672918598157,0.292413727001968,29
"3942","PE","Ferreiros",12170,7832.56,26013,"Mata Setentrional Pernambucana",2,"Nordeste",0,"260550",3,8,2,6,3,5,0,0,0,0,0,8,2,6,3,5,4,8.96604468318641,9.40672918598157,0.372779536633323,31
"3943","PE","Ferreiros",12170,7832.56,26013,"Mata Setentrional Pernambucana",2,"Nordeste",0,"260550",4,13,8,5,5,8,0,0,0,0,0,13,8,5,5,8,9,8.96604468318641,9.40672918598157,0.427433219963971,30
"3944","PE","Ferreiros",12170,7832.56,26013,"Mata Setentrional Pernambucana",2,"Nordeste",0,"260550",5,9,5,4,3,6,2,0,2,0,2,11,5,6,3,8,16,8.96604468318641,9.40672918598157,0.449921363393055,31
"3945","PE","Flores",22618,7515.92,26003,"Pajeú",2,"Nordeste",0,"260560",2,21,7,14,7,14,0,0,0,0,0,21,7,14,7,14,7,8.92477871651715,10.0265013284313,0.291432457536519,29
"3946","PE","Flores",22618,7515.92,26003,"Pajeú",2,"Nordeste",0,"260560",3,22,5,17,9,13,0,0,0,0,0,22,5,17,9,13,12,8.92477871651715,10.0265013284313,0.356996639891041,31
"3947","PE","Flores",22618,7515.92,26003,"Pajeú",2,"Nordeste",0,"260560",4,17,4,13,6,11,0,0,0,0,0,17,4,13,6,11,11,8.92477871651715,10.0265013284313,0.402807057405773,30
"3948","PE","Flores",22618,7515.92,26003,"Pajeú",2,"Nordeste",0,"260560",5,16,1,15,12,4,0,0,0,0,0,16,1,15,12,4,16,8.92477871651715,10.0265013284313,0.434636888783867,31
"3949","PE","Floresta",33184,12865.92,26006,"Itaparica",2,"Nordeste",0,"260570",2,26,8,18,13,13,1,0,1,0,1,27,8,19,13,14,16,9.46233723401286,10.4098231110293,0.272810591371311,29
"3950","PE","Floresta",33184,12865.92,26006,"Itaparica",2,"Nordeste",0,"260570",3,44,14,30,27,17,0,0,0,0,0,44,14,30,27,17,18,9.46233723401286,10.4098231110293,0.358209835644662,31
"3951","PE","Floresta",33184,12865.92,26006,"Itaparica",2,"Nordeste",0,"260570",4,43,15,28,29,14,1,1,0,1,0,44,16,28,30,14,16,9.46233723401286,10.4098231110293,0.406131270468365,30
"3952","PE","Floresta",33184,12865.92,26006,"Itaparica",2,"Nordeste",0,"260570",5,40,10,30,20,20,1,1,0,0,1,41,11,30,20,21,18,9.46233723401286,10.4098231110293,0.41681861480888,31
"3953","PE","Frei Miguelinho",15546,7533.5,26009,"Alto Capibaribe",2,"Nordeste",0,"260580",2,9,4,5,5,4,0,0,0,0,0,9,4,5,5,4,14,8.92711502024134,9.65155864979016,0.308530424072618,29
"3954","PE","Frei Miguelinho",15546,7533.5,26009,"Alto Capibaribe",2,"Nordeste",0,"260580",3,6,2,4,2,4,0,0,0,0,0,6,2,4,2,4,10,8.92711502024134,9.65155864979016,0.397101141632343,31
"3955","PE","Frei Miguelinho",15546,7533.5,26009,"Alto Capibaribe",2,"Nordeste",0,"260580",4,7,2,5,1,6,0,0,0,0,0,7,2,5,1,6,12,8.92711502024134,9.65155864979016,0.44265298117192,30
"3956","PE","Frei Miguelinho",15546,7533.5,26009,"Alto Capibaribe",2,"Nordeste",0,"260580",5,8,2,6,3,5,0,0,0,0,0,8,2,6,3,5,17,8.92711502024134,9.65155864979016,0.428607582734119,31
"3957","PE","Gameleira",31318,7215.12,26015,"Mata Meridional Pernambucana",2,"Nordeste",0,"260590",2,17,6,11,8,9,0,0,0,0,0,17,6,11,8,9,14,8.88393410308629,10.3519482911054,0.313564267608502,29
"3958","PE","Gameleira",31318,7215.12,26015,"Mata Meridional Pernambucana",2,"Nordeste",0,"260590",3,18,9,9,13,5,1,0,1,1,0,19,9,10,14,5,19,8.88393410308629,10.3519482911054,0.3892086360704,31
"3959","PE","Gameleira",31318,7215.12,26015,"Mata Meridional Pernambucana",2,"Nordeste",0,"260590",4,24,10,14,16,8,0,0,0,0,0,24,10,14,16,8,17,8.88393410308629,10.3519482911054,0.424644280377342,30
"3960","PE","Gameleira",31318,7215.12,26015,"Mata Meridional Pernambucana",2,"Nordeste",0,"260590",5,24,12,12,14,10,0,0,0,0,0,24,12,12,14,10,19,8.88393410308629,10.3519482911054,0.431294210689898,31
"3961","PE","Garanhuns",140577,17565.52,26011,"Garanhuns",2,"Nordeste",1,"260600",2,169,60,109,64,105,1,1,0,1,0,170,61,109,65,105,74,9.77369316858851,11.85351066034,0.279799002138207,29
"3962","PE","Garanhuns",140577,17565.52,26011,"Garanhuns",2,"Nordeste",1,"260600",3,150,50,100,59,91,0,0,0,0,0,150,50,100,59,91,76,9.77369316858851,11.85351066034,0.38609890665228,31
"3963","PE","Garanhuns",140577,17565.52,26011,"Garanhuns",2,"Nordeste",1,"260600",4,150,40,110,47,103,5,0,5,0,5,155,40,115,47,108,72,9.77369316858851,11.85351066034,0.447163996292066,30
"3964","PE","Garanhuns",140577,17565.52,26011,"Garanhuns",2,"Nordeste",1,"260600",5,168,71,97,65,103,3,1,2,2,1,171,72,99,67,104,102,9.77369316858851,11.85351066034,0.435391089110703,31
"3965","PE","Glória do Goitá",30751,14973.38,26014,"Vitória de Santo Antão",2,"Nordeste",0,"260610",2,32,12,20,11,21,0,0,0,0,0,32,12,20,11,21,18,9.61402923683124,10.3336777930311,0.277362041031063,29
"3966","PE","Glória do Goitá",30751,14973.38,26014,"Vitória de Santo Antão",2,"Nordeste",0,"260610",3,21,9,12,9,12,0,0,0,0,0,21,9,12,9,12,13,9.61402923683124,10.3336777930311,0.354636736666633,31
"3967","PE","Glória do Goitá",30751,14973.38,26014,"Vitória de Santo Antão",2,"Nordeste",0,"260610",4,25,11,14,11,14,1,0,1,1,0,26,11,15,12,14,25,9.61402923683124,10.3336777930311,0.409589715378738,30
"3968","PE","Glória do Goitá",30751,14973.38,26014,"Vitória de Santo Antão",2,"Nordeste",0,"260610",5,22,4,18,11,11,0,0,0,0,0,22,4,18,11,11,34,9.61402923683124,10.3336777930311,0.418708460502038,31
"3969","PE","Goiana",80055,116122.91,26013,"Mata Setentrional Pernambucana",2,"Nordeste",1,"260620",2,91,31,60,45,46,1,0,1,0,1,92,31,61,45,47,40,11.662404478107,11.2904691774362,0.294157055547225,29
"3970","PE","Goiana",80055,116122.91,26013,"Mata Setentrional Pernambucana",2,"Nordeste",1,"260620",3,83,26,57,31,52,0,0,0,0,0,83,26,57,31,52,43,11.662404478107,11.2904691774362,0.386073151875207,31
"3971","PE","Goiana",80055,116122.91,26013,"Mata Setentrional Pernambucana",2,"Nordeste",1,"260620",4,74,22,52,40,34,1,0,1,0,1,75,22,53,40,35,40,11.662404478107,11.2904691774362,0.447069367155688,30
"3972","PE","Goiana",80055,116122.91,26013,"Mata Setentrional Pernambucana",2,"Nordeste",1,"260620",5,72,18,54,30,42,0,0,0,0,0,72,18,54,30,42,76,11.662404478107,11.2904691774362,0.442802599892571,31
"3973","PE","Granito",7537,9237.86,26001,"Araripina",2,"Nordeste",0,"260630",2,7,0,7,4,3,0,0,0,0,0,7,0,7,4,3,4,9.13106553608031,8.92757950384347,0.286469130571359,29
"3974","PE","Granito",7537,9237.86,26001,"Araripina",2,"Nordeste",0,"260630",3,8,4,4,1,7,1,0,1,0,1,9,4,5,1,8,12,9.13106553608031,8.92757950384347,0.395678738964374,31
"3975","PE","Granito",7537,9237.86,26001,"Araripina",2,"Nordeste",0,"260630",4,3,1,2,0,3,0,0,0,0,0,3,1,2,0,3,2,9.13106553608031,8.92757950384347,0.438219439937908,30
"3976","PE","Granito",7537,9237.86,26001,"Araripina",2,"Nordeste",0,"260630",5,14,3,11,6,8,0,0,0,0,0,14,3,11,6,8,0,9.13106553608031,8.92757950384347,0.448775829897363,31
"3977","PE","Gravatá",84699,13479.21,26008,"Vale do Ipojuca",2,"Nordeste",1,"260640",2,63,29,34,22,41,1,0,1,1,0,64,29,35,23,41,57,9.50890377740769,11.346859074195,0.264726621493157,29
"3978","PE","Gravatá",84699,13479.21,26008,"Vale do Ipojuca",2,"Nordeste",1,"260640",3,68,17,51,30,38,0,0,0,0,0,68,17,51,30,38,47,9.50890377740769,11.346859074195,0.362004972288887,31
"3979","PE","Gravatá",84699,13479.21,26008,"Vale do Ipojuca",2,"Nordeste",1,"260640",4,66,23,43,35,31,1,1,0,0,1,67,24,43,35,32,45,9.50890377740769,11.346859074195,0.425600599246246,30
"3980","PE","Gravatá",84699,13479.21,26008,"Vale do Ipojuca",2,"Nordeste",1,"260640",5,78,33,45,34,44,0,0,0,0,0,78,33,45,34,44,59,9.50890377740769,11.346859074195,0.418087508309637,31
"3981","PE","Iati",19241,8458.26,26011,"Garanhuns",2,"Nordeste",0,"260650",2,22,10,12,11,11,1,0,1,0,1,23,10,13,11,12,13,9.04289875768766,9.86479869792102,0.300563185704751,29
"3982","PE","Iati",19241,8458.26,26011,"Garanhuns",2,"Nordeste",0,"260650",3,16,9,7,9,7,1,0,1,1,0,17,9,8,10,7,3,9.04289875768766,9.86479869792102,0.363427732236864,31
"3983","PE","Iati",19241,8458.26,26011,"Garanhuns",2,"Nordeste",0,"260650",4,20,14,6,10,10,0,0,0,0,0,20,14,6,10,10,15,9.04289875768766,9.86479869792102,0.404400358372311,30
"3984","PE","Iati",19241,8458.26,26011,"Garanhuns",2,"Nordeste",0,"260650",5,22,10,12,12,10,0,0,0,0,0,22,10,12,12,10,11,9.04289875768766,9.86479869792102,0.433213235567207,31
"3985","PE","Ibimirim",29412,8930.46,26004,"Sertão do Moxotó",2,"Nordeste",0,"260660",2,27,10,17,11,16,0,0,0,0,0,27,10,17,11,16,10,9.09722318430198,10.2891580333161,0.292312960878762,29
"3986","PE","Ibimirim",29412,8930.46,26004,"Sertão do Moxotó",2,"Nordeste",0,"260660",3,23,10,13,10,13,0,0,0,0,0,23,10,13,10,13,13,9.09722318430198,10.2891580333161,0.371115756686374,31
"3987","PE","Ibimirim",29412,8930.46,26004,"Sertão do Moxotó",2,"Nordeste",0,"260660",4,24,9,15,11,13,1,1,0,0,1,25,10,15,11,14,20,9.09722318430198,10.2891580333161,0.396916299004059,30
"3988","PE","Ibimirim",29412,8930.46,26004,"Sertão do Moxotó",2,"Nordeste",0,"260660",5,33,16,17,19,14,0,0,0,0,0,33,16,17,19,14,17,9.09722318430198,10.2891580333161,0.425487922339604,31
"3989","PE","Ibirajuba",7768,7834.74,26012,"Brejo Pernambucano",2,"Nordeste",0,"260670",2,4,1,3,1,3,0,0,0,0,0,4,1,3,1,3,8,8.96632296981066,8.95776800997116,0.315717570120923,29
"3990","PE","Ibirajuba",7768,7834.74,26012,"Brejo Pernambucano",2,"Nordeste",0,"260670",3,6,3,3,6,0,0,0,0,0,0,6,3,3,6,0,3,8.96632296981066,8.95776800997116,0.447363643214968,31
"3991","PE","Ibirajuba",7768,7834.74,26012,"Brejo Pernambucano",2,"Nordeste",0,"260670",4,9,4,5,2,7,0,0,0,0,0,9,4,5,2,7,3,8.96632296981066,8.95776800997116,0.449416839283737,30
"3992","PE","Ibirajuba",7768,7834.74,26012,"Brejo Pernambucano",2,"Nordeste",0,"260670",5,7,2,5,4,3,0,0,0,0,0,7,2,5,4,3,4,8.96632296981066,8.95776800997116,0.426776349273975,31
"3993","PE","Igarassu",118370,21887.47,26016,"Itamaracá",2,"Nordeste",1,"260680",2,98,20,78,42,56,0,0,0,0,0,98,20,78,42,56,49,9.99366960594782,11.6815705909479,0.304891502136358,29
"3994","PE","Igarassu",118370,21887.47,26016,"Itamaracá",2,"Nordeste",1,"260680",3,100,25,75,50,50,0,0,0,0,0,100,25,75,50,50,67,9.99366960594782,11.6815705909479,0.410832237799084,31
"3995","PE","Igarassu",118370,21887.47,26016,"Itamaracá",2,"Nordeste",1,"260680",4,95,30,65,43,52,0,0,0,0,0,95,30,65,43,52,80,9.99366960594782,11.6815705909479,0.492674430392862,30
"3996","PE","Igarassu",118370,21887.47,26016,"Itamaracá",2,"Nordeste",1,"260680",5,117,37,80,54,63,5,1,4,2,3,122,38,84,56,66,133,9.99366960594782,11.6815705909479,0.478843954036558,31
"3997","PE","Iguaracy",12247,7348.26,26003,"Pajeú",2,"Nordeste",0,"260690",2,10,2,8,4,6,0,0,0,0,0,10,2,8,4,6,4,8.90221882948692,9.41303628802129,0.289038646836514,29
"3998","PE","Iguaracy",12247,7348.26,26003,"Pajeú",2,"Nordeste",0,"260690",3,11,1,10,5,6,0,0,0,0,0,11,1,10,5,6,5,8.90221882948692,9.41303628802129,0.357400816072455,31
"3999","PE","Iguaracy",12247,7348.26,26003,"Pajeú",2,"Nordeste",0,"260690",4,9,2,7,6,3,1,0,1,0,1,10,2,8,6,4,2,8.90221882948692,9.41303628802129,0.418808006835242,30
"4000","PE","Iguaracy",12247,7348.26,26003,"Pajeú",2,"Nordeste",0,"260690",5,10,1,9,4,6,0,0,0,0,0,10,1,9,4,6,15,8.90221882948692,9.41303628802129,0.422956614148863,31
"4001","PE","Inajá",23645,7317.46,26004,"Sertão do Moxotó",2,"Nordeste",0,"260700",2,23,16,7,11,12,1,1,0,1,0,24,17,7,12,12,6,8.8980185522033,10.070906955078,0.317723334282224,29
"4002","PE","Inajá",23645,7317.46,26004,"Sertão do Moxotó",2,"Nordeste",0,"260700",3,25,12,13,9,16,2,2,0,0,2,27,14,13,9,18,7,8.8980185522033,10.070906955078,0.405346333328454,31
"4003","PE","Inajá",23645,7317.46,26004,"Sertão do Moxotó",2,"Nordeste",0,"260700",4,24,16,8,12,12,0,0,0,0,0,24,16,8,12,12,5,8.8980185522033,10.070906955078,0.435249625008154,30
"4004","PE","Inajá",23645,7317.46,26004,"Sertão do Moxotó",2,"Nordeste",0,"260700",5,28,17,11,16,12,1,0,1,1,0,29,17,12,17,12,6,8.8980185522033,10.070906955078,0.432078641699331,31
"4005","PE","Ingazeira",4543,7950.69,26003,"Pajeú",2,"Nordeste",0,"260710",2,0,0,0,0,0,0,0,0,0,0,0,0,0,0,0,1,8.98101399633496,8.4213428657594,0.255114021808018,29
"4006","PE","Ingazeira",4543,7950.69,26003,"Pajeú",2,"Nordeste",0,"260710",3,6,0,6,3,3,0,0,0,0,0,6,0,6,3,3,4,8.98101399633496,8.4213428657594,0.362920641673244,31
"4007","PE","Ingazeira",4543,7950.69,26003,"Pajeú",2,"Nordeste",0,"260710",4,3,1,2,1,2,0,0,0,0,0,3,1,2,1,2,3,8.98101399633496,8.4213428657594,0.381240060687231,30
"4008","PE","Ingazeira",4543,7950.69,26003,"Pajeú",2,"Nordeste",0,"260710",5,5,0,5,1,4,0,0,0,0,0,5,0,5,1,4,1,8.98101399633496,8.4213428657594,0.414548937647575,31
"4009","PE","Ipojuca",97669,122169.48,26018,"Suape",2,"Nordeste",1,"260720",2,133,45,88,67,66,1,1,0,0,1,134,46,88,67,67,27,11.713164540025,11.4893394898307,0.284586915311922,29
"4010","PE","Ipojuca",97669,122169.48,26018,"Suape",2,"Nordeste",1,"260720",3,135,48,87,71,64,5,0,5,3,2,140,48,92,74,66,30,11.713164540025,11.4893394898307,0.386989260617085,31
"4011","PE","Ipojuca",97669,122169.48,26018,"Suape",2,"Nordeste",1,"260720",4,117,38,79,63,54,1,0,1,0,1,118,38,80,63,55,45,11.713164540025,11.4893394898307,0.465138334197493,30
"4012","PE","Ipojuca",97669,122169.48,26018,"Suape",2,"Nordeste",1,"260720",5,142,54,88,79,63,1,0,1,0,1,143,54,89,79,64,120,11.713164540025,11.4893394898307,0.469529763930892,31
"4013","PE","Ipubi",31187,9606.75,26001,"Araripina",2,"Nordeste",0,"260730",2,53,28,25,31,22,0,0,0,0,0,53,28,25,31,22,19,9.17022125537935,10.3477566203012,0.262501783249768,29
"4014","PE","Ipubi",31187,9606.75,26001,"Araripina",2,"Nordeste",0,"260730",3,41,19,22,19,22,0,0,0,0,0,41,19,22,19,22,17,9.17022125537935,10.3477566203012,0.347825767551666,31
"4015","PE","Ipubi",31187,9606.75,26001,"Araripina",2,"Nordeste",0,"260730",4,45,26,19,26,19,2,2,0,0,2,47,28,19,26,21,21,9.17022125537935,10.3477566203012,0.390062955245195,30
"4016","PE","Ipubi",31187,9606.75,26001,"Araripina",2,"Nordeste",0,"260730",5,58,24,34,27,31,0,0,0,0,0,58,24,34,27,31,21,9.17022125537935,10.3477566203012,0.38318495011492,31
"4017","PE","Itacuruba",4966,11378.85,26006,"Itaparica",2,"Nordeste",0,"260740",2,9,5,4,6,3,0,0,0,0,0,9,5,4,6,3,1,9.33951164809243,8.51036996606811,0.297288486421339,29
"4018","PE","Itacuruba",4966,11378.85,26006,"Itaparica",2,"Nordeste",0,"260740",3,5,3,2,3,2,0,0,0,0,0,5,3,2,3,2,2,9.33951164809243,8.51036996606811,0.360745374942597,31
"4019","PE","Itacuruba",4966,11378.85,26006,"Itaparica",2,"Nordeste",0,"260740",4,7,3,4,7,0,0,0,0,0,0,7,3,4,7,0,3,9.33951164809243,8.51036996606811,0.397905820175122,30
"4020","PE","Itacuruba",4966,11378.85,26006,"Itaparica",2,"Nordeste",0,"260740",5,5,1,4,4,1,0,0,0,0,0,5,1,4,4,1,2,9.33951164809243,8.51036996606811,0.423983607266138,31
"4021","PE","Itaíba",26308,8165.67,26007,"Vale do Ipanema",2,"Nordeste",0,"260750",2,28,15,13,14,14,0,0,0,0,0,28,15,13,14,14,14,9.0076940596008,10.1776283544212,0.295685141976089,29
"4022","PE","Itaíba",26308,8165.67,26007,"Vale do Ipanema",2,"Nordeste",0,"260750",3,25,12,13,9,16,0,0,0,0,0,25,12,13,9,16,16,9.0076940596008,10.1776283544212,0.385514428451764,31
"4023","PE","Itaíba",26308,8165.67,26007,"Vale do Ipanema",2,"Nordeste",0,"260750",4,25,14,11,13,12,0,0,0,0,0,25,14,11,13,12,15,9.0076940596008,10.1776283544212,0.382651502816479,30
"4024","PE","Itaíba",26308,8165.67,26007,"Vale do Ipanema",2,"Nordeste",0,"260750",5,28,14,14,13,15,0,0,0,0,0,28,14,14,13,15,15,9.0076940596008,10.1776283544212,0.432027669638526,31
"4025","PE","Ilha de Itamaracá",26672,9654.89,26016,"Itamaracá",2,"Nordeste",1,"260760",2,30,9,21,16,14,0,0,0,0,0,30,9,21,16,14,14,9.17521980173712,10.1913696049906,0.333556051902426,29
"4026","PE","Ilha de Itamaracá",26672,9654.89,26016,"Itamaracá",2,"Nordeste",1,"260760",3,18,6,12,12,6,0,0,0,0,0,18,6,12,12,6,15,9.17521980173712,10.1913696049906,0.436022521759597,31
"4027","PE","Ilha de Itamaracá",26672,9654.89,26016,"Itamaracá",2,"Nordeste",1,"260760",4,22,5,17,7,15,0,0,0,0,0,22,5,17,7,15,8,9.17521980173712,10.1913696049906,0.523887627103778,30
"4028","PE","Ilha de Itamaracá",26672,9654.89,26016,"Itamaracá",2,"Nordeste",1,"260760",5,23,7,16,11,12,0,0,0,0,0,23,7,16,11,12,16,9.17521980173712,10.1913696049906,0.514908146388195,31
"4029","PE","Itambé",36471,11700.74,26013,"Mata Setentrional Pernambucana",2,"Nordeste",1,"260765",2,29,15,14,14,15,1,0,1,0,1,30,15,15,14,16,15,9.36740736664903,10.5042727032239,0.307649416114036,29
"4030","PE","Itambé",36471,11700.74,26013,"Mata Setentrional Pernambucana",2,"Nordeste",1,"260765",3,27,10,17,11,16,0,0,0,0,0,27,10,17,11,16,27,9.36740736664903,10.5042727032239,0.39570496030321,31
"4031","PE","Itambé",36471,11700.74,26013,"Mata Setentrional Pernambucana",2,"Nordeste",1,"260765",4,31,10,21,14,17,1,0,1,0,1,32,10,22,14,18,20,9.36740736664903,10.5042727032239,0.436361438854728,30
"4032","PE","Itambé",36471,11700.74,26013,"Mata Setentrional Pernambucana",2,"Nordeste",1,"260765",5,28,16,12,14,14,0,0,0,0,0,28,16,12,14,14,33,9.36740736664903,10.5042727032239,0.433977101553448,31
"4033","PE","Itapetim",13553,7993.96,26003,"Pajeú",2,"Nordeste",0,"260770",2,12,4,8,6,6,0,0,0,0,0,12,4,8,6,6,10,8.98644153550594,9.51436320401602,0.292671277997407,29
"4034","PE","Itapetim",13553,7993.96,26003,"Pajeú",2,"Nordeste",0,"260770",3,14,3,11,6,8,2,2,0,0,2,16,5,11,6,10,10,8.98644153550594,9.51436320401602,0.372870678767134,31
"4035","PE","Itapetim",13553,7993.96,26003,"Pajeú",2,"Nordeste",0,"260770",4,15,2,13,8,7,0,0,0,0,0,15,2,13,8,7,7,8.98644153550594,9.51436320401602,0.371181412373151,30
"4036","PE","Itapetim",13553,7993.96,26003,"Pajeú",2,"Nordeste",0,"260770",5,14,3,11,7,7,1,1,0,1,0,15,4,11,8,7,14,8.98644153550594,9.51436320401602,0.406394047080422,31
"4037","PE","Itapissuma",26900,59212.96,26016,"Itamaracá",2,"Nordeste",1,"260775",2,19,10,9,8,11,0,0,0,0,0,19,10,9,8,11,13,10.9888957158318,10.1998815655899,0.309316281900865,29
"4038","PE","Itapissuma",26900,59212.96,26016,"Itamaracá",2,"Nordeste",1,"260775",3,24,12,12,12,12,0,0,0,0,0,24,12,12,12,12,21,10.9888957158318,10.1998815655899,0.405990354795908,31
"4039","PE","Itapissuma",26900,59212.96,26016,"Itamaracá",2,"Nordeste",1,"260775",4,21,7,14,12,9,0,0,0,0,0,21,7,14,12,9,20,10.9888957158318,10.1998815655899,0.476637935331581,30
"4040","PE","Itapissuma",26900,59212.96,26016,"Itamaracá",2,"Nordeste",1,"260775",5,44,17,27,20,24,0,0,0,0,0,44,17,27,20,24,29,10.9888957158318,10.1998815655899,0.469056484960021,31
"4041","PE","Itaquitinga",17006,7839.64,26013,"Mata Setentrional Pernambucana",2,"Nordeste",1,"260780",2,13,6,7,4,9,1,0,1,0,1,14,6,8,4,10,10,8.96694819392283,9.74132150194574,0.279540988215594,29
"4042","PE","Itaquitinga",17006,7839.64,26013,"Mata Setentrional Pernambucana",2,"Nordeste",1,"260780",3,13,5,8,8,5,0,0,0,0,0,13,5,8,8,5,10,8.96694819392283,9.74132150194574,0.368581694460841,31
"4043","PE","Itaquitinga",17006,7839.64,26013,"Mata Setentrional Pernambucana",2,"Nordeste",1,"260780",4,11,4,7,7,4,0,0,0,0,0,11,4,7,7,4,11,8.96694819392283,9.74132150194574,0.407166852500018,30
"4044","PE","Itaquitinga",17006,7839.64,26013,"Mata Setentrional Pernambucana",2,"Nordeste",1,"260780",5,10,5,5,6,4,1,1,0,0,1,11,6,5,6,5,17,8.96694819392283,9.74132150194574,0.414530180447626,31
"4045","PE","Jaboatão dos Guararapes",706867,19149.92,26017,"Recife",2,"Nordeste",1,"260790",2,623,147,476,262,361,4,0,4,1,3,627,147,480,263,364,380,9.86005381705437,13.4685978083703,0.296995185585837,29
"4046","PE","Jaboatão dos Guararapes",706867,19149.92,26017,"Recife",2,"Nordeste",1,"260790",3,620,161,459,247,373,4,1,3,2,2,624,162,462,249,375,359,9.86005381705437,13.4685978083703,0.414796489499874,31
"4047","PE","Jaboatão dos Guararapes",706867,19149.92,26017,"Recife",2,"Nordeste",1,"260790",4,533,121,412,209,324,7,1,6,4,3,540,122,418,213,327,507,9.86005381705437,13.4685978083703,0.505151618978803,30
"4048","PE","Jaboatão dos Guararapes",706867,19149.92,26017,"Recife",2,"Nordeste",1,"260790",5,631,150,481,257,374,3,1,2,2,1,634,151,483,259,375,923,9.86005381705437,13.4685978083703,0.499749899518373,31
"4049","PE","Jaqueira",11644,9358.82,26015,"Mata Meridional Pernambucana",2,"Nordeste",0,"260795",2,6,3,3,5,1,0,0,0,0,0,6,3,3,5,1,7,9.14407449314828,9.36254630486551,0.339541688717455,29
"4050","PE","Jaqueira",11644,9358.82,26015,"Mata Meridional Pernambucana",2,"Nordeste",0,"260795",3,9,3,6,5,4,0,0,0,0,0,9,3,6,5,4,8,9.14407449314828,9.36254630486551,0.423814879612724,31
"4051","PE","Jaqueira",11644,9358.82,26015,"Mata Meridional Pernambucana",2,"Nordeste",0,"260795",4,9,3,6,3,6,0,0,0,0,0,9,3,6,3,6,6,9.14407449314828,9.36254630486551,0.460053158963712,30
"4052","PE","Jaqueira",11644,9358.82,26015,"Mata Meridional Pernambucana",2,"Nordeste",0,"260795",5,10,5,5,5,5,0,0,0,0,0,10,5,5,5,5,9,9.14407449314828,9.36254630486551,0.462282055291156,31
"4053","PE","Jataúba",17228,7303.47,26008,"Vale do Ipojuca",2,"Nordeste",0,"260800",2,17,11,6,6,11,0,0,0,0,0,17,11,6,6,11,12,8.8961048566628,9.754291246174,0.300858297091126,29
"4054","PE","Jataúba",17228,7303.47,26008,"Vale do Ipojuca",2,"Nordeste",0,"260800",3,24,14,10,11,13,0,0,0,0,0,24,14,10,11,13,8,8.8961048566628,9.754291246174,0.373295486537646,31
"4055","PE","Jataúba",17228,7303.47,26008,"Vale do Ipojuca",2,"Nordeste",0,"260800",4,17,12,5,7,10,0,0,0,0,0,17,12,5,7,10,14,8.8961048566628,9.754291246174,0.405972815219061,30
"4056","PE","Jataúba",17228,7303.47,26008,"Vale do Ipojuca",2,"Nordeste",0,"260800",5,19,8,11,8,11,0,0,0,0,0,19,8,11,8,11,12,8.8961048566628,9.754291246174,0.445521030196981,31
"4057","PE","Jatobá",14850,8482.07,26006,"Itaparica",2,"Nordeste",0,"260805",2,10,6,4,4,6,0,0,0,0,0,10,6,4,4,6,6,9.04570980277106,9.60575514423085,0.299745833955592,29
"4058","PE","Jatobá",14850,8482.07,26006,"Itaparica",2,"Nordeste",0,"260805",3,18,8,10,7,11,0,0,0,0,0,18,8,10,7,11,3,9.04570980277106,9.60575514423085,0.388545688415627,31
"4059","PE","Jatobá",14850,8482.07,26006,"Itaparica",2,"Nordeste",0,"260805",4,17,4,13,7,10,0,0,0,0,0,17,4,13,7,10,9,9.04570980277106,9.60575514423085,0.423319137954522,30
"4060","PE","Jatobá",14850,8482.07,26006,"Itaparica",2,"Nordeste",0,"260805",5,23,6,17,9,14,1,1,0,1,0,24,7,17,10,14,10,9.04570980277106,9.60575514423085,0.406268759956671,31
"4061","PE","João Alfredo",33328,8701.73,26010,"Médio Capibaribe",2,"Nordeste",0,"260810",2,28,11,17,18,10,0,0,0,0,0,28,11,17,18,10,22,9.07127713544923,10.4141531635008,0.27405074412246,29
"4062","PE","João Alfredo",33328,8701.73,26010,"Médio Capibaribe",2,"Nordeste",0,"260810",3,19,7,12,9,10,0,0,0,0,0,19,7,12,9,10,23,9.07127713544923,10.4141531635008,0.348116340880314,31
"4063","PE","João Alfredo",33328,8701.73,26010,"Médio Capibaribe",2,"Nordeste",0,"260810",4,21,14,7,8,13,0,0,0,0,0,21,14,7,8,13,25,9.07127713544923,10.4141531635008,0.389892174540422,30
"4064","PE","João Alfredo",33328,8701.73,26010,"Médio Capibaribe",2,"Nordeste",0,"260810",5,31,16,15,12,19,0,0,0,0,0,31,16,15,12,19,41,9.07127713544923,10.4141531635008,0.393728635221919,31
"4065","PE","Joaquim Nabuco",16011,11434.31,26015,"Mata Meridional Pernambucana",2,"Nordeste",1,"260820",2,15,5,10,8,7,0,0,0,0,0,15,5,10,8,7,10,9.34437376357813,9.68103126500205,0.317522260877761,29
"4066","PE","Joaquim Nabuco",16011,11434.31,26015,"Mata Meridional Pernambucana",2,"Nordeste",1,"260820",3,17,7,10,8,9,0,0,0,0,0,17,7,10,8,9,5,9.34437376357813,9.68103126500205,0.414409385572723,31
"4067","PE","Joaquim Nabuco",16011,11434.31,26015,"Mata Meridional Pernambucana",2,"Nordeste",1,"260820",4,16,7,9,9,7,0,0,0,0,0,16,7,9,9,7,10,9.34437376357813,9.68103126500205,0.425763928782446,30
"4068","PE","Joaquim Nabuco",16011,11434.31,26015,"Mata Meridional Pernambucana",2,"Nordeste",1,"260820",5,18,8,10,10,8,0,0,0,0,0,18,8,10,10,8,18,9.34437376357813,9.68103126500205,0.440418773265257,31
"4069","PE","Jucati",11485,8839.64,26011,"Garanhuns",2,"Nordeste",0,"260825",2,12,5,7,4,8,0,0,0,0,0,12,5,7,4,8,9,9.08700143082054,9.3487971151232,0.291831179131503,29
"4070","PE","Jucati",11485,8839.64,26011,"Garanhuns",2,"Nordeste",0,"260825",3,11,4,7,8,3,0,0,0,0,0,11,4,7,8,3,3,9.08700143082054,9.3487971151232,0.359695483060021,31
"4071","PE","Jucati",11485,8839.64,26011,"Garanhuns",2,"Nordeste",0,"260825",4,14,8,6,5,9,0,0,0,0,0,14,8,6,5,9,5,9.08700143082054,9.3487971151232,0.403772125167128,30
"4072","PE","Jucati",11485,8839.64,26011,"Garanhuns",2,"Nordeste",0,"260825",5,15,5,10,6,9,0,0,0,0,0,15,5,10,6,9,5,9.08700143082054,9.3487971151232,0.394720389157312,31
"4073","PE","Jupi",14922,10545.02,26011,"Garanhuns",2,"Nordeste",0,"260830",2,22,15,7,12,10,0,0,0,0,0,22,15,7,12,10,4,9.26340898954455,9.61059191303146,0.280271992511523,29
"4074","PE","Jupi",14922,10545.02,26011,"Garanhuns",2,"Nordeste",0,"260830",3,22,9,13,9,13,0,0,0,0,0,22,9,13,9,13,11,9.26340898954455,9.61059191303146,0.3624751552545,31
"4075","PE","Jupi",14922,10545.02,26011,"Garanhuns",2,"Nordeste",0,"260830",4,11,4,7,6,5,0,0,0,0,0,11,4,7,6,5,10,9.26340898954455,9.61059191303146,0.402718753791318,30
"4076","PE","Jupi",14922,10545.02,26011,"Garanhuns",2,"Nordeste",0,"260830",5,18,9,9,10,8,0,0,0,0,0,18,9,9,10,8,9,9.26340898954455,9.61059191303146,0.404691492335788,31
"4077","PE","Jurema",15431,6799.45,26011,"Garanhuns",2,"Nordeste",0,"260840",2,10,6,4,3,7,1,1,0,0,1,11,7,4,3,8,9,8.8245970055401,9.64413375207121,0.301289845783726,29
"4078","PE","Jurema",15431,6799.45,26011,"Garanhuns",2,"Nordeste",0,"260840",3,13,9,4,6,7,0,0,0,0,0,13,9,4,6,7,17,8.8245970055401,9.64413375207121,0.403361250002999,31
"4079","PE","Jurema",15431,6799.45,26011,"Garanhuns",2,"Nordeste",0,"260840",4,17,10,7,10,7,0,0,0,0,0,17,10,7,10,7,10,8.8245970055401,9.64413375207121,0.435580088360499,30
"4080","PE","Jurema",15431,6799.45,26011,"Garanhuns",2,"Nordeste",0,"260840",5,13,5,8,7,6,0,0,0,0,0,13,5,8,7,6,13,8.8245970055401,9.64413375207121,0.426229126736603,31
"4081","PE","Lagoa do Carro",18252,13842.02,26013,"Mata Setentrional Pernambucana",2,"Nordeste",0,"260845",2,19,3,16,8,11,0,0,0,0,0,19,3,16,8,11,14,9.53546417227867,9.81202994204729,0.287089573482134,29
"4082","PE","Lagoa do Carro",18252,13842.02,26013,"Mata Setentrional Pernambucana",2,"Nordeste",0,"260845",3,14,7,7,6,8,0,0,0,0,0,14,7,7,6,8,11,9.53546417227867,9.81202994204729,0.381996830628671,31
"4083","PE","Lagoa do Carro",18252,13842.02,26013,"Mata Setentrional Pernambucana",2,"Nordeste",0,"260845",4,14,6,8,8,6,0,0,0,0,0,14,6,8,8,6,17,9.53546417227867,9.81202994204729,0.426731796571111,30
"4084","PE","Lagoa do Carro",18252,13842.02,26013,"Mata Setentrional Pernambucana",2,"Nordeste",0,"260845",5,25,11,14,14,11,1,1,0,0,1,26,12,14,14,12,15,9.53546417227867,9.81202994204729,0.420365004792646,31
"4085","PE","Lagoa de Itaenga",21460,14993.15,26013,"Mata Setentrional Pernambucana",2,"Nordeste",1,"260850",2,27,11,16,11,16,3,1,2,1,2,30,12,18,12,18,18,9.6153487091137,9.97394601618469,0.286822589120739,29
"4086","PE","Lagoa de Itaenga",21460,14993.15,26013,"Mata Setentrional Pernambucana",2,"Nordeste",1,"260850",3,22,8,14,12,10,0,0,0,0,0,22,8,14,12,10,10,9.6153487091137,9.97394601618469,0.373861231305857,31
"4087","PE","Lagoa de Itaenga",21460,14993.15,26013,"Mata Setentrional Pernambucana",2,"Nordeste",1,"260850",4,23,7,16,8,15,0,0,0,0,0,23,7,16,8,15,22,9.6153487091137,9.97394601618469,0.415671804417469,30
"4088","PE","Lagoa de Itaenga",21460,14993.15,26013,"Mata Setentrional Pernambucana",2,"Nordeste",1,"260850",5,20,2,18,11,9,0,0,0,0,0,20,2,18,11,9,26,9.6153487091137,9.97394601618469,0.411795491503716,31
"4089","PE","Lagoa do Ouro",13224,8857.97,26011,"Garanhuns",2,"Nordeste",0,"260860",2,4,4,0,3,1,0,0,0,0,0,4,4,0,3,1,11,9.08907289770839,9.48978863950086,0.25663634219345,29
"4090","PE","Lagoa do Ouro",13224,8857.97,26011,"Garanhuns",2,"Nordeste",0,"260860",3,7,5,2,3,4,0,0,0,0,0,7,5,2,3,4,3,9.08907289770839,9.48978863950086,0.339778212277923,31
"4091","PE","Lagoa do Ouro",13224,8857.97,26011,"Garanhuns",2,"Nordeste",0,"260860",4,11,7,4,8,3,0,0,0,0,0,11,7,4,8,3,9,9.08907289770839,9.48978863950086,0.374355010291032,30
"4092","PE","Lagoa do Ouro",13224,8857.97,26011,"Garanhuns",2,"Nordeste",0,"260860",5,10,7,3,4,6,0,0,0,0,0,10,7,3,4,6,4,9.08907289770839,9.48978863950086,0.397223077490051,31
"4093","PE","Lagoa dos Gatos",16318,8624.5,26012,"Brejo Pernambucano",2,"Nordeste",0,"260870",2,21,12,9,12,9,1,1,0,1,0,22,13,9,13,9,16,9.06236226920468,9.70002407198874,0.266937693807655,29
"4094","PE","Lagoa dos Gatos",16318,8624.5,26012,"Brejo Pernambucano",2,"Nordeste",0,"260870",3,16,8,8,10,6,0,0,0,0,0,16,8,8,10,6,15,9.06236226920468,9.70002407198874,0.350263287574615,31
"4095","PE","Lagoa dos Gatos",16318,8624.5,26012,"Brejo Pernambucano",2,"Nordeste",0,"260870",4,12,6,6,7,5,0,0,0,0,0,12,6,6,7,5,8,9.06236226920468,9.70002407198874,0.380058185038321,30
"4096","PE","Lagoa dos Gatos",16318,8624.5,26012,"Brejo Pernambucano",2,"Nordeste",0,"260870",5,14,6,8,8,6,0,0,0,0,0,14,6,8,8,6,15,9.06236226920468,9.70002407198874,0.421432993638301,31
"4097","PE","Lagoa Grande",25849,12656.35,26005,"Petrolina",2,"Nordeste",0,"260875",2,28,9,19,6,22,0,0,0,0,0,28,9,19,6,22,8,9.4459143444923,10.1600271944688,0.287547280995208,29
"4098","PE","Lagoa Grande",25849,12656.35,26005,"Petrolina",2,"Nordeste",0,"260875",3,28,13,15,15,13,0,0,0,0,0,28,13,15,15,13,10,9.4459143444923,10.1600271944688,0.376464646281538,31
"4099","PE","Lagoa Grande",25849,12656.35,26005,"Petrolina",2,"Nordeste",0,"260875",4,24,8,16,12,12,1,0,1,0,1,25,8,17,12,13,13,9.4459143444923,10.1600271944688,0.392940644546182,30
"4100","PE","Lagoa Grande",25849,12656.35,26005,"Petrolina",2,"Nordeste",0,"260875",5,45,20,25,23,22,0,0,0,0,0,45,20,25,23,22,8,9.4459143444923,10.1600271944688,0.392491391842996,31
"4101","PE","Lajedo",40589,11169.67,26011,"Garanhuns",2,"Nordeste",1,"260880",2,53,29,24,25,28,0,0,0,0,0,53,29,24,25,28,31,9.32095734820696,10.6112523729195,0.271697564566237,29
"4102","PE","Lajedo",40589,11169.67,26011,"Garanhuns",2,"Nordeste",1,"260880",3,51,24,27,18,33,0,0,0,0,0,51,24,27,18,33,41,9.32095734820696,10.6112523729195,0.357040617141095,31
"4103","PE","Lajedo",40589,11169.67,26011,"Garanhuns",2,"Nordeste",1,"260880",4,38,13,25,17,21,1,1,0,1,0,39,14,25,18,21,32,9.32095734820696,10.6112523729195,0.377925310683256,30
"4104","PE","Lajedo",40589,11169.67,26011,"Garanhuns",2,"Nordeste",1,"260880",5,56,33,23,19,37,0,0,0,0,0,56,33,23,19,37,35,9.32095734820696,10.6112523729195,0.369031662020043,31
"4105","PE","Limoeiro",56198,13784.48,26010,"Médio Capibaribe",2,"Nordeste",1,"260890",2,56,6,50,18,38,0,0,0,0,0,56,6,50,18,38,32,9.53129860058463,10.9366364480599,0.285526050242937,29
"4106","PE","Limoeiro",56198,13784.48,26010,"Médio Capibaribe",2,"Nordeste",1,"260890",3,52,20,32,22,30,0,0,0,0,0,52,20,32,22,30,42,9.53129860058463,10.9366364480599,0.372021595568999,31
"4107","PE","Limoeiro",56198,13784.48,26010,"Médio Capibaribe",2,"Nordeste",1,"260890",4,51,10,41,23,28,1,0,1,0,1,52,10,42,23,29,39,9.53129860058463,10.9366364480599,0.440041277952707,30
"4108","PE","Limoeiro",56198,13784.48,26010,"Médio Capibaribe",2,"Nordeste",1,"260890",5,63,16,47,30,33,0,0,0,0,0,63,16,47,30,33,66,9.53129860058463,10.9366364480599,0.429164842933699,31
"4109","PE","Macaparana",25472,9447.74,26013,"Mata Setentrional Pernambucana",2,"Nordeste",0,"260900",2,24,5,19,12,12,0,0,0,0,0,24,5,19,12,12,13,9.15353083844689,10.1453350886441,0.275928586968661,29
"4110","PE","Macaparana",25472,9447.74,26013,"Mata Setentrional Pernambucana",2,"Nordeste",0,"260900",3,23,10,13,14,9,0,0,0,0,0,23,10,13,14,9,20,9.15353083844689,10.1453350886441,0.374026721228403,31
"4111","PE","Macaparana",25472,9447.74,26013,"Mata Setentrional Pernambucana",2,"Nordeste",0,"260900",4,20,8,12,14,6,0,0,0,0,0,20,8,12,14,6,19,9.15353083844689,10.1453350886441,0.40836985962756,30
"4112","PE","Macaparana",25472,9447.74,26013,"Mata Setentrional Pernambucana",2,"Nordeste",0,"260900",5,31,13,18,16,15,1,0,1,1,0,32,13,19,17,15,23,9.15353083844689,10.1453350886441,0.417131548334966,31
"4113","PE","Machados",16321,13380.62,26010,"Médio Capibaribe",2,"Nordeste",0,"260910",2,16,7,9,8,8,0,0,0,0,0,16,7,9,8,8,5,9.50156267042629,9.7002079011507,0.27943574044818,29
"4114","PE","Machados",16321,13380.62,26010,"Médio Capibaribe",2,"Nordeste",0,"260910",3,17,6,11,7,10,0,0,0,0,0,17,6,11,7,10,4,9.50156267042629,9.7002079011507,0.341373673773376,31
"4115","PE","Machados",16321,13380.62,26010,"Médio Capibaribe",2,"Nordeste",0,"260910",4,13,3,10,10,3,0,0,0,0,0,13,3,10,10,3,9,9.50156267042629,9.7002079011507,0.390741180343863,30
"4116","PE","Machados",16321,13380.62,26010,"Médio Capibaribe",2,"Nordeste",0,"260910",5,19,8,11,8,11,1,0,1,0,1,20,8,12,8,12,9,9.50156267042629,9.7002079011507,0.383780656972621,31
"4117","PE","Manari",21776,5793.6,26004,"Sertão do Moxotó",2,"Nordeste",0,"260915",2,27,13,14,17,10,2,1,1,2,0,29,14,15,19,10,7,8.66450913901138,9.98856372489125,0.316342524673414,29
"4118","PE","Manari",21776,5793.6,26004,"Sertão do Moxotó",2,"Nordeste",0,"260915",3,15,7,8,9,6,1,0,1,1,0,16,7,9,10,6,7,8.66450913901138,9.98856372489125,0.373741756174142,31
"4119","PE","Manari",21776,5793.6,26004,"Sertão do Moxotó",2,"Nordeste",0,"260915",4,12,5,7,6,6,0,0,0,0,0,12,5,7,6,6,9,8.66450913901138,9.98856372489125,0.423544392630487,30
"4120","PE","Manari",21776,5793.6,26004,"Sertão do Moxotó",2,"Nordeste",0,"260915",5,24,10,14,12,12,1,1,0,0,1,25,11,14,12,13,10,8.66450913901138,9.98856372489125,0.445149010990907,31
"4121","PE","Maraial",11220,7628.78,26015,"Mata Meridional Pernambucana",2,"Nordeste",0,"260920",2,15,7,8,8,7,0,0,0,0,0,15,7,8,8,7,5,8.93968321634319,9.32545317907669,0.311786946992498,29
"4122","PE","Maraial",11220,7628.78,26015,"Mata Meridional Pernambucana",2,"Nordeste",0,"260920",3,7,5,2,4,3,0,0,0,0,0,7,5,2,4,3,7,8.93968321634319,9.32545317907669,0.417727990424919,31
"4123","PE","Maraial",11220,7628.78,26015,"Mata Meridional Pernambucana",2,"Nordeste",0,"260920",4,11,7,4,6,5,0,0,0,0,0,11,7,4,6,5,3,8.93968321634319,9.32545317907669,0.406001996700663,30
"4124","PE","Maraial",11220,7628.78,26015,"Mata Meridional Pernambucana",2,"Nordeste",0,"260920",5,11,6,5,6,5,0,0,0,0,0,11,6,5,6,5,8,8.93968321634319,9.32545317907669,0.419209726194591,31
"4125","PE","Mirandiba",15470,9878.16,26002,"Salgueiro",2,"Nordeste",0,"260930",2,23,5,18,13,10,0,0,0,0,0,23,5,18,13,10,6,9.19808153858024,9.64665794356711,0.289213258115533,29
"4126","PE","Mirandiba",15470,9878.16,26002,"Salgueiro",2,"Nordeste",0,"260930",3,17,3,14,6,11,0,0,0,0,0,17,3,14,6,11,12,9.19808153858024,9.64665794356711,0.361999924928406,31
"4127","PE","Mirandiba",15470,9878.16,26002,"Salgueiro",2,"Nordeste",0,"260930",4,8,2,6,5,3,0,0,0,0,0,8,2,6,5,3,9,9.19808153858024,9.64665794356711,0.401796491257791,30
"4128","PE","Mirandiba",15470,9878.16,26002,"Salgueiro",2,"Nordeste",0,"260930",5,27,12,15,10,17,0,0,0,0,0,27,12,15,10,17,5,9.19808153858024,9.64665794356711,0.397312997928214,31
"4129","PE","Moreno",63294,10566.28,26017,"Recife",2,"Nordeste",1,"260940",2,48,13,35,26,22,1,0,1,0,1,49,13,36,26,23,34,9.26542307746778,11.0555458169099,0.298398198908899,29
"4130","PE","Moreno",63294,10566.28,26017,"Recife",2,"Nordeste",1,"260940",3,57,15,42,27,30,2,2,0,2,0,59,17,42,29,30,47,9.26542307746778,11.0555458169099,0.397749630014309,31
"4131","PE","Moreno",63294,10566.28,26017,"Recife",2,"Nordeste",1,"260940",4,55,18,37,28,27,0,0,0,0,0,55,18,37,28,27,39,9.26542307746778,11.0555458169099,0.47295764092253,30
"4132","PE","Moreno",63294,10566.28,26017,"Recife",2,"Nordeste",1,"260940",5,68,18,50,27,41,0,0,0,0,0,68,18,50,27,41,65,9.26542307746778,11.0555458169099,0.465854649631142,31
"4133","PE","Nazaré da Mata",32573,16319.32,26013,"Mata Setentrional Pernambucana",2,"Nordeste",1,"260950",2,26,12,14,18,8,1,1,0,1,0,27,13,14,19,8,20,9.70010496098335,10.3912390033315,0.281283723407471,29
"4134","PE","Nazaré da Mata",32573,16319.32,26013,"Mata Setentrional Pernambucana",2,"Nordeste",1,"260950",3,31,12,19,18,13,0,0,0,0,0,31,12,19,18,13,16,9.70010496098335,10.3912390033315,0.377170074888163,31
"4135","PE","Nazaré da Mata",32573,16319.32,26013,"Mata Setentrional Pernambucana",2,"Nordeste",1,"260950",4,23,2,21,8,15,0,0,0,0,0,23,2,21,8,15,27,9.70010496098335,10.3912390033315,0.425716577671779,30
"4136","PE","Nazaré da Mata",32573,16319.32,26013,"Mata Setentrional Pernambucana",2,"Nordeste",1,"260950",5,27,7,20,9,18,1,0,1,0,1,28,7,21,9,19,45,9.70010496098335,10.3912390033315,0.438518424289548,31
"4137","PE","Olinda",393115,14122.98,26017,"Recife",2,"Nordeste",1,"260960",2,336,106,230,141,195,5,1,4,4,1,341,107,234,145,196,234,9.55555853693834,12.8818574689114,0.301877055248084,29
"4138","PE","Olinda",393115,14122.98,26017,"Recife",2,"Nordeste",1,"260960",3,311,63,248,125,186,3,0,3,0,3,314,63,251,125,189,279,9.55555853693834,12.8818574689114,0.432438174425477,31
"4139","PE","Olinda",393115,14122.98,26017,"Recife",2,"Nordeste",1,"260960",4,310,87,223,145,165,5,2,3,2,3,315,89,226,147,168,402,9.55555853693834,12.8818574689114,0.540731289401138,30
"4140","PE","Olinda",393115,14122.98,26017,"Recife",2,"Nordeste",1,"260960",5,376,99,277,140,236,1,1,0,0,1,377,100,277,140,237,533,9.55555853693834,12.8818574689114,0.532514010400483,31
"4141","PE","Orobó",23935,13496.22,26010,"Médio Capibaribe",2,"Nordeste",0,"260970",2,23,5,18,8,15,0,0,0,0,0,23,5,18,8,15,9,9.5101649252192,10.0830971018266,0.289627452565725,29
"4142","PE","Orobó",23935,13496.22,26010,"Médio Capibaribe",2,"Nordeste",0,"260970",3,16,5,11,7,9,0,0,0,0,0,16,5,11,7,9,13,9.5101649252192,10.0830971018266,0.377414480243908,31
"4143","PE","Orobó",23935,13496.22,26010,"Médio Capibaribe",2,"Nordeste",0,"260970",4,22,7,15,9,13,0,0,0,0,0,22,7,15,9,13,11,9.5101649252192,10.0830971018266,0.439650807653816,30
"4144","PE","Orobó",23935,13496.22,26010,"Médio Capibaribe",2,"Nordeste",0,"260970",5,27,6,21,10,17,0,0,0,0,0,27,6,21,10,17,15,9.5101649252192,10.0830971018266,0.412823775635034,31
"4145","PE","Orocó",15152,11719,26005,"Petrolina",2,"Nordeste",0,"260980",2,27,9,18,19,8,1,0,1,0,1,28,9,19,19,9,6,9.3689667352586,9.62588781542586,0.316592861232287,29
"4146","PE","Orocó",15152,11719,26005,"Petrolina",2,"Nordeste",0,"260980",3,17,8,9,9,8,1,0,1,1,0,18,8,10,10,8,4,9.3689667352586,9.62588781542586,0.388968504922309,31
"4147","PE","Orocó",15152,11719,26005,"Petrolina",2,"Nordeste",0,"260980",4,19,3,16,13,6,0,0,0,0,0,19,3,16,13,6,3,9.3689667352586,9.62588781542586,0.429656627996636,30
"4148","PE","Orocó",15152,11719,26005,"Petrolina",2,"Nordeste",0,"260980",5,21,4,17,9,12,0,0,0,0,0,21,4,17,9,12,8,9.3689667352586,9.62588781542586,0.425543411760682,31
"4149","PE","Ouricuri",69969,9671.52,26001,"Araripina",2,"Nordeste",0,"260990",2,86,33,53,36,50,1,0,1,1,0,87,33,54,37,50,31,9.17694076327157,11.1558075657985,0.295108571242653,29
"4150","PE","Ouricuri",69969,9671.52,26001,"Araripina",2,"Nordeste",0,"260990",3,76,23,53,37,39,3,1,2,1,2,79,24,55,38,41,36,9.17694076327157,11.1558075657985,0.371274483089923,31
"4151","PE","Ouricuri",69969,9671.52,26001,"Araripina",2,"Nordeste",0,"260990",4,63,30,33,34,29,1,0,1,0,1,64,30,34,34,30,36,9.17694076327157,11.1558075657985,0.410269188371546,30
"4152","PE","Ouricuri",69969,9671.52,26001,"Araripina",2,"Nordeste",0,"260990",5,101,46,55,45,56,0,0,0,0,0,101,46,55,45,56,26,9.17694076327157,11.1558075657985,0.418214021726509,31
"4153","PE","Palmares",63500,12704.44,26015,"Mata Meridional Pernambucana",2,"Nordeste",1,"261000",2,64,11,53,31,33,0,0,0,0,0,64,11,53,31,33,41,9.44970681764785,11.0587951848808,0.287096098736342,29
"4154","PE","Palmares",63500,12704.44,26015,"Mata Meridional Pernambucana",2,"Nordeste",1,"261000",3,53,20,33,27,26,0,0,0,0,0,53,20,33,27,26,54,9.44970681764785,11.0587951848808,0.384534899388031,31
"4155","PE","Palmares",63500,12704.44,26015,"Mata Meridional Pernambucana",2,"Nordeste",1,"261000",4,70,28,42,31,39,0,0,0,0,0,70,28,42,31,39,43,9.44970681764785,11.0587951848808,0.433714937492018,30
"4156","PE","Palmares",63500,12704.44,26015,"Mata Meridional Pernambucana",2,"Nordeste",1,"261000",5,69,23,46,35,34,0,0,0,0,0,69,23,46,35,34,76,9.44970681764785,11.0587951848808,0.43153713234019,31
"4157","PE","Palmeirina",7600,8822.41,26011,"Garanhuns",2,"Nordeste",0,"261010",2,6,4,2,2,4,0,0,0,0,0,6,4,2,2,4,6,9.08505035430725,8.93590352627442,0.293947710814245,29
"4158","PE","Palmeirina",7600,8822.41,26011,"Garanhuns",2,"Nordeste",0,"261010",3,8,6,2,5,3,0,0,0,0,0,8,6,2,5,3,2,9.08505035430725,8.93590352627442,0.371836004030742,31
"4159","PE","Palmeirina",7600,8822.41,26011,"Garanhuns",2,"Nordeste",0,"261010",4,7,3,4,4,3,0,0,0,0,0,7,3,4,4,3,3,9.08505035430725,8.93590352627442,0.418621496987074,30
"4160","PE","Palmeirina",7600,8822.41,26011,"Garanhuns",2,"Nordeste",0,"261010",5,5,1,4,2,3,0,0,0,0,0,5,1,4,2,3,12,9.08505035430725,8.93590352627442,0.440738273169315,31
"4161","PE","Panelas",26456,7178.15,26012,"Brejo Pernambucano",2,"Nordeste",0,"261020",2,26,10,16,11,15,1,0,1,1,0,27,10,17,12,15,18,8.87879696867505,10.1832382546616,0.274068020141671,29
"4162","PE","Panelas",26456,7178.15,26012,"Brejo Pernambucano",2,"Nordeste",0,"261020",3,20,12,8,6,14,1,0,1,0,1,21,12,9,6,15,26,8.87879696867505,10.1832382546616,0.362873603675591,31
"4163","PE","Panelas",26456,7178.15,26012,"Brejo Pernambucano",2,"Nordeste",0,"261020",4,18,7,11,10,8,0,0,0,0,0,18,7,11,10,8,22,8.87879696867505,10.1832382546616,0.398509218129917,30
"4164","PE","Panelas",26456,7178.15,26012,"Brejo Pernambucano",2,"Nordeste",0,"261020",5,35,16,19,18,17,0,0,0,0,0,35,16,19,18,17,20,8.87879696867505,10.1832382546616,0.395312083039383,31
"4165","PE","Paranatama",11566,24880.06,26011,"Garanhuns",2,"Nordeste",0,"261030",2,16,8,8,10,6,0,0,0,0,0,16,8,8,10,6,13,10.1218219584258,9.35582503871816,0.272137461341099,29
"4166","PE","Paranatama",11566,24880.06,26011,"Garanhuns",2,"Nordeste",0,"261030",3,17,8,9,5,12,0,0,0,0,0,17,8,9,5,12,10,10.1218219584258,9.35582503871816,0.341369239284363,31
"4167","PE","Paranatama",11566,24880.06,26011,"Garanhuns",2,"Nordeste",0,"261030",4,18,7,11,12,6,0,0,0,0,0,18,7,11,12,6,6,10.1218219584258,9.35582503871816,0.360796682384418,30
"4168","PE","Paranatama",11566,24880.06,26011,"Garanhuns",2,"Nordeste",0,"261030",5,12,5,7,5,7,0,0,0,0,0,12,5,7,5,7,10,10.1218219584258,9.35582503871816,0.386654241399161,31
"4169","PE","Parnamirim",22106,7616.25,26002,"Salgueiro",2,"Nordeste",0,"261040",2,22,5,17,13,9,0,0,0,0,0,22,5,17,13,9,7,8.9380394015627,10.0036043438709,0.321969065278285,29
"4170","PE","Parnamirim",22106,7616.25,26002,"Salgueiro",2,"Nordeste",0,"261040",3,24,3,21,13,11,2,1,1,0,2,26,4,22,13,13,13,8.9380394015627,10.0036043438709,0.40862614330888,31
"4171","PE","Parnamirim",22106,7616.25,26002,"Salgueiro",2,"Nordeste",0,"261040",4,21,6,15,7,14,0,0,0,0,0,21,6,15,7,14,5,8.9380394015627,10.0036043438709,0.450823229262431,30
"4172","PE","Parnamirim",22106,7616.25,26002,"Salgueiro",2,"Nordeste",0,"261040",5,27,6,21,14,13,1,0,1,0,1,28,6,22,14,14,16,8.9380394015627,10.0036043438709,0.470113539666575,31
"4173","PE","Passira",28894,7751.02,26010,"Médio Capibaribe",2,"Nordeste",0,"261050",2,29,8,21,13,16,0,0,0,0,0,29,8,21,13,16,21,8.9555797265904,10.2713892400893,0.30365252766158,29
"4174","PE","Passira",28894,7751.02,26010,"Médio Capibaribe",2,"Nordeste",0,"261050",3,24,6,18,10,14,0,0,0,0,0,24,6,18,10,14,28,8.9555797265904,10.2713892400893,0.391136210628873,31
"4175","PE","Passira",28894,7751.02,26010,"Médio Capibaribe",2,"Nordeste",0,"261050",4,20,7,13,13,7,0,0,0,0,0,20,7,13,13,7,22,8.9555797265904,10.2713892400893,0.436788716315621,30
"4176","PE","Passira",28894,7751.02,26010,"Médio Capibaribe",2,"Nordeste",0,"261050",5,32,10,22,15,17,0,0,0,0,0,32,10,22,15,17,28,8.9555797265904,10.2713892400893,0.451444045662892,31
"4177","PE","Paudalho",56933,14223.39,26013,"Mata Setentrional Pernambucana",2,"Nordeste",1,"261060",2,64,19,45,31,33,0,0,0,0,0,64,19,45,31,33,31,9.56264307156975,10.9496304168504,0.297689458175326,29
"4178","PE","Paudalho",56933,14223.39,26013,"Mata Setentrional Pernambucana",2,"Nordeste",1,"261060",3,63,18,45,32,31,0,0,0,0,0,63,18,45,32,31,34,9.56264307156975,10.9496304168504,0.393453341636232,31
"4179","PE","Paudalho",56933,14223.39,26013,"Mata Setentrional Pernambucana",2,"Nordeste",1,"261060",4,50,19,31,30,20,0,0,0,0,0,50,19,31,30,20,38,9.56264307156975,10.9496304168504,0.468355321375628,30
"4180","PE","Paudalho",56933,14223.39,26013,"Mata Setentrional Pernambucana",2,"Nordeste",1,"261060",5,76,33,43,41,35,2,1,1,2,0,78,34,44,43,35,59,9.56264307156975,10.9496304168504,0.453804721777225,31
"4181","PE","Paulista",334376,12731.32,26017,"Recife",2,"Nordeste",1,"261070",2,250,43,207,100,150,1,0,1,0,1,251,43,208,100,151,174,9.45182037824179,12.7200213872821,0.299346278035296,29
"4182","PE","Paulista",334376,12731.32,26017,"Recife",2,"Nordeste",1,"261070",3,283,56,227,96,187,1,0,1,1,0,284,56,228,97,187,182,9.45182037824179,12.7200213872821,0.428287675014589,31
"4183","PE","Paulista",334376,12731.32,26017,"Recife",2,"Nordeste",1,"261070",4,251,39,212,94,157,1,0,1,0,1,252,39,213,94,158,277,9.45182037824179,12.7200213872821,0.525525139934169,30
"4184","PE","Paulista",334376,12731.32,26017,"Recife",2,"Nordeste",1,"261070",5,257,46,211,111,146,3,1,2,3,0,260,47,213,114,146,383,9.45182037824179,12.7200213872821,0.51277580210055,31
"4185","PE","Pedra",22668,11037.24,26007,"Vale do Ipanema",2,"Nordeste",0,"261080",2,19,8,11,9,10,0,0,0,0,0,19,8,11,9,10,14,9.30903028857588,10.0287095172895,0.286690682879773,29
"4186","PE","Pedra",22668,11037.24,26007,"Vale do Ipanema",2,"Nordeste",0,"261080",3,25,18,7,18,7,0,0,0,0,0,25,18,7,18,7,15,9.30903028857588,10.0287095172895,0.357354869315061,31
"4187","PE","Pedra",22668,11037.24,26007,"Vale do Ipanema",2,"Nordeste",0,"261080",4,24,14,10,9,15,0,0,0,0,0,24,14,10,9,15,11,9.30903028857588,10.0287095172895,0.400282627490622,30
"4188","PE","Pedra",22668,11037.24,26007,"Vale do Ipanema",2,"Nordeste",0,"261080",5,21,12,9,14,7,0,0,0,0,0,21,12,9,14,7,17,9.30903028857588,10.0287095172895,0.43354898683832,31
"4189","PE","Pesqueira",67735,10269.85,26008,"Vale do Ipojuca",2,"Nordeste",1,"261090",2,74,27,47,41,33,2,1,1,0,2,76,28,48,41,35,41,9.23696769716842,11.1233583120148,0.299878685193573,29
"4190","PE","Pesqueira",67735,10269.85,26008,"Vale do Ipojuca",2,"Nordeste",1,"261090",3,71,23,48,24,47,2,0,2,0,2,73,23,50,24,49,45,9.23696769716842,11.1233583120148,0.386675066894383,31
"4191","PE","Pesqueira",67735,10269.85,26008,"Vale do Ipojuca",2,"Nordeste",1,"261090",4,50,21,29,21,29,0,0,0,0,0,50,21,29,21,29,39,9.23696769716842,11.1233583120148,0.425929901010715,30
"4192","PE","Pesqueira",67735,10269.85,26008,"Vale do Ipojuca",2,"Nordeste",1,"261090",5,80,34,46,31,49,1,1,0,1,0,81,35,46,32,49,48,9.23696769716842,11.1233583120148,0.426354780059675,31
"4193","PE","Petrolândia",36901,36751.1,26006,"Itaparica",2,"Nordeste",0,"261100",2,31,12,19,14,17,0,0,0,0,0,31,12,19,14,17,10,10.5119234361658,10.5159939299324,0.300989281040651,29
"4194","PE","Petrolândia",36901,36751.1,26006,"Itaparica",2,"Nordeste",0,"261100",3,40,19,21,18,22,1,0,1,0,1,41,19,22,18,23,15,10.5119234361658,10.5159939299324,0.401598066431799,31
"4195","PE","Petrolândia",36901,36751.1,26006,"Itaparica",2,"Nordeste",0,"261100",4,36,16,20,13,23,0,0,0,0,0,36,16,20,13,23,12,10.5119234361658,10.5159939299324,0.418013353385004,30
"4196","PE","Petrolândia",36901,36751.1,26006,"Itaparica",2,"Nordeste",0,"261100",5,42,18,24,17,25,0,0,0,0,0,42,18,24,17,25,18,10.5119234361658,10.5159939299324,0.414247744920897,31
"4197","PE","Petrolina",354317,19445.59,26005,"Petrolina",2,"Nordeste",1,"261110",2,503,141,362,202,301,3,1,2,2,1,506,142,364,204,302,141,9.87537558811977,12.7779472716387,0.280991434806431,29
"4198","PE","Petrolina",354317,19445.59,26005,"Petrolina",2,"Nordeste",1,"261110",3,444,126,318,184,260,3,0,3,1,2,447,126,321,185,262,164,9.87537558811977,12.7779472716387,0.393279274749042,31
"4199","PE","Petrolina",354317,19445.59,26005,"Petrolina",2,"Nordeste",1,"261110",4,471,124,347,183,288,4,2,2,1,3,475,126,349,184,291,167,9.87537558811977,12.7779472716387,0.448682581266533,30
"4200","PE","Petrolina",354317,19445.59,26005,"Petrolina",2,"Nordeste",1,"261110",5,523,146,377,205,318,4,1,3,2,2,527,147,380,207,320,145,9.87537558811977,12.7779472716387,0.428296090718965,31
"4201","PE","Poção",11305,7433.25,26008,"Vale do Ipojuca",2,"Nordeste",0,"261120",2,7,4,3,3,4,0,0,0,0,0,7,4,3,3,4,3,8.91371845795493,9.33300038471207,0.307921154247688,29
"4202","PE","Poção",11305,7433.25,26008,"Vale do Ipojuca",2,"Nordeste",0,"261120",3,13,7,6,6,7,0,0,0,0,0,13,7,6,6,7,5,8.91371845795493,9.33300038471207,0.396926311351351,31
"4203","PE","Poção",11305,7433.25,26008,"Vale do Ipojuca",2,"Nordeste",0,"261120",4,13,7,6,5,8,1,1,0,1,0,14,8,6,6,8,8,8.91371845795493,9.33300038471207,0.446840785111793,30
"4204","PE","Poção",11305,7433.25,26008,"Vale do Ipojuca",2,"Nordeste",0,"261120",5,13,6,7,9,4,0,0,0,0,0,13,6,7,9,4,11,8.91371845795493,9.33300038471207,0.439120957125379,31
"4205","PE","Pombos",27148,13530.65,26014,"Vitória de Santo Antão",2,"Nordeste",0,"261130",2,38,11,27,15,23,0,0,0,0,0,38,11,27,15,23,12,9.51271276140039,10.2090586578236,0.283321139937876,29
"4206","PE","Pombos",27148,13530.65,26014,"Vitória de Santo Antão",2,"Nordeste",0,"261130",3,31,9,22,11,20,0,0,0,0,0,31,9,22,11,20,14,9.51271276140039,10.2090586578236,0.373045989631261,31
"4207","PE","Pombos",27148,13530.65,26014,"Vitória de Santo Antão",2,"Nordeste",0,"261130",4,28,8,20,12,16,0,0,0,0,0,28,8,20,12,16,22,9.51271276140039,10.2090586578236,0.411313921897632,30
"4208","PE","Pombos",27148,13530.65,26014,"Vitória de Santo Antão",2,"Nordeste",0,"261130",5,24,8,16,10,14,0,0,0,0,0,24,8,16,10,14,35,9.51271276140039,10.2090586578236,0.418191576000629,31
"4209","PE","Primavera",15101,10731.75,26015,"Mata Meridional Pernambucana",2,"Nordeste",0,"261140",2,12,4,8,7,5,0,0,0,0,0,12,4,8,7,5,5,9.28096191645495,9.62251624577579,0.290207933926461,29
"4210","PE","Primavera",15101,10731.75,26015,"Mata Meridional Pernambucana",2,"Nordeste",0,"261140",3,11,7,4,5,6,0,0,0,0,0,11,7,4,5,6,8,9.28096191645495,9.62251624577579,0.369955411499104,31
"4211","PE","Primavera",15101,10731.75,26015,"Mata Meridional Pernambucana",2,"Nordeste",0,"261140",4,7,1,6,4,3,0,0,0,0,0,7,1,6,4,3,6,9.28096191645495,9.62251624577579,0.416784507756361,30
"4212","PE","Primavera",15101,10731.75,26015,"Mata Meridional Pernambucana",2,"Nordeste",0,"261140",5,5,3,2,3,2,0,0,0,0,0,5,3,2,3,2,18,9.28096191645495,9.62251624577579,0.434781049583779,31
"4213","PE","Quipapá",26175,6944.35,26015,"Mata Meridional Pernambucana",2,"Nordeste",0,"261150",2,24,9,15,13,11,0,0,0,0,0,24,9,15,13,11,15,8.84568365829579,10.1725600357387,0.295763481288195,29
"4214","PE","Quipapá",26175,6944.35,26015,"Mata Meridional Pernambucana",2,"Nordeste",0,"261150",3,15,9,6,9,6,1,0,1,0,1,16,9,7,9,7,15,8.84568365829579,10.1725600357387,0.403311790533956,31
"4215","PE","Quipapá",26175,6944.35,26015,"Mata Meridional Pernambucana",2,"Nordeste",0,"261150",4,18,9,9,7,11,0,0,0,0,0,18,9,9,7,11,12,8.84568365829579,10.1725600357387,0.443295275972407,30
"4216","PE","Quipapá",26175,6944.35,26015,"Mata Meridional Pernambucana",2,"Nordeste",0,"261150",5,22,10,12,14,8,0,0,0,0,0,22,10,12,14,8,13,8.84568365829579,10.1725600357387,0.436090557665958,31
"4217","PE","Quixaba",6805,7773.86,26003,"Pajeú",2,"Nordeste",0,"261153",2,4,0,4,1,3,0,0,0,0,0,4,0,4,1,3,3,8.9585221025029,8.82541291508557,0.309575651717107,29
"4218","PE","Quixaba",6805,7773.86,26003,"Pajeú",2,"Nordeste",0,"261153",3,13,0,13,3,10,0,0,0,0,0,13,0,13,3,10,4,8.9585221025029,8.82541291508557,0.36178030315157,31
"4219","PE","Quixaba",6805,7773.86,26003,"Pajeú",2,"Nordeste",0,"261153",4,6,3,3,3,3,0,0,0,0,0,6,3,3,3,3,2,8.9585221025029,8.82541291508557,0.403566916826655,30
"4220","PE","Quixaba",6805,7773.86,26003,"Pajeú",2,"Nordeste",0,"261153",5,7,0,7,4,3,0,0,0,0,0,7,0,7,4,3,5,8.9585221025029,8.82541291508557,0.42635976841872,31
"4221","PE","Recife",1653461,31994.38,26017,"Recife",2,"Nordeste",1,"261160",2,1377,280,1097,481,896,11,4,7,4,7,1388,284,1104,485,903,941,10.373315541358,14.3183812247938,0.297298011043789,29
"4222","PE","Recife",1653461,31994.38,26017,"Recife",2,"Nordeste",1,"261160",3,1329,304,1025,516,813,9,3,6,2,7,1338,307,1031,518,820,1058,10.373315541358,14.3183812247938,0.427724877884284,31
"4223","PE","Recife",1653461,31994.38,26017,"Recife",2,"Nordeste",1,"261160",4,1181,288,893,417,764,6,3,3,1,5,1187,291,896,418,769,1586,10.373315541358,14.3183812247938,0.53613140989467,30
"4224","PE","Recife",1653461,31994.38,26017,"Recife",2,"Nordeste",1,"261160",5,1401,295,1106,543,858,7,0,7,2,5,1408,295,1113,545,863,2389,10.373315541358,14.3183812247938,0.531335000594908,31
"4225","PE","Riacho das Almas",20646,8886.07,26008,"Vale do Ipojuca",2,"Nordeste",0,"261170",2,27,13,14,13,14,1,1,0,1,0,28,14,14,14,14,12,9.09224016102503,9.93527687502553,0.33068649630309,29
"4226","PE","Riacho das Almas",20646,8886.07,26008,"Vale do Ipojuca",2,"Nordeste",0,"261170",3,27,12,15,7,20,0,0,0,0,0,27,12,15,7,20,20,9.09224016102503,9.93527687502553,0.416582958738711,31
"4227","PE","Riacho das Almas",20646,8886.07,26008,"Vale do Ipojuca",2,"Nordeste",0,"261170",4,18,6,12,8,10,0,0,0,0,0,18,6,12,8,10,13,9.09224016102503,9.93527687502553,0.454300040592937,30
"4228","PE","Riacho das Almas",20646,8886.07,26008,"Vale do Ipojuca",2,"Nordeste",0,"261170",5,17,10,7,10,7,0,0,0,0,0,17,10,7,10,7,24,9.09224016102503,9.93527687502553,0.455489134388485,31
"4229","PE","Ribeirão",47616,9503.44,26015,"Mata Meridional Pernambucana",2,"Nordeste",1,"261180",2,34,10,24,19,15,0,0,0,0,0,34,10,24,19,15,30,9.1594091173075,10.7709241181928,0.29597189588034,29
"4230","PE","Ribeirão",47616,9503.44,26015,"Mata Meridional Pernambucana",2,"Nordeste",1,"261180",3,27,9,18,13,14,1,0,1,0,1,28,9,19,13,15,30,9.1594091173075,10.7709241181928,0.375876346892941,31
"4231","PE","Ribeirão",47616,9503.44,26015,"Mata Meridional Pernambucana",2,"Nordeste",1,"261180",4,26,13,13,13,13,0,0,0,0,0,26,13,13,13,13,27,9.1594091173075,10.7709241181928,0.422547778976441,30
"4232","PE","Ribeirão",47616,9503.44,26015,"Mata Meridional Pernambucana",2,"Nordeste",1,"261180",5,43,11,32,16,27,1,0,1,1,0,44,11,33,17,27,59,9.1594091173075,10.7709241181928,0.432811687801361,31
"4233","PE","Rio Formoso",23628,11369.56,26015,"Mata Meridional Pernambucana",2,"Nordeste",0,"261190",2,20,8,12,17,3,0,0,0,0,0,20,8,12,17,3,16,9.33869488766685,10.0701877284271,0.293635285297134,29
"4234","PE","Rio Formoso",23628,11369.56,26015,"Mata Meridional Pernambucana",2,"Nordeste",0,"261190",3,18,6,12,5,13,0,0,0,0,0,18,6,12,5,13,13,9.33869488766685,10.0701877284271,0.39078378675147,31
"4235","PE","Rio Formoso",23628,11369.56,26015,"Mata Meridional Pernambucana",2,"Nordeste",0,"261190",4,29,9,20,18,11,0,0,0,0,0,29,9,20,18,11,12,9.33869488766685,10.0701877284271,0.43867300956021,30
"4236","PE","Rio Formoso",23628,11369.56,26015,"Mata Meridional Pernambucana",2,"Nordeste",0,"261190",5,25,14,11,15,10,0,0,0,0,0,25,14,11,15,10,28,9.33869488766685,10.0701877284271,0.450588628362976,31
"4237","PE","Sairé",9764,12411.83,26012,"Brejo Pernambucano",2,"Nordeste",0,"261200",2,10,3,7,4,6,0,0,0,0,0,10,3,7,4,6,9,9.42640532905166,9.18645743151285,0.298274133575654,29
"4238","PE","Sairé",9764,12411.83,26012,"Brejo Pernambucano",2,"Nordeste",0,"261200",3,12,11,1,4,8,0,0,0,0,0,12,11,1,4,8,13,9.42640532905166,9.18645743151285,0.385026179637408,31
"4239","PE","Sairé",9764,12411.83,26012,"Brejo Pernambucano",2,"Nordeste",0,"261200",4,9,3,6,5,4,0,0,0,0,0,9,3,6,5,4,9,9.42640532905166,9.18645743151285,0.42523166507262,30
"4240","PE","Sairé",9764,12411.83,26012,"Brejo Pernambucano",2,"Nordeste",0,"261200",5,6,2,4,4,2,0,0,0,0,0,6,2,4,4,2,8,9.42640532905166,9.18645743151285,0.453453604347454,31
"4241","PE","Salgueiro",61249,14172.63,26002,"Salgueiro",2,"Nordeste",1,"261220",2,83,21,62,38,45,0,0,0,0,0,83,21,62,38,45,28,9.55906791884999,11.0227028017431,0.262641205138377,29
"4242","PE","Salgueiro",61249,14172.63,26002,"Salgueiro",2,"Nordeste",1,"261220",3,68,16,52,32,36,0,0,0,0,0,68,16,52,32,36,35,9.55906791884999,11.0227028017431,0.355053509887099,31
"4243","PE","Salgueiro",61249,14172.63,26002,"Salgueiro",2,"Nordeste",1,"261220",4,66,17,49,23,43,1,1,0,1,0,67,18,49,24,43,47,9.55906791884999,11.0227028017431,0.398786541440901,30
"4244","PE","Salgueiro",61249,14172.63,26002,"Salgueiro",2,"Nordeste",1,"261220",5,83,18,65,34,49,1,0,1,1,0,84,18,66,35,49,42,9.55906791884999,11.0227028017431,0.412194898854791,31
"4245","PE","Saloá",15862,8036.97,26011,"Garanhuns",2,"Nordeste",0,"261230",2,12,5,7,4,8,0,0,0,0,0,12,5,7,4,8,9,8.99180742546966,9.67168159064327,0.290000901868328,29
"4246","PE","Saloá",15862,8036.97,26011,"Garanhuns",2,"Nordeste",0,"261230",3,12,7,5,5,7,0,0,0,0,0,12,7,5,5,7,16,8.99180742546966,9.67168159064327,0.37554265903849,31
"4247","PE","Saloá",15862,8036.97,26011,"Garanhuns",2,"Nordeste",0,"261230",4,10,7,3,1,9,1,1,0,0,1,11,8,3,1,10,12,8.99180742546966,9.67168159064327,0.388754067430716,30
"4248","PE","Saloá",15862,8036.97,26011,"Garanhuns",2,"Nordeste",0,"261230",5,26,15,11,12,14,0,0,0,0,0,26,15,11,12,14,10,8.99180742546966,9.67168159064327,0.399301472274607,31
"4249","PE","Sanharó",26890,7652.79,26008,"Vale do Ipojuca",2,"Nordeste",0,"261240",2,18,9,9,10,8,0,0,0,0,0,18,9,9,10,8,12,8.94282556621391,10.1995097492629,0.276364801130867,29
"4250","PE","Sanharó",26890,7652.79,26008,"Vale do Ipojuca",2,"Nordeste",0,"261240",3,27,15,12,19,8,0,0,0,0,0,27,15,12,19,8,11,8.94282556621391,10.1995097492629,0.363791000192833,31
"4251","PE","Sanharó",26890,7652.79,26008,"Vale do Ipojuca",2,"Nordeste",0,"261240",4,27,11,16,8,19,0,0,0,0,0,27,11,16,8,19,8,8.94282556621391,10.1995097492629,0.373561052211691,30
"4252","PE","Sanharó",26890,7652.79,26008,"Vale do Ipojuca",2,"Nordeste",0,"261240",5,23,10,13,14,9,0,0,0,0,0,23,10,13,14,9,19,8.94282556621391,10.1995097492629,0.391245593727102,31
"4253","PE","Santa Cruz",15558,7137.75,26001,"Araripina",2,"Nordeste",0,"261245",2,15,7,8,9,6,0,0,0,0,0,15,7,8,9,6,4,8.87315287962056,9.65233025476672,0.255660915990578,29
"4254","PE","Santa Cruz",15558,7137.75,26001,"Araripina",2,"Nordeste",0,"261245",3,21,8,13,12,9,0,0,0,0,0,21,8,13,12,9,5,8.87315287962056,9.65233025476672,0.349232477328061,31
"4255","PE","Santa Cruz",15558,7137.75,26001,"Araripina",2,"Nordeste",0,"261245",4,14,4,10,5,9,0,0,0,0,0,14,4,10,5,9,7,8.87315287962056,9.65233025476672,0.376652377301988,30
"4256","PE","Santa Cruz",15558,7137.75,26001,"Araripina",2,"Nordeste",0,"261245",5,11,4,7,7,4,1,0,1,1,0,12,4,8,8,4,11,8.87315287962056,9.65233025476672,0.390348008302857,31
"4257","PE","Santa Cruz da Baixa Verde",12650,7231.3,26003,"Pajeú",2,"Nordeste",0,"261247",2,10,2,8,3,7,0,0,0,0,0,10,2,8,3,7,3,8.88617410535196,9.44541249415567,0.273585010331336,29
"4258","PE","Santa Cruz da Baixa Verde",12650,7231.3,26003,"Pajeú",2,"Nordeste",0,"261247",3,14,0,14,3,11,0,0,0,0,0,14,0,14,3,11,5,8.88617410535196,9.44541249415567,0.370134159091371,31
"4259","PE","Santa Cruz da Baixa Verde",12650,7231.3,26003,"Pajeú",2,"Nordeste",0,"261247",4,10,2,8,2,8,0,0,0,0,0,10,2,8,2,8,5,8.88617410535196,9.44541249415567,0.401700618458935,30
"4260","PE","Santa Cruz da Baixa Verde",12650,7231.3,26003,"Pajeú",2,"Nordeste",0,"261247",5,6,2,4,2,4,0,0,0,0,0,6,2,4,2,4,4,8.88617410535196,9.44541249415567,0.376861078760507,31
"4261","PE","Santa Cruz do Capibaribe",109897,14271.52,26009,"Alto Capibaribe",2,"Nordeste",1,"261250",2,104,45,59,41,63,1,0,1,0,1,105,45,60,41,64,37,9.56602122196722,11.6072988424759,0.304349886223768,29
"4262","PE","Santa Cruz do Capibaribe",109897,14271.52,26009,"Alto Capibaribe",2,"Nordeste",1,"261250",3,100,40,60,48,52,0,0,0,0,0,100,40,60,48,52,39,9.56602122196722,11.6072988424759,0.404365649236892,31
"4263","PE","Santa Cruz do Capibaribe",109897,14271.52,26009,"Alto Capibaribe",2,"Nordeste",1,"261250",4,89,42,47,38,51,1,1,0,0,1,90,43,47,38,52,32,9.56602122196722,11.6072988424759,0.445119025890343,30
"4264","PE","Santa Cruz do Capibaribe",109897,14271.52,26009,"Alto Capibaribe",2,"Nordeste",1,"261250",5,112,50,62,51,61,2,1,1,1,1,114,51,63,52,62,31,9.56602122196722,11.6072988424759,0.407192909096847,31
"4265","PE","Santa Filomena",14562,6809.16,26001,"Araripina",2,"Nordeste",0,"261255",2,17,8,9,7,10,1,0,1,1,0,18,8,10,8,10,7,8.82602404351795,9.58617067495466,0.276647340879692,29
"4266","PE","Santa Filomena",14562,6809.16,26001,"Araripina",2,"Nordeste",0,"261255",3,7,2,5,5,2,1,0,1,0,1,8,2,6,5,3,11,8.82602404351795,9.58617067495466,0.343328036888125,31
"4267","PE","Santa Filomena",14562,6809.16,26001,"Araripina",2,"Nordeste",0,"261255",4,18,9,9,6,12,0,0,0,0,0,18,9,9,6,12,8,8.82602404351795,9.58617067495466,0.403447980694444,30
"4268","PE","Santa Filomena",14562,6809.16,26001,"Araripina",2,"Nordeste",0,"261255",5,9,3,6,4,5,0,0,0,0,0,9,3,6,4,5,5,8.82602404351795,9.58617067495466,0.477152554153977,31
"4269","PE","Santa Maria da Boa Vista",42100,15806.8,26005,"Petrolina",2,"Nordeste",0,"261260",2,52,20,32,20,32,1,1,0,0,1,53,21,32,20,33,18,9.66819550617509,10.6478030196705,0.276438368909658,29
"4270","PE","Santa Maria da Boa Vista",42100,15806.8,26005,"Petrolina",2,"Nordeste",0,"261260",3,54,18,36,33,21,2,0,2,1,1,56,18,38,34,22,18,9.66819550617509,10.6478030196705,0.373448648391883,31
"4271","PE","Santa Maria da Boa Vista",42100,15806.8,26005,"Petrolina",2,"Nordeste",0,"261260",4,39,13,26,22,17,0,0,0,0,0,39,13,26,22,17,19,9.66819550617509,10.6478030196705,0.397444433800193,30
"4272","PE","Santa Maria da Boa Vista",42100,15806.8,26005,"Petrolina",2,"Nordeste",0,"261260",5,52,19,33,26,26,1,0,1,1,0,53,19,34,27,26,19,9.66819550617509,10.6478030196705,0.403200280622248,31
"4273","PE","Santa Maria do Cambucá",14223,7300.42,26009,"Alto Capibaribe",2,"Nordeste",0,"261270",2,10,5,5,5,5,0,0,0,0,0,10,5,5,5,5,8,8.89568715972803,9.56261565157023,0.315664546220117,29
"4274","PE","Santa Maria do Cambucá",14223,7300.42,26009,"Alto Capibaribe",2,"Nordeste",0,"261270",3,20,13,7,10,10,0,0,0,0,0,20,13,7,10,10,6,8.89568715972803,9.56261565157023,0.423734860429229,31
"4275","PE","Santa Maria do Cambucá",14223,7300.42,26009,"Alto Capibaribe",2,"Nordeste",0,"261270",4,9,8,1,4,5,2,1,1,1,1,11,9,2,5,6,10,8.89568715972803,9.56261565157023,0.474618269918633,30
"4276","PE","Santa Maria do Cambucá",14223,7300.42,26009,"Alto Capibaribe",2,"Nordeste",0,"261270",5,17,10,7,8,9,0,0,0,0,0,17,10,7,8,9,19,8.89568715972803,9.56261565157023,0.463938311422212,31
"4277","PE","Santa Terezinha",11865,7302.39,26003,"Pajeú",2,"Nordeste",0,"261280",2,12,1,11,3,9,0,0,0,0,0,12,1,11,3,9,3,8.89595697081397,9.38134816886986,0.295121061618947,29
"4278","PE","Santa Terezinha",11865,7302.39,26003,"Pajeú",2,"Nordeste",0,"261280",3,7,2,5,1,6,0,0,0,0,0,7,2,5,1,6,7,8.89595697081397,9.38134816886986,0.399508265982797,31
"4279","PE","Santa Terezinha",11865,7302.39,26003,"Pajeú",2,"Nordeste",0,"261280",4,8,1,7,4,4,1,1,0,1,0,9,2,7,5,4,5,8.89595697081397,9.38134816886986,0.409510522052034,30
"4280","PE","Santa Terezinha",11865,7302.39,26003,"Pajeú",2,"Nordeste",0,"261280",5,8,1,7,5,3,0,0,0,0,0,8,1,7,5,3,3,8.89595697081397,9.38134816886986,0.44189674156936,31
"4281","PE","São Benedito do Sul",16069,6147.44,26015,"Mata Meridional Pernambucana",2,"Nordeste",0,"261290",2,10,3,7,7,3,0,0,0,0,0,10,3,7,7,3,5,8.72379101397765,9.68464722904175,0.305132955992995,29
"4282","PE","São Benedito do Sul",16069,6147.44,26015,"Mata Meridional Pernambucana",2,"Nordeste",0,"261290",3,9,7,2,6,3,0,0,0,0,0,9,7,2,6,3,6,8.72379101397765,9.68464722904175,0.383903461890253,31
"4283","PE","São Benedito do Sul",16069,6147.44,26015,"Mata Meridional Pernambucana",2,"Nordeste",0,"261290",4,6,1,5,3,3,0,0,0,0,0,6,1,5,3,3,6,8.72379101397765,9.68464722904175,0.428716336647338,30
"4284","PE","São Benedito do Sul",16069,6147.44,26015,"Mata Meridional Pernambucana",2,"Nordeste",0,"261290",5,15,5,10,10,5,0,0,0,0,0,15,5,10,10,5,8,8.72379101397765,9.68464722904175,0.402024259131771,31
"4285","PE","São Bento do Una",60042,18409.77,26008,"Vale do Ipojuca",2,"Nordeste",0,"261300",2,74,36,38,32,42,0,0,0,0,0,74,36,38,32,42,32,9.82063678093887,11.0027995963185,0.285995163626898,29
"4286","PE","São Bento do Una",60042,18409.77,26008,"Vale do Ipojuca",2,"Nordeste",0,"261300",3,55,31,24,26,29,0,0,0,0,0,55,31,24,26,29,22,9.82063678093887,11.0027995963185,0.37435585123351,31
"4287","PE","São Bento do Una",60042,18409.77,26008,"Vale do Ipojuca",2,"Nordeste",0,"261300",4,44,21,23,18,26,1,0,1,0,1,45,21,24,18,27,29,9.82063678093887,11.0027995963185,0.405785150932647,30
"4288","PE","São Bento do Una",60042,18409.77,26008,"Vale do Ipojuca",2,"Nordeste",0,"261300",5,61,34,27,28,33,0,0,0,0,0,61,34,27,28,33,59,9.82063678093887,11.0027995963185,0.416588988725566,31
"4289","PE","São Caitano",37368,9628.38,26008,"Vale do Ipojuca",2,"Nordeste",0,"261310",2,41,19,22,19,22,0,0,0,0,0,41,19,22,19,22,22,9.17247026634181,10.5285700021819,0.276174160961384,29
"4290","PE","São Caitano",37368,9628.38,26008,"Vale do Ipojuca",2,"Nordeste",0,"261310",3,35,20,15,15,20,0,0,0,0,0,35,20,15,15,20,25,9.17247026634181,10.5285700021819,0.371365654647498,31
"4291","PE","São Caitano",37368,9628.38,26008,"Vale do Ipojuca",2,"Nordeste",0,"261310",4,40,23,17,16,24,0,0,0,0,0,40,23,17,16,24,24,9.17247026634181,10.5285700021819,0.427713097708573,30
"4292","PE","São Caitano",37368,9628.38,26008,"Vale do Ipojuca",2,"Nordeste",0,"261310",5,45,21,24,25,20,0,0,0,0,0,45,21,24,25,20,32,9.17247026634181,10.5285700021819,0.413109191183546,31
"4293","PE","São João",22899,9912.62,26011,"Garanhuns",2,"Nordeste",0,"261320",2,23,12,11,7,16,0,0,0,0,0,23,12,11,7,16,16,9.20156397179669,10.0388485204666,0.260612257289665,29
"4294","PE","São João",22899,9912.62,26011,"Garanhuns",2,"Nordeste",0,"261320",3,21,11,10,6,15,0,0,0,0,0,21,11,10,6,15,15,9.20156397179669,10.0388485204666,0.355343878814538,31
"4295","PE","São João",22899,9912.62,26011,"Garanhuns",2,"Nordeste",0,"261320",4,22,10,12,11,11,1,1,0,0,1,23,11,12,11,12,13,9.20156397179669,10.0388485204666,0.410739663420223,30
"4296","PE","São João",22899,9912.62,26011,"Garanhuns",2,"Nordeste",0,"261320",5,30,10,20,13,17,1,0,1,0,1,31,10,21,13,18,15,9.20156397179669,10.0388485204666,0.419982808724204,31
"4297","PE","São Joaquim do Monte",21398,7524.49,26012,"Brejo Pernambucano",2,"Nordeste",0,"261330",2,20,9,11,8,12,0,0,0,0,0,20,9,11,8,12,7,8.92591831323393,9.97105273869855,0.298435557116332,29
"4298","PE","São Joaquim do Monte",21398,7524.49,26012,"Brejo Pernambucano",2,"Nordeste",0,"261330",3,28,12,16,11,17,0,0,0,0,0,28,12,16,11,17,16,8.92591831323393,9.97105273869855,0.401811100211901,31
"4299","PE","São Joaquim do Monte",21398,7524.49,26012,"Brejo Pernambucano",2,"Nordeste",0,"261330",4,25,13,12,13,12,0,0,0,0,0,25,13,12,13,12,13,8.92591831323393,9.97105273869855,0.429845398014746,30
"4300","PE","São Joaquim do Monte",21398,7524.49,26012,"Brejo Pernambucano",2,"Nordeste",0,"261330",5,18,12,6,9,9,0,0,0,0,0,18,12,6,9,9,14,8.92591831323393,9.97105273869855,0.423060114629333,31
"4301","PE","São José da Coroa Grande",21586,11039.76,26015,"Mata Meridional Pernambucana",2,"Nordeste",1,"261340",2,15,6,9,8,7,0,0,0,0,0,15,6,9,8,7,12,9.30925858046435,9.97980023538529,0.293033100071647,29
"4302","PE","São José da Coroa Grande",21586,11039.76,26015,"Mata Meridional Pernambucana",2,"Nordeste",1,"261340",3,22,9,13,7,15,1,0,1,0,1,23,9,14,7,16,13,9.30925858046435,9.97980023538529,0.409997979957498,31
"4303","PE","São José da Coroa Grande",21586,11039.76,26015,"Mata Meridional Pernambucana",2,"Nordeste",1,"261340",4,19,5,14,10,9,0,0,0,0,0,19,5,14,10,9,10,9.30925858046435,9.97980023538529,0.459551408735213,30
"4304","PE","São José da Coroa Grande",21586,11039.76,26015,"Mata Meridional Pernambucana",2,"Nordeste",1,"261340",5,26,9,17,17,9,1,0,1,1,0,27,9,18,18,9,21,9.30925858046435,9.97980023538529,0.471763247482759,31
"4305","PE","São José do Belmonte",34021,8008.13,26002,"Salgueiro",2,"Nordeste",0,"261350",2,35,9,26,18,17,1,0,1,1,0,36,9,27,19,17,11,8.98821255462952,10.4347332599917,0.265171959133908,29
"4306","PE","São José do Belmonte",34021,8008.13,26002,"Salgueiro",2,"Nordeste",0,"261350",3,53,15,38,26,27,0,0,0,0,0,53,15,38,26,27,21,8.98821255462952,10.4347332599917,0.356997228775092,31
"4307","PE","São José do Belmonte",34021,8008.13,26002,"Salgueiro",2,"Nordeste",0,"261350",4,37,10,27,19,18,1,0,1,1,0,38,10,28,20,18,14,8.98821255462952,10.4347332599917,0.393677036969659,30
"4308","PE","São José do Belmonte",34021,8008.13,26002,"Salgueiro",2,"Nordeste",0,"261350",5,47,12,35,20,27,2,0,2,0,2,49,12,37,20,29,22,8.98821255462952,10.4347332599917,0.396289650186331,31
"4309","PE","São José do Egito",34056,11370.75,26003,"Pajeú",2,"Nordeste",0,"261360",2,33,11,22,21,12,1,1,0,0,1,34,12,22,21,13,20,9.3387995476298,10.435761507508,0.272250678581038,29
"4310","PE","São José do Egito",34056,11370.75,26003,"Pajeú",2,"Nordeste",0,"261360",3,29,6,23,15,14,0,0,0,0,0,29,6,23,15,14,28,9.3387995476298,10.435761507508,0.359252452403848,31
"4311","PE","São José do Egito",34056,11370.75,26003,"Pajeú",2,"Nordeste",0,"261360",4,39,12,27,16,23,1,0,1,1,0,40,12,28,17,23,28,9.3387995476298,10.435761507508,0.384980708101124,30
"4312","PE","São José do Egito",34056,11370.75,26003,"Pajeú",2,"Nordeste",0,"261360",5,33,6,27,16,17,0,0,0,0,0,33,6,27,16,17,23,9.3387995476298,10.435761507508,0.395734130876113,31
"4313","PE","São Lourenço da Mata",114079,10511.85,26017,"Recife",2,"Nordeste",1,"261370",2,125,25,100,47,78,2,0,2,1,1,127,25,102,48,79,57,9.26025847121619,11.6446464698313,0.300792751575627,29
"4314","PE","São Lourenço da Mata",114079,10511.85,26017,"Recife",2,"Nordeste",1,"261370",3,112,32,80,41,71,1,1,0,0,1,113,33,80,41,72,77,9.26025847121619,11.6446464698313,0.416299731830518,31
"4315","PE","São Lourenço da Mata",114079,10511.85,26017,"Recife",2,"Nordeste",1,"261370",4,112,30,82,52,60,0,0,0,0,0,112,30,82,52,60,115,9.26025847121619,11.6446464698313,0.513303266220433,30
"4316","PE","São Lourenço da Mata",114079,10511.85,26017,"Recife",2,"Nordeste",1,"261370",5,124,36,88,57,67,0,0,0,0,0,124,36,88,57,67,122,9.26025847121619,11.6446464698313,0.49704058577008,31
"4317","PE","São Vicente Férrer",18085,11866.54,26010,"Médio Capibaribe",2,"Nordeste",0,"261380",2,21,7,14,6,15,1,1,0,0,1,22,8,14,6,16,6,9.38147795395774,9.8028381443862,0.285326700037187,29
"4318","PE","São Vicente Férrer",18085,11866.54,26010,"Médio Capibaribe",2,"Nordeste",0,"261380",3,23,13,10,11,12,0,0,0,0,0,23,13,10,11,12,14,9.38147795395774,9.8028381443862,0.366876727206084,31
"4319","PE","São Vicente Férrer",18085,11866.54,26010,"Médio Capibaribe",2,"Nordeste",0,"261380",4,18,7,11,11,7,0,0,0,0,0,18,7,11,11,7,13,9.38147795395774,9.8028381443862,0.389523472594956,30
"4320","PE","São Vicente Férrer",18085,11866.54,26010,"Médio Capibaribe",2,"Nordeste",0,"261380",5,20,14,6,9,11,1,1,0,1,0,21,15,6,10,11,20,9.38147795395774,9.8028381443862,0.397082367514174,31
"4321","PE","Serra Talhada",86915,16007.65,26003,"Pajeú",2,"Nordeste",1,"261390",2,116,31,85,49,67,3,1,2,1,2,119,32,87,50,69,51,9.68082201195658,11.3726859085556,0.263725755715018,29
"4322","PE","Serra Talhada",86915,16007.65,26003,"Pajeú",2,"Nordeste",1,"261390",3,96,24,72,33,63,3,0,3,1,2,99,24,75,34,65,61,9.68082201195658,11.3726859085556,0.358101304191964,31
"4323","PE","Serra Talhada",86915,16007.65,26003,"Pajeú",2,"Nordeste",1,"261390",4,105,33,72,53,52,0,0,0,0,0,105,33,72,53,52,45,9.68082201195658,11.3726859085556,0.411570531983515,30
"4324","PE","Serra Talhada",86915,16007.65,26003,"Pajeú",2,"Nordeste",1,"261390",5,112,34,78,46,66,1,1,0,0,1,113,35,78,46,67,66,9.68082201195658,11.3726859085556,0.411849403821584,31
"4325","PE","Serrita",19196,7038,26002,"Salgueiro",2,"Nordeste",0,"261400",2,30,7,23,14,16,0,0,0,0,0,30,7,23,14,16,8,8.85907931788153,9.86245720297814,0.298756901581731,29
"4326","PE","Serrita",19196,7038,26002,"Salgueiro",2,"Nordeste",0,"261400",3,25,7,18,10,15,0,0,0,0,0,25,7,18,10,15,8,8.85907931788153,9.86245720297814,0.381207202883899,31
"4327","PE","Serrita",19196,7038,26002,"Salgueiro",2,"Nordeste",0,"261400",4,10,2,8,3,7,0,0,0,0,0,10,2,8,3,7,7,8.85907931788153,9.86245720297814,0.435284877654346,30
"4328","PE","Serrita",19196,7038,26002,"Salgueiro",2,"Nordeste",0,"261400",5,23,9,14,9,14,0,0,0,0,0,23,9,14,9,14,11,8.85907931788153,9.86245720297814,0.44308451925588,31
"4329","PE","Sertânia",36050,13764.78,26004,"Sertão do Moxotó",2,"Nordeste",0,"261410",2,49,19,30,15,34,0,0,0,0,0,49,19,30,15,34,18,9.52986843488451,10.4926621427131,0.273080301221032,29
"4330","PE","Sertânia",36050,13764.78,26004,"Sertão do Moxotó",2,"Nordeste",0,"261410",3,29,11,18,10,19,0,0,0,0,0,29,11,18,10,19,24,9.52986843488451,10.4926621427131,0.33701687912806,31
"4331","PE","Sertânia",36050,13764.78,26004,"Sertão do Moxotó",2,"Nordeste",0,"261410",4,37,12,25,17,20,1,0,1,0,1,38,12,26,17,21,19,9.52986843488451,10.4926621427131,0.391983620217253,30
"4332","PE","Sertânia",36050,13764.78,26004,"Sertão do Moxotó",2,"Nordeste",0,"261410",5,28,8,20,15,13,0,0,0,0,0,28,8,20,15,13,20,9.52986843488451,10.4926621427131,0.414307862654598,31
"4333","PE","Sirinhaém",46361,10824.5,26015,"Mata Meridional Pernambucana",2,"Nordeste",0,"261420",2,43,8,35,28,15,0,0,0,0,0,43,8,35,28,15,15,9.28956736242749,10.7442138675403,0.305711369422464,29
"4334","PE","Sirinhaém",46361,10824.5,26015,"Mata Meridional Pernambucana",2,"Nordeste",0,"261420",3,38,13,25,23,15,0,0,0,0,0,38,13,25,23,15,22,9.28956736242749,10.7442138675403,0.406910754475618,31
"4335","PE","Sirinhaém",46361,10824.5,26015,"Mata Meridional Pernambucana",2,"Nordeste",0,"261420",4,35,13,22,17,18,0,0,0,0,0,35,13,22,17,18,27,9.28956736242749,10.7442138675403,0.442380618938202,30
"4336","PE","Sirinhaém",46361,10824.5,26015,"Mata Meridional Pernambucana",2,"Nordeste",0,"261420",5,45,18,27,30,15,1,0,1,0,1,46,18,28,30,16,39,9.28956736242749,10.7442138675403,0.461276440416896,31
"4337","PE","Moreilândia",11270,7259.99,26001,"Araripina",2,"Nordeste",0,"261430",2,8,6,2,3,5,0,0,0,0,0,8,6,2,3,5,5,8.89013373040742,9.32989960703382,0.289607699201253,29
"4338","PE","Moreilândia",11270,7259.99,26001,"Araripina",2,"Nordeste",0,"261430",3,6,1,5,3,3,0,0,0,0,0,6,1,5,3,3,5,8.89013373040742,9.32989960703382,0.380271226142105,31
"4339","PE","Moreilândia",11270,7259.99,26001,"Araripina",2,"Nordeste",0,"261430",4,7,3,4,4,3,0,0,0,0,0,7,3,4,4,3,6,8.89013373040742,9.32989960703382,0.402500817370029,30
"4340","PE","Moreilândia",11270,7259.99,26001,"Araripina",2,"Nordeste",0,"261430",5,8,3,5,1,7,1,1,0,1,0,9,4,5,2,7,6,8.89013373040742,9.32989960703382,0.419558261601378,31
"4341","PE","Surubim",65647,11683.83,26009,"Alto Capibaribe",2,"Nordeste",1,"261450",2,69,29,40,32,37,3,2,1,1,2,72,31,41,33,39,43,9.36596111359007,11.0920471818094,0.278272108015699,29
"4342","PE","Surubim",65647,11683.83,26009,"Alto Capibaribe",2,"Nordeste",1,"261450",3,57,23,34,22,35,1,0,1,0,1,58,23,35,22,36,49,9.36596111359007,11.0920471818094,0.38514967646036,31
"4343","PE","Surubim",65647,11683.83,26009,"Alto Capibaribe",2,"Nordeste",1,"261450",4,55,17,38,21,34,1,0,1,0,1,56,17,39,21,35,31,9.36596111359007,11.0920471818094,0.441885069619333,30
"4344","PE","Surubim",65647,11683.83,26009,"Alto Capibaribe",2,"Nordeste",1,"261450",5,73,20,53,31,42,0,0,0,0,0,73,20,53,31,42,38,9.36596111359007,11.0920471818094,0.422585653732008,31
"4345","PE","Tabira",28704,9351.99,26003,"Pajeú",2,"Nordeste",0,"261460",2,38,8,30,11,27,0,0,0,0,0,38,8,30,11,27,10,9.14334443386134,10.2647917648585,0.245501690600059,29
"4346","PE","Tabira",28704,9351.99,26003,"Pajeú",2,"Nordeste",0,"261460",3,42,4,38,15,27,0,0,0,0,0,42,4,38,15,27,20,9.14334443386134,10.2647917648585,0.344579210715317,31
"4347","PE","Tabira",28704,9351.99,26003,"Pajeú",2,"Nordeste",0,"261460",4,24,1,23,14,10,0,0,0,0,0,24,1,23,14,10,18,9.14334443386134,10.2647917648585,0.385843525769498,30
"4348","PE","Tabira",28704,9351.99,26003,"Pajeú",2,"Nordeste",0,"261460",5,22,2,20,6,16,0,0,0,0,0,22,2,20,6,16,17,9.14334443386134,10.2647917648585,0.372624707226241,31
"4349","PE","Tacaimbó",12859,12610.99,26008,"Vale do Ipojuca",2,"Nordeste",0,"261470",2,15,4,11,5,10,0,0,0,0,0,15,4,11,5,10,4,9.44232393499703,9.46179923427044,0.292081300843945,29
"4350","PE","Tacaimbó",12859,12610.99,26008,"Vale do Ipojuca",2,"Nordeste",0,"261470",3,13,5,8,4,9,0,0,0,0,0,13,5,8,4,9,5,9.44232393499703,9.46179923427044,0.372354933195467,31
"4351","PE","Tacaimbó",12859,12610.99,26008,"Vale do Ipojuca",2,"Nordeste",0,"261470",4,13,7,6,4,9,0,0,0,0,0,13,7,6,4,9,10,9.44232393499703,9.46179923427044,0.391570711094443,30
"4352","PE","Tacaimbó",12859,12610.99,26008,"Vale do Ipojuca",2,"Nordeste",0,"261470",5,11,4,7,6,5,0,0,0,0,0,11,4,7,6,5,6,9.44232393499703,9.46179923427044,0.399431749095346,31
"4353","PE","Tacaratu",26106,6818.94,26006,"Itaparica",2,"Nordeste",0,"261480",2,16,6,10,7,9,0,0,0,0,0,16,6,10,7,9,9,8.82745931353782,10.1699204519487,0.329287643940263,29
"4354","PE","Tacaratu",26106,6818.94,26006,"Itaparica",2,"Nordeste",0,"261480",3,12,4,8,4,8,2,0,2,1,1,14,4,10,5,9,10,8.82745931353782,10.1699204519487,0.419956790737065,31
"4355","PE","Tacaratu",26106,6818.94,26006,"Itaparica",2,"Nordeste",0,"261480",4,29,11,18,13,16,1,1,0,0,1,30,12,18,13,17,9,8.82745931353782,10.1699204519487,0.442945883277935,30
"4356","PE","Tacaratu",26106,6818.94,26006,"Itaparica",2,"Nordeste",0,"261480",5,27,16,11,15,12,0,0,0,0,0,27,16,11,15,12,9,8.82745931353782,10.1699204519487,0.450996307573438,31
"4357","PE","Tamandaré",23623,12486.08,26015,"Mata Meridional Pernambucana",2,"Nordeste",0,"261485",2,26,11,15,13,13,0,0,0,0,0,26,11,15,13,13,10,9.4323697027772,10.0699760926938,0.27650423687283,29
"4358","PE","Tamandaré",23623,12486.08,26015,"Mata Meridional Pernambucana",2,"Nordeste",0,"261485",3,21,7,14,16,5,0,0,0,0,0,21,7,14,16,5,12,9.4323697027772,10.0699760926938,0.37972699341948,31
"4359","PE","Tamandaré",23623,12486.08,26015,"Mata Meridional Pernambucana",2,"Nordeste",0,"261485",4,29,6,23,17,12,1,0,1,0,1,30,6,24,17,13,14,9.4323697027772,10.0699760926938,0.4346806953878,30
"4360","PE","Tamandaré",23623,12486.08,26015,"Mata Meridional Pernambucana",2,"Nordeste",0,"261485",5,30,17,13,16,14,1,1,0,1,0,31,18,13,17,14,21,9.4323697027772,10.0699760926938,0.447407812473774,31
"4361","PE","Taquaritinga do Norte",29127,9871.23,26009,"Alto Capibaribe",2,"Nordeste",0,"261500",2,22,9,13,16,6,0,0,0,0,0,22,9,13,16,6,12,9.19737974472388,10.2794208580383,0.308366617057462,29
"4362","PE","Taquaritinga do Norte",29127,9871.23,26009,"Alto Capibaribe",2,"Nordeste",0,"261500",3,22,9,13,12,10,0,0,0,0,0,22,9,13,12,10,11,9.19737974472388,10.2794208580383,0.410184550196383,31
"4363","PE","Taquaritinga do Norte",29127,9871.23,26009,"Alto Capibaribe",2,"Nordeste",0,"261500",4,34,10,24,12,22,0,0,0,0,0,34,10,24,12,22,17,9.19737974472388,10.2794208580383,0.438798352452737,30
"4364","PE","Taquaritinga do Norte",29127,9871.23,26009,"Alto Capibaribe",2,"Nordeste",0,"261500",5,26,9,17,13,13,0,0,0,0,0,26,9,17,13,13,20,9.19737974472388,10.2794208580383,0.420903023355493,31
"4365","PE","Terra Nova",10206,6866.55,26005,"Petrolina",2,"Nordeste",0,"261520",2,7,3,4,1,6,0,0,0,0,0,7,3,4,1,6,3,8.83441707567396,9.23073106162392,0.289058643389424,29
"4366","PE","Terra Nova",10206,6866.55,26005,"Petrolina",2,"Nordeste",0,"261520",3,8,2,6,4,4,0,0,0,0,0,8,2,6,4,4,7,8.83441707567396,9.23073106162392,0.392443747398123,31
"4367","PE","Terra Nova",10206,6866.55,26005,"Petrolina",2,"Nordeste",0,"261520",4,12,6,6,5,7,0,0,0,0,0,12,6,6,5,7,5,8.83441707567396,9.23073106162392,0.431853526606987,30
"4368","PE","Terra Nova",10206,6866.55,26005,"Petrolina",2,"Nordeste",0,"261520",5,10,2,8,3,7,0,0,0,0,0,10,2,8,3,7,3,8.83441707567396,9.23073106162392,0.428390672641292,31
"4369","PE","Timbaúba",52802,13378.85,26013,"Mata Setentrional Pernambucana",2,"Nordeste",1,"261530",2,54,17,37,25,29,1,0,1,1,0,55,17,38,26,29,33,9.5014303808105,10.8743043477648,0.290891507188674,29
"4370","PE","Timbaúba",52802,13378.85,26013,"Mata Setentrional Pernambucana",2,"Nordeste",1,"261530",3,42,14,28,17,25,0,0,0,0,0,42,14,28,17,25,43,9.5014303808105,10.8743043477648,0.375802824846975,31
"4371","PE","Timbaúba",52802,13378.85,26013,"Mata Setentrional Pernambucana",2,"Nordeste",1,"261530",4,46,15,31,15,31,1,0,1,0,1,47,15,32,15,32,42,9.5014303808105,10.8743043477648,0.427508891107488,30
"4372","PE","Timbaúba",52802,13378.85,26013,"Mata Setentrional Pernambucana",2,"Nordeste",1,"261530",5,51,16,35,14,37,0,0,0,0,0,51,16,35,14,37,59,9.5014303808105,10.8743043477648,0.422985915000418,31
"4373","PE","Toritama",46164,14800.44,26009,"Alto Capibaribe",2,"Nordeste",1,"261540",2,54,38,16,28,26,1,0,1,1,0,55,38,17,29,26,8,9.60241218904002,10.7399555525403,0.310447521121678,29
"4374","PE","Toritama",46164,14800.44,26009,"Alto Capibaribe",2,"Nordeste",1,"261540",3,55,28,27,27,28,0,0,0,0,0,55,28,27,27,28,15,9.60241218904002,10.7399555525403,0.392579233356297,31
"4375","PE","Toritama",46164,14800.44,26009,"Alto Capibaribe",2,"Nordeste",1,"261540",4,51,24,27,28,23,1,1,0,0,1,52,25,27,28,24,10,9.60241218904002,10.7399555525403,0.443338126478438,30
"4376","PE","Toritama",46164,14800.44,26009,"Alto Capibaribe",2,"Nordeste",1,"261540",5,44,29,15,22,22,0,0,0,0,0,44,29,15,22,22,27,9.60241218904002,10.7399555525403,0.419429348329039,31
"4377","PE","Tracunhaém",13813,8596.93,26013,"Mata Setentrional Pernambucana",2,"Nordeste",1,"261550",2,15,7,8,5,10,0,0,0,0,0,15,7,8,5,10,5,9.05916044176605,9.53336545669996,0.307740643548865,29
"4378","PE","Tracunhaém",13813,8596.93,26013,"Mata Setentrional Pernambucana",2,"Nordeste",1,"261550",3,18,9,9,9,9,0,0,0,0,0,18,9,9,9,9,9,9.05916044176605,9.53336545669996,0.392356411909893,31
"4379","PE","Tracunhaém",13813,8596.93,26013,"Mata Setentrional Pernambucana",2,"Nordeste",1,"261550",4,16,3,13,11,5,0,0,0,0,0,16,3,13,11,5,5,9.05916044176605,9.53336545669996,0.439002356447526,30
"4380","PE","Tracunhaém",13813,8596.93,26013,"Mata Setentrional Pernambucana",2,"Nordeste",1,"261550",5,15,2,13,9,6,0,0,0,0,0,15,2,13,9,6,12,9.05916044176605,9.53336545669996,0.417682298732549,31
"4381","PE","Trindade",30816,10451.1,26001,"Araripina",2,"Nordeste",1,"261560",2,38,11,27,25,13,0,0,0,0,0,38,11,27,25,13,16,9.25446251501107,10.3357893145979,0.27713311054517,29
"4382","PE","Trindade",30816,10451.1,26001,"Araripina",2,"Nordeste",1,"261560",3,43,16,27,25,18,0,0,0,0,0,43,16,27,25,18,17,9.25446251501107,10.3357893145979,0.353879867511985,31
"4383","PE","Trindade",30816,10451.1,26001,"Araripina",2,"Nordeste",1,"261560",4,31,7,24,18,13,0,0,0,0,0,31,7,24,18,13,15,9.25446251501107,10.3357893145979,0.366999261967686,30
"4384","PE","Trindade",30816,10451.1,26001,"Araripina",2,"Nordeste",1,"261560",5,36,14,22,15,21,0,0,0,0,0,36,14,22,15,21,20,9.25446251501107,10.3357893145979,0.376128204226833,31
"4385","PE","Triunfo",15243,9305.72,26003,"Pajeú",2,"Nordeste",0,"261570",2,12,2,10,5,7,0,0,0,0,0,12,2,10,5,7,11,9.13838454383674,9.63187566026184,0.261862323351646,29
"4386","PE","Triunfo",15243,9305.72,26003,"Pajeú",2,"Nordeste",0,"261570",3,13,1,12,6,7,0,0,0,0,0,13,1,12,6,7,14,9.13838454383674,9.63187566026184,0.368066172894628,31
"4387","PE","Triunfo",15243,9305.72,26003,"Pajeú",2,"Nordeste",0,"261570",4,9,1,8,5,4,0,0,0,0,0,9,1,8,5,4,16,9.13838454383674,9.63187566026184,0.417865624100095,30
"4388","PE","Triunfo",15243,9305.72,26003,"Pajeú",2,"Nordeste",0,"261570",5,16,2,14,7,9,0,0,0,0,0,16,2,14,7,9,14,9.13838454383674,9.63187566026184,0.444888279824592,31
"4389","PE","Tupanatinga",27551,6882.65,26007,"Vale do Ipanema",2,"Nordeste",0,"261580",2,26,16,10,15,11,0,0,0,0,0,26,16,10,15,11,5,8.83675903118537,10.223794111563,0.274786750418671,29
"4390","PE","Tupanatinga",27551,6882.65,26007,"Vale do Ipanema",2,"Nordeste",0,"261580",3,31,13,18,16,15,1,0,1,1,0,32,13,19,17,15,12,8.83675903118537,10.223794111563,0.363686635680643,31
"4391","PE","Tupanatinga",27551,6882.65,26007,"Vale do Ipanema",2,"Nordeste",0,"261580",4,21,9,12,12,9,1,1,0,0,1,22,10,12,12,10,9,8.83675903118537,10.223794111563,0.393015028806343,30
"4392","PE","Tupanatinga",27551,6882.65,26007,"Vale do Ipanema",2,"Nordeste",0,"261580",5,25,17,8,14,11,0,0,0,0,0,25,17,8,14,11,12,8.83675903118537,10.223794111563,0.430189141699031,31
"4393","PE","Tuparetama",8256,9611.67,26003,"Pajeú",2,"Nordeste",0,"261590",2,11,3,8,6,5,0,0,0,0,0,11,3,8,6,5,4,9.17073326418211,9.01869548772134,0.248381242946619,29
"4394","PE","Tuparetama",8256,9611.67,26003,"Pajeú",2,"Nordeste",0,"261590",3,11,4,7,8,3,0,0,0,0,0,11,4,7,8,3,7,9.17073326418211,9.01869548772134,0.327523791415955,31
"4395","PE","Tuparetama",8256,9611.67,26003,"Pajeú",2,"Nordeste",0,"261590",4,10,2,8,5,5,0,0,0,0,0,10,2,8,5,5,10,9.17073326418211,9.01869548772134,0.356113484629947,30
"4396","PE","Tuparetama",8256,9611.67,26003,"Pajeú",2,"Nordeste",0,"261590",5,6,2,4,2,4,0,0,0,0,0,6,2,4,2,4,8,9.17073326418211,9.01869548772134,0.352829864406987,31
"4397","PE","Venturosa",18661,11783.13,26007,"Vale do Ipanema",2,"Nordeste",0,"261600",2,20,12,8,9,11,0,0,0,0,0,20,12,8,9,11,8,9.37442412649641,9.83419106353347,0.279139652022287,29
"4398","PE","Venturosa",18661,11783.13,26007,"Vale do Ipanema",2,"Nordeste",0,"261600",3,16,3,13,8,8,1,0,1,0,1,17,3,14,8,9,14,9.37442412649641,9.83419106353347,0.345191241965656,31
"4399","PE","Venturosa",18661,11783.13,26007,"Vale do Ipanema",2,"Nordeste",0,"261600",4,21,14,7,10,11,0,0,0,0,0,21,14,7,10,11,16,9.37442412649641,9.83419106353347,0.382808813637572,30
"4400","PE","Venturosa",18661,11783.13,26007,"Vale do Ipanema",2,"Nordeste",0,"261600",5,20,7,13,9,11,0,0,0,0,0,20,7,13,9,11,16,9.37442412649641,9.83419106353347,0.402465170441585,31
"4401","PE","Verdejante",9553,7186.55,26002,"Salgueiro",2,"Nordeste",0,"261610",2,11,2,9,4,7,0,0,0,0,0,11,2,9,4,7,4,8.87996650245682,9.16461052027001,0.275172902452791,29
"4402","PE","Verdejante",9553,7186.55,26002,"Salgueiro",2,"Nordeste",0,"261610",3,9,3,6,5,4,0,0,0,0,0,9,3,6,5,4,5,8.87996650245682,9.16461052027001,0.398571636934298,31
"4403","PE","Verdejante",9553,7186.55,26002,"Salgueiro",2,"Nordeste",0,"261610",4,6,3,3,3,3,1,0,1,0,1,7,3,4,3,4,5,8.87996650245682,9.16461052027001,0.422602544246673,30
"4404","PE","Verdejante",9553,7186.55,26002,"Salgueiro",2,"Nordeste",0,"261610",5,13,4,9,5,8,1,0,1,1,0,14,4,10,6,8,5,8.87996650245682,9.16461052027001,0.45486138969282,31
"4405","PE","Vertente do Lério",7571,7829.31,26009,"Alto Capibaribe",2,"Nordeste",0,"261618",2,8,2,6,2,6,0,0,0,0,0,8,2,6,2,6,7,8.96562966249646,8.93208043810331,0.285429640031271,29
"4406","PE","Vertente do Lério",7571,7829.31,26009,"Alto Capibaribe",2,"Nordeste",0,"261618",3,9,3,6,4,5,0,0,0,0,0,9,3,6,4,5,7,8.96562966249646,8.93208043810331,0.390243109675954,31
"4407","PE","Vertente do Lério",7571,7829.31,26009,"Alto Capibaribe",2,"Nordeste",0,"261618",4,11,6,5,5,6,0,0,0,0,0,11,6,5,5,6,8,8.96562966249646,8.93208043810331,0.44422407902158,30
"4408","PE","Vertente do Lério",7571,7829.31,26009,"Alto Capibaribe",2,"Nordeste",0,"261618",5,7,5,2,2,5,0,0,0,0,0,7,5,2,2,5,4,8.96562966249646,8.93208043810331,0.431763094168023,31
"4409","PE","Vertentes",20954,7806.45,26009,"Alto Capibaribe",2,"Nordeste",0,"261620",2,31,15,16,13,18,0,0,0,0,0,31,15,16,13,18,5,8.96270559404209,9.95008483791291,0.307929265640808,29
"4410","PE","Vertentes",20954,7806.45,26009,"Alto Capibaribe",2,"Nordeste",0,"261620",3,27,17,10,17,10,0,0,0,0,0,27,17,10,17,10,12,8.96270559404209,9.95008483791291,0.410424417951641,31
"4411","PE","Vertentes",20954,7806.45,26009,"Alto Capibaribe",2,"Nordeste",0,"261620",4,15,9,6,4,11,0,0,0,0,0,15,9,6,4,11,12,8.96270559404209,9.95008483791291,0.478392705384475,30
"4412","PE","Vertentes",20954,7806.45,26009,"Alto Capibaribe",2,"Nordeste",0,"261620",5,40,18,22,13,27,0,0,0,0,0,40,18,22,13,27,16,8.96270559404209,9.95008483791291,0.451875600056826,31
"4413","PE","Vicência",32772,10631.56,26013,"Mata Setentrional Pernambucana",2,"Nordeste",0,"261630",2,40,13,27,21,19,0,0,0,0,0,40,13,27,21,19,13,9.2715822150371,10.3973297712617,0.305229334957944,29
"4414","PE","Vicência",32772,10631.56,26013,"Mata Setentrional Pernambucana",2,"Nordeste",0,"261630",3,25,8,17,17,8,0,0,0,0,0,25,8,17,17,8,13,9.2715822150371,10.3973297712617,0.389723795025066,31
"4415","PE","Vicência",32772,10631.56,26013,"Mata Setentrional Pernambucana",2,"Nordeste",0,"261630",4,27,10,17,16,11,2,0,2,2,0,29,10,19,18,11,15,9.2715822150371,10.3973297712617,0.42803727500029,30
"4416","PE","Vicência",32772,10631.56,26013,"Mata Setentrional Pernambucana",2,"Nordeste",0,"261630",5,31,11,20,10,21,0,0,0,0,0,31,11,20,10,21,29,9.2715822150371,10.3973297712617,0.421612059967473,31
"4417","PE","Vitória de Santo Antão",139583,26964.56,26014,"Vitória de Santo Antão",2,"Nordeste",1,"261640",2,137,42,95,59,78,1,0,1,0,1,138,42,96,59,79,89,10.2022786901897,11.8464146853908,0.282807239464042,29
"4418","PE","Vitória de Santo Antão",139583,26964.56,26014,"Vitória de Santo Antão",2,"Nordeste",1,"261640",3,144,50,94,57,87,1,0,1,0,1,145,50,95,57,88,95,10.2022786901897,11.8464146853908,0.3758488060453,31
"4419","PE","Vitória de Santo Antão",139583,26964.56,26014,"Vitória de Santo Antão",2,"Nordeste",1,"261640",4,125,50,75,59,66,1,0,1,0,1,126,50,76,59,67,117,10.2022786901897,11.8464146853908,0.435459587210795,30
"4420","PE","Vitória de Santo Antão",139583,26964.56,26014,"Vitória de Santo Antão",2,"Nordeste",1,"261640",5,150,59,91,69,81,0,0,0,0,0,150,59,91,69,81,205,10.2022786901897,11.8464146853908,0.432680500463567,31
"4421","PE","Xexéu",14757,8422.31,26015,"Mata Meridional Pernambucana",2,"Nordeste",0,"261650",2,19,7,12,9,10,0,0,0,0,0,19,7,12,9,10,14,9.03863941640352,9.59947282546345,0.343994670767174,29
"4422","PE","Xexéu",14757,8422.31,26015,"Mata Meridional Pernambucana",2,"Nordeste",0,"261650",3,19,8,11,10,9,0,0,0,0,0,19,8,11,10,9,12,9.03863941640352,9.59947282546345,0.42067541226655,31
"4423","PE","Xexéu",14757,8422.31,26015,"Mata Meridional Pernambucana",2,"Nordeste",0,"261650",4,19,9,10,11,8,0,0,0,0,0,19,9,10,11,8,11,9.03863941640352,9.59947282546345,0.458504721103227,30
"4424","PE","Xexéu",14757,8422.31,26015,"Mata Meridional Pernambucana",2,"Nordeste",0,"261650",5,19,5,14,10,9,1,1,0,1,0,20,6,14,11,9,18,9.03863941640352,9.59947282546345,0.467800784865037,31
"4425","AL","Água Branca",20230,7004.81,27001,"Serrana do Sertão Alagoano",2,"Nordeste",0,"270010",2,26,15,11,11,15,1,0,1,0,1,27,15,12,11,16,12,8.85435233492003,9.91492193016179,0.287189988119804,29
"4426","AL","Água Branca",20230,7004.81,27001,"Serrana do Sertão Alagoano",2,"Nordeste",0,"270010",3,22,14,8,9,13,0,0,0,0,0,22,14,8,9,13,8,8.85435233492003,9.91492193016179,0.413022768198452,31
"4427","AL","Água Branca",20230,7004.81,27001,"Serrana do Sertão Alagoano",2,"Nordeste",0,"270010",4,16,10,6,10,6,0,0,0,0,0,16,10,6,10,6,11,8.85435233492003,9.91492193016179,0.465244760659817,30
"4428","AL","Água Branca",20230,7004.81,27001,"Serrana do Sertão Alagoano",2,"Nordeste",0,"270010",5,25,14,11,12,13,0,0,0,0,0,25,14,11,12,13,17,8.85435233492003,9.91492193016179,0.473397863462993,31
"4429","AL","Anadia",17526,9399.28,27012,"São Miguel dos Campos",2,"Nordeste",0,"270020",2,12,5,7,10,2,0,0,0,0,0,12,5,7,10,2,12,9.14838836957981,9.7714407716158,0.286234283858442,29
"4430","AL","Anadia",17526,9399.28,27012,"São Miguel dos Campos",2,"Nordeste",0,"270020",3,10,5,5,6,4,0,0,0,0,0,10,5,5,6,4,11,9.14838836957981,9.7714407716158,0.370451554065099,31
"4431","AL","Anadia",17526,9399.28,27012,"São Miguel dos Campos",2,"Nordeste",0,"270020",4,11,3,8,6,5,0,0,0,0,0,11,3,8,6,5,13,9.14838836957981,9.7714407716158,0.374006837111797,30
"4432","AL","Anadia",17526,9399.28,27012,"São Miguel dos Campos",2,"Nordeste",0,"270020",5,17,10,7,10,7,0,0,0,0,0,17,10,7,10,7,7,9.14838836957981,9.7714407716158,0.391659928125151,31
"4433","AL","Arapiraca",233047,19389.15,27006,"Arapiraca",2,"Nordeste",1,"270030",2,281,119,162,116,165,1,1,0,0,1,282,120,162,116,166,121,9.87246891024643,12.3589954289439,0.278110054282286,29
"4434","AL","Arapiraca",233047,19389.15,27006,"Arapiraca",2,"Nordeste",1,"270030",3,281,100,181,120,161,0,0,0,0,0,281,100,181,120,161,145,9.87246891024643,12.3589954289439,0.363473958346321,31
"4435","AL","Arapiraca",233047,19389.15,27006,"Arapiraca",2,"Nordeste",1,"270030",4,291,116,175,117,174,0,0,0,0,0,291,116,175,117,174,129,9.87246891024643,12.3589954289439,0.388760832428091,30
"4436","AL","Arapiraca",233047,19389.15,27006,"Arapiraca",2,"Nordeste",1,"270030",5,346,146,200,148,198,0,0,0,0,0,346,146,200,148,198,186,9.87246891024643,12.3589954289439,0.391994282521143,31
"4437","AL","Atalaia",47365,16261.59,27009,"Mata Alagoana",2,"Nordeste",1,"270040",2,51,23,28,27,24,0,0,0,0,0,51,23,28,27,24,13,9.69656116429892,10.7656388383096,0.303832424433796,29
"4438","AL","Atalaia",47365,16261.59,27009,"Mata Alagoana",2,"Nordeste",1,"270040",3,32,24,8,16,16,1,0,1,0,1,33,24,9,16,17,24,9.69656116429892,10.7656388383096,0.389028590514599,31
"4439","AL","Atalaia",47365,16261.59,27009,"Mata Alagoana",2,"Nordeste",1,"270040",4,47,27,20,25,22,1,1,0,1,0,48,28,20,26,22,20,9.69656116429892,10.7656388383096,0.416087646426946,30
"4440","AL","Atalaia",47365,16261.59,27009,"Mata Alagoana",2,"Nordeste",1,"270040",5,55,28,27,28,27,0,0,0,0,0,55,28,27,28,27,31,9.69656116429892,10.7656388383096,0.42924728300108,31
"4441","AL","Barra de Santo Antônio",16068,11013.89,27011,"Maceió",2,"Nordeste",1,"270050",2,29,13,16,18,11,0,0,0,0,0,29,13,16,18,11,9,9.30691248248365,9.68458499547917,0.305912147380177,29
"4442","AL","Barra de Santo Antônio",16068,11013.89,27011,"Maceió",2,"Nordeste",1,"270050",3,18,11,7,14,4,0,0,0,0,0,18,11,7,14,4,10,9.30691248248365,9.68458499547917,0.40809146307848,31
"4443","AL","Barra de Santo Antônio",16068,11013.89,27011,"Maceió",2,"Nordeste",1,"270050",4,15,9,6,10,5,0,0,0,0,0,15,9,6,10,5,4,9.30691248248365,9.68458499547917,0.444238134542716,30
"4444","AL","Barra de Santo Antônio",16068,11013.89,27011,"Maceió",2,"Nordeste",1,"270050",5,19,9,10,12,7,0,0,0,0,0,19,9,10,12,7,14,9.30691248248365,9.68458499547917,0.450780034336751,31
"4445","AL","Barra de São Miguel",8378,23554.26,27011,"Maceió",2,"Nordeste",0,"270060",2,7,2,5,3,4,0,0,0,0,0,7,2,5,3,4,3,10.0670619748054,9.03336450150698,0.262486839758604,29
"4446","AL","Barra de São Miguel",8378,23554.26,27011,"Maceió",2,"Nordeste",0,"270060",3,12,7,5,8,4,0,0,0,0,0,12,7,5,8,4,5,10.0670619748054,9.03336450150698,0.373714996514992,31
"4447","AL","Barra de São Miguel",8378,23554.26,27011,"Maceió",2,"Nordeste",0,"270060",4,7,4,3,5,2,0,0,0,0,0,7,4,3,5,2,3,10.0670619748054,9.03336450150698,0.419262440208662,30
"4448","AL","Barra de São Miguel",8378,23554.26,27011,"Maceió",2,"Nordeste",0,"270060",5,10,3,7,3,7,0,0,0,0,0,10,3,7,3,7,5,10.0670619748054,9.03336450150698,0.433310316267475,31
"4449","AL","Batalha",18338,9068.67,27004,"Batalha",2,"Nordeste",0,"270070",2,16,8,8,9,7,0,0,0,0,0,16,8,8,9,7,12,9.11258089509118,9.81673068860985,0.293098870934781,29
"4450","AL","Batalha",18338,9068.67,27004,"Batalha",2,"Nordeste",0,"270070",3,26,12,14,10,16,0,0,0,0,0,26,12,14,10,16,6,9.11258089509118,9.81673068860985,0.354079677077035,31
"4451","AL","Batalha",18338,9068.67,27004,"Batalha",2,"Nordeste",0,"270070",4,21,7,14,10,11,0,0,0,0,0,21,7,14,10,11,7,9.11258089509118,9.81673068860985,0.372514626324942,30
"4452","AL","Batalha",18338,9068.67,27004,"Batalha",2,"Nordeste",0,"270070",5,22,8,14,8,14,0,0,0,0,0,22,8,14,8,14,7,9.11258089509118,9.81673068860985,0.397372835746723,31
"4453","AL","Belém",4284,19209.07,27005,"Palmeira dos Índios",2,"Nordeste",0,"270080",2,6,3,3,4,2,0,0,0,0,0,6,3,3,4,2,6,9.86313784230542,8.36264243156764,0.274640777473594,29
"4454","AL","Belém",4284,19209.07,27005,"Palmeira dos Índios",2,"Nordeste",0,"270080",3,7,5,2,4,3,0,0,0,0,0,7,5,2,4,3,7,9.86313784230542,8.36264243156764,0.358203080680444,31
"4455","AL","Belém",4284,19209.07,27005,"Palmeira dos Índios",2,"Nordeste",0,"270080",4,3,1,2,2,1,0,0,0,0,0,3,1,2,2,1,1,9.86313784230542,8.36264243156764,0.419107879859681,30
"4456","AL","Belém",4284,19209.07,27005,"Palmeira dos Índios",2,"Nordeste",0,"270080",5,10,7,3,4,6,0,0,0,0,0,10,7,3,4,6,6,9.86313784230542,8.36264243156764,0.426473169825997,31
"4457","AL","Boca da Mata",27356,12132.78,27012,"São Miguel dos Campos",2,"Nordeste",1,"270100",2,20,5,15,16,4,1,1,0,0,1,21,6,15,16,5,16,9.40366615952121,10.216691162218,0.258332301917053,29
"4458","AL","Boca da Mata",27356,12132.78,27012,"São Miguel dos Campos",2,"Nordeste",1,"270100",3,19,8,11,12,7,0,0,0,0,0,19,8,11,12,7,10,9.40366615952121,10.216691162218,0.346294575976223,31
"4459","AL","Boca da Mata",27356,12132.78,27012,"São Miguel dos Campos",2,"Nordeste",1,"270100",4,20,7,13,4,16,0,0,0,0,0,20,7,13,4,16,12,9.40366615952121,10.216691162218,0.365271047571854,30
"4460","AL","Boca da Mata",27356,12132.78,27012,"São Miguel dos Campos",2,"Nordeste",1,"270100",5,28,13,15,17,11,0,0,0,0,0,28,13,15,17,11,17,9.40366615952121,10.216691162218,0.372866973662134,31
"4461","AL","Branquinha",10460,47215.27,27009,"Mata Alagoana",2,"Nordeste",0,"270110",2,20,9,11,11,9,0,0,0,0,0,20,9,11,11,9,7,10.7624726362025,9.25531373761891,0.308721966842184,29
"4462","AL","Branquinha",10460,47215.27,27009,"Mata Alagoana",2,"Nordeste",0,"270110",3,14,4,10,9,5,0,0,0,0,0,14,4,10,9,5,3,10.7624726362025,9.25531373761891,0.377090910478344,31
"4463","AL","Branquinha",10460,47215.27,27009,"Mata Alagoana",2,"Nordeste",0,"270110",4,17,8,9,11,6,0,0,0,0,0,17,8,9,11,6,4,10.7624726362025,9.25531373761891,0.442815060009222,30
"4464","AL","Branquinha",10460,47215.27,27009,"Mata Alagoana",2,"Nordeste",0,"270110",5,12,7,5,7,5,0,0,0,0,0,12,7,5,7,5,9,10.7624726362025,9.25531373761891,0.438346342589876,31
"4465","AL","Cacimbinhas",10889,8781.74,27005,"Palmeira dos Índios",2,"Nordeste",0,"270120",2,9,5,4,5,4,0,0,0,0,0,9,5,4,5,4,5,9.0804298446711,9.29550838434606,0.27050309616405,29
"4466","AL","Cacimbinhas",10889,8781.74,27005,"Palmeira dos Índios",2,"Nordeste",0,"270120",3,9,6,3,5,4,0,0,0,0,0,9,6,3,5,4,9,9.0804298446711,9.29550838434606,0.355388357453025,31
"4467","AL","Cacimbinhas",10889,8781.74,27005,"Palmeira dos Índios",2,"Nordeste",0,"270120",4,14,9,5,8,6,0,0,0,0,0,14,9,5,8,6,4,9.0804298446711,9.29550838434606,0.385160093495696,30
"4468","AL","Cacimbinhas",10889,8781.74,27005,"Palmeira dos Índios",2,"Nordeste",0,"270120",5,10,6,4,5,5,0,0,0,0,0,10,6,4,5,5,9,9.0804298446711,9.29550838434606,0.400235246613696,31
"4469","AL","Cajueiro",21331,8676.02,27009,"Mata Alagoana",2,"Nordeste",1,"270130",2,18,9,9,9,9,1,0,1,0,1,19,9,10,9,10,13,9.06831817715388,9.96791669269182,0.308361946164502,29
"4470","AL","Cajueiro",21331,8676.02,27009,"Mata Alagoana",2,"Nordeste",1,"270130",3,17,11,6,11,6,0,0,0,0,0,17,11,6,11,6,14,9.06831817715388,9.96791669269182,0.391204921361176,31
"4471","AL","Cajueiro",21331,8676.02,27009,"Mata Alagoana",2,"Nordeste",1,"270130",4,21,13,8,10,11,0,0,0,0,0,21,13,8,10,11,15,9.06831817715388,9.96791669269182,0.423287012101018,30
"4472","AL","Cajueiro",21331,8676.02,27009,"Mata Alagoana",2,"Nordeste",1,"270130",5,29,18,11,16,13,0,0,0,0,0,29,18,11,16,13,21,9.06831817715388,9.96791669269182,0.439780469663856,31
"4473","AL","Campestre",6954,8437.5,27009,"Mata Alagoana",2,"Nordeste",0,"270135",2,11,5,6,7,4,0,0,0,0,0,11,5,6,7,4,3,9.04044133518079,8.84707231256781,0.315093510270858,29
"4474","AL","Campestre",6954,8437.5,27009,"Mata Alagoana",2,"Nordeste",0,"270135",3,10,4,6,4,6,0,0,0,0,0,10,4,6,4,6,2,9.04044133518079,8.84707231256781,0.369133658920872,31
"4475","AL","Campestre",6954,8437.5,27009,"Mata Alagoana",2,"Nordeste",0,"270135",4,6,3,3,3,3,0,0,0,0,0,6,3,3,3,3,2,9.04044133518079,8.84707231256781,0.421348125692244,30
"4476","AL","Campestre",6954,8437.5,27009,"Mata Alagoana",2,"Nordeste",0,"270135",5,9,5,4,4,5,0,0,0,0,0,9,5,4,4,5,6,9.04044133518079,8.84707231256781,0.450885752789187,31
"4477","AL","Campo Alegre",57537,8124.18,27012,"São Miguel dos Campos",2,"Nordeste",1,"270140",2,31,14,17,17,14,1,1,0,0,1,32,15,17,17,15,18,9.00260007902794,10.9601834981029,0.298332813421921,29
"4478","AL","Campo Alegre",57537,8124.18,27012,"São Miguel dos Campos",2,"Nordeste",1,"270140",3,36,11,25,20,16,0,0,0,0,0,36,11,25,20,16,13,9.00260007902794,10.9601834981029,0.39771069490243,31
"4479","AL","Campo Alegre",57537,8124.18,27012,"São Miguel dos Campos",2,"Nordeste",1,"270140",4,38,12,26,23,15,0,0,0,0,0,38,12,26,23,15,18,9.00260007902794,10.9601834981029,0.40896858569686,30
"4480","AL","Campo Alegre",57537,8124.18,27012,"São Miguel dos Campos",2,"Nordeste",1,"270140",5,38,12,26,25,13,0,0,0,0,0,38,12,26,25,13,23,9.00260007902794,10.9601834981029,0.409661525239272,31
"4481","AL","Campo Grande",9567,8976.96,27006,"Arapiraca",2,"Nordeste",0,"270150",2,11,7,4,3,8,0,0,0,0,0,11,7,4,3,8,5,9.10241657391519,9.16607495567817,0.290358565967857,29
"4482","AL","Campo Grande",9567,8976.96,27006,"Arapiraca",2,"Nordeste",0,"270150",3,11,6,5,5,6,0,0,0,0,0,11,6,5,5,6,4,9.10241657391519,9.16607495567817,0.38078987010756,31
"4483","AL","Campo Grande",9567,8976.96,27006,"Arapiraca",2,"Nordeste",0,"270150",4,14,7,7,7,7,0,0,0,0,0,14,7,7,7,7,11,9.10241657391519,9.16607495567817,0.381554639663041,30
"4484","AL","Campo Grande",9567,8976.96,27006,"Arapiraca",2,"Nordeste",0,"270150",5,15,8,7,7,8,0,0,0,0,0,15,8,7,7,8,12,9.10241657391519,9.16607495567817,0.390876027857784,31
"4485","AL","Canapi",17719,6629.41,27001,"Serrana do Sertão Alagoano",2,"Nordeste",0,"270160",2,15,10,5,11,4,0,0,0,0,0,15,10,5,11,4,9,8.79927108977818,9.78239278915807,0.301108090776236,29
"4486","AL","Canapi",17719,6629.41,27001,"Serrana do Sertão Alagoano",2,"Nordeste",0,"270160",3,20,12,8,11,9,0,0,0,0,0,20,12,8,11,9,12,8.79927108977818,9.78239278915807,0.353320612650354,31
"4487","AL","Canapi",17719,6629.41,27001,"Serrana do Sertão Alagoano",2,"Nordeste",0,"270160",4,24,16,8,14,10,0,0,0,0,0,24,16,8,14,10,12,8.79927108977818,9.78239278915807,0.418507259221117,30
"4488","AL","Canapi",17719,6629.41,27001,"Serrana do Sertão Alagoano",2,"Nordeste",0,"270160",5,27,14,13,17,10,0,0,0,0,0,27,14,13,17,10,11,8.79927108977818,9.78239278915807,0.419880782431928,31
"4489","AL","Capela",16979,10749.33,27009,"Mata Alagoana",2,"Nordeste",0,"270170",2,21,7,14,12,9,1,1,0,1,0,22,8,14,13,9,7,9.28259870603209,9.73973256531601,0.290572290192604,29
"4490","AL","Capela",16979,10749.33,27009,"Mata Alagoana",2,"Nordeste",0,"270170",3,9,4,5,3,6,0,0,0,0,0,9,4,5,3,6,8,9.28259870603209,9.73973256531601,0.378470991497102,31
"4491","AL","Capela",16979,10749.33,27009,"Mata Alagoana",2,"Nordeste",0,"270170",4,12,5,7,4,8,0,0,0,0,0,12,5,7,4,8,8,9.28259870603209,9.73973256531601,0.396938534702259,30
"4492","AL","Capela",16979,10749.33,27009,"Mata Alagoana",2,"Nordeste",0,"270170",5,19,7,12,15,4,0,0,0,0,0,19,7,12,15,4,12,9.28259870603209,9.73973256531601,0.412305466628853,31
"4493","AL","Carneiros",9159,6885.91,27003,"Santana do Ipanema",2,"Nordeste",0,"270180",2,12,4,8,7,5,0,0,0,0,0,12,4,8,7,5,8,8.83723257381596,9.12249228140299,0.320254789470703,29
"4494","AL","Carneiros",9159,6885.91,27003,"Santana do Ipanema",2,"Nordeste",0,"270180",3,7,4,3,4,3,0,0,0,0,0,7,4,3,4,3,6,8.83723257381596,9.12249228140299,0.395677635746429,31
"4495","AL","Carneiros",9159,6885.91,27003,"Santana do Ipanema",2,"Nordeste",0,"270180",4,6,4,2,3,3,0,0,0,0,0,6,4,2,3,3,6,8.83723257381596,9.12249228140299,0.414780591803871,30
"4496","AL","Carneiros",9159,6885.91,27003,"Santana do Ipanema",2,"Nordeste",0,"270180",5,7,5,2,3,4,0,0,0,0,0,7,5,2,3,4,6,8.83723257381596,9.12249228140299,0.457360617563092,31
"4497","AL","Chã Preta",7311,15809.36,27008,"Serrana dos Quilombos",2,"Nordeste",0,"270190",2,5,2,3,4,1,0,0,0,0,0,5,2,3,4,1,2,9.66835744867574,8.89713534229332,0.288950840579385,29
"4498","AL","Chã Preta",7311,15809.36,27008,"Serrana dos Quilombos",2,"Nordeste",0,"270190",3,4,3,1,2,2,0,0,0,0,0,4,3,1,2,2,4,9.66835744867574,8.89713534229332,0.378974764756441,31
"4499","AL","Chã Preta",7311,15809.36,27008,"Serrana dos Quilombos",2,"Nordeste",0,"270190",4,5,3,2,4,1,0,0,0,0,0,5,3,2,4,1,0,9.66835744867574,8.89713534229332,0.405245117857967,30
"4500","AL","Chã Preta",7311,15809.36,27008,"Serrana dos Quilombos",2,"Nordeste",0,"270190",5,8,5,3,4,4,0,0,0,0,0,8,5,3,4,4,1,9.66835744867574,8.89713534229332,0.428239566963353,31
"4501","AL","Coité do Nóia",10643,9180.75,27006,"Arapiraca",2,"Nordeste",0,"270200",2,11,5,6,4,7,0,0,0,0,0,11,5,6,4,7,5,9.12486417962373,9.27265767804104,0.280208763851404,29
"4502","AL","Coité do Nóia",10643,9180.75,27006,"Arapiraca",2,"Nordeste",0,"270200",3,6,3,3,3,3,0,0,0,0,0,6,3,3,3,3,6,9.12486417962373,9.27265767804104,0.380474077794437,31
"4503","AL","Coité do Nóia",10643,9180.75,27006,"Arapiraca",2,"Nordeste",0,"270200",4,15,5,10,6,9,0,0,0,0,0,15,5,10,6,9,8,9.12486417962373,9.27265767804104,0.400969999339736,30
"4504","AL","Coité do Nóia",10643,9180.75,27006,"Arapiraca",2,"Nordeste",0,"270200",5,9,5,4,0,9,0,0,0,0,0,9,5,4,0,9,7,9.12486417962373,9.27265767804104,0.428547871300042,31
"4505","AL","Colônia Leopoldina",21818,11732.49,27009,"Mata Alagoana",2,"Nordeste",1,"270210",2,27,14,13,13,14,0,0,0,0,0,27,14,13,13,14,9,9.37011719533495,9.9904905961577,0.296381134031746,29
"4506","AL","Colônia Leopoldina",21818,11732.49,27009,"Mata Alagoana",2,"Nordeste",1,"270210",3,11,4,7,5,6,0,0,0,0,0,11,4,7,5,6,13,9.37011719533495,9.9904905961577,0.390728666168997,31
"4507","AL","Colônia Leopoldina",21818,11732.49,27009,"Mata Alagoana",2,"Nordeste",1,"270210",4,15,4,11,10,5,0,0,0,0,0,15,4,11,10,5,7,9.37011719533495,9.9904905961577,0.408832281264528,30
"4508","AL","Colônia Leopoldina",21818,11732.49,27009,"Mata Alagoana",2,"Nordeste",1,"270210",5,15,5,10,10,5,1,1,0,0,1,16,6,10,10,6,19,9.37011719533495,9.9904905961577,0.41378100330388,31
"4509","AL","Coqueiro Seco",5864,11856.95,27011,"Maceió",2,"Nordeste",1,"270220",2,5,3,2,3,2,0,0,0,0,0,5,3,2,3,2,3,9.3806694725309,8.67658724356649,0.298470724226325,29
"4510","AL","Coqueiro Seco",5864,11856.95,27011,"Maceió",2,"Nordeste",1,"270220",3,4,3,1,1,3,0,0,0,0,0,4,3,1,1,3,4,9.3806694725309,8.67658724356649,0.396827980714805,31
"4511","AL","Coqueiro Seco",5864,11856.95,27011,"Maceió",2,"Nordeste",1,"270220",4,11,1,10,5,6,1,1,0,0,1,12,2,10,5,7,5,9.3806694725309,8.67658724356649,0.42324112157933,30
"4512","AL","Coqueiro Seco",5864,11856.95,27011,"Maceió",2,"Nordeste",1,"270220",5,8,2,6,6,2,0,0,0,0,0,8,2,6,6,2,8,9.3806694725309,8.67658724356649,0.428664454694154,31
"4513","AL","Coruripe",57294,22506.12,27012,"São Miguel dos Campos",2,"Nordeste",1,"270230",2,67,22,45,35,32,0,0,0,0,0,67,22,45,35,32,27,10.0215425512072,10.9559511851783,0.290563772661798,29
"4514","AL","Coruripe",57294,22506.12,27012,"São Miguel dos Campos",2,"Nordeste",1,"270230",3,52,15,37,17,35,1,1,0,0,1,53,16,37,17,36,25,10.0215425512072,10.9559511851783,0.379359056193046,31
"4515","AL","Coruripe",57294,22506.12,27012,"São Miguel dos Campos",2,"Nordeste",1,"270230",4,70,23,47,32,38,1,0,1,0,1,71,23,48,32,39,26,10.0215425512072,10.9559511851783,0.387426925995379,30
"4516","AL","Coruripe",57294,22506.12,27012,"São Miguel dos Campos",2,"Nordeste",1,"270230",5,62,22,40,33,29,1,0,1,0,1,63,22,41,33,30,50,10.0215425512072,10.9559511851783,0.427778837674576,31
"4517","AL","Craíbas",24309,9002.53,27006,"Arapiraca",2,"Nordeste",0,"270235",2,26,10,16,12,14,0,0,0,0,0,26,10,16,12,14,13,9.10526092792514,10.0986019311288,0.277950223345962,29
"4518","AL","Craíbas",24309,9002.53,27006,"Arapiraca",2,"Nordeste",0,"270235",3,28,17,11,13,15,0,0,0,0,0,28,17,11,13,15,10,9.10526092792514,10.0986019311288,0.350547792847365,31
"4519","AL","Craíbas",24309,9002.53,27006,"Arapiraca",2,"Nordeste",0,"270235",4,25,14,11,13,12,0,0,0,0,0,25,14,11,13,12,10,9.10526092792514,10.0986019311288,0.37660123513297,30
"4520","AL","Craíbas",24309,9002.53,27006,"Arapiraca",2,"Nordeste",0,"270235",5,33,14,19,9,24,0,0,0,0,0,33,14,19,9,24,30,9.10526092792514,10.0986019311288,0.381591486599782,31
"4521","AL","Delmiro Gouveia",52262,10039.86,27002,"Alagoana do Sertão do São Francisco",2,"Nordeste",1,"270240",2,65,30,35,27,38,2,1,1,1,1,67,31,36,28,39,23,9.21431844892539,10.8640248085298,0.29799169023856,29
"4522","AL","Delmiro Gouveia",52262,10039.86,27002,"Alagoana do Sertão do São Francisco",2,"Nordeste",1,"270240",3,43,16,27,20,23,1,0,1,0,1,44,16,28,20,24,31,9.21431844892539,10.8640248085298,0.402938215927991,31
"4523","AL","Delmiro Gouveia",52262,10039.86,27002,"Alagoana do Sertão do São Francisco",2,"Nordeste",1,"270240",4,60,33,27,35,25,1,0,1,1,0,61,33,28,36,25,33,9.21431844892539,10.8640248085298,0.425187962420216,30
"4524","AL","Delmiro Gouveia",52262,10039.86,27002,"Alagoana do Sertão do São Francisco",2,"Nordeste",1,"270240",5,65,28,37,33,32,0,0,0,0,0,65,28,37,33,32,36,9.21431844892539,10.8640248085298,0.423153837593663,31
"4525","AL","Dois Riachos",11067,6673.15,27003,"Santana do Ipanema",2,"Nordeste",0,"270250",2,7,2,5,2,5,0,0,0,0,0,7,2,5,2,5,7,8.80584729129625,9.31172298626479,0.300924394900759,29
"4526","AL","Dois Riachos",11067,6673.15,27003,"Santana do Ipanema",2,"Nordeste",0,"270250",3,13,9,4,4,9,0,0,0,0,0,13,9,4,4,9,2,8.80584729129625,9.31172298626479,0.357808500847812,31
"4527","AL","Dois Riachos",11067,6673.15,27003,"Santana do Ipanema",2,"Nordeste",0,"270250",4,12,5,7,5,7,0,0,0,0,0,12,5,7,5,7,4,8.80584729129625,9.31172298626479,0.393580177982635,30
"4528","AL","Dois Riachos",11067,6673.15,27003,"Santana do Ipanema",2,"Nordeste",0,"270250",5,10,7,3,6,4,0,0,0,0,0,10,7,3,6,4,9,8.80584729129625,9.31172298626479,0.410798757043503,31
"4529","AL","Estrela de Alagoas",18255,6405.96,27005,"Palmeira dos Índios",2,"Nordeste",0,"270255",2,18,5,13,11,7,0,0,0,0,0,18,5,13,11,7,12,8.7649840860035,9.81219429408974,0.305526644171139,29
"4530","AL","Estrela de Alagoas",18255,6405.96,27005,"Palmeira dos Índios",2,"Nordeste",0,"270255",3,20,12,8,11,9,0,0,0,0,0,20,12,8,11,9,13,8.7649840860035,9.81219429408974,0.387652725512738,31
"4531","AL","Estrela de Alagoas",18255,6405.96,27005,"Palmeira dos Índios",2,"Nordeste",0,"270255",4,19,6,13,6,13,0,0,0,0,0,19,6,13,6,13,8,8.7649840860035,9.81219429408974,0.420744178678534,30
"4532","AL","Estrela de Alagoas",18255,6405.96,27005,"Palmeira dos Índios",2,"Nordeste",0,"270255",5,13,8,5,3,10,1,0,1,0,1,14,8,6,3,11,12,8.7649840860035,9.81219429408974,0.436358363437531,31
"4533","AL","Feira Grande",22178,14675.24,27006,"Arapiraca",2,"Nordeste",0,"270260",2,27,11,16,9,18,0,0,0,0,0,27,11,16,9,18,7,9.59391699890669,10.0068560855132,0.321085788866645,29
"4534","AL","Feira Grande",22178,14675.24,27006,"Arapiraca",2,"Nordeste",0,"270260",3,22,11,11,14,8,0,0,0,0,0,22,11,11,14,8,16,9.59391699890669,10.0068560855132,0.389996519429159,31
"4535","AL","Feira Grande",22178,14675.24,27006,"Arapiraca",2,"Nordeste",0,"270260",4,25,15,10,12,13,0,0,0,0,0,25,15,10,12,13,12,9.59391699890669,10.0068560855132,0.405118061552246,30
"4536","AL","Feira Grande",22178,14675.24,27006,"Arapiraca",2,"Nordeste",0,"270260",5,23,10,13,9,14,0,0,0,0,0,23,10,13,9,14,9,9.59391699890669,10.0068560855132,0.425391195320333,31
"4537","AL","Feliz Deserto",4779,26515.77,27013,"Penedo",2,"Nordeste",0,"270270",2,4,0,4,0,4,1,0,1,0,1,5,0,5,0,5,5,10.1854949293155,8.47198659857816,0.271948697025889,29
"4538","AL","Feliz Deserto",4779,26515.77,27013,"Penedo",2,"Nordeste",0,"270270",3,3,2,1,0,3,0,0,0,0,0,3,2,1,0,3,2,10.1854949293155,8.47198659857816,0.350318170622711,31
"4539","AL","Feliz Deserto",4779,26515.77,27013,"Penedo",2,"Nordeste",0,"270270",4,4,1,3,3,1,0,0,0,0,0,4,1,3,3,1,2,10.1854949293155,8.47198659857816,0.396644065276836,30
"4540","AL","Feliz Deserto",4779,26515.77,27013,"Penedo",2,"Nordeste",0,"270270",5,4,3,1,0,4,0,0,0,0,0,4,3,1,0,4,8,10.1854949293155,8.47198659857816,0.432805109695875,31
"4541","AL","Flexeiras",12807,11307.07,27009,"Mata Alagoana",2,"Nordeste",1,"270280",2,14,4,10,9,5,0,0,0,0,0,14,4,10,9,5,1,9.3331834727713,9.45774717542607,0.305892555244529,29
"4542","AL","Flexeiras",12807,11307.07,27009,"Mata Alagoana",2,"Nordeste",1,"270280",3,12,5,7,5,7,0,0,0,0,0,12,5,7,5,7,8,9.3331834727713,9.45774717542607,0.377891609047674,31
"4543","AL","Flexeiras",12807,11307.07,27009,"Mata Alagoana",2,"Nordeste",1,"270280",4,12,5,7,10,2,0,0,0,0,0,12,5,7,10,2,8,9.3331834727713,9.45774717542607,0.422531298087007,30
"4544","AL","Flexeiras",12807,11307.07,27009,"Mata Alagoana",2,"Nordeste",1,"270280",5,12,5,7,7,5,0,0,0,0,0,12,5,7,7,5,4,9.3331834727713,9.45774717542607,0.437863216035687,31
"4545","AL","Girau do Ponciano",41237,8473.94,27006,"Arapiraca",2,"Nordeste",0,"270290",2,37,16,21,16,21,1,1,0,1,0,38,17,21,17,21,13,9.04475085067996,10.627091190577,0.317203704160062,29
"4546","AL","Girau do Ponciano",41237,8473.94,27006,"Arapiraca",2,"Nordeste",0,"270290",3,53,24,29,23,30,0,0,0,0,0,53,24,29,23,30,16,9.04475085067996,10.627091190577,0.402645043812053,31
"4547","AL","Girau do Ponciano",41237,8473.94,27006,"Arapiraca",2,"Nordeste",0,"270290",4,57,27,30,19,38,0,0,0,0,0,57,27,30,19,38,18,9.04475085067996,10.627091190577,0.420682936671323,30
"4548","AL","Girau do Ponciano",41237,8473.94,27006,"Arapiraca",2,"Nordeste",0,"270290",5,43,24,19,23,20,0,0,0,0,0,43,24,19,23,20,13,9.04475085067996,10.627091190577,0.435322566512749,31
"4549","AL","Ibateguara",15627,8634.84,27008,"Serrana dos Quilombos",2,"Nordeste",0,"270300",2,17,9,8,11,6,1,0,1,1,0,18,9,9,12,6,11,9.06356046116765,9.6567554664133,0.288502513723142,29
"4550","AL","Ibateguara",15627,8634.84,27008,"Serrana dos Quilombos",2,"Nordeste",0,"270300",3,21,13,8,13,8,0,0,0,0,0,21,13,8,13,8,7,9.06356046116765,9.6567554664133,0.352621840162246,31
"4551","AL","Ibateguara",15627,8634.84,27008,"Serrana dos Quilombos",2,"Nordeste",0,"270300",4,19,13,6,12,7,0,0,0,0,0,19,13,6,12,7,9,9.06356046116765,9.6567554664133,0.37443631949523,30
"4552","AL","Ibateguara",15627,8634.84,27008,"Serrana dos Quilombos",2,"Nordeste",0,"270300",5,15,8,7,13,2,0,0,0,0,0,15,8,7,13,2,15,9.06356046116765,9.6567554664133,0.401678853270075,31
"4553","AL","Igaci",25613,7698.8,27005,"Palmeira dos Índios",2,"Nordeste",0,"270310",2,19,8,11,11,8,0,0,0,0,0,19,8,11,11,8,14,8.94881975154097,10.1508553140745,0.296792811434303,29
"4554","AL","Igaci",25613,7698.8,27005,"Palmeira dos Índios",2,"Nordeste",0,"270310",3,22,8,14,14,8,0,0,0,0,0,22,8,14,14,8,15,8.94881975154097,10.1508553140745,0.378682360644131,31
"4555","AL","Igaci",25613,7698.8,27005,"Palmeira dos Índios",2,"Nordeste",0,"270310",4,29,15,14,15,14,0,0,0,0,0,29,15,14,15,14,11,8.94881975154097,10.1508553140745,0.400117977893688,30
"4556","AL","Igaci",25613,7698.8,27005,"Palmeira dos Índios",2,"Nordeste",0,"270310",5,25,13,12,6,19,0,0,0,0,0,25,13,12,6,19,18,8.94881975154097,10.1508553140745,0.400021625908653,31
"4557","AL","Igreja Nova",24586,14378.75,27013,"Penedo",2,"Nordeste",0,"270320",2,28,13,15,12,16,0,0,0,0,0,28,13,15,12,16,13,9.57350670121022,10.1099324542273,0.334547457609417,29
"4558","AL","Igreja Nova",24586,14378.75,27013,"Penedo",2,"Nordeste",0,"270320",3,26,11,15,14,12,0,0,0,0,0,26,11,15,14,12,8,9.57350670121022,10.1099324542273,0.4165208614111,31
"4559","AL","Igreja Nova",24586,14378.75,27013,"Penedo",2,"Nordeste",0,"270320",4,28,15,13,18,10,0,0,0,0,0,28,15,13,18,10,12,9.57350670121022,10.1099324542273,0.453942683834559,30
"4560","AL","Igreja Nova",24586,14378.75,27013,"Penedo",2,"Nordeste",0,"270320",5,23,11,12,8,15,1,1,0,1,0,24,12,12,9,15,12,9.57350670121022,10.1099324542273,0.45820267985968,31
"4561","AL","Inhapi",18392,6413.19,27001,"Serrana do Sertão Alagoano",2,"Nordeste",0,"270330",2,21,11,10,8,13,0,0,0,0,0,21,11,10,8,13,9,8.76611208602949,9.81967106644302,0.297676440187836,29
"4562","AL","Inhapi",18392,6413.19,27001,"Serrana do Sertão Alagoano",2,"Nordeste",0,"270330",3,16,13,3,7,9,0,0,0,0,0,16,13,3,7,9,12,8.76611208602949,9.81967106644302,0.365127912991332,31
"4563","AL","Inhapi",18392,6413.19,27001,"Serrana do Sertão Alagoano",2,"Nordeste",0,"270330",4,22,16,6,11,11,0,0,0,0,0,22,16,6,11,11,10,8.76611208602949,9.81967106644302,0.378394775888559,30
"4564","AL","Inhapi",18392,6413.19,27001,"Serrana do Sertão Alagoano",2,"Nordeste",0,"270330",5,17,12,5,7,10,0,0,0,0,0,17,12,5,7,10,8,8.76611208602949,9.81967106644302,0.414081276550816,31
"4565","AL","Jacaré dos Homens",5219,8756.97,27004,"Batalha",2,"Nordeste",0,"270340",2,7,3,4,5,2,0,0,0,0,0,7,3,4,5,2,1,9.07760523368559,8.56006109164341,0.306956521397636,29
"4566","AL","Jacaré dos Homens",5219,8756.97,27004,"Batalha",2,"Nordeste",0,"270340",3,9,6,3,6,3,0,0,0,0,0,9,6,3,6,3,1,9.07760523368559,8.56006109164341,0.363003865192767,31
"4567","AL","Jacaré dos Homens",5219,8756.97,27004,"Batalha",2,"Nordeste",0,"270340",4,9,6,3,6,3,0,0,0,0,0,9,6,3,6,3,2,9.07760523368559,8.56006109164341,0.380921307706312,30
"4568","AL","Jacaré dos Homens",5219,8756.97,27004,"Batalha",2,"Nordeste",0,"270340",5,10,5,5,8,2,0,0,0,0,0,10,5,5,8,2,3,9.07760523368559,8.56006109164341,0.424022191189906,31
"4569","AL","Japaratinga",8403,19400.16,27010,"Litoral Norte Alagoano",2,"Nordeste",0,"270360",2,5,1,4,3,2,0,0,0,0,0,5,1,4,3,2,3,9.87303659244009,9.03634406392822,0.272236278674281,29
"4570","AL","Japaratinga",8403,19400.16,27010,"Litoral Norte Alagoano",2,"Nordeste",0,"270360",3,13,5,8,11,2,0,0,0,0,0,13,5,8,11,2,4,9.87303659244009,9.03634406392822,0.359622490506934,31
"4571","AL","Japaratinga",8403,19400.16,27010,"Litoral Norte Alagoano",2,"Nordeste",0,"270360",4,10,5,5,7,3,0,0,0,0,0,10,5,5,7,3,3,9.87303659244009,9.03634406392822,0.423644706516246,30
"4572","AL","Japaratinga",8403,19400.16,27010,"Litoral Norte Alagoano",2,"Nordeste",0,"270360",5,16,6,10,5,11,0,0,0,0,0,16,6,10,5,11,4,9.87303659244009,9.03634406392822,0.460201327571135,31
"4573","AL","Jaramataia",5761,9470.32,27004,"Batalha",2,"Nordeste",0,"270370",2,7,2,5,3,4,0,0,0,0,0,7,2,5,3,4,2,9.15591797652792,8.65886634973238,0.288387162745957,29
"4574","AL","Jaramataia",5761,9470.32,27004,"Batalha",2,"Nordeste",0,"270370",3,7,5,2,3,4,0,0,0,0,0,7,5,2,3,4,2,9.15591797652792,8.65886634973238,0.354546075642943,31
"4575","AL","Jaramataia",5761,9470.32,27004,"Batalha",2,"Nordeste",0,"270370",4,3,1,2,3,0,0,0,0,0,0,3,1,2,3,0,3,9.15591797652792,8.65886634973238,0.417055760515639,30
"4576","AL","Jaramataia",5761,9470.32,27004,"Batalha",2,"Nordeste",0,"270370",5,11,7,4,6,5,0,0,0,0,0,11,7,4,6,5,4,9.15591797652792,8.65886634973238,0.432879442826698,31
"4577","AL","Jequiá da Praia",11536,18032.24,27012,"São Miguel dos Campos",2,"Nordeste",0,"270375",2,7,0,7,3,4,0,0,0,0,0,7,0,7,3,4,5,9.79991654586268,9.35322785952473,0.315965393884491,29
"4578","AL","Jequiá da Praia",11536,18032.24,27012,"São Miguel dos Campos",2,"Nordeste",0,"270375",3,13,4,9,3,10,0,0,0,0,0,13,4,9,3,10,6,9.79991654586268,9.35322785952473,0.405838471730399,31
"4579","AL","Jequiá da Praia",11536,18032.24,27012,"São Miguel dos Campos",2,"Nordeste",0,"270375",4,15,7,8,10,5,0,0,0,0,0,15,7,8,10,5,2,9.79991654586268,9.35322785952473,0.42101873556218,30
"4580","AL","Jequiá da Praia",11536,18032.24,27012,"São Miguel dos Campos",2,"Nordeste",0,"270375",5,9,5,4,4,5,0,0,0,0,0,9,5,4,4,5,11,9.79991654586268,9.35322785952473,0.48516184944629,31
"4581","AL","Joaquim Gomes",24081,10928.99,27009,"Mata Alagoana",2,"Nordeste",0,"270380",2,32,18,14,16,16,0,0,0,0,0,32,18,14,16,16,7,9.29917417067946,10.0891784267997,0.309379252744698,29
"4582","AL","Joaquim Gomes",24081,10928.99,27009,"Mata Alagoana",2,"Nordeste",0,"270380",3,19,12,7,11,8,1,1,0,0,1,20,13,7,11,9,14,9.29917417067946,10.0891784267997,0.404898685557565,31
"4583","AL","Joaquim Gomes",24081,10928.99,27009,"Mata Alagoana",2,"Nordeste",0,"270380",4,32,23,9,20,12,0,0,0,0,0,32,23,9,20,12,9,9.29917417067946,10.0891784267997,0.41777322184869,30
"4584","AL","Joaquim Gomes",24081,10928.99,27009,"Mata Alagoana",2,"Nordeste",0,"270380",5,29,15,14,23,6,0,0,0,0,0,29,15,14,23,6,21,9.29917417067946,10.0891784267997,0.47767990591243,31
"4585","AL","Junqueiro",24722,12811.41,27012,"São Miguel dos Campos",2,"Nordeste",0,"270400",2,35,10,25,19,16,0,0,0,0,0,35,10,25,19,16,15,9.4580914590911,10.1154488144478,0.283490311307109,29
"4586","AL","Junqueiro",24722,12811.41,27012,"São Miguel dos Campos",2,"Nordeste",0,"270400",3,16,9,7,12,4,2,2,0,0,2,18,11,7,12,6,18,9.4580914590911,10.1154488144478,0.359019569784034,31
"4587","AL","Junqueiro",24722,12811.41,27012,"São Miguel dos Campos",2,"Nordeste",0,"270400",4,17,8,9,8,9,0,0,0,0,0,17,8,9,8,9,12,9.4580914590911,10.1154488144478,0.3970391507523,30
"4588","AL","Junqueiro",24722,12811.41,27012,"São Miguel dos Campos",2,"Nordeste",0,"270400",5,18,7,11,8,10,1,0,1,0,1,19,7,12,8,11,20,9.4580914590911,10.1154488144478,0.419714247457678,31
"4589","AL","Lagoa da Canoa",17771,11371.5,27006,"Arapiraca",2,"Nordeste",0,"270410",2,20,9,11,13,7,0,0,0,0,0,20,9,11,13,7,13,9.33886550416447,9.78532319418549,0.31174501159305,29
"4590","AL","Lagoa da Canoa",17771,11371.5,27006,"Arapiraca",2,"Nordeste",0,"270410",3,26,11,15,13,13,0,0,0,0,0,26,11,15,13,13,9,9.33886550416447,9.78532319418549,0.388761020383153,31
"4591","AL","Lagoa da Canoa",17771,11371.5,27006,"Arapiraca",2,"Nordeste",0,"270410",4,25,14,11,16,9,0,0,0,0,0,25,14,11,16,9,10,9.33886550416447,9.78532319418549,0.409961575709213,30
"4592","AL","Lagoa da Canoa",17771,11371.5,27006,"Arapiraca",2,"Nordeste",0,"270410",5,24,10,14,7,17,0,0,0,0,0,24,10,14,7,17,17,9.33886550416447,9.78532319418549,0.43325253677291,31
"4593","AL","Limoeiro de Anadia",28771,14371.66,27006,"Arapiraca",2,"Nordeste",0,"270420",2,31,15,16,16,15,0,0,0,0,0,31,15,16,16,15,17,9.57301349084253,10.2671232143705,0.291441976055004,29
"4594","AL","Limoeiro de Anadia",28771,14371.66,27006,"Arapiraca",2,"Nordeste",0,"270420",3,22,13,9,11,11,0,0,0,0,0,22,13,9,11,11,14,9.57301349084253,10.2671232143705,0.378133041743001,31
"4595","AL","Limoeiro de Anadia",28771,14371.66,27006,"Arapiraca",2,"Nordeste",0,"270420",4,33,11,22,15,18,0,0,0,0,0,33,11,22,15,18,12,9.57301349084253,10.2671232143705,0.413843681271372,30
"4596","AL","Limoeiro de Anadia",28771,14371.66,27006,"Arapiraca",2,"Nordeste",0,"270420",5,30,18,12,11,19,0,0,0,0,0,30,18,12,11,19,12,9.57301349084253,10.2671232143705,0.413789039719588,31
"4597","AL","Maceió",1025360,22126.34,27011,"Maceió",2,"Nordeste",1,"270430",2,1035,310,725,471,564,9,2,7,5,4,1044,312,732,476,568,533,10.0045240330139,13.8405543284037,0.284873179617088,29
"4598","AL","Maceió",1025360,22126.34,27011,"Maceió",2,"Nordeste",1,"270430",3,994,295,699,437,557,7,4,3,4,3,1001,299,702,441,560,516,10.0045240330139,13.8405543284037,0.399124637721221,31
"4599","AL","Maceió",1025360,22126.34,27011,"Maceió",2,"Nordeste",1,"270430",4,952,303,649,452,500,4,3,1,1,3,956,306,650,453,503,600,10.0045240330139,13.8405543284037,0.473945472720075,30
"4600","AL","Maceió",1025360,22126.34,27011,"Maceió",2,"Nordeste",1,"270430",5,1036,315,721,476,560,10,5,5,5,5,1046,320,726,481,565,1204,10.0045240330139,13.8405543284037,0.474294608489184,31
"4601","AL","Major Isidoro",19864,8857.53,27004,"Batalha",2,"Nordeste",0,"270440",2,13,7,6,7,6,0,0,0,0,0,13,7,6,7,6,9,9.0890232236941,9.896664327188,0.28177798936821,29
"4602","AL","Major Isidoro",19864,8857.53,27004,"Batalha",2,"Nordeste",0,"270440",3,20,12,8,7,13,0,0,0,0,0,20,12,8,7,13,12,9.0890232236941,9.896664327188,0.37106256182502,31
"4603","AL","Major Isidoro",19864,8857.53,27004,"Batalha",2,"Nordeste",0,"270440",4,22,13,9,10,12,0,0,0,0,0,22,13,9,10,12,8,9.0890232236941,9.896664327188,0.379287239560718,30
"4604","AL","Major Isidoro",19864,8857.53,27004,"Batalha",2,"Nordeste",0,"270440",5,18,12,6,9,9,0,0,0,0,0,18,12,6,9,9,14,9.0890232236941,9.896664327188,0.420535888246994,31
"4605","AL","Maragogi",33032,19441.53,27010,"Litoral Norte Alagoano",2,"Nordeste",1,"270450",2,42,21,21,26,16,0,0,0,0,0,42,21,21,26,16,15,9.87516677862116,10.4052320675659,0.271897596954614,29
"4606","AL","Maragogi",33032,19441.53,27010,"Litoral Norte Alagoano",2,"Nordeste",1,"270450",3,33,19,14,18,15,2,2,0,1,1,35,21,14,19,16,16,9.87516677862116,10.4052320675659,0.383540805007317,31
"4607","AL","Maragogi",33032,19441.53,27010,"Litoral Norte Alagoano",2,"Nordeste",1,"270450",4,32,14,18,16,16,0,0,0,0,0,32,14,18,16,16,11,9.87516677862116,10.4052320675659,0.461389612676831,30
"4608","AL","Maragogi",33032,19441.53,27010,"Litoral Norte Alagoano",2,"Nordeste",1,"270450",5,55,21,34,31,24,0,0,0,0,0,55,21,34,31,24,27,9.87516677862116,10.4052320675659,0.475667487335496,31
"4609","AL","Maravilha",9004,7262.18,27003,"Santana do Ipanema",2,"Nordeste",0,"270460",2,12,7,5,9,3,0,0,0,0,0,12,7,5,9,3,4,8.89043533822728,9.10542420202662,0.299687006407303,29
"4610","AL","Maravilha",9004,7262.18,27003,"Santana do Ipanema",2,"Nordeste",0,"270460",3,10,9,1,9,1,2,1,1,1,1,12,10,2,10,2,8,8.89043533822728,9.10542420202662,0.37050276576702,31
"4611","AL","Maravilha",9004,7262.18,27003,"Santana do Ipanema",2,"Nordeste",0,"270460",4,12,2,10,6,6,0,0,0,0,0,12,2,10,6,6,5,8.89043533822728,9.10542420202662,0.364677503944302,30
"4612","AL","Maravilha",9004,7262.18,27003,"Santana do Ipanema",2,"Nordeste",0,"270460",5,13,7,6,6,7,0,0,0,0,0,13,7,6,6,7,10,8.89043533822728,9.10542420202662,0.393189220979725,31
"4613","AL","Marechal Deodoro",52380,37503.36,27011,"Maceió",2,"Nordeste",1,"270470",2,64,27,37,32,32,0,0,0,0,0,64,27,37,32,32,22,10.5321858079447,10.8662801180617,0.286741246011384,29
"4614","AL","Marechal Deodoro",52380,37503.36,27011,"Maceió",2,"Nordeste",1,"270470",3,68,30,38,42,26,1,0,1,1,0,69,30,39,43,26,27,10.5321858079447,10.8662801180617,0.398018791696119,31
"4615","AL","Marechal Deodoro",52380,37503.36,27011,"Maceió",2,"Nordeste",1,"270470",4,74,31,43,44,30,2,1,1,0,2,76,32,44,44,32,42,10.5321858079447,10.8662801180617,0.459622930995772,30
"4616","AL","Marechal Deodoro",52380,37503.36,27011,"Maceió",2,"Nordeste",1,"270470",5,72,31,41,42,30,0,0,0,0,0,72,31,41,42,30,59,10.5321858079447,10.8662801180617,0.460116023468034,31
"4617","AL","Maribondo",13193,10812.58,27005,"Palmeira dos Índios",2,"Nordeste",0,"270480",2,9,2,7,2,7,0,0,0,0,0,9,2,7,2,7,6,9.28846555005669,9.48744166488378,0.282425126029632,29
"4618","AL","Maribondo",13193,10812.58,27005,"Palmeira dos Índios",2,"Nordeste",0,"270480",3,13,10,3,8,5,0,0,0,0,0,13,10,3,8,5,8,9.28846555005669,9.48744166488378,0.356197296470374,31
"4619","AL","Maribondo",13193,10812.58,27005,"Palmeira dos Índios",2,"Nordeste",0,"270480",4,13,7,6,6,7,0,0,0,0,0,13,7,6,6,7,11,9.28846555005669,9.48744166488378,0.390442742383256,30
"4620","AL","Maribondo",13193,10812.58,27005,"Palmeira dos Índios",2,"Nordeste",0,"270480",5,18,4,14,9,9,0,0,0,0,0,18,4,14,9,9,12,9.28846555005669,9.48744166488378,0.404375030322165,31
"4621","AL","Mata Grande",25207,8863.29,27001,"Serrana do Sertão Alagoano",2,"Nordeste",0,"270500",2,24,17,7,12,12,1,0,1,1,0,25,17,8,13,12,15,9.08967330650097,10.1348770127042,0.303164941828504,29
"4622","AL","Mata Grande",25207,8863.29,27001,"Serrana do Sertão Alagoano",2,"Nordeste",0,"270500",3,29,17,12,16,13,1,0,1,0,1,30,17,13,16,14,8,9.08967330650097,10.1348770127042,0.393207589110543,31
"4623","AL","Mata Grande",25207,8863.29,27001,"Serrana do Sertão Alagoano",2,"Nordeste",0,"270500",4,27,18,9,17,10,0,0,0,0,0,27,18,9,17,10,8,9.08967330650097,10.1348770127042,0.413679027090681,30
"4624","AL","Mata Grande",25207,8863.29,27001,"Serrana do Sertão Alagoano",2,"Nordeste",0,"270500",5,41,22,19,22,19,1,1,0,1,0,42,23,19,23,19,6,9.08967330650097,10.1348770127042,0.440781209022987,31
"4625","AL","Matriz de Camaragibe",24634,11668.7,27009,"Mata Alagoana",2,"Nordeste",1,"270510",2,29,11,18,17,12,0,0,0,0,0,29,11,18,17,12,12,9.36466532233174,10.1118828815014,0.311792201730364,29
"4626","AL","Matriz de Camaragibe",24634,11668.7,27009,"Mata Alagoana",2,"Nordeste",1,"270510",3,30,15,15,18,12,1,1,0,1,0,31,16,15,19,12,17,9.36466532233174,10.1118828815014,0.383685245713699,31
"4627","AL","Matriz de Camaragibe",24634,11668.7,27009,"Mata Alagoana",2,"Nordeste",1,"270510",4,20,9,11,13,7,1,0,1,1,0,21,9,12,14,7,22,9.36466532233174,10.1118828815014,0.403181706894508,30
"4628","AL","Matriz de Camaragibe",24634,11668.7,27009,"Mata Alagoana",2,"Nordeste",1,"270510",5,27,15,12,16,11,0,0,0,0,0,27,15,12,16,11,27,9.36466532233174,10.1118828815014,0.422712006260309,31
"4629","AL","Messias",18031,8870.93,27009,"Mata Alagoana",2,"Nordeste",1,"270520",2,24,9,15,17,7,0,0,0,0,0,24,9,15,17,7,7,9.09053491760906,9.79984777777637,0.294926291700248,29
"4630","AL","Messias",18031,8870.93,27009,"Mata Alagoana",2,"Nordeste",1,"270520",3,25,10,15,14,11,0,0,0,0,0,25,10,15,14,11,5,9.09053491760906,9.79984777777637,0.375405741988219,31
"4631","AL","Messias",18031,8870.93,27009,"Mata Alagoana",2,"Nordeste",1,"270520",4,15,6,9,8,7,0,0,0,0,0,15,6,9,8,7,8,9.09053491760906,9.79984777777637,0.398633529683848,30
"4632","AL","Messias",18031,8870.93,27009,"Mata Alagoana",2,"Nordeste",1,"270520",5,12,4,8,9,3,0,0,0,0,0,12,4,8,9,3,22,9.09053491760906,9.79984777777637,0.41842833132989,31
"4633","AL","Murici",28333,11210.9,27009,"Mata Alagoana",2,"Nordeste",1,"270550",2,35,17,18,26,9,0,0,0,0,0,35,17,18,26,9,20,9.32464179830291,10.2517824820293,0.292231599819452,29
"4634","AL","Murici",28333,11210.9,27009,"Mata Alagoana",2,"Nordeste",1,"270550",3,25,11,14,13,12,0,0,0,0,0,25,11,14,13,12,17,9.32464179830291,10.2517824820293,0.386460291328322,31
"4635","AL","Murici",28333,11210.9,27009,"Mata Alagoana",2,"Nordeste",1,"270550",4,21,11,10,8,13,1,1,0,0,1,22,12,10,8,14,17,9.32464179830291,10.2517824820293,0.411373846284172,30
"4636","AL","Murici",28333,11210.9,27009,"Mata Alagoana",2,"Nordeste",1,"270550",5,34,17,17,15,19,1,1,0,0,1,35,18,17,15,20,17,9.32464179830291,10.2517824820293,0.403199475842948,31
"4637","AL","Novo Lino",12764,10213.21,27009,"Mata Alagoana",2,"Nordeste",0,"270560",2,7,0,7,3,4,0,0,0,0,0,7,0,7,3,4,1,9.23143725939549,9.45438398739813,0.29423772153907,29
"4638","AL","Novo Lino",12764,10213.21,27009,"Mata Alagoana",2,"Nordeste",0,"270560",3,10,6,4,7,3,0,0,0,0,0,10,6,4,7,3,6,9.23143725939549,9.45438398739813,0.374560589081508,31
"4639","AL","Novo Lino",12764,10213.21,27009,"Mata Alagoana",2,"Nordeste",0,"270560",4,15,9,6,8,7,0,0,0,0,0,15,9,6,8,7,6,9.23143725939549,9.45438398739813,0.389007186160226,30
"4640","AL","Novo Lino",12764,10213.21,27009,"Mata Alagoana",2,"Nordeste",0,"270560",5,6,2,4,4,2,0,0,0,0,0,6,2,4,4,2,11,9.23143725939549,9.45438398739813,0.423172887778931,31
"4641","AL","Olho d'Água das Flores",21738,9291.32,27004,"Batalha",2,"Nordeste",0,"270570",2,20,10,10,9,11,0,0,0,0,0,20,10,10,9,11,6,9.13683590998126,9.98681716012313,0.263538062975826,29
"4642","AL","Olho d'Água das Flores",21738,9291.32,27004,"Batalha",2,"Nordeste",0,"270570",3,33,16,17,15,18,1,1,0,0,1,34,17,17,15,19,8,9.13683590998126,9.98681716012313,0.329423019140269,31
"4643","AL","Olho d'Água das Flores",21738,9291.32,27004,"Batalha",2,"Nordeste",0,"270570",4,31,14,17,13,18,1,0,1,0,1,32,14,18,13,19,11,9.13683590998126,9.98681716012313,0.355543822680483,30
"4644","AL","Olho d'Água das Flores",21738,9291.32,27004,"Batalha",2,"Nordeste",0,"270570",5,32,17,15,14,18,1,1,0,0,1,33,18,15,14,19,22,9.13683590998126,9.98681716012313,0.362805315910392,31
"4645","AL","Olho d'Água do Casado",9441,7602.31,27002,"Alagoana do Sertão do São Francisco",2,"Nordeste",0,"270580",2,13,9,4,7,6,1,0,1,1,0,14,9,5,8,6,8,8.9362074274602,9.15281718573252,0.306907854700373,29
"4646","AL","Olho d'Água do Casado",9441,7602.31,27002,"Alagoana do Sertão do São Francisco",2,"Nordeste",0,"270580",3,7,3,4,1,6,0,0,0,0,0,7,3,4,1,6,2,8.9362074274602,9.15281718573252,0.372382504255774,31
"4647","AL","Olho d'Água do Casado",9441,7602.31,27002,"Alagoana do Sertão do São Francisco",2,"Nordeste",0,"270580",4,11,4,7,5,6,0,0,0,0,0,11,4,7,5,6,5,8.9362074274602,9.15281718573252,0.392077662642596,30
"4648","AL","Olho d'Água do Casado",9441,7602.31,27002,"Alagoana do Sertão do São Francisco",2,"Nordeste",0,"270580",5,10,7,3,4,6,0,0,0,0,0,10,7,3,4,6,3,8.9362074274602,9.15281718573252,0.414197592987324,31
"4649","AL","Olivença",11657,6820.77,27004,"Batalha",2,"Nordeste",0,"270600",2,18,12,6,10,8,0,0,0,0,0,18,12,6,10,8,3,8.82772764769022,9.36366213691983,0.294578694392119,29
"4650","AL","Olivença",11657,6820.77,27004,"Batalha",2,"Nordeste",0,"270600",3,12,10,2,6,6,0,0,0,0,0,12,10,2,6,6,10,8.82772764769022,9.36366213691983,0.389569927296245,31
"4651","AL","Olivença",11657,6820.77,27004,"Batalha",2,"Nordeste",0,"270600",4,13,10,3,5,8,0,0,0,0,0,13,10,3,5,8,2,8.82772764769022,9.36366213691983,0.408768997625228,30
"4652","AL","Olivença",11657,6820.77,27004,"Batalha",2,"Nordeste",0,"270600",5,20,13,7,9,11,0,0,0,0,0,20,13,7,9,11,6,8.82772764769022,9.36366213691983,0.387448847379747,31
"4653","AL","Ouro Branco",11535,6762.83,27003,"Santana do Ipanema",2,"Nordeste",0,"270610",2,13,8,5,9,4,0,0,0,0,0,13,8,5,9,4,11,8.81919672048538,9.35314117060785,0.264035216594958,29
"4654","AL","Ouro Branco",11535,6762.83,27003,"Santana do Ipanema",2,"Nordeste",0,"270610",3,17,11,6,7,10,1,1,0,0,1,18,12,6,7,11,6,8.81919672048538,9.35314117060785,0.341828416911632,31
"4655","AL","Ouro Branco",11535,6762.83,27003,"Santana do Ipanema",2,"Nordeste",0,"270610",4,19,12,7,13,6,1,1,0,0,1,20,13,7,13,7,4,8.81919672048538,9.35314117060785,0.355558493163858,30
"4656","AL","Ouro Branco",11535,6762.83,27003,"Santana do Ipanema",2,"Nordeste",0,"270610",5,14,7,7,8,6,0,0,0,0,0,14,7,7,8,6,7,8.81919672048538,9.35314117060785,0.388170367824181,31
"4657","AL","Palestina",5037,7449.33,27003,"Santana do Ipanema",2,"Nordeste",0,"270620",2,3,1,2,2,1,0,0,0,0,0,3,1,2,2,1,1,8.9158793744435,8.52456594574565,0.289628715479555,29
"4658","AL","Palestina",5037,7449.33,27003,"Santana do Ipanema",2,"Nordeste",0,"270620",3,12,3,9,8,4,0,0,0,0,0,12,3,9,8,4,2,8.9158793744435,8.52456594574565,0.348428032977008,31
"4659","AL","Palestina",5037,7449.33,27003,"Santana do Ipanema",2,"Nordeste",0,"270620",4,3,2,1,2,1,0,0,0,0,0,3,2,1,2,1,3,8.9158793744435,8.52456594574565,0.386231924963835,30
"4660","AL","Palestina",5037,7449.33,27003,"Santana do Ipanema",2,"Nordeste",0,"270620",5,10,3,7,7,3,0,0,0,0,0,10,3,7,7,3,2,8.9158793744435,8.52456594574565,0.39036989566041,31
"4661","AL","Palmeira dos Índios",73337,11344.36,27005,"Palmeira dos Índios",2,"Nordeste",1,"270630",2,106,35,71,51,55,0,0,0,0,0,106,35,71,51,55,32,9.33647598310617,11.2028205354164,0.283759576219769,29
"4662","AL","Palmeira dos Índios",73337,11344.36,27005,"Palmeira dos Índios",2,"Nordeste",1,"270630",3,78,25,53,43,35,0,0,0,0,0,78,25,53,43,35,51,9.33647598310617,11.2028205354164,0.374413202202142,31
"4663","AL","Palmeira dos Índios",73337,11344.36,27005,"Palmeira dos Índios",2,"Nordeste",1,"270630",4,77,18,59,35,42,1,0,1,0,1,78,18,60,35,43,43,9.33647598310617,11.2028205354164,0.401860756485281,30
"4664","AL","Palmeira dos Índios",73337,11344.36,27005,"Palmeira dos Índios",2,"Nordeste",1,"270630",5,82,28,54,35,47,0,0,0,0,0,82,28,54,35,47,64,9.33647598310617,11.2028205354164,0.415984585634465,31
"4665","AL","Pão de Açúcar",24351,8739.4,27003,"Santana do Ipanema",2,"Nordeste",0,"270640",2,26,11,15,16,10,0,0,0,0,0,26,11,15,16,10,13,9.07559681640749,10.1003281954293,0.287201035398627,29
"4666","AL","Pão de Açúcar",24351,8739.4,27003,"Santana do Ipanema",2,"Nordeste",0,"270640",3,16,8,8,8,8,0,0,0,0,0,16,8,8,8,8,8,9.07559681640749,10.1003281954293,0.36056332756188,31
"4667","AL","Pão de Açúcar",24351,8739.4,27003,"Santana do Ipanema",2,"Nordeste",0,"270640",4,31,6,25,15,16,0,0,0,0,0,31,6,25,15,16,15,9.07559681640749,10.1003281954293,0.389543678468203,30
"4668","AL","Pão de Açúcar",24351,8739.4,27003,"Santana do Ipanema",2,"Nordeste",0,"270640",5,33,11,22,20,13,0,0,0,0,0,33,11,22,20,13,12,9.07559681640749,10.1003281954293,0.409397057917162,31
"4669","AL","Pariconha",10539,6971.88,27001,"Serrana do Sertão Alagoano",2,"Nordeste",0,"270642",2,7,1,6,3,4,1,0,1,1,0,8,1,7,4,4,9,8.84964019478783,9.26283794093394,0.328672927446362,29
"4670","AL","Pariconha",10539,6971.88,27001,"Serrana do Sertão Alagoano",2,"Nordeste",0,"270642",3,15,7,8,5,10,0,0,0,0,0,15,7,8,5,10,8,8.84964019478783,9.26283794093394,0.431209980256757,31
"4671","AL","Pariconha",10539,6971.88,27001,"Serrana do Sertão Alagoano",2,"Nordeste",0,"270642",4,13,6,7,10,3,1,1,0,0,1,14,7,7,10,4,10,8.84964019478783,9.26283794093394,0.453381507792551,30
"4672","AL","Pariconha",10539,6971.88,27001,"Serrana do Sertão Alagoano",2,"Nordeste",0,"270642",5,11,5,6,6,5,0,0,0,0,0,11,5,6,6,5,3,8.84964019478783,9.26283794093394,0.462273021303739,31
"4673","AL","Paripueira",13332,12725.84,27011,"Maceió",2,"Nordeste",1,"270644",2,19,8,11,12,7,0,0,0,0,0,19,8,11,12,7,5,9.45138985102786,9.49792243942763,0.29201761390107,29
"4674","AL","Paripueira",13332,12725.84,27011,"Maceió",2,"Nordeste",1,"270644",3,17,6,11,9,8,0,0,0,0,0,17,6,11,9,8,5,9.45138985102786,9.49792243942763,0.39144866917704,31
"4675","AL","Paripueira",13332,12725.84,27011,"Maceió",2,"Nordeste",1,"270644",4,17,8,9,10,7,0,0,0,0,0,17,8,9,10,7,8,9.45138985102786,9.49792243942763,0.437355310272201,30
"4676","AL","Paripueira",13332,12725.84,27011,"Maceió",2,"Nordeste",1,"270644",5,15,9,6,7,8,0,0,0,0,0,15,9,6,7,8,11,9.45138985102786,9.49792243942763,0.43698288899356,31
"4677","AL","Passo de Camaragibe",15258,15951.37,27010,"Litoral Norte Alagoano",2,"Nordeste",0,"270650",2,17,9,8,8,9,0,0,0,0,0,17,9,8,8,9,10,9.67729999794129,9.63285923465017,0.293908687450529,29
"4678","AL","Passo de Camaragibe",15258,15951.37,27010,"Litoral Norte Alagoano",2,"Nordeste",0,"270650",3,12,7,5,6,6,0,0,0,0,0,12,7,5,6,6,11,9.67729999794129,9.63285923465017,0.387800471699594,31
"4679","AL","Passo de Camaragibe",15258,15951.37,27010,"Litoral Norte Alagoano",2,"Nordeste",0,"270650",4,10,5,5,7,3,0,0,0,0,0,10,5,5,7,3,4,9.67729999794129,9.63285923465017,0.416668987856121,30
"4680","AL","Passo de Camaragibe",15258,15951.37,27010,"Litoral Norte Alagoano",2,"Nordeste",0,"270650",5,18,10,8,13,5,0,0,0,0,0,18,10,8,13,5,14,9.67729999794129,9.63285923465017,0.448956945676865,31
"4681","AL","Paulo Jacinto",7560,9648.08,27005,"Palmeira dos Índios",2,"Nordeste",0,"270660",2,4,2,2,1,3,0,0,0,0,0,4,2,2,1,3,11,9.17451421080655,8.93062646917358,0.302411759394624,29
"4682","AL","Paulo Jacinto",7560,9648.08,27005,"Palmeira dos Índios",2,"Nordeste",0,"270660",3,7,1,6,3,4,0,0,0,0,0,7,1,6,3,4,3,9.17451421080655,8.93062646917358,0.386437305868377,31
"4683","AL","Paulo Jacinto",7560,9648.08,27005,"Palmeira dos Índios",2,"Nordeste",0,"270660",4,11,6,5,8,3,0,0,0,0,0,11,6,5,8,3,5,9.17451421080655,8.93062646917358,0.399302045023496,30
"4684","AL","Paulo Jacinto",7560,9648.08,27005,"Palmeira dos Índios",2,"Nordeste",0,"270660",5,4,1,3,3,1,0,0,0,0,0,4,1,3,3,1,9,9.17451421080655,8.93062646917358,0.432818699532378,31
"4685","AL","Penedo",63846,11781.43,27013,"Penedo",2,"Nordeste",1,"270670",2,62,25,37,25,37,0,0,0,0,0,62,25,37,25,37,41,9.3742798420283,11.0642292126698,0.290583527730325,29
"4686","AL","Penedo",63846,11781.43,27013,"Penedo",2,"Nordeste",1,"270670",3,71,23,48,32,39,1,0,1,0,1,72,23,49,32,40,29,9.3742798420283,11.0642292126698,0.389297596873389,31
"4687","AL","Penedo",63846,11781.43,27013,"Penedo",2,"Nordeste",1,"270670",4,76,30,46,42,34,0,0,0,0,0,76,30,46,42,34,30,9.3742798420283,11.0642292126698,0.428657799725209,30
"4688","AL","Penedo",63846,11781.43,27013,"Penedo",2,"Nordeste",1,"270670",5,79,41,38,41,38,0,0,0,0,0,79,41,38,41,38,36,9.3742798420283,11.0642292126698,0.429941175268246,31
"4689","AL","Piaçabuçu",17848,17910.19,27013,"Penedo",2,"Nordeste",0,"270680",2,25,13,12,9,16,0,0,0,0,0,25,13,12,9,16,4,9.79312510359703,9.78964673611237,0.311809461430952,29
"4690","AL","Piaçabuçu",17848,17910.19,27013,"Penedo",2,"Nordeste",0,"270680",3,21,6,15,14,7,0,0,0,0,0,21,6,15,14,7,8,9.79312510359703,9.78964673611237,0.403677809638704,31
"4691","AL","Piaçabuçu",17848,17910.19,27013,"Penedo",2,"Nordeste",0,"270680",4,25,12,13,15,10,1,0,1,1,0,26,12,14,16,10,11,9.79312510359703,9.78964673611237,0.440896268314772,30
"4692","AL","Piaçabuçu",17848,17910.19,27013,"Penedo",2,"Nordeste",0,"270680",5,22,15,7,13,9,0,0,0,0,0,22,15,7,13,9,20,9.79312510359703,9.78964673611237,0.434984581646854,31
"4693","AL","Pilar",35212,13783.87,27011,"Maceió",2,"Nordeste",1,"270690",2,55,18,37,24,31,0,0,0,0,0,55,18,37,24,31,22,9.53125434693868,10.4691422125808,0.270519212559972,29
"4694","AL","Pilar",35212,13783.87,27011,"Maceió",2,"Nordeste",1,"270690",3,54,21,33,26,28,1,1,0,1,0,55,22,33,27,28,23,9.53125434693868,10.4691422125808,0.358798578750753,31
"4695","AL","Pilar",35212,13783.87,27011,"Maceió",2,"Nordeste",1,"270690",4,43,21,22,21,22,0,0,0,0,0,43,21,22,21,22,18,9.53125434693868,10.4691422125808,0.382047853777738,30
"4696","AL","Pilar",35212,13783.87,27011,"Maceió",2,"Nordeste",1,"270690",5,44,21,23,25,19,0,0,0,0,0,44,21,23,25,19,40,9.53125434693868,10.4691422125808,0.396271769732339,31
"4697","AL","Piranhas",25183,9888.19,27002,"Alagoana do Sertão do São Francisco",2,"Nordeste",0,"270710",2,34,20,14,17,17,0,0,0,0,0,34,20,14,17,17,13,9.19909639472322,10.1339244426778,0.286147941024941,29
"4698","AL","Piranhas",25183,9888.19,27002,"Alagoana do Sertão do São Francisco",2,"Nordeste",0,"270710",3,20,10,10,15,5,0,0,0,0,0,20,10,10,15,5,12,9.19909639472322,10.1339244426778,0.365985176164227,31
"4699","AL","Piranhas",25183,9888.19,27002,"Alagoana do Sertão do São Francisco",2,"Nordeste",0,"270710",4,29,17,12,14,15,2,1,1,1,1,31,18,13,15,16,12,9.19909639472322,10.1339244426778,0.408576783374121,30
"4700","AL","Piranhas",25183,9888.19,27002,"Alagoana do Sertão do São Francisco",2,"Nordeste",0,"270710",5,34,16,18,16,18,1,0,1,1,0,35,16,19,17,18,13,9.19909639472322,10.1339244426778,0.41268488624281,31
"4701","AL","Poço das Trincheiras",14418,6439.94,27003,"Santana do Ipanema",2,"Nordeste",0,"270720",2,14,4,10,6,8,1,1,0,1,0,15,5,10,7,8,5,8.77027450228481,9.57623270496452,0.313699317652348,29
"4702","AL","Poço das Trincheiras",14418,6439.94,27003,"Santana do Ipanema",2,"Nordeste",0,"270720",3,14,4,10,7,7,0,0,0,0,0,14,4,10,7,7,9,8.77027450228481,9.57623270496452,0.378211351966414,31
"4703","AL","Poço das Trincheiras",14418,6439.94,27003,"Santana do Ipanema",2,"Nordeste",0,"270720",4,13,6,7,9,4,0,0,0,0,0,13,6,7,9,4,7,8.77027450228481,9.57623270496452,0.40756017948878,30
"4704","AL","Poço das Trincheiras",14418,6439.94,27003,"Santana do Ipanema",2,"Nordeste",0,"270720",5,18,10,8,6,12,1,0,1,0,1,19,10,9,6,13,14,8.77027450228481,9.57623270496452,0.458888430068887,31
"4705","AL","Porto Calvo",27249,12119,27009,"Mata Alagoana",2,"Nordeste",1,"270730",2,27,6,21,14,13,0,0,0,0,0,27,6,21,14,13,13,9.40252974796849,10.2127721021703,0.258052162725882,29
"4706","AL","Porto Calvo",27249,12119,27009,"Mata Alagoana",2,"Nordeste",1,"270730",3,25,14,11,19,6,1,0,1,0,1,26,14,12,19,7,16,9.40252974796849,10.2127721021703,0.348172812413205,31
"4707","AL","Porto Calvo",27249,12119,27009,"Mata Alagoana",2,"Nordeste",1,"270730",4,21,7,14,10,11,0,0,0,0,0,21,7,14,10,11,12,9.40252974796849,10.2127721021703,0.375653850738452,30
"4708","AL","Porto Calvo",27249,12119,27009,"Mata Alagoana",2,"Nordeste",1,"270730",5,41,14,27,22,19,0,0,0,0,0,41,14,27,22,19,32,9.40252974796849,10.2127721021703,0.404281857301387,31
"4709","AL","Porto de Pedras",7701,25309.4,27010,"Litoral Norte Alagoano",2,"Nordeste",0,"270740",2,11,7,4,10,1,0,0,0,0,0,11,7,4,10,1,4,10.1389311472131,8.94910546953925,0.275083319745697,29
"4710","AL","Porto de Pedras",7701,25309.4,27010,"Litoral Norte Alagoano",2,"Nordeste",0,"270740",3,11,4,7,7,4,0,0,0,0,0,11,4,7,7,4,3,10.1389311472131,8.94910546953925,0.347183087677818,31
"4711","AL","Porto de Pedras",7701,25309.4,27010,"Litoral Norte Alagoano",2,"Nordeste",0,"270740",4,10,2,8,6,4,0,0,0,0,0,10,2,8,6,4,3,10.1389311472131,8.94910546953925,0.400916789926282,30
"4712","AL","Porto de Pedras",7701,25309.4,27010,"Litoral Norte Alagoano",2,"Nordeste",0,"270740",5,3,2,1,2,1,0,0,0,0,0,3,2,1,2,1,3,10.1389311472131,8.94910546953925,0.42167940153573,31
"4713","AL","Porto Real do Colégio",20112,8836.64,27013,"Penedo",2,"Nordeste",0,"270750",2,22,10,12,11,11,0,0,0,0,0,22,10,12,11,11,11,9.08666199288125,9.90907193083003,0.306739229795539,29
"4714","AL","Porto Real do Colégio",20112,8836.64,27013,"Penedo",2,"Nordeste",0,"270750",3,22,7,15,10,12,1,1,0,0,1,23,8,15,10,13,13,9.08666199288125,9.90907193083003,0.402580044732286,31
"4715","AL","Porto Real do Colégio",20112,8836.64,27013,"Penedo",2,"Nordeste",0,"270750",4,17,8,9,10,7,0,0,0,0,0,17,8,9,10,7,13,9.08666199288125,9.90907193083003,0.411290340670959,30
"4716","AL","Porto Real do Colégio",20112,8836.64,27013,"Penedo",2,"Nordeste",0,"270750",5,20,12,8,8,12,0,0,0,0,0,20,12,8,8,12,12,9.08666199288125,9.90907193083003,0.425167379713975,31
"4717","AL","Quebrangulo",11248,10739.3,27005,"Palmeira dos Índios",2,"Nordeste",0,"270760",2,14,10,4,5,9,0,0,0,0,0,14,10,4,5,9,5,9.28166518903,9.32794561405045,0.277132749587064,29
"4718","AL","Quebrangulo",11248,10739.3,27005,"Palmeira dos Índios",2,"Nordeste",0,"270760",3,12,4,8,6,6,1,1,0,1,0,13,5,8,7,6,3,9.28166518903,9.32794561405045,0.37457990236824,31
"4719","AL","Quebrangulo",11248,10739.3,27005,"Palmeira dos Índios",2,"Nordeste",0,"270760",4,13,7,6,5,8,0,0,0,0,0,13,7,6,5,8,6,9.28166518903,9.32794561405045,0.389612184408767,30
"4720","AL","Quebrangulo",11248,10739.3,27005,"Palmeira dos Índios",2,"Nordeste",0,"270760",5,9,3,6,6,3,0,0,0,0,0,9,3,6,6,3,8,9.28166518903,9.32794561405045,0.444118856982709,31
"4721","AL","Rio Largo",75394,14045.95,27011,"Maceió",2,"Nordeste",1,"270770",2,106,32,74,48,58,0,0,0,0,0,106,32,74,48,58,55,9.55008937698032,11.2304829752329,0.29724675395074,29
"4722","AL","Rio Largo",75394,14045.95,27011,"Maceió",2,"Nordeste",1,"270770",3,95,36,59,51,44,0,0,0,0,0,95,36,59,51,44,56,9.55008937698032,11.2304829752329,0.39557881452674,31
"4723","AL","Rio Largo",75394,14045.95,27011,"Maceió",2,"Nordeste",1,"270770",4,96,45,51,56,40,0,0,0,0,0,96,45,51,56,40,43,9.55008937698032,11.2304829752329,0.438693597968405,30
"4724","AL","Rio Largo",75394,14045.95,27011,"Maceió",2,"Nordeste",1,"270770",5,90,32,58,40,50,1,0,1,1,0,91,32,59,41,50,111,9.55008937698032,11.2304829752329,0.442605442011466,31
"4725","AL","Roteiro",6649,17204.05,27012,"São Miguel dos Campos",2,"Nordeste",0,"270780",2,14,7,7,5,9,1,1,0,1,0,15,8,7,6,9,6,9.75290010020026,8.80222174640246,0.341464731283765,29
"4726","AL","Roteiro",6649,17204.05,27012,"São Miguel dos Campos",2,"Nordeste",0,"270780",3,10,3,7,5,5,0,0,0,0,0,10,3,7,5,5,4,9.75290010020026,8.80222174640246,0.412452253298221,31
"4727","AL","Roteiro",6649,17204.05,27012,"São Miguel dos Campos",2,"Nordeste",0,"270780",4,10,6,4,6,4,0,0,0,0,0,10,6,4,6,4,8,9.75290010020026,8.80222174640246,0.449835379016142,30
"4728","AL","Roteiro",6649,17204.05,27012,"São Miguel dos Campos",2,"Nordeste",0,"270780",5,17,11,6,8,9,0,0,0,0,0,17,11,6,8,9,3,9.75290010020026,8.80222174640246,0.455788559324426,31
"4729","AL","Santa Luzia do Norte",7320,18606.35,27011,"Maceió",2,"Nordeste",1,"270790",2,11,5,6,5,6,0,0,0,0,0,11,5,6,5,6,2,9.83125819928777,8.89836560695536,0.293489761153731,29
"4730","AL","Santa Luzia do Norte",7320,18606.35,27011,"Maceió",2,"Nordeste",1,"270790",3,4,3,1,2,2,0,0,0,0,0,4,3,1,2,2,5,9.83125819928777,8.89836560695536,0.401545634209141,31
"4731","AL","Santa Luzia do Norte",7320,18606.35,27011,"Maceió",2,"Nordeste",1,"270790",4,9,3,6,6,3,0,0,0,0,0,9,3,6,6,3,3,9.83125819928777,8.89836560695536,0.42504473579715,30
"4732","AL","Santa Luzia do Norte",7320,18606.35,27011,"Maceió",2,"Nordeste",1,"270790",5,12,4,8,6,6,1,0,1,0,1,13,4,9,6,7,11,9.83125819928777,8.89836560695536,0.467753027759608,31
"4733","AL","Santana do Ipanema",47819,10724.56,27003,"Santana do Ipanema",2,"Nordeste",1,"270800",2,68,24,44,31,37,0,0,0,0,0,68,24,44,31,37,23,9.28029171731362,10.7751783290413,0.266464063757026,29
"4734","AL","Santana do Ipanema",47819,10724.56,27003,"Santana do Ipanema",2,"Nordeste",1,"270800",3,50,25,25,27,23,1,0,1,1,0,51,25,26,28,23,34,9.28029171731362,10.7751783290413,0.335593409845708,31
"4735","AL","Santana do Ipanema",47819,10724.56,27003,"Santana do Ipanema",2,"Nordeste",1,"270800",4,58,26,32,23,35,1,1,0,0,1,59,27,32,23,36,28,9.28029171731362,10.7751783290413,0.363833218081429,30
"4736","AL","Santana do Ipanema",47819,10724.56,27003,"Santana do Ipanema",2,"Nordeste",1,"270800",5,77,34,43,42,35,1,0,1,1,0,78,34,44,43,35,38,9.28029171731362,10.7751783290413,0.386304539411361,31
"4737","AL","Santana do Mundaú",10687,101744.85,27008,"Serrana dos Quilombos",2,"Nordeste",0,"270810",2,4,1,3,2,2,0,0,0,0,0,4,1,3,2,2,3,11.5302234877733,9.2767833285249,0.310007660057836,29
"4738","AL","Santana do Mundaú",10687,101744.85,27008,"Serrana dos Quilombos",2,"Nordeste",0,"270810",3,13,5,8,4,9,0,0,0,0,0,13,5,8,4,9,10,11.5302234877733,9.2767833285249,0.376609069242132,31
"4739","AL","Santana do Mundaú",10687,101744.85,27008,"Serrana dos Quilombos",2,"Nordeste",0,"270810",4,15,9,6,11,4,0,0,0,0,0,15,9,6,11,4,9,11.5302234877733,9.2767833285249,0.423092807283357,30
"4740","AL","Santana do Mundaú",10687,101744.85,27008,"Serrana dos Quilombos",2,"Nordeste",0,"270810",5,12,7,5,6,6,0,0,0,0,0,12,7,5,6,6,10,11.5302234877733,9.2767833285249,0.428989096047927,31
"4741","AL","São José da Laje",23996,12668.23,27008,"Serrana dos Quilombos",2,"Nordeste",0,"270830",2,31,18,13,18,13,0,0,0,0,0,31,18,13,18,13,14,9.44685256347729,10.085642428773,0.301440272148848,29
"4742","AL","São José da Laje",23996,12668.23,27008,"Serrana dos Quilombos",2,"Nordeste",0,"270830",3,33,16,17,21,12,0,0,0,0,0,33,16,17,21,12,11,9.44685256347729,10.085642428773,0.389862915825541,31
"4743","AL","São José da Laje",23996,12668.23,27008,"Serrana dos Quilombos",2,"Nordeste",0,"270830",4,27,18,9,19,8,0,0,0,0,0,27,18,9,19,8,8,9.44685256347729,10.085642428773,0.414227210427631,30
"4744","AL","São José da Laje",23996,12668.23,27008,"Serrana dos Quilombos",2,"Nordeste",0,"270830",5,37,19,18,20,17,1,0,1,1,0,38,19,19,21,17,15,9.44685256347729,10.085642428773,0.445167403425021,31
"4745","AL","São José da Tapera",32405,7068.79,27003,"Santana do Ipanema",2,"Nordeste",0,"270840",2,32,20,12,15,17,0,0,0,0,0,32,20,12,15,17,20,8.86344459855753,10.3860680108618,0.297084133584686,29
"4746","AL","São José da Tapera",32405,7068.79,27003,"Santana do Ipanema",2,"Nordeste",0,"270840",3,37,22,15,16,21,0,0,0,0,0,37,22,15,16,21,10,8.86344459855753,10.3860680108618,0.360085242026271,31
"4747","AL","São José da Tapera",32405,7068.79,27003,"Santana do Ipanema",2,"Nordeste",0,"270840",4,58,23,35,25,33,0,0,0,0,0,58,23,35,25,33,19,8.86344459855753,10.3860680108618,0.375516909005938,30
"4748","AL","São José da Tapera",32405,7068.79,27003,"Santana do Ipanema",2,"Nordeste",0,"270840",5,50,27,23,24,26,2,2,0,1,1,52,29,23,25,27,17,8.86344459855753,10.3860680108618,0.401648755951016,31
"4749","AL","São Luís do Quitunde",34692,16709.48,27009,"Mata Alagoana",2,"Nordeste",0,"270850",2,36,20,16,27,9,0,0,0,0,0,36,20,16,27,9,16,9.72373150201487,10.4542643918043,0.301114770750335,29
"4750","AL","São Luís do Quitunde",34692,16709.48,27009,"Mata Alagoana",2,"Nordeste",0,"270850",3,27,16,11,16,11,0,0,0,0,0,27,16,11,16,11,14,9.72373150201487,10.4542643918043,0.363112989448017,31
"4751","AL","São Luís do Quitunde",34692,16709.48,27009,"Mata Alagoana",2,"Nordeste",0,"270850",4,22,8,14,13,9,0,0,0,0,0,22,8,14,13,9,16,9.72373150201487,10.4542643918043,0.404770510987088,30
"4752","AL","São Luís do Quitunde",34692,16709.48,27009,"Mata Alagoana",2,"Nordeste",0,"270850",5,44,27,17,24,20,1,1,0,0,1,45,28,17,24,21,37,9.72373150201487,10.4542643918043,0.432679435230749,31
"4753","AL","São Miguel dos Campos",61797,17123.99,27012,"São Miguel dos Campos",2,"Nordeste",1,"270860",2,49,15,34,27,22,0,0,0,0,0,49,15,34,27,22,29,9.74823568328896,11.0316100985782,0.276032886396096,29
"4754","AL","São Miguel dos Campos",61797,17123.99,27012,"São Miguel dos Campos",2,"Nordeste",1,"270860",3,61,18,43,28,33,0,0,0,0,0,61,18,43,28,33,36,9.74823568328896,11.0316100985782,0.358040346073524,31
"4755","AL","São Miguel dos Campos",61797,17123.99,27012,"São Miguel dos Campos",2,"Nordeste",1,"270860",4,71,26,45,31,40,0,0,0,0,0,71,26,45,31,40,34,9.74823568328896,11.0316100985782,0.38738960897057,30
"4756","AL","São Miguel dos Campos",61797,17123.99,27012,"São Miguel dos Campos",2,"Nordeste",1,"270860",5,77,35,42,44,33,0,0,0,0,0,77,35,42,44,33,44,9.74823568328896,11.0316100985782,0.388724321622048,31
"4757","AL","São Miguel dos Milagres",8013,18786.77,27010,"Litoral Norte Alagoano",2,"Nordeste",0,"270870",2,8,2,6,4,4,0,0,0,0,0,8,2,6,4,4,2,9.84090817768424,8.98882050177807,0.27132349807262,29
"4758","AL","São Miguel dos Milagres",8013,18786.77,27010,"Litoral Norte Alagoano",2,"Nordeste",0,"270870",3,16,8,8,10,6,0,0,0,0,0,16,8,8,10,6,4,9.84090817768424,8.98882050177807,0.351343827978974,31
"4759","AL","São Miguel dos Milagres",8013,18786.77,27010,"Litoral Norte Alagoano",2,"Nordeste",0,"270870",4,9,6,3,7,2,0,0,0,0,0,9,6,3,7,2,9,9.84090817768424,8.98882050177807,0.389832898716059,30
"4760","AL","São Miguel dos Milagres",8013,18786.77,27010,"Litoral Norte Alagoano",2,"Nordeste",0,"270870",5,20,9,11,10,10,0,0,0,0,0,20,9,11,10,10,5,9.84090817768424,8.98882050177807,0.404293906246108,31
"4761","AL","São Sebastião",34290,12884.89,27006,"Arapiraca",2,"Nordeste",0,"270880",2,33,21,12,16,17,0,0,0,0,0,33,21,12,16,17,17,9.46381058599143,10.442609045457,0.305317174351246,29
"4762","AL","São Sebastião",34290,12884.89,27006,"Arapiraca",2,"Nordeste",0,"270880",3,41,18,23,16,25,0,0,0,0,0,41,18,23,16,25,20,9.46381058599143,10.442609045457,0.398824043956114,31
"4763","AL","São Sebastião",34290,12884.89,27006,"Arapiraca",2,"Nordeste",0,"270880",4,23,14,9,11,12,0,0,0,0,0,23,14,9,11,12,11,9.46381058599143,10.442609045457,0.431150056207131,30
"4764","AL","São Sebastião",34290,12884.89,27006,"Arapiraca",2,"Nordeste",0,"270880",5,40,24,16,22,18,0,0,0,0,0,40,24,16,22,18,19,9.46381058599143,10.442609045457,0.446929473917158,31
"4765","AL","Satuba",13936,12368.73,27011,"Maceió",2,"Nordeste",1,"270890",2,35,9,26,18,17,1,0,1,0,1,36,9,27,18,18,6,9.4229267923713,9.54223069909228,0.281249632314992,29
"4766","AL","Satuba",13936,12368.73,27011,"Maceió",2,"Nordeste",1,"270890",3,19,5,14,10,9,1,0,1,1,0,20,5,15,11,9,8,9.4229267923713,9.54223069909228,0.374990879519359,31
"4767","AL","Satuba",13936,12368.73,27011,"Maceió",2,"Nordeste",1,"270890",4,15,3,12,5,10,0,0,0,0,0,15,3,12,5,10,6,9.4229267923713,9.54223069909228,0.425305176298874,30
"4768","AL","Satuba",13936,12368.73,27011,"Maceió",2,"Nordeste",1,"270890",5,26,6,20,10,16,0,0,0,0,0,26,6,20,10,16,20,9.4229267923713,9.54223069909228,0.434118704182512,31
"4769","AL","Senador Rui Palmeira",13921,6349.6,27003,"Santana do Ipanema",2,"Nordeste",0,"270895",2,14,8,6,8,6,0,0,0,0,0,14,8,6,8,6,4,8.75614709777667,9.54115377038857,0.328405898310192,29
"4770","AL","Senador Rui Palmeira",13921,6349.6,27003,"Santana do Ipanema",2,"Nordeste",0,"270895",3,13,8,5,5,8,0,0,0,0,0,13,8,5,5,8,9,8.75614709777667,9.54115377038857,0.380173172747742,31
"4771","AL","Senador Rui Palmeira",13921,6349.6,27003,"Santana do Ipanema",2,"Nordeste",0,"270895",4,21,15,6,10,11,0,0,0,0,0,21,15,6,10,11,6,8.75614709777667,9.54115377038857,0.406894464145238,30
"4772","AL","Senador Rui Palmeira",13921,6349.6,27003,"Santana do Ipanema",2,"Nordeste",0,"270895",5,18,10,8,13,5,0,0,0,0,0,18,10,8,13,5,6,8.75614709777667,9.54115377038857,0.443641410224561,31
"4773","AL","Tanque d'Arca",6138,8821.64,27005,"Palmeira dos Índios",2,"Nordeste",0,"270900",2,5,0,5,1,4,0,0,0,0,0,5,0,5,1,4,4,9.08496307275903,8.72225423517968,0.280478368699118,29
"4774","AL","Tanque d'Arca",6138,8821.64,27005,"Palmeira dos Índios",2,"Nordeste",0,"270900",3,5,2,3,2,3,0,0,0,0,0,5,2,3,2,3,1,9.08496307275903,8.72225423517968,0.376532316502293,31
"4775","AL","Tanque d'Arca",6138,8821.64,27005,"Palmeira dos Índios",2,"Nordeste",0,"270900",4,10,2,8,5,5,0,0,0,0,0,10,2,8,5,5,4,9.08496307275903,8.72225423517968,0.390422429649543,30
"4776","AL","Tanque d'Arca",6138,8821.64,27005,"Palmeira dos Índios",2,"Nordeste",0,"270900",5,7,0,7,3,4,0,0,0,0,0,7,0,7,3,4,3,9.08496307275903,8.72225423517968,0.454628856592865,31
"4777","AL","Taquarana",20072,12761.67,27006,"Arapiraca",2,"Nordeste",0,"270910",2,21,6,15,10,11,0,0,0,0,0,21,6,15,10,11,11,9.45420142607798,9.90708108804626,0.28881015489748,29
"4778","AL","Taquarana",20072,12761.67,27006,"Arapiraca",2,"Nordeste",0,"270910",3,19,9,10,10,9,0,0,0,0,0,19,9,10,10,9,16,9.45420142607798,9.90708108804626,0.373085984823304,31
"4779","AL","Taquarana",20072,12761.67,27006,"Arapiraca",2,"Nordeste",0,"270910",4,23,8,15,10,13,0,0,0,0,0,23,8,15,10,13,8,9.45420142607798,9.90708108804626,0.395040524753024,30
"4780","AL","Taquarana",20072,12761.67,27006,"Arapiraca",2,"Nordeste",0,"270910",5,25,12,13,14,11,0,0,0,0,0,25,12,13,14,11,15,9.45420142607798,9.90708108804626,0.403683756465084,31
"4781","AL","Teotônio Vilela",44372,11655.14,27012,"São Miguel dos Campos",2,"Nordeste",1,"270915",2,45,16,29,22,23,1,1,0,0,1,46,17,29,22,24,22,9.36350256340973,10.7003639188585,0.268777302403945,29
"4782","AL","Teotônio Vilela",44372,11655.14,27012,"São Miguel dos Campos",2,"Nordeste",1,"270915",3,43,15,28,28,15,1,0,1,0,1,44,15,29,28,16,20,9.36350256340973,10.7003639188585,0.364923704985346,31
"4783","AL","Teotônio Vilela",44372,11655.14,27012,"São Miguel dos Campos",2,"Nordeste",1,"270915",4,32,7,25,15,17,0,0,0,0,0,32,7,25,15,17,25,9.36350256340973,10.7003639188585,0.391381457605726,30
"4784","AL","Teotônio Vilela",44372,11655.14,27012,"São Miguel dos Campos",2,"Nordeste",1,"270915",5,45,20,25,21,24,0,0,0,0,0,45,20,25,21,24,26,9.36350256340973,10.7003639188585,0.416711197807867,31
"4785","AL","União dos Palmares",65790,14393.46,27008,"Serrana dos Quilombos",2,"Nordeste",1,"270930",2,95,36,59,48,47,1,1,0,0,1,96,37,59,48,48,38,9.57452921573251,11.09422313008,0.289166110665977,29
"4786","AL","União dos Palmares",65790,14393.46,27008,"Serrana dos Quilombos",2,"Nordeste",1,"270930",3,97,36,61,39,58,0,0,0,0,0,97,36,61,39,58,35,9.57452921573251,11.09422313008,0.372970477635897,31
"4787","AL","União dos Palmares",65790,14393.46,27008,"Serrana dos Quilombos",2,"Nordeste",1,"270930",4,77,25,52,33,44,0,0,0,0,0,77,25,52,33,44,47,9.57452921573251,11.09422313008,0.399491731786447,30
"4788","AL","União dos Palmares",65790,14393.46,27008,"Serrana dos Quilombos",2,"Nordeste",1,"270930",5,90,36,54,49,41,2,1,1,1,1,92,37,55,50,42,67,9.57452921573251,11.09422313008,0.412203259037144,31
"4789","AL","Viçosa",25693,13185.78,27008,"Serrana dos Quilombos",2,"Nordeste",1,"270940",2,27,10,17,11,16,0,0,0,0,0,27,10,17,11,16,9,9.48689425517186,10.153973860242,0.279996614638302,29
"4790","AL","Viçosa",25693,13185.78,27008,"Serrana dos Quilombos",2,"Nordeste",1,"270940",3,27,10,17,14,13,0,0,0,0,0,27,10,17,14,13,16,9.48689425517186,10.153973860242,0.357220076492525,31
"4791","AL","Viçosa",25693,13185.78,27008,"Serrana dos Quilombos",2,"Nordeste",1,"270940",4,17,6,11,12,5,0,0,0,0,0,17,6,11,12,5,23,9.48689425517186,10.153973860242,0.399136662249293,30
"4792","AL","Viçosa",25693,13185.78,27008,"Serrana dos Quilombos",2,"Nordeste",1,"270940",5,35,20,15,26,9,1,0,1,0,1,36,20,16,26,10,22,9.48689425517186,10.153973860242,0.414481733273666,31
"4793","SE","Amparo do São Francisco",2380,11686.42,28007,"Propriá",2,"Nordeste",0,"280010",2,2,0,2,1,1,0,0,0,0,0,2,0,2,1,1,1,9.36618276291009,7.77485576666552,0.299757885521481,29
"4794","SE","Amparo do São Francisco",2380,11686.42,28007,"Propriá",2,"Nordeste",0,"280010",3,3,1,2,2,1,0,0,0,0,0,3,1,2,2,1,0,9.36618276291009,7.77485576666552,0.393438526391562,31
"4795","SE","Amparo do São Francisco",2380,11686.42,28007,"Propriá",2,"Nordeste",0,"280010",4,0,0,0,0,0,0,0,0,0,0,0,0,0,0,0,2,9.36618276291009,7.77485576666552,0.413287091152984,30
"4796","SE","Amparo do São Francisco",2380,11686.42,28007,"Propriá",2,"Nordeste",0,"280010",5,4,1,3,1,3,0,0,0,0,0,4,1,3,1,3,0,9.36618276291009,7.77485576666552,0.450076800200007,31
"4797","SE","Aquidabã",21681,10753.21,28003,"Nossa Senhora das Dores",2,"Nordeste",0,"280020",2,16,9,7,9,7,0,0,0,0,0,16,9,7,9,7,19,9.28295959363348,9.98419157995109,0.267651729007206,29
"4798","SE","Aquidabã",21681,10753.21,28003,"Nossa Senhora das Dores",2,"Nordeste",0,"280020",3,20,11,9,9,11,1,1,0,0,1,21,12,9,9,12,11,9.28295959363348,9.98419157995109,0.34328702083933,31
"4799","SE","Aquidabã",21681,10753.21,28003,"Nossa Senhora das Dores",2,"Nordeste",0,"280020",4,17,10,7,10,7,0,0,0,0,0,17,10,7,10,7,10,9.28295959363348,9.98419157995109,0.37905304038083,30
"4800","SE","Aquidabã",21681,10753.21,28003,"Nossa Senhora das Dores",2,"Nordeste",0,"280020",5,19,8,11,7,12,0,0,0,0,0,19,8,11,7,12,13,9.28295959363348,9.98419157995109,0.379608122540907,31
"4801","SE","Aracaju",664908,26622.38,28011,"Aracaju",2,"Nordeste",1,"280030",2,579,147,432,192,387,4,2,2,2,2,583,149,434,194,389,283,10.1895074944139,13.4074039642027,0.278217520515584,29
"4802","SE","Aracaju",664908,26622.38,28011,"Aracaju",2,"Nordeste",1,"280030",3,556,142,414,197,359,6,3,3,1,5,562,145,417,198,364,366,10.1895074944139,13.4074039642027,0.394098442585027,31
"4803","SE","Aracaju",664908,26622.38,28011,"Aracaju",2,"Nordeste",1,"280030",4,606,143,463,205,401,5,0,5,0,5,611,143,468,205,406,315,10.1895074944139,13.4074039642027,0.456546749193799,30
"4804","SE","Aracaju",664908,26622.38,28011,"Aracaju",2,"Nordeste",1,"280030",5,588,138,450,201,387,7,0,7,1,6,595,138,457,202,393,366,10.1895074944139,13.4074039642027,0.440055015205773,31
"4805","SE","Arauá",9947,10687.24,28012,"Boquim",2,"Nordeste",0,"280040",2,11,6,5,1,10,0,0,0,0,0,11,6,5,1,10,4,9.27680578546372,9.20502627715241,0.29085212944523,29
"4806","SE","Arauá",9947,10687.24,28012,"Boquim",2,"Nordeste",0,"280040",3,14,6,8,9,5,0,0,0,0,0,14,6,8,9,5,8,9.27680578546372,9.20502627715241,0.395831785498248,31
"4807","SE","Arauá",9947,10687.24,28012,"Boquim",2,"Nordeste",0,"280040",4,12,4,8,6,6,1,0,1,0,1,13,4,9,6,7,7,9.27680578546372,9.20502627715241,0.430815432580112,30
"4808","SE","Arauá",9947,10687.24,28012,"Boquim",2,"Nordeste",0,"280040",5,12,5,7,3,9,0,0,0,0,0,12,5,7,3,9,8,9.27680578546372,9.20502627715241,0.423349156247934,31
"4809","SE","Areia Branca",18686,10275.35,28004,"Agreste de Itabaiana",2,"Nordeste",0,"280050",2,15,7,8,7,8,0,0,0,0,0,15,7,8,7,8,8,9.23750310204464,9.8355298593529,0.28497985129731,29
"4810","SE","Areia Branca",18686,10275.35,28004,"Agreste de Itabaiana",2,"Nordeste",0,"280050",3,18,9,9,9,9,0,0,0,0,0,18,9,9,9,9,5,9.23750310204464,9.8355298593529,0.378069300007901,31
"4811","SE","Areia Branca",18686,10275.35,28004,"Agreste de Itabaiana",2,"Nordeste",0,"280050",4,21,12,9,12,9,0,0,0,0,0,21,12,9,12,9,13,9.23750310204464,9.8355298593529,0.40197536379163,30
"4812","SE","Areia Branca",18686,10275.35,28004,"Agreste de Itabaiana",2,"Nordeste",0,"280050",5,22,11,11,14,8,0,0,0,0,0,22,11,11,14,8,12,9.23750310204464,9.8355298593529,0.393324489871258,31
"4813","SE","Barra dos Coqueiros",30930,16438.72,28011,"Aracaju",2,"Nordeste",1,"280060",2,38,11,27,15,23,1,0,1,0,1,39,11,28,15,24,20,9.70739480669823,10.3394818656791,0.279371021666806,29
"4814","SE","Barra dos Coqueiros",30930,16438.72,28011,"Aracaju",2,"Nordeste",1,"280060",3,34,11,23,14,20,1,1,0,1,0,35,12,23,15,20,23,9.70739480669823,10.3394818656791,0.381555843737551,31
"4815","SE","Barra dos Coqueiros",30930,16438.72,28011,"Aracaju",2,"Nordeste",1,"280060",4,33,10,23,14,19,0,0,0,0,0,33,10,23,14,19,17,9.70739480669823,10.3394818656791,0.434433752467217,30
"4816","SE","Barra dos Coqueiros",30930,16438.72,28011,"Aracaju",2,"Nordeste",1,"280060",5,53,14,39,21,32,0,0,0,0,0,53,14,39,21,32,15,9.70739480669823,10.3394818656791,0.424937938617296,31
"4817","SE","Boquim",26899,10937.23,28012,"Boquim",2,"Nordeste",0,"280067",2,15,6,9,6,9,1,1,0,0,1,16,7,9,6,10,18,9.29992784464689,10.1998443901777,0.273331513599757,29
"4818","SE","Boquim",26899,10937.23,28012,"Boquim",2,"Nordeste",0,"280067",3,21,9,12,9,12,0,0,0,0,0,21,9,12,9,12,14,9.29992784464689,10.1998443901777,0.364071385954088,31
"4819","SE","Boquim",26899,10937.23,28012,"Boquim",2,"Nordeste",0,"280067",4,25,13,12,13,12,1,0,1,0,1,26,13,13,13,13,13,9.29992784464689,10.1998443901777,0.387678959210105,30
"4820","SE","Boquim",26899,10937.23,28012,"Boquim",2,"Nordeste",0,"280067",5,26,6,20,6,20,2,1,1,1,1,28,7,21,7,21,15,9.29992784464689,10.1998443901777,0.390398850522897,31
"4821","SE","Brejo Grande",8353,9182.74,28007,"Propriá",2,"Nordeste",0,"280070",2,8,5,3,5,3,1,0,1,1,0,9,5,4,6,3,7,9.12508091402528,9.03037603475591,0.323042356166763,29
"4822","SE","Brejo Grande",8353,9182.74,28007,"Propriá",2,"Nordeste",0,"280070",3,11,5,6,9,2,0,0,0,0,0,11,5,6,9,2,5,9.12508091402528,9.03037603475591,0.391312404645112,31
"4823","SE","Brejo Grande",8353,9182.74,28007,"Propriá",2,"Nordeste",0,"280070",4,9,1,8,6,3,1,0,1,0,1,10,1,9,6,4,6,9.12508091402528,9.03037603475591,0.388779786539032,30
"4824","SE","Brejo Grande",8353,9182.74,28007,"Propriá",2,"Nordeste",0,"280070",5,12,5,7,10,2,0,0,0,0,0,12,5,7,10,2,5,9.12508091402528,9.03037603475591,0.403842297972753,31
"4825","SE","Campo do Brito",18218,10975.49,28004,"Agreste de Itabaiana",2,"Nordeste",0,"280100",2,17,12,5,6,11,0,0,0,0,0,17,12,5,6,11,9,9.30341988387156,9.81016539530476,0.272703430492378,29
"4826","SE","Campo do Brito",18218,10975.49,28004,"Agreste de Itabaiana",2,"Nordeste",0,"280100",3,17,6,11,6,11,0,0,0,0,0,17,6,11,6,11,11,9.30341988387156,9.81016539530476,0.345610153089297,31
"4827","SE","Campo do Brito",18218,10975.49,28004,"Agreste de Itabaiana",2,"Nordeste",0,"280100",4,15,7,8,4,11,0,0,0,0,0,15,7,8,4,11,10,9.30341988387156,9.81016539530476,0.364711660732525,30
"4828","SE","Campo do Brito",18218,10975.49,28004,"Agreste de Itabaiana",2,"Nordeste",0,"280100",5,23,13,10,10,13,0,0,0,0,0,23,13,10,10,13,14,9.30341988387156,9.81016539530476,0.349946440264166,31
"4829","SE","Canindé de São Francisco",30402,73005.72,28001,"Sergipana do Sertão do São Francisco",2,"Nordeste",0,"280120",2,34,19,15,15,19,0,0,0,0,0,34,19,15,15,19,14,11.1982930732252,10.322263674704,0.285307957076418,29
"4830","SE","Canindé de São Francisco",30402,73005.72,28001,"Sergipana do Sertão do São Francisco",2,"Nordeste",0,"280120",3,49,26,23,29,20,0,0,0,0,0,49,26,23,29,20,13,11.1982930732252,10.322263674704,0.378178229550959,31
"4831","SE","Canindé de São Francisco",30402,73005.72,28001,"Sergipana do Sertão do São Francisco",2,"Nordeste",0,"280120",4,43,33,10,25,18,1,1,0,1,0,44,34,10,26,18,16,11.1982930732252,10.322263674704,0.390308399249048,30
"4832","SE","Canindé de São Francisco",30402,73005.72,28001,"Sergipana do Sertão do São Francisco",2,"Nordeste",0,"280120",5,40,23,17,21,19,1,0,1,0,1,41,23,18,21,20,22,11.1982930732252,10.322263674704,0.40352233637592,31
"4833","SE","Capela",34514,11067.57,28008,"Cotinguiba",2,"Nordeste",0,"280130",2,37,20,17,16,21,0,0,0,0,0,37,20,17,16,21,15,9.31177448941123,10.4491203178075,0.2780424054166,29
"4834","SE","Capela",34514,11067.57,28008,"Cotinguiba",2,"Nordeste",0,"280130",3,52,29,23,24,28,0,0,0,0,0,52,29,23,24,28,19,9.31177448941123,10.4491203178075,0.361974648045563,31
"4835","SE","Capela",34514,11067.57,28008,"Cotinguiba",2,"Nordeste",0,"280130",4,44,27,17,22,22,1,1,0,0,1,45,28,17,22,23,9,9.31177448941123,10.4491203178075,0.394211162829154,30
"4836","SE","Capela",34514,11067.57,28008,"Cotinguiba",2,"Nordeste",0,"280130",5,52,31,21,28,24,0,0,0,0,0,52,31,21,28,24,17,9.31177448941123,10.4491203178075,0.385310877760642,31
"4837","SE","Carira",22239,9961.02,28002,"Carira",2,"Nordeste",0,"280140",2,19,9,10,8,11,0,0,0,0,0,19,9,10,8,11,12,9.20643475497369,10.0096027833248,0.298532652564022,29
"4838","SE","Carira",22239,9961.02,28002,"Carira",2,"Nordeste",0,"280140",3,15,8,7,4,11,0,0,0,0,0,15,8,7,4,11,19,9.20643475497369,10.0096027833248,0.363162709547057,31
"4839","SE","Carira",22239,9961.02,28002,"Carira",2,"Nordeste",0,"280140",4,14,10,4,4,10,0,0,0,0,0,14,10,4,4,10,16,9.20643475497369,10.0096027833248,0.380808182530043,30
"4840","SE","Carira",22239,9961.02,28002,"Carira",2,"Nordeste",0,"280140",5,20,13,7,8,12,0,0,0,0,0,20,13,7,8,12,11,9.20643475497369,10.0096027833248,0.39985234981039,31
"4841","SE","Carmópolis",16937,24617.01,28010,"Baixo Cotinguiba",2,"Nordeste",1,"280150",2,15,9,6,9,6,0,0,0,0,0,15,9,6,9,6,6,10.1111929463844,9.73725585689112,0.267322267700493,29
"4842","SE","Carmópolis",16937,24617.01,28010,"Baixo Cotinguiba",2,"Nordeste",1,"280150",3,13,6,7,6,7,0,0,0,0,0,13,6,7,6,7,1,10.1111929463844,9.73725585689112,0.35115890858661,31
"4843","SE","Carmópolis",16937,24617.01,28010,"Baixo Cotinguiba",2,"Nordeste",1,"280150",4,19,9,10,8,11,0,0,0,0,0,19,9,10,8,11,4,10.1111929463844,9.73725585689112,0.376100963117335,30
"4844","SE","Carmópolis",16937,24617.01,28010,"Baixo Cotinguiba",2,"Nordeste",1,"280150",5,25,13,12,9,16,0,0,0,0,0,25,13,12,9,16,6,10.1111929463844,9.73725585689112,0.36580542113045,31
"4845","SE","Cedro de São João",5913,9240.22,28007,"Propriá",2,"Nordeste",0,"280160",2,3,1,2,1,2,0,0,0,0,0,3,1,2,1,2,4,9.1313209738761,8.68490859582083,0.268437189069661,29
"4846","SE","Cedro de São João",5913,9240.22,28007,"Propriá",2,"Nordeste",0,"280160",3,3,1,2,1,2,0,0,0,0,0,3,1,2,1,2,3,9.1313209738761,8.68490859582083,0.376324704059685,31
"4847","SE","Cedro de São João",5913,9240.22,28007,"Propriá",2,"Nordeste",0,"280160",4,5,4,1,4,1,0,0,0,0,0,5,4,1,4,1,0,9.1313209738761,8.68490859582083,0.404291398893673,30
"4848","SE","Cedro de São João",5913,9240.22,28007,"Propriá",2,"Nordeste",0,"280160",5,6,3,3,3,3,0,0,0,0,0,6,3,3,3,3,2,9.1313209738761,8.68490859582083,0.412189047849097,31
"4849","SE","Cristinápolis",18029,11570.6,28012,"Boquim",2,"Nordeste",0,"280170",2,22,8,14,11,11,0,0,0,0,0,22,8,14,11,11,8,9.35622267709723,9.7997368515422,0.294206207471203,29
"4850","SE","Cristinápolis",18029,11570.6,28012,"Boquim",2,"Nordeste",0,"280170",3,28,10,18,11,17,0,0,0,0,0,28,10,18,11,17,11,9.35622267709723,9.7997368515422,0.366661270407075,31
"4851","SE","Cristinápolis",18029,11570.6,28012,"Boquim",2,"Nordeste",0,"280170",4,24,7,17,12,12,0,0,0,0,0,24,7,17,12,12,8,9.35622267709723,9.7997368515422,0.401488425968142,30
"4852","SE","Cristinápolis",18029,11570.6,28012,"Boquim",2,"Nordeste",0,"280170",5,24,10,14,16,8,0,0,0,0,0,24,10,14,16,8,6,9.35622267709723,9.7997368515422,0.401208340323851,31
"4853","SE","Cumbe",3998,9271.46,28003,"Nossa Senhora das Dores",2,"Nordeste",0,"280190",2,3,0,3,0,3,0,0,0,0,0,3,0,3,0,3,2,9.13469614346163,8.29354951506035,0.314394093571021,29
"4854","SE","Cumbe",3998,9271.46,28003,"Nossa Senhora das Dores",2,"Nordeste",0,"280190",3,4,3,1,1,3,0,0,0,0,0,4,3,1,1,3,1,9.13469614346163,8.29354951506035,0.384106110285733,31
"4855","SE","Cumbe",3998,9271.46,28003,"Nossa Senhora das Dores",2,"Nordeste",0,"280190",4,0,0,0,0,0,0,0,0,0,0,0,0,0,0,0,4,9.13469614346163,8.29354951506035,0.385914987266965,30
"4856","SE","Cumbe",3998,9271.46,28003,"Nossa Senhora das Dores",2,"Nordeste",0,"280190",5,2,1,1,1,1,0,0,0,0,0,2,1,1,1,1,2,9.13469614346163,8.29354951506035,0.377595200208331,31
"4857","SE","Divina Pastora",5215,30179.85,28008,"Cotinguiba",2,"Nordeste",1,"280200",2,5,2,3,4,1,0,0,0,0,0,5,2,3,4,1,0,10.3149297621306,8.55929436743487,0.346701063074659,29
"4858","SE","Divina Pastora",5215,30179.85,28008,"Cotinguiba",2,"Nordeste",1,"280200",3,4,1,3,1,3,1,0,1,0,1,5,1,4,1,4,3,10.3149297621306,8.55929436743487,0.440058844658554,31
"4859","SE","Divina Pastora",5215,30179.85,28008,"Cotinguiba",2,"Nordeste",1,"280200",4,4,1,3,0,4,0,0,0,0,0,4,1,3,0,4,2,10.3149297621306,8.55929436743487,0.454580545353047,30
"4860","SE","Divina Pastora",5215,30179.85,28008,"Cotinguiba",2,"Nordeste",1,"280200",5,10,5,5,3,7,0,0,0,0,0,10,5,5,3,7,5,10.3149297621306,8.55929436743487,0.457570096191255,31
"4861","SE","Estância",69556,24677.68,28013,"Estância",2,"Nordeste",1,"280210",2,53,23,30,21,32,1,0,1,0,1,54,23,31,21,33,36,10.1136544703593,11.149887462502,0.253794952776886,29
"4862","SE","Estância",69556,24677.68,28013,"Estância",2,"Nordeste",1,"280210",3,77,26,51,31,46,1,0,1,1,0,78,26,52,32,46,40,10.1136544703593,11.149887462502,0.351151388172956,31
"4863","SE","Estância",69556,24677.68,28013,"Estância",2,"Nordeste",1,"280210",4,82,37,45,29,53,0,0,0,0,0,82,37,45,29,53,45,10.1136544703593,11.149887462502,0.386465570337186,30
"4864","SE","Estância",69556,24677.68,28013,"Estância",2,"Nordeste",1,"280210",5,74,28,46,37,37,1,1,0,1,0,75,29,46,38,37,49,10.1136544703593,11.149887462502,0.386169422311625,31
"4865","SE","Feira Nova",5601,10308.38,28001,"Sergipana do Sertão do São Francisco",2,"Nordeste",0,"280220",2,4,2,2,1,3,0,0,0,0,0,4,2,2,1,3,3,9.24071243566398,8.63070043220983,0.271147711383311,29
"4866","SE","Feira Nova",5601,10308.38,28001,"Sergipana do Sertão do São Francisco",2,"Nordeste",0,"280220",3,10,6,4,7,3,0,0,0,0,0,10,6,4,7,3,3,9.24071243566398,8.63070043220983,0.376182244570211,31
"4867","SE","Feira Nova",5601,10308.38,28001,"Sergipana do Sertão do São Francisco",2,"Nordeste",0,"280220",4,6,2,4,3,3,0,0,0,0,0,6,2,4,3,3,4,9.24071243566398,8.63070043220983,0.386941903623752,30
"4868","SE","Feira Nova",5601,10308.38,28001,"Sergipana do Sertão do São Francisco",2,"Nordeste",0,"280220",5,11,7,4,8,3,1,1,0,1,0,12,8,4,9,3,2,9.24071243566398,8.63070043220983,0.375839089761267,31
"4869","SE","Frei Paulo",15556,14054.71,28002,"Carira",2,"Nordeste",0,"280230",2,10,6,4,4,6,0,0,0,0,0,10,6,4,4,6,8,9.55071284990115,9.65220169527564,0.282113945705366,29
"4870","SE","Frei Paulo",15556,14054.71,28002,"Carira",2,"Nordeste",0,"280230",3,25,16,9,13,12,0,0,0,0,0,25,16,9,13,12,11,9.55071284990115,9.65220169527564,0.366211018674374,31
"4871","SE","Frei Paulo",15556,14054.71,28002,"Carira",2,"Nordeste",0,"280230",4,16,7,9,9,7,0,0,0,0,0,16,7,9,9,7,9,9.55071284990115,9.65220169527564,0.379770233316665,30
"4872","SE","Frei Paulo",15556,14054.71,28002,"Carira",2,"Nordeste",0,"280230",5,17,10,7,12,5,0,0,0,0,0,17,10,7,12,5,15,9.55071284990115,9.65220169527564,0.392277016294566,31
"4873","SE","Gararu",11601,8931.64,28001,"Sergipana do Sertão do São Francisco",2,"Nordeste",0,"280240",2,3,1,2,3,0,0,0,0,0,0,3,1,2,3,0,5,9.09735530762474,9.35884658027541,0.307482074653705,29
"4874","SE","Gararu",11601,8931.64,28001,"Sergipana do Sertão do São Francisco",2,"Nordeste",0,"280240",3,11,6,5,5,6,0,0,0,0,0,11,6,5,5,6,3,9.09735530762474,9.35884658027541,0.396969501009621,31
"4875","SE","Gararu",11601,8931.64,28001,"Sergipana do Sertão do São Francisco",2,"Nordeste",0,"280240",4,12,5,7,7,5,0,0,0,0,0,12,5,7,7,5,1,9.09735530762474,9.35884658027541,0.387202944730932,30
"4876","SE","Gararu",11601,8931.64,28001,"Sergipana do Sertão do São Francisco",2,"Nordeste",0,"280240",5,12,4,8,6,6,0,0,0,0,0,12,4,8,6,6,7,9.09735530762474,9.35884658027541,0.410920863675483,31
"4877","SE","General Maynard",3384,9580.78,28010,"Baixo Cotinguiba",2,"Nordeste",1,"280250",2,4,0,4,2,2,0,0,0,0,0,4,0,4,2,2,2,9.16751428727473,8.12681372072611,0.251054779351651,29
"4878","SE","General Maynard",3384,9580.78,28010,"Baixo Cotinguiba",2,"Nordeste",1,"280250",3,2,0,2,2,0,0,0,0,0,0,2,0,2,2,0,2,9.16751428727473,8.12681372072611,0.344675074297327,31
"4879","SE","General Maynard",3384,9580.78,28010,"Baixo Cotinguiba",2,"Nordeste",1,"280250",4,6,3,3,3,3,0,0,0,0,0,6,3,3,3,3,2,9.16751428727473,8.12681372072611,0.382266322153852,30
"4880","SE","General Maynard",3384,9580.78,28010,"Baixo Cotinguiba",2,"Nordeste",1,"280250",5,3,0,3,1,2,0,0,0,0,0,3,0,3,1,2,0,9.16751428727473,8.12681372072611,0.357126173723102,31
"4881","SE","Gracho Cardoso",5824,10474.29,28001,"Sergipana do Sertão do São Francisco",2,"Nordeste",0,"280260",2,4,4,0,3,1,0,0,0,0,0,4,4,0,3,1,5,9.25667896206355,8.66974258987652,0.292724127925217,29
"4882","SE","Gracho Cardoso",5824,10474.29,28001,"Sergipana do Sertão do São Francisco",2,"Nordeste",0,"280260",3,6,4,2,3,3,0,0,0,0,0,6,4,2,3,3,5,9.25667896206355,8.66974258987652,0.35695982814015,31
"4883","SE","Gracho Cardoso",5824,10474.29,28001,"Sergipana do Sertão do São Francisco",2,"Nordeste",0,"280260",4,4,2,2,2,2,1,1,0,0,1,5,3,2,2,3,4,9.25667896206355,8.66974258987652,0.396921268175645,30
"4884","SE","Gracho Cardoso",5824,10474.29,28001,"Sergipana do Sertão do São Francisco",2,"Nordeste",0,"280260",5,6,4,2,3,3,1,0,1,1,0,7,4,3,4,3,2,9.25667896206355,8.66974258987652,0.420608625317852,31
"4885","SE","Ilha das Flores",8521,8448.23,28007,"Propriá",2,"Nordeste",0,"280270",2,12,8,4,7,5,0,0,0,0,0,12,8,4,7,5,3,9.04171223095423,9.05028898382796,0.283246673213554,29
"4886","SE","Ilha das Flores",8521,8448.23,28007,"Propriá",2,"Nordeste",0,"280270",3,10,6,4,7,3,1,0,1,0,1,11,6,5,7,4,4,9.04171223095423,9.05028898382796,0.353469603883989,31
"4887","SE","Ilha das Flores",8521,8448.23,28007,"Propriá",2,"Nordeste",0,"280270",4,10,5,5,2,8,0,0,0,0,0,10,5,5,2,8,5,9.04171223095423,9.05028898382796,0.361467162087845,30
"4888","SE","Ilha das Flores",8521,8448.23,28007,"Propriá",2,"Nordeste",0,"280270",5,8,6,2,3,5,0,0,0,0,0,8,6,2,3,5,6,9.04171223095423,9.05028898382796,0.356745030716212,31
"4889","SE","Indiaroba",18149,10378.32,28013,"Estância",2,"Nordeste",0,"280280",2,16,7,9,8,8,0,0,0,0,0,16,7,9,8,8,7,9.24747429390982,9.8063707417564,0.316785916471535,29
"4890","SE","Indiaroba",18149,10378.32,28013,"Estância",2,"Nordeste",0,"280280",3,14,7,7,7,7,0,0,0,0,0,14,7,7,7,7,9,9.24747429390982,9.8063707417564,0.42481609387324,31
"4891","SE","Indiaroba",18149,10378.32,28013,"Estância",2,"Nordeste",0,"280280",4,21,11,10,9,12,1,1,0,1,0,22,12,10,10,12,8,9.24747429390982,9.8063707417564,0.438709298368812,30
"4892","SE","Indiaroba",18149,10378.32,28013,"Estância",2,"Nordeste",0,"280280",5,17,7,10,10,7,0,0,0,0,0,17,7,10,10,7,6,9.24747429390982,9.8063707417564,0.444338220317438,31
"4893","SE","Itabaiana",96142,19020.44,28004,"Agreste de Itabaiana",2,"Nordeste",1,"280290",2,107,38,69,35,72,1,0,1,0,1,108,38,70,35,73,53,9.85326946937544,11.4735815442272,0.272593653981714,29
"4894","SE","Itabaiana",96142,19020.44,28004,"Agreste de Itabaiana",2,"Nordeste",1,"280290",3,104,41,63,37,67,1,1,0,1,0,105,42,63,38,67,76,9.85326946937544,11.4735815442272,0.361303185193783,31
"4895","SE","Itabaiana",96142,19020.44,28004,"Agreste de Itabaiana",2,"Nordeste",1,"280290",4,107,48,59,45,62,2,0,2,0,2,109,48,61,45,64,61,9.85326946937544,11.4735815442272,0.38750779260216,30
"4896","SE","Itabaiana",96142,19020.44,28004,"Agreste de Itabaiana",2,"Nordeste",1,"280290",5,116,49,67,43,73,0,0,0,0,0,116,49,67,43,73,71,9.85326946937544,11.4735815442272,0.378243722533975,31
"4897","SE","Itabaianinha",42166,10278.14,28012,"Boquim",2,"Nordeste",0,"280300",2,39,13,26,15,24,0,0,0,0,0,39,13,26,15,24,22,9.23777458878651,10.6493694880799,0.265658650037544,29
"4898","SE","Itabaianinha",42166,10278.14,28012,"Boquim",2,"Nordeste",0,"280300",3,37,24,13,18,19,1,1,0,1,0,38,25,13,19,19,23,9.23777458878651,10.6493694880799,0.364349638744728,31
"4899","SE","Itabaianinha",42166,10278.14,28012,"Boquim",2,"Nordeste",0,"280300",4,41,19,22,16,25,0,0,0,0,0,41,19,22,16,25,13,9.23777458878651,10.6493694880799,0.390932077949452,30
"4900","SE","Itabaianinha",42166,10278.14,28012,"Boquim",2,"Nordeste",0,"280300",5,48,23,25,28,20,0,0,0,0,0,48,23,25,28,20,20,9.23777458878651,10.6493694880799,0.379003445893626,31
"4901","SE","Itabi",4886,10881.59,28001,"Sergipana do Sertão do São Francisco",2,"Nordeste",0,"280310",2,3,2,1,1,2,0,0,0,0,0,3,2,1,1,2,4,9.29482764943845,8.49412925181769,0.310219700151211,29
"4902","SE","Itabi",4886,10881.59,28001,"Sergipana do Sertão do São Francisco",2,"Nordeste",0,"280310",3,5,1,4,4,1,0,0,0,0,0,5,1,4,4,1,1,9.29482764943845,8.49412925181769,0.407277542955071,31
"4903","SE","Itabi",4886,10881.59,28001,"Sergipana do Sertão do São Francisco",2,"Nordeste",0,"280310",4,5,3,2,5,0,0,0,0,0,0,5,3,2,5,0,2,9.29482764943845,8.49412925181769,0.420451374990649,30
"4904","SE","Itabi",4886,10881.59,28001,"Sergipana do Sertão do São Francisco",2,"Nordeste",0,"280310",5,4,2,2,1,3,0,0,0,0,0,4,2,2,1,3,2,9.29482764943845,8.49412925181769,0.401589560959843,31
"4905","SE","Itaporanga d'Ajuda",34709,26581.3,28013,"Estância",2,"Nordeste",0,"280320",2,36,13,23,14,22,0,0,0,0,0,36,13,23,14,22,16,10.1879632400253,10.4547542982996,0.28722421734086,29
"4906","SE","Itaporanga d'Ajuda",34709,26581.3,28013,"Estância",2,"Nordeste",0,"280320",3,25,9,16,15,10,1,1,0,1,0,26,10,16,16,10,9,10.1879632400253,10.4547542982996,0.378829345500981,31
"4907","SE","Itaporanga d'Ajuda",34709,26581.3,28013,"Estância",2,"Nordeste",0,"280320",4,42,16,26,17,25,1,0,1,0,1,43,16,27,17,26,16,10.1879632400253,10.4547542982996,0.413739587083706,30
"4908","SE","Itaporanga d'Ajuda",34709,26581.3,28013,"Estância",2,"Nordeste",0,"280320",5,39,16,23,18,21,0,0,0,0,0,39,16,23,18,21,18,10.1879632400253,10.4547542982996,0.412571759251016,31
"4909","SE","Japaratuba",18907,21171.11,28009,"Japaratuba",2,"Nordeste",0,"280330",2,9,2,7,4,5,1,1,0,1,0,10,3,7,5,5,9,9.96039279544213,9.84728750284793,0.274679940019528,29
"4910","SE","Japaratuba",18907,21171.11,28009,"Japaratuba",2,"Nordeste",0,"280330",3,18,10,8,13,5,0,0,0,0,0,18,10,8,13,5,11,9.96039279544213,9.84728750284793,0.367085916433368,31
"4911","SE","Japaratuba",18907,21171.11,28009,"Japaratuba",2,"Nordeste",0,"280330",4,16,5,11,6,10,0,0,0,0,0,16,5,11,6,10,12,9.96039279544213,9.84728750284793,0.398057208429487,30
"4912","SE","Japaratuba",18907,21171.11,28009,"Japaratuba",2,"Nordeste",0,"280330",5,19,6,13,6,13,0,0,0,0,0,19,6,13,6,13,12,9.96039279544213,9.84728750284793,0.397856119427386,31
"4913","SE","Japoatã",13429,12407.61,28009,"Japaratuba",2,"Nordeste",0,"280340",2,16,9,7,7,9,2,1,1,0,2,18,10,8,7,11,4,9.42606527302778,9.50517182658118,0.277186575979526,29
"4914","SE","Japoatã",13429,12407.61,28009,"Japaratuba",2,"Nordeste",0,"280340",3,20,9,11,10,10,0,0,0,0,0,20,9,11,10,10,7,9.42606527302778,9.50517182658118,0.357530253273969,31
"4915","SE","Japoatã",13429,12407.61,28009,"Japaratuba",2,"Nordeste",0,"280340",4,18,9,9,5,13,0,0,0,0,0,18,9,9,5,13,4,9.42606527302778,9.50517182658118,0.373758122856631,30
"4916","SE","Japoatã",13429,12407.61,28009,"Japaratuba",2,"Nordeste",0,"280340",5,24,10,14,9,15,0,0,0,0,0,24,10,14,9,15,10,9.42606527302778,9.50517182658118,0.384044289938435,31
"4917","SE","Lagarto",105221,14239.6,28006,"Agreste de Lagarto",2,"Nordeste",1,"280350",2,94,44,50,41,53,0,0,0,0,0,94,44,50,41,53,39,9.5637820946838,11.5638181791362,0.281189319488956,29
"4918","SE","Lagarto",105221,14239.6,28006,"Agreste de Lagarto",2,"Nordeste",1,"280350",3,99,45,54,46,53,1,0,1,0,1,100,45,55,46,54,55,9.5637820946838,11.5638181791362,0.369242076796055,31
"4919","SE","Lagarto",105221,14239.6,28006,"Agreste de Lagarto",2,"Nordeste",1,"280350",4,107,42,65,37,70,1,1,0,0,1,108,43,65,37,71,53,9.5637820946838,11.5638181791362,0.400053397119014,30
"4920","SE","Lagarto",105221,14239.6,28006,"Agreste de Lagarto",2,"Nordeste",1,"280350",5,125,43,82,47,78,0,0,0,0,0,125,43,82,47,78,55,9.5637820946838,11.5638181791362,0.393901633266682,31
"4921","SE","Laranjeiras",30080,29166.26,28010,"Baixo Cotinguiba",2,"Nordeste",1,"280360",2,25,12,13,12,13,0,0,0,0,0,25,12,13,12,13,16,10.2807678407233,10.3116157780638,0.295955530441174,29
"4922","SE","Laranjeiras",30080,29166.26,28010,"Baixo Cotinguiba",2,"Nordeste",1,"280360",3,35,11,24,13,22,0,0,0,0,0,35,11,24,13,22,15,10.2807678407233,10.3116157780638,0.385268880578076,31
"4923","SE","Laranjeiras",30080,29166.26,28010,"Baixo Cotinguiba",2,"Nordeste",1,"280360",4,35,21,14,16,19,0,0,0,0,0,35,21,14,16,19,13,10.2807678407233,10.3116157780638,0.412578595674752,30
"4924","SE","Laranjeiras",30080,29166.26,28010,"Baixo Cotinguiba",2,"Nordeste",1,"280360",5,37,12,25,17,20,0,0,0,0,0,37,12,25,17,20,12,10.2807678407233,10.3116157780638,0.410728280321306,31
"4925","SE","Macambira",6961,9345.49,28004,"Agreste de Itabaiana",2,"Nordeste",0,"280370",2,9,4,5,3,6,0,0,0,0,0,9,4,5,3,6,3,9.14264915297195,8.84807842116867,0.291604928002834,29
"4926","SE","Macambira",6961,9345.49,28004,"Agreste de Itabaiana",2,"Nordeste",0,"280370",3,5,2,3,5,0,0,0,0,0,0,5,2,3,5,0,4,9.14264915297195,8.84807842116867,0.374929482177329,31
"4927","SE","Macambira",6961,9345.49,28004,"Agreste de Itabaiana",2,"Nordeste",0,"280370",4,7,3,4,2,5,0,0,0,0,0,7,3,4,2,5,4,9.14264915297195,8.84807842116867,0.408481297955416,30
"4928","SE","Macambira",6961,9345.49,28004,"Agreste de Itabaiana",2,"Nordeste",0,"280370",5,9,3,6,4,5,0,0,0,0,0,9,3,6,4,5,1,9.14264915297195,8.84807842116867,0.427628489603603,31
"4929","SE","Malhada dos Bois",3699,11663.61,28003,"Nossa Senhora das Dores",2,"Nordeste",0,"280380",2,3,1,2,1,2,0,0,0,0,0,3,1,2,1,2,3,9.36422901747545,8.21581779183245,0.320423749839957,29
"4930","SE","Malhada dos Bois",3699,11663.61,28003,"Nossa Senhora das Dores",2,"Nordeste",0,"280380",3,3,1,2,2,1,0,0,0,0,0,3,1,2,2,1,2,9.36422901747545,8.21581779183245,0.389796700311619,31
"4931","SE","Malhada dos Bois",3699,11663.61,28003,"Nossa Senhora das Dores",2,"Nordeste",0,"280380",4,1,1,0,1,0,0,0,0,0,0,1,1,0,1,0,3,9.36422901747545,8.21581779183245,0.405412647739774,30
"4932","SE","Malhada dos Bois",3699,11663.61,28003,"Nossa Senhora das Dores",2,"Nordeste",0,"280380",5,3,1,2,2,1,0,0,0,0,0,3,1,2,2,1,3,9.36422901747545,8.21581779183245,0.389367498145966,31
"4933","SE","Malhador",12653,10060.15,28004,"Agreste de Itabaiana",2,"Nordeste",0,"280390",2,8,6,2,3,5,0,0,0,0,0,8,6,2,3,5,7,9.21633735407935,9.44564962018926,0.27731134599192,29
"4934","SE","Malhador",12653,10060.15,28004,"Agreste de Itabaiana",2,"Nordeste",0,"280390",3,17,12,5,10,7,0,0,0,0,0,17,12,5,10,7,9,9.21633735407935,9.44564962018926,0.362747521822748,31
"4935","SE","Malhador",12653,10060.15,28004,"Agreste de Itabaiana",2,"Nordeste",0,"280390",4,12,4,8,7,5,0,0,0,0,0,12,4,8,7,5,2,9.21633735407935,9.44564962018926,0.383458873608907,30
"4936","SE","Malhador",12653,10060.15,28004,"Agreste de Itabaiana",2,"Nordeste",0,"280390",5,16,9,7,8,8,0,0,0,0,0,16,9,7,8,8,11,9.21633735407935,9.44564962018926,0.378470759062811,31
"4937","SE","Maruim",17271,18454.65,28010,"Baixo Cotinguiba",2,"Nordeste",1,"280400",2,18,8,10,10,8,0,0,0,0,0,18,8,10,10,8,5,9.82307165023414,9.75678407334392,0.280046669541723,29
"4938","SE","Maruim",17271,18454.65,28010,"Baixo Cotinguiba",2,"Nordeste",1,"280400",3,19,8,11,7,12,0,0,0,0,0,19,8,11,7,12,9,9.82307165023414,9.75678407334392,0.377675961831594,31
"4939","SE","Maruim",17271,18454.65,28010,"Baixo Cotinguiba",2,"Nordeste",1,"280400",4,14,4,10,3,11,0,0,0,0,0,14,4,10,3,11,6,9.82307165023414,9.75678407334392,0.401047622762899,30
"4940","SE","Maruim",17271,18454.65,28010,"Baixo Cotinguiba",2,"Nordeste",1,"280400",5,20,10,10,12,8,0,0,0,0,0,20,10,10,12,8,8,9.82307165023414,9.75678407334392,0.396868347825686,31
"4941","SE","Moita Bonita",11348,11419.09,28004,"Agreste de Itabaiana",2,"Nordeste",0,"280410",2,6,1,5,2,4,0,0,0,0,0,6,1,5,2,4,5,9.34304179527143,9.33679679592874,0.256222908333466,29
"4942","SE","Moita Bonita",11348,11419.09,28004,"Agreste de Itabaiana",2,"Nordeste",0,"280410",3,9,6,3,5,4,0,0,0,0,0,9,6,3,5,4,8,9.34304179527143,9.33679679592874,0.326509977985994,31
"4943","SE","Moita Bonita",11348,11419.09,28004,"Agreste de Itabaiana",2,"Nordeste",0,"280410",4,10,4,6,7,3,0,0,0,0,0,10,4,6,7,3,8,9.34304179527143,9.33679679592874,0.346063054832222,30
"4944","SE","Moita Bonita",11348,11419.09,28004,"Agreste de Itabaiana",2,"Nordeste",0,"280410",5,11,5,6,3,8,1,0,1,0,1,12,5,7,3,9,7,9.34304179527143,9.33679679592874,0.356067205228804,31
"4945","SE","Monte Alegre de Sergipe",15175,9186.21,28001,"Sergipana do Sertão do São Francisco",2,"Nordeste",0,"280420",2,16,8,8,9,7,0,0,0,0,0,16,8,8,9,7,5,9.12545872549968,9.6274046159277,0.269436367943784,29
"4946","SE","Monte Alegre de Sergipe",15175,9186.21,28001,"Sergipana do Sertão do São Francisco",2,"Nordeste",0,"280420",3,13,9,4,5,8,0,0,0,0,0,13,9,4,5,8,7,9.12545872549968,9.6274046159277,0.373430787544297,31
"4947","SE","Monte Alegre de Sergipe",15175,9186.21,28001,"Sergipana do Sertão do São Francisco",2,"Nordeste",0,"280420",4,22,10,12,15,7,1,0,1,0,1,23,10,13,15,8,5,9.12545872549968,9.6274046159277,0.392979013305447,30
"4948","SE","Monte Alegre de Sergipe",15175,9186.21,28001,"Sergipana do Sertão do São Francisco",2,"Nordeste",0,"280420",5,15,11,4,10,5,0,0,0,0,0,15,11,4,10,5,1,9.12545872549968,9.6274046159277,0.385944781478984,31
"4949","SE","Muribeca",7639,11999.29,28003,"Nossa Senhora das Dores",2,"Nordeste",0,"280430",2,6,1,5,3,3,0,0,0,0,0,6,1,5,3,3,6,9.39260276035306,8.94102198354136,0.29678415941102,29
"4950","SE","Muribeca",7639,11999.29,28003,"Nossa Senhora das Dores",2,"Nordeste",0,"280430",3,10,4,6,4,6,0,0,0,0,0,10,4,6,4,6,3,9.39260276035306,8.94102198354136,0.37720626409167,31
"4951","SE","Muribeca",7639,11999.29,28003,"Nossa Senhora das Dores",2,"Nordeste",0,"280430",4,6,2,4,1,5,0,0,0,0,0,6,2,4,1,5,10,9.39260276035306,8.94102198354136,0.390720731409229,30
"4952","SE","Muribeca",7639,11999.29,28003,"Nossa Senhora das Dores",2,"Nordeste",0,"280430",5,14,3,11,4,10,0,0,0,0,0,14,3,11,4,10,3,9.39260276035306,8.94102198354136,0.406745523395633,31
"4953","SE","Neópolis",18703,13541.89,28007,"Propriá",2,"Nordeste",1,"280440",2,13,6,7,2,11,1,1,0,0,1,14,7,7,2,12,7,9.51354312313562,9.836439217783,0.299939930291022,29
"4954","SE","Neópolis",18703,13541.89,28007,"Propriá",2,"Nordeste",1,"280440",3,15,3,12,7,8,0,0,0,0,0,15,3,12,7,8,16,9.51354312313562,9.836439217783,0.384284913962496,31
"4955","SE","Neópolis",18703,13541.89,28007,"Propriá",2,"Nordeste",1,"280440",4,18,7,11,10,8,0,0,0,0,0,18,7,11,10,8,12,9.51354312313562,9.836439217783,0.409894880447012,30
"4956","SE","Neópolis",18703,13541.89,28007,"Propriá",2,"Nordeste",1,"280440",5,23,12,11,10,13,1,1,0,0,1,24,13,11,10,14,7,9.51354312313562,9.836439217783,0.402355545779563,31
"4957","SE","Nossa Senhora Aparecida",8809,9529.54,28002,"Carira",2,"Nordeste",0,"280445",2,6,2,4,2,4,0,0,0,0,0,6,2,4,2,4,2,9.16215172685789,9.0835292051098,0.308949270388596,29
"4958","SE","Nossa Senhora Aparecida",8809,9529.54,28002,"Carira",2,"Nordeste",0,"280445",3,4,2,2,1,3,1,0,1,0,1,5,2,3,1,4,6,9.16215172685789,9.0835292051098,0.419911502203406,31
"4959","SE","Nossa Senhora Aparecida",8809,9529.54,28002,"Carira",2,"Nordeste",0,"280445",4,8,2,6,4,4,0,0,0,0,0,8,2,6,4,4,5,9.16215172685789,9.0835292051098,0.40311843841956,30
"4960","SE","Nossa Senhora Aparecida",8809,9529.54,28002,"Carira",2,"Nordeste",0,"280445",5,5,2,3,3,2,0,0,0,0,0,5,2,3,3,2,4,9.16215172685789,9.0835292051098,0.438019568065031,31
"4961","SE","Nossa Senhora da Glória",37324,15374.22,28001,"Sergipana do Sertão do São Francisco",2,"Nordeste",0,"280450",2,45,21,24,16,29,0,0,0,0,0,45,21,24,16,29,19,9.6404473596805,10.5273918303539,0.264996055962199,29
"4962","SE","Nossa Senhora da Glória",37324,15374.22,28001,"Sergipana do Sertão do São Francisco",2,"Nordeste",0,"280450",3,48,17,31,25,23,0,0,0,0,0,48,17,31,25,23,13,9.6404473596805,10.5273918303539,0.359154954037309,31
"4963","SE","Nossa Senhora da Glória",37324,15374.22,28001,"Sergipana do Sertão do São Francisco",2,"Nordeste",0,"280450",4,42,16,26,12,30,0,0,0,0,0,42,16,26,12,30,29,9.6404473596805,10.5273918303539,0.381397350690595,30
"4964","SE","Nossa Senhora da Glória",37324,15374.22,28001,"Sergipana do Sertão do São Francisco",2,"Nordeste",0,"280450",5,42,15,27,18,24,0,0,0,0,0,42,15,27,18,24,18,9.6404473596805,10.5273918303539,0.388531011499959,31
"4965","SE","Nossa Senhora das Dores",26795,11152.16,28003,"Nossa Senhora das Dores",2,"Nordeste",0,"280460",2,22,8,14,6,16,0,0,0,0,0,22,8,14,6,16,10,9.31938848009968,10.195970581929,0.255944161609453,29
"4966","SE","Nossa Senhora das Dores",26795,11152.16,28003,"Nossa Senhora das Dores",2,"Nordeste",0,"280460",3,19,6,13,7,12,1,0,1,0,1,20,6,14,7,13,22,9.31938848009968,10.195970581929,0.349962223363976,31
"4967","SE","Nossa Senhora das Dores",26795,11152.16,28003,"Nossa Senhora das Dores",2,"Nordeste",0,"280460",4,25,12,13,11,14,1,0,1,1,0,26,12,14,12,14,16,9.31938848009968,10.195970581929,0.364906946624477,30
"4968","SE","Nossa Senhora das Dores",26795,11152.16,28003,"Nossa Senhora das Dores",2,"Nordeste",0,"280460",5,24,14,10,8,16,1,0,1,0,1,25,14,11,8,17,14,9.31938848009968,10.195970581929,0.36478760694002,31
"4969","SE","Nossa Senhora de Lourdes",6496,9427.13,28007,"Propriá",2,"Nordeste",0,"280470",2,4,2,2,2,2,0,0,0,0,0,4,2,2,2,2,4,9.15134698147822,8.77894188184151,0.264280049716132,29
"4970","SE","Nossa Senhora de Lourdes",6496,9427.13,28007,"Propriá",2,"Nordeste",0,"280470",3,3,2,1,3,0,0,0,0,0,0,3,2,1,3,0,4,9.15134698147822,8.77894188184151,0.339205559769031,31
"4971","SE","Nossa Senhora de Lourdes",6496,9427.13,28007,"Propriá",2,"Nordeste",0,"280470",4,4,0,4,1,3,0,0,0,0,0,4,0,4,1,3,6,9.15134698147822,8.77894188184151,0.358785959283486,30
"4972","SE","Nossa Senhora de Lourdes",6496,9427.13,28007,"Propriá",2,"Nordeste",0,"280470",5,7,2,5,0,7,0,0,0,0,0,7,2,5,0,7,4,9.15134698147822,8.77894188184151,0.391516385786964,31
"4973","SE","Nossa Senhora do Socorro",185706,14090.75,28011,"Aracaju",2,"Nordeste",1,"280480",2,212,86,126,86,126,3,2,1,0,3,215,88,127,86,129,72,9.5532738327167,12.1319200569965,0.291234477847444,29
"4974","SE","Nossa Senhora do Socorro",185706,14090.75,28011,"Aracaju",2,"Nordeste",1,"280480",3,213,68,145,95,118,2,0,2,1,1,215,68,147,96,119,102,9.5532738327167,12.1319200569965,0.393909425838513,31
"4975","SE","Nossa Senhora do Socorro",185706,14090.75,28011,"Aracaju",2,"Nordeste",1,"280480",4,221,80,141,97,124,5,2,3,1,4,226,82,144,98,128,95,9.5532738327167,12.1319200569965,0.437618558300681,30
"4976","SE","Nossa Senhora do Socorro",185706,14090.75,28011,"Aracaju",2,"Nordeste",1,"280480",5,239,71,168,101,138,2,1,1,1,1,241,72,169,102,139,103,9.5532738327167,12.1319200569965,0.427605726457694,31
"4977","SE","Pacatuba",14540,12256.49,28009,"Japaratuba",2,"Nordeste",0,"280490",2,12,4,8,8,4,0,0,0,0,0,12,4,8,8,4,5,9.41381087159893,9.58465875108751,0.274863908627442,29
"4978","SE","Pacatuba",14540,12256.49,28009,"Japaratuba",2,"Nordeste",0,"280490",3,12,6,6,5,7,0,0,0,0,0,12,6,6,5,7,13,9.41381087159893,9.58465875108751,0.359286413983066,31
"4979","SE","Pacatuba",14540,12256.49,28009,"Japaratuba",2,"Nordeste",0,"280490",4,18,9,9,8,10,0,0,0,0,0,18,9,9,8,10,6,9.41381087159893,9.58465875108751,0.402210694697506,30
"4980","SE","Pacatuba",14540,12256.49,28009,"Japaratuba",2,"Nordeste",0,"280490",5,22,15,7,12,10,0,0,0,0,0,22,15,7,12,10,12,9.41381087159893,9.58465875108751,0.411839167518883,31
"4981","SE","Pedrinhas",9665,8564.54,28012,"Boquim",2,"Nordeste",0,"280510",2,13,5,8,5,8,0,0,0,0,0,13,5,8,5,8,5,9.05538570236907,9.17626639164243,0.280692399680521,29
"4982","SE","Pedrinhas",9665,8564.54,28012,"Boquim",2,"Nordeste",0,"280510",3,10,6,4,8,2,1,1,0,1,0,11,7,4,9,2,4,9.05538570236907,9.17626639164243,0.360893833861386,31
"4983","SE","Pedrinhas",9665,8564.54,28012,"Boquim",2,"Nordeste",0,"280510",4,7,4,3,5,2,0,0,0,0,0,7,4,3,5,2,3,9.05538570236907,9.17626639164243,0.396549893719333,30
"4984","SE","Pedrinhas",9665,8564.54,28012,"Boquim",2,"Nordeste",0,"280510",5,12,8,4,10,2,0,0,0,0,0,12,8,4,10,2,4,9.05538570236907,9.17626639164243,0.392629554447073,31
"4985","SE","Pinhão",6627,8341.66,28002,"Carira",2,"Nordeste",0,"280520",2,6,4,2,4,2,0,0,0,0,0,6,4,2,4,2,3,9.02901751631419,8.79890749208823,0.316966274335124,29
"4986","SE","Pinhão",6627,8341.66,28002,"Carira",2,"Nordeste",0,"280520",3,5,3,2,2,3,0,0,0,0,0,5,3,2,2,3,2,9.02901751631419,8.79890749208823,0.419893206523477,31
"4987","SE","Pinhão",6627,8341.66,28002,"Carira",2,"Nordeste",0,"280520",4,5,1,4,1,4,0,0,0,0,0,5,1,4,1,4,6,9.02901751631419,8.79890749208823,0.405211136205865,30
"4988","SE","Pinhão",6627,8341.66,28002,"Carira",2,"Nordeste",0,"280520",5,3,1,2,1,2,0,0,0,0,0,3,1,2,1,2,6,9.02901751631419,8.79890749208823,0.408442302359792,31
"4989","SE","Pirambu",9359,12001.52,28009,"Japaratuba",2,"Nordeste",0,"280530",2,13,6,7,5,8,0,0,0,0,0,13,6,7,5,8,6,9.39278858741526,9.14409372615726,0.278682524975292,29
"4990","SE","Pirambu",9359,12001.52,28009,"Japaratuba",2,"Nordeste",0,"280530",3,9,7,2,5,4,0,0,0,0,0,9,7,2,5,4,6,9.39278858741526,9.14409372615726,0.357879047179387,31
"4991","SE","Pirambu",9359,12001.52,28009,"Japaratuba",2,"Nordeste",0,"280530",4,12,4,8,8,4,0,0,0,0,0,12,4,8,8,4,4,9.39278858741526,9.14409372615726,0.403386813812757,30
"4992","SE","Pirambu",9359,12001.52,28009,"Japaratuba",2,"Nordeste",0,"280530",5,7,3,4,3,4,0,0,0,0,0,7,3,4,3,4,6,9.39278858741526,9.14409372615726,0.390582049968896,31
"4993","SE","Poço Redondo",35122,8613.54,28001,"Sergipana do Sertão do São Francisco",2,"Nordeste",0,"280540",2,32,17,15,16,16,0,0,0,0,0,32,17,15,16,16,10,9.06109066274863,10.4665829937358,0.281400044441633,29
"4994","SE","Poço Redondo",35122,8613.54,28001,"Sergipana do Sertão do São Francisco",2,"Nordeste",0,"280540",3,42,25,17,21,21,0,0,0,0,0,42,25,17,21,21,18,9.06109066274863,10.4665829937358,0.366909783373807,31
"4995","SE","Poço Redondo",35122,8613.54,28001,"Sergipana do Sertão do São Francisco",2,"Nordeste",0,"280540",4,44,22,22,22,22,1,1,0,1,0,45,23,22,23,22,12,9.06109066274863,10.4665829937358,0.383102369939594,30
"4996","SE","Poço Redondo",35122,8613.54,28001,"Sergipana do Sertão do São Francisco",2,"Nordeste",0,"280540",5,34,20,14,18,16,1,0,1,0,1,35,20,15,18,17,16,9.06109066274863,10.4665829937358,0.410461573851679,31
"4997","SE","Poço Verde",23867,10106.57,28005,"Tobias Barreto",2,"Nordeste",0,"280550",2,19,10,9,7,12,0,0,0,0,0,19,10,9,7,12,13,9.22094098639866,10.0802520306635,0.266808991421438,29
"4998","SE","Poço Verde",23867,10106.57,28005,"Tobias Barreto",2,"Nordeste",0,"280550",3,21,13,8,13,8,0,0,0,0,0,21,13,8,13,8,8,9.22094098639866,10.0802520306635,0.359397391285598,31
"4999","SE","Poço Verde",23867,10106.57,28005,"Tobias Barreto",2,"Nordeste",0,"280550",4,19,12,7,10,9,0,0,0,0,0,19,12,7,10,9,11,9.22094098639866,10.0802520306635,0.389112529100642,30
"5000","SE","Poço Verde",23867,10106.57,28005,"Tobias Barreto",2,"Nordeste",0,"280550",5,12,6,6,3,9,0,0,0,0,0,12,6,6,3,9,13,9.22094098639866,10.0802520306635,0.392983332689889,31
"5001","SE","Porto da Folha",28693,9178.86,28001,"Sergipana do Sertão do São Francisco",2,"Nordeste",0,"280560",2,33,13,20,11,22,0,0,0,0,0,33,13,20,11,22,18,9.12465829289665,10.2644084695597,0.273238214940113,29
"5002","SE","Porto da Folha",28693,9178.86,28001,"Sergipana do Sertão do São Francisco",2,"Nordeste",0,"280560",3,26,11,15,14,12,0,0,0,0,0,26,11,15,14,12,11,9.12465829289665,10.2644084695597,0.365839730108635,31
"5003","SE","Porto da Folha",28693,9178.86,28001,"Sergipana do Sertão do São Francisco",2,"Nordeste",0,"280560",4,24,10,14,6,18,2,2,0,0,2,26,12,14,6,20,10,9.12465829289665,10.2644084695597,0.378277273288338,30
"5004","SE","Porto da Folha",28693,9178.86,28001,"Sergipana do Sertão do São Francisco",2,"Nordeste",0,"280560",5,41,21,20,11,30,2,0,2,0,2,43,21,22,11,32,16,9.12465829289665,10.2644084695597,0.38492914084405,31
"5005","SE","Propriá",29692,17368.48,28007,"Propriá",2,"Nordeste",1,"280570",2,26,8,18,14,12,0,0,0,0,0,26,8,18,14,12,23,9.76241234820986,10.2986329282374,0.261332407322712,29
"5006","SE","Propriá",29692,17368.48,28007,"Propriá",2,"Nordeste",1,"280570",3,23,7,16,12,11,0,0,0,0,0,23,7,16,12,11,23,9.76241234820986,10.2986329282374,0.36293712811662,31
"5007","SE","Propriá",29692,17368.48,28007,"Propriá",2,"Nordeste",1,"280570",4,30,11,19,16,14,0,0,0,0,0,30,11,19,16,14,17,9.76241234820986,10.2986329282374,0.373306400450788,30
"5008","SE","Propriá",29692,17368.48,28007,"Propriá",2,"Nordeste",1,"280570",5,26,14,12,12,14,1,0,1,0,1,27,14,13,12,15,17,9.76241234820986,10.2986329282374,0.364722299423616,31
"5009","SE","Riachão do Dantas",19809,13472.86,28006,"Agreste de Lagarto",2,"Nordeste",0,"280580",2,26,13,13,12,14,0,0,0,0,0,26,13,13,12,14,10,9.50843257054918,9.89389165886268,0.304289005085946,29
"5010","SE","Riachão do Dantas",19809,13472.86,28006,"Agreste de Lagarto",2,"Nordeste",0,"280580",3,17,8,9,8,9,0,0,0,0,0,17,8,9,8,9,11,9.50843257054918,9.89389165886268,0.384720793795593,31
"5011","SE","Riachão do Dantas",19809,13472.86,28006,"Agreste de Lagarto",2,"Nordeste",0,"280580",4,17,12,5,5,12,0,0,0,0,0,17,12,5,5,12,8,9.50843257054918,9.89389165886268,0.413899917859528,30
"5012","SE","Riachão do Dantas",19809,13472.86,28006,"Agreste de Lagarto",2,"Nordeste",0,"280580",5,23,12,11,12,11,1,1,0,0,1,24,13,11,12,12,12,9.50843257054918,9.89389165886268,0.430028853982422,31
"5013","SE","Riachuelo",10284,16934.67,28010,"Baixo Cotinguiba",2,"Nordeste",1,"280590",2,7,1,6,2,5,0,0,0,0,0,7,1,6,2,5,4,9.73711827879098,9.23834456838578,0.323653420823375,29
"5014","SE","Riachuelo",10284,16934.67,28010,"Baixo Cotinguiba",2,"Nordeste",1,"280590",3,16,8,8,7,9,0,0,0,0,0,16,8,8,7,9,2,9.73711827879098,9.23834456838578,0.410713727039875,31
"5015","SE","Riachuelo",10284,16934.67,28010,"Baixo Cotinguiba",2,"Nordeste",1,"280590",4,10,2,8,7,3,0,0,0,0,0,10,2,8,7,3,8,9.73711827879098,9.23834456838578,0.435035658460098,30
"5016","SE","Riachuelo",10284,16934.67,28010,"Baixo Cotinguiba",2,"Nordeste",1,"280590",5,5,1,4,3,2,1,0,1,1,0,6,1,5,4,2,4,9.73711827879098,9.23834456838578,0.43086543382313,31
"5017","SE","Ribeirópolis",18773,16712.77,28002,"Carira",2,"Nordeste",0,"280600",2,12,7,5,6,6,0,0,0,0,0,12,7,5,6,6,11,9.72392837685187,9.84017494632436,0.277689570504456,29
"5018","SE","Ribeirópolis",18773,16712.77,28002,"Carira",2,"Nordeste",0,"280600",3,13,3,10,4,9,0,0,0,0,0,13,3,10,4,9,12,9.72392837685187,9.84017494632436,0.351249154671656,31
"5019","SE","Ribeirópolis",18773,16712.77,28002,"Carira",2,"Nordeste",0,"280600",4,10,6,4,3,7,1,1,0,1,0,11,7,4,4,7,6,9.72392837685187,9.84017494632436,0.374430216689589,30
"5020","SE","Ribeirópolis",18773,16712.77,28002,"Carira",2,"Nordeste",0,"280600",5,15,5,10,7,8,0,0,0,0,0,15,5,10,7,8,7,9.72392837685187,9.84017494632436,0.35870224139488,31
"5021","SE","Rosário do Catete",11008,36097.44,28010,"Baixo Cotinguiba",2,"Nordeste",1,"280610",2,7,2,5,2,5,0,0,0,0,0,7,2,5,2,5,5,10.493977227679,9.30637756017313,0.299794437828211,29
"5022","SE","Rosário do Catete",11008,36097.44,28010,"Baixo Cotinguiba",2,"Nordeste",1,"280610",3,10,5,5,5,5,0,0,0,0,0,10,5,5,5,5,8,10.493977227679,9.30637756017313,0.378720573227647,31
"5023","SE","Rosário do Catete",11008,36097.44,28010,"Baixo Cotinguiba",2,"Nordeste",1,"280610",4,15,9,6,7,8,0,0,0,0,0,15,9,6,7,8,3,10.493977227679,9.30637756017313,0.389832494281849,30
"5024","SE","Rosário do Catete",11008,36097.44,28010,"Baixo Cotinguiba",2,"Nordeste",1,"280610",5,17,7,10,12,5,1,1,0,0,1,18,8,10,12,6,2,10.493977227679,9.30637756017313,0.399365169187253,31
"5025","SE","Salgado",20025,8747.8,28012,"Boquim",2,"Nordeste",0,"280620",2,13,9,4,6,7,0,0,0,0,0,13,9,4,6,7,11,9.07655751916677,9.90473677193656,0.298578542264006,29
"5026","SE","Salgado",20025,8747.8,28012,"Boquim",2,"Nordeste",0,"280620",3,12,5,7,6,6,0,0,0,0,0,12,5,7,6,6,6,9.07655751916677,9.90473677193656,0.389815130579044,31
"5027","SE","Salgado",20025,8747.8,28012,"Boquim",2,"Nordeste",0,"280620",4,13,8,5,6,7,0,0,0,0,0,13,8,5,6,7,10,9.07655751916677,9.90473677193656,0.418797835870633,30
"5028","SE","Salgado",20025,8747.8,28012,"Boquim",2,"Nordeste",0,"280620",5,18,7,11,12,6,0,0,0,0,0,18,7,11,12,6,15,9.07655751916677,9.90473677193656,0.418652264991041,31
"5029","SE","Santa Luzia do Itanhy",14121,11359.84,28013,"Estância",2,"Nordeste",0,"280630",2,13,7,6,6,7,0,0,0,0,0,13,7,6,6,7,7,9.33783960766891,9.55541833006925,0.306876265833754,29
"5030","SE","Santa Luzia do Itanhy",14121,11359.84,28013,"Estância",2,"Nordeste",0,"280630",3,12,7,5,5,7,0,0,0,0,0,12,7,5,5,7,3,9.33783960766891,9.55541833006925,0.386126530659328,31
"5031","SE","Santa Luzia do Itanhy",14121,11359.84,28013,"Estância",2,"Nordeste",0,"280630",4,13,9,4,7,6,0,0,0,0,0,13,9,4,7,6,6,9.33783960766891,9.55541833006925,0.413281581480133,30
"5032","SE","Santa Luzia do Itanhy",14121,11359.84,28013,"Estância",2,"Nordeste",0,"280630",5,14,7,7,6,8,1,0,1,1,0,15,7,8,7,8,4,9.33783960766891,9.55541833006925,0.43264415391106,31
"5033","SE","Santana do São Francisco",7844,8917.56,28007,"Propriá",2,"Nordeste",0,"280640",2,10,5,5,5,5,0,0,0,0,0,10,5,5,5,5,0,9.09577764555356,8.96750418731624,0.295377991237261,29
"5034","SE","Santana do São Francisco",7844,8917.56,28007,"Propriá",2,"Nordeste",0,"280640",3,13,3,10,4,9,0,0,0,0,0,13,3,10,4,9,4,9.09577764555356,8.96750418731624,0.381711065307052,31
"5035","SE","Santana do São Francisco",7844,8917.56,28007,"Propriá",2,"Nordeste",0,"280640",4,8,1,7,2,6,1,1,0,0,1,9,2,7,2,7,2,9.09577764555356,8.96750418731624,0.406068993047352,30
"5036","SE","Santana do São Francisco",7844,8917.56,28007,"Propriá",2,"Nordeste",0,"280640",5,8,4,4,6,2,0,0,0,0,0,8,4,4,6,2,6,9.09577764555356,8.96750418731624,0.420567899263504,31
"5037","SE","Santa Rosa de Lima",3923,11111.81,28008,"Cotinguiba",2,"Nordeste",0,"280650",2,12,4,8,9,3,0,0,0,0,0,12,4,8,9,3,7,9.31576378565589,8.27461194620955,0.314812052937791,29
"5038","SE","Santa Rosa de Lima",3923,11111.81,28008,"Cotinguiba",2,"Nordeste",0,"280650",3,4,3,1,2,2,0,0,0,0,0,4,3,1,2,2,3,9.31576378565589,8.27461194620955,0.387521463606101,31
"5039","SE","Santa Rosa de Lima",3923,11111.81,28008,"Cotinguiba",2,"Nordeste",0,"280650",4,3,0,3,2,1,0,0,0,0,0,3,0,3,2,1,2,9.31576378565589,8.27461194620955,0.428221769663733,30
"5040","SE","Santa Rosa de Lima",3923,11111.81,28008,"Cotinguiba",2,"Nordeste",0,"280650",5,11,7,4,5,6,0,0,0,0,0,11,7,4,5,6,0,9.31576378565589,8.27461194620955,0.402339682514867,31
"5041","SE","Santo Amaro das Brotas",12151,10468.29,28010,"Baixo Cotinguiba",2,"Nordeste",0,"280660",2,14,1,13,10,4,0,0,0,0,0,14,1,13,10,4,11,9.25610596674357,9.40516674990861,0.302537463679786,29
"5042","SE","Santo Amaro das Brotas",12151,10468.29,28010,"Baixo Cotinguiba",2,"Nordeste",0,"280660",3,15,6,9,7,8,0,0,0,0,0,15,6,9,7,8,3,9.25610596674357,9.40516674990861,0.385883820209272,31
"5043","SE","Santo Amaro das Brotas",12151,10468.29,28010,"Baixo Cotinguiba",2,"Nordeste",0,"280660",4,9,5,4,7,2,0,0,0,0,0,9,5,4,7,2,10,9.25610596674357,9.40516674990861,0.404979605043843,30
"5044","SE","Santo Amaro das Brotas",12151,10468.29,28010,"Baixo Cotinguiba",2,"Nordeste",0,"280660",5,12,3,9,6,6,0,0,0,0,0,12,3,9,6,6,14,9.25610596674357,9.40516674990861,0.427320301063009,31
"5045","SE","São Cristóvão",91093,10061.71,28011,"Aracaju",2,"Nordeste",1,"280670",2,89,27,62,38,51,0,0,0,0,0,89,27,62,38,51,42,9.21649240932803,11.419636241657,0.27158799734808,29
"5046","SE","São Cristóvão",91093,10061.71,28011,"Aracaju",2,"Nordeste",1,"280670",3,76,29,47,28,48,1,1,0,0,1,77,30,47,28,49,38,9.21649240932803,11.419636241657,0.379649116698847,31
"5047","SE","São Cristóvão",91093,10061.71,28011,"Aracaju",2,"Nordeste",1,"280670",4,90,32,58,28,62,3,0,3,0,3,93,32,61,28,65,39,9.21649240932803,11.419636241657,0.426857835973563,30
"5048","SE","São Cristóvão",91093,10061.71,28011,"Aracaju",2,"Nordeste",1,"280670",5,85,34,51,30,55,4,3,1,1,3,89,37,52,31,58,51,9.21649240932803,11.419636241657,0.41749525879807,31
"5049","SE","São Domingos",11207,9244.47,28004,"Agreste de Itabaiana",2,"Nordeste",0,"280680",2,6,2,4,3,3,0,0,0,0,0,6,2,4,3,3,4,9.13178081389234,9.32429386205203,0.280630660202426,29
"5050","SE","São Domingos",11207,9244.47,28004,"Agreste de Itabaiana",2,"Nordeste",0,"280680",3,7,3,4,1,6,2,1,1,2,0,9,4,5,3,6,5,9.13178081389234,9.32429386205203,0.364605467969716,31
"5051","SE","São Domingos",11207,9244.47,28004,"Agreste de Itabaiana",2,"Nordeste",0,"280680",4,11,6,5,7,4,0,0,0,0,0,11,6,5,7,4,6,9.13178081389234,9.32429386205203,0.384238053235679,30
"5052","SE","São Domingos",11207,9244.47,28004,"Agreste de Itabaiana",2,"Nordeste",0,"280680",5,14,10,4,8,6,0,0,0,0,0,14,10,4,8,6,8,9.13178081389234,9.32429386205203,0.382046385442367,31
"5053","SE","São Francisco",3781,10031.79,28009,"Japaratuba",2,"Nordeste",0,"280690",2,5,2,3,4,1,0,0,0,0,0,5,2,3,4,1,2,9.21351432963925,8.23774380389093,0.286332506687347,29
"5054","SE","São Francisco",3781,10031.79,28009,"Japaratuba",2,"Nordeste",0,"280690",3,4,1,3,2,2,0,0,0,0,0,4,1,3,2,2,1,9.21351432963925,8.23774380389093,0.37616253194809,31
"5055","SE","São Francisco",3781,10031.79,28009,"Japaratuba",2,"Nordeste",0,"280690",4,6,1,5,2,4,0,0,0,0,0,6,1,5,2,4,2,9.21351432963925,8.23774380389093,0.384327427127148,30
"5056","SE","São Francisco",3781,10031.79,28009,"Japaratuba",2,"Nordeste",0,"280690",5,1,0,1,1,0,0,0,0,0,0,1,0,1,1,0,1,9.21351432963925,8.23774380389093,0.402059536921062,31
"5057","SE","Simão Dias",40606,13014.14,28005,"Tobias Barreto",2,"Nordeste",0,"280710",2,43,20,23,13,30,2,1,1,1,1,45,21,24,14,31,17,9.47379173764268,10.6116711179222,0.291358704775457,29
"5058","SE","Simão Dias",40606,13014.14,28005,"Tobias Barreto",2,"Nordeste",0,"280710",3,37,19,18,20,17,1,0,1,1,0,38,19,19,21,17,29,9.47379173764268,10.6116711179222,0.376238637103854,31
"5059","SE","Simão Dias",40606,13014.14,28005,"Tobias Barreto",2,"Nordeste",0,"280710",4,45,19,26,22,23,1,1,0,1,0,46,20,26,23,23,25,9.47379173764268,10.6116711179222,0.410610101747856,30
"5060","SE","Simão Dias",40606,13014.14,28005,"Tobias Barreto",2,"Nordeste",0,"280710",5,47,24,23,19,28,0,0,0,0,0,47,24,23,19,28,27,9.47379173764268,10.6116711179222,0.411588655993443,31
"5061","SE","Siriri",8970,16159.95,28008,"Cotinguiba",2,"Nordeste",1,"280720",2,7,3,4,3,4,0,0,0,0,0,7,3,4,3,4,4,9.69029123801089,9.10164095505284,0.285164388909406,29
"5062","SE","Siriri",8970,16159.95,28008,"Cotinguiba",2,"Nordeste",1,"280720",3,14,9,5,10,4,0,0,0,0,0,14,9,5,10,4,5,9.69029123801089,9.10164095505284,0.389189505072349,31
"5063","SE","Siriri",8970,16159.95,28008,"Cotinguiba",2,"Nordeste",1,"280720",4,4,2,2,1,3,0,0,0,0,0,4,2,2,1,3,3,9.69029123801089,9.10164095505284,0.424803864450588,30
"5064","SE","Siriri",8970,16159.95,28008,"Cotinguiba",2,"Nordeste",1,"280720",5,12,8,4,5,7,0,0,0,0,0,12,8,4,5,7,2,9.69029123801089,9.10164095505284,0.424618016195148,31
"5065","SE","Telha",3249,9854.68,28007,"Propriá",2,"Nordeste",0,"280730",2,1,0,1,1,0,0,0,0,0,0,1,0,1,1,0,1,9.19570174823264,8.0861025356691,0.252423127258914,29
"5066","SE","Telha",3249,9854.68,28007,"Propriá",2,"Nordeste",0,"280730",3,2,0,2,2,0,0,0,0,0,0,2,0,2,2,0,1,9.19570174823264,8.0861025356691,0.343209500078577,31
"5067","SE","Telha",3249,9854.68,28007,"Propriá",2,"Nordeste",0,"280730",4,5,3,2,3,2,0,0,0,0,0,5,3,2,3,2,2,9.19570174823264,8.0861025356691,0.328428368974259,30
"5068","SE","Telha",3249,9854.68,28007,"Propriá",2,"Nordeste",0,"280730",5,4,1,3,2,2,0,0,0,0,0,4,1,3,2,2,3,9.19570174823264,8.0861025356691,0.327322603494413,31
"5069","SE","Tobias Barreto",52530,10753.11,28005,"Tobias Barreto",2,"Nordeste",1,"280740",2,47,24,23,12,35,1,1,0,0,1,48,25,23,12,36,30,9.28295029404154,10.869139713948,0.264271257271138,29
"5070","SE","Tobias Barreto",52530,10753.11,28005,"Tobias Barreto",2,"Nordeste",1,"280740",3,48,29,19,21,27,1,1,0,0,1,49,30,19,21,28,28,9.28295029404154,10.869139713948,0.361646672723044,31
"5071","SE","Tobias Barreto",52530,10753.11,28005,"Tobias Barreto",2,"Nordeste",1,"280740",4,55,28,27,28,27,0,0,0,0,0,55,28,27,28,27,23,9.28295029404154,10.869139713948,0.374101579532855,30
"5072","SE","Tobias Barreto",52530,10753.11,28005,"Tobias Barreto",2,"Nordeste",1,"280740",5,53,35,18,16,37,0,0,0,0,0,53,35,18,16,37,33,9.28295029404154,10.869139713948,0.377550474290722,31
"5073","SE","Tomar do Geru",13535,9325.03,28012,"Boquim",2,"Nordeste",0,"280750",2,9,0,9,4,5,0,0,0,0,0,9,0,9,4,5,7,9.14045746166502,9.5130342020484,0.292602751129942,29
"5074","SE","Tomar do Geru",13535,9325.03,28012,"Boquim",2,"Nordeste",0,"280750",3,15,6,9,7,8,0,0,0,0,0,15,6,9,7,8,8,9.14045746166502,9.5130342020484,0.377912571710588,31
"5075","SE","Tomar do Geru",13535,9325.03,28012,"Boquim",2,"Nordeste",0,"280750",4,11,2,9,8,3,0,0,0,0,0,11,2,9,8,3,7,9.14045746166502,9.5130342020484,0.405630007944438,30
"5076","SE","Tomar do Geru",13535,9325.03,28012,"Boquim",2,"Nordeste",0,"280750",5,12,7,5,2,10,0,0,0,0,0,12,7,5,2,10,7,9.14045746166502,9.5130342020484,0.38685629799178,31
"5077","SE","Umbaúba",25550,13652.61,28012,"Boquim",2,"Nordeste",0,"280760",2,19,8,11,7,12,1,1,0,1,0,20,9,11,8,12,16,9.52168599112624,10.1483925956319,0.266215995364496,29
"5078","SE","Umbaúba",25550,13652.61,28012,"Boquim",2,"Nordeste",0,"280760",3,35,20,15,17,18,0,0,0,0,0,35,20,15,17,18,16,9.52168599112624,10.1483925956319,0.345199458178796,31
"5079","SE","Umbaúba",25550,13652.61,28012,"Boquim",2,"Nordeste",0,"280760",4,18,8,10,7,11,2,2,0,2,0,20,10,10,9,11,18,9.52168599112624,10.1483925956319,0.369625060449735,30
"5080","SE","Umbaúba",25550,13652.61,28012,"Boquim",2,"Nordeste",0,"280760",5,25,14,11,10,15,1,1,0,0,1,26,15,11,10,16,17,9.52168599112624,10.1483925956319,0.373519606445582,31
"5081","BA","Abaré",20347,6957.04,29005,"Paulo Afonso",2,"Nordeste",0,"290020",2,28,12,16,11,17,0,0,0,0,0,28,12,16,11,17,4,8.84750937551183,9.9206887598559,0.282770750893344,29
"5082","BA","Abaré",20347,6957.04,29005,"Paulo Afonso",2,"Nordeste",0,"290020",3,27,12,15,13,14,1,0,1,1,0,28,12,16,14,14,8,8.84750937551183,9.9206887598559,0.353238928901119,31
"5083","BA","Abaré",20347,6957.04,29005,"Paulo Afonso",2,"Nordeste",0,"290020",4,23,7,16,13,10,1,0,1,0,1,24,7,17,13,11,12,8.84750937551183,9.9206887598559,0.382640355856339,30
"5084","BA","Abaré",20347,6957.04,29005,"Paulo Afonso",2,"Nordeste",0,"290020",5,21,7,14,10,11,0,0,0,0,0,21,7,14,10,11,7,8.84750937551183,9.9206887598559,0.390448395418797,31
"5085","BA","Acajutiba",15187,8850.48,29017,"Alagoinhas",2,"Nordeste",0,"290030",2,10,7,3,6,4,0,0,0,0,0,10,7,3,6,4,9,9.08822697381932,9.62819507773027,0.289172782777983,29
"5086","BA","Acajutiba",15187,8850.48,29017,"Alagoinhas",2,"Nordeste",0,"290030",3,11,6,5,4,7,0,0,0,0,0,11,6,5,4,7,11,9.08822697381932,9.62819507773027,0.390620679136454,31
"5087","BA","Acajutiba",15187,8850.48,29017,"Alagoinhas",2,"Nordeste",0,"290030",4,16,10,6,8,8,0,0,0,0,0,16,10,6,8,8,7,9.08822697381932,9.62819507773027,0.414961265220542,30
"5088","BA","Acajutiba",15187,8850.48,29017,"Alagoinhas",2,"Nordeste",0,"290030",5,11,3,8,5,6,0,0,0,0,0,11,3,8,5,6,13,9.08822697381932,9.62819507773027,0.412843120378385,31
"5089","BA","Adustina",17126,6686.58,29015,"Ribeira do Pombal",2,"Nordeste",0,"290035",2,12,5,7,5,7,0,0,0,0,0,12,5,7,5,7,9,8.80785781164717,9.74835305558614,0.281095860126433,29
"5090","BA","Adustina",17126,6686.58,29015,"Ribeira do Pombal",2,"Nordeste",0,"290035",3,9,7,2,6,3,0,0,0,0,0,9,7,2,6,3,5,8.80785781164717,9.74835305558614,0.362502416481807,31
"5091","BA","Adustina",17126,6686.58,29015,"Ribeira do Pombal",2,"Nordeste",0,"290035",4,6,3,3,1,5,0,0,0,0,0,6,3,3,1,5,7,8.80785781164717,9.74835305558614,0.403829652700035,30
"5092","BA","Adustina",17126,6686.58,29015,"Ribeira do Pombal",2,"Nordeste",0,"290035",5,10,6,4,3,7,0,0,0,0,0,10,6,4,3,7,5,8.80785781164717,9.74835305558614,0.400821288856323,31
"5093","BA","Água Fria",17033,6524.47,29012,"Feira de Santana",2,"Nordeste",0,"290040",2,8,3,5,4,4,0,0,0,0,0,8,3,5,4,4,6,8.78331500283824,9.74290791786058,0.29404623096192,29
"5094","BA","Água Fria",17033,6524.47,29012,"Feira de Santana",2,"Nordeste",0,"290040",3,7,3,4,3,4,0,0,0,0,0,7,3,4,3,4,12,8.78331500283824,9.74290791786058,0.366776878954618,31
"5095","BA","Água Fria",17033,6524.47,29012,"Feira de Santana",2,"Nordeste",0,"290040",4,8,5,3,4,4,0,0,0,0,0,8,5,3,4,4,7,8.78331500283824,9.74290791786058,0.418971169707791,30
"5096","BA","Água Fria",17033,6524.47,29012,"Feira de Santana",2,"Nordeste",0,"290040",5,9,3,6,4,5,0,0,0,0,0,9,3,6,4,5,10,8.78331500283824,9.74290791786058,0.424813458333679,31
"5097","BA","Érico Cardoso",10560,5933.22,29025,"Livramento do Brumado",2,"Nordeste",0,"290050",2,10,3,7,4,6,0,0,0,0,0,10,3,7,4,6,6,8.68832234630604,9.26482855726025,0.329106180092527,29
"5098","BA","Érico Cardoso",10560,5933.22,29025,"Livramento do Brumado",2,"Nordeste",0,"290050",3,8,3,5,2,6,0,0,0,0,0,8,3,5,2,6,9,8.68832234630604,9.26482855726025,0.394956672702664,31
"5099","BA","Érico Cardoso",10560,5933.22,29025,"Livramento do Brumado",2,"Nordeste",0,"290050",4,7,1,6,3,4,0,0,0,0,0,7,1,6,3,4,6,8.68832234630604,9.26482855726025,0.419196742264894,30
"5100","BA","Érico Cardoso",10560,5933.22,29025,"Livramento do Brumado",2,"Nordeste",0,"290050",5,8,2,6,2,6,0,0,0,0,0,8,2,6,2,6,8,8.68832234630604,9.26482855726025,0.403198658846317,31
"5101","BA","Alagoinhas",152327,26272.95,29017,"Alagoinhas",2,"Nordeste",1,"290070",2,141,47,94,60,81,0,0,0,0,0,141,47,94,60,81,81,10.1762951717689,11.9337848048516,0.279628562002534,29
"5102","BA","Alagoinhas",152327,26272.95,29017,"Alagoinhas",2,"Nordeste",1,"290070",3,134,41,93,57,77,2,2,0,0,2,136,43,93,57,79,96,10.1762951717689,11.9337848048516,0.370892929450375,31
"5103","BA","Alagoinhas",152327,26272.95,29017,"Alagoinhas",2,"Nordeste",1,"290070",4,127,45,82,47,80,0,0,0,0,0,127,45,82,47,80,86,10.1762951717689,11.9337848048516,0.421237088039177,30
"5104","BA","Alagoinhas",152327,26272.95,29017,"Alagoinhas",2,"Nordeste",1,"290070",5,136,46,90,47,89,5,3,2,1,4,141,49,92,48,93,100,10.1762951717689,11.9337848048516,0.41229416696562,31
"5105","BA","Alcobaça",22490,11365.43,29032,"Porto Seguro",2,"Nordeste",0,"290080",2,29,15,14,9,20,0,0,0,0,0,29,15,14,9,20,16,9.33833157103065,10.0208260449534,0.269134239952492,29
"5106","BA","Alcobaça",22490,11365.43,29032,"Porto Seguro",2,"Nordeste",0,"290080",3,22,11,11,12,10,0,0,0,0,0,22,11,11,12,10,16,9.33833157103065,10.0208260449534,0.384206155159936,31
"5107","BA","Alcobaça",22490,11365.43,29032,"Porto Seguro",2,"Nordeste",0,"290080",4,26,13,13,11,15,0,0,0,0,0,26,13,13,11,15,11,9.33833157103065,10.0208260449534,0.404992118250051,30
"5108","BA","Alcobaça",22490,11365.43,29032,"Porto Seguro",2,"Nordeste",0,"290080",5,29,9,20,17,12,0,0,0,0,0,29,9,20,17,12,8,9.33833157103065,10.0208260449534,0.385632354481313,31
"5109","BA","Almadina",5366,9017.12,29031,"Ilhéus-Itabuna",2,"Nordeste",0,"290090",2,5,3,2,2,3,0,0,0,0,0,5,3,2,2,3,4,9.10688027160698,8.58783803098557,0.327965920032008,29
"5110","BA","Almadina",5366,9017.12,29031,"Ilhéus-Itabuna",2,"Nordeste",0,"290090",3,4,2,2,2,2,0,0,0,0,0,4,2,2,2,2,11,9.10688027160698,8.58783803098557,0.407560207645624,31
"5111","BA","Almadina",5366,9017.12,29031,"Ilhéus-Itabuna",2,"Nordeste",0,"290090",4,3,3,0,1,2,0,0,0,0,0,3,3,0,1,2,5,9.10688027160698,8.58783803098557,0.438971271746994,30
"5112","BA","Almadina",5366,9017.12,29031,"Ilhéus-Itabuna",2,"Nordeste",0,"290090",5,3,3,0,1,2,0,0,0,0,0,3,3,0,1,2,6,9.10688027160698,8.58783803098557,0.438421728336683,31
"5113","BA","Amargosa",37441,10143.31,29024,"Jequié",2,"Nordeste",0,"290100",2,29,10,19,12,17,0,0,0,0,0,29,10,19,12,17,23,9.22456965385878,10.5305216396365,0.266995260467901,29
"5114","BA","Amargosa",37441,10143.31,29024,"Jequié",2,"Nordeste",0,"290100",3,29,6,23,14,15,1,1,0,1,0,30,7,23,15,15,23,9.22456965385878,10.5305216396365,0.36925045638212,31
"5115","BA","Amargosa",37441,10143.31,29024,"Jequié",2,"Nordeste",0,"290100",4,28,6,22,11,17,0,0,0,0,0,28,6,22,11,17,23,9.22456965385878,10.5305216396365,0.393951642849554,30
"5116","BA","Amargosa",37441,10143.31,29024,"Jequié",2,"Nordeste",0,"290100",5,35,12,23,13,22,0,0,0,0,0,35,12,23,13,22,23,9.22456965385878,10.5305216396365,0.412047924180264,31
"5117","BA","Amélia Rodrigues",25048,12394.4,29019,"Catu",2,"Nordeste",0,"290110",2,12,5,7,6,6,0,0,0,0,0,12,5,7,6,6,17,9.42500003668208,10.1285492630062,0.284914445071807,29
"5118","BA","Amélia Rodrigues",25048,12394.4,29019,"Catu",2,"Nordeste",0,"290110",3,14,5,9,3,11,0,0,0,0,0,14,5,9,3,11,15,9.42500003668208,10.1285492630062,0.386579264497431,31
"5119","BA","Amélia Rodrigues",25048,12394.4,29019,"Catu",2,"Nordeste",0,"290110",4,6,1,5,2,4,1,0,1,0,1,7,1,6,2,5,9,9.42500003668208,10.1285492630062,0.437894394483639,30
"5120","BA","Amélia Rodrigues",25048,12394.4,29019,"Catu",2,"Nordeste",0,"290110",5,19,4,15,5,14,0,0,0,0,0,19,4,15,5,14,16,9.42500003668208,10.1285492630062,0.412265000545681,31
"5121","BA","América Dourada",16090,7163.75,29009,"Irecê",2,"Nordeste",0,"290115",2,15,6,9,7,8,0,0,0,0,0,15,6,9,7,8,7,8.87678886586595,9.68595323998643,0.292189087810263,29
"5122","BA","América Dourada",16090,7163.75,29009,"Irecê",2,"Nordeste",0,"290115",3,13,4,9,7,6,1,0,1,1,0,14,4,10,8,6,5,8.87678886586595,9.68595323998643,0.37545255680193,31
"5123","BA","América Dourada",16090,7163.75,29009,"Irecê",2,"Nordeste",0,"290115",4,18,10,8,12,6,0,0,0,0,0,18,10,8,12,6,6,8.87678886586595,9.68595323998643,0.396939862347971,30
"5124","BA","América Dourada",16090,7163.75,29009,"Irecê",2,"Nordeste",0,"290115",5,18,3,15,10,8,0,0,0,0,0,18,3,15,10,8,14,8.87678886586595,9.68595323998643,0.391161383220341,31
"5125","BA","Anagé",21607,9341.52,29028,"Vitória da Conquista",2,"Nordeste",0,"290120",2,13,5,8,5,8,2,2,0,0,2,15,7,8,5,10,12,9.14222425888138,9.98077261524567,0.265989782874312,29
"5126","BA","Anagé",21607,9341.52,29028,"Vitória da Conquista",2,"Nordeste",0,"290120",3,16,6,10,6,10,0,0,0,0,0,16,6,10,6,10,11,9.14222425888138,9.98077261524567,0.348455822944293,31
"5127","BA","Anagé",21607,9341.52,29028,"Vitória da Conquista",2,"Nordeste",0,"290120",4,15,5,10,4,11,0,0,0,0,0,15,5,10,4,11,10,9.14222425888138,9.98077261524567,0.369785188374752,30
"5128","BA","Anagé",21607,9341.52,29028,"Vitória da Conquista",2,"Nordeste",0,"290120",5,19,11,8,7,12,0,0,0,0,0,19,11,8,7,12,12,9.14222425888138,9.98077261524567,0.398497438577418,31
"5129","BA","Andaraí",13132,7909.7,29023,"Seabra",2,"Nordeste",0,"290130",2,15,6,9,8,7,0,0,0,0,0,15,6,9,8,7,4,8.97584513336737,9.48280727862148,0.278036667047063,29
"5130","BA","Andaraí",13132,7909.7,29023,"Seabra",2,"Nordeste",0,"290130",3,10,4,6,5,5,1,1,0,0,1,11,5,6,5,6,14,8.97584513336737,9.48280727862148,0.347714350210402,31
"5131","BA","Andaraí",13132,7909.7,29023,"Seabra",2,"Nordeste",0,"290130",4,9,2,7,4,5,0,0,0,0,0,9,2,7,4,5,2,8.97584513336737,9.48280727862148,0.40554219744072,30
"5132","BA","Andaraí",13132,7909.7,29023,"Seabra",2,"Nordeste",0,"290130",5,10,3,7,4,6,0,0,0,0,0,10,3,7,4,6,7,8.97584513336737,9.48280727862148,0.412816868646019,31
"5133","BA","Andorinha",14503,13040.84,29008,"Senhor do Bonfim",2,"Nordeste",0,"290135",2,12,3,9,5,7,0,0,0,0,0,12,3,9,5,7,7,9.47584125058386,9.58211080356025,0.292739754219512,29
"5134","BA","Andorinha",14503,13040.84,29008,"Senhor do Bonfim",2,"Nordeste",0,"290135",3,22,4,18,10,12,0,0,0,0,0,22,4,18,10,12,7,9.47584125058386,9.58211080356025,0.389131345403789,31
"5135","BA","Andorinha",14503,13040.84,29008,"Senhor do Bonfim",2,"Nordeste",0,"290135",4,20,5,15,9,11,1,1,0,0,1,21,6,15,9,12,5,9.47584125058386,9.58211080356025,0.410297363043452,30
"5136","BA","Andorinha",14503,13040.84,29008,"Senhor do Bonfim",2,"Nordeste",0,"290135",5,19,11,8,3,16,0,0,0,0,0,19,11,8,3,16,7,9.47584125058386,9.58211080356025,0.409511231369041,31
"5137","BA","Angical",13938,9607.87,29002,"Cotegipe",2,"Nordeste",0,"290140",2,13,4,9,7,6,0,0,0,0,0,13,4,9,7,6,5,9.17033783327694,9.54237420199846,0.291108803110752,29
"5138","BA","Angical",13938,9607.87,29002,"Cotegipe",2,"Nordeste",0,"290140",3,15,5,10,7,8,0,0,0,0,0,15,5,10,7,8,7,9.17033783327694,9.54237420199846,0.360077649325818,31
"5139","BA","Angical",13938,9607.87,29002,"Cotegipe",2,"Nordeste",0,"290140",4,15,3,12,8,7,0,0,0,0,0,15,3,12,8,7,6,9.17033783327694,9.54237420199846,0.375401927663719,30
"5140","BA","Angical",13938,9607.87,29002,"Cotegipe",2,"Nordeste",0,"290140",5,14,4,10,6,8,1,0,1,1,0,15,4,11,7,8,5,9.17033783327694,9.54237420199846,0.408128544833164,31
"5141","BA","Anguera",11297,6672.76,29012,"Feira de Santana",2,"Nordeste",0,"290150",2,4,1,3,1,3,0,0,0,0,0,4,1,3,1,3,7,8.80578884642436,9.33229248272693,0.240108852328303,29
"5142","BA","Anguera",11297,6672.76,29012,"Feira de Santana",2,"Nordeste",0,"290150",3,3,0,3,1,2,0,0,0,0,0,3,0,3,1,2,1,8.80578884642436,9.33229248272693,0.33719577279016,31
"5143","BA","Anguera",11297,6672.76,29012,"Feira de Santana",2,"Nordeste",0,"290150",4,1,0,1,0,1,0,0,0,0,0,1,0,1,0,1,6,8.80578884642436,9.33229248272693,0.409400850385838,30
"5144","BA","Anguera",11297,6672.76,29012,"Feira de Santana",2,"Nordeste",0,"290150",5,4,0,4,1,3,0,0,0,0,0,4,0,4,1,3,5,8.80578884642436,9.33229248272693,0.430061895780899,31
"5145","BA","Antas",19479,6128.05,29015,"Ribeira do Pombal",2,"Nordeste",0,"290160",2,5,1,4,1,4,0,0,0,0,0,5,1,4,1,4,11,8.72063187065607,9.8770922411766,0.278387130629598,29
"5146","BA","Antas",19479,6128.05,29015,"Ribeira do Pombal",2,"Nordeste",0,"290160",3,9,3,6,4,5,0,0,0,0,0,9,3,6,4,5,10,8.72063187065607,9.8770922411766,0.361904328489003,31
"5147","BA","Antas",19479,6128.05,29015,"Ribeira do Pombal",2,"Nordeste",0,"290160",4,10,3,7,8,2,0,0,0,0,0,10,3,7,8,2,7,8.72063187065607,9.8770922411766,0.400898498634093,30
"5148","BA","Antas",19479,6128.05,29015,"Ribeira do Pombal",2,"Nordeste",0,"290160",5,12,5,7,5,7,0,0,0,0,0,12,5,7,5,7,5,8.72063187065607,9.8770922411766,0.368319874443007,31
"5149","BA","Antônio Cardoso",11677,9395.63,29012,"Feira de Santana",2,"Nordeste",0,"290170",2,8,7,1,2,6,0,0,0,0,0,8,7,1,2,6,3,9.14799996654453,9.36537637407572,0.276534815032484,29
"5150","BA","Antônio Cardoso",11677,9395.63,29012,"Feira de Santana",2,"Nordeste",0,"290170",3,13,4,9,7,6,0,0,0,0,0,13,4,9,7,6,8,9.14799996654453,9.36537637407572,0.346589309023374,31
"5151","BA","Antônio Cardoso",11677,9395.63,29012,"Feira de Santana",2,"Nordeste",0,"290170",4,10,5,5,4,6,0,0,0,0,0,10,5,5,4,6,4,9.14799996654453,9.36537637407572,0.370532118145952,30
"5152","BA","Antônio Cardoso",11677,9395.63,29012,"Feira de Santana",2,"Nordeste",0,"290170",5,4,2,2,3,1,1,0,1,1,0,5,2,3,4,1,6,9.14799996654453,9.36537637407572,0.401165114310295,31
"5153","BA","Antônio Gonçalves",11878,5916.84,29008,"Senhor do Bonfim",2,"Nordeste",0,"290180",2,13,5,8,4,9,0,0,0,0,0,13,5,8,4,9,8,8.68555780158099,9.38244322857581,0.279208485981154,29
"5154","BA","Antônio Gonçalves",11878,5916.84,29008,"Senhor do Bonfim",2,"Nordeste",0,"290180",3,11,2,9,5,6,0,0,0,0,0,11,2,9,5,6,3,8.68555780158099,9.38244322857581,0.352738894128603,31
"5155","BA","Antônio Gonçalves",11878,5916.84,29008,"Senhor do Bonfim",2,"Nordeste",0,"290180",4,8,2,6,6,2,0,0,0,0,0,8,2,6,6,2,5,8.68555780158099,9.38244322857581,0.419985046544706,30
"5156","BA","Antônio Gonçalves",11878,5916.84,29008,"Senhor do Bonfim",2,"Nordeste",0,"290180",5,11,4,7,8,3,0,0,0,0,0,11,4,7,8,3,13,8.68555780158099,9.38244322857581,0.410012820759279,31
"5157","BA","Aporá",17788,7112.08,29017,"Alagoinhas",2,"Nordeste",0,"290190",2,6,2,4,3,3,0,0,0,0,0,6,2,4,3,3,7,8.8695500257244,9.78627935163059,0.286875135349958,29
"5158","BA","Aporá",17788,7112.08,29017,"Alagoinhas",2,"Nordeste",0,"290190",3,15,6,9,6,9,0,0,0,0,0,15,6,9,6,9,12,8.8695500257244,9.78627935163059,0.378310262225562,31
"5159","BA","Aporá",17788,7112.08,29017,"Alagoinhas",2,"Nordeste",0,"290190",4,16,11,5,7,9,0,0,0,0,0,16,11,5,7,9,19,8.8695500257244,9.78627935163059,0.41380528803045,30
"5160","BA","Aporá",17788,7112.08,29017,"Alagoinhas",2,"Nordeste",0,"290190",5,7,3,4,0,7,0,0,0,0,0,7,3,4,0,7,16,8.8695500257244,9.78627935163059,0.406729425505926,31
"5161","BA","Apuarema",7302,9079.59,29024,"Jequié",2,"Nordeste",0,"290195",2,8,2,6,2,6,0,0,0,0,0,8,2,6,2,6,6,9.11378431639084,8.89590356221558,0.274372387960659,29
"5162","BA","Apuarema",7302,9079.59,29024,"Jequié",2,"Nordeste",0,"290195",3,14,5,9,1,13,0,0,0,0,0,14,5,9,1,13,0,9.11378431639084,8.89590356221558,0.388471114866347,31
"5163","BA","Apuarema",7302,9079.59,29024,"Jequié",2,"Nordeste",0,"290195",4,5,0,5,2,3,1,0,1,1,0,6,0,6,3,3,2,9.11378431639084,8.89590356221558,0.419827930537022,30
"5164","BA","Apuarema",7302,9079.59,29024,"Jequié",2,"Nordeste",0,"290195",5,12,7,5,4,8,0,0,0,0,0,12,7,5,4,8,3,9.11378431639084,8.89590356221558,0.402787828957925,31
"5165","BA","Aracatu",13045,8289.5,29027,"Brumado",2,"Nordeste",0,"290200",2,9,3,6,2,7,1,0,1,0,1,10,3,7,2,8,12,9.02274493267952,9.47616019757083,0.30350764451996,29
"5166","BA","Aracatu",13045,8289.5,29027,"Brumado",2,"Nordeste",0,"290200",3,11,4,7,2,9,0,0,0,0,0,11,4,7,2,9,11,9.02274493267952,9.47616019757083,0.385915227981646,31
"5167","BA","Aracatu",13045,8289.5,29027,"Brumado",2,"Nordeste",0,"290200",4,8,1,7,1,7,0,0,0,0,0,8,1,7,1,7,7,9.02274493267952,9.47616019757083,0.383519925901297,30
"5168","BA","Aracatu",13045,8289.5,29027,"Brumado",2,"Nordeste",0,"290200",5,13,4,9,7,6,0,0,0,0,0,13,4,9,7,6,9,9.02274493267952,9.47616019757083,0.397279744062798,31
"5169","BA","Araçás",12208,17243.95,29017,"Alagoinhas",2,"Nordeste",0,"290205",2,7,2,5,4,3,0,0,0,0,0,7,2,5,4,3,5,9.75521663630355,9.40984675352424,0.286917609306679,29
"5170","BA","Araçás",12208,17243.95,29017,"Alagoinhas",2,"Nordeste",0,"290205",3,9,3,6,4,5,0,0,0,0,0,9,3,6,4,5,6,9.75521663630355,9.40984675352424,0.366011747494627,31
"5171","BA","Araçás",12208,17243.95,29017,"Alagoinhas",2,"Nordeste",0,"290205",4,8,2,6,1,7,0,0,0,0,0,8,2,6,1,7,7,9.75521663630355,9.40984675352424,0.400320342237842,30
"5172","BA","Araçás",12208,17243.95,29017,"Alagoinhas",2,"Nordeste",0,"290205",5,10,4,6,4,6,0,0,0,0,0,10,4,6,4,6,5,9.75521663630355,9.40984675352424,0.444627309259291,31
"5173","BA","Araci",54648,7858.26,29016,"Serrinha",2,"Nordeste",0,"290210",2,42,19,23,25,17,0,0,0,0,0,42,19,23,25,17,23,8.9693204868706,10.9086678964117,0.277208625922936,29
"5174","BA","Araci",54648,7858.26,29016,"Serrinha",2,"Nordeste",0,"290210",3,35,20,15,15,20,2,2,0,2,0,37,22,15,17,20,18,8.9693204868706,10.9086678964117,0.350956620036931,31
"5175","BA","Araci",54648,7858.26,29016,"Serrinha",2,"Nordeste",0,"290210",4,50,25,25,29,21,1,1,0,1,0,51,26,25,30,21,22,8.9693204868706,10.9086678964117,0.396442117743108,30
"5176","BA","Araci",54648,7858.26,29016,"Serrinha",2,"Nordeste",0,"290210",5,49,33,16,25,24,0,0,0,0,0,49,33,16,25,24,23,8.9693204868706,10.9086678964117,0.385739442484866,31
"5177","BA","Aramari",11461,8079.63,29017,"Alagoinhas",2,"Nordeste",0,"290220",2,7,4,3,4,3,0,0,0,0,0,7,4,3,4,3,6,8.99710135838744,9.3467052464967,0.27408750154004,29
"5178","BA","Aramari",11461,8079.63,29017,"Alagoinhas",2,"Nordeste",0,"290220",3,5,3,2,2,3,0,0,0,0,0,5,3,2,2,3,6,8.99710135838744,9.3467052464967,0.353174137716968,31
"5179","BA","Aramari",11461,8079.63,29017,"Alagoinhas",2,"Nordeste",0,"290220",4,12,4,8,6,6,0,0,0,0,0,12,4,8,6,6,9,8.99710135838744,9.3467052464967,0.381284681966214,30
"5180","BA","Aramari",11461,8079.63,29017,"Alagoinhas",2,"Nordeste",0,"290220",5,9,2,7,3,6,0,0,0,0,0,9,2,7,3,6,4,8.99710135838744,9.3467052464967,0.391840218835872,31
"5181","BA","Arataca",10961,7368.2,29031,"Ilhéus-Itabuna",2,"Nordeste",0,"290225",2,12,2,10,9,3,1,1,0,1,0,13,3,10,10,3,5,8.90492872197499,9.30209879721572,0.326409424605316,29
"5182","BA","Arataca",10961,7368.2,29031,"Ilhéus-Itabuna",2,"Nordeste",0,"290225",3,16,8,8,8,8,0,0,0,0,0,16,8,8,8,8,8,8.90492872197499,9.30209879721572,0.432130237850687,31
"5183","BA","Arataca",10961,7368.2,29031,"Ilhéus-Itabuna",2,"Nordeste",0,"290225",4,8,2,6,4,4,0,0,0,0,0,8,2,6,4,4,10,8.90492872197499,9.30209879721572,0.443446573080932,30
"5184","BA","Arataca",10961,7368.2,29031,"Ilhéus-Itabuna",2,"Nordeste",0,"290225",5,9,5,4,6,3,0,0,0,0,0,9,5,4,6,3,11,8.90492872197499,9.30209879721572,0.441775213729224,31
"5185","BA","Aratuípe",8837,7495.88,29020,"Santo Antônio de Jesus",2,"Nordeste",0,"290230",2,8,4,4,4,4,0,0,0,0,0,8,4,4,4,4,6,8.92210881525223,9.086702731518,0.306637181863589,29
"5186","BA","Aratuípe",8837,7495.88,29020,"Santo Antônio de Jesus",2,"Nordeste",0,"290230",3,5,3,2,5,0,0,0,0,0,0,5,3,2,5,0,2,8.92210881525223,9.086702731518,0.408807640026289,31
"5187","BA","Aratuípe",8837,7495.88,29020,"Santo Antônio de Jesus",2,"Nordeste",0,"290230",4,17,9,8,2,15,0,0,0,0,0,17,9,8,2,15,7,8.92210881525223,9.086702731518,0.454462457935095,30
"5188","BA","Aratuípe",8837,7495.88,29020,"Santo Antônio de Jesus",2,"Nordeste",0,"290230",5,12,5,7,5,7,2,1,1,0,2,14,6,8,5,9,4,8.92210881525223,9.086702731518,0.398989024628809,31
"5189","BA","Aurelino Leal",11299,9065.39,29031,"Ilhéus-Itabuna",2,"Nordeste",0,"290240",2,14,3,11,5,9,0,0,0,0,0,14,3,11,5,9,2,9.11221914487796,9.33246950520925,0.294112168889526,29
"5190","BA","Aurelino Leal",11299,9065.39,29031,"Ilhéus-Itabuna",2,"Nordeste",0,"290240",3,15,10,5,10,5,0,0,0,0,0,15,10,5,10,5,7,9.11221914487796,9.33246950520925,0.38963388568356,31
"5191","BA","Aurelino Leal",11299,9065.39,29031,"Ilhéus-Itabuna",2,"Nordeste",0,"290240",4,12,5,7,5,7,0,0,0,0,0,12,5,7,5,7,15,9.11221914487796,9.33246950520925,0.420386300996575,30
"5192","BA","Aurelino Leal",11299,9065.39,29031,"Ilhéus-Itabuna",2,"Nordeste",0,"290240",5,11,7,4,9,2,0,0,0,0,0,11,7,4,9,2,4,9.11221914487796,9.33246950520925,0.42697872345204,31
"5193","BA","Baianópolis",13929,12394.24,29001,"Barreiras",2,"Nordeste",0,"290250",2,7,1,6,4,3,0,0,0,0,0,7,1,6,4,3,5,9.42498712754306,9.54172827668803,0.29866165342792,29
"5194","BA","Baianópolis",13929,12394.24,29001,"Barreiras",2,"Nordeste",0,"290250",3,7,1,6,1,6,0,0,0,0,0,7,1,6,1,6,9,9.42498712754306,9.54172827668803,0.373857599356035,31
"5195","BA","Baianópolis",13929,12394.24,29001,"Barreiras",2,"Nordeste",0,"290250",4,7,3,4,5,2,0,0,0,0,0,7,3,4,5,2,6,9.42498712754306,9.54172827668803,0.398432981562531,30
"5196","BA","Baianópolis",13929,12394.24,29001,"Barreiras",2,"Nordeste",0,"290250",5,8,4,4,5,3,1,0,1,1,0,9,4,5,6,3,7,9.42498712754306,9.54172827668803,0.440844286481086,31
"5197","BA","Baixa Grande",20449,7778.36,29011,"Itaberaba",2,"Nordeste",0,"290260",2,8,5,3,2,6,0,0,0,0,0,8,5,3,2,6,12,8.95910079803648,9.92568926051981,0.260890156560299,29
"5198","BA","Baixa Grande",20449,7778.36,29011,"Itaberaba",2,"Nordeste",0,"290260",3,4,1,3,2,2,0,0,0,0,0,4,1,3,2,2,7,8.95910079803648,9.92568926051981,0.34719060643312,31
"5199","BA","Baixa Grande",20449,7778.36,29011,"Itaberaba",2,"Nordeste",0,"290260",4,18,3,15,8,10,0,0,0,0,0,18,3,15,8,10,13,8.95910079803648,9.92568926051981,0.390894614168912,30
"5200","BA","Baixa Grande",20449,7778.36,29011,"Itaberaba",2,"Nordeste",0,"290260",5,9,4,5,5,4,1,1,0,1,0,10,5,5,6,4,13,8.95910079803648,9.92568926051981,0.381751221353631,31
"5201","BA","Banzaê",13240,7308.28,29015,"Ribeira do Pombal",2,"Nordeste",0,"290265",2,12,3,9,5,7,0,0,0,0,0,12,3,9,5,7,7,8.89676323094017,9.490997829491,0.288351618291111,29
"5202","BA","Banzaê",13240,7308.28,29015,"Ribeira do Pombal",2,"Nordeste",0,"290265",3,12,5,7,5,7,0,0,0,0,0,12,5,7,5,7,9,8.89676323094017,9.490997829491,0.362203976963962,31
"5203","BA","Banzaê",13240,7308.28,29015,"Ribeira do Pombal",2,"Nordeste",0,"290265",4,12,5,7,6,6,0,0,0,0,0,12,5,7,6,6,6,8.89676323094017,9.490997829491,0.431399869972718,30
"5204","BA","Banzaê",13240,7308.28,29015,"Ribeira do Pombal",2,"Nordeste",0,"290265",5,15,4,11,8,7,0,0,0,0,0,15,4,11,8,7,5,8.89676323094017,9.490997829491,0.414430157249905,31
"5205","BA","Barra",53910,6869.12,29006,"Barra",2,"Nordeste",0,"290270",2,66,34,32,31,35,2,0,2,0,2,68,34,34,31,37,13,8.83479128385311,10.8950712684457,0.251197896625369,29
"5206","BA","Barra",53910,6869.12,29006,"Barra",2,"Nordeste",0,"290270",3,66,22,44,34,32,2,1,1,1,1,68,23,45,35,33,29,8.83479128385311,10.8950712684457,0.321261477492929,31
"5207","BA","Barra",53910,6869.12,29006,"Barra",2,"Nordeste",0,"290270",4,57,17,40,25,32,1,1,0,1,0,58,18,40,26,32,21,8.83479128385311,10.8950712684457,0.365170813860583,30
"5208","BA","Barra",53910,6869.12,29006,"Barra",2,"Nordeste",0,"290270",5,85,27,58,48,37,3,1,2,2,1,88,28,60,50,38,35,8.83479128385311,10.8950712684457,0.356577340305651,31
"5209","BA","Barra da Estiva",20392,12265.58,29023,"Seabra",2,"Nordeste",0,"290280",2,31,14,17,15,16,0,0,0,0,0,31,14,17,15,16,6,9.41455224460833,9.92289794605595,0.271330420310974,29
"5210","BA","Barra da Estiva",20392,12265.58,29023,"Seabra",2,"Nordeste",0,"290280",3,26,9,17,11,15,1,1,0,1,0,27,10,17,12,15,9,9.41455224460833,9.92289794605595,0.341089597266211,31
"5211","BA","Barra da Estiva",20392,12265.58,29023,"Seabra",2,"Nordeste",0,"290280",4,26,12,14,8,18,1,0,1,1,0,27,12,15,9,18,5,9.41455224460833,9.92289794605595,0.366088809257799,30
"5212","BA","Barra da Estiva",20392,12265.58,29023,"Seabra",2,"Nordeste",0,"290280",5,36,11,25,14,22,0,0,0,0,0,36,11,25,14,22,5,9.41455224460833,9.92289794605595,0.359884078650628,31
"5213","BA","Barra do Choça",31209,12464.99,29028,"Vitória da Conquista",2,"Nordeste",0,"290290",2,36,18,18,14,22,1,0,1,0,1,37,18,19,14,23,20,9.43067919371105,10.348461793739,0.280532011244198,29
"5214","BA","Barra do Choça",31209,12464.99,29028,"Vitória da Conquista",2,"Nordeste",0,"290290",3,38,17,21,13,25,1,1,0,1,0,39,18,21,14,25,22,9.43067919371105,10.348461793739,0.357754773590119,31
"5215","BA","Barra do Choça",31209,12464.99,29028,"Vitória da Conquista",2,"Nordeste",0,"290290",4,33,16,17,9,24,1,0,1,1,0,34,16,18,10,24,20,9.43067919371105,10.348461793739,0.38725064464579,30
"5216","BA","Barra do Choça",31209,12464.99,29028,"Vitória da Conquista",2,"Nordeste",0,"290290",5,40,25,15,18,22,0,0,0,0,0,40,25,15,18,22,15,9.43067919371105,10.348461793739,0.374236606860987,31
"5217","BA","Barra do Mendes",13833,6808.47,29009,"Irecê",2,"Nordeste",0,"290300",2,9,2,7,2,7,1,0,1,1,0,10,2,8,3,7,9,8.82592270429804,9.53481232087482,0.31548784341891,29
"5218","BA","Barra do Mendes",13833,6808.47,29009,"Irecê",2,"Nordeste",0,"290300",3,13,4,9,8,5,0,0,0,0,0,13,4,9,8,5,15,8.82592270429804,9.53481232087482,0.412387340262425,31
"5219","BA","Barra do Mendes",13833,6808.47,29009,"Irecê",2,"Nordeste",0,"290300",4,10,4,6,5,5,0,0,0,0,0,10,4,6,5,5,8,8.82592270429804,9.53481232087482,0.455167559915669,30
"5220","BA","Barra do Mendes",13833,6808.47,29009,"Irecê",2,"Nordeste",0,"290300",5,7,0,7,3,4,0,0,0,0,0,7,0,7,3,4,9,8.82592270429804,9.53481232087482,0.412917140513432,31
"5221","BA","Barreiras",156975,30842.2,29001,"Barreiras",2,"Nordeste",1,"290320",2,191,29,162,65,126,2,1,1,0,2,193,30,163,65,128,61,10.3366391610603,11.9638418359823,0.271337065239451,29
"5222","BA","Barreiras",156975,30842.2,29001,"Barreiras",2,"Nordeste",1,"290320",3,178,33,145,60,118,3,1,2,1,2,181,34,147,61,120,61,10.3366391610603,11.9638418359823,0.363845409978472,31
"5223","BA","Barreiras",156975,30842.2,29001,"Barreiras",2,"Nordeste",1,"290320",4,190,48,142,77,113,3,1,2,0,3,193,49,144,77,116,71,10.3366391610603,11.9638418359823,0.376443039368194,30
"5224","BA","Barreiras",156975,30842.2,29001,"Barreiras",2,"Nordeste",1,"290320",5,223,57,166,95,128,2,0,2,0,2,225,57,168,95,130,60,10.3366391610603,11.9638418359823,0.368330557799399,31
"5225","BA","Barro Alto",15054,6203.97,29009,"Irecê",2,"Nordeste",0,"290323",2,11,5,6,3,8,0,0,0,0,0,11,5,6,3,8,12,8.7329446886948,9.61939901559448,0.320339275953402,29
"5226","BA","Barro Alto",15054,6203.97,29009,"Irecê",2,"Nordeste",0,"290323",3,10,3,7,4,6,0,0,0,0,0,10,3,7,4,6,10,8.7329446886948,9.61939901559448,0.397819972718056,31
"5227","BA","Barro Alto",15054,6203.97,29009,"Irecê",2,"Nordeste",0,"290323",4,8,1,7,6,2,0,0,0,0,0,8,1,7,6,2,8,8.7329446886948,9.61939901559448,0.411588577580778,30
"5228","BA","Barro Alto",15054,6203.97,29009,"Irecê",2,"Nordeste",0,"290323",5,13,4,9,4,9,0,0,0,0,0,13,4,9,4,9,7,8.7329446886948,9.61939901559448,0.40291971016788,31
"5229","BA","Barrocas",16105,15110.2,29016,"Serrinha",2,"Nordeste",0,"290327",2,9,3,6,3,6,0,0,0,0,0,9,3,6,3,6,5,9.62312529144656,9.6868850617653,0.273427564076692,29
"5230","BA","Barrocas",16105,15110.2,29016,"Serrinha",2,"Nordeste",0,"290327",3,17,5,12,4,13,0,0,0,0,0,17,5,12,4,13,8,9.62312529144656,9.6868850617653,0.379615545443846,31
"5231","BA","Barrocas",16105,15110.2,29016,"Serrinha",2,"Nordeste",0,"290327",4,14,5,9,8,6,0,0,0,0,0,14,5,9,8,6,7,9.62312529144656,9.6868850617653,0.391476094126374,30
"5232","BA","Barrocas",16105,15110.2,29016,"Serrinha",2,"Nordeste",0,"290327",5,8,3,5,7,1,0,0,0,0,0,8,3,5,7,1,9,9.62312529144656,9.6868850617653,0.393287222389001,31
"5233","BA","Belmonte",23437,12442.31,29031,"Ilhéus-Itabuna",2,"Nordeste",0,"290340",2,30,14,16,18,12,0,0,0,0,0,30,14,16,18,12,13,9.428858040373,10.0620712491519,0.2808771339048,29
"5234","BA","Belmonte",23437,12442.31,29031,"Ilhéus-Itabuna",2,"Nordeste",0,"290340",3,25,11,14,14,11,1,0,1,1,0,26,11,15,15,11,11,9.428858040373,10.0620712491519,0.368746671796556,31
"5235","BA","Belmonte",23437,12442.31,29031,"Ilhéus-Itabuna",2,"Nordeste",0,"290340",4,20,7,13,7,13,0,0,0,0,0,20,7,13,7,13,5,9.428858040373,10.0620712491519,0.387416709429656,30
"5236","BA","Belmonte",23437,12442.31,29031,"Ilhéus-Itabuna",2,"Nordeste",0,"290340",5,19,8,11,14,5,1,1,0,1,0,20,9,11,15,5,20,9.428858040373,10.0620712491519,0.385868745978875,31
"5237","BA","Belo Campo",17109,7538.82,29028,"Vitória da Conquista",2,"Nordeste",0,"290350",2,18,4,14,5,13,0,0,0,0,0,18,4,14,5,13,9,8.92782095008107,9.74735991982465,0.268728864299136,29
"5238","BA","Belo Campo",17109,7538.82,29028,"Vitória da Conquista",2,"Nordeste",0,"290350",3,14,6,8,7,7,0,0,0,0,0,14,6,8,7,7,9,8.92782095008107,9.74735991982465,0.351555706386967,31
"5239","BA","Belo Campo",17109,7538.82,29028,"Vitória da Conquista",2,"Nordeste",0,"290350",4,16,8,8,7,9,0,0,0,0,0,16,8,8,7,9,7,8.92782095008107,9.74735991982465,0.369270759928929,30
"5240","BA","Belo Campo",17109,7538.82,29028,"Vitória da Conquista",2,"Nordeste",0,"290350",5,23,12,11,9,14,0,0,0,0,0,23,12,11,9,14,7,8.92782095008107,9.74735991982465,0.397518343814636,31
"5241","BA","Biritinga",15984,7607.76,29016,"Serrinha",2,"Nordeste",0,"290360",2,8,1,7,4,4,0,0,0,0,0,8,1,7,4,4,13,8.93692405798632,9.67934350088833,0.270527965136217,29
"5242","BA","Biritinga",15984,7607.76,29016,"Serrinha",2,"Nordeste",0,"290360",3,13,5,8,3,10,1,1,0,0,1,14,6,8,3,11,7,8.93692405798632,9.67934350088833,0.366437334671048,31
"5243","BA","Biritinga",15984,7607.76,29016,"Serrinha",2,"Nordeste",0,"290360",4,13,8,5,3,10,0,0,0,0,0,13,8,5,3,10,8,8.93692405798632,9.67934350088833,0.376010611036099,30
"5244","BA","Biritinga",15984,7607.76,29016,"Serrinha",2,"Nordeste",0,"290360",5,12,5,7,2,10,0,0,0,0,0,12,5,7,2,10,14,8.93692405798632,9.67934350088833,0.398656507484461,31
"5245","BA","Boa Nova",12329,7159.43,29028,"Vitória da Conquista",2,"Nordeste",0,"290370",2,10,4,6,7,3,1,0,1,0,1,11,4,7,7,4,11,8.87618564784718,9.41970948986855,0.30122737953827,29
"5246","BA","Boa Nova",12329,7159.43,29028,"Vitória da Conquista",2,"Nordeste",0,"290370",3,15,2,13,7,8,1,1,0,1,0,16,3,13,8,8,8,8.87618564784718,9.41970948986855,0.38331539306912,31
"5247","BA","Boa Nova",12329,7159.43,29028,"Vitória da Conquista",2,"Nordeste",0,"290370",4,11,4,7,3,8,0,0,0,0,0,11,4,7,3,8,5,8.87618564784718,9.41970948986855,0.41873210209895,30
"5248","BA","Boa Nova",12329,7159.43,29028,"Vitória da Conquista",2,"Nordeste",0,"290370",5,12,4,8,7,5,0,0,0,0,0,12,4,8,7,5,7,8.87618564784718,9.41970948986855,0.391857643261383,31
"5249","BA","Boa Vista do Tupim",18531,6535.89,29011,"Itaberaba",2,"Nordeste",0,"290380",2,22,9,13,7,15,0,0,0,0,0,22,9,13,7,15,10,8.78506380653285,9.82720028436401,0.301318015408711,29
"5250","BA","Boa Vista do Tupim",18531,6535.89,29011,"Itaberaba",2,"Nordeste",0,"290380",3,14,5,9,4,10,0,0,0,0,0,14,5,9,4,10,9,8.78506380653285,9.82720028436401,0.364023684735235,31
"5251","BA","Boa Vista do Tupim",18531,6535.89,29011,"Itaberaba",2,"Nordeste",0,"290380",4,16,3,13,5,11,0,0,0,0,0,16,3,13,5,11,14,8.78506380653285,9.82720028436401,0.399282930666918,30
"5252","BA","Boa Vista do Tupim",18531,6535.89,29011,"Itaberaba",2,"Nordeste",0,"290380",5,11,5,6,6,5,0,0,0,0,0,11,5,6,6,5,10,8.78506380653285,9.82720028436401,0.405279220978067,31
"5253","BA","Bom Jesus da Lapa",69662,14722.75,29007,"Bom Jesus da Lapa",2,"Nordeste",1,"290390",2,74,14,60,36,38,1,1,0,1,0,75,15,60,37,38,23,9.59714919548624,11.1514102543893,0.281459839280477,29
"5254","BA","Bom Jesus da Lapa",69662,14722.75,29007,"Bom Jesus da Lapa",2,"Nordeste",1,"290390",3,60,15,45,32,28,2,1,1,0,2,62,16,46,32,30,36,9.59714919548624,11.1514102543893,0.364629963841676,31
"5255","BA","Bom Jesus da Lapa",69662,14722.75,29007,"Bom Jesus da Lapa",2,"Nordeste",1,"290390",4,57,15,42,24,33,1,0,1,0,1,58,15,43,24,34,28,9.59714919548624,11.1514102543893,0.382248938245469,30
"5256","BA","Bom Jesus da Lapa",69662,14722.75,29007,"Bom Jesus da Lapa",2,"Nordeste",1,"290390",5,63,11,52,24,39,1,1,0,0,1,64,12,52,24,40,45,9.59714919548624,11.1514102543893,0.391036686643544,31
"5257","BA","Boninal",14446,6762.67,29023,"Seabra",2,"Nordeste",0,"290400",2,23,5,18,13,10,0,0,0,0,0,23,5,18,13,10,7,8.81917306147093,9.57817283861079,0.294298854487659,29
"5258","BA","Boninal",14446,6762.67,29023,"Seabra",2,"Nordeste",0,"290400",3,8,0,8,1,7,0,0,0,0,0,8,0,8,1,7,13,8.81917306147093,9.57817283861079,0.382089846214449,31
"5259","BA","Boninal",14446,6762.67,29023,"Seabra",2,"Nordeste",0,"290400",4,2,0,2,2,0,0,0,0,0,0,2,0,2,2,0,8,8.81917306147093,9.57817283861079,0.423281722115779,30
"5260","BA","Boninal",14446,6762.67,29023,"Seabra",2,"Nordeste",0,"290400",5,3,1,2,2,1,0,0,0,0,0,3,1,2,2,1,8,8.81917306147093,9.57817283861079,0.406689049140647,31
"5261","BA","Bonito",16884,9927.66,29023,"Seabra",2,"Nordeste",0,"290405",2,21,9,12,9,12,0,0,0,0,0,21,9,12,9,12,6,9.20308007972267,9.73412170690239,0.281606602709132,29
"5262","BA","Bonito",16884,9927.66,29023,"Seabra",2,"Nordeste",0,"290405",3,18,5,13,9,9,0,0,0,0,0,18,5,13,9,9,3,9.20308007972267,9.73412170690239,0.365041279277475,31
"5263","BA","Bonito",16884,9927.66,29023,"Seabra",2,"Nordeste",0,"290405",4,17,6,11,12,5,0,0,0,0,0,17,6,11,12,5,7,9.20308007972267,9.73412170690239,0.381961760190573,30
"5264","BA","Bonito",16884,9927.66,29023,"Seabra",2,"Nordeste",0,"290405",5,19,11,8,9,10,1,1,0,1,0,20,12,8,10,10,4,9.20308007972267,9.73412170690239,0.375547745715553,31
"5265","BA","Boquira",21497,6955.07,29022,"Boquira",2,"Nordeste",0,"290410",2,13,1,12,4,9,0,0,0,0,0,13,1,12,4,9,11,8.84722616900855,9.97566866949614,0.259379608193099,29
"5266","BA","Boquira",21497,6955.07,29022,"Boquira",2,"Nordeste",0,"290410",3,18,4,14,6,12,0,0,0,0,0,18,4,14,6,12,11,8.84722616900855,9.97566866949614,0.312677735146168,31
"5267","BA","Boquira",21497,6955.07,29022,"Boquira",2,"Nordeste",0,"290410",4,16,4,12,6,10,0,0,0,0,0,16,4,12,6,10,14,8.84722616900855,9.97566866949614,0.349513105501302,30
"5268","BA","Boquira",21497,6955.07,29022,"Boquira",2,"Nordeste",0,"290410",5,19,3,16,4,15,0,0,0,0,0,19,3,16,4,15,16,8.84722616900855,9.97566866949614,0.413214926992466,31
"5269","BA","Botuporã",10129,8804.57,29022,"Boquira",2,"Nordeste",0,"290420",2,9,3,6,6,3,0,0,0,0,0,9,3,6,6,3,2,9.0830261838491,9.2231578756868,0.271827358775654,29
"5270","BA","Botuporã",10129,8804.57,29022,"Boquira",2,"Nordeste",0,"290420",3,6,0,6,2,4,0,0,0,0,0,6,0,6,2,4,8,9.0830261838491,9.2231578756868,0.361365935248563,31
"5271","BA","Botuporã",10129,8804.57,29022,"Boquira",2,"Nordeste",0,"290420",4,10,1,9,3,7,0,0,0,0,0,10,1,9,3,7,1,9.0830261838491,9.2231578756868,0.411701045586107,30
"5272","BA","Botuporã",10129,8804.57,29022,"Boquira",2,"Nordeste",0,"290420",5,10,2,8,3,7,0,0,0,0,0,10,2,8,3,7,8,9.0830261838491,9.2231578756868,0.387350459186567,31
"5273","BA","Brejões",14222,8389.63,29024,"Jequié",2,"Nordeste",0,"290430",2,10,1,9,5,5,0,0,0,0,0,10,1,9,5,5,7,9.03475169836962,9.56254534044346,0.271222134661711,29
"5274","BA","Brejões",14222,8389.63,29024,"Jequié",2,"Nordeste",0,"290430",3,7,4,3,4,3,0,0,0,0,0,7,4,3,4,3,9,9.03475169836962,9.56254534044346,0.349509122586163,31
"5275","BA","Brejões",14222,8389.63,29024,"Jequié",2,"Nordeste",0,"290430",4,17,5,12,8,9,0,0,0,0,0,17,5,12,8,9,9,9.03475169836962,9.56254534044346,0.350100976879332,30
"5276","BA","Brejões",14222,8389.63,29024,"Jequié",2,"Nordeste",0,"290430",5,18,3,15,7,11,1,1,0,0,1,19,4,15,7,12,4,9.03475169836962,9.56254534044346,0.384639374681924,31
"5277","BA","Brotas de Macaúbas",10130,7774.65,29022,"Boquira",2,"Nordeste",0,"290450",2,14,7,7,3,11,1,0,1,0,1,15,7,8,3,12,9,8.95862371995701,9.22325659724273,0.274993822298944,29
"5278","BA","Brotas de Macaúbas",10130,7774.65,29022,"Boquira",2,"Nordeste",0,"290450",3,10,5,5,3,7,0,0,0,0,0,10,5,5,3,7,9,8.95862371995701,9.22325659724273,0.355115109588407,31
"5279","BA","Brotas de Macaúbas",10130,7774.65,29022,"Boquira",2,"Nordeste",0,"290450",4,12,5,7,6,6,0,0,0,0,0,12,5,7,6,6,9,8.95862371995701,9.22325659724273,0.390320242103129,30
"5280","BA","Brotas de Macaúbas",10130,7774.65,29022,"Boquira",2,"Nordeste",0,"290450",5,8,3,5,3,5,0,0,0,0,0,8,3,5,3,5,4,8.95862371995701,9.22325659724273,0.415946461055026,31
"5281","BA","Brumado",67335,26374.82,29027,"Brumado",2,"Nordeste",1,"290460",2,59,15,44,20,39,0,0,0,0,0,59,15,44,20,39,31,10.1801650461105,11.1174354398841,0.277342200314637,29
"5282","BA","Brumado",67335,26374.82,29027,"Brumado",2,"Nordeste",1,"290460",3,52,9,43,19,33,0,0,0,0,0,52,9,43,19,33,37,10.1801650461105,11.1174354398841,0.362871784752265,31
"5283","BA","Brumado",67335,26374.82,29027,"Brumado",2,"Nordeste",1,"290460",4,55,10,45,20,35,2,0,2,2,0,57,10,47,22,35,39,10.1801650461105,11.1174354398841,0.40426883216651,30
"5284","BA","Brumado",67335,26374.82,29027,"Brumado",2,"Nordeste",1,"290460",5,86,25,61,26,60,3,0,3,3,0,89,25,64,29,60,40,10.1801650461105,11.1174354398841,0.360524144965493,31
"5285","BA","Buerarema",18306,10451.86,29031,"Ilhéus-Itabuna",2,"Nordeste",0,"290470",2,19,9,10,6,13,0,0,0,0,0,19,9,10,6,13,5,9.25453523198516,9.81498415394472,0.295729513826377,29
"5286","BA","Buerarema",18306,10451.86,29031,"Ilhéus-Itabuna",2,"Nordeste",0,"290470",3,18,10,8,8,10,1,1,0,1,0,19,11,8,9,10,14,9.25453523198516,9.81498415394472,0.380232659061112,31
"5287","BA","Buerarema",18306,10451.86,29031,"Ilhéus-Itabuna",2,"Nordeste",0,"290470",4,16,6,10,8,8,1,0,1,0,1,17,6,11,8,9,15,9.25453523198516,9.81498415394472,0.403677005233127,30
"5288","BA","Buerarema",18306,10451.86,29031,"Ilhéus-Itabuna",2,"Nordeste",0,"290470",5,26,13,13,11,15,0,0,0,0,0,26,13,13,11,15,18,9.25453523198516,9.81498415394472,0.414732160245445,31
"5289","BA","Buritirama",21276,6088.01,29006,"Barra",2,"Nordeste",0,"290475",2,21,6,15,9,12,1,1,0,0,1,22,7,15,9,13,6,8.71407654211573,9.96533495586221,0.256807994810763,29
"5290","BA","Buritirama",21276,6088.01,29006,"Barra",2,"Nordeste",0,"290475",3,22,7,15,9,13,0,0,0,0,0,22,7,15,9,13,13,8.71407654211573,9.96533495586221,0.341527799372364,31
"5291","BA","Buritirama",21276,6088.01,29006,"Barra",2,"Nordeste",0,"290475",4,24,11,13,10,14,0,0,0,0,0,24,11,13,10,14,9,8.71407654211573,9.96533495586221,0.384836459039732,30
"5292","BA","Buritirama",21276,6088.01,29006,"Barra",2,"Nordeste",0,"290475",5,29,12,17,16,13,0,0,0,0,0,29,12,17,16,13,8,8.71407654211573,9.96533495586221,0.397830221463928,31
"5293","BA","Caatiba",6488,9258.96,29028,"Vitória da Conquista",2,"Nordeste",0,"290480",2,1,0,1,0,1,0,0,0,0,0,1,0,1,0,1,2,9.13334701031775,8.77770959579525,0.324627720331428,29
"5294","BA","Caatiba",6488,9258.96,29028,"Vitória da Conquista",2,"Nordeste",0,"290480",3,5,3,2,2,3,0,0,0,0,0,5,3,2,2,3,1,9.13334701031775,8.77770959579525,0.397068760236426,31
"5295","BA","Caatiba",6488,9258.96,29028,"Vitória da Conquista",2,"Nordeste",0,"290480",4,4,1,3,1,3,0,0,0,0,0,4,1,3,1,3,3,9.13334701031775,8.77770959579525,0.408201876862388,30
"5296","BA","Caatiba",6488,9258.96,29028,"Vitória da Conquista",2,"Nordeste",0,"290480",5,2,1,1,1,1,1,1,0,0,1,3,2,1,1,2,4,9.13334701031775,8.77770959579525,0.408107774661812,31
"5297","BA","Cabaceiras do Paraguaçu",18911,6327.48,29020,"Santo Antônio de Jesus",2,"Nordeste",0,"290485",2,7,3,4,3,4,0,0,0,0,0,7,3,4,3,4,11,8.75265733160828,9.84749904232727,0.288922281591302,29
"5298","BA","Cabaceiras do Paraguaçu",18911,6327.48,29020,"Santo Antônio de Jesus",2,"Nordeste",0,"290485",3,21,5,16,9,12,0,0,0,0,0,21,5,16,9,12,7,8.75265733160828,9.84749904232727,0.374862086102893,31
"5299","BA","Cabaceiras do Paraguaçu",18911,6327.48,29020,"Santo Antônio de Jesus",2,"Nordeste",0,"290485",4,18,4,14,12,6,1,0,1,0,1,19,4,15,12,7,4,8.75265733160828,9.84749904232727,0.419834670932475,30
"5300","BA","Cabaceiras do Paraguaçu",18911,6327.48,29020,"Santo Antônio de Jesus",2,"Nordeste",0,"290485",5,17,6,11,10,7,0,0,0,0,0,17,6,11,10,7,9,8.75265733160828,9.84749904232727,0.433818886321308,31
"5301","BA","Cachoeira",33567,13985.81,29020,"Santo Antônio de Jesus",2,"Nordeste",1,"290490",2,23,7,16,7,16,0,0,0,0,0,23,7,16,7,16,17,9.54579852315795,10.4212987204758,0.313537425302667,29
"5302","BA","Cachoeira",33567,13985.81,29020,"Santo Antônio de Jesus",2,"Nordeste",1,"290490",3,25,8,17,13,12,1,0,1,0,1,26,8,18,13,13,15,9.54579852315795,10.4212987204758,0.418889147265727,31
"5303","BA","Cachoeira",33567,13985.81,29020,"Santo Antônio de Jesus",2,"Nordeste",1,"290490",4,21,6,15,8,13,0,0,0,0,0,21,6,15,8,13,19,9.54579852315795,10.4212987204758,0.482154976611625,30
"5304","BA","Cachoeira",33567,13985.81,29020,"Santo Antônio de Jesus",2,"Nordeste",1,"290490",5,24,3,21,15,9,1,0,1,0,1,25,3,22,15,10,16,9.54579852315795,10.4212987204758,0.462184589497555,31
"5305","BA","Caculé",23291,11872.73,29026,"Guanambi",2,"Nordeste",0,"290500",2,12,3,9,6,6,0,0,0,0,0,12,3,9,6,6,8,9.38199945273511,10.0558222988394,0.261832360590223,29
"5306","BA","Caculé",23291,11872.73,29026,"Guanambi",2,"Nordeste",0,"290500",3,24,8,16,6,18,1,0,1,0,1,25,8,17,6,19,18,9.38199945273511,10.0558222988394,0.346455610626445,31
"5307","BA","Caculé",23291,11872.73,29026,"Guanambi",2,"Nordeste",0,"290500",4,15,1,14,7,8,0,0,0,0,0,15,1,14,7,8,12,9.38199945273511,10.0558222988394,0.346941626700517,30
"5308","BA","Caculé",23291,11872.73,29026,"Guanambi",2,"Nordeste",0,"290500",5,21,5,16,10,11,0,0,0,0,0,21,5,16,10,11,17,9.38199945273511,10.0558222988394,0.341878059466551,31
"5309","BA","Caém",9058,7887.38,29010,"Jacobina",2,"Nordeste",0,"290510",2,12,3,9,6,6,0,0,0,0,0,12,3,9,6,6,5,8.97301929278762,9.11140362411616,0.312868011023861,29
"5310","BA","Caém",9058,7887.38,29010,"Jacobina",2,"Nordeste",0,"290510",3,6,3,3,5,1,0,0,0,0,0,6,3,3,5,1,4,8.97301929278762,9.11140362411616,0.405626451026344,31
"5311","BA","Caém",9058,7887.38,29010,"Jacobina",2,"Nordeste",0,"290510",4,8,3,5,4,4,0,0,0,0,0,8,3,5,4,4,0,8.97301929278762,9.11140362411616,0.420886407165435,30
"5312","BA","Caém",9058,7887.38,29010,"Jacobina",2,"Nordeste",0,"290510",5,8,3,5,6,2,0,0,0,0,0,8,3,5,6,2,10,8.97301929278762,9.11140362411616,0.452385992728575,31
"5313","BA","Caetanos",14608,5601.55,29028,"Vitória da Conquista",2,"Nordeste",0,"290515",2,10,1,9,4,6,0,0,0,0,0,10,1,9,4,6,3,8.63079862413943,9.58932460283475,0.331785652854209,29
"5314","BA","Caetanos",14608,5601.55,29028,"Vitória da Conquista",2,"Nordeste",0,"290515",3,9,3,6,5,4,1,0,1,1,0,10,3,7,6,4,8,8.63079862413943,9.58932460283475,0.446599056767317,31
"5315","BA","Caetanos",14608,5601.55,29028,"Vitória da Conquista",2,"Nordeste",0,"290515",4,11,2,9,5,6,0,0,0,0,0,11,2,9,5,6,4,8.63079862413943,9.58932460283475,0.458341504320327,30
"5316","BA","Caetanos",14608,5601.55,29028,"Vitória da Conquista",2,"Nordeste",0,"290515",5,6,1,5,2,4,1,1,0,0,1,7,2,5,2,5,7,8.63079862413943,9.58932460283475,0.439476406311661,31
"5317","BA","Caetité",51081,16855.69,29026,"Guanambi",2,"Nordeste",0,"290520",2,42,11,31,12,30,2,2,0,0,2,44,13,31,12,32,14,9.73244356423755,10.8411678870888,0.278895764216381,29
"5318","BA","Caetité",51081,16855.69,29026,"Guanambi",2,"Nordeste",0,"290520",3,54,13,41,13,41,0,0,0,0,0,54,13,41,13,41,39,9.73244356423755,10.8411678870888,0.360157859405376,31
"5319","BA","Caetité",51081,16855.69,29026,"Guanambi",2,"Nordeste",0,"290520",4,39,17,22,17,22,0,0,0,0,0,39,17,22,17,22,14,9.73244356423755,10.8411678870888,0.399131625294157,30
"5320","BA","Caetité",51081,16855.69,29026,"Guanambi",2,"Nordeste",0,"290520",5,55,22,33,22,33,1,0,1,0,1,56,22,34,22,34,21,9.73244356423755,10.8411678870888,0.394114447968204,31
"5321","BA","Cafarnaum",18513,8771.14,29009,"Irecê",2,"Nordeste",0,"290530",2,13,6,7,5,8,0,0,0,0,0,13,6,7,5,8,5,9.07922206551593,9.82622846698918,0.271324508258803,29
"5322","BA","Cafarnaum",18513,8771.14,29009,"Irecê",2,"Nordeste",0,"290530",3,21,4,17,5,16,0,0,0,0,0,21,4,17,5,16,11,9.07922206551593,9.82622846698918,0.337202319384518,31
"5323","BA","Cafarnaum",18513,8771.14,29009,"Irecê",2,"Nordeste",0,"290530",4,22,8,14,11,11,0,0,0,0,0,22,8,14,11,11,11,9.07922206551593,9.82622846698918,0.381839488963945,30
"5324","BA","Cafarnaum",18513,8771.14,29009,"Irecê",2,"Nordeste",0,"290530",5,27,14,13,15,12,1,0,1,0,1,28,14,14,15,13,13,9.07922206551593,9.82622846698918,0.370551015792953,31
"5325","BA","Cairu",18427,63029.19,29030,"Valença",2,"Nordeste",0,"290540",2,27,8,19,12,15,1,0,1,1,0,28,8,20,13,15,9,11.0513532314013,9.82157225933486,0.275771349522312,29
"5326","BA","Cairu",18427,63029.19,29030,"Valença",2,"Nordeste",0,"290540",3,18,4,14,9,9,0,0,0,0,0,18,4,14,9,9,9,11.0513532314013,9.82157225933486,0.393654732060189,31
"5327","BA","Cairu",18427,63029.19,29030,"Valença",2,"Nordeste",0,"290540",4,9,2,7,2,7,0,0,0,0,0,9,2,7,2,7,10,11.0513532314013,9.82157225933486,0.48219071048971,30
"5328","BA","Cairu",18427,63029.19,29030,"Valença",2,"Nordeste",0,"290540",5,19,7,12,5,14,0,0,0,0,0,19,7,12,5,14,3,11.0513532314013,9.82157225933486,0.495797177202134,31
"5329","BA","Caldeirão Grande",13391,6868.07,29010,"Jacobina",2,"Nordeste",0,"290550",2,12,4,8,7,5,0,0,0,0,0,12,4,8,7,5,8,8.83463841416112,9.50233811849557,0.28212759583669,29
"5330","BA","Caldeirão Grande",13391,6868.07,29010,"Jacobina",2,"Nordeste",0,"290550",3,15,11,4,6,9,0,0,0,0,0,15,11,4,6,9,5,8.83463841416112,9.50233811849557,0.34121014991843,31
"5331","BA","Caldeirão Grande",13391,6868.07,29010,"Jacobina",2,"Nordeste",0,"290550",4,11,5,6,5,6,0,0,0,0,0,11,5,6,5,6,3,8.83463841416112,9.50233811849557,0.399315454222084,30
"5332","BA","Caldeirão Grande",13391,6868.07,29010,"Jacobina",2,"Nordeste",0,"290550",5,7,3,4,2,5,0,0,0,0,0,7,3,4,2,5,13,8.83463841416112,9.50233811849557,0.425895274339408,31
"5333","BA","Camacan",32006,8835.59,29031,"Ilhéus-Itabuna",2,"Nordeste",0,"290560",2,23,10,13,14,9,1,0,1,1,0,24,10,14,15,9,7,9.08654316237698,10.3736786642059,0.293283343864581,29
"5334","BA","Camacan",32006,8835.59,29031,"Ilhéus-Itabuna",2,"Nordeste",0,"290560",3,34,13,21,12,22,1,0,1,0,1,35,13,22,12,23,16,9.08654316237698,10.3736786642059,0.383195737399735,31
"5335","BA","Camacan",32006,8835.59,29031,"Ilhéus-Itabuna",2,"Nordeste",0,"290560",4,21,8,13,11,10,0,0,0,0,0,21,8,13,11,10,24,9.08654316237698,10.3736786642059,0.41761478377304,30
"5336","BA","Camacan",32006,8835.59,29031,"Ilhéus-Itabuna",2,"Nordeste",0,"290560",5,32,12,20,17,15,0,0,0,0,0,32,12,20,17,15,16,9.08654316237698,10.3736786642059,0.41293579514417,31
"5337","BA","Camaçari",304302,81105.66,29021,"Salvador",2,"Nordeste",1,"290570",2,268,71,197,94,174,3,0,3,2,1,271,71,200,96,175,115,11.3035080280505,12.6257759083249,0.280891675629672,29
"5338","BA","Camaçari",304302,81105.66,29021,"Salvador",2,"Nordeste",1,"290570",3,292,71,221,97,195,2,2,0,2,0,294,73,221,99,195,135,11.3035080280505,12.6257759083249,0.386483447132597,31
"5339","BA","Camaçari",304302,81105.66,29021,"Salvador",2,"Nordeste",1,"290570",4,271,76,195,92,179,5,2,3,3,2,276,78,198,95,181,138,11.3035080280505,12.6257759083249,0.455221795027447,30
"5340","BA","Camaçari",304302,81105.66,29021,"Salvador",2,"Nordeste",1,"290570",5,313,89,224,100,213,8,5,3,1,7,321,94,227,101,220,152,11.3035080280505,12.6257759083249,0.432472116303264,31
"5341","BA","Camamu",35382,9820.61,29030,"Valença",2,"Nordeste",0,"290580",2,33,19,14,18,15,1,1,0,0,1,34,20,14,18,16,15,9.19223851754553,10.4739584952286,0.270212943152808,29
"5342","BA","Camamu",35382,9820.61,29030,"Valença",2,"Nordeste",0,"290580",3,48,30,18,24,24,1,0,1,0,1,49,30,19,24,25,18,9.19223851754553,10.4739584952286,0.366746368624641,31
"5343","BA","Camamu",35382,9820.61,29030,"Valença",2,"Nordeste",0,"290580",4,33,15,18,11,22,0,0,0,0,0,33,15,18,11,22,22,9.19223851754553,10.4739584952286,0.417511876129034,30
"5344","BA","Camamu",35382,9820.61,29030,"Valença",2,"Nordeste",0,"290580",5,37,14,23,17,20,1,1,0,1,0,38,15,23,18,20,15,9.19223851754553,10.4739584952286,0.404043973276506,31
"5345","BA","Campo Alegre de Lourdes",28820,7539.84,29004,"Juazeiro",2,"Nordeste",0,"290590",2,32,15,17,12,20,0,0,0,0,0,32,15,17,12,20,14,8.9279562406177,10.2688248695535,0.277899847205071,29
"5346","BA","Campo Alegre de Lourdes",28820,7539.84,29004,"Juazeiro",2,"Nordeste",0,"290590",3,44,17,27,21,23,1,0,1,1,0,45,17,28,22,23,9,8.9279562406177,10.2688248695535,0.370031317548533,31
"5347","BA","Campo Alegre de Lourdes",28820,7539.84,29004,"Juazeiro",2,"Nordeste",0,"290590",4,47,28,19,24,23,2,0,2,1,1,49,28,21,25,24,12,8.9279562406177,10.2688248695535,0.39811322100747,30
"5348","BA","Campo Alegre de Lourdes",28820,7539.84,29004,"Juazeiro",2,"Nordeste",0,"290590",5,35,16,19,21,14,1,1,0,0,1,36,17,19,21,15,8,8.9279562406177,10.2688248695535,0.420949275638498,31
"5349","BA","Campo Formoso",71487,15898.52,29008,"Senhor do Bonfim",2,"Nordeste",0,"290600",2,95,24,71,33,62,0,0,0,0,0,95,24,71,33,62,33,9.67398130211494,11.1772708939694,0.312158403778423,29
"5350","BA","Campo Formoso",71487,15898.52,29008,"Senhor do Bonfim",2,"Nordeste",0,"290600",3,82,26,56,36,46,0,0,0,0,0,82,26,56,36,46,42,9.67398130211494,11.1772708939694,0.39139610712283,31
"5351","BA","Campo Formoso",71487,15898.52,29008,"Senhor do Bonfim",2,"Nordeste",0,"290600",4,75,27,48,35,40,3,1,2,2,1,78,28,50,37,41,27,9.67398130211494,11.1772708939694,0.416883202905404,30
"5352","BA","Campo Formoso",71487,15898.52,29008,"Senhor do Bonfim",2,"Nordeste",0,"290600",5,97,34,63,48,49,0,0,0,0,0,97,34,63,48,49,30,9.67398130211494,11.1772708939694,0.414950856995749,31
"5353","BA","Canápolis",9703,6762.02,29003,"Santa Maria da Vitória",2,"Nordeste",0,"290610",2,3,0,3,0,3,0,0,0,0,0,3,0,3,0,3,1,8.81907694096828,9.1801903950253,0.301621267379352,29
"5354","BA","Canápolis",9703,6762.02,29003,"Santa Maria da Vitória",2,"Nordeste",0,"290610",3,2,0,2,1,1,0,0,0,0,0,2,0,2,1,1,7,8.81907694096828,9.1801903950253,0.391550757319387,31
"5355","BA","Canápolis",9703,6762.02,29003,"Santa Maria da Vitória",2,"Nordeste",0,"290610",4,0,0,0,0,0,0,0,0,0,0,0,0,0,0,0,4,8.81907694096828,9.1801903950253,0.396727226194705,30
"5356","BA","Canápolis",9703,6762.02,29003,"Santa Maria da Vitória",2,"Nordeste",0,"290610",5,2,0,2,2,0,0,0,0,0,0,2,0,2,2,0,2,8.81907694096828,9.1801903950253,0.396323073147821,31
"5357","BA","Canarana",26325,7457.06,29009,"Irecê",2,"Nordeste",0,"290620",2,9,3,6,3,6,0,0,0,0,0,9,3,6,3,6,17,8.91691651364258,10.1782743370022,0.284135086479637,29
"5358","BA","Canarana",26325,7457.06,29009,"Irecê",2,"Nordeste",0,"290620",3,11,3,8,6,5,0,0,0,0,0,11,3,8,6,5,9,8.91691651364258,10.1782743370022,0.369924627981037,31
"5359","BA","Canarana",26325,7457.06,29009,"Irecê",2,"Nordeste",0,"290620",4,16,4,12,4,12,1,1,0,1,0,17,5,12,5,12,11,8.91691651364258,10.1782743370022,0.404158263335468,30
"5360","BA","Canarana",26325,7457.06,29009,"Irecê",2,"Nordeste",0,"290620",5,13,3,10,6,7,0,0,0,0,0,13,3,10,6,7,14,8.91691651364258,10.1782743370022,0.397197889119702,31
"5361","BA","Canavieiras",30906,9973.92,29031,"Ilhéus-Itabuna",2,"Nordeste",1,"290630",2,24,11,13,12,12,0,0,0,0,0,24,11,13,12,12,16,9.20772896521968,10.3387056187936,0.267079331029258,29
"5362","BA","Canavieiras",30906,9973.92,29031,"Ilhéus-Itabuna",2,"Nordeste",1,"290630",3,18,10,8,9,9,0,0,0,0,0,18,10,8,9,9,19,9.20772896521968,10.3387056187936,0.353264107503114,31
"5363","BA","Canavieiras",30906,9973.92,29031,"Ilhéus-Itabuna",2,"Nordeste",1,"290630",4,19,7,12,11,8,1,0,1,1,0,20,7,13,12,8,22,9.20772896521968,10.3387056187936,0.388404908702643,30
"5364","BA","Canavieiras",30906,9973.92,29031,"Ilhéus-Itabuna",2,"Nordeste",1,"290630",5,27,17,10,11,16,0,0,0,0,0,27,17,10,11,16,19,9.20772896521968,10.3387056187936,0.375014920423265,31
"5365","BA","Candeal",8181,6482.95,29016,"Serrinha",2,"Nordeste",0,"290640",2,5,1,4,2,3,0,0,0,0,0,5,1,4,2,3,4,8.77693093266646,9.0095696715137,0.269111471828203,29
"5366","BA","Candeal",8181,6482.95,29016,"Serrinha",2,"Nordeste",0,"290640",3,5,1,4,3,2,0,0,0,0,0,5,1,4,3,2,5,8.77693093266646,9.0095696715137,0.346887591199733,31
"5367","BA","Candeal",8181,6482.95,29016,"Serrinha",2,"Nordeste",0,"290640",4,2,1,1,1,1,0,0,0,0,0,2,1,1,1,1,5,8.77693093266646,9.0095696715137,0.398298358803109,30
"5368","BA","Candeal",8181,6482.95,29016,"Serrinha",2,"Nordeste",0,"290640",5,6,3,3,2,4,0,0,0,0,0,6,3,3,2,4,3,8.77693093266646,9.0095696715137,0.366503147454413,31
"5369","BA","Candeias",87458,50279.23,29021,"Salvador",2,"Nordeste",1,"290650",2,66,21,45,28,38,0,0,0,0,0,66,21,45,28,38,53,10.8253473483467,11.3789139571088,0.303338185401499,29
"5370","BA","Candeias",87458,50279.23,29021,"Salvador",2,"Nordeste",1,"290650",3,73,20,53,31,42,1,0,1,0,1,74,20,54,31,43,46,10.8253473483467,11.3789139571088,0.390006161478496,31
"5371","BA","Candeias",87458,50279.23,29021,"Salvador",2,"Nordeste",1,"290650",4,68,16,52,28,40,0,0,0,0,0,68,16,52,28,40,57,10.8253473483467,11.3789139571088,0.451631001276409,30
"5372","BA","Candeias",87458,50279.23,29021,"Salvador",2,"Nordeste",1,"290650",5,84,24,60,32,52,0,0,0,0,0,84,24,60,32,52,59,10.8253473483467,11.3789139571088,0.43798624755348,31
"5373","BA","Candiba",14368,7829.79,29026,"Guanambi",2,"Nordeste",0,"290660",2,8,1,7,1,7,0,0,0,0,0,8,1,7,1,7,9,8.96569096870182,9.57275879054198,0.302810519851396,29
"5374","BA","Candiba",14368,7829.79,29026,"Guanambi",2,"Nordeste",0,"290660",3,6,2,4,2,4,0,0,0,0,0,6,2,4,2,4,9,8.96569096870182,9.57275879054198,0.433019093964885,31
"5375","BA","Candiba",14368,7829.79,29026,"Guanambi",2,"Nordeste",0,"290660",4,7,2,5,2,5,0,0,0,0,0,7,2,5,2,5,12,8.96569096870182,9.57275879054198,0.384491892487785,30
"5376","BA","Candiba",14368,7829.79,29026,"Guanambi",2,"Nordeste",0,"290660",5,11,3,8,4,7,0,0,0,0,0,11,3,8,4,7,7,8.96569096870182,9.57275879054198,0.387980948044786,31
"5377","BA","Cândido Sales",25053,8330.26,29028,"Vitória da Conquista",2,"Nordeste",0,"290670",2,15,4,11,6,9,1,0,1,1,0,16,4,12,7,9,17,9.02764994715878,10.1287488598213,0.312546381219284,29
"5378","BA","Cândido Sales",25053,8330.26,29028,"Vitória da Conquista",2,"Nordeste",0,"290670",3,20,9,11,10,10,0,0,0,0,0,20,9,11,10,10,15,9.02764994715878,10.1287488598213,0.38422493079798,31
"5379","BA","Cândido Sales",25053,8330.26,29028,"Vitória da Conquista",2,"Nordeste",0,"290670",4,27,9,18,12,15,0,0,0,0,0,27,9,18,12,15,16,9.02764994715878,10.1287488598213,0.382761861821814,30
"5380","BA","Cândido Sales",25053,8330.26,29028,"Vitória da Conquista",2,"Nordeste",0,"290670",5,27,9,18,14,13,0,0,0,0,0,27,9,18,14,13,16,9.02764994715878,10.1287488598213,0.392537689135646,31
"5381","BA","Cansanção",34882,7476.84,29014,"Euclides da Cunha",2,"Nordeste",0,"290680",2,33,15,18,17,16,0,0,0,0,0,33,15,18,17,16,20,8.91956552181415,10.4597262158286,0.301608506159151,29
"5382","BA","Cansanção",34882,7476.84,29014,"Euclides da Cunha",2,"Nordeste",0,"290680",3,33,10,23,19,14,0,0,0,0,0,33,10,23,19,14,16,8.91956552181415,10.4597262158286,0.384934301515822,31
"5383","BA","Cansanção",34882,7476.84,29014,"Euclides da Cunha",2,"Nordeste",0,"290680",4,23,10,13,14,9,0,0,0,0,0,23,10,13,14,9,23,8.91956552181415,10.4597262158286,0.400231551798985,30
"5384","BA","Cansanção",34882,7476.84,29014,"Euclides da Cunha",2,"Nordeste",0,"290680",5,33,14,19,16,17,2,2,0,1,1,35,16,19,17,18,16,8.91956552181415,10.4597262158286,0.414843398224318,31
"5385","BA","Canudos",16753,7617.34,29014,"Euclides da Cunha",2,"Nordeste",0,"290682",2,15,7,8,10,5,0,0,0,0,0,15,7,8,10,5,7,8.93818250637278,9.72633262569353,0.26904977527123,29
"5386","BA","Canudos",16753,7617.34,29014,"Euclides da Cunha",2,"Nordeste",0,"290682",3,10,5,5,7,3,0,0,0,0,0,10,5,5,7,3,3,8.93818250637278,9.72633262569353,0.345127819390284,31
"5387","BA","Canudos",16753,7617.34,29014,"Euclides da Cunha",2,"Nordeste",0,"290682",4,18,6,12,6,12,0,0,0,0,0,18,6,12,6,12,10,8.93818250637278,9.72633262569353,0.373284218102873,30
"5388","BA","Canudos",16753,7617.34,29014,"Euclides da Cunha",2,"Nordeste",0,"290682",5,33,7,26,11,22,0,0,0,0,0,33,7,26,11,22,9,8.93818250637278,9.72633262569353,0.382246751884279,31
"5389","BA","Capela do Alto Alegre",11616,7701.83,29016,"Serrinha",2,"Nordeste",0,"290685",2,6,1,5,1,5,0,0,0,0,0,6,1,5,1,5,6,8.94921324194222,9.36013873706458,0.278533722553032,29
"5390","BA","Capela do Alto Alegre",11616,7701.83,29016,"Serrinha",2,"Nordeste",0,"290685",3,6,0,6,2,4,0,0,0,0,0,6,0,6,2,4,10,8.94921324194222,9.36013873706458,0.368628147479973,31
"5391","BA","Capela do Alto Alegre",11616,7701.83,29016,"Serrinha",2,"Nordeste",0,"290685",4,5,0,5,1,4,0,0,0,0,0,5,0,5,1,4,6,8.94921324194222,9.36013873706458,0.374748518743434,30
"5392","BA","Capela do Alto Alegre",11616,7701.83,29016,"Serrinha",2,"Nordeste",0,"290685",5,11,3,8,6,5,0,0,0,0,0,11,3,8,6,5,11,8.94921324194222,9.36013873706458,0.380391171251425,31
"5393","BA","Capim Grosso",30862,14039.95,29010,"Jacobina",2,"Nordeste",1,"290687",2,30,9,21,13,17,0,0,0,0,0,30,9,21,13,17,13,9.5496621163199,10.3372809326312,0.262894764145289,29
"5394","BA","Capim Grosso",30862,14039.95,29010,"Jacobina",2,"Nordeste",1,"290687",3,34,10,24,15,19,1,1,0,1,0,35,11,24,16,19,23,9.5496621163199,10.3372809326312,0.344949778564968,31
"5395","BA","Capim Grosso",30862,14039.95,29010,"Jacobina",2,"Nordeste",1,"290687",4,36,15,21,19,17,0,0,0,0,0,36,15,21,19,17,24,9.5496621163199,10.3372809326312,0.374490380805481,30
"5396","BA","Capim Grosso",30862,14039.95,29010,"Jacobina",2,"Nordeste",1,"290687",5,31,10,21,12,19,0,0,0,0,0,31,10,21,12,19,32,9.5496621163199,10.3372809326312,0.35875671419182,31
"5397","BA","Caraíbas",8801,7465.03,29027,"Brumado",2,"Nordeste",0,"290689",2,5,1,4,1,4,0,0,0,0,0,5,1,4,1,4,6,8.9179847287194,9.08262063037381,0.353358650398833,29
"5398","BA","Caraíbas",8801,7465.03,29027,"Brumado",2,"Nordeste",0,"290689",3,2,0,2,0,2,1,0,1,0,1,3,0,3,0,3,5,8.9179847287194,9.08262063037381,0.391749389374195,31
"5399","BA","Caraíbas",8801,7465.03,29027,"Brumado",2,"Nordeste",0,"290689",4,3,1,2,2,1,0,0,0,0,0,3,1,2,2,1,7,8.9179847287194,9.08262063037381,0.424897282624196,30
"5400","BA","Caraíbas",8801,7465.03,29027,"Brumado",2,"Nordeste",0,"290689",5,7,0,7,3,4,0,0,0,0,0,7,0,7,3,4,8,8.9179847287194,9.08262063037381,0.429390856376514,31
"5401","BA","Caravelas",22093,15910.13,29032,"Porto Seguro",2,"Nordeste",0,"290690",2,17,5,12,9,8,0,0,0,0,0,17,5,12,9,8,12,9.67471129226011,10.003016095251,0.29285721215983,29
"5402","BA","Caravelas",22093,15910.13,29032,"Porto Seguro",2,"Nordeste",0,"290690",3,21,8,13,13,8,0,0,0,0,0,21,8,13,13,8,13,9.67471129226011,10.003016095251,0.396414442873974,31
"5403","BA","Caravelas",22093,15910.13,29032,"Porto Seguro",2,"Nordeste",0,"290690",4,22,13,9,11,11,0,0,0,0,0,22,13,9,11,11,11,9.67471129226011,10.003016095251,0.409362852389309,30
"5404","BA","Caravelas",22093,15910.13,29032,"Porto Seguro",2,"Nordeste",0,"290690",5,21,13,8,12,9,0,0,0,0,0,21,13,8,12,9,14,9.67471129226011,10.003016095251,0.407210631942717,31
"5405","BA","Cardeal da Silva",9346,11169.1,29018,"Entre Rios",2,"Nordeste",0,"290700",2,7,2,5,3,4,0,0,0,0,0,7,2,5,3,4,5,9.32090631585378,9.14270372326037,0.262256292563415,29
"5406","BA","Cardeal da Silva",9346,11169.1,29018,"Entre Rios",2,"Nordeste",0,"290700",3,14,6,8,7,7,0,0,0,0,0,14,6,8,7,7,4,9.32090631585378,9.14270372326037,0.366866207849155,31
"5407","BA","Cardeal da Silva",9346,11169.1,29018,"Entre Rios",2,"Nordeste",0,"290700",4,9,5,4,5,4,0,0,0,0,0,9,5,4,5,4,1,9.32090631585378,9.14270372326037,0.40176143250307,30
"5408","BA","Cardeal da Silva",9346,11169.1,29018,"Entre Rios",2,"Nordeste",0,"290700",5,7,3,4,3,4,1,1,0,1,0,8,4,4,4,4,6,9.32090631585378,9.14270372326037,0.381327173242642,31
"5409","BA","Carinhanha",29070,7402.52,29007,"Bom Jesus da Lapa",2,"Nordeste",0,"290710",2,29,8,21,10,19,0,0,0,0,0,29,8,21,10,19,13,8.90957576176203,10.2774619935529,0.287897540572104,29
"5410","BA","Carinhanha",29070,7402.52,29007,"Bom Jesus da Lapa",2,"Nordeste",0,"290710",3,24,5,19,9,15,1,1,0,0,1,25,6,19,9,16,13,8.90957576176203,10.2774619935529,0.368522350945335,31
"5411","BA","Carinhanha",29070,7402.52,29007,"Bom Jesus da Lapa",2,"Nordeste",0,"290710",4,30,11,19,14,16,0,0,0,0,0,30,11,19,14,16,13,8.90957576176203,10.2774619935529,0.38126580514533,30
"5412","BA","Carinhanha",29070,7402.52,29007,"Bom Jesus da Lapa",2,"Nordeste",0,"290710",5,40,14,26,10,30,0,0,0,0,0,40,14,26,10,30,12,8.90957576176203,10.2774619935529,0.373236971365405,31
"5413","BA","Casa Nova",72545,9672.3,29004,"Juazeiro",2,"Nordeste",1,"290720",2,67,31,36,34,33,0,0,0,0,0,67,31,36,34,33,35,9.17702140918333,11.1919623379498,0.298278735308017,29
"5414","BA","Casa Nova",72545,9672.3,29004,"Juazeiro",2,"Nordeste",1,"290720",3,66,31,35,25,41,2,0,2,0,2,68,31,37,25,43,33,9.17702140918333,11.1919623379498,0.385619584106778,31
"5415","BA","Casa Nova",72545,9672.3,29004,"Juazeiro",2,"Nordeste",1,"290720",4,77,36,41,31,46,1,1,0,1,0,78,37,41,32,46,40,9.17702140918333,11.1919623379498,0.389947119940828,30
"5416","BA","Casa Nova",72545,9672.3,29004,"Juazeiro",2,"Nordeste",1,"290720",5,80,36,44,32,48,3,3,0,1,2,83,39,44,33,50,34,9.17702140918333,11.1919623379498,0.413315056799862,31
"5417","BA","Castro Alves",26318,10522.43,29020,"Santo Antônio de Jesus",2,"Nordeste",0,"290730",2,13,2,11,8,5,1,1,0,1,0,14,3,11,9,5,12,9.2612644482111,10.1780083947101,0.246095183948463,29
"5418","BA","Castro Alves",26318,10522.43,29020,"Santo Antônio de Jesus",2,"Nordeste",0,"290730",3,25,6,19,9,16,0,0,0,0,0,25,6,19,9,16,15,9.2612644482111,10.1780083947101,0.341797850550806,31
"5419","BA","Castro Alves",26318,10522.43,29020,"Santo Antônio de Jesus",2,"Nordeste",0,"290730",4,23,6,17,8,15,0,0,0,0,0,23,6,17,8,15,21,9.2612644482111,10.1780083947101,0.371113582837455,30
"5420","BA","Castro Alves",26318,10522.43,29020,"Santo Antônio de Jesus",2,"Nordeste",0,"290730",5,22,4,18,7,15,0,0,0,0,0,22,4,18,7,15,16,9.2612644482111,10.1780083947101,0.379525254224819,31
"5421","BA","Catu",54970,10971.95,29019,"Catu",2,"Nordeste",1,"290750",2,37,13,24,14,23,0,0,0,0,0,37,13,24,14,23,20,9.30309729499279,10.9145428608547,0.273657915648401,29
"5422","BA","Catu",54970,10971.95,29019,"Catu",2,"Nordeste",1,"290750",3,39,7,32,11,28,1,1,0,0,1,40,8,32,11,29,27,9.30309729499279,10.9145428608547,0.363817459253248,31
"5423","BA","Catu",54970,10971.95,29019,"Catu",2,"Nordeste",1,"290750",4,40,12,28,12,28,1,1,0,1,0,41,13,28,13,28,24,9.30309729499279,10.9145428608547,0.414340995064708,30
"5424","BA","Catu",54970,10971.95,29019,"Catu",2,"Nordeste",1,"290750",5,47,10,37,24,23,0,0,0,0,0,47,10,37,24,23,33,9.30309729499279,10.9145428608547,0.412131180611156,31
"5425","BA","Central",17280,9059.39,29009,"Irecê",2,"Nordeste",0,"290760",2,8,3,5,5,3,0,0,0,0,0,8,3,5,5,3,9,9.11155706785201,9.75730504235805,0.282135391174293,29
"5426","BA","Central",17280,9059.39,29009,"Irecê",2,"Nordeste",0,"290760",3,11,5,6,7,4,0,0,0,0,0,11,5,6,7,4,5,9.11155706785201,9.75730504235805,0.389975803037424,31
"5427","BA","Central",17280,9059.39,29009,"Irecê",2,"Nordeste",0,"290760",4,11,2,9,5,6,2,0,2,2,0,13,2,11,7,6,8,9.11155706785201,9.75730504235805,0.422523036373805,30
"5428","BA","Central",17280,9059.39,29009,"Irecê",2,"Nordeste",0,"290760",5,22,9,13,10,12,0,0,0,0,0,22,9,13,10,12,9,9.11155706785201,9.75730504235805,0.405037304689694,31
"5429","BA","Chorrochó",11200,6866.08,29005,"Paulo Afonso",2,"Nordeste",0,"290770",2,13,8,5,5,8,0,0,0,0,0,13,8,5,5,8,7,8.83434862556642,9.32366905728319,0.282446154483091,29
"5430","BA","Chorrochó",11200,6866.08,29005,"Paulo Afonso",2,"Nordeste",0,"290770",3,11,3,8,6,5,0,0,0,0,0,11,3,8,6,5,8,8.83434862556642,9.32366905728319,0.364512230583078,31
"5431","BA","Chorrochó",11200,6866.08,29005,"Paulo Afonso",2,"Nordeste",0,"290770",4,20,7,13,12,8,1,0,1,1,0,21,7,14,13,8,9,8.83434862556642,9.32366905728319,0.397946725670488,30
"5432","BA","Chorrochó",11200,6866.08,29005,"Paulo Afonso",2,"Nordeste",0,"290770",5,8,3,5,6,2,0,0,0,0,0,8,3,5,6,2,4,8.83434862556642,9.32366905728319,0.402339071302479,31
"5433","BA","Cícero Dantas",32576,8087.65,29015,"Ribeira do Pombal",2,"Nordeste",0,"290780",2,16,9,7,8,8,0,0,0,0,0,16,9,7,8,8,9,8.99809348577781,10.3913310999102,0.280603824502021,29
"5434","BA","Cícero Dantas",32576,8087.65,29015,"Ribeira do Pombal",2,"Nordeste",0,"290780",3,11,7,4,5,6,0,0,0,0,0,11,7,4,5,6,16,8.99809348577781,10.3913310999102,0.376029518058285,31
"5435","BA","Cícero Dantas",32576,8087.65,29015,"Ribeira do Pombal",2,"Nordeste",0,"290780",4,20,9,11,11,9,0,0,0,0,0,20,9,11,11,9,18,8.99809348577781,10.3913310999102,0.411246205346823,30
"5436","BA","Cícero Dantas",32576,8087.65,29015,"Ribeira do Pombal",2,"Nordeste",0,"290780",5,23,10,13,11,12,0,0,0,0,0,23,10,13,11,12,32,8.99809348577781,10.3913310999102,0.393789031893262,31
"5437","BA","Cipó",17352,7651.42,29015,"Ribeira do Pombal",2,"Nordeste",0,"290790",2,15,4,11,8,7,0,0,0,0,0,15,4,11,8,7,9,8.94264653051018,9.76146305250671,0.285991574456928,29
"5438","BA","Cipó",17352,7651.42,29015,"Ribeira do Pombal",2,"Nordeste",0,"290790",3,17,6,11,5,12,0,0,0,0,0,17,6,11,5,12,10,8.94264653051018,9.76146305250671,0.366715218144515,31
"5439","BA","Cipó",17352,7651.42,29015,"Ribeira do Pombal",2,"Nordeste",0,"290790",4,22,13,9,11,11,0,0,0,0,0,22,13,9,11,11,7,8.94264653051018,9.76146305250671,0.381877206167487,30
"5440","BA","Cipó",17352,7651.42,29015,"Ribeira do Pombal",2,"Nordeste",0,"290790",5,32,21,11,13,19,0,0,0,0,0,32,21,11,13,19,10,8.94264653051018,9.76146305250671,0.373261576927507,31
"5441","BA","Coaraci",16549,8691.23,29031,"Ilhéus-Itabuna",2,"Nordeste",1,"290800",2,16,7,9,11,5,0,0,0,0,0,16,7,9,11,5,19,9.07006975024562,9.71408095601894,0.285957668520742,29
"5442","BA","Coaraci",16549,8691.23,29031,"Ilhéus-Itabuna",2,"Nordeste",1,"290800",3,15,8,7,9,6,1,1,0,0,1,16,9,7,9,7,18,9.07006975024562,9.71408095601894,0.372647528663176,31
"5443","BA","Coaraci",16549,8691.23,29031,"Ilhéus-Itabuna",2,"Nordeste",1,"290800",4,11,3,8,3,8,0,0,0,0,0,11,3,8,3,8,13,9.07006975024562,9.71408095601894,0.41097916369503,30
"5444","BA","Coaraci",16549,8691.23,29031,"Ilhéus-Itabuna",2,"Nordeste",1,"290800",5,11,3,8,6,5,0,0,0,0,0,11,3,8,6,5,24,9.07006975024562,9.71408095601894,0.381411334957023,31
"5445","BA","Cocos",18807,16958.23,29003,"Santa Maria da Vitória",2,"Nordeste",0,"290810",2,6,0,6,1,5,0,0,0,0,0,6,0,6,1,5,8,9.73850854069213,9.84198441994208,0.293229750952542,29
"5446","BA","Cocos",18807,16958.23,29003,"Santa Maria da Vitória",2,"Nordeste",0,"290810",3,1,0,1,0,1,0,0,0,0,0,1,0,1,0,1,8,9.73850854069213,9.84198441994208,0.344308200955407,31
"5447","BA","Cocos",18807,16958.23,29003,"Santa Maria da Vitória",2,"Nordeste",0,"290810",4,3,1,2,2,1,0,0,0,0,0,3,1,2,2,1,7,9.73850854069213,9.84198441994208,0.37106447070744,30
"5448","BA","Cocos",18807,16958.23,29003,"Santa Maria da Vitória",2,"Nordeste",0,"290810",5,5,1,4,3,2,0,0,0,0,0,5,1,4,3,2,8,9.73850854069213,9.84198441994208,0.394113372131868,31
"5449","BA","Conceição da Feira",22762,12009.8,29012,"Feira de Santana",2,"Nordeste",0,"290820",2,24,7,17,8,16,0,0,0,0,0,24,7,17,8,16,8,9.39347826214603,10.0328477578418,0.260736125212855,29
"5450","BA","Conceição da Feira",22762,12009.8,29012,"Feira de Santana",2,"Nordeste",0,"290820",3,15,1,14,7,8,0,0,0,0,0,15,1,14,7,8,8,9.39347826214603,10.0328477578418,0.34726970126303,31
"5451","BA","Conceição da Feira",22762,12009.8,29012,"Feira de Santana",2,"Nordeste",0,"290820",4,16,5,11,7,9,0,0,0,0,0,16,5,11,7,9,10,9.39347826214603,10.0328477578418,0.382774645366566,30
"5452","BA","Conceição da Feira",22762,12009.8,29012,"Feira de Santana",2,"Nordeste",0,"290820",5,14,8,6,7,7,1,0,1,0,1,15,8,7,7,8,11,9.39347826214603,10.0328477578418,0.36298915823151,31
"5453","BA","Conceição do Almeida",17165,9215.26,29020,"Santo Antônio de Jesus",2,"Nordeste",0,"290830",2,10,1,9,5,5,0,0,0,0,0,10,1,9,5,5,12,9.12861608457296,9.75062770589179,0.290780558353961,29
"5454","BA","Conceição do Almeida",17165,9215.26,29020,"Santo Antônio de Jesus",2,"Nordeste",0,"290830",3,10,2,8,1,9,0,0,0,0,0,10,2,8,1,9,13,9.12861608457296,9.75062770589179,0.383618038548379,31
"5455","BA","Conceição do Almeida",17165,9215.26,29020,"Santo Antônio de Jesus",2,"Nordeste",0,"290830",4,10,1,9,5,5,0,0,0,0,0,10,1,9,5,5,5,9.12861608457296,9.75062770589179,0.443121549910192,30
"5456","BA","Conceição do Almeida",17165,9215.26,29020,"Santo Antônio de Jesus",2,"Nordeste",0,"290830",5,17,4,13,5,12,0,0,0,0,0,17,4,13,5,12,13,9.12861608457296,9.75062770589179,0.428575520771759,31
"5457","BA","Conceição do Coité",67013,11055.14,29016,"Serrinha",2,"Nordeste",1,"290840",2,71,25,46,27,44,3,0,3,1,2,74,25,49,28,46,35,9.31065075716432,11.1126419094025,0.25710596971593,29
"5458","BA","Conceição do Coité",67013,11055.14,29016,"Serrinha",2,"Nordeste",1,"290840",3,86,37,49,30,56,1,1,0,0,1,87,38,49,30,57,40,9.31065075716432,11.1126419094025,0.337513984261145,31
"5459","BA","Conceição do Coité",67013,11055.14,29016,"Serrinha",2,"Nordeste",1,"290840",4,60,15,45,30,30,1,1,0,0,1,61,16,45,30,31,50,9.31065075716432,11.1126419094025,0.376229160756753,30
"5460","BA","Conceição do Coité",67013,11055.14,29016,"Serrinha",2,"Nordeste",1,"290840",5,62,18,44,24,38,1,0,1,1,0,63,18,45,25,38,43,9.31065075716432,11.1126419094025,0.364716659946845,31
"5461","BA","Conceição do Jacuípe",33398,68300.94,29012,"Feira de Santana",2,"Nordeste",1,"290850",2,29,12,17,9,20,1,0,1,0,1,30,12,18,9,21,23,11.1316788082753,10.4162512969324,0.265027514864955,29
"5462","BA","Conceição do Jacuípe",33398,68300.94,29012,"Feira de Santana",2,"Nordeste",1,"290850",3,31,7,24,11,20,0,0,0,0,0,31,7,24,11,20,26,11.1316788082753,10.4162512969324,0.350618020897269,31
"5463","BA","Conceição do Jacuípe",33398,68300.94,29012,"Feira de Santana",2,"Nordeste",1,"290850",4,15,4,11,8,7,0,0,0,0,0,15,4,11,8,7,15,11.1316788082753,10.4162512969324,0.395545926081872,30
"5464","BA","Conceição do Jacuípe",33398,68300.94,29012,"Feira de Santana",2,"Nordeste",1,"290850",5,15,2,13,5,10,0,0,0,0,0,15,2,13,5,10,16,11.1316788082753,10.4162512969324,0.368261450892552,31
"5465","BA","Conde",26035,10604.67,29018,"Entre Rios",2,"Nordeste",0,"290860",2,28,10,18,10,18,0,0,0,0,0,28,10,18,10,18,11,9.26904974911717,10.167197065597,0.282857199759695,29
"5466","BA","Conde",26035,10604.67,29018,"Entre Rios",2,"Nordeste",0,"290860",3,16,13,3,8,8,0,0,0,0,0,16,13,3,8,8,17,9.26904974911717,10.167197065597,0.370944450171298,31
"5467","BA","Conde",26035,10604.67,29018,"Entre Rios",2,"Nordeste",0,"290860",4,24,10,14,11,13,0,0,0,0,0,24,10,14,11,13,4,9.26904974911717,10.167197065597,0.412548908074614,30
"5468","BA","Conde",26035,10604.67,29018,"Entre Rios",2,"Nordeste",0,"290860",5,32,16,16,26,6,0,0,0,0,0,32,16,16,26,6,13,9.26904974911717,10.167197065597,0.423415264701045,31
"5469","BA","Condeúba",17178,8596.77,29027,"Brumado",2,"Nordeste",0,"290870",2,9,2,7,2,7,0,0,0,0,0,9,2,7,2,7,6,9.05914183029789,9.75138477432617,0.296273689872521,29
"5470","BA","Condeúba",17178,8596.77,29027,"Brumado",2,"Nordeste",0,"290870",3,19,4,15,8,11,0,0,0,0,0,19,4,15,8,11,12,9.05914183029789,9.75138477432617,0.370954771433984,31
"5471","BA","Condeúba",17178,8596.77,29027,"Brumado",2,"Nordeste",0,"290870",4,16,1,15,6,10,0,0,0,0,0,16,1,15,6,10,11,9.05914183029789,9.75138477432617,0.413863191713931,30
"5472","BA","Condeúba",17178,8596.77,29027,"Brumado",2,"Nordeste",0,"290870",5,13,5,8,4,9,0,0,0,0,0,13,5,8,4,9,10,9.05914183029789,9.75138477432617,0.406649401295613,31
"5473","BA","Coração de Maria",22495,7586.96,29012,"Feira de Santana",2,"Nordeste",0,"290890",2,11,3,8,5,6,0,0,0,0,0,11,3,8,5,6,12,8.93418626314809,10.0210483412753,0.250132992051349,29
"5474","BA","Coração de Maria",22495,7586.96,29012,"Feira de Santana",2,"Nordeste",0,"290890",3,13,2,11,3,10,1,0,1,0,1,14,2,12,3,11,16,8.93418626314809,10.0210483412753,0.348306160194889,31
"5475","BA","Coração de Maria",22495,7586.96,29012,"Feira de Santana",2,"Nordeste",0,"290890",4,12,5,7,6,6,0,0,0,0,0,12,5,7,6,6,16,8.93418626314809,10.0210483412753,0.399013289857377,30
"5476","BA","Coração de Maria",22495,7586.96,29012,"Feira de Santana",2,"Nordeste",0,"290890",5,15,6,9,6,9,0,0,0,0,0,15,6,9,6,9,14,8.93418626314809,10.0210483412753,0.387024795903649,31
"5477","BA","Coribe",14149,8835.24,29003,"Santa Maria da Vitória",2,"Nordeste",0,"290910",2,9,3,6,4,5,0,0,0,0,0,9,3,6,4,5,5,9.08650354907075,9.55739922919595,0.299508826774527,29
"5478","BA","Coribe",14149,8835.24,29003,"Santa Maria da Vitória",2,"Nordeste",0,"290910",3,9,3,6,3,6,0,0,0,0,0,9,3,6,3,6,8,9.08650354907075,9.55739922919595,0.390639035586325,31
"5479","BA","Coribe",14149,8835.24,29003,"Santa Maria da Vitória",2,"Nordeste",0,"290910",4,6,1,5,5,1,0,0,0,0,0,6,1,5,5,1,3,9.08650354907075,9.55739922919595,0.400331080778512,30
"5480","BA","Coribe",14149,8835.24,29003,"Santa Maria da Vitória",2,"Nordeste",0,"290910",5,8,1,7,4,4,0,0,0,0,0,8,1,7,4,4,4,9.08650354907075,9.55739922919595,0.40728911659547,31
"5481","BA","Coronel João Sá",15717,8311.11,29013,"Jeremoabo",2,"Nordeste",0,"290920",2,12,6,6,2,10,0,0,0,0,0,12,6,6,2,10,7,9.0253484529365,9.66249820807633,0.260731213097853,29
"5482","BA","Coronel João Sá",15717,8311.11,29013,"Jeremoabo",2,"Nordeste",0,"290920",3,10,6,4,5,5,0,0,0,0,0,10,6,4,5,5,7,9.0253484529365,9.66249820807633,0.333855766336754,31
"5483","BA","Coronel João Sá",15717,8311.11,29013,"Jeremoabo",2,"Nordeste",0,"290920",4,15,9,6,8,7,0,0,0,0,0,15,9,6,8,7,14,9.0253484529365,9.66249820807633,0.352643907335726,30
"5484","BA","Coronel João Sá",15717,8311.11,29013,"Jeremoabo",2,"Nordeste",0,"290920",5,13,6,7,5,8,0,0,0,0,0,13,6,7,5,8,9,9.0253484529365,9.66249820807633,0.353851900548235,31
"5485","BA","Correntina",32191,60601.65,29003,"Santa Maria da Vitória",2,"Nordeste",0,"290930",2,5,2,3,2,3,1,0,1,1,0,6,2,4,3,3,14,11.0120773994095,10.3794421893586,0.279098847990507,29
"5486","BA","Correntina",32191,60601.65,29003,"Santa Maria da Vitória",2,"Nordeste",0,"290930",3,11,6,5,4,7,0,0,0,0,0,11,6,5,4,7,16,11.0120773994095,10.3794421893586,0.380549474628888,31
"5487","BA","Correntina",32191,60601.65,29003,"Santa Maria da Vitória",2,"Nordeste",0,"290930",4,10,7,3,4,6,1,0,1,1,0,11,7,4,5,6,12,11.0120773994095,10.3794421893586,0.397822492883918,30
"5488","BA","Correntina",32191,60601.65,29003,"Santa Maria da Vitória",2,"Nordeste",0,"290930",5,25,10,15,12,13,0,0,0,0,0,25,10,15,12,13,13,11.0120773994095,10.3794421893586,0.372182474428883,31
"5489","BA","Cotegipe",13769,9186.91,29002,"Cotegipe",2,"Nordeste",0,"290940",2,12,1,11,5,7,0,0,0,0,0,12,1,11,5,7,6,9.12553492377197,9.53017496744437,0.279297627334218,29
"5490","BA","Cotegipe",13769,9186.91,29002,"Cotegipe",2,"Nordeste",0,"290940",3,13,4,9,6,7,0,0,0,0,0,13,4,9,6,7,4,9.12553492377197,9.53017496744437,0.358211710722663,31
"5491","BA","Cotegipe",13769,9186.91,29002,"Cotegipe",2,"Nordeste",0,"290940",4,11,3,8,7,4,0,0,0,0,0,11,3,8,7,4,6,9.12553492377197,9.53017496744437,0.35983523435104,30
"5492","BA","Cotegipe",13769,9186.91,29002,"Cotegipe",2,"Nordeste",0,"290940",5,8,4,4,4,4,0,0,0,0,0,8,4,4,4,4,7,9.12553492377197,9.53017496744437,0.412979242816303,31
"5493","BA","Cravolândia",5351,6994.99,29024,"Jequié",2,"Nordeste",0,"290950",2,4,3,1,1,3,0,0,0,0,0,4,3,1,1,3,1,8.85294945750599,8.5850387383113,0.274627136833166,29
"5494","BA","Cravolândia",5351,6994.99,29024,"Jequié",2,"Nordeste",0,"290950",3,4,2,2,1,3,1,0,1,0,1,5,2,3,1,4,1,8.85294945750599,8.5850387383113,0.368137238996542,31
"5495","BA","Cravolândia",5351,6994.99,29024,"Jequié",2,"Nordeste",0,"290950",4,0,0,0,0,0,0,0,0,0,0,0,0,0,0,0,3,8.85294945750599,8.5850387383113,0.436894128855739,30
"5496","BA","Cravolândia",5351,6994.99,29024,"Jequié",2,"Nordeste",0,"290950",5,3,2,1,0,3,0,0,0,0,0,3,2,1,0,3,5,8.85294945750599,8.5850387383113,0.448962629424367,31
"5497","BA","Crisópolis",21163,7257.53,29017,"Alagoinhas",2,"Nordeste",0,"290960",2,17,7,10,7,10,0,0,0,0,0,17,7,10,7,10,9,8.88979482954508,9.96000965286045,0.306255650254033,29
"5498","BA","Crisópolis",21163,7257.53,29017,"Alagoinhas",2,"Nordeste",0,"290960",3,15,8,7,7,8,1,1,0,0,1,16,9,7,7,9,12,8.88979482954508,9.96000965286045,0.387168800155353,31
"5499","BA","Crisópolis",21163,7257.53,29017,"Alagoinhas",2,"Nordeste",0,"290960",4,15,7,8,6,9,0,0,0,0,0,15,7,8,6,9,13,8.88979482954508,9.96000965286045,0.407746274012552,30
"5500","BA","Crisópolis",21163,7257.53,29017,"Alagoinhas",2,"Nordeste",0,"290960",5,17,6,11,10,7,2,1,1,1,1,19,7,12,11,8,16,8.88979482954508,9.96000965286045,0.40521760305848,31
"5501","BA","Cristópolis",13947,8040.63,29002,"Cotegipe",2,"Nordeste",0,"290970",2,7,3,4,3,4,0,0,0,0,0,7,3,4,3,4,5,8.99226271731212,9.54301971035869,0.311035374686277,29
"5502","BA","Cristópolis",13947,8040.63,29002,"Cotegipe",2,"Nordeste",0,"290970",3,12,2,10,6,6,0,0,0,0,0,12,2,10,6,6,9,8.99226271731212,9.54301971035869,0.39764921761258,31
"5503","BA","Cristópolis",13947,8040.63,29002,"Cotegipe",2,"Nordeste",0,"290970",4,12,4,8,1,11,0,0,0,0,0,12,4,8,1,11,4,8.99226271731212,9.54301971035869,0.417393637114442,30
"5504","BA","Cristópolis",13947,8040.63,29002,"Cotegipe",2,"Nordeste",0,"290970",5,12,2,10,7,5,0,0,0,0,0,12,2,10,7,5,8,8.99226271731212,9.54301971035869,0.419646909706574,31
"5505","BA","Cruz das Almas",63591,15661.85,29020,"Santo Antônio de Jesus",2,"Nordeste",1,"290980",2,54,14,40,17,37,2,0,2,0,2,56,14,42,17,39,31,9.65898309794412,11.0602272298808,0.265614192855312,29
"5506","BA","Cruz das Almas",63591,15661.85,29020,"Santo Antônio de Jesus",2,"Nordeste",1,"290980",3,46,10,36,15,31,1,1,0,1,0,47,11,36,16,31,23,9.65898309794412,11.0602272298808,0.37898465352117,31
"5507","BA","Cruz das Almas",63591,15661.85,29020,"Santo Antônio de Jesus",2,"Nordeste",1,"290980",4,58,7,51,19,39,1,0,1,0,1,59,7,52,19,40,27,9.65898309794412,11.0602272298808,0.443724008183144,30
"5508","BA","Cruz das Almas",63591,15661.85,29020,"Santo Antônio de Jesus",2,"Nordeste",1,"290980",5,61,11,50,20,41,0,0,0,0,0,61,11,50,20,41,38,9.65898309794412,11.0602272298808,0.420506553581178,31
"5509","BA","Curaçá",34886,9240.01,29004,"Juazeiro",2,"Nordeste",0,"290990",2,34,12,22,16,18,1,0,1,0,1,35,12,23,16,19,23,9.13129824688623,10.4598408815781,0.2767396146563,29
"5510","BA","Curaçá",34886,9240.01,29004,"Juazeiro",2,"Nordeste",0,"290990",3,42,14,28,24,18,1,1,0,0,1,43,15,28,24,19,22,9.13129824688623,10.4598408815781,0.348084642490547,31
"5511","BA","Curaçá",34886,9240.01,29004,"Juazeiro",2,"Nordeste",0,"290990",4,37,11,26,21,16,1,0,1,0,1,38,11,27,21,17,16,9.13129824688623,10.4598408815781,0.379292221658765,30
"5512","BA","Curaçá",34886,9240.01,29004,"Juazeiro",2,"Nordeste",0,"290990",5,36,13,23,23,13,0,0,0,0,0,36,13,23,23,13,18,9.13129824688623,10.4598408815781,0.381147844173969,31
"5513","BA","Dário Meira",10525,8302.03,29028,"Vitória da Conquista",2,"Nordeste",0,"291000",2,6,1,5,2,4,0,0,0,0,0,6,1,5,2,4,5,9.02425534219354,9.26150865855058,0.308578246424723,29
"5514","BA","Dário Meira",10525,8302.03,29028,"Vitória da Conquista",2,"Nordeste",0,"291000",3,11,7,4,7,4,0,0,0,0,0,11,7,4,7,4,8,9.02425534219354,9.26150865855058,0.375056584895919,31
"5515","BA","Dário Meira",10525,8302.03,29028,"Vitória da Conquista",2,"Nordeste",0,"291000",4,11,4,7,6,5,0,0,0,0,0,11,4,7,6,5,9,9.02425534219354,9.26150865855058,0.392022169409109,30
"5516","BA","Dário Meira",10525,8302.03,29028,"Vitória da Conquista",2,"Nordeste",0,"291000",5,12,2,10,8,4,0,0,0,0,0,12,2,10,8,4,8,9.02425534219354,9.26150865855058,0.425573380169482,31
"5517","BA","Dias d'Ávila",82432,36526.22,29021,"Salvador",2,"Nordeste",1,"291005",2,76,22,54,29,47,2,1,1,2,0,78,23,55,31,47,37,10.5057856378407,11.319728990024,0.289374187511701,29
"5518","BA","Dias d'Ávila",82432,36526.22,29021,"Salvador",2,"Nordeste",1,"291005",3,68,20,48,26,42,3,0,3,1,2,71,20,51,27,44,39,10.5057856378407,11.319728990024,0.383679380923644,31
"5519","BA","Dias d'Ávila",82432,36526.22,29021,"Salvador",2,"Nordeste",1,"291005",4,75,19,56,31,44,1,0,1,1,0,76,19,57,32,44,40,10.5057856378407,11.319728990024,0.445811059082817,30
"5520","BA","Dias d'Ávila",82432,36526.22,29021,"Salvador",2,"Nordeste",1,"291005",5,73,19,54,27,46,1,1,0,0,1,74,20,54,27,47,39,10.5057856378407,11.319728990024,0.428720504880341,31
"5521","BA","Dom Basílio",12240,9129.47,29025,"Livramento do Brumado",2,"Nordeste",0,"291010",2,17,6,11,6,11,0,0,0,0,0,17,6,11,6,11,6,9.11926292152067,9.41246455606632,0.283307110718764,29
"5522","BA","Dom Basílio",12240,9129.47,29025,"Livramento do Brumado",2,"Nordeste",0,"291010",3,6,3,3,0,6,0,0,0,0,0,6,3,3,0,6,7,9.11926292152067,9.41246455606632,0.390406844762419,31
"5523","BA","Dom Basílio",12240,9129.47,29025,"Livramento do Brumado",2,"Nordeste",0,"291010",4,3,0,3,1,2,0,0,0,0,0,3,0,3,1,2,3,9.11926292152067,9.41246455606632,0.375855659824187,30
"5524","BA","Dom Basílio",12240,9129.47,29025,"Livramento do Brumado",2,"Nordeste",0,"291010",5,9,2,7,4,5,0,0,0,0,0,9,2,7,4,5,5,9.11926292152067,9.41246455606632,0.404542062342562,31
"5525","BA","Elísio Medrado",8126,7109.8,29012,"Feira de Santana",2,"Nordeste",0,"291030",2,5,1,4,1,4,0,0,0,0,0,5,1,4,1,4,7,8.86922939300643,9.00282407654767,0.297591961147495,29
"5526","BA","Elísio Medrado",8126,7109.8,29012,"Feira de Santana",2,"Nordeste",0,"291030",3,4,1,3,1,3,0,0,0,0,0,4,1,3,1,3,9,8.86922939300643,9.00282407654767,0.374261539769233,31
"5527","BA","Elísio Medrado",8126,7109.8,29012,"Feira de Santana",2,"Nordeste",0,"291030",4,9,0,9,3,6,0,0,0,0,0,9,0,9,3,6,8,8.86922939300643,9.00282407654767,0.39083059044203,30
"5528","BA","Elísio Medrado",8126,7109.8,29012,"Feira de Santana",2,"Nordeste",0,"291030",5,5,1,4,3,2,0,0,0,0,0,5,1,4,3,2,6,8.86922939300643,9.00282407654767,0.401711044506363,31
"5529","BA","Encruzilhada",16446,10359.26,29029,"Itapetinga",2,"Nordeste",0,"291040",2,24,15,9,15,9,0,0,0,0,0,24,15,9,15,9,8,9.2456360846909,9.70783756553084,0.299136900517154,29
"5530","BA","Encruzilhada",16446,10359.26,29029,"Itapetinga",2,"Nordeste",0,"291040",3,24,8,16,5,19,0,0,0,0,0,24,8,16,5,19,10,9.2456360846909,9.70783756553084,0.373235448061696,31
"5531","BA","Encruzilhada",16446,10359.26,29029,"Itapetinga",2,"Nordeste",0,"291040",4,16,6,10,8,8,0,0,0,0,0,16,6,10,8,8,10,9.2456360846909,9.70783756553084,0.359588513617407,30
"5532","BA","Encruzilhada",16446,10359.26,29029,"Itapetinga",2,"Nordeste",0,"291040",5,13,9,4,6,7,0,0,0,0,0,13,9,4,6,7,5,9.2456360846909,9.70783756553084,0.394184308100447,31
"5533","BA","Entre Rios",41901,13407.68,29018,"Entre Rios",2,"Nordeste",0,"291050",2,27,7,20,11,16,1,0,1,0,1,28,7,21,11,17,15,9.50358295608861,10.6430649719739,0.263041844092059,29
"5534","BA","Entre Rios",41901,13407.68,29018,"Entre Rios",2,"Nordeste",0,"291050",3,15,3,12,3,12,1,0,1,1,0,16,3,13,4,12,12,9.50358295608861,10.6430649719739,0.355382041607045,31
"5535","BA","Entre Rios",41901,13407.68,29018,"Entre Rios",2,"Nordeste",0,"291050",4,24,10,14,12,12,2,1,1,0,2,26,11,15,12,14,13,9.50358295608861,10.6430649719739,0.380259130909065,30
"5536","BA","Entre Rios",41901,13407.68,29018,"Entre Rios",2,"Nordeste",0,"291050",5,21,9,12,8,13,0,0,0,0,0,21,9,12,8,13,25,9.50358295608861,10.6430649719739,0.38531169844375,31
"5537","BA","Esplanada",37578,17024.93,29018,"Entre Rios",2,"Nordeste",0,"291060",2,28,16,12,14,14,1,0,1,0,1,29,16,13,14,15,17,9.74243401940867,10.5341740517535,0.287347889638027,29
"5538","BA","Esplanada",37578,17024.93,29018,"Entre Rios",2,"Nordeste",0,"291060",3,45,17,28,19,26,0,0,0,0,0,45,17,28,19,26,19,9.74243401940867,10.5341740517535,0.39243296273091,31
"5539","BA","Esplanada",37578,17024.93,29018,"Entre Rios",2,"Nordeste",0,"291060",4,23,8,15,11,12,0,0,0,0,0,23,8,15,11,12,14,9.74243401940867,10.5341740517535,0.404525986377877,30
"5540","BA","Esplanada",37578,17024.93,29018,"Entre Rios",2,"Nordeste",0,"291060",5,30,11,19,14,16,1,1,0,0,1,31,12,19,14,17,16,9.74243401940867,10.5341740517535,0.396740446855146,31
"5541","BA","Euclides da Cunha",60858,9236.04,29014,"Euclides da Cunha",2,"Nordeste",0,"291070",2,54,22,32,24,30,0,0,0,0,0,54,22,32,24,30,33,9.13086850134418,11.0162985606041,0.267702839411307,29
"5542","BA","Euclides da Cunha",60858,9236.04,29014,"Euclides da Cunha",2,"Nordeste",0,"291070",3,55,22,33,25,30,1,1,0,0,1,56,23,33,25,31,31,9.13086850134418,11.0162985606041,0.352143757651335,31
"5543","BA","Euclides da Cunha",60858,9236.04,29014,"Euclides da Cunha",2,"Nordeste",0,"291070",4,42,21,21,21,21,1,1,0,0,1,43,22,21,21,22,26,9.13086850134418,11.0162985606041,0.407004875479558,30
"5544","BA","Euclides da Cunha",60858,9236.04,29014,"Euclides da Cunha",2,"Nordeste",0,"291070",5,52,25,27,24,28,0,0,0,0,0,52,25,27,24,28,35,9.13086850134418,11.0162985606041,0.396358995089034,31
"5545","BA","Eunápolis",114396,25735.13,29032,"Porto Seguro",2,"Nordeste",1,"291072",2,113,29,84,42,71,2,1,1,0,2,115,30,85,42,73,73,10.1556122635604,11.6474213922816,0.27511177879435,29
"5546","BA","Eunápolis",114396,25735.13,29032,"Porto Seguro",2,"Nordeste",1,"291072",3,129,33,96,56,73,2,1,1,1,1,131,34,97,57,74,56,10.1556122635604,11.6474213922816,0.362744056274096,31
"5547","BA","Eunápolis",114396,25735.13,29032,"Porto Seguro",2,"Nordeste",1,"291072",4,121,37,84,48,73,2,1,1,1,1,123,38,85,49,74,59,10.1556122635604,11.6474213922816,0.396639111450876,30
"5548","BA","Eunápolis",114396,25735.13,29032,"Porto Seguro",2,"Nordeste",1,"291072",5,120,44,76,45,75,0,0,0,0,0,120,44,76,45,75,80,10.1556122635604,11.6474213922816,0.391452135020448,31
"5549","BA","Fátima",17845,9681.7,29015,"Ribeira do Pombal",2,"Nordeste",0,"291075",2,13,7,6,4,9,0,0,0,0,0,13,7,6,4,9,3,9.17799278468598,9.78947863592426,0.271220879711601,29
"5550","BA","Fátima",17845,9681.7,29015,"Ribeira do Pombal",2,"Nordeste",0,"291075",3,19,6,13,6,13,1,1,0,0,1,20,7,13,6,14,11,9.17799278468598,9.78947863592426,0.357730448778084,31
"5551","BA","Fátima",17845,9681.7,29015,"Ribeira do Pombal",2,"Nordeste",0,"291075",4,18,7,11,10,8,0,0,0,0,0,18,7,11,10,8,12,9.17799278468598,9.78947863592426,0.406542827987726,30
"5552","BA","Fátima",17845,9681.7,29015,"Ribeira do Pombal",2,"Nordeste",0,"291075",5,18,7,11,4,14,0,0,0,0,0,18,7,11,4,14,9,9.17799278468598,9.78947863592426,0.4015938658181,31
"5553","BA","Feira de Santana",619609,24074.06,29012,"Feira de Santana",2,"Nordeste",1,"291080",2,598,157,441,214,384,5,1,4,1,4,603,158,445,215,388,295,10.0888901912519,13.3368439129197,0.274748361043599,29
"5554","BA","Feira de Santana",619609,24074.06,29012,"Feira de Santana",2,"Nordeste",1,"291080",3,651,177,474,222,429,5,4,1,3,2,656,181,475,225,431,374,10.0888901912519,13.3368439129197,0.376540786764296,31
"5555","BA","Feira de Santana",619609,24074.06,29012,"Feira de Santana",2,"Nordeste",1,"291080",4,606,154,452,187,419,8,3,5,2,6,614,157,457,189,425,331,10.0888901912519,13.3368439129197,0.419842845899174,30
"5556","BA","Feira de Santana",619609,24074.06,29012,"Feira de Santana",2,"Nordeste",1,"291080",5,651,149,502,216,435,7,1,6,2,5,658,150,508,218,440,381,10.0888901912519,13.3368439129197,0.393223843263017,31
"5557","BA","Filadélfia",16345,7291.65,29008,"Senhor do Bonfim",2,"Nordeste",0,"291085",2,12,2,10,7,5,0,0,0,0,0,12,2,10,7,5,8,8.89448513684081,9.70167731915831,0.286931667924927,29
"5558","BA","Filadélfia",16345,7291.65,29008,"Senhor do Bonfim",2,"Nordeste",0,"291085",3,12,1,11,3,9,0,0,0,0,0,12,1,11,3,9,12,8.89448513684081,9.70167731915831,0.366463115476522,31
"5559","BA","Filadélfia",16345,7291.65,29008,"Senhor do Bonfim",2,"Nordeste",0,"291085",4,22,9,13,13,9,1,1,0,0,1,23,10,13,13,10,9,8.89448513684081,9.70167731915831,0.38520452517692,30
"5560","BA","Filadélfia",16345,7291.65,29008,"Senhor do Bonfim",2,"Nordeste",0,"291085",5,17,7,10,8,9,0,0,0,0,0,17,7,10,8,9,11,8.89448513684081,9.70167731915831,0.37788250076103,31
"5561","BA","Firmino Alves",5629,8586.85,29031,"Ilhéus-Itabuna",2,"Nordeste",0,"291090",2,10,6,4,1,9,0,0,0,0,0,10,6,4,1,9,1,9.05798724225393,8.63568708546403,0.328219151930563,29
"5562","BA","Firmino Alves",5629,8586.85,29031,"Ilhéus-Itabuna",2,"Nordeste",0,"291090",3,1,0,1,0,1,0,0,0,0,0,1,0,1,0,1,4,9.05798724225393,8.63568708546403,0.390486067494665,31
"5563","BA","Firmino Alves",5629,8586.85,29031,"Ilhéus-Itabuna",2,"Nordeste",0,"291090",4,4,1,3,1,3,0,0,0,0,0,4,1,3,1,3,3,9.05798724225393,8.63568708546403,0.403038225661121,30
"5564","BA","Firmino Alves",5629,8586.85,29031,"Ilhéus-Itabuna",2,"Nordeste",0,"291090",5,1,1,0,1,0,0,0,0,0,0,1,1,0,1,0,2,9.05798724225393,8.63568708546403,0.373317597743644,31
"5565","BA","Floresta Azul",10575,7384.34,29031,"Ilhéus-Itabuna",2,"Nordeste",0,"291100",2,15,6,9,8,7,0,0,0,0,0,15,6,9,8,7,6,8.90711682062642,9.26624800391448,0.297139477232711,29
"5566","BA","Floresta Azul",10575,7384.34,29031,"Ilhéus-Itabuna",2,"Nordeste",0,"291100",3,12,3,9,5,7,0,0,0,0,0,12,3,9,5,7,3,8.90711682062642,9.26624800391448,0.404044987162085,31
"5567","BA","Floresta Azul",10575,7384.34,29031,"Ilhéus-Itabuna",2,"Nordeste",0,"291100",4,9,3,6,4,5,0,0,0,0,0,9,3,6,4,5,4,8.90711682062642,9.26624800391448,0.434894119312177,30
"5568","BA","Floresta Azul",10575,7384.34,29031,"Ilhéus-Itabuna",2,"Nordeste",0,"291100",5,7,2,5,4,3,0,0,0,0,0,7,2,5,4,3,5,8.90711682062642,9.26624800391448,0.416173564915491,31
"5569","BA","Formosa do Rio Preto",25857,106481.34,29001,"Barreiras",2,"Nordeste",0,"291110",2,32,6,26,15,17,0,0,0,0,0,32,6,26,15,17,10,11.5757250375127,10.1603366363155,0.240918251902684,29
"5570","BA","Formosa do Rio Preto",25857,106481.34,29001,"Barreiras",2,"Nordeste",0,"291110",3,31,10,21,18,13,0,0,0,0,0,31,10,21,18,13,9,11.5757250375127,10.1603366363155,0.316759504767473,31
"5571","BA","Formosa do Rio Preto",25857,106481.34,29001,"Barreiras",2,"Nordeste",0,"291110",4,34,13,21,17,17,1,1,0,0,1,35,14,21,17,18,8,11.5757250375127,10.1603366363155,0.338491680212739,30
"5572","BA","Formosa do Rio Preto",25857,106481.34,29001,"Barreiras",2,"Nordeste",0,"291110",5,43,17,26,26,17,0,0,0,0,0,43,17,26,26,17,8,11.5757250375127,10.1603366363155,0.360400703396855,31
"5573","BA","Gandu",32596,11199.11,29031,"Ilhéus-Itabuna",2,"Nordeste",1,"291120",2,30,10,20,9,21,0,0,0,0,0,30,10,20,9,21,15,9.32358958984002,10.3919448604401,0.256221849353827,29
"5574","BA","Gandu",32596,11199.11,29031,"Ilhéus-Itabuna",2,"Nordeste",1,"291120",3,30,14,16,16,14,0,0,0,0,0,30,14,16,16,14,12,9.32358958984002,10.3919448604401,0.334244695282659,31
"5575","BA","Gandu",32596,11199.11,29031,"Ilhéus-Itabuna",2,"Nordeste",1,"291120",4,25,8,17,12,13,0,0,0,0,0,25,8,17,12,13,21,9.32358958984002,10.3919448604401,0.384542577638486,30
"5576","BA","Gandu",32596,11199.11,29031,"Ilhéus-Itabuna",2,"Nordeste",1,"291120",5,25,8,17,14,11,4,1,3,2,2,29,9,20,16,13,12,9.32358958984002,10.3919448604401,0.369923155160029,31
"5577","BA","Gentio do Ouro",11259,13219.03,29009,"Irecê",2,"Nordeste",0,"291130",2,17,6,11,7,10,0,0,0,0,0,17,6,11,7,10,9,9.48941273703745,9.32892308780313,0.294154788743695,29
"5578","BA","Gentio do Ouro",11259,13219.03,29009,"Irecê",2,"Nordeste",0,"291130",3,9,1,8,3,6,0,0,0,0,0,9,1,8,3,6,1,9.48941273703745,9.32892308780313,0.378678526253172,31
"5579","BA","Gentio do Ouro",11259,13219.03,29009,"Irecê",2,"Nordeste",0,"291130",4,7,2,5,3,4,0,0,0,0,0,7,2,5,3,4,6,9.48941273703745,9.32892308780313,0.415938222657864,30
"5580","BA","Gentio do Ouro",11259,13219.03,29009,"Irecê",2,"Nordeste",0,"291130",5,9,2,7,3,6,1,0,1,0,1,10,2,8,3,7,5,9.48941273703745,9.32892308780313,0.409405798911314,31
"5581","BA","Glória",15234,11236.96,29005,"Paulo Afonso",2,"Nordeste",0,"291140",2,21,6,15,12,9,0,0,0,0,0,21,6,15,12,9,6,9.32696362423262,9.63128505093273,0.343887664755943,29
"5582","BA","Glória",15234,11236.96,29005,"Paulo Afonso",2,"Nordeste",0,"291140",3,14,5,9,4,10,0,0,0,0,0,14,5,9,4,10,9,9.32696362423262,9.63128505093273,0.429844229588239,31
"5583","BA","Glória",15234,11236.96,29005,"Paulo Afonso",2,"Nordeste",0,"291140",4,14,4,10,8,6,0,0,0,0,0,14,4,10,8,6,5,9.32696362423262,9.63128505093273,0.468612159191652,30
"5584","BA","Glória",15234,11236.96,29005,"Paulo Afonso",2,"Nordeste",0,"291140",5,20,9,11,11,9,0,0,0,0,0,20,9,11,11,9,6,9.32696362423262,9.63128505093273,0.473385364530144,31
"5585","BA","Gongogi",6985,8058.7,29031,"Ilhéus-Itabuna",2,"Nordeste",0,"291150",2,6,1,5,3,3,0,0,0,0,0,6,1,5,3,3,3,8.99450753216941,8.85152027169106,0.328230301905495,29
"5586","BA","Gongogi",6985,8058.7,29031,"Ilhéus-Itabuna",2,"Nordeste",0,"291150",3,4,1,3,1,3,0,0,0,0,0,4,1,3,1,3,4,8.99450753216941,8.85152027169106,0.41743029017973,31
"5587","BA","Gongogi",6985,8058.7,29031,"Ilhéus-Itabuna",2,"Nordeste",0,"291150",4,5,2,3,4,1,0,0,0,0,0,5,2,3,4,1,5,8.99450753216941,8.85152027169106,0.448583471190891,30
"5588","BA","Gongogi",6985,8058.7,29031,"Ilhéus-Itabuna",2,"Nordeste",0,"291150",5,5,1,4,2,3,0,0,0,0,0,5,1,4,2,3,2,8.99450753216941,8.85152027169106,0.417760249993057,31
"5589","BA","Governador Mangabeira",20762,8678.35,29020,"Santo Antônio de Jesus",2,"Nordeste",1,"291160",2,20,7,13,10,10,1,1,0,1,0,21,8,13,11,10,13,9.06858669741869,9.94087967175319,0.290761809909101,29
"5590","BA","Governador Mangabeira",20762,8678.35,29020,"Santo Antônio de Jesus",2,"Nordeste",1,"291160",3,18,4,14,6,12,0,0,0,0,0,18,4,14,6,12,7,9.06858669741869,9.94087967175319,0.382964694556905,31
"5591","BA","Governador Mangabeira",20762,8678.35,29020,"Santo Antônio de Jesus",2,"Nordeste",1,"291160",4,17,2,15,4,13,0,0,0,0,0,17,2,15,4,13,7,9.06858669741869,9.94087967175319,0.426536949302688,30
"5592","BA","Governador Mangabeira",20762,8678.35,29020,"Santo Antônio de Jesus",2,"Nordeste",1,"291160",5,21,7,14,12,9,0,0,0,0,0,21,7,14,12,9,17,9.06858669741869,9.94087967175319,0.412949203427634,31
"5593","BA","Guanambi",84928,15961.44,29026,"Guanambi",2,"Nordeste",1,"291170",2,99,12,87,26,73,0,0,0,0,0,99,12,87,26,73,45,9.67793109249763,11.3495591176919,0.27904685979208,29
"5594","BA","Guanambi",84928,15961.44,29026,"Guanambi",2,"Nordeste",1,"291170",3,97,24,73,33,64,0,0,0,0,0,97,24,73,33,64,34,9.67793109249763,11.3495591176919,0.361036530140951,31
"5595","BA","Guanambi",84928,15961.44,29026,"Guanambi",2,"Nordeste",1,"291170",4,80,16,64,24,56,0,0,0,0,0,80,16,64,24,56,44,9.67793109249763,11.3495591176919,0.388400321734136,30
"5596","BA","Guanambi",84928,15961.44,29026,"Guanambi",2,"Nordeste",1,"291170",5,100,18,82,34,66,1,1,0,0,1,101,19,82,34,67,42,9.67793109249763,11.3495591176919,0.381999192616508,31
"5597","BA","Guaratinga",20700,9374.74,29032,"Porto Seguro",2,"Nordeste",0,"291180",2,16,5,11,7,9,2,2,0,1,1,18,7,11,8,10,4,9.1457741171207,9.93788897925346,0.334075309782986,29
"5598","BA","Guaratinga",20700,9374.74,29032,"Porto Seguro",2,"Nordeste",0,"291180",3,10,5,5,5,5,0,0,0,0,0,10,5,5,5,5,6,9.1457741171207,9.93788897925346,0.387792913636903,31
"5599","BA","Guaratinga",20700,9374.74,29032,"Porto Seguro",2,"Nordeste",0,"291180",4,20,13,7,10,10,1,1,0,0,1,21,14,7,10,11,16,9.1457741171207,9.93788897925346,0.389687093182145,30
"5600","BA","Guaratinga",20700,9374.74,29032,"Porto Seguro",2,"Nordeste",0,"291180",5,14,8,6,8,6,0,0,0,0,0,14,8,6,8,6,15,9.1457741171207,9.93788897925346,0.402347012538893,31
"5601","BA","Heliópolis",12987,7337.22,29015,"Ribeira do Pombal",2,"Nordeste",0,"291185",2,12,2,10,5,7,0,0,0,0,0,12,2,10,5,7,7,8.90071530327195,9.47170413611009,0.293606289663584,29
"5602","BA","Heliópolis",12987,7337.22,29015,"Ribeira do Pombal",2,"Nordeste",0,"291185",3,7,2,5,4,3,0,0,0,0,0,7,2,5,4,3,5,8.90071530327195,9.47170413611009,0.396594405389948,31
"5603","BA","Heliópolis",12987,7337.22,29015,"Ribeira do Pombal",2,"Nordeste",0,"291185",4,9,4,5,3,6,0,0,0,0,0,9,4,5,3,6,7,8.90071530327195,9.47170413611009,0.421376951170674,30
"5604","BA","Heliópolis",12987,7337.22,29015,"Ribeira do Pombal",2,"Nordeste",0,"291185",5,14,6,8,10,4,0,0,0,0,0,14,6,8,10,4,2,8.90071530327195,9.47170413611009,0.434913256229475,31
"5605","BA","Iaçu",24121,8247.06,29011,"Itaberaba",2,"Nordeste",0,"291190",2,32,11,21,17,15,0,0,0,0,0,32,11,21,17,15,12,9.01761205217975,10.0908381093515,0.272931286924908,29
"5606","BA","Iaçu",24121,8247.06,29011,"Itaberaba",2,"Nordeste",0,"291190",3,33,15,18,17,16,0,0,0,0,0,33,15,18,17,16,21,9.01761205217975,10.0908381093515,0.348568213442485,31
"5607","BA","Iaçu",24121,8247.06,29011,"Itaberaba",2,"Nordeste",0,"291190",4,26,9,17,13,13,0,0,0,0,0,26,9,17,13,13,21,9.01761205217975,10.0908381093515,0.367449513774833,30
"5608","BA","Iaçu",24121,8247.06,29011,"Itaberaba",2,"Nordeste",0,"291190",5,33,14,19,15,18,0,0,0,0,0,33,14,19,15,18,23,9.01761205217975,10.0908381093515,0.394901225952476,31
"5609","BA","Ibiassucê",9031,8707.34,29026,"Guanambi",2,"Nordeste",0,"291200",2,2,0,2,0,2,0,0,0,0,0,2,0,2,0,2,7,9.07192162710722,9.1084183822508,0.250975646848881,29
"5610","BA","Ibiassucê",9031,8707.34,29026,"Guanambi",2,"Nordeste",0,"291200",3,7,1,6,1,6,0,0,0,0,0,7,1,6,1,6,6,9.07192162710722,9.1084183822508,0.341096576176992,31
"5611","BA","Ibiassucê",9031,8707.34,29026,"Guanambi",2,"Nordeste",0,"291200",4,9,1,8,0,9,0,0,0,0,0,9,1,8,0,9,3,9.07192162710722,9.1084183822508,0.351847845242692,30
"5612","BA","Ibiassucê",9031,8707.34,29026,"Guanambi",2,"Nordeste",0,"291200",5,5,3,2,3,2,0,0,0,0,0,5,3,2,3,2,6,9.07192162710722,9.1084183822508,0.340156876098846,31
"5613","BA","Ibicaraí",21378,8295.7,29031,"Ilhéus-Itabuna",2,"Nordeste",0,"291210",2,14,9,5,6,8,0,0,0,0,0,14,9,5,6,8,21,9.02349258724972,9.97011763483389,0.305526825224298,29
"5614","BA","Ibicaraí",21378,8295.7,29031,"Ilhéus-Itabuna",2,"Nordeste",0,"291210",3,16,4,12,7,9,0,0,0,0,0,16,4,12,7,9,24,9.02349258724972,9.97011763483389,0.40618161065444,31
"5615","BA","Ibicaraí",21378,8295.7,29031,"Ilhéus-Itabuna",2,"Nordeste",0,"291210",4,15,6,9,7,8,0,0,0,0,0,15,6,9,7,8,18,9.02349258724972,9.97011763483389,0.456760389773085,30
"5616","BA","Ibicaraí",21378,8295.7,29031,"Ilhéus-Itabuna",2,"Nordeste",0,"291210",5,29,16,13,15,14,1,1,0,1,0,30,17,13,16,14,23,9.02349258724972,9.97011763483389,0.400257631733457,31
"5617","BA","Ibicoara",19786,15724.83,29023,"Seabra",2,"Nordeste",0,"291220",2,24,13,11,12,12,0,0,0,0,0,24,13,11,12,12,9,9.66299627069939,9.89272989588317,0.299270169327829,29
"5618","BA","Ibicoara",19786,15724.83,29023,"Seabra",2,"Nordeste",0,"291220",3,21,9,12,11,10,1,0,1,1,0,22,9,13,12,10,9,9.66299627069939,9.89272989588317,0.384297638819033,31
"5619","BA","Ibicoara",19786,15724.83,29023,"Seabra",2,"Nordeste",0,"291220",4,18,4,14,6,12,1,0,1,0,1,19,4,15,6,13,9,9.66299627069939,9.89272989588317,0.384333296106755,30
"5620","BA","Ibicoara",19786,15724.83,29023,"Seabra",2,"Nordeste",0,"291220",5,20,7,13,11,9,0,0,0,0,0,20,7,13,11,9,3,9.66299627069939,9.89272989588317,0.377834363317721,31
"5621","BA","Ibicuí",16230,9030.79,29028,"Vitória da Conquista",2,"Nordeste",0,"291230",2,9,2,7,4,5,0,0,0,0,0,9,2,7,4,5,6,9.10839512874159,9.69461666050864,0.287704863877465,29
"5622","BA","Ibicuí",16230,9030.79,29028,"Vitória da Conquista",2,"Nordeste",0,"291230",3,10,3,7,6,4,0,0,0,0,0,10,3,7,6,4,16,9.10839512874159,9.69461666050864,0.375440654797748,31
"5623","BA","Ibicuí",16230,9030.79,29028,"Vitória da Conquista",2,"Nordeste",0,"291230",4,8,4,4,1,7,0,0,0,0,0,8,4,4,1,7,10,9.10839512874159,9.69461666050864,0.377308884480024,30
"5624","BA","Ibicuí",16230,9030.79,29028,"Vitória da Conquista",2,"Nordeste",0,"291230",5,9,6,3,5,4,0,0,0,0,0,9,6,3,5,4,8,9.10839512874159,9.69461666050864,0.371909443377989,31
"5625","BA","Ibipeba",18319,7404.56,29009,"Irecê",2,"Nordeste",0,"291240",2,7,3,4,6,1,0,0,0,0,0,7,3,4,6,1,11,8.90985130562523,9.81569405158546,0.330945066105371,29
"5626","BA","Ibipeba",18319,7404.56,29009,"Irecê",2,"Nordeste",0,"291240",3,13,5,8,7,6,0,0,0,0,0,13,5,8,7,6,8,8.90985130562523,9.81569405158546,0.437862755458295,31
"5627","BA","Ibipeba",18319,7404.56,29009,"Irecê",2,"Nordeste",0,"291240",4,12,4,8,4,8,2,0,2,2,0,14,4,10,6,8,9,8.90985130562523,9.81569405158546,0.451406076229328,30
"5628","BA","Ibipeba",18319,7404.56,29009,"Irecê",2,"Nordeste",0,"291240",5,17,6,11,10,7,0,0,0,0,0,17,6,11,10,7,12,8.90985130562523,9.81569405158546,0.430302507044506,31
"5629","BA","Ibipitanga",14947,6786.76,29022,"Boquira",2,"Nordeste",0,"291250",2,5,0,5,3,2,0,0,0,0,0,5,0,5,3,2,5,8.82272893435758,9.61226588978581,0.274885095522066,29
"5630","BA","Ibipitanga",14947,6786.76,29022,"Boquira",2,"Nordeste",0,"291250",3,8,3,5,3,5,0,0,0,0,0,8,3,5,3,5,10,8.82272893435758,9.61226588978581,0.371737122856186,31
"5631","BA","Ibipitanga",14947,6786.76,29022,"Boquira",2,"Nordeste",0,"291250",4,2,0,2,1,1,2,1,1,0,2,4,1,3,1,3,10,8.82272893435758,9.61226588978581,0.396644549575711,30
"5632","BA","Ibipitanga",14947,6786.76,29022,"Boquira",2,"Nordeste",0,"291250",5,4,0,4,1,3,0,0,0,0,0,4,0,4,1,3,5,8.82272893435758,9.61226588978581,0.404050452692833,31
"5633","BA","Ibirapitanga",23404,8427.53,29031,"Ilhéus-Itabuna",2,"Nordeste",0,"291270",2,20,11,9,12,8,1,1,0,0,1,21,12,9,12,9,17,9.03925900687643,10.0606622269081,0.305599216827137,29
"5634","BA","Ibirapitanga",23404,8427.53,29031,"Ilhéus-Itabuna",2,"Nordeste",0,"291270",3,17,8,9,10,7,0,0,0,0,0,17,8,9,10,7,14,9.03925900687643,10.0606622269081,0.38004896078531,31
"5635","BA","Ibirapitanga",23404,8427.53,29031,"Ilhéus-Itabuna",2,"Nordeste",0,"291270",4,23,14,9,11,12,1,1,0,1,0,24,15,9,12,12,16,9.03925900687643,10.0606622269081,0.410836521611183,30
"5636","BA","Ibirapitanga",23404,8427.53,29031,"Ilhéus-Itabuna",2,"Nordeste",0,"291270",5,29,13,16,20,9,1,1,0,0,1,30,14,16,20,10,7,9.03925900687643,10.0606622269081,0.40727281559202,31
"5637","BA","Ibirapuã",8690,32641.24,29032,"Porto Seguro",2,"Nordeste",0,"291280",2,10,4,6,4,6,0,0,0,0,0,10,4,6,4,6,3,10.3933317985525,9.06992821825944,0.291899062235943,29
"5638","BA","Ibirapuã",8690,32641.24,29032,"Porto Seguro",2,"Nordeste",0,"291280",3,10,4,6,4,6,0,0,0,0,0,10,4,6,4,6,4,10.3933317985525,9.06992821825944,0.403309545758774,31
"5639","BA","Ibirapuã",8690,32641.24,29032,"Porto Seguro",2,"Nordeste",0,"291280",4,8,5,3,3,5,0,0,0,0,0,8,5,3,3,5,2,10.3933317985525,9.06992821825944,0.37869592048351,30
"5640","BA","Ibirapuã",8690,32641.24,29032,"Porto Seguro",2,"Nordeste",0,"291280",5,10,3,7,6,4,0,0,0,0,0,10,3,7,6,4,6,10.3933317985525,9.06992821825944,0.38756194636857,31
"5641","BA","Ibirataia",14882,10624.97,29031,"Ilhéus-Itabuna",2,"Nordeste",0,"291290",2,11,4,7,4,7,0,0,0,0,0,11,4,7,4,7,11,9.27096217025922,9.60790770795721,0.282408705127901,29
"5642","BA","Ibirataia",14882,10624.97,29031,"Ilhéus-Itabuna",2,"Nordeste",0,"291290",3,17,6,11,5,12,1,0,1,1,0,18,6,12,6,12,22,9.27096217025922,9.60790770795721,0.347811763922587,31
"5643","BA","Ibirataia",14882,10624.97,29031,"Ilhéus-Itabuna",2,"Nordeste",0,"291290",4,17,10,7,6,11,0,0,0,0,0,17,10,7,6,11,15,9.27096217025922,9.60790770795721,0.413687494610233,30
"5644","BA","Ibirataia",14882,10624.97,29031,"Ilhéus-Itabuna",2,"Nordeste",0,"291290",5,32,12,20,12,20,0,0,0,0,0,32,12,20,12,20,15,9.27096217025922,9.60790770795721,0.377995321336014,31
"5645","BA","Ibitiara",16403,6081.83,29022,"Boquira",2,"Nordeste",0,"291300",2,10,3,7,4,6,0,0,0,0,0,10,3,7,4,6,12,8.71306091651487,9.70521952391249,0.269081019420153,29
"5646","BA","Ibitiara",16403,6081.83,29022,"Boquira",2,"Nordeste",0,"291300",3,5,0,5,3,2,0,0,0,0,0,5,0,5,3,2,7,8.71306091651487,9.70521952391249,0.336351116236465,31
"5647","BA","Ibitiara",16403,6081.83,29022,"Boquira",2,"Nordeste",0,"291300",4,2,1,1,1,1,0,0,0,0,0,2,1,1,1,1,11,8.71306091651487,9.70521952391249,0.352869712718754,30
"5648","BA","Ibitiara",16403,6081.83,29022,"Boquira",2,"Nordeste",0,"291300",5,7,1,6,3,4,0,0,0,0,0,7,1,6,3,4,18,8.71306091651487,9.70521952391249,0.39722380487219,31
"5649","BA","Ibititá",17080,6949.28,29009,"Irecê",2,"Nordeste",0,"291310",2,17,5,12,6,11,0,0,0,0,0,17,5,12,6,11,4,8.84639333606998,9.74566346734256,0.295106283479883,29
"5650","BA","Ibititá",17080,6949.28,29009,"Irecê",2,"Nordeste",0,"291310",3,11,2,9,3,8,0,0,0,0,0,11,2,9,3,8,8,8.84639333606998,9.74566346734256,0.395639321103637,31
"5651","BA","Ibititá",17080,6949.28,29009,"Irecê",2,"Nordeste",0,"291310",4,15,4,11,8,7,0,0,0,0,0,15,4,11,8,7,9,8.84639333606998,9.74566346734256,0.416095939046103,30
"5652","BA","Ibititá",17080,6949.28,29009,"Irecê",2,"Nordeste",0,"291310",5,18,6,12,8,10,0,0,0,0,0,18,6,12,8,10,11,8.84639333606998,9.74566346734256,0.413699551425747,31
"5653","BA","Ibotirama",27003,12401.78,29006,"Barra",2,"Nordeste",0,"291320",2,27,6,21,10,17,0,0,0,0,0,27,6,21,10,17,13,9.42559528967814,10.2037032499252,0.257433611706923,29
"5654","BA","Ibotirama",27003,12401.78,29006,"Barra",2,"Nordeste",0,"291320",3,32,11,21,9,23,1,1,0,1,0,33,12,21,10,23,16,9.42559528967814,10.2037032499252,0.336342073904731,31
"5655","BA","Ibotirama",27003,12401.78,29006,"Barra",2,"Nordeste",0,"291320",4,24,8,16,9,15,0,0,0,0,0,24,8,16,9,15,15,9.42559528967814,10.2037032499252,0.355038082908581,30
"5656","BA","Ibotirama",27003,12401.78,29006,"Barra",2,"Nordeste",0,"291320",5,25,8,17,14,11,0,0,0,0,0,25,8,17,14,11,18,9.42559528967814,10.2037032499252,0.329882732880279,31
"5657","BA","Ichu",6220,6963.23,29016,"Serrinha",2,"Nordeste",0,"291330",2,1,0,1,0,1,0,0,0,0,0,1,0,1,0,1,4,8.8483987261362,8.73552518573323,0.277356016357596,29
"5658","BA","Ichu",6220,6963.23,29016,"Serrinha",2,"Nordeste",0,"291330",3,2,1,1,1,1,0,0,0,0,0,2,1,1,1,1,2,8.8483987261362,8.73552518573323,0.346683369544566,31
"5659","BA","Ichu",6220,6963.23,29016,"Serrinha",2,"Nordeste",0,"291330",4,2,0,2,0,2,0,0,0,0,0,2,0,2,0,2,2,8.8483987261362,8.73552518573323,0.383951895255146,30
"5660","BA","Ichu",6220,6963.23,29016,"Serrinha",2,"Nordeste",0,"291330",5,3,0,3,0,3,0,0,0,0,0,3,0,3,0,3,3,8.8483987261362,8.73552518573323,0.347806333440239,31
"5661","BA","Igaporã",15650,11445.7,29026,"Guanambi",2,"Nordeste",0,"291340",2,6,2,4,1,5,0,0,0,0,0,6,2,4,1,5,6,9.34536939259585,9.6582261959683,0.27321111434476,29
"5662","BA","Igaporã",15650,11445.7,29026,"Guanambi",2,"Nordeste",0,"291340",3,12,0,12,6,6,0,0,0,0,0,12,0,12,6,6,11,9.34536939259585,9.6582261959683,0.350578184361334,31
"5663","BA","Igaporã",15650,11445.7,29026,"Guanambi",2,"Nordeste",0,"291340",4,7,0,7,1,6,0,0,0,0,0,7,0,7,1,6,7,9.34536939259585,9.6582261959683,0.384076248873258,30
"5664","BA","Igaporã",15650,11445.7,29026,"Guanambi",2,"Nordeste",0,"291340",5,13,2,11,4,9,0,0,0,0,0,13,2,11,4,9,12,9.34536939259585,9.6582261959683,0.378037686416293,31
"5665","BA","Igrapiúna",13091,11067.21,29030,"Valença",2,"Nordeste",0,"291345",2,6,1,5,4,2,0,0,0,0,0,6,1,5,4,2,4,9.31174196141682,9.4796802501801,0.301206499837988,29
"5666","BA","Igrapiúna",13091,11067.21,29030,"Valença",2,"Nordeste",0,"291345",3,6,0,6,5,1,0,0,0,0,0,6,0,6,5,1,6,9.31174196141682,9.4796802501801,0.408507058984366,31
"5667","BA","Igrapiúna",13091,11067.21,29030,"Valença",2,"Nordeste",0,"291345",4,10,5,5,6,4,0,0,0,0,0,10,5,5,6,4,6,9.31174196141682,9.4796802501801,0.485143836462826,30
"5668","BA","Igrapiúna",13091,11067.21,29030,"Valença",2,"Nordeste",0,"291345",5,11,5,6,4,7,0,0,0,0,0,11,5,6,4,7,8,9.31174196141682,9.4796802501801,0.443448367069262,31
"5669","BA","Iguaí",26963,7177.34,29028,"Vitória da Conquista",2,"Nordeste",0,"291350",2,2,1,1,0,2,0,0,0,0,0,2,1,1,0,2,14,8.87868411986239,10.2022208347999,0.307257961947976,29
"5670","BA","Iguaí",26963,7177.34,29028,"Vitória da Conquista",2,"Nordeste",0,"291350",3,3,2,1,1,2,0,0,0,0,0,3,2,1,1,2,18,8.87868411986239,10.2022208347999,0.376616320370444,31
"5671","BA","Iguaí",26963,7177.34,29028,"Vitória da Conquista",2,"Nordeste",0,"291350",4,4,1,3,2,2,1,0,1,0,1,5,1,4,2,3,16,8.87868411986239,10.2022208347999,0.408285606754369,30
"5672","BA","Iguaí",26963,7177.34,29028,"Vitória da Conquista",2,"Nordeste",0,"291350",5,1,1,0,0,1,0,0,0,0,0,1,1,0,0,1,13,8.87868411986239,10.2022208347999,0.398443136720635,31
"5673","BA","Ilhéus",159923,25829.06,29031,"Ilhéus-Itabuna",2,"Nordeste",1,"291360",2,158,57,101,66,92,1,0,1,0,1,159,57,102,66,93,115,10.1592554936352,11.982447728378,0.301941425920775,29
"5674","BA","Ilhéus",159923,25829.06,29031,"Ilhéus-Itabuna",2,"Nordeste",1,"291360",3,165,53,112,71,94,2,1,1,2,0,167,54,113,73,94,137,10.1592554936352,11.982447728378,0.410604189246122,31
"5675","BA","Ilhéus",159923,25829.06,29031,"Ilhéus-Itabuna",2,"Nordeste",1,"291360",4,138,43,95,62,76,1,0,1,0,1,139,43,96,62,77,144,10.1592554936352,11.982447728378,0.504407348860208,30
"5676","BA","Ilhéus",159923,25829.06,29031,"Ilhéus-Itabuna",2,"Nordeste",1,"291360",5,157,49,108,67,90,0,0,0,0,0,157,49,108,67,90,149,10.1592554936352,11.982447728378,0.471194290300212,31
"5677","BA","Inhambupe",40333,16152.27,29017,"Alagoinhas",2,"Nordeste",0,"291370",2,16,8,8,3,13,0,0,0,0,0,16,8,8,3,13,25,9.6898158760491,10.6049252714138,0.271873118963812,29
"5678","BA","Inhambupe",40333,16152.27,29017,"Alagoinhas",2,"Nordeste",0,"291370",3,32,12,20,11,21,1,0,1,0,1,33,12,21,11,22,20,9.6898158760491,10.6049252714138,0.355820919579081,31
"5679","BA","Inhambupe",40333,16152.27,29017,"Alagoinhas",2,"Nordeste",0,"291370",4,35,12,23,14,21,0,0,0,0,0,35,12,23,14,21,21,9.6898158760491,10.6049252714138,0.385534788549993,30
"5680","BA","Inhambupe",40333,16152.27,29017,"Alagoinhas",2,"Nordeste",0,"291370",5,23,9,14,6,17,0,0,0,0,0,23,9,14,6,17,22,9.6898158760491,10.6049252714138,0.389616855822419,31
"5681","BA","Ipecaetá",14354,5475.96,29012,"Feira de Santana",2,"Nordeste",0,"291380",2,5,2,3,2,3,0,0,0,0,0,5,2,3,2,3,9,8.60812288177976,9.57178392799002,0.313140072963704,29
"5682","BA","Ipecaetá",14354,5475.96,29012,"Feira de Santana",2,"Nordeste",0,"291380",3,6,3,3,2,4,0,0,0,0,0,6,3,3,2,4,10,8.60812288177976,9.57178392799002,0.405208429515088,31
"5683","BA","Ipecaetá",14354,5475.96,29012,"Feira de Santana",2,"Nordeste",0,"291380",4,10,3,7,5,5,0,0,0,0,0,10,3,7,5,5,6,8.60812288177976,9.57178392799002,0.422861044500058,30
"5684","BA","Ipecaetá",14354,5475.96,29012,"Feira de Santana",2,"Nordeste",0,"291380",5,7,2,5,4,3,0,0,0,0,0,7,2,5,4,3,11,8.60812288177976,9.57178392799002,0.426448442528078,31
"5685","BA","Ipiaú",45922,9913.51,29031,"Ilhéus-Itabuna",2,"Nordeste",1,"291390",2,49,16,33,24,25,0,0,0,0,0,49,16,33,24,25,22,9.20165375230358,10.734699584052,0.272725806186395,29
"5686","BA","Ipiaú",45922,9913.51,29031,"Ilhéus-Itabuna",2,"Nordeste",1,"291390",3,31,13,18,11,20,0,0,0,0,0,31,13,18,11,20,39,9.20165375230358,10.734699584052,0.362807617969783,31
"5687","BA","Ipiaú",45922,9913.51,29031,"Ilhéus-Itabuna",2,"Nordeste",1,"291390",4,40,17,23,18,22,1,0,1,0,1,41,17,24,18,23,35,9.20165375230358,10.734699584052,0.427488777989973,30
"5688","BA","Ipiaú",45922,9913.51,29031,"Ilhéus-Itabuna",2,"Nordeste",1,"291390",5,43,13,30,21,22,1,1,0,1,0,44,14,30,22,22,27,9.20165375230358,10.734699584052,0.41858821578727,31
"5689","BA","Ipirá",59435,11085.75,29012,"Feira de Santana",2,"Nordeste",0,"291400",2,10,2,8,5,5,1,1,0,0,1,11,3,8,5,6,36,9.31341577876029,10.9926385574147,0.263331767312127,29
"5690","BA","Ipirá",59435,11085.75,29012,"Feira de Santana",2,"Nordeste",0,"291400",3,40,16,24,13,27,0,0,0,0,0,40,16,24,13,27,31,9.31341577876029,10.9926385574147,0.349300277775342,31
"5691","BA","Ipirá",59435,11085.75,29012,"Feira de Santana",2,"Nordeste",0,"291400",4,17,5,12,7,10,0,0,0,0,0,17,5,12,7,10,31,9.31341577876029,10.9926385574147,0.388041021227019,30
"5692","BA","Ipirá",59435,11085.75,29012,"Feira de Santana",2,"Nordeste",0,"291400",5,4,2,2,2,2,0,0,0,0,0,4,2,2,2,2,36,9.31341577876029,10.9926385574147,0.377330937282523,31
"5693","BA","Ipupiara",9911,8138.75,29022,"Boquira",2,"Nordeste",0,"291410",2,6,4,2,3,3,0,0,0,0,0,6,4,2,3,3,6,9.00439188455107,9.20140053040671,0.282394131284326,29
"5694","BA","Ipupiara",9911,8138.75,29022,"Boquira",2,"Nordeste",0,"291410",3,4,0,4,2,2,0,0,0,0,0,4,0,4,2,2,10,9.00439188455107,9.20140053040671,0.336142524180535,31
"5695","BA","Ipupiara",9911,8138.75,29022,"Boquira",2,"Nordeste",0,"291410",4,7,2,5,3,4,0,0,0,0,0,7,2,5,3,4,6,9.00439188455107,9.20140053040671,0.347051250389918,30
"5696","BA","Ipupiara",9911,8138.75,29022,"Boquira",2,"Nordeste",0,"291410",5,6,1,5,5,1,0,0,0,0,0,6,1,5,5,1,3,9.00439188455107,9.20140053040671,0.356480762855303,31
"5697","BA","Irajuba",7279,9719.84,29024,"Jequié",2,"Nordeste",0,"291420",2,4,3,1,3,1,0,0,0,0,0,4,3,1,3,1,7,9.18192443641365,8.89274876911826,0.309567818068869,29
"5698","BA","Irajuba",7279,9719.84,29024,"Jequié",2,"Nordeste",0,"291420",3,2,2,0,1,1,0,0,0,0,0,2,2,0,1,1,3,9.18192443641365,8.89274876911826,0.379855779116057,31
"5699","BA","Irajuba",7279,9719.84,29024,"Jequié",2,"Nordeste",0,"291420",4,3,1,2,1,2,0,0,0,0,0,3,1,2,1,2,7,9.18192443641365,8.89274876911826,0.398160607884025,30
"5700","BA","Irajuba",7279,9719.84,29024,"Jequié",2,"Nordeste",0,"291420",5,5,2,3,2,3,0,0,0,0,0,5,2,3,2,3,11,9.18192443641365,8.89274876911826,0.420684843570519,31
"5701","BA","Iramaia",8197,8200.69,29024,"Jequié",2,"Nordeste",0,"291430",2,4,3,1,4,0,0,0,0,0,0,4,3,1,4,0,8,9.0119735760537,9.01152351265303,0.3526410715232,29
"5702","BA","Iramaia",8197,8200.69,29024,"Jequié",2,"Nordeste",0,"291430",3,8,3,5,4,4,0,0,0,0,0,8,3,5,4,4,5,9.0119735760537,9.01152351265303,0.422345632664512,31
"5703","BA","Iramaia",8197,8200.69,29024,"Jequié",2,"Nordeste",0,"291430",4,14,4,10,5,9,0,0,0,0,0,14,4,10,5,9,6,9.0119735760537,9.01152351265303,0.428038300792941,30
"5704","BA","Iramaia",8197,8200.69,29024,"Jequié",2,"Nordeste",0,"291430",5,5,0,5,3,2,0,0,0,0,0,5,0,5,3,2,5,9.0119735760537,9.01152351265303,0.470122613088934,31
"5705","BA","Iraquara",25478,16169.78,29009,"Irecê",2,"Nordeste",0,"291440",2,14,3,11,6,8,0,0,0,0,0,14,3,11,6,8,16,9.69089934703642,10.1455706136697,0.295044351359397,29
"5706","BA","Iraquara",25478,16169.78,29009,"Irecê",2,"Nordeste",0,"291440",3,13,2,11,8,5,0,0,0,0,0,13,2,11,8,5,12,9.69089934703642,10.1455706136697,0.386278289878125,31
"5707","BA","Iraquara",25478,16169.78,29009,"Irecê",2,"Nordeste",0,"291440",4,9,3,6,2,7,0,0,0,0,0,9,3,6,2,7,11,9.69089934703642,10.1455706136697,0.412613194470344,30
"5708","BA","Iraquara",25478,16169.78,29009,"Irecê",2,"Nordeste",0,"291440",5,1,0,1,1,0,0,0,0,0,0,1,0,1,1,0,14,9.69089934703642,10.1455706136697,0.396090269320085,31
"5709","BA","Irará",29173,8742.97,29012,"Feira de Santana",2,"Nordeste",0,"291450",2,20,7,13,6,14,0,0,0,0,0,20,7,13,6,14,19,9.07600522785852,10.2809989029626,0.266984853858987,29
"5710","BA","Irará",29173,8742.97,29012,"Feira de Santana",2,"Nordeste",0,"291450",3,9,2,7,3,6,0,0,0,0,0,9,2,7,3,6,28,9.07600522785852,10.2809989029626,0.351174315155153,31
"5711","BA","Irará",29173,8742.97,29012,"Feira de Santana",2,"Nordeste",0,"291450",4,19,1,18,6,13,0,0,0,0,0,19,1,18,6,13,16,9.07600522785852,10.2809989029626,0.400762285909469,30
"5712","BA","Irará",29173,8742.97,29012,"Feira de Santana",2,"Nordeste",0,"291450",5,14,8,6,7,7,0,0,0,0,0,14,8,6,7,7,16,9.07600522785852,10.2809989029626,0.424680409270205,31
"5713","BA","Irecê",73524,16746.4,29009,"Irecê",2,"Nordeste",1,"291460",2,101,15,86,31,70,0,0,0,0,0,101,15,86,31,70,33,9.72593858878031,11.2053671625137,0.284901935109212,29
"5714","BA","Irecê",73524,16746.4,29009,"Irecê",2,"Nordeste",1,"291460",3,77,16,61,23,54,0,0,0,0,0,77,16,61,23,54,42,9.72593858878031,11.2053671625137,0.37133894783514,31
"5715","BA","Irecê",73524,16746.4,29009,"Irecê",2,"Nordeste",1,"291460",4,93,20,73,32,61,1,0,1,1,0,94,20,74,33,61,29,9.72593858878031,11.2053671625137,0.395319566648849,30
"5716","BA","Irecê",73524,16746.4,29009,"Irecê",2,"Nordeste",1,"291460",5,140,33,107,48,92,2,2,0,0,2,142,35,107,48,94,35,9.72593858878031,11.2053671625137,0.375147785738611,31
"5717","BA","Itabela",30747,11561.02,29032,"Porto Seguro",2,"Nordeste",1,"291465",2,23,12,11,13,10,1,0,1,0,1,24,12,12,13,11,15,9.35539437362798,10.3335477074997,0.293686703485626,29
"5718","BA","Itabela",30747,11561.02,29032,"Porto Seguro",2,"Nordeste",1,"291465",3,40,20,20,21,19,0,0,0,0,0,40,20,20,21,19,20,9.35539437362798,10.3335477074997,0.365574503488469,31
"5719","BA","Itabela",30747,11561.02,29032,"Porto Seguro",2,"Nordeste",1,"291465",4,40,17,23,23,17,1,0,1,0,1,41,17,24,23,18,13,9.35539437362798,10.3335477074997,0.371784745692833,30
"5720","BA","Itabela",30747,11561.02,29032,"Porto Seguro",2,"Nordeste",1,"291465",5,43,23,20,27,16,2,1,1,0,2,45,24,21,27,18,19,9.35539437362798,10.3335477074997,0.364112833614405,31
"5721","BA","Itaberaba",64646,14009.43,29011,"Itaberaba",2,"Nordeste",1,"291470",2,72,15,57,29,43,1,0,1,1,0,73,15,58,30,43,36,9.54748595327855,11.0766815106695,0.276680175491733,29
"5722","BA","Itaberaba",64646,14009.43,29011,"Itaberaba",2,"Nordeste",1,"291470",3,53,13,40,27,26,1,0,1,1,0,54,13,41,28,26,43,9.54748595327855,11.0766815106695,0.353316506600868,31
"5723","BA","Itaberaba",64646,14009.43,29011,"Itaberaba",2,"Nordeste",1,"291470",4,56,16,40,24,32,0,0,0,0,0,56,16,40,24,32,35,9.54748595327855,11.0766815106695,0.371835979154557,30
"5724","BA","Itaberaba",64646,14009.43,29011,"Itaberaba",2,"Nordeste",1,"291470",5,49,14,35,19,30,0,0,0,0,0,49,14,35,19,30,47,9.54748595327855,11.0766815106695,0.383019043579999,31
"5725","BA","Itabuna",213685,19184.77,29031,"Ilhéus-Itabuna",2,"Nordeste",1,"291480",2,143,29,114,47,96,1,0,1,1,0,144,29,115,48,96,131,9.86187201407648,12.2722582469859,0.295905910335885,29
"5726","BA","Itabuna",213685,19184.77,29031,"Ilhéus-Itabuna",2,"Nordeste",1,"291480",3,181,51,130,69,112,1,0,1,0,1,182,51,131,69,113,144,9.86187201407648,12.2722582469859,0.400520399804756,31
"5727","BA","Itabuna",213685,19184.77,29031,"Ilhéus-Itabuna",2,"Nordeste",1,"291480",4,168,43,125,77,91,3,2,1,0,3,171,45,126,77,94,168,9.86187201407648,12.2722582469859,0.474154619003431,30
"5728","BA","Itabuna",213685,19184.77,29031,"Ilhéus-Itabuna",2,"Nordeste",1,"291480",5,228,48,180,92,136,2,0,2,0,2,230,48,182,92,138,189,9.86187201407648,12.2722582469859,0.452119831548271,31
"5729","BA","Itacaré",28684,11003.98,29031,"Ilhéus-Itabuna",2,"Nordeste",0,"291490",2,24,10,14,13,11,1,0,1,0,1,25,10,15,13,12,8,9.30601230452191,10.2640947550025,0.25179587495608,29
"5730","BA","Itacaré",28684,11003.98,29031,"Ilhéus-Itabuna",2,"Nordeste",0,"291490",3,29,10,19,14,15,0,0,0,0,0,29,10,19,14,15,14,9.30601230452191,10.2640947550025,0.369373748153489,31
"5731","BA","Itacaré",28684,11003.98,29031,"Ilhéus-Itabuna",2,"Nordeste",0,"291490",4,26,8,18,14,12,0,0,0,0,0,26,8,18,14,12,11,9.30601230452191,10.2640947550025,0.440709281610141,30
"5732","BA","Itacaré",28684,11003.98,29031,"Ilhéus-Itabuna",2,"Nordeste",0,"291490",5,43,17,26,20,23,0,0,0,0,0,43,17,26,20,23,12,9.30601230452191,10.2640947550025,0.445325010045904,31
"5733","BA","Itaeté",16110,5898.19,29023,"Seabra",2,"Nordeste",0,"291500",2,16,3,13,10,6,0,0,0,0,0,16,3,13,10,6,5,8.68240080316629,9.68719547617102,0.297243918991507,29
"5734","BA","Itaeté",16110,5898.19,29023,"Seabra",2,"Nordeste",0,"291500",3,8,3,5,0,8,0,0,0,0,0,8,3,5,0,8,6,8.68240080316629,9.68719547617102,0.36749337002068,31
"5735","BA","Itaeté",16110,5898.19,29023,"Seabra",2,"Nordeste",0,"291500",4,13,3,10,8,5,0,0,0,0,0,13,3,10,8,5,8,8.68240080316629,9.68719547617102,0.375787204980267,30
"5736","BA","Itaeté",16110,5898.19,29023,"Seabra",2,"Nordeste",0,"291500",5,11,2,9,4,7,1,0,1,1,0,12,2,10,5,7,8,8.68240080316629,9.68719547617102,0.413369925718936,31
"5737","BA","Itagi",12242,8090.05,29024,"Jequié",2,"Nordeste",0,"291510",2,16,6,10,7,9,0,0,0,0,0,16,6,10,7,9,12,8.99839019050315,9.41262794141102,0.285101280889231,29
"5738","BA","Itagi",12242,8090.05,29024,"Jequié",2,"Nordeste",0,"291510",3,18,6,12,9,9,0,0,0,0,0,18,6,12,9,9,9,8.99839019050315,9.41262794141102,0.381021096527907,31
"5739","BA","Itagi",12242,8090.05,29024,"Jequié",2,"Nordeste",0,"291510",4,16,8,8,10,6,1,0,1,1,0,17,8,9,11,6,15,8.99839019050315,9.41262794141102,0.410520073879722,30
"5740","BA","Itagi",12242,8090.05,29024,"Jequié",2,"Nordeste",0,"291510",5,7,5,2,2,5,0,0,0,0,0,7,5,2,2,5,8,8.99839019050315,9.41262794141102,0.401747938909875,31
"5741","BA","Itagibá",14452,9279.05,29031,"Ilhéus-Itabuna",2,"Nordeste",0,"291520",2,8,1,7,3,5,0,0,0,0,0,8,1,7,3,5,5,9.13551444985035,9.57858809226753,0.265155416888808,29
"5742","BA","Itagibá",14452,9279.05,29031,"Ilhéus-Itabuna",2,"Nordeste",0,"291520",3,10,5,5,6,4,0,0,0,0,0,10,5,5,6,4,13,9.13551444985035,9.57858809226753,0.360858892472247,31
"5743","BA","Itagibá",14452,9279.05,29031,"Ilhéus-Itabuna",2,"Nordeste",0,"291520",4,7,4,3,4,3,0,0,0,0,0,7,4,3,4,3,16,9.13551444985035,9.57858809226753,0.408195264572962,30
"5744","BA","Itagibá",14452,9279.05,29031,"Ilhéus-Itabuna",2,"Nordeste",0,"291520",5,28,14,14,17,11,0,0,0,0,0,28,14,14,17,11,8,9.13551444985035,9.57858809226753,0.416922577555365,31
"5745","BA","Itagimirim",6825,16147.89,29032,"Porto Seguro",2,"Nordeste",0,"291530",2,3,2,1,3,0,0,0,0,0,0,3,2,1,3,0,0,9.68954466996053,8.82834762005316,0.279218774883943,29
"5746","BA","Itagimirim",6825,16147.89,29032,"Porto Seguro",2,"Nordeste",0,"291530",3,5,0,5,2,3,0,0,0,0,0,5,0,5,2,3,5,9.68954466996053,8.82834762005316,0.369645543316103,31
"5747","BA","Itagimirim",6825,16147.89,29032,"Porto Seguro",2,"Nordeste",0,"291530",4,1,1,0,1,0,0,0,0,0,0,1,1,0,1,0,4,9.68954466996053,8.82834762005316,0.417331274295349,30
"5748","BA","Itagimirim",6825,16147.89,29032,"Porto Seguro",2,"Nordeste",0,"291530",5,3,3,0,1,2,0,0,0,0,0,3,3,0,1,2,2,9.68954466996053,8.82834762005316,0.405338125373726,31
"5749","BA","Itaguaçu da Bahia",14542,8431.96,29006,"Barra",2,"Nordeste",0,"291535",2,11,7,4,9,2,0,0,0,0,0,11,7,4,9,2,0,9.03978452693687,9.58479629321,0.322815956289964,29
"5750","BA","Itaguaçu da Bahia",14542,8431.96,29006,"Barra",2,"Nordeste",0,"291535",3,8,3,5,2,6,0,0,0,0,0,8,3,5,2,6,5,9.03978452693687,9.58479629321,0.402113470889455,31
"5751","BA","Itaguaçu da Bahia",14542,8431.96,29006,"Barra",2,"Nordeste",0,"291535",4,11,1,10,6,5,0,0,0,0,0,11,1,10,6,5,6,9.03978452693687,9.58479629321,0.394654106309554,30
"5752","BA","Itaguaçu da Bahia",14542,8431.96,29006,"Barra",2,"Nordeste",0,"291535",5,14,5,9,7,7,1,0,1,1,0,15,5,10,8,7,3,9.03978452693687,9.58479629321,0.422203376105667,31
"5753","BA","Itaju do Colônia",6596,9796.14,29031,"Ilhéus-Itabuna",2,"Nordeste",0,"291540",2,2,1,1,2,0,0,0,0,0,0,2,1,1,2,0,2,9.18974370951751,8.79421868367949,0.269905836608702,29
"5754","BA","Itaju do Colônia",6596,9796.14,29031,"Ilhéus-Itabuna",2,"Nordeste",0,"291540",3,4,2,2,2,2,0,0,0,0,0,4,2,2,2,2,5,9.18974370951751,8.79421868367949,0.33789425172081,31
"5755","BA","Itaju do Colônia",6596,9796.14,29031,"Ilhéus-Itabuna",2,"Nordeste",0,"291540",4,7,4,3,5,2,0,0,0,0,0,7,4,3,5,2,4,9.18974370951751,8.79421868367949,0.378806167844868,30
"5756","BA","Itaju do Colônia",6596,9796.14,29031,"Ilhéus-Itabuna",2,"Nordeste",0,"291540",5,9,3,6,3,6,0,0,0,0,0,9,3,6,3,6,3,9.18974370951751,8.79421868367949,0.361332874725254,31
"5757","BA","Itajuípe",20398,11152.02,29031,"Ilhéus-Itabuna",2,"Nordeste",0,"291550",2,19,6,13,11,8,0,0,0,0,0,19,6,13,11,8,11,9.31937592639898,9.92319213581046,0.292082450750238,29
"5758","BA","Itajuípe",20398,11152.02,29031,"Ilhéus-Itabuna",2,"Nordeste",0,"291550",3,20,10,10,7,13,0,0,0,0,0,20,10,10,7,13,13,9.31937592639898,9.92319213581046,0.378398034097007,31
"5759","BA","Itajuípe",20398,11152.02,29031,"Ilhéus-Itabuna",2,"Nordeste",0,"291550",4,8,5,3,6,2,0,0,0,0,0,8,5,3,6,2,21,9.31937592639898,9.92319213581046,0.445832284586966,30
"5760","BA","Itajuípe",20398,11152.02,29031,"Ilhéus-Itabuna",2,"Nordeste",0,"291550",5,12,7,5,6,6,2,1,1,1,1,14,8,6,7,7,21,9.31937592639898,9.92319213581046,0.423330670650992,31
"5761","BA","Itamaraju",64455,13965.75,29032,"Porto Seguro",2,"Nordeste",1,"291560",2,66,22,44,31,35,4,1,3,1,3,70,23,47,32,38,29,9.54436318262998,11.0737225848772,0.292675392958269,29
"5762","BA","Itamaraju",64455,13965.75,29032,"Porto Seguro",2,"Nordeste",1,"291560",3,59,21,38,35,24,2,1,1,1,1,61,22,39,36,25,39,9.54436318262998,11.0737225848772,0.374358674661141,31
"5763","BA","Itamaraju",64455,13965.75,29032,"Porto Seguro",2,"Nordeste",1,"291560",4,69,29,40,36,33,0,0,0,0,0,69,29,40,36,33,45,9.54436318262998,11.0737225848772,0.377404934314,30
"5764","BA","Itamaraju",64455,13965.75,29032,"Porto Seguro",2,"Nordeste",1,"291560",5,68,32,36,33,35,0,0,0,0,0,68,32,36,33,35,43,9.54436318262998,11.0737225848772,0.390978535731789,31
"5765","BA","Itambé",22754,10099.79,29029,"Itapetinga",2,"Nordeste",1,"291580",2,25,17,8,9,16,0,0,0,0,0,25,17,8,9,16,13,9.22026991053398,10.0324962330997,0.296636464558661,29
"5766","BA","Itambé",22754,10099.79,29029,"Itapetinga",2,"Nordeste",1,"291580",3,19,6,13,6,13,0,0,0,0,0,19,6,13,6,13,11,9.22026991053398,10.0324962330997,0.380136432430957,31
"5767","BA","Itambé",22754,10099.79,29029,"Itapetinga",2,"Nordeste",1,"291580",4,16,8,8,10,6,0,0,0,0,0,16,8,8,10,6,10,9.22026991053398,10.0324962330997,0.392859393698239,30
"5768","BA","Itambé",22754,10099.79,29029,"Itapetinga",2,"Nordeste",1,"291580",5,22,11,11,12,10,0,0,0,0,0,22,11,11,12,10,11,9.22026991053398,10.0324962330997,0.353496421714519,31
"5769","BA","Itanagra",6436,10298.85,29019,"Catu",2,"Nordeste",0,"291590",2,8,5,3,7,1,0,0,0,0,0,8,5,3,7,1,4,9.23978751749891,8.76966250811227,0.270716091741865,29
"5770","BA","Itanagra",6436,10298.85,29019,"Catu",2,"Nordeste",0,"291590",3,4,2,2,4,0,0,0,0,0,0,4,2,2,4,0,2,9.23978751749891,8.76966250811227,0.357300462571552,31
"5771","BA","Itanagra",6436,10298.85,29019,"Catu",2,"Nordeste",0,"291590",4,5,3,2,2,3,1,1,0,1,0,6,4,2,3,3,1,9.23978751749891,8.76966250811227,0.406200046799124,30
"5772","BA","Itanagra",6436,10298.85,29019,"Catu",2,"Nordeste",0,"291590",5,4,1,3,2,2,0,0,0,0,0,4,1,3,2,2,3,9.23978751749891,8.76966250811227,0.422902681048725,31
"5773","BA","Itanhém",19316,11605.19,29032,"Porto Seguro",2,"Nordeste",0,"291600",2,10,4,6,4,6,1,0,1,1,0,11,4,7,5,6,15,9.35920769082785,9.86868904699343,0.30883810561848,29
"5774","BA","Itanhém",19316,11605.19,29032,"Porto Seguro",2,"Nordeste",0,"291600",3,14,4,10,6,8,0,0,0,0,0,14,4,10,6,8,6,9.35920769082785,9.86868904699343,0.407495047167889,31
"5775","BA","Itanhém",19316,11605.19,29032,"Porto Seguro",2,"Nordeste",0,"291600",4,11,2,9,8,3,0,0,0,0,0,11,2,9,8,3,12,9.35920769082785,9.86868904699343,0.405662717753419,30
"5776","BA","Itanhém",19316,11605.19,29032,"Porto Seguro",2,"Nordeste",0,"291600",5,7,2,5,2,5,0,0,0,0,0,7,2,5,2,5,18,9.35920769082785,9.86868904699343,0.425837658932642,31
"5777","BA","Itaparica",22337,10722.56,29021,"Salvador",2,"Nordeste",1,"291610",2,16,6,10,3,13,0,0,0,0,0,16,6,10,3,13,16,9.28010521208533,10.0139997753336,0.309254780746047,29
"5778","BA","Itaparica",22337,10722.56,29021,"Salvador",2,"Nordeste",1,"291610",3,15,4,11,9,6,0,0,0,0,0,15,4,11,9,6,15,9.28010521208533,10.0139997753336,0.412318464482374,31
"5779","BA","Itaparica",22337,10722.56,29021,"Salvador",2,"Nordeste",1,"291610",4,10,3,7,7,3,0,0,0,0,0,10,3,7,7,3,17,9.28010521208533,10.0139997753336,0.481159937983828,30
"5780","BA","Itaparica",22337,10722.56,29021,"Salvador",2,"Nordeste",1,"291610",5,20,3,17,8,12,0,0,0,0,0,20,3,17,8,12,13,9.28010521208533,10.0139997753336,0.471873343373286,31
"5781","BA","Itapé",8526,9913.19,29031,"Ilhéus-Itabuna",2,"Nordeste",0,"291620",2,12,3,9,7,5,0,0,0,0,0,12,3,9,7,5,5,9.20162147259995,9.05087559732516,0.307770144262845,29
"5782","BA","Itapé",8526,9913.19,29031,"Ilhéus-Itabuna",2,"Nordeste",0,"291620",3,8,4,4,4,4,0,0,0,0,0,8,4,4,4,4,5,9.20162147259995,9.05087559732516,0.388673647191811,31
"5783","BA","Itapé",8526,9913.19,29031,"Ilhéus-Itabuna",2,"Nordeste",0,"291620",4,8,2,6,2,6,0,0,0,0,0,8,2,6,2,6,8,9.20162147259995,9.05087559732516,0.414684891044496,30
"5784","BA","Itapé",8526,9913.19,29031,"Ilhéus-Itabuna",2,"Nordeste",0,"291620",5,11,4,7,5,6,0,0,0,0,0,11,4,7,5,6,8,9.20162147259995,9.05087559732516,0.42044245912921,31
"5785","BA","Itapebi",10215,27428.96,29031,"Ilhéus-Itabuna",2,"Nordeste",0,"291630",2,11,6,5,5,6,0,0,0,0,0,11,6,5,5,6,4,10.2193546685209,9.23161250725172,0.286280709644308,29
"5786","BA","Itapebi",10215,27428.96,29031,"Ilhéus-Itabuna",2,"Nordeste",0,"291630",3,7,3,4,4,3,0,0,0,0,0,7,3,4,4,3,7,10.2193546685209,9.23161250725172,0.366455053698292,31
"5787","BA","Itapebi",10215,27428.96,29031,"Ilhéus-Itabuna",2,"Nordeste",0,"291630",4,6,4,2,4,2,0,0,0,0,0,6,4,2,4,2,9,10.2193546685209,9.23161250725172,0.408989489354662,30
"5788","BA","Itapebi",10215,27428.96,29031,"Ilhéus-Itabuna",2,"Nordeste",0,"291630",5,10,5,5,6,4,0,0,0,0,0,10,5,5,6,4,6,10.2193546685209,9.23161250725172,0.402623117685292,31
"5789","BA","Itapetinga",76795,14271.87,29029,"Itapetinga",2,"Nordeste",1,"291640",2,71,21,50,28,43,2,1,1,1,1,73,22,51,29,44,49,9.56604574603391,11.2488948128497,0.288447802331369,29
"5790","BA","Itapetinga",76795,14271.87,29029,"Itapetinga",2,"Nordeste",1,"291640",3,62,27,35,27,35,0,0,0,0,0,62,27,35,27,35,46,9.56604574603391,11.2488948128497,0.37246842469273,31
"5791","BA","Itapetinga",76795,14271.87,29029,"Itapetinga",2,"Nordeste",1,"291640",4,65,24,41,31,34,0,0,0,0,0,65,24,41,31,34,47,9.56604574603391,11.2488948128497,0.40348076929667,30
"5792","BA","Itapetinga",76795,14271.87,29029,"Itapetinga",2,"Nordeste",1,"291640",5,76,33,43,41,35,1,0,1,1,0,77,33,44,42,35,37,9.56604574603391,11.2488948128497,0.372680049356243,31
"5793","BA","Itapicuru",35883,7677.87,29015,"Ribeira do Pombal",2,"Nordeste",0,"291650",2,20,14,6,9,11,0,0,0,0,0,20,14,6,9,11,13,8.94609744392483,10.4880189247176,0.265281445463645,29
"5794","BA","Itapicuru",35883,7677.87,29015,"Ribeira do Pombal",2,"Nordeste",0,"291650",3,16,8,8,9,7,0,0,0,0,0,16,8,8,9,7,17,8.94609744392483,10.4880189247176,0.352464704063192,31
"5795","BA","Itapicuru",35883,7677.87,29015,"Ribeira do Pombal",2,"Nordeste",0,"291650",4,21,13,8,10,11,0,0,0,0,0,21,13,8,10,11,14,8.94609744392483,10.4880189247176,0.373745852555491,30
"5796","BA","Itapicuru",35883,7677.87,29015,"Ribeira do Pombal",2,"Nordeste",0,"291650",5,20,12,8,10,10,0,0,0,0,0,20,12,8,10,10,10,8.94609744392483,10.4880189247176,0.377808070952349,31
"5797","BA","Itapitanga",10298,7157.14,29031,"Ilhéus-Itabuna",2,"Nordeste",0,"291660",2,4,3,1,2,2,0,0,0,0,0,4,3,1,2,2,7,8.87586573881597,9.23970498060609,0.285275879074505,29
"5798","BA","Itapitanga",10298,7157.14,29031,"Ilhéus-Itabuna",2,"Nordeste",0,"291660",3,7,5,2,3,4,0,0,0,0,0,7,5,2,3,4,11,8.87586573881597,9.23970498060609,0.366820664911223,31
"5799","BA","Itapitanga",10298,7157.14,29031,"Ilhéus-Itabuna",2,"Nordeste",0,"291660",4,3,1,2,1,2,0,0,0,0,0,3,1,2,1,2,6,8.87586573881597,9.23970498060609,0.41033890907211,30
"5800","BA","Itapitanga",10298,7157.14,29031,"Ilhéus-Itabuna",2,"Nordeste",0,"291660",5,5,2,3,2,3,0,0,0,0,0,5,2,3,2,3,5,8.87586573881597,9.23970498060609,0.401596979128959,31
"5801","BA","Itaquara",8347,7945.81,29024,"Jequié",2,"Nordeste",0,"291670",2,8,2,6,6,2,0,0,0,0,0,8,2,6,6,2,3,8.9804000246867,9.02965747185074,0.304016576393504,29
"5802","BA","Itaquara",8347,7945.81,29024,"Jequié",2,"Nordeste",0,"291670",3,14,4,10,4,10,0,0,0,0,0,14,4,10,4,10,7,8.9804000246867,9.02965747185074,0.329654099666675,31
"5803","BA","Itaquara",8347,7945.81,29024,"Jequié",2,"Nordeste",0,"291670",4,4,0,4,4,0,0,0,0,0,0,4,0,4,4,0,5,8.9804000246867,9.02965747185074,0.379116458474043,30
"5804","BA","Itaquara",8347,7945.81,29024,"Jequié",2,"Nordeste",0,"291670",5,6,2,4,5,1,0,0,0,0,0,6,2,4,5,1,4,8.9804000246867,9.02965747185074,0.383441804283834,31
"5805","BA","Itarantim",19843,13929.74,29029,"Itapetinga",2,"Nordeste",1,"291680",2,16,5,11,6,10,1,0,1,0,1,17,5,12,6,11,7,9.54178140184733,9.89560657908525,0.257138897713611,29
"5806","BA","Itarantim",19843,13929.74,29029,"Itapetinga",2,"Nordeste",1,"291680",3,16,9,7,10,6,0,0,0,0,0,16,9,7,10,6,17,9.54178140184733,9.89560657908525,0.323579350986922,31
"5807","BA","Itarantim",19843,13929.74,29029,"Itapetinga",2,"Nordeste",1,"291680",4,7,2,5,1,6,0,0,0,0,0,7,2,5,1,6,10,9.54178140184733,9.89560657908525,0.331232970892084,30
"5808","BA","Itarantim",19843,13929.74,29029,"Itapetinga",2,"Nordeste",1,"291680",5,14,7,7,4,10,0,0,0,0,0,14,7,7,4,10,12,9.54178140184733,9.89560657908525,0.338520646227127,31
"5809","BA","Itatim",14539,23178.62,29012,"Feira de Santana",2,"Nordeste",0,"291685",2,8,4,4,5,3,0,0,0,0,0,8,4,4,5,3,7,10.0509855810404,9.58458997293143,0.270365227752044,29
"5810","BA","Itatim",14539,23178.62,29012,"Feira de Santana",2,"Nordeste",0,"291685",3,5,1,4,1,4,0,0,0,0,0,5,1,4,1,4,10,10.0509855810404,9.58458997293143,0.331958959752211,31
"5811","BA","Itatim",14539,23178.62,29012,"Feira de Santana",2,"Nordeste",0,"291685",4,10,2,8,4,6,0,0,0,0,0,10,2,8,4,6,9,10.0509855810404,9.58458997293143,0.374007879493289,30
"5812","BA","Itatim",14539,23178.62,29012,"Feira de Santana",2,"Nordeste",0,"291685",5,5,0,5,0,5,0,0,0,0,0,5,0,5,0,5,9,10.0509855810404,9.58458997293143,0.361949888386465,31
"5813","BA","Itiruçu",12528,7483.3,29024,"Jequié",2,"Nordeste",0,"291690",2,9,0,9,3,6,0,0,0,0,0,9,0,9,3,6,8,8.92042915014938,9.43572141823058,0.285106826497353,29
"5814","BA","Itiruçu",12528,7483.3,29024,"Jequié",2,"Nordeste",0,"291690",3,11,2,9,5,6,0,0,0,0,0,11,2,9,5,6,11,8.92042915014938,9.43572141823058,0.376807778104429,31
"5815","BA","Itiruçu",12528,7483.3,29024,"Jequié",2,"Nordeste",0,"291690",4,12,3,9,4,8,0,0,0,0,0,12,3,9,4,8,7,8.92042915014938,9.43572141823058,0.397832704535681,30
"5816","BA","Itiruçu",12528,7483.3,29024,"Jequié",2,"Nordeste",0,"291690",5,7,5,2,4,3,0,0,0,0,0,7,5,2,4,3,3,8.92042915014938,9.43572141823058,0.373378196642048,31
"5817","BA","Itiúba",36116,7204.65,29008,"Senhor do Bonfim",2,"Nordeste",0,"291700",2,34,14,20,19,15,0,0,0,0,0,34,14,20,19,15,21,8.88248192987688,10.4944912594274,0.299674254580154,29
"5818","BA","Itiúba",36116,7204.65,29008,"Senhor do Bonfim",2,"Nordeste",0,"291700",3,31,13,18,16,15,2,0,2,1,1,33,13,20,17,16,26,8.88248192987688,10.4944912594274,0.37777925404045,31
"5819","BA","Itiúba",36116,7204.65,29008,"Senhor do Bonfim",2,"Nordeste",0,"291700",4,33,14,19,15,18,2,0,2,2,0,35,14,21,17,18,23,8.88248192987688,10.4944912594274,0.412542323168971,30
"5820","BA","Itiúba",36116,7204.65,29008,"Senhor do Bonfim",2,"Nordeste",0,"291700",5,34,9,25,16,18,2,0,2,1,1,36,9,27,17,19,22,8.88248192987688,10.4944912594274,0.415199491336061,31
"5821","BA","Itororó",20388,10872.92,29029,"Itapetinga",2,"Nordeste",1,"291710",2,17,9,8,7,10,0,0,0,0,0,17,9,8,7,10,9,9.29403057329571,9.92270177145993,0.292623304501957,29
"5822","BA","Itororó",20388,10872.92,29029,"Itapetinga",2,"Nordeste",1,"291710",3,8,4,4,2,6,0,0,0,0,0,8,4,4,2,6,17,9.29403057329571,9.92270177145993,0.378435479239605,31
"5823","BA","Itororó",20388,10872.92,29029,"Itapetinga",2,"Nordeste",1,"291710",4,8,2,6,4,4,1,0,1,0,1,9,2,7,4,5,21,9.29403057329571,9.92270177145993,0.409668338138741,30
"5824","BA","Itororó",20388,10872.92,29029,"Itapetinga",2,"Nordeste",1,"291710",5,18,8,10,5,13,1,1,0,1,0,19,9,10,6,13,17,9.29403057329571,9.92270177145993,0.388385590736816,31
"5825","BA","Ituaçu",19030,8462.8,29027,"Brumado",2,"Nordeste",0,"291720",2,14,4,10,8,6,0,0,0,0,0,14,4,10,8,6,16,9.04343536710916,9.8537719602902,0.279393234563564,29
"5826","BA","Ituaçu",19030,8462.8,29027,"Brumado",2,"Nordeste",0,"291720",3,20,12,8,8,12,1,1,0,0,1,21,13,8,8,13,14,9.04343536710916,9.8537719602902,0.352290523046831,31
"5827","BA","Ituaçu",19030,8462.8,29027,"Brumado",2,"Nordeste",0,"291720",4,12,4,8,8,4,0,0,0,0,0,12,4,8,8,4,6,9.04343536710916,9.8537719602902,0.359119671718145,30
"5828","BA","Ituaçu",19030,8462.8,29027,"Brumado",2,"Nordeste",0,"291720",5,13,5,8,6,7,0,0,0,0,0,13,5,8,6,7,10,9.04343536710916,9.8537719602902,0.380200127198331,31
"5829","BA","Ituberá",28740,10492.33,29030,"Valença",2,"Nordeste",0,"291730",2,24,10,14,11,13,0,0,0,0,0,24,10,14,11,13,16,9.25839979302741,10.266045159633,0.277857466879552,29
"5830","BA","Ituberá",28740,10492.33,29030,"Valença",2,"Nordeste",0,"291730",3,13,6,7,6,7,1,0,1,0,1,14,6,8,6,8,7,9.25839979302741,10.266045159633,0.38675463140829,31
"5831","BA","Ituberá",28740,10492.33,29030,"Valença",2,"Nordeste",0,"291730",4,19,9,10,13,6,0,0,0,0,0,19,9,10,13,6,9,9.25839979302741,10.266045159633,0.438074065392763,30
"5832","BA","Ituberá",28740,10492.33,29030,"Valença",2,"Nordeste",0,"291730",5,25,11,14,10,15,2,2,0,2,0,27,13,14,12,15,18,9.25839979302741,10.266045159633,0.396324973098259,31
"5833","BA","Iuiu",11016,8728.32,29026,"Guanambi",2,"Nordeste",0,"291733",2,12,6,6,3,9,0,0,0,0,0,12,6,6,3,9,5,9.07432819045218,9.30710404040849,0.254317372783209,29
"5834","BA","Iuiu",11016,8728.32,29026,"Guanambi",2,"Nordeste",0,"291733",3,12,5,7,5,7,0,0,0,0,0,12,5,7,5,7,10,9.07432819045218,9.30710404040849,0.333634913287501,31
"5835","BA","Iuiu",11016,8728.32,29026,"Guanambi",2,"Nordeste",0,"291733",4,10,3,7,3,7,0,0,0,0,0,10,3,7,3,7,6,9.07432819045218,9.30710404040849,0.369533606031703,30
"5836","BA","Iuiu",11016,8728.32,29026,"Guanambi",2,"Nordeste",0,"291733",5,9,1,8,2,7,1,0,1,0,1,10,1,9,2,8,6,9.07432819045218,9.30710404040849,0.340275901830047,31
"5837","BA","Jaborandi",8277,78337.5,29003,"Santa Maria da Vitória",2,"Nordeste",0,"291735",2,3,0,3,2,1,0,0,0,0,0,3,0,3,2,1,5,11.2687816945329,9.0212358628854,0.290555713735046,29
"5838","BA","Jaborandi",8277,78337.5,29003,"Santa Maria da Vitória",2,"Nordeste",0,"291735",3,3,2,1,2,1,0,0,0,0,0,3,2,1,2,1,10,11.2687816945329,9.0212358628854,0.363832418988366,31
"5839","BA","Jaborandi",8277,78337.5,29003,"Santa Maria da Vitória",2,"Nordeste",0,"291735",4,12,2,10,6,6,1,0,1,1,0,13,2,11,7,6,4,11.2687816945329,9.0212358628854,0.405908064064984,30
"5840","BA","Jaborandi",8277,78337.5,29003,"Santa Maria da Vitória",2,"Nordeste",0,"291735",5,8,3,5,2,6,0,0,0,0,0,8,3,5,2,6,5,11.2687816945329,9.0212358628854,0.385296279172891,31
"5841","BA","Jacaraci",14850,6814.78,29026,"Guanambi",2,"Nordeste",0,"291740",2,6,1,5,4,2,0,0,0,0,0,6,1,5,4,2,7,8.82684906187809,9.60575514423085,0.259610731582129,29
"5842","BA","Jacaraci",14850,6814.78,29026,"Guanambi",2,"Nordeste",0,"291740",3,9,5,4,3,6,0,0,0,0,0,9,5,4,3,6,7,8.82684906187809,9.60575514423085,0.359148773509792,31
"5843","BA","Jacaraci",14850,6814.78,29026,"Guanambi",2,"Nordeste",0,"291740",4,6,2,4,3,3,0,0,0,0,0,6,2,4,3,3,6,8.82684906187809,9.60575514423085,0.393082346554614,30
"5844","BA","Jacaraci",14850,6814.78,29026,"Guanambi",2,"Nordeste",0,"291740",5,11,0,11,1,10,0,0,0,0,0,11,0,11,1,10,7,8.82684906187809,9.60575514423085,0.420806019466093,31
"5845","BA","Jacobina",80635,17237.46,29010,"Jacobina",2,"Nordeste",1,"291750",2,88,29,59,39,49,0,0,0,0,0,88,29,59,39,49,42,9.75484020157675,11.2976880774146,0.297286790894361,29
"5846","BA","Jacobina",80635,17237.46,29010,"Jacobina",2,"Nordeste",1,"291750",3,83,28,55,39,44,1,0,1,1,0,84,28,56,40,44,50,9.75484020157675,11.2976880774146,0.381453071691532,31
"5847","BA","Jacobina",80635,17237.46,29010,"Jacobina",2,"Nordeste",1,"291750",4,84,27,57,29,55,1,0,1,1,0,85,27,58,30,55,49,9.75484020157675,11.2976880774146,0.396502613061018,30
"5848","BA","Jacobina",80635,17237.46,29010,"Jacobina",2,"Nordeste",1,"291750",5,93,34,59,29,64,0,0,0,0,0,93,34,59,29,64,53,9.75484020157675,11.2976880774146,0.412466042818689,31
"5849","BA","Jaguaquara",54673,10120.1,29024,"Jequié",2,"Nordeste",1,"291760",2,45,12,33,24,21,0,0,0,0,0,45,12,33,24,21,14,9.22227882421556,10.9091252650862,0.268036605728127,29
"5850","BA","Jaguaquara",54673,10120.1,29024,"Jequié",2,"Nordeste",1,"291760",3,52,19,33,23,29,1,0,1,1,0,53,19,34,24,29,29,9.22227882421556,10.9091252650862,0.340269908652231,31
"5851","BA","Jaguaquara",54673,10120.1,29024,"Jequié",2,"Nordeste",1,"291760",4,39,11,28,21,18,0,0,0,0,0,39,11,28,21,18,34,9.22227882421556,10.9091252650862,0.373404157987771,30
"5852","BA","Jaguaquara",54673,10120.1,29024,"Jequié",2,"Nordeste",1,"291760",5,49,15,34,22,27,0,0,0,0,0,49,15,34,22,27,36,9.22227882421556,10.9091252650862,0.363104435032516,31
"5853","BA","Jaguarari",33746,19288.82,29008,"Senhor do Bonfim",2,"Nordeste",0,"291770",2,33,12,21,11,22,0,0,0,0,0,33,12,21,11,22,15,9.86728093243722,10.4266171707583,0.267259528947305,29
"5854","BA","Jaguarari",33746,19288.82,29008,"Senhor do Bonfim",2,"Nordeste",0,"291770",3,29,13,16,13,16,1,0,1,0,1,30,13,17,13,17,18,9.86728093243722,10.4266171707583,0.350588632808405,31
"5855","BA","Jaguarari",33746,19288.82,29008,"Senhor do Bonfim",2,"Nordeste",0,"291770",4,27,10,17,11,16,0,0,0,0,0,27,10,17,11,16,13,9.86728093243722,10.4266171707583,0.391072775219031,30
"5856","BA","Jaguarari",33746,19288.82,29008,"Senhor do Bonfim",2,"Nordeste",0,"291770",5,37,10,27,14,23,0,0,0,0,0,37,10,27,14,23,19,9.86728093243722,10.4266171707583,0.382090141854212,31
"5857","BA","Jaguaripe",18981,9053.68,29020,"Santo Antônio de Jesus",2,"Nordeste",0,"291780",2,14,6,8,4,10,0,0,0,0,0,14,6,8,4,10,7,9.11092658387672,9.85119375781499,0.321437330608799,29
"5858","BA","Jaguaripe",18981,9053.68,29020,"Santo Antônio de Jesus",2,"Nordeste",0,"291780",3,16,2,14,7,9,2,0,2,0,2,18,2,16,7,11,16,9.11092658387672,9.85119375781499,0.412742347460855,31
"5859","BA","Jaguaripe",18981,9053.68,29020,"Santo Antônio de Jesus",2,"Nordeste",0,"291780",4,9,4,5,4,5,1,1,0,1,0,10,5,5,5,5,4,9.11092658387672,9.85119375781499,0.475674707093421,30
"5860","BA","Jaguaripe",18981,9053.68,29020,"Santo Antônio de Jesus",2,"Nordeste",0,"291780",5,13,5,8,5,8,0,0,0,0,0,13,5,8,5,8,4,9.11092658387672,9.85119375781499,0.48803769662884,31
"5861","BA","Jandaíra",10726,11335.37,29018,"Entre Rios",2,"Nordeste",0,"291790",2,20,10,10,8,12,0,0,0,0,0,20,10,10,8,12,8,9.33568320466737,9.28042597954287,0.279710300321445,29
"5862","BA","Jandaíra",10726,11335.37,29018,"Entre Rios",2,"Nordeste",0,"291790",3,6,0,6,3,3,0,0,0,0,0,6,0,6,3,3,2,9.33568320466737,9.28042597954287,0.390032945599536,31
"5863","BA","Jandaíra",10726,11335.37,29018,"Entre Rios",2,"Nordeste",0,"291790",4,8,3,5,5,3,0,0,0,0,0,8,3,5,5,3,2,9.33568320466737,9.28042597954287,0.443134905759208,30
"5864","BA","Jandaíra",10726,11335.37,29018,"Entre Rios",2,"Nordeste",0,"291790",5,18,6,12,10,8,1,1,0,0,1,19,7,12,10,9,4,9.33568320466737,9.28042597954287,0.43665227622023,31
"5865","BA","Jequié",156126,16887.27,29024,"Jequié",2,"Nordeste",1,"291800",2,148,44,104,65,83,1,1,0,1,0,149,45,104,66,83,94,9.73431536263463,11.9584186525315,0.289448613804854,29
"5866","BA","Jequié",156126,16887.27,29024,"Jequié",2,"Nordeste",1,"291800",3,144,42,102,51,93,2,1,1,1,1,146,43,103,52,94,89,9.73431536263463,11.9584186525315,0.38246426466016,31
"5867","BA","Jequié",156126,16887.27,29024,"Jequié",2,"Nordeste",1,"291800",4,146,36,110,63,83,0,0,0,0,0,146,36,110,63,83,104,9.73431536263463,11.9584186525315,0.422882313177151,30
"5868","BA","Jequié",156126,16887.27,29024,"Jequié",2,"Nordeste",1,"291800",5,172,42,130,66,106,3,1,2,2,1,175,43,132,68,107,133,9.73431536263463,11.9584186525315,0.408856710304541,31
"5869","BA","Jeremoabo",40651,8080.34,29013,"Jeremoabo",2,"Nordeste",0,"291810",2,36,12,24,13,23,0,0,0,0,0,36,12,24,13,23,17,8.99718922983776,10.6127787149194,0.291591218062568,29
"5870","BA","Jeremoabo",40651,8080.34,29013,"Jeremoabo",2,"Nordeste",0,"291810",3,44,23,21,22,22,0,0,0,0,0,44,23,21,22,22,18,8.99718922983776,10.6127787149194,0.374502091362496,31
"5871","BA","Jeremoabo",40651,8080.34,29013,"Jeremoabo",2,"Nordeste",0,"291810",4,32,17,15,21,11,0,0,0,0,0,32,17,15,21,11,23,8.99718922983776,10.6127787149194,0.399035786147181,30
"5872","BA","Jeremoabo",40651,8080.34,29013,"Jeremoabo",2,"Nordeste",0,"291810",5,27,13,14,10,17,0,0,0,0,0,27,13,14,10,17,17,8.99718922983776,10.6127787149194,0.410862191442665,31
"5873","BA","Jiquiriçá",14557,6879.14,29024,"Jequié",2,"Nordeste",0,"291820",2,8,1,7,2,6,0,0,0,0,0,8,1,7,2,6,6,8.83624892311424,9.58582725656466,0.272120917510476,29
"5874","BA","Jiquiriçá",14557,6879.14,29024,"Jequié",2,"Nordeste",0,"291820",3,12,5,7,7,5,0,0,0,0,0,12,5,7,7,5,3,8.83624892311424,9.58582725656466,0.368579786758471,31
"5875","BA","Jiquiriçá",14557,6879.14,29024,"Jequié",2,"Nordeste",0,"291820",4,8,2,6,2,6,0,0,0,0,0,8,2,6,2,6,5,8.83624892311424,9.58582725656466,0.392091893960881,30
"5876","BA","Jiquiriçá",14557,6879.14,29024,"Jequié",2,"Nordeste",0,"291820",5,19,8,11,8,11,0,0,0,0,0,19,8,11,8,11,7,8.83624892311424,9.58582725656466,0.424651831598716,31
"5877","BA","Jitaúna",10808,14818.13,29024,"Jequié",2,"Nordeste",0,"291830",2,11,4,7,7,4,0,0,0,0,0,11,4,7,7,4,11,9.6036067100519,9.28804187964004,0.27070491141605,29
"5878","BA","Jitaúna",10808,14818.13,29024,"Jequié",2,"Nordeste",0,"291830",3,10,4,6,3,7,0,0,0,0,0,10,4,6,3,7,9,9.6036067100519,9.28804187964004,0.369210825757722,31
"5879","BA","Jitaúna",10808,14818.13,29024,"Jequié",2,"Nordeste",0,"291830",4,16,5,11,10,6,0,0,0,0,0,16,5,11,10,6,9,9.6036067100519,9.28804187964004,0.413604500095267,30
"5880","BA","Jitaúna",10808,14818.13,29024,"Jequié",2,"Nordeste",0,"291830",5,16,5,11,4,12,0,0,0,0,0,16,5,11,4,12,13,9.6036067100519,9.28804187964004,0.400043160578554,31
"5881","BA","João Dourado",25402,8412.7,29009,"Irecê",2,"Nordeste",0,"291835",2,28,11,17,19,9,0,0,0,0,0,28,11,17,19,9,18,9.037497747816,10.1425831900643,0.293283256233393,29
"5882","BA","João Dourado",25402,8412.7,29009,"Irecê",2,"Nordeste",0,"291835",3,28,9,19,14,14,0,0,0,0,0,28,9,19,14,14,14,9.037497747816,10.1425831900643,0.366126741642963,31
"5883","BA","João Dourado",25402,8412.7,29009,"Irecê",2,"Nordeste",0,"291835",4,21,7,14,9,12,1,0,1,1,0,22,7,15,10,12,19,9.037497747816,10.1425831900643,0.374113347030308,30
"5884","BA","João Dourado",25402,8412.7,29009,"Irecê",2,"Nordeste",0,"291835",5,24,13,11,14,10,0,0,0,0,0,24,13,11,14,10,10,9.037497747816,10.1425831900643,0.379536257018356,31
"5885","BA","Juazeiro",218162,19032.14,29004,"Juazeiro",2,"Nordeste",1,"291840",2,281,101,180,128,153,3,0,3,1,2,284,101,183,129,155,119,9.85388440798768,12.2929931850609,0.286246376381477,29
"5886","BA","Juazeiro",218162,19032.14,29004,"Juazeiro",2,"Nordeste",1,"291840",3,328,98,230,152,176,6,3,3,2,4,334,101,233,154,180,138,9.85388440798768,12.2929931850609,0.380882570245079,31
"5887","BA","Juazeiro",218162,19032.14,29004,"Juazeiro",2,"Nordeste",1,"291840",4,294,103,191,133,161,6,3,3,4,2,300,106,194,137,163,111,9.85388440798768,12.2929931850609,0.419184749253139,30
"5888","BA","Juazeiro",218162,19032.14,29004,"Juazeiro",2,"Nordeste",1,"291840",5,362,121,241,158,204,5,2,3,2,3,367,123,244,160,207,120,9.85388440798768,12.2929931850609,0.401928089783814,31
"5889","BA","Jucuruçu",8988,10218.73,29032,"Porto Seguro",2,"Nordeste",0,"291845",2,7,3,4,0,7,0,0,0,0,0,7,3,4,0,7,3,9.2319775898912,9.10364563330522,0.329080107835497,29
"5890","BA","Jucuruçu",8988,10218.73,29032,"Porto Seguro",2,"Nordeste",0,"291845",3,7,1,6,3,4,0,0,0,0,0,7,1,6,3,4,3,9.2319775898912,9.10364563330522,0.43492668652399,31
"5891","BA","Jucuruçu",8988,10218.73,29032,"Porto Seguro",2,"Nordeste",0,"291845",4,10,7,3,5,5,0,0,0,0,0,10,7,3,5,5,4,9.2319775898912,9.10364563330522,0.407292492299668,30
"5892","BA","Jucuruçu",8988,10218.73,29032,"Porto Seguro",2,"Nordeste",0,"291845",5,2,1,1,1,1,0,0,0,0,0,2,1,1,1,1,6,9.2319775898912,9.10364563330522,0.455271156412951,31
"5893","BA","Jussara",15262,6839.15,29009,"Irecê",2,"Nordeste",0,"291850",2,21,10,11,13,8,0,0,0,0,0,21,10,11,13,8,8,8.83041873388872,9.63312135784958,0.288765465645587,29
"5894","BA","Jussara",15262,6839.15,29009,"Irecê",2,"Nordeste",0,"291850",3,14,8,6,8,6,0,0,0,0,0,14,8,6,8,6,10,8.83041873388872,9.63312135784958,0.398411502137764,31
"5895","BA","Jussara",15262,6839.15,29009,"Irecê",2,"Nordeste",0,"291850",4,18,7,11,7,11,0,0,0,0,0,18,7,11,7,11,8,8.83041873388872,9.63312135784958,0.426158748018512,30
"5896","BA","Jussara",15262,6839.15,29009,"Irecê",2,"Nordeste",0,"291850",5,8,3,5,5,3,1,1,0,1,0,9,4,5,6,3,10,8.83041873388872,9.63312135784958,0.420554974110701,31
"5897","BA","Jussari",5768,9175.97,29031,"Ilhéus-Itabuna",2,"Nordeste",0,"291855",2,6,2,4,4,2,0,0,0,0,0,6,2,4,4,2,4,9.12434338940543,8.66008067896479,0.27624895360554,29
"5898","BA","Jussari",5768,9175.97,29031,"Ilhéus-Itabuna",2,"Nordeste",0,"291855",3,6,5,1,4,2,0,0,0,0,0,6,5,1,4,2,1,9.12434338940543,8.66008067896479,0.356574348246976,31
"5899","BA","Jussari",5768,9175.97,29031,"Ilhéus-Itabuna",2,"Nordeste",0,"291855",4,3,3,0,2,1,0,0,0,0,0,3,3,0,2,1,6,9.12434338940543,8.66008067896479,0.368762542907553,30
"5900","BA","Jussari",5768,9175.97,29031,"Ilhéus-Itabuna",2,"Nordeste",0,"291855",5,4,1,3,0,4,0,0,0,0,0,4,1,3,0,4,9,9.12434338940543,8.66008067896479,0.396504343011054,31
"5901","BA","Jussiape",5976,8771.05,29023,"Seabra",2,"Nordeste",0,"291860",2,3,2,1,0,3,0,0,0,0,0,3,2,1,0,3,4,9.0792118045394,8.69550672681265,0.29486505916432,29
"5902","BA","Jussiape",5976,8771.05,29023,"Seabra",2,"Nordeste",0,"291860",3,4,0,4,1,3,0,0,0,0,0,4,0,4,1,3,7,9.0792118045394,8.69550672681265,0.371879927609287,31
"5903","BA","Jussiape",5976,8771.05,29023,"Seabra",2,"Nordeste",0,"291860",4,3,0,3,2,1,0,0,0,0,0,3,0,3,2,1,4,9.0792118045394,8.69550672681265,0.418892021559439,30
"5904","BA","Jussiape",5976,8771.05,29023,"Seabra",2,"Nordeste",0,"291860",5,3,1,2,1,2,0,0,0,0,0,3,1,2,1,2,7,9.0792118045394,8.69550672681265,0.423861891703769,31
"5905","BA","Laje",24032,9997.93,29024,"Jequié",2,"Nordeste",0,"291880",2,19,8,11,8,11,1,1,0,0,1,20,9,11,8,12,10,9.21013335054873,10.0871415545639,0.298205018338308,29
"5906","BA","Laje",24032,9997.93,29024,"Jequié",2,"Nordeste",0,"291880",3,13,4,9,4,9,0,0,0,0,0,13,4,9,4,9,9,9.21013335054873,10.0871415545639,0.391181577902402,31
"5907","BA","Laje",24032,9997.93,29024,"Jequié",2,"Nordeste",0,"291880",4,16,6,10,8,8,0,0,0,0,0,16,6,10,8,8,13,9.21013335054873,10.0871415545639,0.417278092588861,30
"5908","BA","Laje",24032,9997.93,29024,"Jequié",2,"Nordeste",0,"291880",5,22,5,17,7,15,0,0,0,0,0,22,5,17,7,15,12,9.21013335054873,10.0871415545639,0.422462542628758,31
"5909","BA","Lajedo do Tabocal",8577,7754.62,29024,"Jequié",2,"Nordeste",0,"291905",2,1,0,1,1,0,0,0,0,0,0,1,0,1,1,0,3,8.95604407376532,9.05683948099042,0.288394522191963,29
"5910","BA","Lajedo do Tabocal",8577,7754.62,29024,"Jequié",2,"Nordeste",0,"291905",3,3,1,2,1,2,0,0,0,0,0,3,1,2,1,2,2,8.95604407376532,9.05683948099042,0.387149924093869,31
"5911","BA","Lajedo do Tabocal",8577,7754.62,29024,"Jequié",2,"Nordeste",0,"291905",4,4,1,3,2,2,0,0,0,0,0,4,1,3,2,2,4,8.95604407376532,9.05683948099042,0.437092239435728,30
"5912","BA","Lajedo do Tabocal",8577,7754.62,29024,"Jequié",2,"Nordeste",0,"291905",5,3,0,3,0,3,0,0,0,0,0,3,0,3,0,3,7,8.95604407376532,9.05683948099042,0.451417549253119,31
"5913","BA","Lamarão",8191,6142.62,29016,"Serrinha",2,"Nordeste",0,"291910",2,9,2,7,3,6,0,0,0,0,0,9,2,7,3,6,6,8.72300664022404,9.0107912695156,0.299511254026161,29
"5914","BA","Lamarão",8191,6142.62,29016,"Serrinha",2,"Nordeste",0,"291910",3,6,4,2,1,5,0,0,0,0,0,6,4,2,1,5,6,8.72300664022404,9.0107912695156,0.383413577425722,31
"5915","BA","Lamarão",8191,6142.62,29016,"Serrinha",2,"Nordeste",0,"291910",4,5,3,2,2,3,1,1,0,0,1,6,4,2,2,4,5,8.72300664022404,9.0107912695156,0.437413619597865,30
"5916","BA","Lamarão",8191,6142.62,29016,"Serrinha",2,"Nordeste",0,"291910",5,6,2,4,4,2,0,0,0,0,0,6,2,4,4,2,6,8.72300664022404,9.0107912695156,0.432980792236658,31
"5917","BA","Lapão",27274,7624.63,29009,"Irecê",2,"Nordeste",0,"291915",2,38,12,26,18,20,0,0,0,0,0,38,12,26,18,20,10,8.93913907570809,10.2136891464178,0.324994268282082,29
"5918","BA","Lapão",27274,7624.63,29009,"Irecê",2,"Nordeste",0,"291915",3,35,8,27,16,19,0,0,0,0,0,35,8,27,16,19,15,8.93913907570809,10.2136891464178,0.417088860126267,31
"5919","BA","Lapão",27274,7624.63,29009,"Irecê",2,"Nordeste",0,"291915",4,34,15,19,13,21,1,1,0,1,0,35,16,19,14,21,16,8.93913907570809,10.2136891464178,0.433343089896458,30
"5920","BA","Lapão",27274,7624.63,29009,"Irecê",2,"Nordeste",0,"291915",5,48,18,30,20,28,0,0,0,0,0,48,18,30,20,28,15,8.93913907570809,10.2136891464178,0.416912193562588,31
"5921","BA","Lauro de Freitas",201635,33059.94,29021,"Salvador",2,"Nordeste",1,"291920",2,153,17,136,44,109,1,0,1,0,1,154,17,137,44,110,99,10.4060775564913,12.2142144112218,0.283127500841091,29
"5922","BA","Lauro de Freitas",201635,33059.94,29021,"Salvador",2,"Nordeste",1,"291920",3,149,33,116,48,101,4,3,1,2,2,153,36,117,50,103,102,10.4060775564913,12.2142144112218,0.398933538068331,31
"5923","BA","Lauro de Freitas",201635,33059.94,29021,"Salvador",2,"Nordeste",1,"291920",4,138,22,116,42,96,4,2,2,0,4,142,24,118,42,100,103,10.4060775564913,12.2142144112218,0.481433036147181,30
"5924","BA","Lauro de Freitas",201635,33059.94,29021,"Salvador",2,"Nordeste",1,"291920",5,166,19,147,33,133,9,2,7,3,6,175,21,154,36,139,131,10.4060775564913,12.2142144112218,0.458790180646835,31
"5925","BA","Lençóis",11499,10749.56,29023,"Seabra",2,"Nordeste",0,"291930",2,3,1,2,1,2,1,1,0,1,0,4,2,2,2,2,3,9.28262010248559,9.35001535404867,0.260263859879528,29
"5926","BA","Lençóis",11499,10749.56,29023,"Seabra",2,"Nordeste",0,"291930",3,11,6,5,9,2,0,0,0,0,0,11,6,5,9,2,5,9.28262010248559,9.35001535404867,0.338287764432842,31
"5927","BA","Lençóis",11499,10749.56,29023,"Seabra",2,"Nordeste",0,"291930",4,4,0,4,3,1,0,0,0,0,0,4,0,4,3,1,3,9.28262010248559,9.35001535404867,0.411357072316811,30
"5928","BA","Lençóis",11499,10749.56,29023,"Seabra",2,"Nordeste",0,"291930",5,5,1,4,0,5,0,0,0,0,0,5,1,4,0,5,9,9.28262010248559,9.35001535404867,0.398879737507062,31
"5929","BA","Licínio de Almeida",12373,8700.57,29026,"Guanambi",2,"Nordeste",0,"291940",2,13,5,8,5,8,0,0,0,0,0,13,5,8,5,8,8,9.07114381973789,9.42327195821398,0.278015996730106,29
"5930","BA","Licínio de Almeida",12373,8700.57,29026,"Guanambi",2,"Nordeste",0,"291940",3,12,4,8,0,12,0,0,0,0,0,12,4,8,0,12,4,9.07114381973789,9.42327195821398,0.354393127874652,31
"5931","BA","Licínio de Almeida",12373,8700.57,29026,"Guanambi",2,"Nordeste",0,"291940",4,4,0,4,0,4,0,0,0,0,0,4,0,4,0,4,9,9.07114381973789,9.42327195821398,0.370997738934036,30
"5932","BA","Licínio de Almeida",12373,8700.57,29026,"Guanambi",2,"Nordeste",0,"291940",5,6,1,5,3,3,0,0,0,0,0,6,1,5,3,3,6,9.07114381973789,9.42327195821398,0.389517979365804,31
"5933","BA","Livramento de Nossa Senhora",46062,9930.9,29025,"Livramento do Brumado",2,"Nordeste",0,"291950",2,36,7,29,12,24,1,0,1,1,0,37,7,30,13,24,20,9.20340638737325,10.737743594056,0.260910247420141,29
"5934","BA","Livramento de Nossa Senhora",46062,9930.9,29025,"Livramento do Brumado",2,"Nordeste",0,"291950",3,42,10,32,16,26,2,2,0,2,0,44,12,32,18,26,22,9.20340638737325,10.737743594056,0.347013218588075,31
"5935","BA","Livramento de Nossa Senhora",46062,9930.9,29025,"Livramento do Brumado",2,"Nordeste",0,"291950",4,26,11,15,8,18,0,0,0,0,0,26,11,15,8,18,24,9.20340638737325,10.737743594056,0.377124583279072,30
"5936","BA","Livramento de Nossa Senhora",46062,9930.9,29025,"Livramento do Brumado",2,"Nordeste",0,"291950",5,39,11,28,13,26,0,0,0,0,0,39,11,28,13,26,14,9.20340638737325,10.737743594056,0.36390549197843,31
"5937","BA","Luís Eduardo Magalhães",90162,72967.01,29001,"Barreiras",2,"Nordeste",1,"291955",2,152,38,114,54,98,1,0,1,1,0,153,38,115,55,98,24,11.1977627001767,11.4093633312538,0.276274409301783,29
"5938","BA","Luís Eduardo Magalhães",90162,72967.01,29001,"Barreiras",2,"Nordeste",1,"291955",3,126,18,108,53,73,1,1,0,0,1,127,19,108,53,74,28,11.1977627001767,11.4093633312538,0.339069220310606,31
"5939","BA","Luís Eduardo Magalhães",90162,72967.01,29001,"Barreiras",2,"Nordeste",1,"291955",4,135,40,95,47,88,0,0,0,0,0,135,40,95,47,88,25,11.1977627001767,11.4093633312538,0.346722910756071,30
"5940","BA","Luís Eduardo Magalhães",90162,72967.01,29001,"Barreiras",2,"Nordeste",1,"291955",5,172,41,131,72,100,1,1,0,0,1,173,42,131,72,101,26,11.1977627001767,11.4093633312538,0.332287111514156,31
"5941","BA","Macajuba",11332,6456.98,29011,"Itaberaba",2,"Nordeste",0,"291960",2,7,3,4,6,1,0,0,0,0,0,7,3,4,6,1,7,8.77291699520801,9.33538586095041,0.269886145280682,29
"5942","BA","Macajuba",11332,6456.98,29011,"Itaberaba",2,"Nordeste",0,"291960",3,12,4,8,4,8,1,1,0,1,0,13,5,8,5,8,9,8.77291699520801,9.33538586095041,0.345194695683666,31
"5943","BA","Macajuba",11332,6456.98,29011,"Itaberaba",2,"Nordeste",0,"291960",4,10,5,5,6,4,0,0,0,0,0,10,5,5,6,4,3,8.77291699520801,9.33538586095041,0.352714989008271,30
"5944","BA","Macajuba",11332,6456.98,29011,"Itaberaba",2,"Nordeste",0,"291960",5,6,2,4,4,2,0,0,0,0,0,6,2,4,4,2,7,8.77291699520801,9.33538586095041,0.359196300994918,31
"5945","BA","Macarani",18909,9005.25,29029,"Itapetinga",2,"Nordeste",1,"291970",2,15,9,6,10,5,0,0,0,0,0,15,9,6,10,5,9,9.10556301957894,9.84739327818122,0.278554803203076,29
"5946","BA","Macarani",18909,9005.25,29029,"Itapetinga",2,"Nordeste",1,"291970",3,10,5,5,7,3,0,0,0,0,0,10,5,5,7,3,6,9.10556301957894,9.84739327818122,0.345274591491047,31
"5947","BA","Macarani",18909,9005.25,29029,"Itapetinga",2,"Nordeste",1,"291970",4,12,2,10,9,3,0,0,0,0,0,12,2,10,9,3,11,9.10556301957894,9.84739327818122,0.344730131020171,30
"5948","BA","Macarani",18909,9005.25,29029,"Itapetinga",2,"Nordeste",1,"291970",5,18,5,13,4,14,0,0,0,0,0,18,5,13,4,14,10,9.10556301957894,9.84739327818122,0.348786724659147,31
"5949","BA","Macaúbas",50161,7457.96,29022,"Boquira",2,"Nordeste",0,"291980",2,33,14,19,15,18,0,0,0,0,0,33,14,19,15,18,23,8.91703719735619,10.8229931113122,0.234675733580449,29
"5950","BA","Macaúbas",50161,7457.96,29022,"Boquira",2,"Nordeste",0,"291980",3,49,8,41,14,35,0,0,0,0,0,49,8,41,14,35,23,8.91703719735619,10.8229931113122,0.317481834767655,31
"5951","BA","Macaúbas",50161,7457.96,29022,"Boquira",2,"Nordeste",0,"291980",4,42,16,26,17,25,0,0,0,0,0,42,16,26,17,25,20,8.91703719735619,10.8229931113122,0.358046207449978,30
"5952","BA","Macaúbas",50161,7457.96,29022,"Boquira",2,"Nordeste",0,"291980",5,47,12,35,25,22,0,0,0,0,0,47,12,35,25,22,25,8.91703719735619,10.8229931113122,0.36774231132599,31
"5953","BA","Macururé",7787,5528.26,29005,"Paulo Afonso",2,"Nordeste",0,"291990",2,6,1,5,1,5,0,0,0,0,0,6,1,5,1,5,5,8.61762839762657,8.96021095557699,0.29533584603613,29
"5954","BA","Macururé",7787,5528.26,29005,"Paulo Afonso",2,"Nordeste",0,"291990",3,5,1,4,2,3,0,0,0,0,0,5,1,4,2,3,4,8.61762839762657,8.96021095557699,0.371852834996052,31
"5955","BA","Macururé",7787,5528.26,29005,"Paulo Afonso",2,"Nordeste",0,"291990",4,4,1,3,1,3,0,0,0,0,0,4,1,3,1,3,2,8.61762839762657,8.96021095557699,0.403695223709056,30
"5956","BA","Macururé",7787,5528.26,29005,"Paulo Afonso",2,"Nordeste",0,"291990",5,3,0,3,1,2,1,0,1,1,0,4,0,4,2,2,2,8.61762839762657,8.96021095557699,0.398412459393148,31
"5957","BA","Madre de Deus",21432,23019.15,29021,"Salvador",2,"Nordeste",1,"291992",2,14,1,13,6,8,0,0,0,0,0,14,1,13,6,8,7,10.0440817571806,9.97264041122444,0.29361671905695,29
"5958","BA","Madre de Deus",21432,23019.15,29021,"Salvador",2,"Nordeste",1,"291992",3,15,3,12,6,9,0,0,0,0,0,15,3,12,6,9,5,10.0440817571806,9.97264041122444,0.39321079787166,31
"5959","BA","Madre de Deus",21432,23019.15,29021,"Salvador",2,"Nordeste",1,"291992",4,6,1,5,2,4,0,0,0,0,0,6,1,5,2,4,7,10.0440817571806,9.97264041122444,0.452326723923309,30
"5960","BA","Madre de Deus",21432,23019.15,29021,"Salvador",2,"Nordeste",1,"291992",5,6,2,4,4,2,0,0,0,0,0,6,2,4,4,2,10,10.0440817571806,9.97264041122444,0.439207746804622,31
"5961","BA","Maiquinique",10206,10168.34,29029,"Itapetinga",2,"Nordeste",0,"292000",2,5,4,1,4,1,0,0,0,0,0,5,4,1,4,1,7,9.22703425054785,9.23073106162392,0.307966911292391,29
"5962","BA","Maiquinique",10206,10168.34,29029,"Itapetinga",2,"Nordeste",0,"292000",3,3,2,1,2,1,0,0,0,0,0,3,2,1,2,1,4,9.22703425054785,9.23073106162392,0.407842555784495,31
"5963","BA","Maiquinique",10206,10168.34,29029,"Itapetinga",2,"Nordeste",0,"292000",4,5,2,3,3,2,0,0,0,0,0,5,2,3,3,2,2,9.22703425054785,9.23073106162392,0.402266374139814,30
"5964","BA","Maiquinique",10206,10168.34,29029,"Itapetinga",2,"Nordeste",0,"292000",5,5,2,3,2,3,0,0,0,0,0,5,2,3,2,3,5,9.22703425054785,9.23073106162392,0.36173891993404,31
"5965","BA","Mairi",18602,7023.86,29011,"Itaberaba",2,"Nordeste",0,"292010",2,13,4,9,8,5,1,1,0,1,0,14,5,9,9,5,10,8.85706820345344,9.83102438080241,0.2673372065915,29
"5966","BA","Mairi",18602,7023.86,29011,"Itaberaba",2,"Nordeste",0,"292010",3,15,8,7,7,8,0,0,0,0,0,15,8,7,7,8,15,8.85706820345344,9.83102438080241,0.357217433145261,31
"5967","BA","Mairi",18602,7023.86,29011,"Itaberaba",2,"Nordeste",0,"292010",4,10,2,8,5,5,0,0,0,0,0,10,2,8,5,5,13,8.85706820345344,9.83102438080241,0.388646988759691,30
"5968","BA","Mairi",18602,7023.86,29011,"Itaberaba",2,"Nordeste",0,"292010",5,15,3,12,5,10,0,0,0,0,0,15,3,12,5,10,8,8.85706820345344,9.83102438080241,0.39037199656058,31
"5969","BA","Malhada",16861,8151.43,29026,"Guanambi",2,"Nordeste",0,"292020",2,16,6,10,6,10,0,0,0,0,0,16,6,10,6,10,8,9.00594865096628,9.73275854177798,0.35186429075448,29
"5970","BA","Malhada",16861,8151.43,29026,"Guanambi",2,"Nordeste",0,"292020",3,10,3,7,3,7,0,0,0,0,0,10,3,7,3,7,8,9.00594865096628,9.73275854177798,0.411042271129797,31
"5971","BA","Malhada",16861,8151.43,29026,"Guanambi",2,"Nordeste",0,"292020",4,7,0,7,2,5,1,1,0,0,1,8,1,7,2,6,6,9.00594865096628,9.73275854177798,0.446078192605232,30
"5972","BA","Malhada",16861,8151.43,29026,"Guanambi",2,"Nordeste",0,"292020",5,9,2,7,3,6,0,0,0,0,0,9,2,7,3,6,5,9.00594865096628,9.73275854177798,0.392314034150202,31
"5973","BA","Malhada de Pedras",8359,7382.54,29027,"Brumado",2,"Nordeste",0,"292030",2,10,2,8,5,5,0,0,0,0,0,10,2,8,5,5,4,8.90687303182216,9.03109408169916,0.282751155715,29
"5974","BA","Malhada de Pedras",8359,7382.54,29027,"Brumado",2,"Nordeste",0,"292030",3,8,3,5,1,7,0,0,0,0,0,8,3,5,1,7,6,8.90687303182216,9.03109408169916,0.334118968319668,31
"5975","BA","Malhada de Pedras",8359,7382.54,29027,"Brumado",2,"Nordeste",0,"292030",4,4,2,2,3,1,0,0,0,0,0,4,2,2,3,1,0,8.90687303182216,9.03109408169916,0.377932526445101,30
"5976","BA","Malhada de Pedras",8359,7382.54,29027,"Brumado",2,"Nordeste",0,"292030",5,7,4,3,4,3,0,0,0,0,0,7,4,3,4,3,5,8.90687303182216,9.03109408169916,0.365910843360984,31
"5977","BA","Manoel Vitorino",13087,10233.65,29028,"Vitória da Conquista",2,"Nordeste",0,"292040",2,14,4,10,6,8,0,0,0,0,0,14,4,10,6,8,10,9.23343658905381,9.47937465005548,0.258939225921715,29
"5978","BA","Manoel Vitorino",13087,10233.65,29028,"Vitória da Conquista",2,"Nordeste",0,"292040",3,12,5,7,7,5,0,0,0,0,0,12,5,7,7,5,12,9.23343658905381,9.47937465005548,0.360417013440174,31
"5979","BA","Manoel Vitorino",13087,10233.65,29028,"Vitória da Conquista",2,"Nordeste",0,"292040",4,4,2,2,1,3,0,0,0,0,0,4,2,2,1,3,11,9.23343658905381,9.47937465005548,0.385678831961972,30
"5980","BA","Manoel Vitorino",13087,10233.65,29028,"Vitória da Conquista",2,"Nordeste",0,"292040",5,17,5,12,8,9,0,0,0,0,0,17,5,12,8,9,4,9.23343658905381,9.47937465005548,0.375058213578707,31
"5981","BA","Maracás",20393,39669.93,29024,"Jequié",2,"Nordeste",0,"292050",2,30,13,17,8,22,1,0,1,1,0,31,13,18,9,22,15,10.5883487489492,9.92294698369235,0.269261528245117,29
"5982","BA","Maracás",20393,39669.93,29024,"Jequié",2,"Nordeste",0,"292050",3,25,8,17,6,19,1,1,0,0,1,26,9,17,6,20,11,10.5883487489492,9.92294698369235,0.360956516672453,31
"5983","BA","Maracás",20393,39669.93,29024,"Jequié",2,"Nordeste",0,"292050",4,24,9,15,10,14,0,0,0,0,0,24,9,15,10,14,11,10.5883487489492,9.92294698369235,0.38913515738129,30
"5984","BA","Maracás",20393,39669.93,29024,"Jequié",2,"Nordeste",0,"292050",5,18,7,11,4,14,1,1,0,0,1,19,8,11,4,15,16,10.5883487489492,9.92294698369235,0.379642371234459,31
"5985","BA","Maragogipe",44793,7429.63,29020,"Santo Antônio de Jesus",2,"Nordeste",0,"292060",2,30,8,22,15,15,0,0,0,0,0,30,8,22,15,15,23,8.91323133835609,10.7098071561948,0.292902103570523,29
"5986","BA","Maragogipe",44793,7429.63,29020,"Santo Antônio de Jesus",2,"Nordeste",0,"292060",3,25,9,16,11,14,1,1,0,0,1,26,10,16,11,15,21,8.91323133835609,10.7098071561948,0.372424695481524,31
"5987","BA","Maragogipe",44793,7429.63,29020,"Santo Antônio de Jesus",2,"Nordeste",0,"292060",4,29,7,22,10,19,2,1,1,0,2,31,8,23,10,21,28,8.91323133835609,10.7098071561948,0.440726155422312,30
"5988","BA","Maragogipe",44793,7429.63,29020,"Santo Antônio de Jesus",2,"Nordeste",0,"292060",5,40,12,28,17,23,1,1,0,1,0,41,13,28,18,23,34,8.91323133835609,10.7098071561948,0.44414235026272,31
"5989","BA","Maraú",20617,11351.44,29030,"Valença",2,"Nordeste",0,"292070",2,21,14,7,9,12,2,1,1,2,0,23,15,8,11,12,7,9.33709988710864,9.93387125717057,0.255252241648558,29
"5990","BA","Maraú",20617,11351.44,29030,"Valença",2,"Nordeste",0,"292070",3,25,14,11,13,12,0,0,0,0,0,25,14,11,13,12,7,9.33709988710864,9.93387125717057,0.365309449709679,31
"5991","BA","Maraú",20617,11351.44,29030,"Valença",2,"Nordeste",0,"292070",4,21,13,8,11,10,1,0,1,1,0,22,13,9,12,10,8,9.33709988710864,9.93387125717057,0.443796872010399,30
"5992","BA","Maraú",20617,11351.44,29030,"Valença",2,"Nordeste",0,"292070",5,21,4,17,9,12,0,0,0,0,0,21,4,17,9,12,8,9.33709988710864,9.93387125717057,0.444953567973202,31
"5993","BA","Marcionílio Souza",10380,7384.67,29024,"Jequié",2,"Nordeste",0,"292080",2,11,3,8,4,7,0,0,0,0,0,11,3,8,4,7,6,8.90716150879442,9.24763615671988,0.298844719490797,29
"5994","BA","Marcionílio Souza",10380,7384.67,29024,"Jequié",2,"Nordeste",0,"292080",3,10,4,6,6,4,0,0,0,0,0,10,4,6,6,4,6,8.90716150879442,9.24763615671988,0.385664115891032,31
"5995","BA","Marcionílio Souza",10380,7384.67,29024,"Jequié",2,"Nordeste",0,"292080",4,8,3,5,4,4,0,0,0,0,0,8,3,5,4,4,7,8.90716150879442,9.24763615671988,0.427025415397309,30
"5996","BA","Marcionílio Souza",10380,7384.67,29024,"Jequié",2,"Nordeste",0,"292080",5,5,1,4,2,3,0,0,0,0,0,5,1,4,2,3,8,8.90716150879442,9.24763615671988,0.441360079001388,31
"5997","BA","Mascote",13717,9338.7,29031,"Ilhéus-Itabuna",2,"Nordeste",0,"292090",2,9,5,4,7,2,2,1,1,1,1,11,6,5,8,3,3,9.14192233524007,9.52639121847841,0.335666722254371,29
"5998","BA","Mascote",13717,9338.7,29031,"Ilhéus-Itabuna",2,"Nordeste",0,"292090",3,10,6,4,4,6,0,0,0,0,0,10,6,4,4,6,7,9.14192233524007,9.52639121847841,0.441311772137109,31
"5999","BA","Mascote",13717,9338.7,29031,"Ilhéus-Itabuna",2,"Nordeste",0,"292090",4,7,4,3,6,1,0,0,0,0,0,7,4,3,6,1,3,9.14192233524007,9.52639121847841,0.442768807010013,30
"6000","BA","Mascote",13717,9338.7,29031,"Ilhéus-Itabuna",2,"Nordeste",0,"292090",5,11,5,6,6,5,0,0,0,0,0,11,5,6,6,5,8,9.14192233524007,9.52639121847841,0.421159546819738,31
"6001","BA","Mata de São João",47126,24684,29019,"Catu",2,"Nordeste",1,"292100",2,50,10,40,21,29,0,0,0,0,0,50,10,40,21,29,26,10.113910539441,10.7605801446843,0.269042794185435,29
"6002","BA","Mata de São João",47126,24684,29019,"Catu",2,"Nordeste",1,"292100",3,59,23,36,21,38,0,0,0,0,0,59,23,36,21,38,21,10.113910539441,10.7605801446843,0.35469294168911,31
"6003","BA","Mata de São João",47126,24684,29019,"Catu",2,"Nordeste",1,"292100",4,52,24,28,16,36,1,1,0,1,0,53,25,28,17,36,18,10.113910539441,10.7605801446843,0.407319697597441,30
"6004","BA","Mata de São João",47126,24684,29019,"Catu",2,"Nordeste",1,"292100",5,55,12,43,18,37,0,0,0,0,0,55,12,43,18,37,22,10.113910539441,10.7605801446843,0.403422251816686,31
"6005","BA","Matina",12283,6127.39,29026,"Guanambi",2,"Nordeste",0,"292105",2,14,4,10,5,9,0,0,0,0,0,14,4,10,5,9,2,8.72052416338475,9.41597147153909,0.262291988560493,29
"6006","BA","Matina",12283,6127.39,29026,"Guanambi",2,"Nordeste",0,"292105",3,4,1,3,4,0,0,0,0,0,0,4,1,3,4,0,5,8.72052416338475,9.41597147153909,0.342200116033149,31
"6007","BA","Matina",12283,6127.39,29026,"Guanambi",2,"Nordeste",0,"292105",4,11,4,7,2,9,0,0,0,0,0,11,4,7,2,9,3,8.72052416338475,9.41597147153909,0.392969350063561,30
"6008","BA","Matina",12283,6127.39,29026,"Guanambi",2,"Nordeste",0,"292105",5,15,7,8,9,6,0,0,0,0,0,15,7,8,9,6,6,8.72052416338475,9.41597147153909,0.371586891966835,31
"6009","BA","Medeiros Neto",22716,14560.93,29032,"Porto Seguro",2,"Nordeste",0,"292110",2,22,8,14,13,9,1,1,0,0,1,23,9,14,13,10,11,9.58609719333722,10.0308248009973,0.28069747102911,29
"6010","BA","Medeiros Neto",22716,14560.93,29032,"Porto Seguro",2,"Nordeste",0,"292110",3,19,6,13,6,13,0,0,0,0,0,19,6,13,6,13,14,9.58609719333722,10.0308248009973,0.344504144164112,31
"6011","BA","Medeiros Neto",22716,14560.93,29032,"Porto Seguro",2,"Nordeste",0,"292110",4,27,10,17,10,17,0,0,0,0,0,27,10,17,10,17,22,9.58609719333722,10.0308248009973,0.345063466033721,30
"6012","BA","Medeiros Neto",22716,14560.93,29032,"Porto Seguro",2,"Nordeste",0,"292110",5,24,10,14,12,12,0,0,0,0,0,24,10,14,12,12,17,9.58609719333722,10.0308248009973,0.335327750087258,31
"6013","BA","Miguel Calmon",25894,8294.65,29010,"Jacobina",2,"Nordeste",0,"292120",2,17,6,11,4,13,0,0,0,0,0,17,6,11,4,13,14,9.02336600764152,10.1617665606186,0.265514482761417,29
"6014","BA","Miguel Calmon",25894,8294.65,29010,"Jacobina",2,"Nordeste",0,"292120",3,13,1,12,4,9,0,0,0,0,0,13,1,12,4,9,18,9.02336600764152,10.1617665606186,0.365574987860532,31
"6015","BA","Miguel Calmon",25894,8294.65,29010,"Jacobina",2,"Nordeste",0,"292120",4,21,10,11,8,13,0,0,0,0,0,21,10,11,8,13,19,9.02336600764152,10.1617665606186,0.401493059561921,30
"6016","BA","Miguel Calmon",25894,8294.65,29010,"Jacobina",2,"Nordeste",0,"292120",5,21,6,15,5,16,0,0,0,0,0,21,6,15,5,16,17,9.02336600764152,10.1617665606186,0.401187600927333,31
"6017","BA","Milagres",10893,8592.64,29024,"Jequié",2,"Nordeste",0,"292130",2,7,1,6,3,4,0,0,0,0,0,7,1,6,3,4,6,9.05866130187028,9.29587566008245,0.278511966683766,29
"6018","BA","Milagres",10893,8592.64,29024,"Jequié",2,"Nordeste",0,"292130",3,6,3,3,2,4,1,0,1,0,1,7,3,4,2,5,10,9.05866130187028,9.29587566008245,0.374658377401851,31
"6019","BA","Milagres",10893,8592.64,29024,"Jequié",2,"Nordeste",0,"292130",4,5,0,5,2,3,0,0,0,0,0,5,0,5,2,3,11,9.05866130187028,9.29587566008245,0.394554681614596,30
"6020","BA","Milagres",10893,8592.64,29024,"Jequié",2,"Nordeste",0,"292130",5,10,4,6,4,6,0,0,0,0,0,10,4,6,4,6,10,9.05866130187028,9.29587566008245,0.393008246898188,31
"6021","BA","Mirangaba",18474,6388.68,29010,"Jacobina",2,"Nordeste",0,"292140",2,9,1,8,1,8,0,0,0,0,0,9,1,8,1,8,4,8.76228295326253,9.82411961715256,0.302060249522475,29
"6022","BA","Mirangaba",18474,6388.68,29010,"Jacobina",2,"Nordeste",0,"292140",3,11,8,3,6,5,0,0,0,0,0,11,8,3,6,5,8,8.76228295326253,9.82411961715256,0.406862612202031,31
"6023","BA","Mirangaba",18474,6388.68,29010,"Jacobina",2,"Nordeste",0,"292140",4,6,2,4,1,5,0,0,0,0,0,6,2,4,1,5,10,8.76228295326253,9.82411961715256,0.42346990666339,30
"6024","BA","Mirangaba",18474,6388.68,29010,"Jacobina",2,"Nordeste",0,"292140",5,11,5,6,4,7,0,0,0,0,0,11,5,6,4,7,4,8.76228295326253,9.82411961715256,0.456373222539331,31
"6025","BA","Mirante",8447,6633.66,29028,"Vitória da Conquista",2,"Nordeste",0,"292145",2,9,1,8,0,9,0,0,0,0,0,9,1,8,0,9,2,8.79991196706307,9.0415666277275,0.328660994146443,29
"6026","BA","Mirante",8447,6633.66,29028,"Vitória da Conquista",2,"Nordeste",0,"292145",3,9,5,4,1,8,0,0,0,0,0,9,5,4,1,8,5,8.79991196706307,9.0415666277275,0.397557469150964,31
"6027","BA","Mirante",8447,6633.66,29028,"Vitória da Conquista",2,"Nordeste",0,"292145",4,7,2,5,3,4,0,0,0,0,0,7,2,5,3,4,1,8.79991196706307,9.0415666277275,0.413894309784295,30
"6028","BA","Mirante",8447,6633.66,29028,"Vitória da Conquista",2,"Nordeste",0,"292145",5,8,1,7,2,6,0,0,0,0,0,8,1,7,2,6,4,8.79991196706307,9.0415666277275,0.420184049482959,31
"6029","BA","Monte Santo",49278,6863.25,29014,"Euclides da Cunha",2,"Nordeste",0,"292150",2,33,17,16,13,20,0,0,0,0,0,33,17,16,13,20,34,8.8339363694636,10.8052330129682,0.281923742973589,29
"6030","BA","Monte Santo",49278,6863.25,29014,"Euclides da Cunha",2,"Nordeste",0,"292150",3,35,18,17,13,22,0,0,0,0,0,35,18,17,13,22,22,8.8339363694636,10.8052330129682,0.357821099028814,31
"6031","BA","Monte Santo",49278,6863.25,29014,"Euclides da Cunha",2,"Nordeste",0,"292150",4,61,29,32,31,30,1,0,1,1,0,62,29,33,32,30,24,8.8339363694636,10.8052330129682,0.388445311221992,30
"6032","BA","Monte Santo",49278,6863.25,29014,"Euclides da Cunha",2,"Nordeste",0,"292150",5,53,30,23,25,28,0,0,0,0,0,53,30,23,25,28,26,8.8339363694636,10.8052330129682,0.417609023516879,31
"6033","BA","Morro do Chapéu",35440,10691.9,29010,"Jacobina",2,"Nordeste",0,"292170",2,31,9,22,9,22,0,0,0,0,0,31,9,22,9,22,21,9.27724172442794,10.475596404719,0.292590864701356,29
"6034","BA","Morro do Chapéu",35440,10691.9,29010,"Jacobina",2,"Nordeste",0,"292170",3,28,9,19,12,16,0,0,0,0,0,28,9,19,12,16,20,9.27724172442794,10.475596404719,0.374423290584185,31
"6035","BA","Morro do Chapéu",35440,10691.9,29010,"Jacobina",2,"Nordeste",0,"292170",4,28,12,16,12,16,0,0,0,0,0,28,12,16,12,16,22,9.27724172442794,10.475596404719,0.403971569566268,30
"6036","BA","Morro do Chapéu",35440,10691.9,29010,"Jacobina",2,"Nordeste",0,"292170",5,42,8,34,23,19,0,0,0,0,0,42,8,34,23,19,18,9.27724172442794,10.475596404719,0.397680782578202,31
"6037","BA","Mortugaba",12052,7337.5,29026,"Guanambi",2,"Nordeste",0,"292180",2,9,1,8,4,5,0,0,0,0,0,9,1,8,4,5,3,8.90075346413635,9.39698590025019,0.270588722542701,29
"6038","BA","Mortugaba",12052,7337.5,29026,"Guanambi",2,"Nordeste",0,"292180",3,11,3,8,5,6,0,0,0,0,0,11,3,8,5,6,6,8.90075346413635,9.39698590025019,0.372895556368179,31
"6039","BA","Mortugaba",12052,7337.5,29026,"Guanambi",2,"Nordeste",0,"292180",4,11,3,8,7,4,0,0,0,0,0,11,3,8,7,4,11,8.90075346413635,9.39698590025019,0.397347643187143,30
"6040","BA","Mortugaba",12052,7337.5,29026,"Guanambi",2,"Nordeste",0,"292180",5,9,0,9,4,5,0,0,0,0,0,9,0,9,4,5,8,8.90075346413635,9.39698590025019,0.405775843311642,31
"6041","BA","Mucugê",8889,37229.67,29023,"Seabra",2,"Nordeste",0,"292190",2,12,2,10,7,5,0,0,0,0,0,12,2,10,7,5,1,10.524861303008,9.09256983624167,0.288732126150892,29
"6042","BA","Mucugê",8889,37229.67,29023,"Seabra",2,"Nordeste",0,"292190",3,10,2,8,6,4,0,0,0,0,0,10,2,8,6,4,2,10.524861303008,9.09256983624167,0.383690588277966,31
"6043","BA","Mucugê",8889,37229.67,29023,"Seabra",2,"Nordeste",0,"292190",4,10,5,5,3,7,0,0,0,0,0,10,5,5,3,7,6,10.524861303008,9.09256983624167,0.419452010231792,30
"6044","BA","Mucugê",8889,37229.67,29023,"Seabra",2,"Nordeste",0,"292190",5,5,2,3,0,5,0,0,0,0,0,5,2,3,0,5,5,10.524861303008,9.09256983624167,0.39359767305358,31
"6045","BA","Mucuri",42251,59689.06,29032,"Porto Seguro",2,"Nordeste",0,"292200",2,50,17,33,24,26,0,0,0,0,0,50,17,33,24,26,18,10.9969040330072,10.6513833011443,0.275918439013059,29
"6046","BA","Mucuri",42251,59689.06,29032,"Porto Seguro",2,"Nordeste",0,"292200",3,34,9,25,16,18,0,0,0,0,0,34,9,25,16,18,16,10.9969040330072,10.6513833011443,0.379347239201108,31
"6047","BA","Mucuri",42251,59689.06,29032,"Porto Seguro",2,"Nordeste",0,"292200",4,39,11,28,12,27,0,0,0,0,0,39,11,28,12,27,13,10.9969040330072,10.6513833011443,0.39130550865891,30
"6048","BA","Mucuri",42251,59689.06,29032,"Porto Seguro",2,"Nordeste",0,"292200",5,58,22,36,30,28,0,0,0,0,0,58,22,36,30,28,18,10.9969040330072,10.6513833011443,0.384320011875433,31
"6049","BA","Mulungu do Morro",10673,34599.69,29009,"Irecê",2,"Nordeste",0,"292205",2,10,5,5,4,6,0,0,0,0,0,10,5,5,4,6,13,10.4516000014681,9.27547246691396,0.29552673295892,29
"6050","BA","Mulungu do Morro",10673,34599.69,29009,"Irecê",2,"Nordeste",0,"292205",3,7,4,3,3,4,0,0,0,0,0,7,4,3,3,4,4,10.4516000014681,9.27547246691396,0.370181167002129,31
"6051","BA","Mulungu do Morro",10673,34599.69,29009,"Irecê",2,"Nordeste",0,"292205",4,20,11,9,8,12,0,0,0,0,0,20,11,9,8,12,7,10.4516000014681,9.27547246691396,0.412535247428806,30
"6052","BA","Mulungu do Morro",10673,34599.69,29009,"Irecê",2,"Nordeste",0,"292205",5,16,4,12,12,4,0,0,0,0,0,16,4,12,12,4,11,10.4516000014681,9.27547246691396,0.390308367815188,31
"6053","BA","Mundo Novo",26970,6060.56,29011,"Itaberaba",2,"Nordeste",0,"292210",2,11,3,8,6,5,0,0,0,0,0,11,3,8,6,5,13,8.70955748403481,10.2024804161338,0.287592054380948,29
"6054","BA","Mundo Novo",26970,6060.56,29011,"Itaberaba",2,"Nordeste",0,"292210",3,8,5,3,3,5,1,1,0,0,1,9,6,3,3,6,15,8.70955748403481,10.2024804161338,0.373436272403419,31
"6055","BA","Mundo Novo",26970,6060.56,29011,"Itaberaba",2,"Nordeste",0,"292210",4,11,6,5,3,8,1,0,1,0,1,12,6,6,3,9,6,8.70955748403481,10.2024804161338,0.421789707812181,30
"6056","BA","Mundo Novo",26970,6060.56,29011,"Itaberaba",2,"Nordeste",0,"292210",5,13,8,5,5,8,1,0,1,1,0,14,8,6,6,8,17,8.70955748403481,10.2024804161338,0.408633106706874,31
"6057","BA","Muniz Ferreira",7443,6831.64,29020,"Santo Antônio de Jesus",2,"Nordeste",0,"292220",2,4,1,3,1,3,0,0,0,0,0,4,1,3,1,3,5,8.82932004087164,8.91502927235991,0.320245037086495,29
"6058","BA","Muniz Ferreira",7443,6831.64,29020,"Santo Antônio de Jesus",2,"Nordeste",0,"292220",3,5,3,2,3,2,0,0,0,0,0,5,3,2,3,2,5,8.82932004087164,8.91502927235991,0.392484346923291,31
"6059","BA","Muniz Ferreira",7443,6831.64,29020,"Santo Antônio de Jesus",2,"Nordeste",0,"292220",4,3,2,1,1,2,0,0,0,0,0,3,2,1,1,2,2,8.82932004087164,8.91502927235991,0.440460788072818,30
"6060","BA","Muniz Ferreira",7443,6831.64,29020,"Santo Antônio de Jesus",2,"Nordeste",0,"292220",5,11,5,6,3,8,0,0,0,0,0,11,5,6,3,8,3,8.82932004087164,8.91502927235991,0.448158486969844,31
"6061","BA","Muquém do São Francisco",11417,12405.57,29006,"Barra",2,"Nordeste",0,"292225",2,13,2,11,9,4,0,0,0,0,0,13,2,11,9,4,2,9.42590084428429,9.34285875167633,0.31109043531588,29
"6062","BA","Muquém do São Francisco",11417,12405.57,29006,"Barra",2,"Nordeste",0,"292225",3,12,4,8,5,7,0,0,0,0,0,12,4,8,5,7,6,9.42590084428429,9.34285875167633,0.44116751561524,31
"6063","BA","Muquém do São Francisco",11417,12405.57,29006,"Barra",2,"Nordeste",0,"292225",4,14,3,11,4,10,0,0,0,0,0,14,3,11,4,10,4,9.42590084428429,9.34285875167633,0.44696841197146,30
"6064","BA","Muquém do São Francisco",11417,12405.57,29006,"Barra",2,"Nordeste",0,"292225",5,15,4,11,9,6,0,0,0,0,0,15,4,11,9,6,2,9.42590084428429,9.34285875167633,0.41027145407745,31
"6065","BA","Muritiba",29410,8531.9,29020,"Santo Antônio de Jesus",2,"Nordeste",1,"292230",2,19,4,15,10,9,1,1,0,1,0,20,5,15,11,9,12,9.05156735894121,10.289090031548,0.305043224200212,29
"6066","BA","Muritiba",29410,8531.9,29020,"Santo Antônio de Jesus",2,"Nordeste",1,"292230",3,17,3,14,8,9,0,0,0,0,0,17,3,14,8,9,27,9.05156735894121,10.289090031548,0.408330534101176,31
"6067","BA","Muritiba",29410,8531.9,29020,"Santo Antônio de Jesus",2,"Nordeste",1,"292230",4,26,6,20,9,17,1,0,1,0,1,27,6,21,9,18,24,9.05156735894121,10.289090031548,0.463909795528255,30
"6068","BA","Muritiba",29410,8531.9,29020,"Santo Antônio de Jesus",2,"Nordeste",1,"292230",5,26,4,22,8,18,1,0,1,1,0,27,4,23,9,18,16,9.05156735894121,10.289090031548,0.441521655059546,31
"6069","BA","Mutuípe",22282,9973.26,29024,"Jequié",2,"Nordeste",0,"292240",2,13,3,10,6,7,0,0,0,0,0,13,3,10,6,7,13,9.20766279045209,10.0115344566193,0.255462794301172,29
"6070","BA","Mutuípe",22282,9973.26,29024,"Jequié",2,"Nordeste",0,"292240",3,29,12,17,15,14,0,0,0,0,0,29,12,17,15,14,12,9.20766279045209,10.0115344566193,0.368024871343202,31
"6071","BA","Mutuípe",22282,9973.26,29024,"Jequié",2,"Nordeste",0,"292240",4,16,7,9,9,7,0,0,0,0,0,16,7,9,9,7,10,9.20766279045209,10.0115344566193,0.405159702210883,30
"6072","BA","Mutuípe",22282,9973.26,29024,"Jequié",2,"Nordeste",0,"292240",5,20,5,15,10,10,1,0,1,1,0,21,5,16,11,10,12,9.20766279045209,10.0115344566193,0.443344982843224,31
"6073","BA","Nazaré",28594,9208.88,29020,"Santo Antônio de Jesus",2,"Nordeste",1,"292250",2,19,6,13,7,12,0,0,0,0,0,19,6,13,7,12,14,9.12792351490566,10.2609521845891,0.261372295990768,29
"6074","BA","Nazaré",28594,9208.88,29020,"Santo Antônio de Jesus",2,"Nordeste",1,"292250",3,15,2,13,5,10,2,0,2,0,2,17,2,15,5,12,17,9.12792351490566,10.2609521845891,0.34905682006581,31
"6075","BA","Nazaré",28594,9208.88,29020,"Santo Antônio de Jesus",2,"Nordeste",1,"292250",4,18,4,14,7,11,0,0,0,0,0,18,4,14,7,11,15,9.12792351490566,10.2609521845891,0.394887711222603,30
"6076","BA","Nazaré",28594,9208.88,29020,"Santo Antônio de Jesus",2,"Nordeste",1,"292250",5,23,7,16,9,14,0,0,0,0,0,23,7,16,9,14,13,9.12792351490566,10.2609521845891,0.378160758746723,31
"6077","BA","Nilo Peçanha",14079,9286.81,29030,"Valença",2,"Nordeste",0,"292260",2,8,2,6,3,5,0,0,0,0,0,8,2,6,3,5,3,9.13635039286101,9.55243960446253,0.319995757898685,29
"6078","BA","Nilo Peçanha",14079,9286.81,29030,"Valença",2,"Nordeste",0,"292260",3,7,2,5,3,4,0,0,0,0,0,7,2,5,3,4,13,9.13635039286101,9.55243960446253,0.426470520901872,31
"6079","BA","Nilo Peçanha",14079,9286.81,29030,"Valença",2,"Nordeste",0,"292260",4,11,5,6,7,4,0,0,0,0,0,11,5,6,7,4,7,9.13635039286101,9.55243960446253,0.447592568200118,30
"6080","BA","Nilo Peçanha",14079,9286.81,29030,"Valença",2,"Nordeste",0,"292260",5,11,3,8,7,4,0,0,0,0,0,11,3,8,7,4,8,9.13635039286101,9.55243960446253,0.452810987190201,31
"6081","BA","Nordestina",13164,11129,29014,"Euclides da Cunha",2,"Nordeste",0,"292265",2,14,8,6,5,9,0,0,0,0,0,14,8,6,5,9,7,9.31730959297342,9.48524111006323,0.271003762810486,29
"6082","BA","Nordestina",13164,11129,29014,"Euclides da Cunha",2,"Nordeste",0,"292265",3,9,3,6,5,4,1,1,0,0,1,10,4,6,5,5,7,9.31730959297342,9.48524111006323,0.345918673259365,31
"6083","BA","Nordestina",13164,11129,29014,"Euclides da Cunha",2,"Nordeste",0,"292265",4,12,6,6,6,6,0,0,0,0,0,12,6,6,6,6,5,9.31730959297342,9.48524111006323,0.378699237263164,30
"6084","BA","Nordestina",13164,11129,29014,"Euclides da Cunha",2,"Nordeste",0,"292265",5,20,8,12,12,8,1,0,1,1,0,21,8,13,13,8,11,9.31730959297342,9.48524111006323,0.395634983396005,31
"6085","BA","Nova Canaã",16472,7753.2,29028,"Vitória da Conquista",2,"Nordeste",0,"292270",2,14,7,7,9,5,0,0,0,0,0,14,7,7,9,5,8,8.95586094035212,9.70941724870763,0.280978344250746,29
"6086","BA","Nova Canaã",16472,7753.2,29028,"Vitória da Conquista",2,"Nordeste",0,"292270",3,11,6,5,6,5,0,0,0,0,0,11,6,5,6,5,4,8.95586094035212,9.70941724870763,0.38235893112346,31
"6087","BA","Nova Canaã",16472,7753.2,29028,"Vitória da Conquista",2,"Nordeste",0,"292270",4,5,2,3,2,3,0,0,0,0,0,5,2,3,2,3,6,8.95586094035212,9.70941724870763,0.401287739735147,30
"6088","BA","Nova Canaã",16472,7753.2,29028,"Vitória da Conquista",2,"Nordeste",0,"292270",5,9,6,3,3,6,0,0,0,0,0,9,6,3,3,6,9,8.95586094035212,9.70941724870763,0.419976708129787,31
"6089","BA","Nova Fátima",7821,9892.11,29016,"Serrinha",2,"Nordeste",0,"292273",2,1,1,0,1,0,0,0,0,0,0,1,1,0,1,0,5,9.19949274867653,8.96456770260161,0.236885610237667,29
"6090","BA","Nova Fátima",7821,9892.11,29016,"Serrinha",2,"Nordeste",0,"292273",3,4,1,3,2,2,0,0,0,0,0,4,1,3,2,2,2,9.19949274867653,8.96456770260161,0.31889120497101,31
"6091","BA","Nova Fátima",7821,9892.11,29016,"Serrinha",2,"Nordeste",0,"292273",4,6,2,4,3,3,0,0,0,0,0,6,2,4,3,3,5,9.19949274867653,8.96456770260161,0.301098715441475,30
"6092","BA","Nova Fátima",7821,9892.11,29016,"Serrinha",2,"Nordeste",0,"292273",5,12,1,11,3,9,0,0,0,0,0,12,1,11,3,9,4,9.19949274867653,8.96456770260161,0.322517286869667,31
"6093","BA","Nova Ibiá",6554,11037.76,29031,"Ilhéus-Itabuna",2,"Nordeste",0,"292275",2,3,1,2,2,1,0,0,0,0,0,3,1,2,2,1,2,9.30907740069367,8.78783082925876,0.267824518702486,29
"6094","BA","Nova Ibiá",6554,11037.76,29031,"Ilhéus-Itabuna",2,"Nordeste",0,"292275",3,2,2,0,2,0,0,0,0,0,0,2,2,0,2,0,3,9.30907740069367,8.78783082925876,0.355406796105131,31
"6095","BA","Nova Ibiá",6554,11037.76,29031,"Ilhéus-Itabuna",2,"Nordeste",0,"292275",4,3,1,2,1,2,0,0,0,0,0,3,1,2,1,2,10,9.30907740069367,8.78783082925876,0.378721229730688,30
"6096","BA","Nova Ibiá",6554,11037.76,29031,"Ilhéus-Itabuna",2,"Nordeste",0,"292275",5,4,1,3,3,1,0,0,0,0,0,4,1,3,3,1,2,9.30907740069367,8.78783082925876,0.389635859894058,31
"6097","BA","Nova Itarana",8279,6216.44,29024,"Jequié",2,"Nordeste",0,"292280",2,5,3,2,1,4,0,0,0,0,0,5,3,2,1,4,5,8.73495267461312,9.02147746713881,0.248294510837058,29
"6098","BA","Nova Itarana",8279,6216.44,29024,"Jequié",2,"Nordeste",0,"292280",3,10,7,3,8,2,0,0,0,0,0,10,7,3,8,2,4,8.73495267461312,9.02147746713881,0.315030085830461,31
"6099","BA","Nova Itarana",8279,6216.44,29024,"Jequié",2,"Nordeste",0,"292280",4,8,6,2,3,5,0,0,0,0,0,8,6,2,3,5,1,8.73495267461312,9.02147746713881,0.345721781250664,30
"6100","BA","Nova Itarana",8279,6216.44,29024,"Jequié",2,"Nordeste",0,"292280",5,10,3,7,6,4,0,0,0,0,0,10,3,7,6,4,5,8.73495267461312,9.02147746713881,0.326914327303763,31
"6101","BA","Nova Redenção",9123,5877.58,29023,"Seabra",2,"Nordeste",0,"292285",2,7,4,3,3,4,0,0,0,0,0,7,4,3,3,4,4,8.67890039155086,9.11855397634547,0.299758093339233,29
"6102","BA","Nova Redenção",9123,5877.58,29023,"Seabra",2,"Nordeste",0,"292285",3,7,3,4,4,3,0,0,0,0,0,7,3,4,4,3,0,8.67890039155086,9.11855397634547,0.370162437542121,31
"6103","BA","Nova Redenção",9123,5877.58,29023,"Seabra",2,"Nordeste",0,"292285",4,7,1,6,4,3,0,0,0,0,0,7,1,6,4,3,3,8.67890039155086,9.11855397634547,0.411364282325135,30
"6104","BA","Nova Redenção",9123,5877.58,29023,"Seabra",2,"Nordeste",0,"292285",5,3,1,2,1,2,0,0,0,0,0,3,1,2,1,2,6,8.67890039155086,9.11855397634547,0.389962194406635,31
"6105","BA","Nova Soure",26998,8494.34,29015,"Ribeira do Pombal",2,"Nordeste",0,"292290",2,27,10,17,13,14,0,0,0,0,0,27,10,17,13,14,8,9.04715533832735,10.2035180681688,0.267020981181698,29
"6106","BA","Nova Soure",26998,8494.34,29015,"Ribeira do Pombal",2,"Nordeste",0,"292290",3,20,6,14,16,4,1,0,1,0,1,21,6,15,16,5,6,9.04715533832735,10.2035180681688,0.359409986419764,31
"6107","BA","Nova Soure",26998,8494.34,29015,"Ribeira do Pombal",2,"Nordeste",0,"292290",4,12,6,6,7,5,0,0,0,0,0,12,6,6,7,5,17,9.04715533832735,10.2035180681688,0.389508367667882,30
"6108","BA","Nova Soure",26998,8494.34,29015,"Ribeira do Pombal",2,"Nordeste",0,"292290",5,23,10,13,5,18,1,1,0,0,1,24,11,13,5,19,16,9.04715533832735,10.2035180681688,0.37742901385022,31
"6109","BA","Nova Viçosa",43783,11470.31,29032,"Porto Seguro",2,"Nordeste",1,"292300",2,30,13,17,16,14,1,1,0,0,1,31,14,17,16,15,25,9.34751723678522,10.6870008931695,0.287049491834534,29
"6110","BA","Nova Viçosa",43783,11470.31,29032,"Porto Seguro",2,"Nordeste",1,"292300",3,30,10,20,13,17,1,0,1,1,0,31,10,21,14,17,23,9.34751723678522,10.6870008931695,0.362352702558823,31
"6111","BA","Nova Viçosa",43783,11470.31,29032,"Porto Seguro",2,"Nordeste",1,"292300",4,35,11,24,20,15,0,0,0,0,0,35,11,24,20,15,12,9.34751723678522,10.6870008931695,0.368053161608229,30
"6112","BA","Nova Viçosa",43783,11470.31,29032,"Porto Seguro",2,"Nordeste",1,"292300",5,39,11,28,20,19,1,1,0,1,0,40,12,28,21,19,17,9.34751723678522,10.6870008931695,0.371028787414343,31
"6113","BA","Novo Horizonte",12522,6468.78,29022,"Boquira",2,"Nordeste",0,"292303",2,9,2,7,3,6,0,0,0,0,0,9,2,7,3,6,4,8.77474280711819,9.43524237630526,0.380249685267115,29
"6114","BA","Novo Horizonte",12522,6468.78,29022,"Boquira",2,"Nordeste",0,"292303",3,4,1,3,1,3,0,0,0,0,0,4,1,3,1,3,5,8.77474280711819,9.43524237630526,0.432084918984152,31
"6115","BA","Novo Horizonte",12522,6468.78,29022,"Boquira",2,"Nordeste",0,"292303",4,5,0,5,2,3,1,0,1,0,1,6,0,6,2,4,9,8.77474280711819,9.43524237630526,0.449514399290856,30
"6116","BA","Novo Horizonte",12522,6468.78,29022,"Boquira",2,"Nordeste",0,"292303",5,11,4,7,3,8,0,0,0,0,0,11,4,7,3,8,6,8.77474280711819,9.43524237630526,0.419315986196833,31
"6117","BA","Novo Triunfo",15443,5064.6,29015,"Ribeira do Pombal",2,"Nordeste",0,"292305",2,9,5,4,5,4,0,0,0,0,0,9,5,4,5,4,4,8.53003044021773,9.644911105223,0.300484795422911,29
"6118","BA","Novo Triunfo",15443,5064.6,29015,"Ribeira do Pombal",2,"Nordeste",0,"292305",3,10,2,8,5,5,0,0,0,0,0,10,2,8,5,5,6,8.53003044021773,9.644911105223,0.370934144059302,31
"6119","BA","Novo Triunfo",15443,5064.6,29015,"Ribeira do Pombal",2,"Nordeste",0,"292305",4,10,4,6,3,7,0,0,0,0,0,10,4,6,3,7,4,8.53003044021773,9.644911105223,0.370772625716212,30
"6120","BA","Novo Triunfo",15443,5064.6,29015,"Ribeira do Pombal",2,"Nordeste",0,"292305",5,5,3,2,2,3,0,0,0,0,0,5,3,2,2,3,3,8.53003044021773,9.644911105223,0.424508651561669,31
"6121","BA","Olindina",28304,7104.84,29015,"Ribeira do Pombal",2,"Nordeste",0,"292310",2,20,9,11,12,8,0,0,0,0,0,20,9,11,12,8,9,8.86853152092507,10.2507584163996,0.299289972272281,29
"6122","BA","Olindina",28304,7104.84,29015,"Ribeira do Pombal",2,"Nordeste",0,"292310",3,12,6,6,4,8,0,0,0,0,0,12,6,6,4,8,12,8.86853152092507,10.2507584163996,0.375166324005295,31
"6123","BA","Olindina",28304,7104.84,29015,"Ribeira do Pombal",2,"Nordeste",0,"292310",4,14,6,8,7,7,2,2,0,0,2,16,8,8,7,9,15,8.86853152092507,10.2507584163996,0.407026773823249,30
"6124","BA","Olindina",28304,7104.84,29015,"Ribeira do Pombal",2,"Nordeste",0,"292310",5,24,12,12,7,17,0,0,0,0,0,24,12,12,7,17,19,8.86853152092507,10.2507584163996,0.389931865410166,31
"6125","BA","Oliveira dos Brejinhos",21810,7826.44,29022,"Boquira",2,"Nordeste",0,"292320",2,17,4,13,8,9,1,1,0,0,1,18,5,13,8,10,16,8.96526302403683,9.99012385919568,0.268911573986304,29
"6126","BA","Oliveira dos Brejinhos",21810,7826.44,29022,"Boquira",2,"Nordeste",0,"292320",3,19,7,12,9,10,0,0,0,0,0,19,7,12,9,10,11,8.96526302403683,9.99012385919568,0.348246704336114,31
"6127","BA","Oliveira dos Brejinhos",21810,7826.44,29022,"Boquira",2,"Nordeste",0,"292320",4,20,5,15,8,12,0,0,0,0,0,20,5,15,8,12,10,8.96526302403683,9.99012385919568,0.380262782139352,30
"6128","BA","Oliveira dos Brejinhos",21810,7826.44,29022,"Boquira",2,"Nordeste",0,"292320",5,25,8,17,10,15,0,0,0,0,0,25,8,17,10,15,7,8.96526302403683,9.99012385919568,0.407976244815076,31
"6129","BA","Ouriçangas",8570,6484.99,29012,"Feira de Santana",2,"Nordeste",0,"292330",2,9,7,2,3,6,0,0,0,0,0,9,7,2,3,6,4,8.77724555472931,9.05602301159183,0.313204925544906,29
"6130","BA","Ouriçangas",8570,6484.99,29012,"Feira de Santana",2,"Nordeste",0,"292330",3,6,0,6,2,4,0,0,0,0,0,6,0,6,2,4,5,8.77724555472931,9.05602301159183,0.377138470890463,31
"6131","BA","Ouriçangas",8570,6484.99,29012,"Feira de Santana",2,"Nordeste",0,"292330",4,5,1,4,0,5,0,0,0,0,0,5,1,4,0,5,3,8.77724555472931,9.05602301159183,0.427531806291203,30
"6132","BA","Ouriçangas",8570,6484.99,29012,"Feira de Santana",2,"Nordeste",0,"292330",5,1,1,0,1,0,0,0,0,0,0,1,1,0,1,0,5,8.77724555472931,9.05602301159183,0.472372768938218,31
"6133","BA","Ourolândia",17511,8917.15,29010,"Jacobina",2,"Nordeste",0,"292335",2,14,3,11,6,8,0,0,0,0,0,14,3,11,6,8,8,9.09573166779445,9.7705845338719,0.283390631673166,29
"6134","BA","Ourolândia",17511,8917.15,29010,"Jacobina",2,"Nordeste",0,"292335",3,15,7,8,7,8,0,0,0,0,0,15,7,8,7,8,10,9.09573166779445,9.7705845338719,0.33313219527239,31
"6135","BA","Ourolândia",17511,8917.15,29010,"Jacobina",2,"Nordeste",0,"292335",4,13,5,8,6,7,0,0,0,0,0,13,5,8,6,7,4,9.09573166779445,9.7705845338719,0.361040884984069,30
"6136","BA","Ourolândia",17511,8917.15,29010,"Jacobina",2,"Nordeste",0,"292335",5,17,9,8,12,5,0,0,0,0,0,17,9,8,12,5,3,9.09573166779445,9.7705845338719,0.352728822657139,31
"6137","BA","Palmas de Monte Alto",21796,7657.11,29026,"Guanambi",2,"Nordeste",0,"292340",2,14,6,8,4,10,0,0,0,0,0,14,6,8,4,10,13,8.9433899069496,9.98948174570299,0.255330588394599,29
"6138","BA","Palmas de Monte Alto",21796,7657.11,29026,"Guanambi",2,"Nordeste",0,"292340",3,15,4,11,4,11,0,0,0,0,0,15,4,11,4,11,17,8.9433899069496,9.98948174570299,0.334811352533247,31
"6139","BA","Palmas de Monte Alto",21796,7657.11,29026,"Guanambi",2,"Nordeste",0,"292340",4,22,8,14,10,12,0,0,0,0,0,22,8,14,10,12,10,8.9433899069496,9.98948174570299,0.354808879655495,30
"6140","BA","Palmas de Monte Alto",21796,7657.11,29026,"Guanambi",2,"Nordeste",0,"292340",5,12,4,8,4,8,0,0,0,0,0,12,4,8,4,8,5,8.9433899069496,9.98948174570299,0.349370098110018,31
"6141","BA","Palmeiras",9071,8913.87,29023,"Seabra",2,"Nordeste",0,"292350",2,13,1,12,6,7,0,0,0,0,0,13,1,12,6,7,5,9.09536376959939,9.11283779061494,0.251493059139416,29
"6142","BA","Palmeiras",9071,8913.87,29023,"Seabra",2,"Nordeste",0,"292350",3,8,2,6,3,5,0,0,0,0,0,8,2,6,3,5,5,9.09536376959939,9.11283779061494,0.377189735988735,31
"6143","BA","Palmeiras",9071,8913.87,29023,"Seabra",2,"Nordeste",0,"292350",4,4,1,3,2,2,0,0,0,0,0,4,1,3,2,2,3,9.09536376959939,9.11283779061494,0.423212372018032,30
"6144","BA","Palmeiras",9071,8913.87,29023,"Seabra",2,"Nordeste",0,"292350",5,6,0,6,0,6,0,0,0,0,0,6,0,6,0,6,8,9.09536376959939,9.11283779061494,0.42455444260026,31
"6145","BA","Paramirim",21695,9665.33,29025,"Livramento do Brumado",2,"Nordeste",0,"292360",2,8,2,6,4,4,0,0,0,0,0,8,2,6,4,4,4,9.17630053487744,9.98483709823245,0.231292383499438,29
"6146","BA","Paramirim",21695,9665.33,29025,"Livramento do Brumado",2,"Nordeste",0,"292360",3,16,2,14,7,9,0,0,0,0,0,16,2,14,7,9,10,9.17630053487744,9.98483709823245,0.331506464718902,31
"6147","BA","Paramirim",21695,9665.33,29025,"Livramento do Brumado",2,"Nordeste",0,"292360",4,18,1,17,9,9,0,0,0,0,0,18,1,17,9,9,13,9.17630053487744,9.98483709823245,0.37652702869884,30
"6148","BA","Paramirim",21695,9665.33,29025,"Livramento do Brumado",2,"Nordeste",0,"292360",5,19,3,16,6,13,0,0,0,0,0,19,3,16,6,13,14,9.17630053487744,9.98483709823245,0.352463873770878,31
"6149","BA","Paratinga",32141,6769.58,29007,"Bom Jesus da Lapa",2,"Nordeste",0,"292370",2,34,11,23,15,19,0,0,0,0,0,34,11,23,15,19,12,8.82019432557713,10.3778877526843,0.26596467996937,29
"6150","BA","Paratinga",32141,6769.58,29007,"Bom Jesus da Lapa",2,"Nordeste",0,"292370",3,28,9,19,13,15,2,0,2,0,2,30,9,21,13,17,14,8.82019432557713,10.3778877526843,0.349555115293304,31
"6151","BA","Paratinga",32141,6769.58,29007,"Bom Jesus da Lapa",2,"Nordeste",0,"292370",4,34,10,24,12,22,0,0,0,0,0,34,10,24,12,22,13,8.82019432557713,10.3778877526843,0.384939145651846,30
"6152","BA","Paratinga",32141,6769.58,29007,"Bom Jesus da Lapa",2,"Nordeste",0,"292370",5,19,8,11,7,12,2,0,2,1,1,21,8,13,8,13,22,8.82019432557713,10.3778877526843,0.372543444504096,31
"6153","BA","Paripiranga",29058,9625.99,29015,"Ribeira do Pombal",2,"Nordeste",0,"292380",2,23,9,14,10,13,0,0,0,0,0,23,9,14,10,13,10,9.17222201100941,10.2770491116313,0.293600757701054,29
"6154","BA","Paripiranga",29058,9625.99,29015,"Ribeira do Pombal",2,"Nordeste",0,"292380",3,22,12,10,9,13,1,1,0,0,1,23,13,10,9,14,11,9.17222201100941,10.2770491116313,0.382100529194768,31
"6155","BA","Paripiranga",29058,9625.99,29015,"Ribeira do Pombal",2,"Nordeste",0,"292380",4,13,5,8,0,13,0,0,0,0,0,13,5,8,0,13,14,9.17222201100941,10.2770491116313,0.430763606931847,30
"6156","BA","Paripiranga",29058,9625.99,29015,"Ribeira do Pombal",2,"Nordeste",0,"292380",5,14,5,9,7,7,1,1,0,1,0,15,6,9,8,7,7,9.17222201100941,10.2770491116313,0.426284645438791,31
"6157","BA","Pau Brasil",9686,9120.44,29031,"Ilhéus-Itabuna",2,"Nordeste",0,"292390",2,12,7,5,5,7,0,0,0,0,0,12,7,5,5,7,6,9.11827332751863,9.17843682296317,0.330859675359042,29
"6158","BA","Pau Brasil",9686,9120.44,29031,"Ilhéus-Itabuna",2,"Nordeste",0,"292390",3,18,9,9,15,3,0,0,0,0,0,18,9,9,15,3,10,9.11827332751863,9.17843682296317,0.405383941323813,31
"6159","BA","Pau Brasil",9686,9120.44,29031,"Ilhéus-Itabuna",2,"Nordeste",0,"292390",4,9,4,5,6,3,0,0,0,0,0,9,4,5,6,3,12,9.11827332751863,9.17843682296317,0.400129262126803,30
"6160","BA","Pau Brasil",9686,9120.44,29031,"Ilhéus-Itabuna",2,"Nordeste",0,"292390",5,11,5,6,6,5,1,0,1,1,0,12,5,7,7,5,6,9.11827332751863,9.17843682296317,0.408747310652951,31
"6161","BA","Paulo Afonso",118516,29723.43,29005,"Paulo Afonso",2,"Nordeste",1,"292400",2,129,47,82,56,73,0,0,0,0,0,129,47,82,56,73,46,10.2996909026704,11.6828032515398,0.292214873898885,29
"6162","BA","Paulo Afonso",118516,29723.43,29005,"Paulo Afonso",2,"Nordeste",1,"292400",3,125,53,72,52,73,1,0,1,0,1,126,53,73,52,74,57,10.2996909026704,11.6828032515398,0.386272541757174,31
"6163","BA","Paulo Afonso",118516,29723.43,29005,"Paulo Afonso",2,"Nordeste",1,"292400",4,116,32,84,49,67,2,1,1,1,1,118,33,85,50,68,63,10.2996909026704,11.6828032515398,0.429357424165919,30
"6164","BA","Paulo Afonso",118516,29723.43,29005,"Paulo Afonso",2,"Nordeste",1,"292400",5,127,39,88,44,83,3,1,2,2,1,130,40,90,46,84,68,10.2996909026704,11.6828032515398,0.428712388121913,31
"6165","BA","Pé de Serra",13556,6962.06,29016,"Serrinha",2,"Nordeste",0,"292405",2,11,3,8,5,6,0,0,0,0,0,11,3,8,5,6,5,8.8482306865474,9.51458453272694,0.288019685401481,29
"6166","BA","Pé de Serra",13556,6962.06,29016,"Serrinha",2,"Nordeste",0,"292405",3,12,2,10,5,7,0,0,0,0,0,12,2,10,5,7,9,8.8482306865474,9.51458453272694,0.360470161202674,31
"6167","BA","Pé de Serra",13556,6962.06,29016,"Serrinha",2,"Nordeste",0,"292405",4,8,2,6,3,5,0,0,0,0,0,8,2,6,3,5,6,8.8482306865474,9.51458453272694,0.385526319418224,30
"6168","BA","Pé de Serra",13556,6962.06,29016,"Serrinha",2,"Nordeste",0,"292405",5,11,3,8,5,6,0,0,0,0,0,11,3,8,5,6,6,8.8482306865474,9.51458453272694,0.38679126639016,31
"6169","BA","Pedrão",7394,5555.19,29012,"Feira de Santana",2,"Nordeste",0,"292410",2,7,4,3,4,3,0,0,0,0,0,7,4,3,4,3,2,8.62248790490915,8.90842413949658,0.317042213411069,29
"6170","BA","Pedrão",7394,5555.19,29012,"Feira de Santana",2,"Nordeste",0,"292410",3,6,2,4,0,6,0,0,0,0,0,6,2,4,0,6,5,8.62248790490915,8.90842413949658,0.423712462232137,31
"6171","BA","Pedrão",7394,5555.19,29012,"Feira de Santana",2,"Nordeste",0,"292410",4,3,2,1,2,1,0,0,0,0,0,3,2,1,2,1,1,8.62248790490915,8.90842413949658,0.463253364280061,30
"6172","BA","Pedrão",7394,5555.19,29012,"Feira de Santana",2,"Nordeste",0,"292410",5,7,1,6,3,4,1,1,0,0,1,8,2,6,3,5,2,8.62248790490915,8.90842413949658,0.464972122782168,31
"6173","BA","Pedro Alexandre",16682,5636.83,29013,"Jeremoabo",2,"Nordeste",0,"292420",2,13,7,6,9,4,0,0,0,0,0,13,7,6,9,4,3,8.63707712974142,9.72208557280156,0.285739835180667,29
"6174","BA","Pedro Alexandre",16682,5636.83,29013,"Jeremoabo",2,"Nordeste",0,"292420",3,5,4,1,0,5,0,0,0,0,0,5,4,1,0,5,4,8.63707712974142,9.72208557280156,0.381776846084007,31
"6175","BA","Pedro Alexandre",16682,5636.83,29013,"Jeremoabo",2,"Nordeste",0,"292420",4,8,4,4,3,5,0,0,0,0,0,8,4,4,3,5,4,8.63707712974142,9.72208557280156,0.388874035908819,30
"6176","BA","Pedro Alexandre",16682,5636.83,29013,"Jeremoabo",2,"Nordeste",0,"292420",5,21,15,6,10,11,1,1,0,0,1,22,16,6,10,12,4,8.63707712974142,9.72208557280156,0.407787524276906,31
"6177","BA","Piatã",16984,7262.1,29023,"Seabra",2,"Nordeste",0,"292430",2,19,4,15,6,13,0,0,0,0,0,19,4,15,6,13,13,8.89042432219068,9.74002700338309,0.263133893144484,29
"6178","BA","Piatã",16984,7262.1,29023,"Seabra",2,"Nordeste",0,"292430",3,12,2,10,8,4,1,1,0,0,1,13,3,10,8,5,10,8.89042432219068,9.74002700338309,0.35632565409155,31
"6179","BA","Piatã",16984,7262.1,29023,"Seabra",2,"Nordeste",0,"292430",4,11,4,7,3,8,0,0,0,0,0,11,4,7,3,8,5,8.89042432219068,9.74002700338309,0.382366022518356,30
"6180","BA","Piatã",16984,7262.1,29023,"Seabra",2,"Nordeste",0,"292430",5,20,4,16,12,8,0,0,0,0,0,20,4,16,12,8,9,8.89042432219068,9.74002700338309,0.391950418571394,31
"6181","BA","Pilão Arcado",35175,6795.43,29004,"Juazeiro",2,"Nordeste",0,"292440",2,42,31,11,22,20,0,0,0,0,0,42,31,11,22,20,13,8.8240056064079,10.4680908819826,0.255372246900396,29
"6182","BA","Pilão Arcado",35175,6795.43,29004,"Juazeiro",2,"Nordeste",0,"292440",3,48,31,17,26,22,0,0,0,0,0,48,31,17,26,22,13,8.8240056064079,10.4680908819826,0.336366769936698,31
"6183","BA","Pilão Arcado",35175,6795.43,29004,"Juazeiro",2,"Nordeste",0,"292440",4,56,31,25,28,28,0,0,0,0,0,56,31,25,28,28,9,8.8240056064079,10.4680908819826,0.352860728749467,30
"6184","BA","Pilão Arcado",35175,6795.43,29004,"Juazeiro",2,"Nordeste",0,"292440",5,51,27,24,29,22,1,0,1,1,0,52,27,25,30,22,18,8.8240056064079,10.4680908819826,0.393654206701168,31
"6185","BA","Pindaí",16285,11577.37,29026,"Guanambi",2,"Nordeste",0,"292450",2,8,2,6,4,4,0,0,0,0,0,8,2,6,4,4,10,9.35680760961555,9.69799971771033,0.330743160163253,29
"6186","BA","Pindaí",16285,11577.37,29026,"Guanambi",2,"Nordeste",0,"292450",3,15,5,10,6,9,0,0,0,0,0,15,5,10,6,9,7,9.35680760961555,9.69799971771033,0.41063495481776,31
"6187","BA","Pindaí",16285,11577.37,29026,"Guanambi",2,"Nordeste",0,"292450",4,16,3,13,8,8,0,0,0,0,0,16,3,13,8,8,5,9.35680760961555,9.69799971771033,0.422074242188433,30
"6188","BA","Pindaí",16285,11577.37,29026,"Guanambi",2,"Nordeste",0,"292450",5,10,2,8,3,7,0,0,0,0,0,10,2,8,3,7,16,9.35680760961555,9.69799971771033,0.413035437823336,31
"6189","BA","Pindobaçu",20098,6558.46,29008,"Senhor do Bonfim",2,"Nordeste",0,"292460",2,25,4,21,10,15,0,0,0,0,0,25,4,21,10,15,8,8.78851109828105,9.9083755866089,0.312034059402249,29
"6190","BA","Pindobaçu",20098,6558.46,29008,"Senhor do Bonfim",2,"Nordeste",0,"292460",3,16,7,9,7,9,0,0,0,0,0,16,7,9,7,9,10,8.78851109828105,9.9083755866089,0.404304383570838,31
"6191","BA","Pindobaçu",20098,6558.46,29008,"Senhor do Bonfim",2,"Nordeste",0,"292460",4,20,5,15,9,11,0,0,0,0,0,20,5,15,9,11,11,8.78851109828105,9.9083755866089,0.417806728957988,30
"6192","BA","Pindobaçu",20098,6558.46,29008,"Senhor do Bonfim",2,"Nordeste",0,"292460",5,20,12,8,12,8,0,0,0,0,0,20,12,8,12,8,12,8.78851109828105,9.9083755866089,0.408306152931328,31
"6193","BA","Pintadas",10394,8194.33,29012,"Feira de Santana",2,"Nordeste",0,"292465",2,5,2,3,1,4,0,0,0,0,0,5,2,3,1,4,6,9.01119773066663,9.24898399556839,0.27541228315497,29
"6194","BA","Pintadas",10394,8194.33,29012,"Feira de Santana",2,"Nordeste",0,"292465",3,2,0,2,1,1,0,0,0,0,0,2,0,2,1,1,3,9.01119773066663,9.24898399556839,0.341917896615523,31
"6195","BA","Pintadas",10394,8194.33,29012,"Feira de Santana",2,"Nordeste",0,"292465",4,7,3,4,5,2,0,0,0,0,0,7,3,4,5,2,9,9.01119773066663,9.24898399556839,0.370181146535864,30
"6196","BA","Pintadas",10394,8194.33,29012,"Feira de Santana",2,"Nordeste",0,"292465",5,5,3,2,3,2,0,0,0,0,0,5,3,2,3,2,6,9.01119773066663,9.24898399556839,0.352520166667314,31
"6197","BA","Piraí do Norte",10036,7954.22,29030,"Valença",2,"Nordeste",0,"292467",2,8,4,4,2,6,0,0,0,0,0,8,4,4,2,6,2,8.98145788442461,9.21393390748631,0.315735910899977,29
"6198","BA","Piraí do Norte",10036,7954.22,29030,"Valença",2,"Nordeste",0,"292467",3,7,2,5,4,3,2,0,2,0,2,9,2,7,4,5,0,8.98145788442461,9.21393390748631,0.398130314378273,31
"6199","BA","Piraí do Norte",10036,7954.22,29030,"Valença",2,"Nordeste",0,"292467",4,6,4,2,4,2,0,0,0,0,0,6,4,2,4,2,3,8.98145788442461,9.21393390748631,0.441256395303096,30
"6200","BA","Piraí do Norte",10036,7954.22,29030,"Valença",2,"Nordeste",0,"292467",5,4,3,1,3,1,1,0,1,1,0,5,3,2,4,1,5,8.98145788442461,9.21393390748631,0.427970496949187,31
"6201","BA","Piritiba",24964,6216.63,29010,"Jacobina",2,"Nordeste",0,"292480",2,21,10,11,11,10,0,0,0,0,0,21,10,11,11,10,16,8.73498323826313,10.1251900660539,0.264045446056594,29
"6202","BA","Piritiba",24964,6216.63,29010,"Jacobina",2,"Nordeste",0,"292480",3,14,7,7,7,7,0,0,0,0,0,14,7,7,7,7,13,8.73498323826313,10.1251900660539,0.355951480351868,31
"6203","BA","Piritiba",24964,6216.63,29010,"Jacobina",2,"Nordeste",0,"292480",4,12,1,11,6,6,0,0,0,0,0,12,1,11,6,6,10,8.73498323826313,10.1251900660539,0.395510575701715,30
"6204","BA","Piritiba",24964,6216.63,29010,"Jacobina",2,"Nordeste",0,"292480",5,13,3,10,7,6,0,0,0,0,0,13,3,10,7,6,18,8.73498323826313,10.1251900660539,0.385773538702493,31
"6205","BA","Planaltino",9370,7307.62,29024,"Jequié",2,"Nordeste",0,"292490",2,4,2,2,1,3,0,0,0,0,0,4,2,2,1,3,6,8.89667291833535,9.14526837523247,0.290053093156158,29
"6206","BA","Planaltino",9370,7307.62,29024,"Jequié",2,"Nordeste",0,"292490",3,5,1,4,2,3,0,0,0,0,0,5,1,4,2,3,4,8.89667291833535,9.14526837523247,0.35199398800292,31
"6207","BA","Planaltino",9370,7307.62,29024,"Jequié",2,"Nordeste",0,"292490",4,6,2,4,3,3,0,0,0,0,0,6,2,4,3,3,3,8.89667291833535,9.14526837523247,0.38047863471292,30
"6208","BA","Planaltino",9370,7307.62,29024,"Jequié",2,"Nordeste",0,"292490",5,3,1,2,2,1,0,0,0,0,0,3,1,2,2,1,5,8.89667291833535,9.14526837523247,0.375064023592874,31
"6209","BA","Planalto",26426,9127.41,29028,"Vitória da Conquista",2,"Nordeste",0,"292500",2,10,2,8,3,7,1,1,0,0,1,11,3,8,3,8,18,9.11903725316894,10.1821036529742,0.252889407003038,29
"6210","BA","Planalto",26426,9127.41,29028,"Vitória da Conquista",2,"Nordeste",0,"292500",3,13,6,7,4,9,0,0,0,0,0,13,6,7,4,9,7,9.11903725316894,10.1821036529742,0.319625220502661,31
"6211","BA","Planalto",26426,9127.41,29028,"Vitória da Conquista",2,"Nordeste",0,"292500",4,13,7,6,5,8,0,0,0,0,0,13,7,6,5,8,10,9.11903725316894,10.1821036529742,0.365205549540828,30
"6212","BA","Planalto",26426,9127.41,29028,"Vitória da Conquista",2,"Nordeste",0,"292500",5,12,8,4,7,5,0,0,0,0,0,12,8,4,7,5,11,9.11903725316894,10.1821036529742,0.363469554114123,31
"6213","BA","Poções",46879,10142.68,29028,"Vitória da Conquista",2,"Nordeste",1,"292510",2,52,28,24,31,21,0,0,0,0,0,52,28,24,31,21,26,9.2245075420269,10.7553250929654,0.268564173213155,29
"6214","BA","Poções",46879,10142.68,29028,"Vitória da Conquista",2,"Nordeste",1,"292510",3,48,23,25,20,28,0,0,0,0,0,48,23,25,20,28,28,9.2245075420269,10.7553250929654,0.34784386352938,31
"6215","BA","Poções",46879,10142.68,29028,"Vitória da Conquista",2,"Nordeste",1,"292510",4,44,21,23,19,25,2,1,1,0,2,46,22,24,19,27,33,9.2245075420269,10.7553250929654,0.373218935640831,30
"6216","BA","Poções",46879,10142.68,29028,"Vitória da Conquista",2,"Nordeste",1,"292510",5,49,15,34,23,26,0,0,0,0,0,49,15,34,23,26,38,9.2245075420269,10.7553250929654,0.350765539245383,31
"6217","BA","Pojuca",39972,26557.29,29019,"Catu",2,"Nordeste",1,"292520",2,36,16,20,18,18,0,0,0,0,0,36,16,20,18,18,18,10.1870595652521,10.5959344879817,0.276434069332163,29
"6218","BA","Pojuca",39972,26557.29,29019,"Catu",2,"Nordeste",1,"292520",3,24,9,15,9,15,1,0,1,0,1,25,9,16,9,16,24,10.1870595652521,10.5959344879817,0.358375310168352,31
"6219","BA","Pojuca",39972,26557.29,29019,"Catu",2,"Nordeste",1,"292520",4,41,9,32,16,25,1,0,1,0,1,42,9,33,16,26,12,10.1870595652521,10.5959344879817,0.38842668492605,30
"6220","BA","Pojuca",39972,26557.29,29019,"Catu",2,"Nordeste",1,"292520",5,34,6,28,15,19,1,0,1,0,1,35,6,29,15,20,24,10.1870595652521,10.5959344879817,0.391667459228735,31
"6221","BA","Ponto Novo",14819,7544.35,29010,"Jacobina",2,"Nordeste",0,"292525",2,24,11,13,9,15,0,0,0,0,0,24,11,13,9,15,18,8.92855421772279,9.60366542019018,0.268759940051848,29
"6222","BA","Ponto Novo",14819,7544.35,29010,"Jacobina",2,"Nordeste",0,"292525",3,13,4,9,7,6,1,0,1,1,0,14,4,10,8,6,10,8.92855421772279,9.60366542019018,0.352232818978143,31
"6223","BA","Ponto Novo",14819,7544.35,29010,"Jacobina",2,"Nordeste",0,"292525",4,19,10,9,3,16,0,0,0,0,0,19,10,9,3,16,4,8.92855421772279,9.60366542019018,0.385074210194099,30
"6224","BA","Ponto Novo",14819,7544.35,29010,"Jacobina",2,"Nordeste",0,"292525",5,17,4,13,11,6,0,0,0,0,0,17,4,13,11,6,7,8.92855421772279,9.60366542019018,0.385924184203928,31
"6225","BA","Porto Seguro",150658,21317.76,29032,"Porto Seguro",2,"Nordeste",1,"292530",2,198,69,129,92,106,1,0,1,1,0,199,69,130,93,106,58,9.96729580709396,11.9227676463679,0.27282350373226,29
"6226","BA","Porto Seguro",150658,21317.76,29032,"Porto Seguro",2,"Nordeste",1,"292530",3,219,65,154,101,118,2,1,1,1,1,221,66,155,102,119,61,9.96729580709396,11.9227676463679,0.387344514559052,31
"6227","BA","Porto Seguro",150658,21317.76,29032,"Porto Seguro",2,"Nordeste",1,"292530",4,204,72,132,93,111,4,3,1,2,2,208,75,133,95,113,60,9.96729580709396,11.9227676463679,0.448892372049637,30
"6228","BA","Porto Seguro",150658,21317.76,29032,"Porto Seguro",2,"Nordeste",1,"292530",5,230,89,141,106,124,1,1,0,1,0,231,90,141,107,124,63,9.96729580709396,11.9227676463679,0.427680725013135,31
"6229","BA","Potiraguá",6916,11213.83,29029,"Itapetinga",2,"Nordeste",0,"292540",2,7,0,7,4,3,0,0,0,0,0,7,0,7,4,3,5,9.32490311694681,8.84159284680318,0.302932069236087,29
"6230","BA","Potiraguá",6916,11213.83,29029,"Itapetinga",2,"Nordeste",0,"292540",3,6,2,4,2,4,0,0,0,0,0,6,2,4,2,4,6,9.32490311694681,8.84159284680318,0.344730153075867,31
"6231","BA","Potiraguá",6916,11213.83,29029,"Itapetinga",2,"Nordeste",0,"292540",4,6,3,3,2,4,0,0,0,0,0,6,3,3,2,4,6,9.32490311694681,8.84159284680318,0.357581572685217,30
"6232","BA","Potiraguá",6916,11213.83,29029,"Itapetinga",2,"Nordeste",0,"292540",5,9,2,7,5,4,0,0,0,0,0,9,2,7,5,4,10,9.32490311694681,8.84159284680318,0.348875068942812,31
"6233","BA","Prado",28194,15773.03,29032,"Porto Seguro",2,"Nordeste",0,"292550",2,53,29,24,36,17,1,0,1,0,1,54,29,25,36,18,13,9.66605679847007,10.2468644683309,0.286041400620646,29
"6234","BA","Prado",28194,15773.03,29032,"Porto Seguro",2,"Nordeste",0,"292550",3,26,14,12,18,8,0,0,0,0,0,26,14,12,18,8,22,9.66605679847007,10.2468644683309,0.388942512429638,31
"6235","BA","Prado",28194,15773.03,29032,"Porto Seguro",2,"Nordeste",0,"292550",4,33,16,17,20,13,0,0,0,0,0,33,16,17,20,13,18,9.66605679847007,10.2468644683309,0.403408633222979,30
"6236","BA","Prado",28194,15773.03,29032,"Porto Seguro",2,"Nordeste",0,"292550",5,51,23,28,30,21,0,0,0,0,0,51,23,28,30,21,22,9.66605679847007,10.2468644683309,0.398084912637052,31
"6237","BA","Presidente Dutra",15160,6667.59,29009,"Irecê",2,"Nordeste",0,"292560",2,9,3,6,6,3,0,0,0,0,0,9,3,6,6,3,10,8.80501375427778,9.62641565919636,0.308646936969761,29
"6238","BA","Presidente Dutra",15160,6667.59,29009,"Irecê",2,"Nordeste",0,"292560",3,11,4,7,6,5,1,0,1,0,1,12,4,8,6,6,5,8.80501375427778,9.62641565919636,0.40948625928263,31
"6239","BA","Presidente Dutra",15160,6667.59,29009,"Irecê",2,"Nordeste",0,"292560",4,15,4,11,7,8,0,0,0,0,0,15,4,11,7,8,9,8.80501375427778,9.62641565919636,0.436254683177943,30
"6240","BA","Presidente Dutra",15160,6667.59,29009,"Irecê",2,"Nordeste",0,"292560",5,9,2,7,3,6,0,0,0,0,0,9,2,7,3,6,9,8.80501375427778,9.62641565919636,0.449109929973524,31
"6241","BA","Presidente Jânio Quadros",12179,6545.69,29027,"Brumado",2,"Nordeste",0,"292570",2,12,4,8,5,7,1,1,0,0,1,13,5,8,5,8,1,8.78656209677506,9.40746843608711,0.2985227819029,29
"6242","BA","Presidente Jânio Quadros",12179,6545.69,29027,"Brumado",2,"Nordeste",0,"292570",3,7,1,6,2,5,0,0,0,0,0,7,1,6,2,5,6,8.78656209677506,9.40746843608711,0.365961020054341,31
"6243","BA","Presidente Jânio Quadros",12179,6545.69,29027,"Brumado",2,"Nordeste",0,"292570",4,11,3,8,4,7,0,0,0,0,0,11,3,8,4,7,7,8.78656209677506,9.40746843608711,0.373688835366459,30
"6244","BA","Presidente Jânio Quadros",12179,6545.69,29027,"Brumado",2,"Nordeste",0,"292570",5,18,5,13,8,10,0,0,0,0,0,18,5,13,8,10,13,8.78656209677506,9.40746843608711,0.402310187445965,31
"6245","BA","Presidente Tancredo Neves",28004,9395.84,29030,"Valença",2,"Nordeste",0,"292575",2,25,8,17,11,14,0,0,0,0,0,25,8,17,11,14,7,9.14802231711104,10.2401026360971,0.272949997185608,29
"6246","BA","Presidente Tancredo Neves",28004,9395.84,29030,"Valença",2,"Nordeste",0,"292575",3,33,15,18,17,16,1,0,1,0,1,34,15,19,17,17,15,9.14802231711104,10.2401026360971,0.343202151142989,31
"6247","BA","Presidente Tancredo Neves",28004,9395.84,29030,"Valença",2,"Nordeste",0,"292575",4,28,14,14,12,16,0,0,0,0,0,28,14,14,12,16,8,9.14802231711104,10.2401026360971,0.372871902812373,30
"6248","BA","Presidente Tancredo Neves",28004,9395.84,29030,"Valença",2,"Nordeste",0,"292575",5,42,14,28,20,22,0,0,0,0,0,42,14,28,20,22,19,9.14802231711104,10.2401026360971,0.381422336835025,31
"6249","BA","Queimadas",25433,8027.25,29014,"Euclides da Cunha",2,"Nordeste",0,"292580",2,21,7,14,9,12,0,0,0,0,0,21,7,14,9,12,12,8.99059728253259,10.1438028223587,0.282282331646025,29
"6250","BA","Queimadas",25433,8027.25,29014,"Euclides da Cunha",2,"Nordeste",0,"292580",3,30,10,20,19,11,0,0,0,0,0,30,10,20,19,11,17,8.99059728253259,10.1438028223587,0.353542954109816,31
"6251","BA","Queimadas",25433,8027.25,29014,"Euclides da Cunha",2,"Nordeste",0,"292580",4,24,11,13,9,15,0,0,0,0,0,24,11,13,9,15,12,8.99059728253259,10.1438028223587,0.376976259550275,30
"6252","BA","Queimadas",25433,8027.25,29014,"Euclides da Cunha",2,"Nordeste",0,"292580",5,18,6,12,9,9,0,0,0,0,0,18,6,12,9,9,14,8.99059728253259,10.1438028223587,0.403580444495207,31
"6253","BA","Quijingue",27626,6488.67,29014,"Euclides da Cunha",2,"Nordeste",0,"292590",2,18,7,11,7,11,1,1,0,0,1,19,8,11,7,12,16,8.77781285803442,10.2265126372599,0.319681960836742,29
"6254","BA","Quijingue",27626,6488.67,29014,"Euclides da Cunha",2,"Nordeste",0,"292590",3,17,6,11,5,12,2,0,2,1,1,19,6,13,6,13,18,8.77781285803442,10.2265126372599,0.402563465873299,31
"6255","BA","Quijingue",27626,6488.67,29014,"Euclides da Cunha",2,"Nordeste",0,"292590",4,23,8,15,8,15,1,0,1,0,1,24,8,16,8,16,8,8.77781285803442,10.2265126372599,0.418261730826026,30
"6256","BA","Quijingue",27626,6488.67,29014,"Euclides da Cunha",2,"Nordeste",0,"292590",5,28,15,13,13,15,0,0,0,0,0,28,15,13,13,15,18,8.77781285803442,10.2265126372599,0.427928279671232,31
"6257","BA","Quixabeira",8956,6787.12,29010,"Jacobina",2,"Nordeste",0,"292593",2,3,1,2,2,1,0,0,0,0,0,3,1,2,2,1,2,8.82278197740792,9.10007897771865,0.287301190524203,29
"6258","BA","Quixabeira",8956,6787.12,29010,"Jacobina",2,"Nordeste",0,"292593",3,4,3,1,4,0,0,0,0,0,0,4,3,1,4,0,3,8.82278197740792,9.10007897771865,0.346247575643788,31
"6259","BA","Quixabeira",8956,6787.12,29010,"Jacobina",2,"Nordeste",0,"292593",4,6,1,5,1,5,0,0,0,0,0,6,1,5,1,5,5,8.82278197740792,9.10007897771865,0.380837413471269,30
"6260","BA","Quixabeira",8956,6787.12,29010,"Jacobina",2,"Nordeste",0,"292593",5,5,3,2,2,3,0,0,0,0,0,5,3,2,2,3,3,8.82278197740792,9.10007897771865,0.392426662103431,31
"6261","BA","Rafael Jambeiro",22633,13463.17,29012,"Feira de Santana",2,"Nordeste",0,"292595",2,18,7,11,9,9,0,0,0,0,0,18,7,11,9,9,10,9.50771308809999,10.0271642972297,0.276628887413593,29
"6262","BA","Rafael Jambeiro",22633,13463.17,29012,"Feira de Santana",2,"Nordeste",0,"292595",3,15,7,8,6,9,0,0,0,0,0,15,7,8,6,9,11,9.50771308809999,10.0271642972297,0.349853565382042,31
"6263","BA","Rafael Jambeiro",22633,13463.17,29012,"Feira de Santana",2,"Nordeste",0,"292595",4,12,3,9,5,7,0,0,0,0,0,12,3,9,5,7,12,9.50771308809999,10.0271642972297,0.401528649784063,30
"6264","BA","Rafael Jambeiro",22633,13463.17,29012,"Feira de Santana",2,"Nordeste",0,"292595",5,14,7,7,5,9,0,0,0,0,0,14,7,7,5,9,9,9.50771308809999,10.0271642972297,0.42427378078181,31
"6265","BA","Remanso",41170,8864.84,29004,"Juazeiro",2,"Nordeste",0,"292600",2,50,19,31,23,27,0,0,0,0,0,50,19,31,23,27,19,9.08984816984007,10.6254651147639,0.267963206483576,29
"6266","BA","Remanso",41170,8864.84,29004,"Juazeiro",2,"Nordeste",0,"292600",3,39,15,24,19,20,0,0,0,0,0,39,15,24,19,20,21,9.08984816984007,10.6254651147639,0.362204826876863,31
"6267","BA","Remanso",41170,8864.84,29004,"Juazeiro",2,"Nordeste",0,"292600",4,39,17,22,24,15,0,0,0,0,0,39,17,22,24,15,31,9.08984816984007,10.6254651147639,0.373662548598833,30
"6268","BA","Remanso",41170,8864.84,29004,"Juazeiro",2,"Nordeste",0,"292600",5,26,11,15,14,12,0,0,0,0,0,26,11,15,14,12,28,9.08984816984007,10.6254651147639,0.392399142566358,31
"6269","BA","Retirolândia",14495,8574.08,29016,"Serrinha",2,"Nordeste",0,"292610",2,14,4,10,5,9,0,0,0,0,0,14,4,10,5,9,5,9.05649897764857,9.58155904135576,0.243355619197941,29
"6270","BA","Retirolândia",14495,8574.08,29016,"Serrinha",2,"Nordeste",0,"292610",3,13,3,10,8,5,0,0,0,0,0,13,3,10,8,5,6,9.05649897764857,9.58155904135576,0.319917130355812,31
"6271","BA","Retirolândia",14495,8574.08,29016,"Serrinha",2,"Nordeste",0,"292610",4,10,6,4,4,6,0,0,0,0,0,10,6,4,4,6,8,9.05649897764857,9.58155904135576,0.333664376391476,30
"6272","BA","Retirolândia",14495,8574.08,29016,"Serrinha",2,"Nordeste",0,"292610",5,12,2,10,3,9,0,0,0,0,0,12,2,10,3,9,12,9.05649897764857,9.58155904135576,0.362040571650866,31
"6273","BA","Riachão das Neves",22334,43808.04,29001,"Barreiras",2,"Nordeste",0,"292620",2,23,8,15,11,12,1,0,1,0,1,24,8,16,11,13,11,10.687572641163,10.0138654600057,0.300217741768068,29
"6274","BA","Riachão das Neves",22334,43808.04,29001,"Barreiras",2,"Nordeste",0,"292620",3,27,11,16,8,19,1,0,1,1,0,28,11,17,9,19,17,10.687572641163,10.0138654600057,0.337811349649562,31
"6275","BA","Riachão das Neves",22334,43808.04,29001,"Barreiras",2,"Nordeste",0,"292620",4,21,7,14,9,12,0,0,0,0,0,21,7,14,9,12,12,10.687572641163,10.0138654600057,0.365327363247916,30
"6276","BA","Riachão das Neves",22334,43808.04,29001,"Barreiras",2,"Nordeste",0,"292620",5,21,8,13,13,8,0,0,0,0,0,21,8,13,13,8,14,10.687572641163,10.0138654600057,0.389300496256727,31
"6277","BA","Riachão do Jacuípe",33468,10660.01,29016,"Serrinha",2,"Nordeste",0,"292630",2,30,3,27,11,19,0,0,0,0,0,30,3,27,11,19,16,9.2742546358057,10.4183450374155,0.265344907647106,29
"6278","BA","Riachão do Jacuípe",33468,10660.01,29016,"Serrinha",2,"Nordeste",0,"292630",3,31,13,18,8,23,0,0,0,0,0,31,13,18,8,23,16,9.2742546358057,10.4183450374155,0.354330689036397,31
"6279","BA","Riachão do Jacuípe",33468,10660.01,29016,"Serrinha",2,"Nordeste",0,"292630",4,29,9,20,14,15,0,0,0,0,0,29,9,20,14,15,10,9.2742546358057,10.4183450374155,0.372655777624571,30
"6280","BA","Riachão do Jacuípe",33468,10660.01,29016,"Serrinha",2,"Nordeste",0,"292630",5,36,9,27,15,21,1,1,0,1,0,37,10,27,16,21,15,9.2742546358057,10.4183450374155,0.362779140217628,31
"6281","BA","Riacho de Santana",35593,7195.92,29026,"Guanambi",2,"Nordeste",0,"292640",2,25,8,17,12,13,0,0,0,0,0,25,8,17,12,13,12,8.88126947772124,10.4799042682926,0.264904724916843,29
"6282","BA","Riacho de Santana",35593,7195.92,29026,"Guanambi",2,"Nordeste",0,"292640",3,25,12,13,9,16,0,0,0,0,0,25,12,13,9,16,16,8.88126947772124,10.4799042682926,0.333114623156828,31
"6283","BA","Riacho de Santana",35593,7195.92,29026,"Guanambi",2,"Nordeste",0,"292640",4,19,7,12,7,12,0,0,0,0,0,19,7,12,7,12,12,8.88126947772124,10.4799042682926,0.375333049553668,30
"6284","BA","Riacho de Santana",35593,7195.92,29026,"Guanambi",2,"Nordeste",0,"292640",5,27,13,14,12,15,0,0,0,0,0,27,13,14,12,15,16,8.88126947772124,10.4799042682926,0.406079051089418,31
"6285","BA","Ribeira do Amparo",14612,8719.36,29015,"Ribeira do Pombal",2,"Nordeste",0,"292650",2,17,6,11,5,12,0,0,0,0,0,17,6,11,5,12,6,9.0733011197141,9.58959838791517,0.307385432552908,29
"6286","BA","Ribeira do Amparo",14612,8719.36,29015,"Ribeira do Pombal",2,"Nordeste",0,"292650",3,11,7,4,4,7,0,0,0,0,0,11,7,4,4,7,6,9.0733011197141,9.58959838791517,0.395650251387698,31
"6287","BA","Ribeira do Amparo",14612,8719.36,29015,"Ribeira do Pombal",2,"Nordeste",0,"292650",4,12,7,5,5,7,0,0,0,0,0,12,7,5,5,7,6,9.0733011197141,9.58959838791517,0.397821155641695,30
"6288","BA","Ribeira do Amparo",14612,8719.36,29015,"Ribeira do Pombal",2,"Nordeste",0,"292650",5,20,9,11,9,11,0,0,0,0,0,20,9,11,9,11,8,9.0733011197141,9.58959838791517,0.421493505705922,31
"6289","BA","Ribeira do Pombal",53956,10613.52,29015,"Ribeira do Pombal",2,"Nordeste",1,"292660",2,54,16,38,23,31,0,0,0,0,0,54,16,38,23,31,31,9.26988393907524,10.8959241785896,0.26980899730697,29
"6290","BA","Ribeira do Pombal",53956,10613.52,29015,"Ribeira do Pombal",2,"Nordeste",1,"292660",3,46,16,30,19,27,0,0,0,0,0,46,16,30,19,27,30,9.26988393907524,10.8959241785896,0.351922073126546,31
"6291","BA","Ribeira do Pombal",53956,10613.52,29015,"Ribeira do Pombal",2,"Nordeste",1,"292660",4,59,18,41,28,31,0,0,0,0,0,59,18,41,28,31,24,9.26988393907524,10.8959241785896,0.390423223747508,30
"6292","BA","Ribeira do Pombal",53956,10613.52,29015,"Ribeira do Pombal",2,"Nordeste",1,"292660",5,54,13,41,17,37,0,0,0,0,0,54,13,41,17,37,28,9.26988393907524,10.8959241785896,0.387108809701692,31
"6293","BA","Ribeirão do Largo",5343,12765.84,29029,"Itapetinga",2,"Nordeste",0,"292665",2,8,4,4,3,5,0,0,0,0,0,8,4,4,3,5,4,9.4545281324459,8.58354257195777,0.296244249307694,29
"6294","BA","Ribeirão do Largo",5343,12765.84,29029,"Itapetinga",2,"Nordeste",0,"292665",3,8,3,5,4,4,0,0,0,0,0,8,3,5,4,4,3,9.4545281324459,8.58354257195777,0.385031348680357,31
"6295","BA","Ribeirão do Largo",5343,12765.84,29029,"Itapetinga",2,"Nordeste",0,"292665",4,4,2,2,1,3,0,0,0,0,0,4,2,2,1,3,3,9.4545281324459,8.58354257195777,0.410326706597258,30
"6296","BA","Ribeirão do Largo",5343,12765.84,29029,"Itapetinga",2,"Nordeste",0,"292665",5,5,2,3,3,2,0,0,0,0,0,5,2,3,3,2,7,9.4545281324459,8.58354257195777,0.430235744156637,31
"6297","BA","Rio de Contas",12932,9122.98,29023,"Seabra",2,"Nordeste",0,"292670",2,12,2,10,2,10,0,0,0,0,0,12,2,10,2,10,13,9.11855178408175,9.46746013884532,0.27286283967029,29
"6298","BA","Rio de Contas",12932,9122.98,29023,"Seabra",2,"Nordeste",0,"292670",3,10,3,7,2,8,0,0,0,0,0,10,3,7,2,8,7,9.11855178408175,9.46746013884532,0.383736397962422,31
"6299","BA","Rio de Contas",12932,9122.98,29023,"Seabra",2,"Nordeste",0,"292670",4,9,3,6,2,7,0,0,0,0,0,9,3,6,2,7,6,9.11855178408175,9.46746013884532,0.413848069637498,30
"6300","BA","Rio de Contas",12932,9122.98,29023,"Seabra",2,"Nordeste",0,"292670",5,16,3,13,5,11,0,0,0,0,0,16,3,13,5,11,10,9.11855178408175,9.46746013884532,0.407492414033139,31
"6301","BA","Rio do Antônio",15448,6589.39,29027,"Brumado",2,"Nordeste",0,"292680",2,11,3,8,5,6,0,0,0,0,0,11,3,8,5,6,2,8.79321605872054,9.64523482410835,0.282856764198449,29
"6302","BA","Rio do Antônio",15448,6589.39,29027,"Brumado",2,"Nordeste",0,"292680",3,13,8,5,2,11,0,0,0,0,0,13,8,5,2,11,5,8.79321605872054,9.64523482410835,0.40374759894329,31
"6303","BA","Rio do Antônio",15448,6589.39,29027,"Brumado",2,"Nordeste",0,"292680",4,4,2,2,0,4,0,0,0,0,0,4,2,2,0,4,4,8.79321605872054,9.64523482410835,0.441483402431369,30
"6304","BA","Rio do Antônio",15448,6589.39,29027,"Brumado",2,"Nordeste",0,"292680",5,3,2,1,1,2,0,0,0,0,0,3,2,1,1,2,4,8.79321605872054,9.64523482410835,0.440829103605721,31
"6305","BA","Rio do Pires",11663,7072.5,29025,"Livramento do Brumado",2,"Nordeste",0,"292690",2,9,4,5,2,7,0,0,0,0,0,9,4,5,2,7,6,8.86396930317572,9.36417671669105,0.293414417153291,29
"6306","BA","Rio do Pires",11663,7072.5,29025,"Livramento do Brumado",2,"Nordeste",0,"292690",3,5,1,4,1,4,0,0,0,0,0,5,1,4,1,4,6,8.86396930317572,9.36417671669105,0.355702269079814,31
"6307","BA","Rio do Pires",11663,7072.5,29025,"Livramento do Brumado",2,"Nordeste",0,"292690",4,3,2,1,2,1,0,0,0,0,0,3,2,1,2,1,6,8.86396930317572,9.36417671669105,0.400880286662757,30
"6308","BA","Rio do Pires",11663,7072.5,29025,"Livramento do Brumado",2,"Nordeste",0,"292690",5,11,5,6,3,8,1,0,1,0,1,12,5,7,3,9,5,8.86396930317572,9.36417671669105,0.402218214155658,31
"6309","BA","Rio Real",40976,21840.4,29017,"Alagoinhas",2,"Nordeste",0,"292700",2,32,9,23,17,15,0,0,0,0,0,32,9,23,17,15,15,9.99151674470944,10.6207418084393,0.277265249402724,29
"6310","BA","Rio Real",40976,21840.4,29017,"Alagoinhas",2,"Nordeste",0,"292700",3,32,16,16,16,16,0,0,0,0,0,32,16,16,16,16,16,9.99151674470944,10.6207418084393,0.352876049687182,31
"6311","BA","Rio Real",40976,21840.4,29017,"Alagoinhas",2,"Nordeste",0,"292700",4,35,12,23,18,17,1,1,0,0,1,36,13,23,18,18,22,9.99151674470944,10.6207418084393,0.373639530286434,30
"6312","BA","Rio Real",40976,21840.4,29017,"Alagoinhas",2,"Nordeste",0,"292700",5,54,18,36,21,33,0,0,0,0,0,54,18,36,21,33,20,9.99151674470944,10.6207418084393,0.365523559850804,31
"6313","BA","Rodelas",9442,9752.43,29005,"Paulo Afonso",2,"Nordeste",0,"292710",2,10,0,10,6,4,0,0,0,0,0,10,0,10,6,4,4,9.1852717637083,9.15292310110623,0.304190261998801,29
"6314","BA","Rodelas",9442,9752.43,29005,"Paulo Afonso",2,"Nordeste",0,"292710",3,15,6,9,8,7,0,0,0,0,0,15,6,9,8,7,9,9.1852717637083,9.15292310110623,0.384591452818148,31
"6315","BA","Rodelas",9442,9752.43,29005,"Paulo Afonso",2,"Nordeste",0,"292710",4,15,7,8,9,6,0,0,0,0,0,15,7,8,9,6,4,9.1852717637083,9.15292310110623,0.409087565460208,30
"6316","BA","Rodelas",9442,9752.43,29005,"Paulo Afonso",2,"Nordeste",0,"292710",5,18,7,11,7,11,0,0,0,0,0,18,7,11,7,11,3,9.1852717637083,9.15292310110623,0.429121095972979,31
"6317","BA","Ruy Barbosa",30857,9764.4,29011,"Itaberaba",2,"Nordeste",0,"292720",2,22,8,14,12,10,0,0,0,0,0,22,8,14,12,10,14,9.18649839749061,10.3371189079706,0.278334554047527,29
"6318","BA","Ruy Barbosa",30857,9764.4,29011,"Itaberaba",2,"Nordeste",0,"292720",3,28,10,18,15,13,0,0,0,0,0,28,10,18,15,13,11,9.18649839749061,10.3371189079706,0.34431448689962,31
"6319","BA","Ruy Barbosa",30857,9764.4,29011,"Itaberaba",2,"Nordeste",0,"292720",4,22,9,13,9,13,0,0,0,0,0,22,9,13,9,13,20,9.18649839749061,10.3371189079706,0.346018674025748,30
"6320","BA","Ruy Barbosa",30857,9764.4,29011,"Itaberaba",2,"Nordeste",0,"292720",5,28,8,20,11,17,1,0,1,0,1,29,8,21,11,18,20,9.18649839749061,10.3371189079706,0.346588168251269,31
"6321","BA","Salinas da Margarida",15862,10704.28,29020,"Santo Antônio de Jesus",2,"Nordeste",0,"292730",2,7,2,5,3,4,0,0,0,0,0,7,2,5,3,4,12,9.27839894047132,9.67168159064327,0.315791625820446,29
"6322","BA","Salinas da Margarida",15862,10704.28,29020,"Santo Antônio de Jesus",2,"Nordeste",0,"292730",3,4,1,3,1,3,0,0,0,0,0,4,1,3,1,3,7,9.27839894047132,9.67168159064327,0.44043997386271,31
"6323","BA","Salinas da Margarida",15862,10704.28,29020,"Santo Antônio de Jesus",2,"Nordeste",0,"292730",4,11,1,10,6,5,0,0,0,0,0,11,1,10,6,5,7,9.27839894047132,9.67168159064327,0.478146332693774,30
"6324","BA","Salinas da Margarida",15862,10704.28,29020,"Santo Antônio de Jesus",2,"Nordeste",0,"292730",5,15,2,13,3,12,0,0,0,0,0,15,2,13,3,12,5,9.27839894047132,9.67168159064327,0.4783936065154,31
"6325","BA","Salvador",2886698,22232.68,29021,"Salvador",2,"Nordeste",1,"292740",2,2179,470,1709,695,1484,32,8,24,12,20,2211,478,1733,707,1504,1372,10.0093185574965,14.8756238463151,0.288510391663945,29
"6326","BA","Salvador",2886698,22232.68,29021,"Salvador",2,"Nordeste",1,"292740",3,2010,405,1605,601,1409,23,7,16,5,18,2033,412,1621,606,1427,1515,10.0093185574965,14.8756238463151,0.408655363139612,31
"6327","BA","Salvador",2886698,22232.68,29021,"Salvador",2,"Nordeste",1,"292740",4,1994,426,1568,631,1363,29,10,19,4,25,2023,436,1587,635,1388,1643,10.0093185574965,14.8756238463151,0.502155459163693,30
"6328","BA","Salvador",2886698,22232.68,29021,"Salvador",2,"Nordeste",1,"292740",5,2150,478,1672,666,1484,29,9,20,10,19,2179,487,1692,676,1503,2443,10.0093185574965,14.8756238463151,0.483233754092289,31
"6329","BA","Santa Bárbara",20883,8147.3,29012,"Feira de Santana",2,"Nordeste",0,"292750",2,21,11,10,12,9,0,0,0,0,0,21,11,10,12,9,8,9.00544186300324,9.94669070983678,0.260666503164657,29
"6330","BA","Santa Bárbara",20883,8147.3,29012,"Feira de Santana",2,"Nordeste",0,"292750",3,16,6,10,7,9,0,0,0,0,0,16,6,10,7,9,11,9.00544186300324,9.94669070983678,0.332363534400881,31
"6331","BA","Santa Bárbara",20883,8147.3,29012,"Feira de Santana",2,"Nordeste",0,"292750",4,15,7,8,6,9,0,0,0,0,0,15,7,8,6,9,12,9.00544186300324,9.94669070983678,0.373276237431781,30
"6332","BA","Santa Bárbara",20883,8147.3,29012,"Feira de Santana",2,"Nordeste",0,"292750",5,5,3,2,2,3,0,0,0,0,0,5,3,2,2,3,13,9.00544186300324,9.94669070983678,0.393517151976401,31
"6333","BA","Santa Brígida",14063,6983.66,29013,"Jeremoabo",2,"Nordeste",0,"292760",2,7,1,6,5,2,0,0,0,0,0,7,1,6,5,2,4,8.85132841363107,9.55130251387025,0.316766049732653,29
"6334","BA","Santa Brígida",14063,6983.66,29013,"Jeremoabo",2,"Nordeste",0,"292760",3,19,9,10,9,10,0,0,0,0,0,19,9,10,9,10,11,8.85132841363107,9.55130251387025,0.379289932100369,31
"6335","BA","Santa Brígida",14063,6983.66,29013,"Jeremoabo",2,"Nordeste",0,"292760",4,12,7,5,8,4,0,0,0,0,0,12,7,5,8,4,7,8.85132841363107,9.55130251387025,0.413128948572683,30
"6336","BA","Santa Brígida",14063,6983.66,29013,"Jeremoabo",2,"Nordeste",0,"292760",5,8,3,5,3,5,0,0,0,0,0,8,3,5,3,5,9,8.85132841363107,9.55130251387025,0.449002866370545,31
"6337","BA","Santa Cruz Cabrália",27922,15085.38,29032,"Porto Seguro",2,"Nordeste",0,"292770",2,38,10,28,13,25,0,0,0,0,0,38,10,28,13,25,14,9.62148134186256,10.2371701875486,0.280767812546687,29
"6338","BA","Santa Cruz Cabrália",27922,15085.38,29032,"Porto Seguro",2,"Nordeste",0,"292770",3,43,14,29,29,14,0,0,0,0,0,43,14,29,29,14,18,9.62148134186256,10.2371701875486,0.390126425260781,31
"6339","BA","Santa Cruz Cabrália",27922,15085.38,29032,"Porto Seguro",2,"Nordeste",0,"292770",4,35,13,22,14,21,0,0,0,0,0,35,13,22,14,21,16,9.62148134186256,10.2371701875486,0.462870591638893,30
"6340","BA","Santa Cruz Cabrália",27922,15085.38,29032,"Porto Seguro",2,"Nordeste",0,"292770",5,43,16,27,21,22,2,2,0,1,1,45,18,27,22,23,16,9.62148134186256,10.2371701875486,0.447863578707326,31
"6341","BA","Santa Inês",10606,6534.75,29024,"Jequié",2,"Nordeste",0,"292790",2,8,1,7,3,5,0,0,0,0,0,8,1,7,3,5,9,8.78488936977951,9.26917515769708,0.273523852844257,29
"6342","BA","Santa Inês",10606,6534.75,29024,"Jequié",2,"Nordeste",0,"292790",3,5,2,3,3,2,0,0,0,0,0,5,2,3,3,2,5,8.78488936977951,9.26917515769708,0.36684427799177,31
"6343","BA","Santa Inês",10606,6534.75,29024,"Jequié",2,"Nordeste",0,"292790",4,3,0,3,2,1,0,0,0,0,0,3,0,3,2,1,5,8.78488936977951,9.26917515769708,0.407680325829444,30
"6344","BA","Santa Inês",10606,6534.75,29024,"Jequié",2,"Nordeste",0,"292790",5,7,3,4,3,4,0,0,0,0,0,7,3,4,3,4,12,8.78488936977951,9.26917515769708,0.415031202787995,31
"6345","BA","Santaluz",37531,10065.84,29016,"Serrinha",2,"Nordeste",0,"292800",2,29,17,12,12,17,0,0,0,0,0,29,17,12,12,17,21,9.21690279211759,10.5329225371245,0.262352221331452,29
"6346","BA","Santaluz",37531,10065.84,29016,"Serrinha",2,"Nordeste",0,"292800",3,41,14,27,17,24,2,0,2,0,2,43,14,29,17,26,17,9.21690279211759,10.5329225371245,0.359958145456141,31
"6347","BA","Santaluz",37531,10065.84,29016,"Serrinha",2,"Nordeste",0,"292800",4,42,20,22,20,22,0,0,0,0,0,42,20,22,20,22,21,9.21690279211759,10.5329225371245,0.388720240033209,30
"6348","BA","Santaluz",37531,10065.84,29016,"Serrinha",2,"Nordeste",0,"292800",5,42,12,30,19,23,0,0,0,0,0,42,12,30,19,23,26,9.21690279211759,10.5329225371245,0.399940512718511,31
"6349","BA","Santa Luzia",12449,7339.73,29031,"Ilhéus-Itabuna",2,"Nordeste",0,"292805",2,9,5,4,3,6,0,0,0,0,0,9,5,4,3,6,6,8.90105733619084,9.42939557738179,0.270964631209677,29
"6350","BA","Santa Luzia",12449,7339.73,29031,"Ilhéus-Itabuna",2,"Nordeste",0,"292805",3,13,8,5,5,8,0,0,0,0,0,13,8,5,5,8,9,8.90105733619084,9.42939557738179,0.363023213127075,31
"6351","BA","Santa Luzia",12449,7339.73,29031,"Ilhéus-Itabuna",2,"Nordeste",0,"292805",4,17,9,8,10,7,0,0,0,0,0,17,9,8,10,7,7,8.90105733619084,9.42939557738179,0.386042665440956,30
"6352","BA","Santa Luzia",12449,7339.73,29031,"Ilhéus-Itabuna",2,"Nordeste",0,"292805",5,8,4,4,5,3,1,0,1,0,1,9,4,5,5,4,5,8.90105733619084,9.42939557738179,0.418796858359438,31
"6353","BA","Santa Maria da Vitória",39775,11678.58,29003,"Santa Maria da Vitória",2,"Nordeste",1,"292810",2,45,13,32,18,27,0,0,0,0,0,45,13,32,18,27,22,9.36551167364887,10.590993853206,0.273031205051183,29
"6354","BA","Santa Maria da Vitória",39775,11678.58,29003,"Santa Maria da Vitória",2,"Nordeste",1,"292810",3,22,7,15,9,13,1,0,1,1,0,23,7,16,10,13,22,9.36551167364887,10.590993853206,0.353981476417711,31
"6355","BA","Santa Maria da Vitória",39775,11678.58,29003,"Santa Maria da Vitória",2,"Nordeste",1,"292810",4,36,13,23,15,21,1,1,0,0,1,37,14,23,15,22,15,9.36551167364887,10.590993853206,0.373535761119762,30
"6356","BA","Santa Maria da Vitória",39775,11678.58,29003,"Santa Maria da Vitória",2,"Nordeste",1,"292810",5,32,14,18,15,17,0,0,0,0,0,32,14,18,15,17,19,9.36551167364887,10.590993853206,0.372601565053051,31
"6357","BA","Santana",26705,9418.19,29003,"Santa Maria da Vitória",2,"Nordeste",0,"292820",2,16,7,9,7,9,0,0,0,0,0,16,7,9,7,9,10,9.15039820473464,10.1926060927739,0.275423298008165,29
"6358","BA","Santana",26705,9418.19,29003,"Santa Maria da Vitória",2,"Nordeste",0,"292820",3,14,5,9,3,11,0,0,0,0,0,14,5,9,3,11,13,9.15039820473464,10.1926060927739,0.369925626942625,31
"6359","BA","Santana",26705,9418.19,29003,"Santa Maria da Vitória",2,"Nordeste",0,"292820",4,22,7,15,7,15,0,0,0,0,0,22,7,15,7,15,17,9.15039820473464,10.1926060927739,0.388168973315802,30
"6360","BA","Santana",26705,9418.19,29003,"Santa Maria da Vitória",2,"Nordeste",0,"292820",5,29,3,26,18,11,1,1,0,0,1,30,4,26,18,12,11,9.15039820473464,10.1926060927739,0.367159849138237,31
"6361","BA","Santanópolis",8966,5688.4,29012,"Feira de Santana",2,"Nordeste",0,"292830",2,6,2,4,4,2,0,0,0,0,0,6,2,4,4,2,4,8.64618429249854,9.10119492471538,0.270179192523996,29
"6362","BA","Santanópolis",8966,5688.4,29012,"Feira de Santana",2,"Nordeste",0,"292830",3,1,0,1,0,1,0,0,0,0,0,1,0,1,0,1,4,8.64618429249854,9.10119492471538,0.361172008265481,31
"6363","BA","Santanópolis",8966,5688.4,29012,"Feira de Santana",2,"Nordeste",0,"292830",4,3,1,2,1,2,0,0,0,0,0,3,1,2,1,2,3,8.64618429249854,9.10119492471538,0.398349929574606,30
"6364","BA","Santanópolis",8966,5688.4,29012,"Feira de Santana",2,"Nordeste",0,"292830",5,7,2,5,1,6,0,0,0,0,0,7,2,5,1,6,6,8.64618429249854,9.10119492471538,0.415832944039835,31
"6365","BA","Santa Rita de Cássia",28481,7985.64,29002,"Cotegipe",2,"Nordeste",0,"292840",2,33,14,19,12,21,0,0,0,0,0,33,14,19,12,21,14,8.98540020771903,10.256992477269,0.278957515358274,29
"6366","BA","Santa Rita de Cássia",28481,7985.64,29002,"Cotegipe",2,"Nordeste",0,"292840",3,21,7,14,11,10,1,1,0,0,1,22,8,14,11,11,11,8.98540020771903,10.256992477269,0.355069170731859,31
"6367","BA","Santa Rita de Cássia",28481,7985.64,29002,"Cotegipe",2,"Nordeste",0,"292840",4,23,8,15,10,13,2,0,2,1,1,25,8,17,11,14,6,8.98540020771903,10.256992477269,0.340616362748786,30
"6368","BA","Santa Rita de Cássia",28481,7985.64,29002,"Cotegipe",2,"Nordeste",0,"292840",5,25,9,16,9,16,0,0,0,0,0,25,9,16,9,16,9,8.98540020771903,10.256992477269,0.34329317889341,31
"6369","BA","Santa Terezinha",10464,7106.75,29012,"Feira de Santana",2,"Nordeste",0,"292850",2,7,2,5,5,2,0,0,0,0,0,7,2,5,5,2,4,8.86880031562172,9.25569607369698,0.277765520788775,29
"6370","BA","Santa Terezinha",10464,7106.75,29012,"Feira de Santana",2,"Nordeste",0,"292850",3,9,4,5,6,3,0,0,0,0,0,9,4,5,6,3,9,8.86880031562172,9.25569607369698,0.342895866948119,31
"6371","BA","Santa Terezinha",10464,7106.75,29012,"Feira de Santana",2,"Nordeste",0,"292850",4,11,1,10,3,8,0,0,0,0,0,11,1,10,3,8,8,8.86880031562172,9.25569607369698,0.407491479953044,30
"6372","BA","Santa Terezinha",10464,7106.75,29012,"Feira de Santana",2,"Nordeste",0,"292850",5,6,2,4,4,2,0,0,0,0,0,6,2,4,4,2,6,8.86880031562172,9.25569607369698,0.425274684142136,31
"6373","BA","Santo Amaro",60131,13628.51,29020,"Santo Antônio de Jesus",2,"Nordeste",1,"292860",2,37,13,24,19,18,4,1,3,0,4,41,14,27,19,22,24,9.51991920103338,11.004280794529,0.309719594486862,29
"6374","BA","Santo Amaro",60131,13628.51,29020,"Santo Antônio de Jesus",2,"Nordeste",1,"292860",3,35,5,30,13,22,2,1,1,0,2,37,6,31,13,24,41,9.51991920103338,11.004280794529,0.398823726246345,31
"6375","BA","Santo Amaro",60131,13628.51,29020,"Santo Antônio de Jesus",2,"Nordeste",1,"292860",4,52,15,37,23,29,0,0,0,0,0,52,15,37,23,29,46,9.51991920103338,11.004280794529,0.458596770316866,30
"6376","BA","Santo Amaro",60131,13628.51,29020,"Santo Antônio de Jesus",2,"Nordeste",1,"292860",5,44,16,28,18,26,1,1,0,1,0,45,17,28,19,26,48,9.51991920103338,11.004280794529,0.451609217693842,31
"6377","BA","Santo Antônio de Jesus",102380,21629.28,29020,"Santo Antônio de Jesus",2,"Nordeste",1,"292870",2,100,18,82,29,71,4,0,4,1,3,104,18,86,30,74,74,9.98180323129183,11.5364466600116,0.270698395842312,29
"6378","BA","Santo Antônio de Jesus",102380,21629.28,29020,"Santo Antônio de Jesus",2,"Nordeste",1,"292870",3,107,23,84,36,71,0,0,0,0,0,107,23,84,36,71,64,9.98180323129183,11.5364466600116,0.366503822490594,31
"6379","BA","Santo Antônio de Jesus",102380,21629.28,29020,"Santo Antônio de Jesus",2,"Nordeste",1,"292870",4,87,19,68,22,65,2,1,1,1,1,89,20,69,23,66,52,9.98180323129183,11.5364466600116,0.401244895996712,30
"6380","BA","Santo Antônio de Jesus",102380,21629.28,29020,"Santo Antônio de Jesus",2,"Nordeste",1,"292870",5,120,31,89,34,86,1,0,1,0,1,121,31,90,34,87,45,9.98180323129183,11.5364466600116,0.393943493446725,31
"6381","BA","Santo Estêvão",53269,13962.54,29012,"Feira de Santana",2,"Nordeste",0,"292880",2,33,11,22,5,28,1,1,0,0,1,34,12,22,5,29,31,9.54413330818983,10.8831098274427,0.260493162929622,29
"6382","BA","Santo Estêvão",53269,13962.54,29012,"Feira de Santana",2,"Nordeste",0,"292880",3,41,9,32,13,28,1,0,1,1,0,42,9,33,14,28,31,9.54413330818983,10.8831098274427,0.34435817701886,31
"6383","BA","Santo Estêvão",53269,13962.54,29012,"Feira de Santana",2,"Nordeste",0,"292880",4,25,10,15,12,13,0,0,0,0,0,25,10,15,12,13,47,9.54413330818983,10.8831098274427,0.357116843434214,30
"6384","BA","Santo Estêvão",53269,13962.54,29012,"Feira de Santana",2,"Nordeste",0,"292880",5,48,17,31,18,30,1,0,1,0,1,49,17,32,18,31,37,9.54413330818983,10.8831098274427,0.35201515593613,31
"6385","BA","São Desidério",34266,109841.86,29001,"Barreiras",2,"Nordeste",0,"292890",2,44,9,35,22,22,0,0,0,0,0,44,9,35,22,22,14,11.6067969740203,10.4419088878929,0.283495601967028,29
"6386","BA","São Desidério",34266,109841.86,29001,"Barreiras",2,"Nordeste",0,"292890",3,47,21,26,19,28,0,0,0,0,0,47,21,26,19,28,12,11.6067969740203,10.4419088878929,0.353011456338959,31
"6387","BA","São Desidério",34266,109841.86,29001,"Barreiras",2,"Nordeste",0,"292890",4,49,11,38,20,29,1,1,0,0,1,50,12,38,20,30,16,11.6067969740203,10.4419088878929,0.362957392073678,30
"6388","BA","São Desidério",34266,109841.86,29001,"Barreiras",2,"Nordeste",0,"292890",5,37,11,26,16,21,0,0,0,0,0,37,11,26,16,21,15,11.6067969740203,10.4419088878929,0.3849452501491,31
"6389","BA","São Domingos",9072,7755.89,29016,"Serrinha",2,"Nordeste",0,"292895",2,5,1,4,1,4,0,0,0,0,0,5,1,4,1,4,4,8.95620783369363,9.11294802596753,0.279357703604895,29
"6390","BA","São Domingos",9072,7755.89,29016,"Serrinha",2,"Nordeste",0,"292895",3,5,2,3,3,2,0,0,0,0,0,5,2,3,3,2,4,8.95620783369363,9.11294802596753,0.37428548797951,31
"6391","BA","São Domingos",9072,7755.89,29016,"Serrinha",2,"Nordeste",0,"292895",4,1,0,1,1,0,0,0,0,0,0,1,0,1,1,0,5,8.95620783369363,9.11294802596753,0.364458790695817,30
"6392","BA","São Domingos",9072,7755.89,29016,"Serrinha",2,"Nordeste",0,"292895",5,6,2,4,2,4,0,0,0,0,0,6,2,4,2,4,12,8.95620783369363,9.11294802596753,0.374181393625194,31
"6393","BA","São Félix",14762,14138.21,29020,"Santo Antônio de Jesus",2,"Nordeste",1,"292900",2,9,1,8,4,5,1,0,1,0,1,10,1,9,4,6,5,9.55663634020667,9.59981159033,0.284761034546564,29
"6394","BA","São Félix",14762,14138.21,29020,"Santo Antônio de Jesus",2,"Nordeste",1,"292900",3,12,3,9,1,11,0,0,0,0,0,12,3,9,1,11,10,9.55663634020667,9.59981159033,0.404275781201399,31
"6395","BA","São Félix",14762,14138.21,29020,"Santo Antônio de Jesus",2,"Nordeste",1,"292900",4,8,0,8,5,3,0,0,0,0,0,8,0,8,5,3,8,9.55663634020667,9.59981159033,0.421991341608472,30
"6396","BA","São Félix",14762,14138.21,29020,"Santo Antônio de Jesus",2,"Nordeste",1,"292900",5,8,3,5,4,4,0,0,0,0,0,8,3,5,4,4,17,9.55663634020667,9.59981159033,0.401898112636388,31
"6397","BA","São Félix do Coribe",15468,13999.38,29003,"Santa Maria da Vitória",2,"Nordeste",1,"292905",2,20,5,15,14,6,0,0,0,0,0,20,5,15,14,6,6,9.54676832190247,9.64652865272719,0.293397518904703,29
"6398","BA","São Félix do Coribe",15468,13999.38,29003,"Santa Maria da Vitória",2,"Nordeste",1,"292905",3,13,4,9,5,8,1,1,0,0,1,14,5,9,5,9,8,9.54676832190247,9.64652865272719,0.369701520455597,31
"6399","BA","São Félix do Coribe",15468,13999.38,29003,"Santa Maria da Vitória",2,"Nordeste",1,"292905",4,11,1,10,5,6,0,0,0,0,0,11,1,10,5,6,5,9.54676832190247,9.64652865272719,0.383333979800854,30
"6400","BA","São Félix do Coribe",15468,13999.38,29003,"Santa Maria da Vitória",2,"Nordeste",1,"292905",5,11,3,8,3,8,0,0,0,0,0,11,3,8,3,8,5,9.54676832190247,9.64652865272719,0.359670737391851,31
"6401","BA","São Felipe",21080,8870.08,29020,"Santo Antônio de Jesus",2,"Nordeste",0,"292910",2,9,2,7,0,9,0,0,0,0,0,9,2,7,0,9,9,9.09043909442868,9.9560800026553,0.269330401992293,29
"6402","BA","São Felipe",21080,8870.08,29020,"Santo Antônio de Jesus",2,"Nordeste",0,"292910",3,17,4,13,6,11,0,0,0,0,0,17,4,13,6,11,16,9.09043909442868,9.9560800026553,0.373168960741474,31
"6403","BA","São Felipe",21080,8870.08,29020,"Santo Antônio de Jesus",2,"Nordeste",0,"292910",4,16,3,13,9,7,0,0,0,0,0,16,3,13,9,7,12,9.09043909442868,9.9560800026553,0.413293170252627,30
"6404","BA","São Felipe",21080,8870.08,29020,"Santo Antônio de Jesus",2,"Nordeste",0,"292910",5,25,3,22,13,12,0,0,0,0,0,25,3,22,13,12,9,9.09043909442868,9.9560800026553,0.39301106355965,31
"6405","BA","São Francisco do Conde",40245,225290.31,29021,"Salvador",2,"Nordeste",1,"292920",2,38,7,31,19,19,0,0,0,0,0,38,7,31,19,19,12,12.3251451161745,10.6027410515278,0.301174878567431,29
"6406","BA","São Francisco do Conde",40245,225290.31,29021,"Salvador",2,"Nordeste",1,"292920",3,39,8,31,12,27,0,0,0,0,0,39,8,31,12,27,13,12.3251451161745,10.6027410515278,0.385776278730224,31
"6407","BA","São Francisco do Conde",40245,225290.31,29021,"Salvador",2,"Nordeste",1,"292920",4,39,14,25,16,23,2,0,2,0,2,41,14,27,16,25,16,12.3251451161745,10.6027410515278,0.434630691477594,30
"6408","BA","São Francisco do Conde",40245,225290.31,29021,"Salvador",2,"Nordeste",1,"292920",5,36,13,23,5,31,0,0,0,0,0,36,13,23,5,31,24,12.3251451161745,10.6027410515278,0.443410857663133,31
"6409","BA","São Gabriel",18789,6153.82,29009,"Irecê",2,"Nordeste",0,"292925",2,16,4,12,7,9,0,0,0,0,0,16,4,12,7,9,5,8.72482830618545,9.84102687119352,0.292735026445383,29
"6410","BA","São Gabriel",18789,6153.82,29009,"Irecê",2,"Nordeste",0,"292925",3,10,4,6,3,7,1,1,0,0,1,11,5,6,3,8,11,8.72482830618545,9.84102687119352,0.381794420174755,31
"6411","BA","São Gabriel",18789,6153.82,29009,"Irecê",2,"Nordeste",0,"292925",4,25,11,14,11,14,2,1,1,2,0,27,12,15,13,14,10,8.72482830618545,9.84102687119352,0.433713988519782,30
"6412","BA","São Gabriel",18789,6153.82,29009,"Irecê",2,"Nordeste",0,"292925",5,18,3,15,7,11,0,0,0,0,0,18,3,15,7,11,15,8.72482830618545,9.84102687119352,0.394621222898938,31
"6413","BA","São Gonçalo dos Campos",37942,27516.55,29012,"Feira de Santana",2,"Nordeste",0,"292930",2,18,8,10,9,9,0,0,0,0,0,18,8,10,9,9,16,10.2225429208165,10.5438139569125,0.278140117900092,29
"6414","BA","São Gonçalo dos Campos",37942,27516.55,29012,"Feira de Santana",2,"Nordeste",0,"292930",3,24,9,15,9,15,1,0,1,1,0,25,9,16,10,15,20,10.2225429208165,10.5438139569125,0.381378139742122,31
"6415","BA","São Gonçalo dos Campos",37942,27516.55,29012,"Feira de Santana",2,"Nordeste",0,"292930",4,16,4,12,8,8,0,0,0,0,0,16,4,12,8,8,25,10.2225429208165,10.5438139569125,0.421618725215899,30
"6416","BA","São Gonçalo dos Campos",37942,27516.55,29012,"Feira de Santana",2,"Nordeste",0,"292930",5,33,10,23,14,19,1,1,0,1,0,34,11,23,15,19,18,10.2225429208165,10.5438139569125,0.405304303806538,31
"6417","BA","São José do Jacuípe",10505,8366.76,29010,"Jacobina",2,"Nordeste",0,"292937",2,15,6,9,10,5,0,0,0,0,0,15,6,9,10,5,5,9.03202199176803,9.2596066132791,0.257016887216879,29
"6418","BA","São José do Jacuípe",10505,8366.76,29010,"Jacobina",2,"Nordeste",0,"292937",3,14,5,9,4,10,0,0,0,0,0,14,5,9,4,10,2,9.03202199176803,9.2596066132791,0.346394872550506,31
"6419","BA","São José do Jacuípe",10505,8366.76,29010,"Jacobina",2,"Nordeste",0,"292937",4,10,4,6,3,7,0,0,0,0,0,10,4,6,3,7,7,9.03202199176803,9.2596066132791,0.358418205341424,30
"6420","BA","São José do Jacuípe",10505,8366.76,29010,"Jacobina",2,"Nordeste",0,"292937",5,12,8,4,7,5,0,0,0,0,0,12,8,4,7,5,3,9.03202199176803,9.2596066132791,0.376541467532041,31
"6421","BA","São Miguel das Matas",11704,11426.85,29024,"Jequié",2,"Nordeste",0,"292940",2,6,3,3,3,3,0,0,0,0,0,6,3,3,3,3,7,9.34372112825562,9.36768594269996,0.274109626632476,29
"6422","BA","São Miguel das Matas",11704,11426.85,29024,"Jequié",2,"Nordeste",0,"292940",3,7,2,5,4,3,0,0,0,0,0,7,2,5,4,3,7,9.34372112825562,9.36768594269996,0.363400244811853,31
"6423","BA","São Miguel das Matas",11704,11426.85,29024,"Jequié",2,"Nordeste",0,"292940",4,6,4,2,3,3,0,0,0,0,0,6,4,2,3,3,7,9.34372112825562,9.36768594269996,0.38897217154876,30
"6424","BA","São Miguel das Matas",11704,11426.85,29024,"Jequié",2,"Nordeste",0,"292940",5,14,6,8,5,9,0,0,0,0,0,14,6,8,5,9,7,9.34372112825562,9.36768594269996,0.427564771775767,31
"6425","BA","São Sebastião do Passé",44430,14504.51,29019,"Catu",2,"Nordeste",1,"292950",2,29,13,16,11,18,2,0,2,1,1,31,13,18,12,19,20,9.58221491453023,10.70167019593,0.282675952590411,29
"6426","BA","São Sebastião do Passé",44430,14504.51,29019,"Catu",2,"Nordeste",1,"292950",3,27,7,20,9,18,4,1,3,1,3,31,8,23,10,21,19,9.58221491453023,10.70167019593,0.365632305871009,31
"6427","BA","São Sebastião do Passé",44430,14504.51,29019,"Catu",2,"Nordeste",1,"292950",4,34,9,25,12,22,0,0,0,0,0,34,9,25,12,22,28,9.58221491453023,10.70167019593,0.42034344725606,30
"6428","BA","São Sebastião do Passé",44430,14504.51,29019,"Catu",2,"Nordeste",1,"292950",5,20,5,15,6,14,0,0,0,0,0,20,5,15,6,14,27,9.58221491453023,10.70167019593,0.436093325180297,31
"6429","BA","Sapeaçu",17409,9473.63,29020,"Santo Antônio de Jesus",2,"Nordeste",0,"292960",2,13,1,12,5,8,0,0,0,0,0,13,1,12,5,8,6,9.15626742846731,9.76474259285872,0.303841054779,29
"6430","BA","Sapeaçu",17409,9473.63,29020,"Santo Antônio de Jesus",2,"Nordeste",0,"292960",3,18,4,14,6,12,0,0,0,0,0,18,4,14,6,12,7,9.15626742846731,9.76474259285872,0.394143838820183,31
"6431","BA","Sapeaçu",17409,9473.63,29020,"Santo Antônio de Jesus",2,"Nordeste",0,"292960",4,19,6,13,6,13,0,0,0,0,0,19,6,13,6,13,12,9.15626742846731,9.76474259285872,0.437958229933956,30
"6432","BA","Sapeaçu",17409,9473.63,29020,"Santo Antônio de Jesus",2,"Nordeste",0,"292960",5,11,3,8,2,9,0,0,0,0,0,11,3,8,2,9,12,9.15626742846731,9.76474259285872,0.441582263100334,31
"6433","BA","Sátiro Dias",17302,10517.96,29017,"Alagoinhas",2,"Nordeste",0,"292970",2,11,5,6,6,5,0,0,0,0,0,11,5,6,6,5,12,9.26083955113768,9.75857738074032,0.316495549546026,29
"6434","BA","Sátiro Dias",17302,10517.96,29017,"Alagoinhas",2,"Nordeste",0,"292970",3,13,6,7,7,6,0,0,0,0,0,13,6,7,7,6,19,9.26083955113768,9.75857738074032,0.410856679898692,31
"6435","BA","Sátiro Dias",17302,10517.96,29017,"Alagoinhas",2,"Nordeste",0,"292970",4,14,5,9,4,10,0,0,0,0,0,14,5,9,4,10,7,9.26083955113768,9.75857738074032,0.427991971411962,30
"6436","BA","Sátiro Dias",17302,10517.96,29017,"Alagoinhas",2,"Nordeste",0,"292970",5,13,7,6,4,9,0,0,0,0,0,13,7,6,4,9,10,9.26083955113768,9.75857738074032,0.4521750149507,31
"6437","BA","Saubara",12105,11133.59,29020,"Santo Antônio de Jesus",2,"Nordeste",0,"292975",2,8,5,3,4,4,0,0,0,0,0,8,5,3,4,4,6,9.31772194392316,9.40137386937216,0.303646806936455,29
"6438","BA","Saubara",12105,11133.59,29020,"Santo Antônio de Jesus",2,"Nordeste",0,"292975",3,6,2,4,4,2,0,0,0,0,0,6,2,4,4,2,9,9.31772194392316,9.40137386937216,0.382913626080015,31
"6439","BA","Saubara",12105,11133.59,29020,"Santo Antônio de Jesus",2,"Nordeste",0,"292975",4,8,1,7,4,4,1,0,1,0,1,9,1,8,4,5,8,9.31772194392316,9.40137386937216,0.424144118641208,30
"6440","BA","Saubara",12105,11133.59,29020,"Santo Antônio de Jesus",2,"Nordeste",0,"292975",5,7,1,6,1,6,1,0,1,0,1,8,1,7,1,7,9,9.31772194392316,9.40137386937216,0.450287159597905,31
"6441","BA","Saúde",12943,6536.81,29010,"Jacobina",2,"Nordeste",0,"292980",2,6,2,4,2,4,0,0,0,0,0,6,2,4,2,4,5,8.78520455786984,9.46831038044244,0.272709085281049,29
"6442","BA","Saúde",12943,6536.81,29010,"Jacobina",2,"Nordeste",0,"292980",3,4,3,1,2,2,0,0,0,0,0,4,3,1,2,2,8,8.78520455786984,9.46831038044244,0.351282072613549,31
"6443","BA","Saúde",12943,6536.81,29010,"Jacobina",2,"Nordeste",0,"292980",4,3,1,2,1,2,0,0,0,0,0,3,1,2,1,2,7,8.78520455786984,9.46831038044244,0.389202465399481,30
"6444","BA","Saúde",12943,6536.81,29010,"Jacobina",2,"Nordeste",0,"292980",5,5,2,3,3,2,0,0,0,0,0,5,2,3,3,2,5,8.78520455786984,9.46831038044244,0.401069181721878,31
"6445","BA","Seabra",44234,12018.57,29023,"Seabra",2,"Nordeste",0,"292990",2,37,12,25,18,19,0,0,0,0,0,37,12,25,18,19,20,9.39420823262587,10.6972490031287,0.290154840188238,29
"6446","BA","Seabra",44234,12018.57,29023,"Seabra",2,"Nordeste",0,"292990",3,46,8,38,23,23,0,0,0,0,0,46,8,38,23,23,11,9.39420823262587,10.6972490031287,0.376949991345331,31
"6447","BA","Seabra",44234,12018.57,29023,"Seabra",2,"Nordeste",0,"292990",4,9,1,8,3,6,0,0,0,0,0,9,1,8,3,6,24,9.39420823262587,10.6972490031287,0.406661125077017,30
"6448","BA","Seabra",44234,12018.57,29023,"Seabra",2,"Nordeste",0,"292990",5,11,3,8,5,6,0,0,0,0,0,11,3,8,5,6,20,9.39420823262587,10.6972490031287,0.419436501403018,31
"6449","BA","Sebastião Laranjeiras",11512,7000.68,29026,"Guanambi",2,"Nordeste",0,"293000",2,5,1,4,2,3,0,0,0,0,0,5,1,4,2,3,4,8.85376256617653,9.3511452485672,0.292838150275205,29
"6450","BA","Sebastião Laranjeiras",11512,7000.68,29026,"Guanambi",2,"Nordeste",0,"293000",3,5,2,3,2,3,0,0,0,0,0,5,2,3,2,3,4,8.85376256617653,9.3511452485672,0.37554013355234,31
"6451","BA","Sebastião Laranjeiras",11512,7000.68,29026,"Guanambi",2,"Nordeste",0,"293000",4,5,2,3,2,3,0,0,0,0,0,5,2,3,2,3,7,8.85376256617653,9.3511452485672,0.416221654200442,30
"6452","BA","Sebastião Laranjeiras",11512,7000.68,29026,"Guanambi",2,"Nordeste",0,"293000",5,11,3,8,6,5,0,0,0,0,0,11,3,8,6,5,5,8.85376256617653,9.3511452485672,0.405018244274122,31
"6453","BA","Senhor do Bonfim",79424,11114.63,29008,"Senhor do Bonfim",2,"Nordeste",1,"293010",2,62,12,50,21,41,1,1,0,0,1,63,13,50,21,42,52,9.31601753749515,11.2825558685643,0.272743123185719,29
"6454","BA","Senhor do Bonfim",79424,11114.63,29008,"Senhor do Bonfim",2,"Nordeste",1,"293010",3,87,30,57,39,48,0,0,0,0,0,87,30,57,39,48,64,9.31601753749515,11.2825558685643,0.367881666981708,31
"6455","BA","Senhor do Bonfim",79424,11114.63,29008,"Senhor do Bonfim",2,"Nordeste",1,"293010",4,62,14,48,29,33,0,0,0,0,0,62,14,48,29,33,49,9.31601753749515,11.2825558685643,0.40569612024828,30
"6456","BA","Senhor do Bonfim",79424,11114.63,29008,"Senhor do Bonfim",2,"Nordeste",1,"293010",5,79,28,51,33,46,2,1,1,0,2,81,29,52,33,48,52,9.31601753749515,11.2825558685643,0.404803648545382,31
"6457","BA","Serra do Ramalho",31416,8923.97,29007,"Bom Jesus da Lapa",2,"Nordeste",0,"293015",2,23,4,19,11,12,0,0,0,0,0,23,4,19,11,12,14,9.09649619382557,10.3550725962578,0.317691390752488,29
"6458","BA","Serra do Ramalho",31416,8923.97,29007,"Bom Jesus da Lapa",2,"Nordeste",0,"293015",3,30,8,22,12,18,0,0,0,0,0,30,8,22,12,18,16,9.09649619382557,10.3550725962578,0.404202910559688,31
"6459","BA","Serra do Ramalho",31416,8923.97,29007,"Bom Jesus da Lapa",2,"Nordeste",0,"293015",4,38,12,26,18,20,0,0,0,0,0,38,12,26,18,20,14,9.09649619382557,10.3550725962578,0.401990044960842,30
"6460","BA","Serra do Ramalho",31416,8923.97,29007,"Bom Jesus da Lapa",2,"Nordeste",0,"293015",5,48,16,32,28,20,1,1,0,0,1,49,17,32,28,21,12,9.09649619382557,10.3550725962578,0.406052710940923,31
"6461","BA","Sento Sé",40989,22558.77,29004,"Juazeiro",2,"Nordeste",0,"293020",2,51,18,33,31,20,1,0,1,1,0,52,18,34,32,20,9,10.0238791828491,10.6210590170066,0.290824227327481,29
"6462","BA","Sento Sé",40989,22558.77,29004,"Juazeiro",2,"Nordeste",0,"293020",3,30,10,20,13,17,1,0,1,1,0,31,10,21,14,17,16,10.0238791828491,10.6210590170066,0.353679444420606,31
"6463","BA","Sento Sé",40989,22558.77,29004,"Juazeiro",2,"Nordeste",0,"293020",4,29,13,16,16,13,0,0,0,0,0,29,13,16,16,13,9,10.0238791828491,10.6210590170066,0.359263426426584,30
"6464","BA","Sento Sé",40989,22558.77,29004,"Juazeiro",2,"Nordeste",0,"293020",5,31,16,15,19,12,2,2,0,1,1,33,18,15,20,13,19,10.0238791828491,10.6210590170066,0.363807337472638,31
"6465","BA","Serra Dourada",17321,8231.8,29003,"Santa Maria da Vitória",2,"Nordeste",0,"293030",2,2,0,2,1,1,0,0,0,0,0,2,0,2,1,1,6,9.01575998178629,9.75967491717028,0.313572236216053,29
"6466","BA","Serra Dourada",17321,8231.8,29003,"Santa Maria da Vitória",2,"Nordeste",0,"293030",3,2,0,2,0,2,0,0,0,0,0,2,0,2,0,2,4,9.01575998178629,9.75967491717028,0.374474146283022,31
"6467","BA","Serra Dourada",17321,8231.8,29003,"Santa Maria da Vitória",2,"Nordeste",0,"293030",4,7,1,6,2,5,0,0,0,0,0,7,1,6,2,5,6,9.01575998178629,9.75967491717028,0.414139576676379,30
"6468","BA","Serra Dourada",17321,8231.8,29003,"Santa Maria da Vitória",2,"Nordeste",0,"293030",5,5,1,4,4,1,0,0,0,0,0,5,1,4,4,1,4,9.01575998178629,9.75967491717028,0.412826220627224,31
"6469","BA","Serra Preta",14699,7524.19,29012,"Feira de Santana",2,"Nordeste",0,"293040",2,6,2,4,1,5,0,0,0,0,0,6,2,4,1,5,8,8.92587844262733,9.59553474324199,0.286610414206537,29
"6470","BA","Serra Preta",14699,7524.19,29012,"Feira de Santana",2,"Nordeste",0,"293040",3,4,2,2,0,4,0,0,0,0,0,4,2,2,0,4,10,8.92587844262733,9.59553474324199,0.356823612161494,31
"6471","BA","Serra Preta",14699,7524.19,29012,"Feira de Santana",2,"Nordeste",0,"293040",4,4,2,2,2,2,0,0,0,0,0,4,2,2,2,2,10,8.92587844262733,9.59553474324199,0.396238682154101,30
"6472","BA","Serra Preta",14699,7524.19,29012,"Feira de Santana",2,"Nordeste",0,"293040",5,7,2,5,3,4,0,0,0,0,0,7,2,5,3,4,12,8.92587844262733,9.59553474324199,0.375003080087207,31
"6473","BA","Serrinha",81286,10814.03,29016,"Serrinha",2,"Nordeste",1,"293050",2,58,21,37,28,30,0,0,0,0,0,58,21,37,28,30,48,9.28859964411972,11.3057290789855,0.269281577511246,29
"6474","BA","Serrinha",81286,10814.03,29016,"Serrinha",2,"Nordeste",1,"293050",3,52,17,35,18,34,0,0,0,0,0,52,17,35,18,34,50,9.28859964411972,11.3057290789855,0.362300990466497,31
"6475","BA","Serrinha",81286,10814.03,29016,"Serrinha",2,"Nordeste",1,"293050",4,46,20,26,18,28,3,2,1,1,2,49,22,27,19,30,49,9.28859964411972,11.3057290789855,0.411369207804976,30
"6476","BA","Serrinha",81286,10814.03,29016,"Serrinha",2,"Nordeste",1,"293050",5,72,15,57,28,44,3,1,2,0,3,75,16,59,28,47,71,9.28859964411972,11.3057290789855,0.381845638029378,31
"6477","BA","Serrolândia",13446,6977.85,29010,"Jacobina",2,"Nordeste",0,"293060",2,9,2,7,4,5,0,0,0,0,0,9,2,7,4,5,9,8.85049612538498,9.50643694302898,0.267231783336153,29
"6478","BA","Serrolândia",13446,6977.85,29010,"Jacobina",2,"Nordeste",0,"293060",3,9,3,6,6,3,0,0,0,0,0,9,3,6,6,3,13,8.85049612538498,9.50643694302898,0.355781933506918,31
"6479","BA","Serrolândia",13446,6977.85,29010,"Jacobina",2,"Nordeste",0,"293060",4,5,2,3,3,2,0,0,0,0,0,5,2,3,3,2,5,8.85049612538498,9.50643694302898,0.383984805206212,30
"6480","BA","Serrolândia",13446,6977.85,29010,"Jacobina",2,"Nordeste",0,"293060",5,3,1,2,0,3,0,0,0,0,0,3,1,2,0,3,11,8.85049612538498,9.50643694302898,0.381735442329776,31
"6481","BA","Simões Filho",135783,43740.28,29021,"Salvador",2,"Nordeste",1,"293070",2,112,42,70,49,63,1,0,1,0,1,113,42,71,49,64,60,10.6860246956735,11.8188133021763,0.284434375382918,29
"6482","BA","Simões Filho",135783,43740.28,29021,"Salvador",2,"Nordeste",1,"293070",3,92,32,60,40,52,3,1,2,2,1,95,33,62,42,53,84,10.6860246956735,11.8188133021763,0.380157371996384,31
"6483","BA","Simões Filho",135783,43740.28,29021,"Salvador",2,"Nordeste",1,"293070",4,114,41,73,47,67,0,0,0,0,0,114,41,73,47,67,77,10.6860246956735,11.8188133021763,0.443478162008715,30
"6484","BA","Simões Filho",135783,43740.28,29021,"Salvador",2,"Nordeste",1,"293070",5,123,34,89,48,75,1,1,0,1,0,124,35,89,49,75,79,10.6860246956735,11.8188133021763,0.421683365498993,31
"6485","BA","Sítio do Mato",13059,7305.55,29007,"Bom Jesus da Lapa",2,"Nordeste",0,"293075",2,16,4,12,8,8,0,0,0,0,0,16,4,12,8,8,10,8.89638961224723,9.47723283022041,0.339088427688421,29
"6486","BA","Sítio do Mato",13059,7305.55,29007,"Bom Jesus da Lapa",2,"Nordeste",0,"293075",3,13,3,10,8,5,0,0,0,0,0,13,3,10,8,5,6,8.89638961224723,9.47723283022041,0.397267349388973,31
"6487","BA","Sítio do Mato",13059,7305.55,29007,"Bom Jesus da Lapa",2,"Nordeste",0,"293075",4,7,1,6,4,3,0,0,0,0,0,7,1,6,4,3,6,8.89638961224723,9.47723283022041,0.415173624018634,30
"6488","BA","Sítio do Mato",13059,7305.55,29007,"Bom Jesus da Lapa",2,"Nordeste",0,"293075",5,13,5,8,3,10,0,0,0,0,0,13,5,8,3,10,1,8.89638961224723,9.47723283022041,0.404288165452646,31
"6489","BA","Sítio do Quinto",9701,7430.46,29013,"Jeremoabo",2,"Nordeste",0,"293076",2,9,6,3,3,6,0,0,0,0,0,9,6,3,3,6,5,8.91334304696632,9.17998425196128,0.292658853356493,29
"6490","BA","Sítio do Quinto",9701,7430.46,29013,"Jeremoabo",2,"Nordeste",0,"293076",3,5,1,4,2,3,0,0,0,0,0,5,1,4,2,3,7,8.91334304696632,9.17998425196128,0.383654702567817,31
"6491","BA","Sítio do Quinto",9701,7430.46,29013,"Jeremoabo",2,"Nordeste",0,"293076",4,11,4,7,6,5,0,0,0,0,0,11,4,7,6,5,11,8.91334304696632,9.17998425196128,0.398846651896867,30
"6492","BA","Sítio do Quinto",9701,7430.46,29013,"Jeremoabo",2,"Nordeste",0,"293076",5,16,5,11,6,10,0,0,0,0,0,16,5,11,6,10,3,8.91334304696632,9.17998425196128,0.404976813554622,31
"6493","BA","Sobradinho",23233,30335.78,29004,"Juazeiro",2,"Nordeste",1,"293077",2,32,11,21,15,17,1,1,0,0,1,33,12,21,15,18,14,10.3200831529187,10.0533289607753,0.293683750774807,29
"6494","BA","Sobradinho",23233,30335.78,29004,"Juazeiro",2,"Nordeste",1,"293077",3,29,10,19,17,12,1,1,0,0,1,30,11,19,17,13,20,10.3200831529187,10.0533289607753,0.370825206918213,31
"6495","BA","Sobradinho",23233,30335.78,29004,"Juazeiro",2,"Nordeste",1,"293077",4,31,11,20,13,18,1,0,1,1,0,32,11,21,14,18,10,10.3200831529187,10.0533289607753,0.390773639226096,30
"6496","BA","Sobradinho",23233,30335.78,29004,"Juazeiro",2,"Nordeste",1,"293077",5,31,18,13,9,22,0,0,0,0,0,31,18,13,9,22,15,10.3200831529187,10.0533289607753,0.387406002743944,31
"6497","BA","Souto Soares",17050,6873.05,29009,"Irecê",2,"Nordeste",0,"293080",2,11,2,9,5,6,1,0,1,0,1,12,2,10,5,7,6,8.83536324593874,9.74390548271166,0.310445158583797,29
"6498","BA","Souto Soares",17050,6873.05,29009,"Irecê",2,"Nordeste",0,"293080",3,11,5,6,4,7,0,0,0,0,0,11,5,6,4,7,12,8.83536324593874,9.74390548271166,0.411274991790551,31
"6499","BA","Souto Soares",17050,6873.05,29009,"Irecê",2,"Nordeste",0,"293080",4,4,0,4,1,3,0,0,0,0,0,4,0,4,1,3,5,8.83536324593874,9.74390548271166,0.443658224591495,30
"6500","BA","Souto Soares",17050,6873.05,29009,"Irecê",2,"Nordeste",0,"293080",5,1,1,0,0,1,0,0,0,0,0,1,1,0,0,1,16,8.83536324593874,9.74390548271166,0.425043673469209,31
"6501","BA","Tabocas do Brejo Velho",12516,12079.3,29002,"Cotegipe",2,"Nordeste",0,"293090",2,8,2,6,5,3,0,0,0,0,0,8,2,6,5,3,2,9.39924852278994,9.43476310478877,0.278808095043349,29
"6502","BA","Tabocas do Brejo Velho",12516,12079.3,29002,"Cotegipe",2,"Nordeste",0,"293090",3,7,1,6,2,5,0,0,0,0,0,7,1,6,2,5,5,9.39924852278994,9.43476310478877,0.341912033753428,31
"6503","BA","Tabocas do Brejo Velho",12516,12079.3,29002,"Cotegipe",2,"Nordeste",0,"293090",4,9,1,8,3,6,0,0,0,0,0,9,1,8,3,6,2,9.39924852278994,9.43476310478877,0.360040076917155,30
"6504","BA","Tabocas do Brejo Velho",12516,12079.3,29002,"Cotegipe",2,"Nordeste",0,"293090",5,16,2,14,5,11,0,0,0,0,0,16,2,14,5,11,7,9.39924852278994,9.43476310478877,0.359663006939532,31
"6505","BA","Tanhaçu",20393,8991.6,29027,"Brumado",2,"Nordeste",0,"293100",2,22,10,12,10,12,0,0,0,0,0,22,10,12,10,12,11,9.10404608715826,9.92294698369235,0.284610238927434,29
"6506","BA","Tanhaçu",20393,8991.6,29027,"Brumado",2,"Nordeste",0,"293100",3,16,5,11,5,11,1,0,1,0,1,17,5,12,5,12,13,9.10404608715826,9.92294698369235,0.349363467461189,31
"6507","BA","Tanhaçu",20393,8991.6,29027,"Brumado",2,"Nordeste",0,"293100",4,18,6,12,5,13,0,0,0,0,0,18,6,12,5,13,15,9.10404608715826,9.92294698369235,0.387949449212441,30
"6508","BA","Tanhaçu",20393,8991.6,29027,"Brumado",2,"Nordeste",0,"293100",5,16,7,9,5,11,1,1,0,0,1,17,8,9,5,12,13,9.10404608715826,9.92294698369235,0.374134428846633,31
"6509","BA","Tanque Novo",17443,9531.18,29022,"Boquira",2,"Nordeste",0,"293105",2,18,8,10,6,12,0,0,0,0,0,18,8,10,6,12,3,9.16232380850056,9.76669370101813,0.252581090369074,29
"6510","BA","Tanque Novo",17443,9531.18,29022,"Boquira",2,"Nordeste",0,"293105",3,11,1,10,4,7,0,0,0,0,0,11,1,10,4,7,8,9.16232380850056,9.76669370101813,0.327148380553889,31
"6511","BA","Tanque Novo",17443,9531.18,29022,"Boquira",2,"Nordeste",0,"293105",4,13,3,10,2,11,0,0,0,0,0,13,3,10,2,11,6,9.16232380850056,9.76669370101813,0.369524789320396,30
"6512","BA","Tanque Novo",17443,9531.18,29022,"Boquira",2,"Nordeste",0,"293105",5,13,2,11,1,12,0,0,0,0,0,13,2,11,1,12,6,9.16232380850056,9.76669370101813,0.362860998966256,31
"6513","BA","Tanquinho",7928,6797.37,29012,"Feira de Santana",2,"Nordeste",0,"293110",2,6,0,6,2,4,0,0,0,0,0,6,0,6,2,4,9,8.82429105164556,8.97815607600982,0.26215509601505,29
"6514","BA","Tanquinho",7928,6797.37,29012,"Feira de Santana",2,"Nordeste",0,"293110",3,1,0,1,0,1,0,0,0,0,0,1,0,1,0,1,10,8.82429105164556,8.97815607600982,0.342199376939088,31
"6515","BA","Tanquinho",7928,6797.37,29012,"Feira de Santana",2,"Nordeste",0,"293110",4,4,1,3,2,2,0,0,0,0,0,4,1,3,2,2,8,8.82429105164556,8.97815607600982,0.36647604363435,30
"6516","BA","Tanquinho",7928,6797.37,29012,"Feira de Santana",2,"Nordeste",0,"293110",5,1,1,0,0,1,0,0,0,0,0,1,1,0,0,1,4,8.82429105164556,8.97815607600982,0.361954351794113,31
"6517","BA","Taperoá",21253,8030.32,29030,"Valença",2,"Nordeste",0,"293120",2,14,6,8,5,9,1,0,1,1,0,15,6,9,6,9,5,8.99097965670719,9.96425334085869,0.278557702170167,29
"6518","BA","Taperoá",21253,8030.32,29030,"Valença",2,"Nordeste",0,"293120",3,7,5,2,3,4,0,0,0,0,0,7,5,2,3,4,7,8.99097965670719,9.96425334085869,0.369035932310463,31
"6519","BA","Taperoá",21253,8030.32,29030,"Valença",2,"Nordeste",0,"293120",4,14,4,10,6,8,0,0,0,0,0,14,4,10,6,8,14,8.99097965670719,9.96425334085869,0.422170003362795,30
"6520","BA","Taperoá",21253,8030.32,29030,"Valença",2,"Nordeste",0,"293120",5,25,10,15,14,11,0,0,0,0,0,25,10,15,14,11,9,8.99097965670719,9.96425334085869,0.422540688854,31
"6521","BA","Tapiramutá",16974,6432.6,29011,"Itaberaba",2,"Nordeste",0,"293130",2,5,1,4,1,4,0,0,0,0,0,5,1,4,1,4,5,8.76913409009025,9.73943804052962,0.284621656286947,29
"6522","BA","Tapiramutá",16974,6432.6,29011,"Itaberaba",2,"Nordeste",0,"293130",3,6,3,3,1,5,0,0,0,0,0,6,3,3,1,5,8,8.76913409009025,9.73943804052962,0.36436925917151,31
"6523","BA","Tapiramutá",16974,6432.6,29011,"Itaberaba",2,"Nordeste",0,"293130",4,7,5,2,4,3,0,0,0,0,0,7,5,2,4,3,5,8.76913409009025,9.73943804052962,0.38619696233589,30
"6524","BA","Tapiramutá",16974,6432.6,29011,"Itaberaba",2,"Nordeste",0,"293130",5,3,0,3,1,2,0,0,0,0,0,3,0,3,1,2,3,8.76913409009025,9.73943804052962,0.375143011787061,31
"6525","BA","Teixeira de Freitas",162438,16319.99,29032,"Porto Seguro",2,"Nordeste",1,"293135",2,173,44,129,70,103,2,2,0,1,1,175,46,129,71,104,83,9.70014601577281,11.9980516694861,0.288381128010263,29
"6526","BA","Teixeira de Freitas",162438,16319.99,29032,"Porto Seguro",2,"Nordeste",1,"293135",3,167,44,123,69,98,1,1,0,0,1,168,45,123,69,99,87,9.70014601577281,11.9980516694861,0.369642489130394,31
"6527","BA","Teixeira de Freitas",162438,16319.99,29032,"Porto Seguro",2,"Nordeste",1,"293135",4,182,57,125,68,114,0,0,0,0,0,182,57,125,68,114,76,9.70014601577281,11.9980516694861,0.386787010802989,30
"6528","BA","Teixeira de Freitas",162438,16319.99,29032,"Porto Seguro",2,"Nordeste",1,"293135",5,223,68,155,101,122,0,0,0,0,0,223,68,155,101,122,92,9.70014601577281,11.9980516694861,0.369828467227005,31
"6529","BA","Teodoro Sampaio",7359,9684.91,29012,"Feira de Santana",2,"Nordeste",0,"293140",2,5,1,4,1,4,1,0,1,1,0,6,1,5,2,4,4,9.17832428307722,8.9036793329266,0.298286635955666,29
"6530","BA","Teodoro Sampaio",7359,9684.91,29012,"Feira de Santana",2,"Nordeste",0,"293140",3,1,0,1,0,1,0,0,0,0,0,1,0,1,0,1,7,9.17832428307722,8.9036793329266,0.381786433672545,31
"6531","BA","Teodoro Sampaio",7359,9684.91,29012,"Feira de Santana",2,"Nordeste",0,"293140",4,3,2,1,0,3,0,0,0,0,0,3,2,1,0,3,3,9.17832428307722,8.9036793329266,0.416534881834375,30
"6532","BA","Teodoro Sampaio",7359,9684.91,29012,"Feira de Santana",2,"Nordeste",0,"293140",5,6,3,3,1,5,0,0,0,0,0,6,3,3,1,5,5,9.17832428307722,8.9036793329266,0.406238167984096,31
"6533","BA","Teofilândia",22555,7038.51,29016,"Serrinha",2,"Nordeste",0,"293150",2,12,4,8,5,7,0,0,0,0,0,12,4,8,5,7,8,8.85915177902428,10.0237120498425,0.281983038044026,29
"6534","BA","Teofilândia",22555,7038.51,29016,"Serrinha",2,"Nordeste",0,"293150",3,19,5,14,7,12,0,0,0,0,0,19,5,14,7,12,12,8.85915177902428,10.0237120498425,0.39288703287621,31
"6535","BA","Teofilândia",22555,7038.51,29016,"Serrinha",2,"Nordeste",0,"293150",4,12,5,7,6,6,0,0,0,0,0,12,5,7,6,6,9,8.85915177902428,10.0237120498425,0.431589418308322,30
"6536","BA","Teofilândia",22555,7038.51,29016,"Serrinha",2,"Nordeste",0,"293150",5,15,8,7,10,5,0,0,0,0,0,15,8,7,10,5,8,8.85915177902428,10.0237120498425,0.425929140745027,31
"6537","BA","Teolândia",15022,11399.35,29031,"Ilhéus-Itabuna",2,"Nordeste",0,"293160",2,11,4,7,5,6,0,0,0,0,0,11,4,7,5,6,5,9.34131161521316,9.61727107224596,0.264131120550711,29
"6538","BA","Teolândia",15022,11399.35,29031,"Ilhéus-Itabuna",2,"Nordeste",0,"293160",3,8,3,5,4,4,0,0,0,0,0,8,3,5,4,4,6,9.34131161521316,9.61727107224596,0.367301776837964,31
"6539","BA","Teolândia",15022,11399.35,29031,"Ilhéus-Itabuna",2,"Nordeste",0,"293160",4,17,7,10,7,10,0,0,0,0,0,17,7,10,7,10,3,9.34131161521316,9.61727107224596,0.371514850082081,30
"6540","BA","Teolândia",15022,11399.35,29031,"Ilhéus-Itabuna",2,"Nordeste",0,"293160",5,14,3,11,8,6,0,0,0,0,0,14,3,11,8,6,5,9.34131161521316,9.61727107224596,0.416722184813092,31
"6541","BA","Terra Nova",13025,8907.66,29019,"Catu",2,"Nordeste",0,"293170",2,7,3,4,4,3,1,0,1,1,0,8,3,5,5,3,2,9.09466685970991,9.47462586662157,0.289860235680557,29
"6542","BA","Terra Nova",13025,8907.66,29019,"Catu",2,"Nordeste",0,"293170",3,11,5,6,4,7,0,0,0,0,0,11,5,6,4,7,7,9.09466685970991,9.47462586662157,0.374493311517954,31
"6543","BA","Terra Nova",13025,8907.66,29019,"Catu",2,"Nordeste",0,"293170",4,7,6,1,4,3,0,0,0,0,0,7,6,1,4,3,6,9.09466685970991,9.47462586662157,0.405852871909443,30
"6544","BA","Terra Nova",13025,8907.66,29019,"Catu",2,"Nordeste",0,"293170",5,9,3,6,2,7,0,0,0,0,0,9,3,6,2,7,7,9.09466685970991,9.47462586662157,0.404567640684097,31
"6545","BA","Tremedal",16189,6818.22,29027,"Brumado",2,"Nordeste",0,"293180",2,8,5,3,1,7,1,0,1,0,1,9,5,4,1,8,6,8.8273537197044,9.69208727824151,0.281092365151592,29
"6546","BA","Tremedal",16189,6818.22,29027,"Brumado",2,"Nordeste",0,"293180",3,15,8,7,6,9,1,0,1,1,0,16,8,8,7,9,14,8.8273537197044,9.69208727824151,0.355720872567719,31
"6547","BA","Tremedal",16189,6818.22,29027,"Brumado",2,"Nordeste",0,"293180",4,15,4,11,5,10,0,0,0,0,0,15,4,11,5,10,16,8.8273537197044,9.69208727824151,0.372861090414886,30
"6548","BA","Tremedal",16189,6818.22,29027,"Brumado",2,"Nordeste",0,"293180",5,10,1,9,3,7,0,0,0,0,0,10,1,9,3,7,15,8.8273537197044,9.69208727824151,0.413495128566087,31
"6549","BA","Tucano",50798,8924.09,29014,"Euclides da Cunha",2,"Nordeste",0,"293190",2,33,10,23,16,17,0,0,0,0,0,33,10,23,16,17,18,9.09650964066517,10.8356122627128,0.29064623664158,29
"6550","BA","Tucano",50798,8924.09,29014,"Euclides da Cunha",2,"Nordeste",0,"293190",3,29,12,17,11,18,0,0,0,0,0,29,12,17,11,18,17,9.09650964066517,10.8356122627128,0.38168034661271,31
"6551","BA","Tucano",50798,8924.09,29014,"Euclides da Cunha",2,"Nordeste",0,"293190",4,36,14,22,17,19,1,1,0,0,1,37,15,22,17,20,14,9.09650964066517,10.8356122627128,0.412008176715723,30
"6552","BA","Tucano",50798,8924.09,29014,"Euclides da Cunha",2,"Nordeste",0,"293190",5,59,21,38,26,33,1,1,0,0,1,60,22,38,26,34,22,9.09650964066517,10.8356122627128,0.417058818949001,31
"6553","BA","Uauá",24113,7922.56,29014,"Euclides da Cunha",2,"Nordeste",0,"293200",2,26,5,21,11,15,0,0,0,0,0,26,5,21,11,15,16,8.97746966490339,10.0905063931317,0.283784420209825,29
"6554","BA","Uauá",24113,7922.56,29014,"Euclides da Cunha",2,"Nordeste",0,"293200",3,19,5,14,8,11,0,0,0,0,0,19,5,14,8,11,12,8.97746966490339,10.0905063931317,0.379966804515816,31
"6555","BA","Uauá",24113,7922.56,29014,"Euclides da Cunha",2,"Nordeste",0,"293200",4,19,7,12,12,7,1,1,0,1,0,20,8,12,13,7,12,8.97746966490339,10.0905063931317,0.422703411144312,30
"6556","BA","Uauá",24113,7922.56,29014,"Euclides da Cunha",2,"Nordeste",0,"293200",5,24,7,17,17,7,0,0,0,0,0,24,7,17,17,7,12,8.97746966490339,10.0905063931317,0.419037607179143,31
"6557","BA","Ubaíra",19877,8477.56,29024,"Jequié",2,"Nordeste",0,"293210",2,11,3,8,3,8,0,0,0,0,0,11,3,8,3,8,13,9.04517795153299,9.8973185633906,0.27223584760817,29
"6558","BA","Ubaíra",19877,8477.56,29024,"Jequié",2,"Nordeste",0,"293210",3,17,6,11,9,8,1,1,0,1,0,18,7,11,10,8,14,9.04517795153299,9.8973185633906,0.364340698051587,31
"6559","BA","Ubaíra",19877,8477.56,29024,"Jequié",2,"Nordeste",0,"293210",4,7,1,6,5,2,0,0,0,0,0,7,1,6,5,2,9,9.04517795153299,9.8973185633906,0.376843399236644,30
"6560","BA","Ubaíra",19877,8477.56,29024,"Jequié",2,"Nordeste",0,"293210",5,9,2,7,4,5,2,1,1,1,1,11,3,8,5,6,14,9.04517795153299,9.8973185633906,0.392030195636568,31
"6561","BA","Ubaitaba",18847,11008.54,29031,"Ilhéus-Itabuna",2,"Nordeste",0,"293220",2,17,7,10,12,5,0,0,0,0,0,17,7,10,12,5,11,9.30642661420251,9.84410902901663,0.275403739226967,29
"6562","BA","Ubaitaba",18847,11008.54,29031,"Ilhéus-Itabuna",2,"Nordeste",0,"293220",3,19,6,13,10,9,0,0,0,0,0,19,6,13,10,9,9,9.30642661420251,9.84410902901663,0.371102206980146,31
"6563","BA","Ubaitaba",18847,11008.54,29031,"Ilhéus-Itabuna",2,"Nordeste",0,"293220",4,16,6,10,5,11,1,1,0,1,0,17,7,10,6,11,7,9.30642661420251,9.84410902901663,0.389344662379905,30
"6564","BA","Ubaitaba",18847,11008.54,29031,"Ilhéus-Itabuna",2,"Nordeste",0,"293220",5,20,8,12,16,4,0,0,0,0,0,20,8,12,16,4,13,9.30642661420251,9.84410902901663,0.400570524473127,31
"6565","BA","Ubatã",27263,7204.87,29031,"Ilhéus-Itabuna",2,"Nordeste",0,"293230",2,14,7,7,8,6,0,0,0,0,0,14,7,7,8,6,7,8.88251246524517,10.2132857505526,0.282087004413778,29
"6566","BA","Ubatã",27263,7204.87,29031,"Ilhéus-Itabuna",2,"Nordeste",0,"293230",3,13,5,8,5,8,0,0,0,0,0,13,5,8,5,8,13,8.88251246524517,10.2132857505526,0.370968945688149,31
"6567","BA","Ubatã",27263,7204.87,29031,"Ilhéus-Itabuna",2,"Nordeste",0,"293230",4,14,4,10,8,6,0,0,0,0,0,14,4,10,8,6,8,8.88251246524517,10.2132857505526,0.41535308606986,30
"6568","BA","Ubatã",27263,7204.87,29031,"Ilhéus-Itabuna",2,"Nordeste",0,"293230",5,17,5,12,9,8,0,0,0,0,0,17,5,12,9,8,21,8.88251246524517,10.2132857505526,0.386499735527984,31
"6569","BA","Uibaí",13891,6406.49,29009,"Irecê",2,"Nordeste",0,"293240",2,8,2,6,0,8,0,0,0,0,0,8,2,6,0,8,8,8.76506681803372,9.53899642739739,0.303668691792954,29
"6570","BA","Uibaí",13891,6406.49,29009,"Irecê",2,"Nordeste",0,"293240",3,11,5,6,7,4,0,0,0,0,0,11,5,6,7,4,7,8.76506681803372,9.53899642739739,0.389016055447144,31
"6571","BA","Uibaí",13891,6406.49,29009,"Irecê",2,"Nordeste",0,"293240",4,11,3,8,5,6,0,0,0,0,0,11,3,8,5,6,14,8.76506681803372,9.53899642739739,0.437209765041925,30
"6572","BA","Uibaí",13891,6406.49,29009,"Irecê",2,"Nordeste",0,"293240",5,14,5,9,6,8,0,0,0,0,0,14,5,9,6,8,8,8.76506681803372,9.53899642739739,0.414292364321058,31
"6573","BA","Umburanas",19402,7899.7,29008,"Senhor do Bonfim",2,"Nordeste",0,"293245",2,18,9,9,11,7,0,0,0,0,0,18,9,9,11,7,5,8.97458006305051,9.87313143252123,0.258624994446629,29
"6574","BA","Umburanas",19402,7899.7,29008,"Senhor do Bonfim",2,"Nordeste",0,"293245",3,11,3,8,6,5,0,0,0,0,0,11,3,8,6,5,3,8.97458006305051,9.87313143252123,0.328981306521296,31
"6575","BA","Umburanas",19402,7899.7,29008,"Senhor do Bonfim",2,"Nordeste",0,"293245",4,7,4,3,5,2,0,0,0,0,0,7,4,3,5,2,7,8.97458006305051,9.87313143252123,0.359385770287678,30
"6576","BA","Umburanas",19402,7899.7,29008,"Senhor do Bonfim",2,"Nordeste",0,"293245",5,11,2,9,8,3,0,0,0,0,0,11,2,9,8,3,4,8.97458006305051,9.87313143252123,0.39608100738819,31
"6577","BA","Una",18544,13415.79,29031,"Ilhéus-Itabuna",2,"Nordeste",0,"293250",2,17,4,13,11,6,1,0,1,0,1,18,4,14,11,7,4,9.50418765042884,9.82790156557953,0.315403310387796,29
"6578","BA","Una",18544,13415.79,29031,"Ilhéus-Itabuna",2,"Nordeste",0,"293250",3,20,8,12,7,13,0,0,0,0,0,20,8,12,7,13,8,9.50418765042884,9.82790156557953,0.390035988668119,31
"6579","BA","Una",18544,13415.79,29031,"Ilhéus-Itabuna",2,"Nordeste",0,"293250",4,18,6,12,11,7,0,0,0,0,0,18,6,12,11,7,11,9.50418765042884,9.82790156557953,0.402457343970018,30
"6580","BA","Una",18544,13415.79,29031,"Ilhéus-Itabuna",2,"Nordeste",0,"293250",5,23,12,11,13,10,1,1,0,0,1,24,13,11,13,11,12,9.50418765042884,9.82790156557953,0.390389083165138,31
"6581","BA","Urandi",16665,9687,29026,"Guanambi",2,"Nordeste",0,"293260",2,5,1,4,3,2,0,0,0,0,0,5,1,4,3,2,6,9.17854005942639,9.72106599074184,0.298114198135375,29
"6582","BA","Urandi",16665,9687,29026,"Guanambi",2,"Nordeste",0,"293260",3,2,0,2,1,1,1,1,0,0,1,3,1,2,1,2,10,9.17854005942639,9.72106599074184,0.384184530422538,31
"6583","BA","Urandi",16665,9687,29026,"Guanambi",2,"Nordeste",0,"293260",4,1,0,1,0,1,1,0,1,0,1,2,0,2,0,2,12,9.17854005942639,9.72106599074184,0.380992573679062,30
"6584","BA","Urandi",16665,9687,29026,"Guanambi",2,"Nordeste",0,"293260",5,1,0,1,0,1,1,1,0,0,1,2,1,1,0,2,13,9.17854005942639,9.72106599074184,0.431219050115441,31
"6585","BA","Uruçuca",20413,11066.82,29031,"Ilhéus-Itabuna",2,"Nordeste",0,"293270",2,23,10,13,12,11,0,0,0,0,0,23,10,13,12,11,18,9.31170672156217,9.92392723177358,0.286439606481671,29
"6586","BA","Uruçuca",20413,11066.82,29031,"Ilhéus-Itabuna",2,"Nordeste",0,"293270",3,23,13,10,15,8,0,0,0,0,0,23,13,10,15,8,11,9.31170672156217,9.92392723177358,0.369608996978532,31
"6587","BA","Uruçuca",20413,11066.82,29031,"Ilhéus-Itabuna",2,"Nordeste",0,"293270",4,21,6,15,9,12,0,0,0,0,0,21,6,15,9,12,17,9.31170672156217,9.92392723177358,0.437986635590418,30
"6588","BA","Uruçuca",20413,11066.82,29031,"Ilhéus-Itabuna",2,"Nordeste",0,"293270",5,31,12,19,15,16,0,0,0,0,0,31,12,19,15,16,21,9.31170672156217,9.92392723177358,0.430158282426047,31
"6589","BA","Utinga",19256,8329.77,29023,"Seabra",2,"Nordeste",0,"293280",2,16,4,12,7,9,0,0,0,0,0,16,4,12,7,9,9,9.02759112373528,9.86557797946291,0.292064552742224,29
"6590","BA","Utinga",19256,8329.77,29023,"Seabra",2,"Nordeste",0,"293280",3,12,6,6,8,4,0,0,0,0,0,12,6,6,8,4,16,9.02759112373528,9.86557797946291,0.361347170080572,31
"6591","BA","Utinga",19256,8329.77,29023,"Seabra",2,"Nordeste",0,"293280",4,18,5,13,10,8,0,0,0,0,0,18,5,13,10,8,6,9.02759112373528,9.86557797946291,0.390244793168688,30
"6592","BA","Utinga",19256,8329.77,29023,"Seabra",2,"Nordeste",0,"293280",5,10,3,7,4,6,0,0,0,0,0,10,3,7,4,6,10,9.02759112373528,9.86557797946291,0.381288116066466,31
"6593","BA","Valença",97233,15175.39,29030,"Valença",2,"Nordeste",1,"293290",2,89,39,50,40,49,0,0,0,0,0,89,39,50,40,49,46,9.6274303157622,11.4848654390022,0.29248692359819,29
"6594","BA","Valença",97233,15175.39,29030,"Valença",2,"Nordeste",1,"293290",3,67,21,46,31,36,0,0,0,0,0,67,21,46,31,36,42,9.6274303157622,11.4848654390022,0.393448827748941,31
"6595","BA","Valença",97233,15175.39,29030,"Valença",2,"Nordeste",1,"293290",4,63,17,46,24,39,0,0,0,0,0,63,17,46,24,39,49,9.6274303157622,11.4848654390022,0.450096009309866,30
"6596","BA","Valença",97233,15175.39,29030,"Valença",2,"Nordeste",1,"293290",5,88,36,52,34,54,3,1,2,2,1,91,37,54,36,55,48,9.6274303157622,11.4848654390022,0.441639284890454,31
"6597","BA","Valente",28800,8021.56,29016,"Serrinha",2,"Nordeste",0,"293300",2,12,2,10,3,9,0,0,0,0,0,12,2,10,3,9,16,8.98988819566093,10.268130666124,0.252761367994015,29
"6598","BA","Valente",28800,8021.56,29016,"Serrinha",2,"Nordeste",0,"293300",3,14,7,7,9,5,1,0,1,0,1,15,7,8,9,6,15,8.98988819566093,10.268130666124,0.330698500765453,31
"6599","BA","Valente",28800,8021.56,29016,"Serrinha",2,"Nordeste",0,"293300",4,18,4,14,7,11,0,0,0,0,0,18,4,14,7,11,8,8.98988819566093,10.268130666124,0.366235904817243,30
"6600","BA","Valente",28800,8021.56,29016,"Serrinha",2,"Nordeste",0,"293300",5,16,5,11,5,11,0,0,0,0,0,16,5,11,5,11,18,8.98988819566093,10.268130666124,0.385559268405248,31
"6601","BA","Várzea da Roça",14121,6425.49,29011,"Itaberaba",2,"Nordeste",0,"293305",2,11,4,7,5,6,0,0,0,0,0,11,4,7,5,6,5,8.76802817144686,9.55541833006925,0.273039969712161,29
"6602","BA","Várzea da Roça",14121,6425.49,29011,"Itaberaba",2,"Nordeste",0,"293305",3,7,4,3,3,4,0,0,0,0,0,7,4,3,3,4,4,8.76802817144686,9.55541833006925,0.317924119793017,31
"6603","BA","Várzea da Roça",14121,6425.49,29011,"Itaberaba",2,"Nordeste",0,"293305",4,9,5,4,5,4,0,0,0,0,0,9,5,4,5,4,10,8.76802817144686,9.55541833006925,0.350151000072813,30
"6604","BA","Várzea da Roça",14121,6425.49,29011,"Itaberaba",2,"Nordeste",0,"293305",5,9,3,6,5,4,0,0,0,0,0,9,3,6,5,4,9,8.76802817144686,9.55541833006925,0.35661752196124,31
"6605","BA","Várzea do Poço",9210,9051.44,29010,"Jacobina",2,"Nordeste",0,"293310",2,4,1,3,2,2,0,0,0,0,0,4,1,3,2,2,2,9.11067914005846,9.12804512924935,0.221641966152648,29
"6606","BA","Várzea do Poço",9210,9051.44,29010,"Jacobina",2,"Nordeste",0,"293310",3,8,4,4,2,6,0,0,0,0,0,8,4,4,2,6,5,9.11067914005846,9.12804512924935,0.327449897150146,31
"6607","BA","Várzea do Poço",9210,9051.44,29010,"Jacobina",2,"Nordeste",0,"293310",4,3,0,3,1,2,0,0,0,0,0,3,0,3,1,2,6,9.11067914005846,9.12804512924935,0.360779485718346,30
"6608","BA","Várzea do Poço",9210,9051.44,29010,"Jacobina",2,"Nordeste",0,"293310",5,3,1,2,2,1,0,0,0,0,0,3,1,2,2,1,7,9.11067914005846,9.12804512924935,0.360686713709368,31
"6609","BA","Várzea Nova",12625,8308.48,29010,"Jacobina",2,"Nordeste",0,"293315",2,9,4,5,4,5,0,0,0,0,0,9,4,5,4,5,9,9.02503195896499,9.44343425414356,0.281876358703484,29
"6610","BA","Várzea Nova",12625,8308.48,29010,"Jacobina",2,"Nordeste",0,"293315",3,7,3,4,3,4,1,0,1,1,0,8,3,5,4,4,5,9.02503195896499,9.44343425414356,0.379205299939269,31
"6611","BA","Várzea Nova",12625,8308.48,29010,"Jacobina",2,"Nordeste",0,"293315",4,15,5,10,7,8,0,0,0,0,0,15,5,10,7,8,8,9.02503195896499,9.44343425414356,0.398042969064519,30
"6612","BA","Várzea Nova",12625,8308.48,29010,"Jacobina",2,"Nordeste",0,"293315",5,18,7,11,6,12,0,0,0,0,0,18,7,11,6,12,8,9.02503195896499,9.44343425414356,0.386132293727481,31
"6613","BA","Varzedo",8785,11320.1,29020,"Santo Antônio de Jesus",2,"Nordeste",0,"293317",2,8,2,6,5,3,0,0,0,0,0,8,2,6,5,3,3,9.33433518564042,9.0808010006212,0.266167322113557,29
"6614","BA","Varzedo",8785,11320.1,29020,"Santo Antônio de Jesus",2,"Nordeste",0,"293317",3,8,5,3,2,6,0,0,0,0,0,8,5,3,2,6,11,9.33433518564042,9.0808010006212,0.330753069323793,31
"6615","BA","Varzedo",8785,11320.1,29020,"Santo Antônio de Jesus",2,"Nordeste",0,"293317",4,10,3,7,3,7,0,0,0,0,0,10,3,7,3,7,7,9.33433518564042,9.0808010006212,0.390620718867762,30
"6616","BA","Varzedo",8785,11320.1,29020,"Santo Antônio de Jesus",2,"Nordeste",0,"293317",5,9,3,6,4,5,0,0,0,0,0,9,3,6,4,5,4,9.33433518564042,9.0808010006212,0.380764940555148,31
"6617","BA","Vera Cruz",43716,12650.04,29021,"Salvador",2,"Nordeste",1,"293320",2,43,11,32,16,27,1,0,1,0,1,44,11,33,16,28,31,9.445415656206,10.6854694467966,0.313137516233352,29
"6618","BA","Vera Cruz",43716,12650.04,29021,"Salvador",2,"Nordeste",1,"293320",3,41,16,25,15,26,1,1,0,0,1,42,17,25,15,27,27,9.445415656206,10.6854694467966,0.400928909654759,31
"6619","BA","Vera Cruz",43716,12650.04,29021,"Salvador",2,"Nordeste",1,"293320",4,37,16,21,20,17,2,0,2,0,2,39,16,23,20,19,30,9.445415656206,10.6854694467966,0.475692308511734,30
"6620","BA","Vera Cruz",43716,12650.04,29021,"Salvador",2,"Nordeste",1,"293320",5,38,16,22,19,19,2,0,2,1,1,40,16,24,20,20,24,9.445415656206,10.6854694467966,0.457202302125039,31
"6621","BA","Vitória da Conquista",341128,20761.05,29028,"Vitória da Conquista",2,"Nordeste",1,"293330",2,343,97,246,108,235,3,2,1,0,3,346,99,247,108,238,148,9.94083391403548,12.7400130524022,0.282326536115234,29
"6622","BA","Vitória da Conquista",341128,20761.05,29028,"Vitória da Conquista",2,"Nordeste",1,"293330",3,382,111,271,126,256,5,2,3,2,3,387,113,274,128,259,208,9.94083391403548,12.7400130524022,0.371229326530042,31
"6623","BA","Vitória da Conquista",341128,20761.05,29028,"Vitória da Conquista",2,"Nordeste",1,"293330",4,339,95,244,111,228,4,1,3,1,3,343,96,247,112,231,166,9.94083391403548,12.7400130524022,0.427107639050023,30
"6624","BA","Vitória da Conquista",341128,20761.05,29028,"Vitória da Conquista",2,"Nordeste",1,"293330",5,377,110,267,130,247,4,2,2,2,2,381,112,269,132,249,203,9.94083391403548,12.7400130524022,0.406910064563056,31
"6625","BA","Wagner",9344,7355.48,29023,"Seabra",2,"Nordeste",0,"293340",2,9,2,7,5,4,0,0,0,0,0,9,2,7,5,4,8,8.9032008926328,9.14248970506801,0.294342083202198,29
"6626","BA","Wagner",9344,7355.48,29023,"Seabra",2,"Nordeste",0,"293340",3,6,1,5,2,4,0,0,0,0,0,6,1,5,2,4,7,8.9032008926328,9.14248970506801,0.385321936612412,31
"6627","BA","Wagner",9344,7355.48,29023,"Seabra",2,"Nordeste",0,"293340",4,6,1,5,2,4,0,0,0,0,0,6,1,5,2,4,4,8.9032008926328,9.14248970506801,0.395959394717387,30
"6628","BA","Wagner",9344,7355.48,29023,"Seabra",2,"Nordeste",0,"293340",5,8,3,5,4,4,0,0,0,0,0,8,3,5,4,4,2,8.9032008926328,9.14248970506801,0.35568967796308,31
"6629","BA","Wanderley",12180,10371.85,29002,"Cotegipe",2,"Nordeste",0,"293345",2,5,3,2,2,3,0,0,0,0,0,5,3,2,2,3,6,9.24685068454087,9.40755054126389,0.264538699004884,29
"6630","BA","Wanderley",12180,10371.85,29002,"Cotegipe",2,"Nordeste",0,"293345",3,16,6,10,8,8,0,0,0,0,0,16,6,10,8,8,5,9.24685068454087,9.40755054126389,0.340061710931333,31
"6631","BA","Wanderley",12180,10371.85,29002,"Cotegipe",2,"Nordeste",0,"293345",4,8,4,4,6,2,0,0,0,0,0,8,4,4,6,2,4,9.24685068454087,9.40755054126389,0.320258213965512,30
"6632","BA","Wanderley",12180,10371.85,29002,"Cotegipe",2,"Nordeste",0,"293345",5,16,6,10,9,7,0,0,0,0,0,16,6,10,9,7,6,9.24685068454087,9.40755054126389,0.361874663144416,31
"6633","BA","Wenceslau Guimarães",20978,11512.21,29031,"Ilhéus-Itabuna",2,"Nordeste",0,"293350",2,24,9,15,8,16,0,0,0,0,0,24,9,15,8,16,12,9.35116349023543,9.95122954852155,0.278495724404023,29
"6634","BA","Wenceslau Guimarães",20978,11512.21,29031,"Ilhéus-Itabuna",2,"Nordeste",0,"293350",3,27,15,12,12,15,0,0,0,0,0,27,15,12,12,15,13,9.35116349023543,9.95122954852155,0.369599382615143,31
"6635","BA","Wenceslau Guimarães",20978,11512.21,29031,"Ilhéus-Itabuna",2,"Nordeste",0,"293350",4,23,13,10,10,13,1,1,0,1,0,24,14,10,11,13,9,9.35116349023543,9.95122954852155,0.391651774933026,30
"6636","BA","Wenceslau Guimarães",20978,11512.21,29031,"Ilhéus-Itabuna",2,"Nordeste",0,"293350",5,25,11,14,8,17,1,0,1,1,0,26,11,15,9,17,15,9.35116349023543,9.95122954852155,0.410329214806566,31
"6637","BA","Xique-Xique",46523,8442.06,29006,"Barra",2,"Nordeste",1,"293360",2,60,23,37,28,32,0,0,0,0,0,60,23,37,28,32,24,9.04098163363773,10.7477020929454,0.275621544439594,29
"6638","BA","Xique-Xique",46523,8442.06,29006,"Barra",2,"Nordeste",1,"293360",3,66,29,37,25,41,0,0,0,0,0,66,29,37,25,41,24,9.04098163363773,10.7477020929454,0.354841185726501,31
"6639","BA","Xique-Xique",46523,8442.06,29006,"Barra",2,"Nordeste",1,"293360",4,60,22,38,28,32,1,0,1,1,0,61,22,39,29,32,20,9.04098163363773,10.7477020929454,0.383786931710156,30
"6640","BA","Xique-Xique",46523,8442.06,29006,"Barra",2,"Nordeste",1,"293360",5,76,26,50,40,36,1,0,1,1,0,77,26,51,41,36,24,9.04098163363773,10.7477020929454,0.39163475067951,31
"6641","MG","Abaeté",23250,21286.43,31024,"Três Marias",3,"Sudeste",1,"310020",2,16,6,10,6,10,0,0,0,0,0,16,6,10,6,10,10,9.96582505946808,10.0540604110155,0.272318663920594,29
"6642","MG","Abaeté",23250,21286.43,31024,"Três Marias",3,"Sudeste",1,"310020",3,13,6,7,5,8,0,0,0,0,0,13,6,7,5,8,18,9.96582505946808,10.0540604110155,0.344851999357115,31
"6643","MG","Abaeté",23250,21286.43,31024,"Três Marias",3,"Sudeste",1,"310020",4,13,6,7,4,9,0,0,0,0,0,13,6,7,4,9,13,9.96582505946808,10.0540604110155,0.372330536433069,30
"6644","MG","Abaeté",23250,21286.43,31024,"Três Marias",3,"Sudeste",1,"310020",5,12,3,9,5,7,0,0,0,0,0,12,3,9,5,7,12,9.96582505946808,10.0540604110155,0.364179100826973,31
"6645","MG","Abre Campo",13444,13938.86,31061,"Manhuaçu",3,"Sudeste",0,"310030",2,9,2,7,2,7,0,0,0,0,0,9,2,7,2,7,7,9.54243590191734,9.506288188845,0.300748207614662,29
"6646","MG","Abre Campo",13444,13938.86,31061,"Manhuaçu",3,"Sudeste",0,"310030",3,13,6,7,6,7,0,0,0,0,0,13,6,7,6,7,9,9.54243590191734,9.506288188845,0.384970756086871,31
"6647","MG","Abre Campo",13444,13938.86,31061,"Manhuaçu",3,"Sudeste",0,"310030",4,13,3,10,5,8,0,0,0,0,0,13,3,10,5,8,7,9.54243590191734,9.506288188845,0.410828605523451,30
"6648","MG","Abre Campo",13444,13938.86,31061,"Manhuaçu",3,"Sudeste",0,"310030",5,6,1,5,1,5,1,1,0,0,1,7,2,5,1,6,11,9.54243590191734,9.506288188845,0.399563819749926,31
"6649","MG","Água Boa",13523,10181.74,31036,"Peçanha",3,"Sudeste",0,"310060",2,21,10,11,12,9,2,2,0,0,2,23,12,11,12,11,6,9.22835119887795,9.51214721847336,0.31370222263306,29
"6650","MG","Água Boa",13523,10181.74,31036,"Peçanha",3,"Sudeste",0,"310060",3,14,8,6,8,6,1,1,0,0,1,15,9,6,8,7,6,9.22835119887795,9.51214721847336,0.430839705345847,31
"6651","MG","Água Boa",13523,10181.74,31036,"Peçanha",3,"Sudeste",0,"310060",4,13,5,8,6,7,0,0,0,0,0,13,5,8,6,7,6,9.22835119887795,9.51214721847336,0.451138344653197,30
"6652","MG","Água Boa",13523,10181.74,31036,"Peçanha",3,"Sudeste",0,"310060",5,17,10,7,8,9,0,0,0,0,0,17,10,7,8,9,1,9.22835119887795,9.51214721847336,0.401750346474478,31
"6653","MG","Águas Formosas",19247,12107.63,31016,"Nanuque",3,"Sudeste",0,"310090",2,23,10,13,11,12,0,0,0,0,0,23,10,13,11,12,9,9.40159111136614,9.86511048341512,0.287950427749787,29
"6654","MG","Águas Formosas",19247,12107.63,31016,"Nanuque",3,"Sudeste",0,"310090",3,20,6,14,14,6,0,0,0,0,0,20,6,14,14,6,16,9.40159111136614,9.86511048341512,0.400284365580126,31
"6655","MG","Águas Formosas",19247,12107.63,31016,"Nanuque",3,"Sudeste",0,"310090",4,18,8,10,6,12,0,0,0,0,0,18,8,10,6,12,10,9.40159111136614,9.86511048341512,0.417552853151623,30
"6656","MG","Águas Formosas",19247,12107.63,31016,"Nanuque",3,"Sudeste",0,"310090",5,16,4,12,6,10,0,0,0,0,0,16,4,12,6,10,11,9.40159111136614,9.86511048341512,0.384039345739756,31
"6657","MG","Águas Vermelhas",13599,16163.09,31005,"Salinas",3,"Sudeste",0,"310100",2,12,4,8,4,8,0,0,0,0,0,12,4,8,4,8,5,9.69048552666752,9.51775153960896,0.332001966915149,29
"6658","MG","Águas Vermelhas",13599,16163.09,31005,"Salinas",3,"Sudeste",0,"310100",3,9,5,4,4,5,0,0,0,0,0,9,5,4,4,5,5,9.69048552666752,9.51775153960896,0.377816690162899,31
"6659","MG","Águas Vermelhas",13599,16163.09,31005,"Salinas",3,"Sudeste",0,"310100",4,5,3,2,2,3,0,0,0,0,0,5,3,2,2,3,7,9.69048552666752,9.51775153960896,0.38960056052652,30
"6660","MG","Águas Vermelhas",13599,16163.09,31005,"Salinas",3,"Sudeste",0,"310100",5,10,4,6,5,5,0,0,0,0,0,10,4,6,5,5,9,9.69048552666752,9.51775153960896,0.395718442543017,31
"6661","MG","Aimorés",25141,18105.07,31041,"Aimorés",3,"Sudeste",0,"310110",2,18,6,12,6,12,0,0,0,0,0,18,6,12,6,12,19,9.80394728852753,10.1322552586006,0.312251754930275,29
"6662","MG","Aimorés",25141,18105.07,31041,"Aimorés",3,"Sudeste",0,"310110",3,26,6,20,6,20,0,0,0,0,0,26,6,20,6,20,22,9.80394728852753,10.1322552586006,0.396195194999958,31
"6663","MG","Aimorés",25141,18105.07,31041,"Aimorés",3,"Sudeste",0,"310110",4,21,6,15,7,14,0,0,0,0,0,21,6,15,7,14,16,9.80394728852753,10.1322552586006,0.435547401858537,30
"6664","MG","Aimorés",25141,18105.07,31041,"Aimorés",3,"Sudeste",0,"310110",5,30,10,20,15,15,0,0,0,0,0,30,10,20,15,15,23,9.80394728852753,10.1322552586006,0.442385036840317,31
"6665","MG","Além Paraíba",35401,25797.76,31066,"Cataguases",3,"Sudeste",1,"310150",2,22,4,18,9,13,0,0,0,0,0,22,4,18,9,13,21,10.1580429454351,10.4744953473105,0.347700175213295,29
"6666","MG","Além Paraíba",35401,25797.76,31066,"Cataguases",3,"Sudeste",1,"310150",3,23,3,20,6,17,0,0,0,0,0,23,3,20,6,17,26,10.1580429454351,10.4744953473105,0.437639372400024,31
"6667","MG","Além Paraíba",35401,25797.76,31066,"Cataguases",3,"Sudeste",1,"310150",4,29,8,21,11,18,0,0,0,0,0,29,8,21,11,18,24,10.1580429454351,10.4744953473105,0.495274787365887,30
"6668","MG","Além Paraíba",35401,25797.76,31066,"Cataguases",3,"Sudeste",1,"310150",5,49,8,41,20,29,0,0,0,0,0,49,8,41,20,29,36,10.1580429454351,10.4744953473105,0.477515648794103,31
"6669","MG","Alfenas",80494,32762.64,31049,"Alfenas",3,"Sudeste",1,"310160",2,69,12,57,24,45,0,0,0,0,0,69,12,57,24,45,46,10.3970441208007,11.2959379264674,0.307693506053197,29
"6670","MG","Alfenas",80494,32762.64,31049,"Alfenas",3,"Sudeste",1,"310160",3,70,12,58,20,50,0,0,0,0,0,70,12,58,20,50,49,10.3970441208007,11.2959379264674,0.391411263668097,31
"6671","MG","Alfenas",80494,32762.64,31049,"Alfenas",3,"Sudeste",1,"310160",4,75,13,62,27,48,0,0,0,0,0,75,13,62,27,48,40,10.3970441208007,11.2959379264674,0.439821715181274,30
"6672","MG","Alfenas",80494,32762.64,31049,"Alfenas",3,"Sudeste",1,"310160",5,91,17,74,34,57,0,0,0,0,0,91,17,74,34,57,39,10.3970441208007,11.2959379264674,0.39768554927615,31
"6673","MG","Alfredo Vasconcelos",6981,13855.97,31059,"Barbacena",3,"Sudeste",1,"310163",2,8,2,6,3,5,0,0,0,0,0,8,2,6,3,5,3,9.53647146567285,8.8509474519704,0.311383266717068,29
"6674","MG","Alfredo Vasconcelos",6981,13855.97,31059,"Barbacena",3,"Sudeste",1,"310163",3,6,1,5,0,6,0,0,0,0,0,6,1,5,0,6,2,9.53647146567285,8.8509474519704,0.402696052747604,31
"6675","MG","Alfredo Vasconcelos",6981,13855.97,31059,"Barbacena",3,"Sudeste",1,"310163",4,5,2,3,2,3,0,0,0,0,0,5,2,3,2,3,5,9.53647146567285,8.8509474519704,0.424155452294299,30
"6676","MG","Alfredo Vasconcelos",6981,13855.97,31059,"Barbacena",3,"Sudeste",1,"310163",5,9,4,5,2,7,0,0,0,0,0,9,4,5,2,7,7,9.53647146567285,8.8509474519704,0.44766412372696,31
"6677","MG","Almenara",42143,12833.65,31014,"Almenara",3,"Sudeste",1,"310170",2,3,2,1,2,1,0,0,0,0,0,3,2,1,2,1,17,9.45982590662801,10.6488238760914,0.26413380232553,29
"6678","MG","Almenara",42143,12833.65,31014,"Almenara",3,"Sudeste",1,"310170",3,3,1,2,1,2,0,0,0,0,0,3,1,2,1,2,30,9.45982590662801,10.6488238760914,0.336338320747824,31
"6679","MG","Almenara",42143,12833.65,31014,"Almenara",3,"Sudeste",1,"310170",4,1,0,1,0,1,0,0,0,0,0,1,0,1,0,1,15,9.45982590662801,10.6488238760914,0.359986333427447,30
"6680","MG","Almenara",42143,12833.65,31014,"Almenara",3,"Sudeste",1,"310170",5,3,0,3,1,2,0,0,0,0,0,3,0,3,1,2,17,9.45982590662801,10.6488238760914,0.34591319854698,31
"6681","MG","Alpercata",7436,10644.77,31037,"Governador Valadares",3,"Sudeste",0,"310180",2,2,1,1,1,1,0,0,0,0,0,2,1,1,1,1,7,9.27282397070618,8.91408834884133,0.318168784840702,29
"6682","MG","Alpercata",7436,10644.77,31037,"Governador Valadares",3,"Sudeste",0,"310180",3,7,1,6,2,5,0,0,0,0,0,7,1,6,2,5,8,9.27282397070618,8.91408834884133,0.412173620282419,31
"6683","MG","Alpercata",7436,10644.77,31037,"Governador Valadares",3,"Sudeste",0,"310180",4,7,2,5,3,4,0,0,0,0,0,7,2,5,3,4,3,9.27282397070618,8.91408834884133,0.419661562787025,30
"6684","MG","Alpercata",7436,10644.77,31037,"Governador Valadares",3,"Sudeste",0,"310180",5,8,1,7,3,5,0,0,0,0,0,8,1,7,3,5,5,9.27282397070618,8.91408834884133,0.391382939477439,31
"6685","MG","Alpinópolis",19958,18048.35,31047,"Passos",3,"Sudeste",1,"310190",2,14,4,10,5,9,0,0,0,0,0,14,4,10,5,9,8,9.80080954684025,9.90138534444426,0.28898206549482,29
"6686","MG","Alpinópolis",19958,18048.35,31047,"Passos",3,"Sudeste",1,"310190",3,13,2,11,2,11,0,0,0,0,0,13,2,11,2,11,17,9.80080954684025,9.90138534444426,0.360509559378092,31
"6687","MG","Alpinópolis",19958,18048.35,31047,"Passos",3,"Sudeste",1,"310190",4,11,3,8,6,5,0,0,0,0,0,11,3,8,6,5,9,9.80080954684025,9.90138534444426,0.394347005982653,30
"6688","MG","Alpinópolis",19958,18048.35,31047,"Passos",3,"Sudeste",1,"310190",5,24,5,19,11,13,0,0,0,0,0,24,5,19,11,13,11,9.80080954684025,9.90138534444426,0.369065768687417,31
"6689","MG","Alterosa",14517,14738.41,31049,"Alfenas",3,"Sudeste",0,"310200",2,14,7,7,5,9,0,0,0,0,0,14,7,7,5,9,12,9.59821229018277,9.58307565546143,0.30463623568202,29
"6690","MG","Alterosa",14517,14738.41,31049,"Alfenas",3,"Sudeste",0,"310200",3,14,6,8,6,8,0,0,0,0,0,14,6,8,6,8,3,9.59821229018277,9.58307565546143,0.380438828302282,31
"6691","MG","Alterosa",14517,14738.41,31049,"Alfenas",3,"Sudeste",0,"310200",4,11,2,9,4,7,0,0,0,0,0,11,2,9,4,7,5,9.59821229018277,9.58307565546143,0.387917058484416,30
"6692","MG","Alterosa",14517,14738.41,31049,"Alfenas",3,"Sudeste",0,"310200",5,16,3,13,3,13,0,0,0,0,0,16,3,13,3,13,8,9.59821229018277,9.58307565546143,0.35853273626042,31
"6693","MG","Alvinópolis",15169,17741.25,31031,"Itabira",3,"Sudeste",0,"310230",2,7,0,7,2,5,0,0,0,0,0,7,0,7,2,5,8,9.78364771561347,9.62700915059167,0.314215628895267,29
"6694","MG","Alvinópolis",15169,17741.25,31031,"Itabira",3,"Sudeste",0,"310230",3,20,1,19,6,14,0,0,0,0,0,20,1,19,6,14,12,9.78364771561347,9.62700915059167,0.448316883014015,31
"6695","MG","Alvinópolis",15169,17741.25,31031,"Itabira",3,"Sudeste",0,"310230",4,11,1,10,5,6,0,0,0,0,0,11,1,10,5,6,9,9.78364771561347,9.62700915059167,0.484625155915062,30
"6696","MG","Alvinópolis",15169,17741.25,31031,"Itabira",3,"Sudeste",0,"310230",5,18,3,15,7,11,0,0,0,0,0,18,3,15,7,11,9,9.78364771561347,9.62700915059167,0.465177389744405,31
"6697","MG","Andradas",41396,21690.12,31051,"Poços de Caldas",3,"Sudeste",1,"310260",2,32,10,22,11,21,1,0,1,1,0,33,10,23,12,21,28,9.98461213630907,10.6309395367881,0.31431122763368,29
"6698","MG","Andradas",41396,21690.12,31051,"Poços de Caldas",3,"Sudeste",1,"310260",3,30,8,22,14,16,0,0,0,0,0,30,8,22,14,16,19,9.98461213630907,10.6309395367881,0.400764902397558,31
"6699","MG","Andradas",41396,21690.12,31051,"Poços de Caldas",3,"Sudeste",1,"310260",4,43,15,28,12,31,0,0,0,0,0,43,15,28,12,31,25,9.98461213630907,10.6309395367881,0.425424000271115,30
"6700","MG","Andradas",41396,21690.12,31051,"Poços de Caldas",3,"Sudeste",1,"310260",5,38,11,27,19,19,0,0,0,0,0,38,11,27,19,19,39,9.98461213630907,10.6309395367881,0.390693926662058,31
"6701","MG","Cachoeira de Pajeú",9442,10437.83,31013,"Pedra Azul",3,"Sudeste",0,"310270",2,0,0,0,0,0,0,0,0,0,0,0,0,0,0,0,6,9.25319198542578,9.15292310110623,0.30058990263474,29
"6702","MG","Cachoeira de Pajeú",9442,10437.83,31013,"Pedra Azul",3,"Sudeste",0,"310270",3,1,0,1,0,1,0,0,0,0,0,1,0,1,0,1,5,9.25319198542578,9.15292310110623,0.381842026216911,31
"6703","MG","Cachoeira de Pajeú",9442,10437.83,31013,"Pedra Azul",3,"Sudeste",0,"310270",4,0,0,0,0,0,0,0,0,0,0,0,0,0,0,0,4,9.25319198542578,9.15292310110623,0.407254338060118,30
"6704","MG","Cachoeira de Pajeú",9442,10437.83,31013,"Pedra Azul",3,"Sudeste",0,"310270",5,4,2,2,0,4,0,0,0,0,0,4,2,2,0,4,5,9.25319198542578,9.15292310110623,0.409495646955765,31
"6705","MG","Andrelândia",12206,19029.8,31055,"Andrelândia",3,"Sudeste",0,"310280",2,7,2,5,4,3,0,0,0,0,0,7,2,5,4,3,7,9.85376145051348,9.40968291310444,0.322306411366739,29
"6706","MG","Andrelândia",12206,19029.8,31055,"Andrelândia",3,"Sudeste",0,"310280",3,8,1,7,6,2,0,0,0,0,0,8,1,7,6,2,8,9.85376145051348,9.40968291310444,0.453159158247838,31
"6707","MG","Andrelândia",12206,19029.8,31055,"Andrelândia",3,"Sudeste",0,"310280",4,7,2,5,3,4,1,0,1,0,1,8,2,6,3,5,9,9.85376145051348,9.40968291310444,0.472070174825616,30
"6708","MG","Andrelândia",12206,19029.8,31055,"Andrelândia",3,"Sudeste",0,"310280",5,11,1,10,4,7,0,0,0,0,0,11,1,10,4,7,18,9.85376145051348,9.40968291310444,0.474469057564909,31
"6709","MG","Antônio Carlos",11459,14330,31059,"Barbacena",3,"Sudeste",1,"310290",2,14,4,10,3,11,0,0,0,0,0,14,4,10,3,11,9,9.57011052082222,9.34653072642645,0.347474352262682,29
"6710","MG","Antônio Carlos",11459,14330,31059,"Barbacena",3,"Sudeste",1,"310290",3,11,2,9,2,9,0,0,0,0,0,11,2,9,2,9,7,9.57011052082222,9.34653072642645,0.420473712664578,31
"6711","MG","Antônio Carlos",11459,14330,31059,"Barbacena",3,"Sudeste",1,"310290",4,11,0,11,4,7,0,0,0,0,0,11,0,11,4,7,7,9.57011052082222,9.34653072642645,0.464369112778716,30
"6712","MG","Antônio Carlos",11459,14330,31059,"Barbacena",3,"Sudeste",1,"310290",5,7,0,7,1,6,0,0,0,0,0,7,0,7,1,6,13,9.57011052082222,9.34653072642645,0.481203051966062,31
"6713","MG","Antônio Dias",9275,26636.74,31039,"Ipatinga",3,"Sudeste",0,"310300",2,9,4,5,4,5,0,0,0,0,0,9,4,5,4,5,4,10.1900467447938,9.13507788747564,0.356442865106498,29
"6714","MG","Antônio Dias",9275,26636.74,31039,"Ipatinga",3,"Sudeste",0,"310300",3,5,0,5,2,3,0,0,0,0,0,5,0,5,2,3,4,10.1900467447938,9.13507788747564,0.410805675426865,31
"6715","MG","Antônio Dias",9275,26636.74,31039,"Ipatinga",3,"Sudeste",0,"310300",4,11,6,5,5,6,0,0,0,0,0,11,6,5,5,6,2,10.1900467447938,9.13507788747564,0.434188861362999,30
"6716","MG","Antônio Dias",9275,26636.74,31039,"Ipatinga",3,"Sudeste",0,"310300",5,10,3,7,4,6,0,0,0,0,0,10,3,7,4,6,3,10.1900467447938,9.13507788747564,0.422240103496977,31
"6717","MG","Araçuaí",36712,10966.47,31012,"Araçuaí",3,"Sudeste",0,"310340",2,25,10,15,12,13,1,0,1,1,0,26,10,16,13,13,17,9.30259771479385,10.5108589560747,0.292559177603405,29
"6718","MG","Araçuaí",36712,10966.47,31012,"Araçuaí",3,"Sudeste",0,"310340",3,27,7,20,9,18,0,0,0,0,0,27,7,20,9,18,25,9.30259771479385,10.5108589560747,0.371597687094655,31
"6719","MG","Araçuaí",36712,10966.47,31012,"Araçuaí",3,"Sudeste",0,"310340",4,32,10,22,15,17,0,0,0,0,0,32,10,22,15,17,15,9.30259771479385,10.5108589560747,0.402984954942474,30
"6720","MG","Araçuaí",36712,10966.47,31012,"Araçuaí",3,"Sudeste",0,"310340",5,39,12,27,19,20,1,0,1,1,0,40,12,28,20,20,19,9.30259771479385,10.5108589560747,0.37809006070498,31
"6721","MG","Araguari",117825,39942.34,31018,"Uberlândia",3,"Sudeste",1,"310350",2,92,14,78,41,51,2,0,2,2,0,94,14,80,43,51,57,10.5951921931354,11.6769557517919,0.30762754986193,29
"6722","MG","Araguari",117825,39942.34,31018,"Uberlândia",3,"Sudeste",1,"310350",3,80,7,73,33,47,0,0,0,0,0,80,7,73,33,47,73,10.5951921931354,11.6769557517919,0.388121835523125,31
"6723","MG","Araguari",117825,39942.34,31018,"Uberlândia",3,"Sudeste",1,"310350",4,79,16,63,29,50,1,0,1,0,1,80,16,64,29,51,70,10.5951921931354,11.6769557517919,0.424800533182291,30
"6724","MG","Araguari",117825,39942.34,31018,"Uberlândia",3,"Sudeste",1,"310350",5,99,9,90,29,70,1,0,1,1,0,100,9,91,30,70,60,10.5951921931354,11.6769557517919,0.379594042415996,31
"6725","MG","Araporã",6931,189009.59,31018,"Uberlândia",3,"Sudeste",1,"310375",2,2,0,2,0,2,0,0,0,0,0,2,0,2,0,2,6,12.1495530334953,8.84375938191798,0.282191915585313,29
"6726","MG","Araporã",6931,189009.59,31018,"Uberlândia",3,"Sudeste",1,"310375",3,1,0,1,0,1,0,0,0,0,0,1,0,1,0,1,3,12.1495530334953,8.84375938191798,0.367850512285369,31
"6727","MG","Araporã",6931,189009.59,31018,"Uberlândia",3,"Sudeste",1,"310375",4,1,0,1,0,1,0,0,0,0,0,1,0,1,0,1,2,12.1495530334953,8.84375938191798,0.393051062994574,30
"6728","MG","Araporã",6931,189009.59,31018,"Uberlândia",3,"Sudeste",1,"310375",5,1,0,1,0,1,0,0,0,0,0,1,0,1,0,1,3,12.1495530334953,8.84375938191798,0.371049298611527,31
"6729","MG","Araújos",9401,33338.17,31026,"Bom Despacho",3,"Sudeste",0,"310390",2,8,1,7,2,6,0,0,0,0,0,8,1,7,2,6,1,10.4144582657761,9.14857134557855,0.295800479548736,29
"6730","MG","Araújos",9401,33338.17,31026,"Bom Despacho",3,"Sudeste",0,"310390",3,5,1,4,1,4,0,0,0,0,0,5,1,4,1,4,7,10.4144582657761,9.14857134557855,0.334642783752331,31
"6731","MG","Araújos",9401,33338.17,31026,"Bom Despacho",3,"Sudeste",0,"310390",4,8,2,6,2,6,0,0,0,0,0,8,2,6,2,6,0,10.4144582657761,9.14857134557855,0.387362647192354,30
"6732","MG","Araújos",9401,33338.17,31026,"Bom Despacho",3,"Sudeste",0,"310390",5,12,3,9,6,6,0,0,0,0,0,12,3,9,6,6,8,10.4144582657761,9.14857134557855,0.382346717939719,31
"6733","MG","Araxá",107337,58774.85,31023,"Araxá",3,"Sudeste",1,"310400",2,107,19,88,35,72,0,0,0,0,0,107,19,88,35,72,74,10.9814693212995,11.5837286967656,0.300774167408074,29
"6734","MG","Araxá",107337,58774.85,31023,"Araxá",3,"Sudeste",1,"310400",3,108,19,89,24,84,5,1,4,0,5,113,20,93,24,89,62,10.9814693212995,11.5837286967656,0.385909707151913,31
"6735","MG","Araxá",107337,58774.85,31023,"Araxá",3,"Sudeste",1,"310400",4,115,23,92,46,69,1,0,1,1,0,116,23,93,47,69,64,10.9814693212995,11.5837286967656,0.431645068173614,30
"6736","MG","Araxá",107337,58774.85,31023,"Araxá",3,"Sudeste",1,"310400",5,129,15,114,42,87,2,1,1,1,1,131,16,115,43,88,72,10.9814693212995,11.5837286967656,0.391793589223877,31
"6737","MG","Arcos",40380,31945.72,31044,"Formiga",3,"Sudeste",1,"310420",2,39,8,31,5,34,1,1,0,0,1,40,9,31,5,35,19,10.3717934915209,10.6060898918668,0.302317120137557,29
"6738","MG","Arcos",40380,31945.72,31044,"Formiga",3,"Sudeste",1,"310420",3,34,6,28,9,25,0,0,0,0,0,34,6,28,9,25,32,10.3717934915209,10.6060898918668,0.394842472046351,31
"6739","MG","Arcos",40380,31945.72,31044,"Formiga",3,"Sudeste",1,"310420",4,35,5,30,5,30,0,0,0,0,0,35,5,30,5,30,28,10.3717934915209,10.6060898918668,0.430952416302055,30
"6740","MG","Arcos",40380,31945.72,31044,"Formiga",3,"Sudeste",1,"310420",5,36,4,32,10,26,0,0,0,0,0,36,4,32,10,26,18,10.3717934915209,10.6060898918668,0.382688869234331,31
"6741","MG","Areado",15181,15383.32,31049,"Alfenas",3,"Sudeste",1,"310430",2,10,1,9,1,9,0,0,0,0,0,10,1,9,1,9,6,9.64103908452362,9.62779992493271,0.303182212260437,29
"6742","MG","Areado",15181,15383.32,31049,"Alfenas",3,"Sudeste",1,"310430",3,14,3,11,7,7,0,0,0,0,0,14,3,11,7,7,10,9.64103908452362,9.62779992493271,0.394629247276378,31
"6743","MG","Areado",15181,15383.32,31049,"Alfenas",3,"Sudeste",1,"310430",4,7,1,6,4,3,0,0,0,0,0,7,1,6,4,3,11,9.64103908452362,9.62779992493271,0.398532602841879,30
"6744","MG","Areado",15181,15383.32,31049,"Alfenas",3,"Sudeste",1,"310430",5,13,4,9,5,8,0,0,0,0,0,13,4,9,5,8,6,9.64103908452362,9.62779992493271,0.355223537767584,31
"6745","MG","Arinos",17862,12222.79,31001,"Unaí",3,"Sudeste",0,"310450",2,11,2,9,4,7,0,0,0,0,0,11,2,9,4,7,8,9.41105752090481,9.79043083024383,0.279375245853762,29
"6746","MG","Arinos",17862,12222.79,31001,"Unaí",3,"Sudeste",0,"310450",3,8,1,7,2,6,0,0,0,0,0,8,1,7,2,6,4,9.41105752090481,9.79043083024383,0.369382308222872,31
"6747","MG","Arinos",17862,12222.79,31001,"Unaí",3,"Sudeste",0,"310450",4,7,3,4,3,4,0,0,0,0,0,7,3,4,3,4,7,9.41105752090481,9.79043083024383,0.394404100142638,30
"6748","MG","Arinos",17862,12222.79,31001,"Unaí",3,"Sudeste",0,"310450",5,19,7,12,11,8,0,0,0,0,0,19,7,12,11,8,7,9.41105752090481,9.79043083024383,0.373842115654994,31
"6749","MG","Astolfo Dutra",14270,18898.37,31064,"Ubá",3,"Sudeste",0,"310460",2,3,0,3,0,3,0,0,0,0,0,3,0,3,0,3,15,9.84683095394232,9.56591471047088,0.314056554622788,29
"6750","MG","Astolfo Dutra",14270,18898.37,31064,"Ubá",3,"Sudeste",0,"310460",3,8,1,7,0,8,1,0,1,0,1,9,1,8,0,9,11,9.84683095394232,9.56591471047088,0.408897000733262,31
"6751","MG","Astolfo Dutra",14270,18898.37,31064,"Ubá",3,"Sudeste",0,"310460",4,15,5,10,7,8,0,0,0,0,0,15,5,10,7,8,5,9.84683095394232,9.56591471047088,0.436383519291813,30
"6752","MG","Astolfo Dutra",14270,18898.37,31064,"Ubá",3,"Sudeste",0,"310460",5,9,2,7,3,6,1,0,1,0,1,10,2,8,3,7,11,9.84683095394232,9.56591471047088,0.41960538380066,31
"6753","MG","Ataléia",12678,9689.69,31015,"Teófilo Otoni",3,"Sudeste",0,"310470",2,7,3,4,2,5,0,0,0,0,0,7,3,4,2,5,7,9.178817712629,9.44762348684411,0.280775670827699,29
"6754","MG","Ataléia",12678,9689.69,31015,"Teófilo Otoni",3,"Sudeste",0,"310470",3,13,4,9,5,8,0,0,0,0,0,13,4,9,5,8,5,9.178817712629,9.44762348684411,0.369984771582563,31
"6755","MG","Ataléia",12678,9689.69,31015,"Teófilo Otoni",3,"Sudeste",0,"310470",4,3,0,3,0,3,0,0,0,0,0,3,0,3,0,3,6,9.178817712629,9.44762348684411,0.406076959120536,30
"6756","MG","Ataléia",12678,9689.69,31015,"Teófilo Otoni",3,"Sudeste",0,"310470",5,11,5,6,3,8,0,0,0,0,0,11,5,6,3,8,11,9.178817712629,9.44762348684411,0.443795669698009,31
"6757","MG","Baependi",19199,14385.08,31054,"São Lourenço",3,"Sudeste",1,"310490",2,14,3,11,1,13,0,0,0,0,0,14,3,11,1,13,13,9.57394683731881,9.86261347332616,0.33481302256378,29
"6758","MG","Baependi",19199,14385.08,31054,"São Lourenço",3,"Sudeste",1,"310490",3,9,2,7,1,8,0,0,0,0,0,9,2,7,1,8,10,9.57394683731881,9.86261347332616,0.415442967441054,31
"6759","MG","Baependi",19199,14385.08,31054,"São Lourenço",3,"Sudeste",1,"310490",4,19,6,13,6,13,0,0,0,0,0,19,6,13,6,13,17,9.57394683731881,9.86261347332616,0.466712236834542,30
"6760","MG","Baependi",19199,14385.08,31054,"São Lourenço",3,"Sudeste",1,"310490",5,24,7,17,7,17,0,0,0,0,0,24,7,17,7,17,15,9.57394683731881,9.86261347332616,0.435148384162375,31
"6761","MG","Bambuí",23898,22762.91,31042,"Piuí",3,"Sudeste",1,"310510",2,27,4,23,10,17,0,0,0,0,0,27,4,23,10,17,13,10.0328877359549,10.0815500524097,0.298290045628223,29
"6762","MG","Bambuí",23898,22762.91,31042,"Piuí",3,"Sudeste",1,"310510",3,16,2,14,7,9,0,0,0,0,0,16,2,14,7,9,20,10.0328877359549,10.0815500524097,0.372934010664715,31
"6763","MG","Bambuí",23898,22762.91,31042,"Piuí",3,"Sudeste",1,"310510",4,7,3,4,5,2,0,0,0,0,0,7,3,4,5,2,14,10.0328877359549,10.0815500524097,0.402184029162424,30
"6764","MG","Bambuí",23898,22762.91,31042,"Piuí",3,"Sudeste",1,"310510",5,17,1,16,6,11,0,0,0,0,0,17,1,16,6,11,18,10.0328877359549,10.0815500524097,0.359682532064362,31
"6765","MG","Bandeira do Sul",5778,12754.46,31051,"Poços de Caldas",3,"Sudeste",0,"310530",2,6,1,5,3,3,0,0,0,0,0,6,1,5,3,3,5,9.45363629334101,8.66181288102618,0.317580966750957,29
"6766","MG","Bandeira do Sul",5778,12754.46,31051,"Poços de Caldas",3,"Sudeste",0,"310530",3,5,0,5,3,2,0,0,0,0,0,5,0,5,3,2,3,9.45363629334101,8.66181288102618,0.37927161880945,31
"6767","MG","Bandeira do Sul",5778,12754.46,31051,"Poços de Caldas",3,"Sudeste",0,"310530",4,4,0,4,2,2,0,0,0,0,0,4,0,4,2,2,1,9.45363629334101,8.66181288102618,0.423698694389376,30
"6768","MG","Bandeira do Sul",5778,12754.46,31051,"Poços de Caldas",3,"Sudeste",0,"310530",5,6,2,4,1,5,0,0,0,0,0,6,2,4,1,5,2,9.45363629334101,8.66181288102618,0.373031913677588,31
"6769","MG","Barão de Cocais",32866,25089.36,31031,"Itabira",3,"Sudeste",1,"310540",2,25,5,20,8,17,0,0,0,0,0,25,5,20,8,17,10,10.1301991308645,10.4001939677412,0.313467565245122,29
"6770","MG","Barão de Cocais",32866,25089.36,31031,"Itabira",3,"Sudeste",1,"310540",3,23,6,17,6,17,0,0,0,0,0,23,6,17,6,17,11,10.1301991308645,10.4001939677412,0.393057922349511,31
"6771","MG","Barão de Cocais",32866,25089.36,31031,"Itabira",3,"Sudeste",1,"310540",4,27,8,19,11,16,0,0,0,0,0,27,8,19,11,16,15,10.1301991308645,10.4001939677412,0.442159173886976,30
"6772","MG","Barão de Cocais",32866,25089.36,31031,"Itabira",3,"Sudeste",1,"310540",5,33,5,28,13,20,0,0,0,0,0,33,5,28,13,20,21,10.1301991308645,10.4001939677412,0.412095010231486,31
"6773","MG","Barbacena",138204,20970.96,31059,"Barbacena",3,"Sudeste",1,"310560",2,112,18,94,32,80,2,0,2,0,2,114,18,96,32,82,90,9.95089390253337,11.8364861334569,0.311225448835596,29
"6774","MG","Barbacena",138204,20970.96,31059,"Barbacena",3,"Sudeste",1,"310560",3,97,11,86,30,67,2,1,1,0,2,99,12,87,30,69,77,9.95089390253337,11.8364861334569,0.408336432335354,31
"6775","MG","Barbacena",138204,20970.96,31059,"Barbacena",3,"Sudeste",1,"310560",4,109,13,96,24,85,2,2,0,1,1,111,15,96,25,86,81,9.95089390253337,11.8364861334569,0.463953102637074,30
"6776","MG","Barbacena",138204,20970.96,31059,"Barbacena",3,"Sudeste",1,"310560",5,130,19,111,48,82,3,0,3,2,1,133,19,114,50,83,84,9.95089390253337,11.8364861334569,0.436449534737748,31
"6777","MG","Barroso",20897,19119.33,31059,"Barbacena",3,"Sudeste",1,"310590",2,13,2,11,1,12,0,0,0,0,0,13,2,11,1,12,12,9.85845514415041,9.9473608869801,0.308933573100999,29
"6778","MG","Barroso",20897,19119.33,31059,"Barbacena",3,"Sudeste",1,"310590",3,21,6,15,9,12,0,0,0,0,0,21,6,15,9,12,11,9.85845514415041,9.9473608869801,0.417822468920693,31
"6779","MG","Barroso",20897,19119.33,31059,"Barbacena",3,"Sudeste",1,"310590",4,10,2,8,3,7,0,0,0,0,0,10,2,8,3,7,15,9.85845514415041,9.9473608869801,0.46822501309574,30
"6780","MG","Barroso",20897,19119.33,31059,"Barbacena",3,"Sudeste",1,"310590",5,23,8,15,3,20,0,0,0,0,0,23,8,15,3,20,6,9.85845514415041,9.9473608869801,0.428549874274592,31
"6781","MG","Bela Vista de Minas",10262,24802.97,31031,"Itabira",3,"Sudeste",1,"310600",2,6,1,5,2,4,0,0,0,0,0,6,1,5,2,4,4,10.1187186830472,9.23620303150191,0.343514007359112,29
"6782","MG","Bela Vista de Minas",10262,24802.97,31031,"Itabira",3,"Sudeste",1,"310600",3,6,1,5,2,4,0,0,0,0,0,6,1,5,2,4,4,10.1187186830472,9.23620303150191,0.466457130712936,31
"6783","MG","Bela Vista de Minas",10262,24802.97,31031,"Itabira",3,"Sudeste",1,"310600",4,4,0,4,0,4,0,0,0,0,0,4,0,4,0,4,9,10.1187186830472,9.23620303150191,0.494813897212285,30
"6784","MG","Bela Vista de Minas",10262,24802.97,31031,"Itabira",3,"Sudeste",1,"310600",5,10,1,9,4,6,0,0,0,0,0,10,1,9,4,6,4,10.1187186830472,9.23620303150191,0.442031187458462,31
"6785","MG","Belo Horizonte",2521564,36759.66,31030,"Belo Horizonte",3,"Sudeste",1,"310620",2,1940,217,1723,526,1414,28,8,20,13,15,1968,225,1743,539,1429,1258,10.512156327243,14.740389901894,0.294131000508905,29
"6786","MG","Belo Horizonte",2521564,36759.66,31030,"Belo Horizonte",3,"Sudeste",1,"310620",3,2002,240,1762,569,1433,28,3,25,5,23,2030,243,1787,574,1456,1452,10.512156327243,14.740389901894,0.402797342546468,31
"6787","MG","Belo Horizonte",2521564,36759.66,31030,"Belo Horizonte",3,"Sudeste",1,"310620",4,1941,219,1722,517,1424,31,8,23,14,17,1972,227,1745,531,1441,1235,10.512156327243,14.740389901894,0.478643077593506,30
"6788","MG","Belo Horizonte",2521564,36759.66,31030,"Belo Horizonte",3,"Sudeste",1,"310620",5,2126,233,1893,584,1542,23,2,21,11,12,2149,235,1914,595,1554,1341,10.512156327243,14.740389901894,0.433548813221541,31
"6789","MG","Belo Oriente",26994,64197.42,31039,"Ipatinga",3,"Sudeste",1,"310630",2,15,1,14,7,8,1,0,1,0,1,16,1,15,7,9,17,11.0697183019546,10.2033698980692,0.33939264043906,29
"6790","MG","Belo Oriente",26994,64197.42,31039,"Ipatinga",3,"Sudeste",1,"310630",3,23,2,21,7,16,0,0,0,0,0,23,2,21,7,16,20,11.0697183019546,10.2033698980692,0.427071510068786,31
"6791","MG","Belo Oriente",26994,64197.42,31039,"Ipatinga",3,"Sudeste",1,"310630",4,18,4,14,12,6,0,0,0,0,0,18,4,14,12,6,18,11.0697183019546,10.2033698980692,0.463965679972333,30
"6792","MG","Belo Oriente",26994,64197.42,31039,"Ipatinga",3,"Sudeste",1,"310630",5,19,5,14,7,12,0,0,0,0,0,19,5,14,7,12,11,11.0697183019546,10.2033698980692,0.429044640272853,31
"6793","MG","Betim",444784,58911.58,31030,"Belo Horizonte",3,"Sudeste",1,"310670",2,403,76,327,131,272,1,0,1,0,1,404,76,328,131,273,184,10.9837929547298,13.0053440500485,0.294291582835286,29
"6794","MG","Betim",444784,58911.58,31030,"Belo Horizonte",3,"Sudeste",1,"310670",3,435,66,369,136,299,6,3,3,2,4,441,69,372,138,303,202,10.9837929547298,13.0053440500485,0.385393906595969,31
"6795","MG","Betim",444784,58911.58,31030,"Belo Horizonte",3,"Sudeste",1,"310670",4,435,76,359,148,287,7,0,7,3,4,442,76,366,151,291,168,10.9837929547298,13.0053440500485,0.437977716151386,30
"6796","MG","Betim",444784,58911.58,31030,"Belo Horizonte",3,"Sudeste",1,"310670",5,484,86,398,156,328,5,1,4,2,3,489,87,402,158,331,200,10.9837929547298,13.0053440500485,0.392570128841005,31
"6797","MG","Bicas",14554,17441.5,31065,"Juiz de Fora",3,"Sudeste",1,"310690",2,11,3,8,4,7,0,0,0,0,0,11,3,8,4,7,11,9.76660770293871,9.58562114890703,0.316675610658014,29
"6798","MG","Bicas",14554,17441.5,31065,"Juiz de Fora",3,"Sudeste",1,"310690",3,11,5,6,4,7,0,0,0,0,0,11,5,6,4,7,11,9.76660770293871,9.58562114890703,0.415897437016479,31
"6799","MG","Bicas",14554,17441.5,31065,"Juiz de Fora",3,"Sudeste",1,"310690",4,12,6,6,4,8,0,0,0,0,0,12,6,6,4,8,17,9.76660770293871,9.58562114890703,0.46153246037986,30
"6800","MG","Bicas",14554,17441.5,31065,"Juiz de Fora",3,"Sudeste",1,"310690",5,14,7,7,3,11,0,0,0,0,0,14,7,7,3,11,12,9.76660770293871,9.58562114890703,0.43144590576969,31
"6801","MG","Boa Esperança",40219,20451.28,31050,"Varginha",3,"Sudeste",1,"310710",2,38,10,28,9,29,0,0,0,0,0,38,10,28,9,29,22,9.92580075119921,10.6020947997654,0.292355071891986,29
"6802","MG","Boa Esperança",40219,20451.28,31050,"Varginha",3,"Sudeste",1,"310710",3,41,8,33,18,23,0,0,0,0,0,41,8,33,18,23,38,9.92580075119921,10.6020947997654,0.372033571698789,31
"6803","MG","Boa Esperança",40219,20451.28,31050,"Varginha",3,"Sudeste",1,"310710",4,30,5,25,15,15,0,0,0,0,0,30,5,25,15,15,17,9.92580075119921,10.6020947997654,0.413586973761775,30
"6804","MG","Boa Esperança",40219,20451.28,31050,"Varginha",3,"Sudeste",1,"310710",5,43,9,34,17,26,0,0,0,0,0,43,9,34,17,26,31,9.92580075119921,10.6020947997654,0.383855428781414,31
"6805","MG","Bocaiúva",50256,16896.06,31009,"Bocaiúva",3,"Sudeste",1,"310730",2,50,11,39,15,35,2,0,2,1,1,52,11,41,16,36,16,9.73483573763605,10.8248852217784,0.281846490377769,29
"6806","MG","Bocaiúva",50256,16896.06,31009,"Bocaiúva",3,"Sudeste",1,"310730",3,41,8,33,19,22,0,0,0,0,0,41,8,33,19,22,23,9.73483573763605,10.8248852217784,0.359397811197891,31
"6807","MG","Bocaiúva",50256,16896.06,31009,"Bocaiúva",3,"Sudeste",1,"310730",4,33,5,28,8,25,0,0,0,0,0,33,5,28,8,25,30,9.73483573763605,10.8248852217784,0.39533102553684,30
"6808","MG","Bocaiúva",50256,16896.06,31009,"Bocaiúva",3,"Sudeste",1,"310730",5,56,12,44,25,31,0,0,0,0,0,56,12,44,25,31,28,9.73483573763605,10.8248852217784,0.37260492896042,31
"6809","MG","Bom Despacho",51028,26205.17,31026,"Bom Despacho",3,"Sudeste",1,"310740",2,41,7,34,13,28,0,0,0,0,0,41,7,34,13,28,30,10.1737119985268,10.8401297806582,0.297182043195533,29
"6810","MG","Bom Despacho",51028,26205.17,31026,"Bom Despacho",3,"Sudeste",1,"310740",3,53,17,36,19,34,0,0,0,0,0,53,17,36,19,34,34,10.1737119985268,10.8401297806582,0.375920952367097,31
"6811","MG","Bom Despacho",51028,26205.17,31026,"Bom Despacho",3,"Sudeste",1,"310740",4,49,12,37,16,33,0,0,0,0,0,49,12,37,16,33,25,10.1737119985268,10.8401297806582,0.414432273195971,30
"6812","MG","Bom Despacho",51028,26205.17,31026,"Bom Despacho",3,"Sudeste",1,"310740",5,55,20,35,17,38,0,0,0,0,0,55,20,35,17,38,42,10.1737119985268,10.8401297806582,0.368954256762869,31
"6813","MG","Bom Jardim de Minas",6459,16680.23,31055,"Andrelândia",3,"Sudeste",0,"310750",2,2,1,1,1,1,0,0,0,0,0,2,1,1,1,1,2,9.7219794647865,8.77322978603247,0.316486617658698,29
"6814","MG","Bom Jardim de Minas",6459,16680.23,31055,"Andrelândia",3,"Sudeste",0,"310750",3,1,0,1,0,1,0,0,0,0,0,1,0,1,0,1,7,9.7219794647865,8.77322978603247,0.424651291171287,31
"6815","MG","Bom Jardim de Minas",6459,16680.23,31055,"Andrelândia",3,"Sudeste",0,"310750",4,5,1,4,1,4,0,0,0,0,0,5,1,4,1,4,5,9.7219794647865,8.77322978603247,0.517332482591652,30
"6816","MG","Bom Jardim de Minas",6459,16680.23,31055,"Andrelândia",3,"Sudeste",0,"310750",5,8,1,7,5,3,0,0,0,0,0,8,1,7,5,3,1,9.7219794647865,8.77322978603247,0.459284164547946,31
"6817","MG","Bom Jesus do Galho",14862,10095.97,31040,"Caratinga",3,"Sudeste",0,"310780",2,12,3,9,5,7,0,0,0,0,0,12,3,9,5,7,8,9.21989161330273,9.60656289871742,0.369806911998356,29
"6818","MG","Bom Jesus do Galho",14862,10095.97,31040,"Caratinga",3,"Sudeste",0,"310780",3,15,5,10,7,8,0,0,0,0,0,15,5,10,7,8,6,9.21989161330273,9.60656289871742,0.454907928081894,31
"6819","MG","Bom Jesus do Galho",14862,10095.97,31040,"Caratinga",3,"Sudeste",0,"310780",4,19,7,12,10,9,0,0,0,0,0,19,7,12,10,9,11,9.21989161330273,9.60656289871742,0.430833630654401,30
"6820","MG","Bom Jesus do Galho",14862,10095.97,31040,"Caratinga",3,"Sudeste",0,"310780",5,9,4,5,5,4,1,0,1,1,0,10,4,6,6,4,13,9.21989161330273,9.60656289871742,0.441415006135397,31
"6821","MG","Bom Repouso",10537,11751.22,31052,"Pouso Alegre",3,"Sudeste",0,"310790",2,9,5,4,4,5,0,0,0,0,0,9,5,4,4,5,6,9.3717123439696,9.26264815159953,0.326365994123847,29
"6822","MG","Bom Repouso",10537,11751.22,31052,"Pouso Alegre",3,"Sudeste",0,"310790",3,9,6,3,3,6,0,0,0,0,0,9,6,3,3,6,7,9.3717123439696,9.26264815159953,0.392234798451357,31
"6823","MG","Bom Repouso",10537,11751.22,31052,"Pouso Alegre",3,"Sudeste",0,"310790",4,16,9,7,8,8,1,0,1,0,1,17,9,8,8,9,5,9.3717123439696,9.26264815159953,0.397317748317871,30
"6824","MG","Bom Repouso",10537,11751.22,31052,"Pouso Alegre",3,"Sudeste",0,"310790",5,9,4,5,4,5,0,0,0,0,0,9,4,5,4,5,9,9.3717123439696,9.26264815159953,0.398401505986858,31
"6825","MG","Bom Sucesso",17607,16038.21,31046,"Oliveira",3,"Sudeste",1,"310800",2,9,1,8,4,5,0,0,0,0,0,9,1,8,4,5,21,9.68272927918323,9.77605182922644,0.298618444370658,29
"6826","MG","Bom Sucesso",17607,16038.21,31046,"Oliveira",3,"Sudeste",1,"310800",3,7,1,6,1,6,0,0,0,0,0,7,1,6,1,6,12,9.68272927918323,9.77605182922644,0.375415172985738,31
"6827","MG","Bom Sucesso",17607,16038.21,31046,"Oliveira",3,"Sudeste",1,"310800",4,12,2,10,5,7,0,0,0,0,0,12,2,10,5,7,14,9.68272927918323,9.77605182922644,0.393980200266967,30
"6828","MG","Bom Sucesso",17607,16038.21,31046,"Oliveira",3,"Sudeste",1,"310800",5,15,4,11,7,8,0,0,0,0,0,15,4,11,7,8,14,9.68272927918323,9.77605182922644,0.373472265046574,31
"6829","MG","Bonfim",6860,13055.7,31032,"Itaguara",3,"Sudeste",0,"310810",2,3,0,3,1,2,0,0,0,0,0,3,0,3,1,2,6,9.47698009899871,8.83346272071993,0.296271155433034,29
"6830","MG","Bonfim",6860,13055.7,31032,"Itaguara",3,"Sudeste",0,"310810",3,3,0,3,2,1,0,0,0,0,0,3,0,3,2,1,1,9.47698009899871,8.83346272071993,0.363100193107967,31
"6831","MG","Bonfim",6860,13055.7,31032,"Itaguara",3,"Sudeste",0,"310810",4,1,0,1,0,1,0,0,0,0,0,1,0,1,0,1,2,9.47698009899871,8.83346272071993,0.400620921650374,30
"6832","MG","Bonfim",6860,13055.7,31032,"Itaguara",3,"Sudeste",0,"310810",5,3,0,3,2,1,0,0,0,0,0,3,0,3,2,1,1,9.47698009899871,8.83346272071993,0.388103451226865,31
"6833","MG","Bonfinópolis de Minas",5444,35159.24,31001,"Unaí",3,"Sudeste",0,"310820",2,6,3,3,3,3,0,0,0,0,0,6,3,3,3,3,2,10.4676427360934,8.60226936377136,0.263150447464821,29
"6834","MG","Bonfinópolis de Minas",5444,35159.24,31001,"Unaí",3,"Sudeste",0,"310820",3,4,0,4,4,0,0,0,0,0,0,4,0,4,4,0,1,10.4676427360934,8.60226936377136,0.358780388770005,31
"6835","MG","Bonfinópolis de Minas",5444,35159.24,31001,"Unaí",3,"Sudeste",0,"310820",4,3,1,2,1,2,0,0,0,0,0,3,1,2,1,2,4,10.4676427360934,8.60226936377136,0.382231799764397,30
"6836","MG","Bonfinópolis de Minas",5444,35159.24,31001,"Unaí",3,"Sudeste",0,"310820",5,1,0,1,0,1,0,0,0,0,0,1,0,1,0,1,3,10.4676427360934,8.60226936377136,0.345183232365504,31
"6837","MG","Borda da Mata",19614,15837.66,31052,"Pouso Alegre",3,"Sudeste",0,"310830",2,10,2,8,4,6,0,0,0,0,0,10,2,8,4,6,8,9.67014592718294,9.88399887595227,0.296049848172997,29
"6838","MG","Borda da Mata",19614,15837.66,31052,"Pouso Alegre",3,"Sudeste",0,"310830",3,5,0,5,2,3,0,0,0,0,0,5,0,5,2,3,16,9.67014592718294,9.88399887595227,0.385388410743047,31
"6839","MG","Borda da Mata",19614,15837.66,31052,"Pouso Alegre",3,"Sudeste",0,"310830",4,6,1,5,0,6,0,0,0,0,0,6,1,5,0,6,9,9.67014592718294,9.88399887595227,0.410345622849067,30
"6840","MG","Borda da Mata",19614,15837.66,31052,"Pouso Alegre",3,"Sudeste",0,"310830",5,15,3,12,7,8,0,0,0,0,0,15,3,12,7,8,17,9.67014592718294,9.88399887595227,0.372155550106288,31
"6841","MG","Botelhos",14949,15242.62,31051,"Poços de Caldas",3,"Sudeste",0,"310840",2,13,1,12,5,8,0,0,0,0,0,13,1,12,5,8,8,9.63185073047527,9.61239968694951,0.328826803501986,29
"6842","MG","Botelhos",14949,15242.62,31051,"Poços de Caldas",3,"Sudeste",0,"310840",3,6,3,3,4,2,0,0,0,0,0,6,3,3,4,2,10,9.63185073047527,9.61239968694951,0.436105422726225,31
"6843","MG","Botelhos",14949,15242.62,31051,"Poços de Caldas",3,"Sudeste",0,"310840",4,13,2,11,6,7,0,0,0,0,0,13,2,11,6,7,14,9.63185073047527,9.61239968694951,0.475993420896209,30
"6844","MG","Botelhos",14949,15242.62,31051,"Poços de Caldas",3,"Sudeste",0,"310840",5,10,1,9,4,6,0,0,0,0,0,10,1,9,4,6,14,9.63185073047527,9.61239968694951,0.433315676315222,31
"6845","MG","Brasilândia de Minas",16748,15956.54,31002,"Paracatu",3,"Sudeste",1,"310855",2,12,4,8,7,5,0,0,0,0,0,12,4,8,7,5,5,9.67762405552107,9.72603412713903,0.320028577456414,29
"6846","MG","Brasilândia de Minas",16748,15956.54,31002,"Paracatu",3,"Sudeste",1,"310855",3,24,5,19,13,11,0,0,0,0,0,24,5,19,13,11,5,9.67762405552107,9.72603412713903,0.378483705223024,31
"6847","MG","Brasilândia de Minas",16748,15956.54,31002,"Paracatu",3,"Sudeste",1,"310855",4,17,1,16,4,13,0,0,0,0,0,17,1,16,4,13,7,9.67762405552107,9.72603412713903,0.379756283247118,30
"6848","MG","Brasilândia de Minas",16748,15956.54,31002,"Paracatu",3,"Sudeste",1,"310855",5,19,5,14,10,9,0,0,0,0,0,19,5,14,10,9,3,9.67762405552107,9.72603412713903,0.362912015925811,31
"6849","MG","Brasília de Minas",32405,9564.25,31007,"Montes Claros",3,"Sudeste",0,"310860",2,43,7,36,13,30,0,0,0,0,0,43,7,36,13,30,17,9.16578746792709,10.3860680108618,0.287238439163837,29
"6850","MG","Brasília de Minas",32405,9564.25,31007,"Montes Claros",3,"Sudeste",0,"310860",3,28,7,21,8,20,1,0,1,0,1,29,7,22,8,21,22,9.16578746792709,10.3860680108618,0.381894701430123,31
"6851","MG","Brasília de Minas",32405,9564.25,31007,"Montes Claros",3,"Sudeste",0,"310860",4,28,9,19,4,24,0,0,0,0,0,28,9,19,4,24,21,9.16578746792709,10.3860680108618,0.446404337562748,30
"6852","MG","Brasília de Minas",32405,9564.25,31007,"Montes Claros",3,"Sudeste",0,"310860",5,46,8,38,17,29,0,0,0,0,0,46,8,38,17,29,20,9.16578746792709,10.3860680108618,0.393147081585972,31
"6853","MG","Brazópolis",14410,11729.62,31056,"Itajubá",3,"Sudeste",0,"310890",2,17,6,11,5,12,0,0,0,0,0,17,6,11,5,12,8,9.36987254555585,9.57567768899357,0.358528533156166,29
"6854","MG","Brazópolis",14410,11729.62,31056,"Itajubá",3,"Sudeste",0,"310890",3,14,7,7,6,8,0,0,0,0,0,14,7,7,6,8,12,9.36987254555585,9.57567768899357,0.447787872148813,31
"6855","MG","Brazópolis",14410,11729.62,31056,"Itajubá",3,"Sudeste",0,"310890",4,12,3,9,3,9,0,0,0,0,0,12,3,9,3,9,7,9.36987254555585,9.57567768899357,0.476628262642083,30
"6856","MG","Brazópolis",14410,11729.62,31056,"Itajubá",3,"Sudeste",0,"310890",5,19,5,14,4,15,1,1,0,0,1,20,6,14,4,16,16,9.36987254555585,9.57567768899357,0.456112712551334,31
"6857","MG","Brumadinho",40666,65381.46,31030,"Belo Horizonte",3,"Sudeste",1,"310900",2,29,7,22,9,20,0,0,0,0,0,29,7,22,9,20,22,11.0879940110169,10.6131476414703,0.297188529474767,29
"6858","MG","Brumadinho",40666,65381.46,31030,"Belo Horizonte",3,"Sudeste",1,"310900",3,40,8,32,12,28,0,0,0,0,0,40,8,32,12,28,20,11.0879940110169,10.6131476414703,0.385015307269246,31
"6859","MG","Brumadinho",40666,65381.46,31030,"Belo Horizonte",3,"Sudeste",1,"310900",4,27,5,22,7,20,0,0,0,0,0,27,5,22,7,20,13,11.0879940110169,10.6131476414703,0.428995840590365,30
"6860","MG","Brumadinho",40666,65381.46,31030,"Belo Horizonte",3,"Sudeste",1,"310900",5,55,15,40,20,35,1,0,1,0,1,56,15,41,20,36,22,11.0879940110169,10.6131476414703,0.399155329983409,31
"6861","MG","Bueno Brandão",10991,13699.9,31052,"Pouso Alegre",3,"Sudeste",0,"310910",2,6,0,6,2,4,0,0,0,0,0,6,0,6,2,4,5,9.5251438125195,9.3048320350689,0.324371918387302,29
"6862","MG","Bueno Brandão",10991,13699.9,31052,"Pouso Alegre",3,"Sudeste",0,"310910",3,9,4,5,1,8,0,0,0,0,0,9,4,5,1,8,6,9.5251438125195,9.3048320350689,0.410123424384647,31
"6863","MG","Bueno Brandão",10991,13699.9,31052,"Pouso Alegre",3,"Sudeste",0,"310910",4,10,6,4,2,8,0,0,0,0,0,10,6,4,2,8,6,9.5251438125195,9.3048320350689,0.409169605499904,30
"6864","MG","Bueno Brandão",10991,13699.9,31052,"Pouso Alegre",3,"Sudeste",0,"310910",5,8,4,4,0,8,0,0,0,0,0,8,4,4,0,8,10,9.5251438125195,9.3048320350689,0.395391071852427,31
"6865","MG","Buenópolis",10353,11826.04,31025,"Curvelo",3,"Sudeste",0,"310920",2,9,2,7,4,5,0,0,0,0,0,9,2,7,4,5,6,9.37805915875287,9.24503161176611,0.267907705022469,29
"6866","MG","Buenópolis",10353,11826.04,31025,"Curvelo",3,"Sudeste",0,"310920",3,8,0,8,7,1,0,0,0,0,0,8,0,8,7,1,2,9.37805915875287,9.24503161176611,0.34076612270828,31
"6867","MG","Buenópolis",10353,11826.04,31025,"Curvelo",3,"Sudeste",0,"310920",4,10,4,6,5,5,0,0,0,0,0,10,4,6,5,5,1,9.37805915875287,9.24503161176611,0.357519340179676,30
"6868","MG","Buenópolis",10353,11826.04,31025,"Curvelo",3,"Sudeste",0,"310920",5,7,2,5,5,2,0,0,0,0,0,7,2,5,5,2,6,9.37805915875287,9.24503161176611,0.352202178280896,31
"6869","MG","Buritis",25013,32657.62,31001,"Unaí",3,"Sudeste",0,"310930",2,22,6,16,13,9,0,0,0,0,0,22,6,16,13,9,14,10.3938334918545,10.1271509686972,0.275653292465402,29
"6870","MG","Buritis",25013,32657.62,31001,"Unaí",3,"Sudeste",0,"310930",3,22,9,13,11,11,0,0,0,0,0,22,9,13,11,11,14,10.3938334918545,10.1271509686972,0.366579680291359,31
"6871","MG","Buritis",25013,32657.62,31001,"Unaí",3,"Sudeste",0,"310930",4,36,8,28,16,20,1,1,0,0,1,37,9,28,16,21,5,10.3938334918545,10.1271509686972,0.370089861601783,30
"6872","MG","Buritis",25013,32657.62,31001,"Unaí",3,"Sudeste",0,"310930",5,25,4,21,12,13,1,1,0,1,0,26,5,21,13,13,9,10.3938334918545,10.1271509686972,0.359999611584583,31
"6873","MG","Buritizeiro",28121,15521.68,31006,"Pirapora",3,"Sudeste",1,"310940",2,19,8,11,10,9,0,0,0,0,0,19,8,11,10,9,15,9.64999303530156,10.24427190717,0.313108611336997,29
"6874","MG","Buritizeiro",28121,15521.68,31006,"Pirapora",3,"Sudeste",1,"310940",3,19,6,13,8,11,1,0,1,1,0,20,6,14,9,11,9,9.64999303530156,10.24427190717,0.370233657258832,31
"6875","MG","Buritizeiro",28121,15521.68,31006,"Pirapora",3,"Sudeste",1,"310940",4,21,9,12,8,13,0,0,0,0,0,21,9,12,8,13,8,9.64999303530156,10.24427190717,0.399605540310946,30
"6876","MG","Buritizeiro",28121,15521.68,31006,"Pirapora",3,"Sudeste",1,"310940",5,31,9,22,20,11,0,0,0,0,0,31,9,22,20,11,8,9.64999303530156,10.24427190717,0.402451834125285,31
"6877","MG","Cabeceira Grande",6988,44075.37,31001,"Unaí",3,"Sudeste",0,"310945",2,5,2,3,3,2,0,0,0,0,0,5,2,3,3,2,4,10.6936564020125,8.85194967125395,0.311571562740942,29
"6878","MG","Cabeceira Grande",6988,44075.37,31001,"Unaí",3,"Sudeste",0,"310945",3,5,1,4,1,4,0,0,0,0,0,5,1,4,1,4,2,10.6936564020125,8.85194967125395,0.428702792405164,31
"6879","MG","Cabeceira Grande",6988,44075.37,31001,"Unaí",3,"Sudeste",0,"310945",4,4,2,2,1,3,0,0,0,0,0,4,2,2,1,3,3,10.6936564020125,8.85194967125395,0.452539137270275,30
"6880","MG","Cabeceira Grande",6988,44075.37,31001,"Unaí",3,"Sudeste",0,"310945",5,3,0,3,2,1,0,0,0,0,0,3,0,3,2,1,2,10.6936564020125,8.85194967125395,0.420777865285426,31
"6881","MG","Cabo Verde",14075,13726.1,31048,"São Sebastião do Paraíso",3,"Sudeste",0,"310950",2,9,1,8,5,4,0,0,0,0,0,9,1,8,5,4,11,9.52705440888572,9.55215545300789,0.280057765068935,29
"6882","MG","Cabo Verde",14075,13726.1,31048,"São Sebastião do Paraíso",3,"Sudeste",0,"310950",3,9,1,8,2,7,0,0,0,0,0,9,1,8,2,7,7,9.52705440888572,9.55215545300789,0.376171646545986,31
"6883","MG","Cabo Verde",14075,13726.1,31048,"São Sebastião do Paraíso",3,"Sudeste",0,"310950",4,13,2,11,7,6,0,0,0,0,0,13,2,11,7,6,9,9.52705440888572,9.55215545300789,0.389744583126515,30
"6884","MG","Cabo Verde",14075,13726.1,31048,"São Sebastião do Paraíso",3,"Sudeste",0,"310950",5,9,4,5,6,3,0,0,0,0,0,9,4,5,6,3,12,9.52705440888572,9.55215545300789,0.360574748072963,31
"6885","MG","Cachoeira de Minas",11579,24207.36,31053,"Santa Rita do Sapucaí",3,"Sudeste",0,"310970",2,8,3,5,3,5,0,0,0,0,0,8,3,5,3,5,6,10.0944119981373,9.35694839161227,0.308282717959535,29
"6886","MG","Cachoeira de Minas",11579,24207.36,31053,"Santa Rita do Sapucaí",3,"Sudeste",0,"310970",3,9,1,8,3,6,0,0,0,0,0,9,1,8,3,6,5,10.0944119981373,9.35694839161227,0.399034095401884,31
"6887","MG","Cachoeira de Minas",11579,24207.36,31053,"Santa Rita do Sapucaí",3,"Sudeste",0,"310970",4,11,0,11,3,8,0,0,0,0,0,11,0,11,3,8,7,10.0944119981373,9.35694839161227,0.445059846700873,30
"6888","MG","Cachoeira de Minas",11579,24207.36,31053,"Santa Rita do Sapucaí",3,"Sudeste",0,"310970",5,12,3,9,5,7,0,0,0,0,0,12,3,9,5,7,6,10.0944119981373,9.35694839161227,0.402013465613087,31
"6889","MG","Caetanópolis",11749,22082.57,31027,"Sete Lagoas",3,"Sudeste",1,"310990",2,5,0,5,2,3,0,0,0,0,0,5,0,5,2,3,7,10.0025438885452,9.37152340956757,0.294677420456827,29
"6890","MG","Caetanópolis",11749,22082.57,31027,"Sete Lagoas",3,"Sudeste",1,"310990",3,2,0,2,2,0,0,0,0,0,0,2,0,2,2,0,2,10.0025438885452,9.37152340956757,0.36461456352597,31
"6891","MG","Caetanópolis",11749,22082.57,31027,"Sete Lagoas",3,"Sudeste",1,"310990",4,0,0,0,0,0,0,0,0,0,0,0,0,0,0,0,12,10.0025438885452,9.37152340956757,0.408037549198506,30
"6892","MG","Caetanópolis",11749,22082.57,31027,"Sete Lagoas",3,"Sudeste",1,"310990",5,0,0,0,0,0,0,0,0,0,0,0,0,0,0,0,7,10.0025438885452,9.37152340956757,0.409882332582073,31
"6893","MG","Caeté",45047,13417.84,31030,"Belo Horizonte",3,"Sudeste",1,"311000",2,33,5,28,13,20,0,0,0,0,0,33,5,28,13,20,15,9.50434044377092,10.7154616681443,0.295505624340856,29
"6894","MG","Caeté",45047,13417.84,31030,"Belo Horizonte",3,"Sudeste",1,"311000",3,32,3,29,14,18,0,0,0,0,0,32,3,29,14,18,24,9.50434044377092,10.7154616681443,0.381265656811467,31
"6895","MG","Caeté",45047,13417.84,31030,"Belo Horizonte",3,"Sudeste",1,"311000",4,30,4,26,10,20,0,0,0,0,0,30,4,26,10,20,17,9.50434044377092,10.7154616681443,0.428416319619217,30
"6896","MG","Caeté",45047,13417.84,31030,"Belo Horizonte",3,"Sudeste",1,"311000",5,30,3,27,8,22,0,0,0,0,0,30,3,27,8,22,17,9.50434044377092,10.7154616681443,0.399832125935006,31
"6897","MG","Caldas",14541,16405.53,31051,"Poços de Caldas",3,"Sudeste",0,"311030",2,8,2,6,4,4,0,0,0,0,0,8,2,6,4,4,4,9.70537375209674,9.58472752451349,0.298617607660197,29
"6898","MG","Caldas",14541,16405.53,31051,"Poços de Caldas",3,"Sudeste",0,"311030",3,9,1,8,3,6,0,0,0,0,0,9,1,8,3,6,12,9.70537375209674,9.58472752451349,0.388753213630398,31
"6899","MG","Caldas",14541,16405.53,31051,"Poços de Caldas",3,"Sudeste",0,"311030",4,5,2,3,3,2,0,0,0,0,0,5,2,3,3,2,7,9.70537375209674,9.58472752451349,0.423743610458755,30
"6900","MG","Caldas",14541,16405.53,31051,"Poços de Caldas",3,"Sudeste",0,"311030",5,10,6,4,5,5,0,0,0,0,0,10,6,4,5,5,11,9.70537375209674,9.58472752451349,0.364028063640338,31
"6901","MG","Camanducaia",21801,25876.92,31052,"Pouso Alegre",3,"Sudeste",0,"311050",2,19,6,13,9,10,0,0,0,0,0,19,6,13,9,10,16,10.1611067307133,9.98971111928475,0.309518935030664,29
"6902","MG","Camanducaia",21801,25876.92,31052,"Pouso Alegre",3,"Sudeste",0,"311050",3,23,5,18,8,15,1,1,0,1,0,24,6,18,9,15,13,10.1611067307133,9.98971111928475,0.412226512047211,31
"6903","MG","Camanducaia",21801,25876.92,31052,"Pouso Alegre",3,"Sudeste",0,"311050",4,17,3,14,10,7,0,0,0,0,0,17,3,14,10,7,15,10.1611067307133,9.98971111928475,0.471644949637281,30
"6904","MG","Camanducaia",21801,25876.92,31052,"Pouso Alegre",3,"Sudeste",0,"311050",5,15,7,8,5,10,0,0,0,0,0,15,7,8,5,10,17,10.1611067307133,9.98971111928475,0.468581578435209,31
"6905","MG","Cambuí",29814,39584.67,31052,"Pouso Alegre",3,"Sudeste",0,"311060",2,29,5,24,6,23,0,0,0,0,0,29,5,24,6,23,17,10.5861972010797,10.3027333608304,0.309877090227785,29
"6906","MG","Cambuí",29814,39584.67,31052,"Pouso Alegre",3,"Sudeste",0,"311060",3,19,2,17,9,10,0,0,0,0,0,19,2,17,9,10,15,10.5861972010797,10.3027333608304,0.403889707081412,31
"6907","MG","Cambuí",29814,39584.67,31052,"Pouso Alegre",3,"Sudeste",0,"311060",4,18,4,14,7,11,1,0,1,1,0,19,4,15,8,11,15,10.5861972010797,10.3027333608304,0.434293185402587,30
"6908","MG","Cambuí",29814,39584.67,31052,"Pouso Alegre",3,"Sudeste",0,"311060",5,24,3,21,9,15,0,0,0,0,0,24,3,21,9,15,21,10.5861972010797,10.3027333608304,0.415898169007106,31
"6909","MG","Cambuquira",12812,18411.33,31054,"São Lourenço",3,"Sudeste",0,"311070",2,11,2,9,4,7,0,0,0,0,0,11,2,9,4,7,12,9.82072151496371,9.45813751072905,0.318414746966098,29
"6910","MG","Cambuquira",12812,18411.33,31054,"São Lourenço",3,"Sudeste",0,"311070",3,11,3,8,4,7,0,0,0,0,0,11,3,8,4,7,15,9.82072151496371,9.45813751072905,0.423109975914935,31
"6911","MG","Cambuquira",12812,18411.33,31054,"São Lourenço",3,"Sudeste",0,"311070",4,7,1,6,5,2,0,0,0,0,0,7,1,6,5,2,11,9.82072151496371,9.45813751072905,0.443135739181823,30
"6912","MG","Cambuquira",12812,18411.33,31054,"São Lourenço",3,"Sudeste",0,"311070",5,16,2,14,9,7,0,0,0,0,0,16,2,14,9,7,9,9.82072151496371,9.45813751072905,0.424849576946372,31
"6913","MG","Campanha",16762,19019.38,31050,"Varginha",3,"Sudeste",0,"311090",2,12,3,9,6,6,0,0,0,0,0,12,3,9,6,6,10,9.85321373830204,9.72686969865885,0.285913795873398,29
"6914","MG","Campanha",16762,19019.38,31050,"Varginha",3,"Sudeste",0,"311090",3,17,2,15,7,10,0,0,0,0,0,17,2,15,7,10,15,9.85321373830204,9.72686969865885,0.355754540143456,31
"6915","MG","Campanha",16762,19019.38,31050,"Varginha",3,"Sudeste",0,"311090",4,10,2,8,2,8,0,0,0,0,0,10,2,8,2,8,7,9.85321373830204,9.72686969865885,0.375986211480888,30
"6916","MG","Campanha",16762,19019.38,31050,"Varginha",3,"Sudeste",0,"311090",5,18,5,13,10,8,0,0,0,0,0,18,5,13,10,8,11,9.85321373830204,9.72686969865885,0.337754238757453,31
"6917","MG","Campestre",21054,15634.91,31051,"Poços de Caldas",3,"Sudeste",0,"311100",2,12,6,6,3,9,0,0,0,0,0,12,6,6,3,9,17,9.65726151355942,9.95484584481127,0.284850694673124,29
"6918","MG","Campestre",21054,15634.91,31051,"Poços de Caldas",3,"Sudeste",0,"311100",3,14,3,11,3,11,0,0,0,0,0,14,3,11,3,11,13,9.65726151355942,9.95484584481127,0.364003686482906,31
"6919","MG","Campestre",21054,15634.91,31051,"Poços de Caldas",3,"Sudeste",0,"311100",4,14,10,4,4,10,0,0,0,0,0,14,10,4,4,10,5,9.65726151355942,9.95484584481127,0.421103142862714,30
"6920","MG","Campestre",21054,15634.91,31051,"Poços de Caldas",3,"Sudeste",0,"311100",5,18,7,11,9,9,0,0,0,0,0,18,7,11,9,9,9,9.65726151355942,9.95484584481127,0.396657192417775,31
"6921","MG","Campina Verde",19752,26023.14,31021,"Frutal",3,"Sudeste",0,"311110",2,11,1,10,4,7,0,0,0,0,0,11,1,10,4,7,13,10.1667414211885,9.89101003102502,0.279362552103533,29
"6922","MG","Campina Verde",19752,26023.14,31021,"Frutal",3,"Sudeste",0,"311110",3,11,4,7,6,5,0,0,0,0,0,11,4,7,6,5,18,10.1667414211885,9.89101003102502,0.345086555453319,31
"6923","MG","Campina Verde",19752,26023.14,31021,"Frutal",3,"Sudeste",0,"311110",4,10,1,9,1,9,0,0,0,0,0,10,1,9,1,9,11,10.1667414211885,9.89101003102502,0.37515607480705,30
"6924","MG","Campina Verde",19752,26023.14,31021,"Frutal",3,"Sudeste",0,"311110",5,12,2,10,3,9,0,0,0,0,0,12,2,10,3,9,5,10.1667414211885,9.89101003102502,0.375247017626953,31
"6925","MG","Campo Belo",54186,19088.69,31045,"Campo Belo",3,"Sudeste",1,"311120",2,38,9,29,10,28,0,0,0,0,0,38,9,29,10,28,44,9.85685129204983,10.9001778514789,0.287500958370607,29
"6926","MG","Campo Belo",54186,19088.69,31045,"Campo Belo",3,"Sudeste",1,"311120",3,42,12,30,18,24,0,0,0,0,0,42,12,30,18,24,49,9.85685129204983,10.9001778514789,0.386305205744821,31
"6927","MG","Campo Belo",54186,19088.69,31045,"Campo Belo",3,"Sudeste",1,"311120",4,50,10,40,20,30,1,0,1,0,1,51,10,41,20,31,26,9.85685129204983,10.9001778514789,0.402323684035982,30
"6928","MG","Campo Belo",54186,19088.69,31045,"Campo Belo",3,"Sudeste",1,"311120",5,61,18,43,21,40,1,0,1,0,1,62,18,44,21,41,33,9.85685129204983,10.9001778514789,0.349905848005462,31
"6929","MG","Campo do Meio",11651,14629.8,31050,"Varginha",3,"Sudeste",0,"311130",2,10,4,6,4,6,0,0,0,0,0,10,4,6,4,6,9,9.59081582338074,9.36314729221994,0.348185365500283,29
"6930","MG","Campo do Meio",11651,14629.8,31050,"Varginha",3,"Sudeste",0,"311130",3,14,2,12,3,11,0,0,0,0,0,14,2,12,3,11,13,9.59081582338074,9.36314729221994,0.419065170878608,31
"6931","MG","Campo do Meio",11651,14629.8,31050,"Varginha",3,"Sudeste",0,"311130",4,10,2,8,5,5,0,0,0,0,0,10,2,8,5,5,6,9.59081582338074,9.36314729221994,0.399099759414182,30
"6932","MG","Campo do Meio",11651,14629.8,31050,"Varginha",3,"Sudeste",0,"311130",5,11,1,10,5,6,0,0,0,0,0,11,1,10,5,6,8,9.59081582338074,9.36314729221994,0.37702694052238,31
"6933","MG","Campo Florido",8269,62765.31,31022,"Uberaba",3,"Sudeste",0,"311140",2,13,4,9,2,11,0,0,0,0,0,13,4,9,2,11,7,11.0471578112985,9.02026886172217,0.330102785053874,29
"6934","MG","Campo Florido",8269,62765.31,31022,"Uberaba",3,"Sudeste",0,"311140",3,6,1,5,2,4,0,0,0,0,0,6,1,5,2,4,1,11.0471578112985,9.02026886172217,0.41558777827182,31
"6935","MG","Campo Florido",8269,62765.31,31022,"Uberaba",3,"Sudeste",0,"311140",4,9,2,7,4,5,0,0,0,0,0,9,2,7,4,5,1,11.0471578112985,9.02026886172217,0.414342886631137,30
"6936","MG","Campo Florido",8269,62765.31,31022,"Uberaba",3,"Sudeste",0,"311140",5,10,2,8,5,5,0,0,0,0,0,10,2,8,5,5,4,11.0471578112985,9.02026886172217,0.405126949801225,31
"6937","MG","Campos Altos",15563,20257.03,31023,"Araxá",3,"Sudeste",1,"311150",2,12,4,8,5,7,0,0,0,0,0,12,4,8,5,7,2,9.91625717278225,9.65265158120501,0.352376292020052,29
"6938","MG","Campos Altos",15563,20257.03,31023,"Araxá",3,"Sudeste",1,"311150",3,8,2,6,4,4,0,0,0,0,0,8,2,6,4,4,9,9.91625717278225,9.65265158120501,0.42157440856177,31
"6939","MG","Campos Altos",15563,20257.03,31023,"Araxá",3,"Sudeste",1,"311150",4,12,4,8,8,4,0,0,0,0,0,12,4,8,8,4,7,9.91625717278225,9.65265158120501,0.447169346488993,30
"6940","MG","Campos Altos",15563,20257.03,31023,"Araxá",3,"Sudeste",1,"311150",5,20,5,15,8,12,0,0,0,0,0,20,5,15,8,12,6,9.91625717278225,9.65265158120501,0.449926836587871,31
"6941","MG","Campos Gerais",28842,16504.82,31050,"Varginha",3,"Sudeste",0,"311160",2,30,12,18,12,18,0,0,0,0,0,30,12,18,12,18,16,9.7114077384417,10.269587937122,0.309220870897359,29
"6942","MG","Campos Gerais",28842,16504.82,31050,"Varginha",3,"Sudeste",0,"311160",3,24,4,20,10,14,1,0,1,0,1,25,4,21,10,15,14,9.7114077384417,10.269587937122,0.372521773414362,31
"6943","MG","Campos Gerais",28842,16504.82,31050,"Varginha",3,"Sudeste",0,"311160",4,30,4,26,6,24,0,0,0,0,0,30,4,26,6,24,13,9.7114077384417,10.269587937122,0.397911605388901,30
"6944","MG","Campos Gerais",28842,16504.82,31050,"Varginha",3,"Sudeste",0,"311160",5,24,9,15,14,10,0,0,0,0,0,24,9,15,14,10,19,9.7114077384417,10.269587937122,0.376697370694339,31
"6945","MG","Canápolis",12201,28651.44,31018,"Uberlândia",3,"Sudeste",1,"311180",2,10,1,9,5,5,0,0,0,0,0,10,1,9,5,5,6,10.2629589826599,9.40927319457533,0.299845036256755,29
"6946","MG","Canápolis",12201,28651.44,31018,"Uberlândia",3,"Sudeste",1,"311180",3,13,4,9,3,10,0,0,0,0,0,13,4,9,3,10,15,10.2629589826599,9.40927319457533,0.365538611763755,31
"6947","MG","Canápolis",12201,28651.44,31018,"Uberlândia",3,"Sudeste",1,"311180",4,7,3,4,4,3,0,0,0,0,0,7,3,4,4,3,7,10.2629589826599,9.40927319457533,0.374763434461449,30
"6948","MG","Canápolis",12201,28651.44,31018,"Uberlândia",3,"Sudeste",1,"311180",5,10,1,9,2,8,0,0,0,0,0,10,1,9,2,8,10,10.2629589826599,9.40927319457533,0.354222828649011,31
"6949","MG","Candeias",14888,16584.42,31045,"Campo Belo",3,"Sudeste",0,"311200",2,11,2,9,4,7,0,0,0,0,0,11,2,9,4,7,5,9.71621897940998,9.60831079832209,0.301180160474638,29
"6950","MG","Candeias",14888,16584.42,31045,"Campo Belo",3,"Sudeste",0,"311200",3,11,5,6,5,6,0,0,0,0,0,11,5,6,5,6,4,9.71621897940998,9.60831079832209,0.386394891694364,31
"6951","MG","Candeias",14888,16584.42,31045,"Campo Belo",3,"Sudeste",0,"311200",4,9,3,6,0,9,0,0,0,0,0,9,3,6,0,9,6,9.71621897940998,9.60831079832209,0.382079342878268,30
"6952","MG","Candeias",14888,16584.42,31045,"Campo Belo",3,"Sudeste",0,"311200",5,13,3,10,6,7,0,0,0,0,0,13,3,10,6,7,7,9.71621897940998,9.60831079832209,0.394068071361586,31
"6953","MG","Capelinha",38057,17018.52,31011,"Capelinha",3,"Sudeste",0,"311230",2,47,10,37,17,30,0,0,0,0,0,47,10,37,17,30,25,9.74205744182469,10.5468403148323,0.277558906113586,29
"6954","MG","Capelinha",38057,17018.52,31011,"Capelinha",3,"Sudeste",0,"311230",3,41,8,33,18,23,1,0,1,0,1,42,8,34,18,24,14,9.74205744182469,10.5468403148323,0.357538657700355,31
"6955","MG","Capelinha",38057,17018.52,31011,"Capelinha",3,"Sudeste",0,"311230",4,45,18,27,15,30,0,0,0,0,0,45,18,27,15,30,19,9.74205744182469,10.5468403148323,0.366285162862722,30
"6956","MG","Capelinha",38057,17018.52,31011,"Capelinha",3,"Sudeste",0,"311230",5,37,10,27,10,27,0,0,0,0,0,37,10,27,10,27,16,9.74205744182469,10.5468403148323,0.361949260285312,31
"6957","MG","Capim Branco",9826,9197.33,31027,"Sete Lagoas",3,"Sudeste",1,"311250",2,10,1,9,4,6,0,0,0,0,0,10,1,9,4,6,3,9.12666850352461,9.19278721272859,0.307844458340562,29
"6958","MG","Capim Branco",9826,9197.33,31027,"Sete Lagoas",3,"Sudeste",1,"311250",3,8,2,6,2,6,0,0,0,0,0,8,2,6,2,6,5,9.12666850352461,9.19278721272859,0.380030908805246,31
"6959","MG","Capim Branco",9826,9197.33,31027,"Sete Lagoas",3,"Sudeste",1,"311250",4,7,0,7,2,5,0,0,0,0,0,7,0,7,2,5,3,9.12666850352461,9.19278721272859,0.426776130139651,30
"6960","MG","Capim Branco",9826,9197.33,31027,"Sete Lagoas",3,"Sudeste",1,"311250",5,5,0,5,0,5,0,0,0,0,0,5,0,5,0,5,7,9.12666850352461,9.19278721272859,0.40617216282463,31
"6961","MG","Capinópolis",16234,25482.29,31017,"Ituiutaba",3,"Sudeste",1,"311260",2,16,7,9,8,8,0,0,0,0,0,16,7,9,8,8,9,10.1457389800589,9.69486308732112,0.278381859043427,29
"6962","MG","Capinópolis",16234,25482.29,31017,"Ituiutaba",3,"Sudeste",1,"311260",3,7,1,6,3,4,0,0,0,0,0,7,1,6,3,4,6,10.1457389800589,9.69486308732112,0.327865104647251,31
"6963","MG","Capinópolis",16234,25482.29,31017,"Ituiutaba",3,"Sudeste",1,"311260",4,8,1,7,4,4,0,0,0,0,0,8,1,7,4,4,2,10.1457389800589,9.69486308732112,0.359199070504652,30
"6964","MG","Capinópolis",16234,25482.29,31017,"Ituiutaba",3,"Sudeste",1,"311260",5,11,4,7,1,10,0,0,0,0,0,11,4,7,1,10,7,10.1457389800589,9.69486308732112,0.347487661592933,31
"6965","MG","Capitão Enéas",15313,20419.38,31007,"Montes Claros",3,"Sudeste",0,"311270",2,18,2,16,8,10,0,0,0,0,0,18,2,16,8,10,6,9.9242397288679,9.63645741981521,0.297447679189536,29
"6966","MG","Capitão Enéas",15313,20419.38,31007,"Montes Claros",3,"Sudeste",0,"311270",3,17,4,13,8,9,1,0,1,1,0,18,4,14,9,9,9,9.9242397288679,9.63645741981521,0.386419406066735,31
"6967","MG","Capitão Enéas",15313,20419.38,31007,"Montes Claros",3,"Sudeste",0,"311270",4,22,3,19,11,11,0,0,0,0,0,22,3,19,11,11,8,9.9242397288679,9.63645741981521,0.418649839760658,30
"6968","MG","Capitão Enéas",15313,20419.38,31007,"Montes Claros",3,"Sudeste",0,"311270",5,13,1,12,8,5,0,0,0,0,0,13,1,12,8,5,14,9.9242397288679,9.63645741981521,0.407136216545146,31
"6969","MG","Capitólio",8663,29044.94,31047,"Passos",3,"Sudeste",0,"311280",2,8,2,6,4,4,0,0,0,0,0,8,2,6,4,4,3,10.2765995646645,9.06681636189014,0.29805182937007,29
"6970","MG","Capitólio",8663,29044.94,31047,"Passos",3,"Sudeste",0,"311280",3,10,4,6,3,7,0,0,0,0,0,10,4,6,3,7,5,10.2765995646645,9.06681636189014,0.386323723497217,31
"6971","MG","Capitólio",8663,29044.94,31047,"Passos",3,"Sudeste",0,"311280",4,12,5,7,3,9,0,0,0,0,0,12,5,7,3,9,6,10.2765995646645,9.06681636189014,0.444225748196529,30
"6972","MG","Capitólio",8663,29044.94,31047,"Passos",3,"Sudeste",0,"311280",5,16,5,11,7,9,1,1,0,1,0,17,6,11,8,9,6,10.2765995646645,9.06681636189014,0.409667816665753,31
"6973","MG","Caraí",23780,6553.54,31012,"Araçuaí",3,"Sudeste",0,"311300",2,14,5,9,9,5,0,0,0,0,0,14,5,9,9,5,10,8.78776064064973,10.0766001702448,0.296166075093668,29
"6974","MG","Caraí",23780,6553.54,31012,"Araçuaí",3,"Sudeste",0,"311300",3,19,8,11,10,9,0,0,0,0,0,19,8,11,10,9,13,8.78776064064973,10.0766001702448,0.399651357261359,31
"6975","MG","Caraí",23780,6553.54,31012,"Araçuaí",3,"Sudeste",0,"311300",4,19,6,13,10,9,0,0,0,0,0,19,6,13,10,9,11,8.78776064064973,10.0766001702448,0.425684619975751,30
"6976","MG","Caraí",23780,6553.54,31012,"Araçuaí",3,"Sudeste",0,"311300",5,19,7,12,7,12,0,0,0,0,0,19,7,12,7,12,17,8.78776064064973,10.0766001702448,0.394798782229712,31
"6977","MG","Carandaí",25669,18800.32,31059,"Barbacena",3,"Sudeste",0,"311320",2,16,3,13,0,16,0,0,0,0,0,16,3,13,0,16,17,9.84162916994978,10.1530393171266,0.310648947704816,29
"6978","MG","Carandaí",25669,18800.32,31059,"Barbacena",3,"Sudeste",0,"311320",3,22,5,17,7,15,0,0,0,0,0,22,5,17,7,15,18,9.84162916994978,10.1530393171266,0.402880653245836,31
"6979","MG","Carandaí",25669,18800.32,31059,"Barbacena",3,"Sudeste",0,"311320",4,21,8,13,6,15,1,0,1,1,0,22,8,14,7,15,11,9.84162916994978,10.1530393171266,0.446923756492868,30
"6980","MG","Carandaí",25669,18800.32,31059,"Barbacena",3,"Sudeste",0,"311320",5,20,6,14,7,13,0,0,0,0,0,20,6,14,7,13,20,9.84162916994978,10.1530393171266,0.416649737065494,31
"6981","MG","Carangola",33011,16145.4,31063,"Muriaé",3,"Sudeste",0,"311330",2,28,9,19,9,19,0,0,0,0,0,28,9,19,9,19,18,9.68939045835775,10.4045961182387,0.291138179573451,29
"6982","MG","Carangola",33011,16145.4,31063,"Muriaé",3,"Sudeste",0,"311330",3,37,8,29,14,23,0,0,0,0,0,37,8,29,14,23,24,9.68939045835775,10.4045961182387,0.391888618405939,31
"6983","MG","Carangola",33011,16145.4,31063,"Muriaé",3,"Sudeste",0,"311330",4,33,8,25,15,18,0,0,0,0,0,33,8,25,15,18,32,9.68939045835775,10.4045961182387,0.438789509629603,30
"6984","MG","Carangola",33011,16145.4,31063,"Muriaé",3,"Sudeste",0,"311330",5,43,12,31,19,24,0,0,0,0,0,43,12,31,19,24,21,9.68939045835775,10.4045961182387,0.408821724397681,31
"6985","MG","Caratinga",92603,18565.43,31040,"Caratinga",3,"Sudeste",1,"311340",2,81,21,60,32,49,0,0,0,0,0,81,21,60,32,49,54,9.82905652820667,11.4360768175177,0.326537195940085,29
"6986","MG","Caratinga",92603,18565.43,31040,"Caratinga",3,"Sudeste",1,"311340",3,102,29,73,36,66,2,1,1,0,2,104,30,74,36,68,57,9.82905652820667,11.4360768175177,0.419393229870423,31
"6987","MG","Caratinga",92603,18565.43,31040,"Caratinga",3,"Sudeste",1,"311340",4,80,20,60,31,49,0,0,0,0,0,80,20,60,31,49,52,9.82905652820667,11.4360768175177,0.45330430987285,30
"6988","MG","Caratinga",92603,18565.43,31040,"Caratinga",3,"Sudeste",1,"311340",5,99,22,77,30,69,1,0,1,0,1,100,22,78,30,70,55,9.82905652820667,11.4360768175177,0.429657800957367,31
"6989","MG","Carbonita",9414,17550,31011,"Capelinha",3,"Sudeste",0,"311350",2,6,4,2,2,4,0,0,0,0,0,6,4,2,2,4,2,9.77280922889401,9.14995322196109,0.285518171692502,29
"6990","MG","Carbonita",9414,17550,31011,"Capelinha",3,"Sudeste",0,"311350",3,6,2,4,6,0,0,0,0,0,0,6,2,4,6,0,1,9.77280922889401,9.14995322196109,0.351600902293809,31
"6991","MG","Carbonita",9414,17550,31011,"Capelinha",3,"Sudeste",0,"311350",4,4,2,2,1,3,0,0,0,0,0,4,2,2,1,3,3,9.77280922889401,9.14995322196109,0.347337819426821,30
"6992","MG","Carbonita",9414,17550,31011,"Capelinha",3,"Sudeste",0,"311350",5,8,1,7,3,5,0,0,0,0,0,8,1,7,3,5,7,9.77280922889401,9.14995322196109,0.349672676205478,31
"6993","MG","Careaçu",6792,20794.13,31053,"Santa Rita do Sapucaí",3,"Sudeste",0,"311360",2,3,0,3,3,0,0,0,0,0,0,3,0,3,3,0,0,9.94242601432178,8.82350072799118,0.292987258297815,29
"6994","MG","Careaçu",6792,20794.13,31053,"Santa Rita do Sapucaí",3,"Sudeste",0,"311360",3,6,1,5,2,4,0,0,0,0,0,6,1,5,2,4,6,9.94242601432178,8.82350072799118,0.388081869660736,31
"6995","MG","Careaçu",6792,20794.13,31053,"Santa Rita do Sapucaí",3,"Sudeste",0,"311360",4,5,0,5,3,2,0,0,0,0,0,5,0,5,3,2,4,9.94242601432178,8.82350072799118,0.430478651365369,30
"6996","MG","Careaçu",6792,20794.13,31053,"Santa Rita do Sapucaí",3,"Sudeste",0,"311360",5,3,0,3,1,2,0,0,0,0,0,3,0,3,1,2,8,9.94242601432178,8.82350072799118,0.385763399070349,31
"6997","MG","Carlos Chagas",18674,17722.5,31016,"Nanuque",3,"Sudeste",0,"311370",2,14,6,8,2,12,0,0,0,0,0,14,6,8,2,12,9,9.78259029772917,9.83488746104387,0.281147481716807,29
"6998","MG","Carlos Chagas",18674,17722.5,31016,"Nanuque",3,"Sudeste",0,"311370",3,15,3,12,8,7,0,0,0,0,0,15,3,12,8,7,17,9.78259029772917,9.83488746104387,0.361912268476414,31
"6999","MG","Carlos Chagas",18674,17722.5,31016,"Nanuque",3,"Sudeste",0,"311370",4,18,7,11,7,11,0,0,0,0,0,18,7,11,7,11,7,9.78259029772917,9.83488746104387,0.388481698396174,30
"7000","MG","Carlos Chagas",18674,17722.5,31016,"Nanuque",3,"Sudeste",0,"311370",5,13,3,10,9,4,0,0,0,0,0,13,3,10,9,4,17,9.78259029772917,9.83488746104387,0.370155414780412,31
"7001","MG","Carmo da Cachoeira",12182,18335.14,31050,"Varginha",3,"Sudeste",0,"311390",2,8,4,4,6,2,1,1,0,1,0,9,5,4,7,2,6,9.81657471614576,9.40771473139643,0.312910107134433,29
"7002","MG","Carmo da Cachoeira",12182,18335.14,31050,"Varginha",3,"Sudeste",0,"311390",3,7,3,4,4,3,0,0,0,0,0,7,3,4,4,3,5,9.81657471614576,9.40771473139643,0.373551851020363,31
"7003","MG","Carmo da Cachoeira",12182,18335.14,31050,"Varginha",3,"Sudeste",0,"311390",4,9,1,8,5,4,0,0,0,0,0,9,1,8,5,4,1,9.81657471614576,9.40771473139643,0.410749191726916,30
"7004","MG","Carmo da Cachoeira",12182,18335.14,31050,"Varginha",3,"Sudeste",0,"311390",5,13,5,8,2,11,0,0,0,0,0,13,5,8,2,11,18,9.81657471614576,9.40771473139643,0.380844645629435,31
"7005","MG","Carmo da Mata",11511,15895.66,31046,"Oliveira",3,"Sudeste",0,"311400",2,11,2,9,5,6,0,0,0,0,0,11,2,9,5,6,6,9.67380139497422,9.35105837891506,0.284358255302791,29
"7006","MG","Carmo da Mata",11511,15895.66,31046,"Oliveira",3,"Sudeste",0,"311400",3,12,3,9,4,8,0,0,0,0,0,12,3,9,4,8,10,9.67380139497422,9.35105837891506,0.371969829208568,31
"7007","MG","Carmo da Mata",11511,15895.66,31046,"Oliveira",3,"Sudeste",0,"311400",4,7,0,7,2,5,0,0,0,0,0,7,0,7,2,5,9,9.67380139497422,9.35105837891506,0.366232881602358,30
"7008","MG","Carmo da Mata",11511,15895.66,31046,"Oliveira",3,"Sudeste",0,"311400",5,6,2,4,3,3,0,0,0,0,0,6,2,4,3,3,9,9.67380139497422,9.35105837891506,0.328425993739643,31
"7009","MG","Carmo de Minas",14947,13297.23,31054,"São Lourenço",3,"Sudeste",0,"311410",2,15,5,10,8,7,0,0,0,0,0,15,5,10,8,7,8,9.4953110218418,9.61226588978581,0.358967200003595,29
"7010","MG","Carmo de Minas",14947,13297.23,31054,"São Lourenço",3,"Sudeste",0,"311410",3,10,2,8,4,6,0,0,0,0,0,10,2,8,4,6,3,9.4953110218418,9.61226588978581,0.466776907653924,31
"7011","MG","Carmo de Minas",14947,13297.23,31054,"São Lourenço",3,"Sudeste",0,"311410",4,6,0,6,1,5,0,0,0,0,0,6,0,6,1,5,3,9.4953110218418,9.61226588978581,0.496686799956065,30
"7012","MG","Carmo de Minas",14947,13297.23,31054,"São Lourenço",3,"Sudeste",0,"311410",5,12,4,8,5,7,0,0,0,0,0,12,4,8,5,7,7,9.4953110218418,9.61226588978581,0.479369143397831,31
"7013","MG","Carmo do Cajuru",22693,18309.3,31043,"Divinópolis",3,"Sudeste",0,"311420",2,24,6,18,9,15,1,0,1,0,1,25,6,19,9,16,12,9.8151644064626,10.0298117858696,0.286394714417594,29
"7014","MG","Carmo do Cajuru",22693,18309.3,31043,"Divinópolis",3,"Sudeste",0,"311420",3,27,4,23,11,16,1,0,1,0,1,28,4,24,11,17,17,9.8151644064626,10.0298117858696,0.379110883838591,31
"7015","MG","Carmo do Cajuru",22693,18309.3,31043,"Divinópolis",3,"Sudeste",0,"311420",4,23,3,20,10,13,0,0,0,0,0,23,3,20,10,13,12,9.8151644064626,10.0298117858696,0.418581274801482,30
"7016","MG","Carmo do Cajuru",22693,18309.3,31043,"Divinópolis",3,"Sudeste",0,"311420",5,28,3,25,8,20,0,0,0,0,0,28,3,25,8,20,17,9.8151644064626,10.0298117858696,0.377271735171468,31
"7017","MG","Carmo do Paranaíba",30334,23740.39,31020,"Patos de Minas",3,"Sudeste",1,"311430",2,24,3,21,3,21,0,0,0,0,0,24,3,21,3,21,21,10.0749330959984,10.3200244746113,0.313616233592992,29
"7018","MG","Carmo do Paranaíba",30334,23740.39,31020,"Patos de Minas",3,"Sudeste",1,"311430",3,28,6,22,11,17,0,0,0,0,0,28,6,22,11,17,20,10.0749330959984,10.3200244746113,0.397034593930394,31
"7019","MG","Carmo do Paranaíba",30334,23740.39,31020,"Patos de Minas",3,"Sudeste",1,"311430",4,19,1,18,5,14,1,0,1,1,0,20,1,19,6,14,15,10.0749330959984,10.3200244746113,0.416631883565438,30
"7020","MG","Carmo do Paranaíba",30334,23740.39,31020,"Patos de Minas",3,"Sudeste",1,"311430",5,25,7,18,12,13,0,0,0,0,0,25,7,18,12,13,20,10.0749330959984,10.3200244746113,0.406343592585305,31
"7021","MG","Carmo do Rio Claro",21268,22346.74,31049,"Alfenas",3,"Sudeste",0,"311440",2,12,3,9,5,7,0,0,0,0,0,12,3,9,5,7,12,10.0144357281054,9.96495887462423,0.317695896075003,29
"7022","MG","Carmo do Rio Claro",21268,22346.74,31049,"Alfenas",3,"Sudeste",0,"311440",3,14,2,12,4,10,0,0,0,0,0,14,2,12,4,10,14,10.0144357281054,9.96495887462423,0.377774224943698,31
"7023","MG","Carmo do Rio Claro",21268,22346.74,31049,"Alfenas",3,"Sudeste",0,"311440",4,12,2,10,6,6,0,0,0,0,0,12,2,10,6,6,9,10.0144357281054,9.96495887462423,0.415422100691191,30
"7024","MG","Carmo do Rio Claro",21268,22346.74,31049,"Alfenas",3,"Sudeste",0,"311440",5,25,5,20,11,14,0,0,0,0,0,25,5,20,11,14,9,10.0144357281054,9.96495887462423,0.378859293955862,31
"7025","MG","Carmópolis de Minas",19559,21567.69,31046,"Oliveira",3,"Sudeste",0,"311450",2,16,3,13,5,11,0,0,0,0,0,16,3,13,5,11,2,9.97895164046334,9.88119081753752,0.291410399197368,29
"7026","MG","Carmópolis de Minas",19559,21567.69,31046,"Oliveira",3,"Sudeste",0,"311450",3,17,3,14,6,11,0,0,0,0,0,17,3,14,6,11,4,9.97895164046334,9.88119081753752,0.377717815441987,31
"7027","MG","Carmópolis de Minas",19559,21567.69,31046,"Oliveira",3,"Sudeste",0,"311450",4,26,2,24,9,17,1,1,0,1,0,27,3,24,10,17,8,9.97895164046334,9.88119081753752,0.409887028225794,30
"7028","MG","Carmópolis de Minas",19559,21567.69,31046,"Oliveira",3,"Sudeste",0,"311450",5,16,3,13,8,8,0,0,0,0,0,16,3,13,8,8,7,9.97895164046334,9.88119081753752,0.393745880506317,31
"7029","MG","Carneirinho",10066,31855.26,31021,"Frutal",3,"Sudeste",0,"311455",2,1,0,1,0,1,0,0,0,0,0,1,0,1,0,1,2,10.3689577965013,9.2169186873363,0.347474406723914,29
"7030","MG","Carneirinho",10066,31855.26,31021,"Frutal",3,"Sudeste",0,"311455",3,8,2,6,2,6,0,0,0,0,0,8,2,6,2,6,6,10.3689577965013,9.2169186873363,0.40070112613018,31
"7031","MG","Carneirinho",10066,31855.26,31021,"Frutal",3,"Sudeste",0,"311455",4,1,0,1,0,1,0,0,0,0,0,1,0,1,0,1,5,10.3689577965013,9.2169186873363,0.434404822358897,30
"7032","MG","Carneirinho",10066,31855.26,31021,"Frutal",3,"Sudeste",0,"311455",5,7,3,4,3,4,0,0,0,0,0,7,3,4,3,4,2,10.3689577965013,9.2169186873363,0.432099798996593,31
"7033","MG","Cássia",17740,18376.7,31047,"Passos",3,"Sudeste",1,"311510",2,17,5,12,6,11,0,0,0,0,0,17,5,12,6,11,11,9.81883883680841,9.78357725586357,0.32117804131723,29
"7034","MG","Cássia",17740,18376.7,31047,"Passos",3,"Sudeste",1,"311510",3,9,4,5,3,6,0,0,0,0,0,9,4,5,3,6,18,9.81883883680841,9.78357725586357,0.386935266787774,31
"7035","MG","Cássia",17740,18376.7,31047,"Passos",3,"Sudeste",1,"311510",4,16,3,13,5,11,0,0,0,0,0,16,3,13,5,11,12,9.81883883680841,9.78357725586357,0.4284481743274,30
"7036","MG","Cássia",17740,18376.7,31047,"Passos",3,"Sudeste",1,"311510",5,20,3,17,6,14,1,1,0,1,0,21,4,17,7,14,14,9.81883883680841,9.78357725586357,0.407536244358164,31
"7037","MG","Cataguases",75540,20631.9,31066,"Cataguases",3,"Sudeste",1,"311530",2,47,11,36,13,34,0,0,0,0,0,47,11,36,13,34,52,9.93459370070958,11.2324175962664,0.321609011649158,29
"7038","MG","Cataguases",75540,20631.9,31066,"Cataguases",3,"Sudeste",1,"311530",3,59,16,43,24,35,1,0,1,0,1,60,16,44,24,36,49,9.93459370070958,11.2324175962664,0.419125195210178,31
"7039","MG","Cataguases",75540,20631.9,31066,"Cataguases",3,"Sudeste",1,"311530",4,46,8,38,15,31,0,0,0,0,0,46,8,38,15,31,32,9.93459370070958,11.2324175962664,0.492764155051747,30
"7040","MG","Cataguases",75540,20631.9,31066,"Cataguases",3,"Sudeste",1,"311530",5,55,11,44,22,33,0,0,0,0,0,55,11,44,22,33,51,9.93459370070958,11.2324175962664,0.45290560935848,31
"7041","MG","Catas Altas",5421,78778.67,31031,"Itabira",3,"Sudeste",0,"311535",2,4,1,3,1,3,0,0,0,0,0,4,1,3,1,3,2,11.2743975539249,8.59803557926034,0.36739832610846,29
"7042","MG","Catas Altas",5421,78778.67,31031,"Itabira",3,"Sudeste",0,"311535",3,3,0,3,0,3,0,0,0,0,0,3,0,3,0,3,2,11.2743975539249,8.59803557926034,0.463974870657166,31
"7043","MG","Catas Altas",5421,78778.67,31031,"Itabira",3,"Sudeste",0,"311535",4,2,0,2,1,1,0,0,0,0,0,2,0,2,1,1,1,11.2743975539249,8.59803557926034,0.519564421797491,30
"7044","MG","Catas Altas",5421,78778.67,31031,"Itabira",3,"Sudeste",0,"311535",5,6,0,6,2,4,0,0,0,0,0,6,0,6,2,4,1,11.2743975539249,8.59803557926034,0.460984257238734,31
"7045","MG","Caxambu",21610,15512.4,31054,"São Lourenço",3,"Sudeste",1,"311550",2,16,7,9,8,8,0,0,0,0,0,16,7,9,8,8,19,9.6493949830779,9.98091144950093,0.30374729878775,29
"7046","MG","Caxambu",21610,15512.4,31054,"São Lourenço",3,"Sudeste",1,"311550",3,19,3,16,7,12,0,0,0,0,0,19,3,16,7,12,17,9.6493949830779,9.98091144950093,0.409211088637753,31
"7047","MG","Caxambu",21610,15512.4,31054,"São Lourenço",3,"Sudeste",1,"311550",4,11,2,9,5,6,0,0,0,0,0,11,2,9,5,6,9,9.6493949830779,9.98091144950093,0.467945604315887,30
"7048","MG","Caxambu",21610,15512.4,31054,"São Lourenço",3,"Sudeste",1,"311550",5,22,5,17,4,18,0,0,0,0,0,22,5,17,4,18,16,9.6493949830779,9.98091144950093,0.435721809160531,31
"7049","MG","Centralina",10346,24105.53,31018,"Uberlândia",3,"Sudeste",0,"311580",2,4,0,4,1,3,0,0,0,0,0,4,0,4,1,3,8,10.0901965537376,9.24435525056346,0.34368896103226,29
"7050","MG","Centralina",10346,24105.53,31018,"Uberlândia",3,"Sudeste",0,"311580",3,4,1,3,3,1,0,0,0,0,0,4,1,3,3,1,4,10.0901965537376,9.24435525056346,0.412342299403221,31
"7051","MG","Centralina",10346,24105.53,31018,"Uberlândia",3,"Sudeste",0,"311580",4,9,1,8,4,5,0,0,0,0,0,9,1,8,4,5,6,10.0901965537376,9.24435525056346,0.403530517556371,30
"7052","MG","Centralina",10346,24105.53,31018,"Uberlândia",3,"Sudeste",0,"311580",5,10,2,8,3,7,0,0,0,0,0,10,2,8,3,7,11,10.0901965537376,9.24435525056346,0.372009025800956,31
"7053","MG","Chácara",3186,11892.54,31065,"Juiz de Fora",3,"Sudeste",1,"311590",2,5,2,3,2,3,0,0,0,0,0,5,2,3,2,3,1,9.38366659176515,8.06652149046999,0.296543410154497,29
"7054","MG","Chácara",3186,11892.54,31065,"Juiz de Fora",3,"Sudeste",1,"311590",3,2,0,2,0,2,0,0,0,0,0,2,0,2,0,2,2,9.38366659176515,8.06652149046999,0.423730622338591,31
"7055","MG","Chácara",3186,11892.54,31065,"Juiz de Fora",3,"Sudeste",1,"311590",4,0,0,0,0,0,0,0,0,0,0,0,0,0,0,0,1,9.38366659176515,8.06652149046999,0.461316027501042,30
"7056","MG","Chácara",3186,11892.54,31065,"Juiz de Fora",3,"Sudeste",1,"311590",5,2,0,2,1,1,0,0,0,0,0,2,0,2,1,1,3,9.38366659176515,8.06652149046999,0.441907281942604,31
"7057","MG","Chapada Gaúcha",13953,14845.12,31003,"Januária",3,"Sudeste",0,"311615",2,18,5,13,7,11,0,0,0,0,0,18,5,13,7,11,3,9.605426470695,9.54344981789221,0.282081114401369,29
"7058","MG","Chapada Gaúcha",13953,14845.12,31003,"Januária",3,"Sudeste",0,"311615",3,15,7,8,7,8,0,0,0,0,0,15,7,8,7,8,0,9.605426470695,9.54344981789221,0.323707237032199,31
"7059","MG","Chapada Gaúcha",13953,14845.12,31003,"Januária",3,"Sudeste",0,"311615",4,14,4,10,8,6,0,0,0,0,0,14,4,10,8,6,3,9.605426470695,9.54344981789221,0.383981611571189,30
"7060","MG","Chapada Gaúcha",13953,14845.12,31003,"Januária",3,"Sudeste",0,"311615",5,17,1,16,5,12,0,0,0,0,0,17,1,16,5,12,5,9.605426470695,9.54344981789221,0.367394428418365,31
"7061","MG","Claro dos Poções",7514,8569.39,31007,"Montes Claros",3,"Sudeste",0,"311650",2,3,1,2,1,2,0,0,0,0,0,3,1,2,1,2,3,9.05595183052876,8.92452322613391,0.295976593345335,29
"7062","MG","Claro dos Poções",7514,8569.39,31007,"Montes Claros",3,"Sudeste",0,"311650",3,7,3,4,0,7,0,0,0,0,0,7,3,4,0,7,7,9.05595183052876,8.92452322613391,0.389805541184153,31
"7063","MG","Claro dos Poções",7514,8569.39,31007,"Montes Claros",3,"Sudeste",0,"311650",4,4,0,4,1,3,0,0,0,0,0,4,0,4,1,3,3,9.05595183052876,8.92452322613391,0.402210399036197,30
"7064","MG","Claro dos Poções",7514,8569.39,31007,"Montes Claros",3,"Sudeste",0,"311650",5,2,0,2,2,0,0,0,0,0,0,2,0,2,2,0,5,9.05595183052876,8.92452322613391,0.383182634169125,31
"7065","MG","Cláudio",28859,24910.46,31043,"Divinópolis",3,"Sudeste",1,"311660",2,32,6,26,7,25,1,0,1,0,1,33,6,27,7,26,8,10.123043074565,10.2701771816929,0.274718137215693,29
"7066","MG","Cláudio",28859,24910.46,31043,"Divinópolis",3,"Sudeste",1,"311660",3,34,9,25,5,29,1,1,0,0,1,35,10,25,5,30,13,10.123043074565,10.2701771816929,0.34141881413784,31
"7067","MG","Cláudio",28859,24910.46,31043,"Divinópolis",3,"Sudeste",1,"311660",4,25,5,20,7,18,0,0,0,0,0,25,5,20,7,18,11,10.123043074565,10.2701771816929,0.376519247911119,30
"7068","MG","Cláudio",28859,24910.46,31043,"Divinópolis",3,"Sudeste",1,"311660",5,34,6,28,12,22,1,0,1,1,0,35,6,29,13,22,13,10.123043074565,10.2701771816929,0.335569797423254,31
"7069","MG","Conceição da Aparecida",10322,18406.82,31049,"Alfenas",3,"Sudeste",0,"311710",2,5,2,3,1,4,0,0,0,0,0,5,2,3,1,4,6,9.82047652709644,9.24203281870867,0.326744488856389,29
"7070","MG","Conceição da Aparecida",10322,18406.82,31049,"Alfenas",3,"Sudeste",0,"311710",3,13,5,8,5,8,0,0,0,0,0,13,5,8,5,8,11,9.82047652709644,9.24203281870867,0.387450762515542,31
"7071","MG","Conceição da Aparecida",10322,18406.82,31049,"Alfenas",3,"Sudeste",0,"311710",4,7,2,5,0,7,0,0,0,0,0,7,2,5,0,7,11,9.82047652709644,9.24203281870867,0.413231960460735,30
"7072","MG","Conceição da Aparecida",10322,18406.82,31049,"Alfenas",3,"Sudeste",0,"311710",5,9,2,7,4,5,0,0,0,0,0,9,2,7,4,5,5,9.82047652709644,9.24203281870867,0.401139512383159,31
"7073","MG","Conceição das Alagoas",28346,32801.19,31022,"Uberaba",3,"Sudeste",1,"311730",2,30,5,25,15,15,0,0,0,0,0,30,5,25,15,15,5,10.3982200742019,10.2522412057269,0.281857701121047,29
"7074","MG","Conceição das Alagoas",28346,32801.19,31022,"Uberaba",3,"Sudeste",1,"311730",3,26,8,18,9,17,2,1,1,1,1,28,9,19,10,18,8,10.3982200742019,10.2522412057269,0.351766334632116,31
"7075","MG","Conceição das Alagoas",28346,32801.19,31022,"Uberaba",3,"Sudeste",1,"311730",4,24,9,15,13,11,0,0,0,0,0,24,9,15,13,11,15,10.3982200742019,10.2522412057269,0.382084185101158,30
"7076","MG","Conceição das Alagoas",28346,32801.19,31022,"Uberaba",3,"Sudeste",1,"311730",5,28,12,16,17,11,0,0,0,0,0,28,12,16,17,11,9,10.3982200742019,10.2522412057269,0.369740858046803,31
"7077","MG","Conceição do Mato Dentro",17503,41556.9,31028,"Conceição do Mato Dentro",3,"Sudeste",0,"311750",2,25,5,20,5,20,0,0,0,0,0,25,5,20,5,20,12,10.6348188514783,9.77012757379084,0.284253084140207,29
"7078","MG","Conceição do Mato Dentro",17503,41556.9,31028,"Conceição do Mato Dentro",3,"Sudeste",0,"311750",3,17,0,17,11,6,0,0,0,0,0,17,0,17,11,6,21,10.6348188514783,9.77012757379084,0.380387328299044,31
"7079","MG","Conceição do Mato Dentro",17503,41556.9,31028,"Conceição do Mato Dentro",3,"Sudeste",0,"311750",4,16,4,12,5,11,0,0,0,0,0,16,4,12,5,11,13,10.6348188514783,9.77012757379084,0.412678012252438,30
"7080","MG","Conceição do Mato Dentro",17503,41556.9,31028,"Conceição do Mato Dentro",3,"Sudeste",0,"311750",5,22,4,18,5,17,0,0,0,0,0,22,4,18,5,17,10,10.6348188514783,9.77012757379084,0.393144712509703,31
"7081","MG","Conceição do Pará",5533,47184.32,31043,"Divinópolis",3,"Sudeste",0,"311760",2,4,2,2,0,4,0,0,0,0,0,4,2,2,0,4,4,10.761816912992,8.61848544289811,0.307230489714999,29
"7082","MG","Conceição do Pará",5533,47184.32,31043,"Divinópolis",3,"Sudeste",0,"311760",3,6,2,4,3,3,0,0,0,0,0,6,2,4,3,3,2,10.761816912992,8.61848544289811,0.390742319967944,31
"7083","MG","Conceição do Pará",5533,47184.32,31043,"Divinópolis",3,"Sudeste",0,"311760",4,4,1,3,2,2,0,0,0,0,0,4,1,3,2,2,2,10.761816912992,8.61848544289811,0.416232148050522,30
"7084","MG","Conceição do Pará",5533,47184.32,31043,"Divinópolis",3,"Sudeste",0,"311760",5,13,2,11,4,9,0,0,0,0,0,13,2,11,4,9,5,10.761816912992,8.61848544289811,0.409418564714705,31
"7085","MG","Conceição do Rio Verde",13684,15525.35,31054,"São Lourenço",3,"Sudeste",1,"311770",2,12,2,10,8,4,0,0,0,0,0,12,2,10,8,4,11,9.65022945083098,9.52398254609749,0.321170076949871,29
"7086","MG","Conceição do Rio Verde",13684,15525.35,31054,"São Lourenço",3,"Sudeste",1,"311770",3,11,4,7,7,4,0,0,0,0,0,11,4,7,7,4,13,9.65022945083098,9.52398254609749,0.450613896094996,31
"7087","MG","Conceição do Rio Verde",13684,15525.35,31054,"São Lourenço",3,"Sudeste",1,"311770",4,9,4,5,4,5,0,0,0,0,0,9,4,5,4,5,10,9.65022945083098,9.52398254609749,0.481667019750448,30
"7088","MG","Conceição do Rio Verde",13684,15525.35,31054,"São Lourenço",3,"Sudeste",1,"311770",5,12,7,5,5,7,0,0,0,0,0,12,7,5,5,7,9,9.65022945083098,9.52398254609749,0.411104594052558,31
"7089","MG","Conceição dos Ouros",11748,15525.11,31053,"Santa Rita do Sapucaí",3,"Sudeste",0,"311780",2,7,1,6,2,5,0,0,0,0,0,7,1,6,2,5,7,9.65021399212279,9.37143829231851,0.310559301323718,29
"7090","MG","Conceição dos Ouros",11748,15525.11,31053,"Santa Rita do Sapucaí",3,"Sudeste",0,"311780",3,7,1,6,3,4,0,0,0,0,0,7,1,6,3,4,5,9.65021399212279,9.37143829231851,0.390194951289982,31
"7091","MG","Conceição dos Ouros",11748,15525.11,31053,"Santa Rita do Sapucaí",3,"Sudeste",0,"311780",4,6,1,5,1,5,0,0,0,0,0,6,1,5,1,5,7,9.65021399212279,9.37143829231851,0.440828778173475,30
"7092","MG","Conceição dos Ouros",11748,15525.11,31053,"Santa Rita do Sapucaí",3,"Sudeste",0,"311780",5,8,1,7,1,7,0,0,0,0,0,8,1,7,1,7,4,9.65021399212279,9.37143829231851,0.416549611535624,31
"7093","MG","Confins",6800,163730.37,31030,"Belo Horizonte",3,"Sudeste",1,"311787",2,6,1,5,1,5,0,0,0,0,0,6,1,5,1,5,2,12.005976268449,8.8246778911642,0.296355313975242,29
"7094","MG","Confins",6800,163730.37,31030,"Belo Horizonte",3,"Sudeste",1,"311787",3,13,2,11,4,9,0,0,0,0,0,13,2,11,4,9,2,12.005976268449,8.8246778911642,0.370021747469065,31
"7095","MG","Confins",6800,163730.37,31030,"Belo Horizonte",3,"Sudeste",1,"311787",4,5,1,4,3,2,0,0,0,0,0,5,1,4,3,2,5,12.005976268449,8.8246778911642,0.429649856360398,30
"7096","MG","Confins",6800,163730.37,31030,"Belo Horizonte",3,"Sudeste",1,"311787",5,5,1,4,2,3,0,0,0,0,0,5,1,4,2,3,7,12.005976268449,8.8246778911642,0.37792006111045,31
"7097","MG","Congonhal",12082,16917.61,31052,"Pouso Alegre",3,"Sudeste",0,"311790",2,9,2,7,2,7,0,0,0,0,0,9,2,7,2,7,2,9.73611037022799,9.39947202069869,0.288854043044789,29
"7098","MG","Congonhal",12082,16917.61,31052,"Pouso Alegre",3,"Sudeste",0,"311790",3,12,1,11,5,7,0,0,0,0,0,12,1,11,5,7,8,9.73611037022799,9.39947202069869,0.3731480454165,31
"7099","MG","Congonhal",12082,16917.61,31052,"Pouso Alegre",3,"Sudeste",0,"311790",4,11,1,10,4,7,0,0,0,0,0,11,1,10,4,7,2,9.73611037022799,9.39947202069869,0.395705548288436,30
"7100","MG","Congonhal",12082,16917.61,31052,"Pouso Alegre",3,"Sudeste",0,"311790",5,12,1,11,2,10,0,0,0,0,0,12,1,11,2,10,4,9.73611037022799,9.39947202069869,0.374657935317869,31
"7101","MG","Congonhas",55309,31529.18,31034,"Conselheiro Lafaiete",3,"Sudeste",1,"311800",2,42,7,35,11,31,0,0,0,0,0,42,7,35,11,31,32,10.3586687452234,10.9206909229121,0.298826950054169,29
"7102","MG","Congonhas",55309,31529.18,31034,"Conselheiro Lafaiete",3,"Sudeste",1,"311800",3,54,10,44,22,32,1,0,1,0,1,55,10,45,22,33,35,10.3586687452234,10.9206909229121,0.375602369289353,31
"7103","MG","Congonhas",55309,31529.18,31034,"Conselheiro Lafaiete",3,"Sudeste",1,"311800",4,55,5,50,17,38,0,0,0,0,0,55,5,50,17,38,15,10.3586687452234,10.9206909229121,0.410694994348855,30
"7104","MG","Congonhas",55309,31529.18,31034,"Conselheiro Lafaiete",3,"Sudeste",1,"311800",5,69,16,53,26,43,0,0,0,0,0,69,16,53,26,43,24,10.3586687452234,10.9206909229121,0.381418447995297,31
"7105","MG","Conquista",6969,47796.5,31022,"Uberaba",3,"Sudeste",0,"311820",2,7,1,6,4,3,0,0,0,0,0,7,1,6,4,3,3,10.7747076940414,8.84922702143852,0.280808879363944,29
"7106","MG","Conquista",6969,47796.5,31022,"Uberaba",3,"Sudeste",0,"311820",3,8,3,5,3,5,0,0,0,0,0,8,3,5,3,5,4,10.7747076940414,8.84922702143852,0.331091208974939,31
"7107","MG","Conquista",6969,47796.5,31022,"Uberaba",3,"Sudeste",0,"311820",4,6,3,3,2,4,0,0,0,0,0,6,3,3,2,4,5,10.7747076940414,8.84922702143852,0.383233230162503,30
"7108","MG","Conquista",6969,47796.5,31022,"Uberaba",3,"Sudeste",0,"311820",5,2,0,2,1,1,0,0,0,0,0,2,0,2,1,1,2,10.7747076940414,8.84922702143852,0.347418642757597,31
"7109","MG","Conselheiro Lafaiete",129606,16555.58,31034,"Conselheiro Lafaiete",3,"Sudeste",1,"311830",2,103,15,88,33,70,3,2,1,0,3,106,17,89,33,73,68,9.71447848410035,11.772254358125,0.292483298918697,29
"7110","MG","Conselheiro Lafaiete",129606,16555.58,31034,"Conselheiro Lafaiete",3,"Sudeste",1,"311830",3,124,20,104,30,94,1,1,0,1,0,125,21,104,31,94,76,9.71447848410035,11.772254358125,0.384332344240924,31
"7111","MG","Conselheiro Lafaiete",129606,16555.58,31034,"Conselheiro Lafaiete",3,"Sudeste",1,"311830",4,117,16,101,38,79,1,0,1,0,1,118,16,102,38,80,50,9.71447848410035,11.772254358125,0.44667270814463,30
"7112","MG","Conselheiro Lafaiete",129606,16555.58,31034,"Conselheiro Lafaiete",3,"Sudeste",1,"311830",5,135,15,120,42,93,1,0,1,0,1,136,15,121,42,94,74,9.71447848410035,11.772254358125,0.41551983128722,31
"7113","MG","Conselheiro Pena",22949,12474.09,31041,"Aimorés",3,"Sudeste",0,"311840",2,20,7,13,4,16,1,1,0,0,1,21,8,13,4,17,12,9.43140897206725,10.0410296415546,0.319646345455167,29
"7114","MG","Conselheiro Pena",22949,12474.09,31041,"Aimorés",3,"Sudeste",0,"311840",3,24,6,18,12,12,0,0,0,0,0,24,6,18,12,12,13,9.43140897206725,10.0410296415546,0.414408227528151,31
"7115","MG","Conselheiro Pena",22949,12474.09,31041,"Aimorés",3,"Sudeste",0,"311840",4,13,2,11,7,6,0,0,0,0,0,13,2,11,7,6,10,9.43140897206725,10.0410296415546,0.44764010729374,30
"7116","MG","Conselheiro Pena",22949,12474.09,31041,"Aimorés",3,"Sudeste",0,"311840",5,20,5,15,6,14,0,0,0,0,0,20,5,15,6,14,11,9.43140897206725,10.0410296415546,0.395779777689432,31
"7117","MG","Contagem",668949,42077.02,31030,"Belo Horizonte",3,"Sudeste",1,"311860",2,604,82,522,159,445,7,2,5,2,5,611,84,527,161,450,268,10.6472570274134,13.4134631030206,0.287783896253918,29
"7118","MG","Contagem",668949,42077.02,31030,"Belo Horizonte",3,"Sudeste",1,"311860",3,605,80,525,178,427,7,2,5,3,4,612,82,530,181,431,354,10.6472570274134,13.4134631030206,0.384515936229541,31
"7119","MG","Contagem",668949,42077.02,31030,"Belo Horizonte",3,"Sudeste",1,"311860",4,583,93,490,194,389,4,0,4,0,4,587,93,494,194,393,310,10.6472570274134,13.4134631030206,0.446028115944676,30
"7120","MG","Contagem",668949,42077.02,31030,"Belo Horizonte",3,"Sudeste",1,"311860",5,669,118,551,201,468,3,0,3,1,2,672,118,554,202,470,266,10.6472570274134,13.4134631030206,0.401310215268488,31
"7121","MG","Coqueiral",9128,17043.31,31050,"Varginha",3,"Sudeste",0,"311870",2,9,5,4,5,4,0,0,0,0,0,9,5,4,5,4,7,9.74351303034574,9.11910189154191,0.323341410337625,29
"7122","MG","Coqueiral",9128,17043.31,31050,"Varginha",3,"Sudeste",0,"311870",3,8,1,7,2,6,0,0,0,0,0,8,1,7,2,6,6,9.74351303034574,9.11910189154191,0.382568047875891,31
"7123","MG","Coqueiral",9128,17043.31,31050,"Varginha",3,"Sudeste",0,"311870",4,4,0,4,1,3,0,0,0,0,0,4,0,4,1,3,4,9.74351303034574,9.11910189154191,0.410768143721466,30
"7124","MG","Coqueiral",9128,17043.31,31050,"Varginha",3,"Sudeste",0,"311870",5,6,2,4,3,3,0,0,0,0,0,6,2,4,3,3,5,9.74351303034574,9.11910189154191,0.389605286374908,31
"7125","MG","Coração de Jesus",26611,7902.43,31007,"Montes Claros",3,"Sudeste",0,"311880",2,11,4,7,3,8,0,0,0,0,0,11,4,7,3,8,9,8.9749255860942,10.1890799431228,0.295287416049556,29
"7126","MG","Coração de Jesus",26611,7902.43,31007,"Montes Claros",3,"Sudeste",0,"311880",3,13,1,12,4,9,0,0,0,0,0,13,1,12,4,9,16,8.9749255860942,10.1890799431228,0.355471366916364,31
"7127","MG","Coração de Jesus",26611,7902.43,31007,"Montes Claros",3,"Sudeste",0,"311880",4,24,6,18,11,13,1,0,1,0,1,25,6,19,11,14,13,8.9749255860942,10.1890799431228,0.378387114703124,30
"7128","MG","Coração de Jesus",26611,7902.43,31007,"Montes Claros",3,"Sudeste",0,"311880",5,28,5,23,12,16,1,0,1,0,1,29,5,24,12,17,21,8.9749255860942,10.1890799431228,0.362787666947405,31
"7129","MG","Cordisburgo",8897,10708.03,31027,"Sete Lagoas",3,"Sudeste",0,"311890",2,2,1,1,1,1,0,0,0,0,0,2,1,1,1,1,3,9.27874920627995,9.09346942024477,0.28485035476925,29
"7130","MG","Cordisburgo",8897,10708.03,31027,"Sete Lagoas",3,"Sudeste",0,"311890",3,2,0,2,1,1,0,0,0,0,0,2,0,2,1,1,6,9.27874920627995,9.09346942024477,0.3673752254823,31
"7131","MG","Cordisburgo",8897,10708.03,31027,"Sete Lagoas",3,"Sudeste",0,"311890",4,0,0,0,0,0,0,0,0,0,0,0,0,0,0,0,7,9.27874920627995,9.09346942024477,0.395878352225711,30
"7132","MG","Cordisburgo",8897,10708.03,31027,"Sete Lagoas",3,"Sudeste",0,"311890",5,3,0,3,0,3,0,0,0,0,0,3,0,3,0,3,6,9.27874920627995,9.09346942024477,0.374325135664446,31
"7133","MG","Corinto",23668,13412.98,31025,"Curvelo",3,"Sudeste",1,"311910",2,21,5,16,9,12,1,0,1,1,0,22,5,17,10,12,8,9.50397817381025,10.0718792037966,0.315724996051576,29
"7134","MG","Corinto",23668,13412.98,31025,"Curvelo",3,"Sudeste",1,"311910",3,13,5,8,8,5,1,1,0,0,1,14,6,8,8,6,20,9.50397817381025,10.0718792037966,0.365452973939475,31
"7135","MG","Corinto",23668,13412.98,31025,"Curvelo",3,"Sudeste",1,"311910",4,24,5,19,9,15,0,0,0,0,0,24,5,19,9,15,19,9.50397817381025,10.0718792037966,0.408368295903529,30
"7136","MG","Corinto",23668,13412.98,31025,"Curvelo",3,"Sudeste",1,"311910",5,22,7,15,9,13,0,0,0,0,0,22,7,15,9,13,17,9.50397817381025,10.0718792037966,0.39326027557835,31
"7137","MG","Coromandel",27966,35895.18,31019,"Patrocínio",3,"Sudeste",0,"311930",2,18,3,15,7,11,0,0,0,0,0,18,3,15,7,11,20,10.488358303624,10.2387447656008,0.305301625605617,29
"7138","MG","Coromandel",27966,35895.18,31019,"Patrocínio",3,"Sudeste",0,"311930",3,21,3,18,9,12,0,0,0,0,0,21,3,18,9,12,20,10.488358303624,10.2387447656008,0.389900658021646,31
"7139","MG","Coromandel",27966,35895.18,31019,"Patrocínio",3,"Sudeste",0,"311930",4,17,5,12,7,10,0,0,0,0,0,17,5,12,7,10,16,10.488358303624,10.2387447656008,0.424210370819693,30
"7140","MG","Coromandel",27966,35895.18,31019,"Patrocínio",3,"Sudeste",0,"311930",5,23,5,18,12,11,2,0,2,1,1,25,5,20,13,12,12,10.488358303624,10.2387447656008,0.397002189425087,31
"7141","MG","Coronel Fabriciano",110290,15566.54,31039,"Ipatinga",3,"Sudeste",1,"311940",2,94,11,83,25,69,0,0,0,0,0,94,11,83,25,69,67,9.65287901791081,11.6108685393002,0.319942051358821,29
"7142","MG","Coronel Fabriciano",110290,15566.54,31039,"Ipatinga",3,"Sudeste",1,"311940",3,89,13,76,30,59,1,0,1,0,1,90,13,77,30,60,73,9.65287901791081,11.6108685393002,0.41713130644765,31
"7143","MG","Coronel Fabriciano",110290,15566.54,31039,"Ipatinga",3,"Sudeste",1,"311940",4,105,13,92,32,73,2,0,2,0,2,107,13,94,32,75,68,9.65287901791081,11.6108685393002,0.443601323795497,30
"7144","MG","Coronel Fabriciano",110290,15566.54,31039,"Ipatinga",3,"Sudeste",1,"311940",5,104,19,85,29,75,0,0,0,0,0,104,19,85,29,75,60,9.65287901791081,11.6108685393002,0.404742709251085,31
"7145","MG","Coronel Murta",9215,8721.9,31012,"Araçuaí",3,"Sudeste",0,"311950",2,7,1,6,2,5,0,0,0,0,0,7,1,6,2,5,8,9.07359238307672,9.12858787010392,0.32165656989179,29
"7146","MG","Coronel Murta",9215,8721.9,31012,"Araçuaí",3,"Sudeste",0,"311950",3,4,2,2,2,2,0,0,0,0,0,4,2,2,2,2,3,9.07359238307672,9.12858787010392,0.40267333637543,31
"7147","MG","Coronel Murta",9215,8721.9,31012,"Araçuaí",3,"Sudeste",0,"311950",4,9,2,7,5,4,0,0,0,0,0,9,2,7,5,4,7,9.07359238307672,9.12858787010392,0.458940879177067,30
"7148","MG","Coronel Murta",9215,8721.9,31012,"Araçuaí",3,"Sudeste",0,"311950",5,8,2,6,2,6,0,0,0,0,0,8,2,6,2,6,4,9.07359238307672,9.12858787010392,0.413791504781473,31
"7149","MG","Coronel Pacheco",3090,13117.79,31065,"Juiz de Fora",3,"Sudeste",0,"311960",2,1,1,0,1,0,0,0,0,0,0,1,1,0,1,0,0,9.48172460318766,8.03592636989179,0.285410441239428,29
"7150","MG","Coronel Pacheco",3090,13117.79,31065,"Juiz de Fora",3,"Sudeste",0,"311960",3,1,0,1,0,1,0,0,0,0,0,1,0,1,0,1,0,9.48172460318766,8.03592636989179,0.411400283906139,31
"7151","MG","Coronel Pacheco",3090,13117.79,31065,"Juiz de Fora",3,"Sudeste",0,"311960",4,0,0,0,0,0,0,0,0,0,0,0,0,0,0,0,0,9.48172460318766,8.03592636989179,0.455081040229384,30
"7152","MG","Coronel Pacheco",3090,13117.79,31065,"Juiz de Fora",3,"Sudeste",0,"311960",5,3,0,3,2,1,0,0,0,0,0,3,0,3,2,1,1,9.48172460318766,8.03592636989179,0.440392846997834,31
"7153","MG","Cristais",12931,14356.93,31045,"Campo Belo",3,"Sudeste",0,"312020",2,11,3,8,4,7,0,0,0,0,0,11,3,8,4,7,5,9.5719880314454,9.46738280829585,0.300731672747596,29
"7154","MG","Cristais",12931,14356.93,31045,"Campo Belo",3,"Sudeste",0,"312020",3,8,1,7,2,6,0,0,0,0,0,8,1,7,2,6,11,9.5719880314454,9.46738280829585,0.357979790659774,31
"7155","MG","Cristais",12931,14356.93,31045,"Campo Belo",3,"Sudeste",0,"312020",4,13,6,7,6,7,0,0,0,0,0,13,6,7,6,7,6,9.5719880314454,9.46738280829585,0.388743202458494,30
"7156","MG","Cristais",12931,14356.93,31045,"Campo Belo",3,"Sudeste",0,"312020",5,11,3,8,4,7,0,0,0,0,0,11,3,8,4,7,7,9.5719880314454,9.46738280829585,0.356619870495581,31
"7157","MG","Cristina",10226,15978.3,31056,"Itajubá",3,"Sudeste",0,"312050",2,8,3,5,1,7,0,0,0,0,0,8,3,5,1,7,6,9.67898683068247,9.23268877563994,0.385809521262516,29
"7158","MG","Cristina",10226,15978.3,31056,"Itajubá",3,"Sudeste",0,"312050",3,9,3,6,2,7,0,0,0,0,0,9,3,6,2,7,7,9.67898683068247,9.23268877563994,0.477723674005008,31
"7159","MG","Cristina",10226,15978.3,31056,"Itajubá",3,"Sudeste",0,"312050",4,8,0,8,2,6,0,0,0,0,0,8,0,8,2,6,6,9.67898683068247,9.23268877563994,0.459959512382698,30
"7160","MG","Cristina",10226,15978.3,31056,"Itajubá",3,"Sudeste",0,"312050",5,7,2,5,2,5,0,0,0,0,0,7,2,5,2,5,8,9.67898683068247,9.23268877563994,0.452515938373443,31
"7161","MG","Cruzília",15474,14871.29,31055,"Andrelândia",3,"Sudeste",1,"312080",2,11,0,11,4,7,0,0,0,0,0,11,0,11,4,7,13,9.60718778754084,9.6469164751094,0.307857371363273,29
"7162","MG","Cruzília",15474,14871.29,31055,"Andrelândia",3,"Sudeste",1,"312080",3,21,5,16,9,12,0,0,0,0,0,21,5,16,9,12,10,9.60718778754084,9.6469164751094,0.376510405675244,31
"7163","MG","Cruzília",15474,14871.29,31055,"Andrelândia",3,"Sudeste",1,"312080",4,13,0,13,4,9,0,0,0,0,0,13,0,13,4,9,12,9.60718778754084,9.6469164751094,0.415703891908649,30
"7164","MG","Cruzília",15474,14871.29,31055,"Andrelândia",3,"Sudeste",1,"312080",5,14,7,7,4,10,0,0,0,0,0,14,7,7,4,10,13,9.60718778754084,9.6469164751094,0.407927484288775,31
"7165","MG","Curral de Dentro",7799,8100.44,31005,"Salinas",3,"Sudeste",0,"312087",2,9,0,9,3,6,0,0,0,0,0,9,0,9,3,6,2,8.99967366017285,8.9617507993305,0.318567725880483,29
"7166","MG","Curral de Dentro",7799,8100.44,31005,"Salinas",3,"Sudeste",0,"312087",3,14,3,11,9,5,1,0,1,1,0,15,3,12,10,5,3,8.99967366017285,8.9617507993305,0.387055079346304,31
"7167","MG","Curral de Dentro",7799,8100.44,31005,"Salinas",3,"Sudeste",0,"312087",4,9,2,7,2,7,0,0,0,0,0,9,2,7,2,7,3,8.99967366017285,8.9617507993305,0.363980784247513,30
"7168","MG","Curral de Dentro",7799,8100.44,31005,"Salinas",3,"Sudeste",0,"312087",5,8,2,6,5,3,0,0,0,0,0,8,2,6,5,3,2,8.99967366017285,8.9617507993305,0.344150655341818,31
"7169","MG","Curvelo",80616,19260.82,31025,"Curvelo",3,"Sudeste",1,"312090",2,76,18,58,36,40,0,0,0,0,0,76,18,58,36,40,45,9.86582825973138,11.2974524199602,0.3084921514564,29
"7170","MG","Curvelo",80616,19260.82,31025,"Curvelo",3,"Sudeste",1,"312090",3,78,11,67,41,37,0,0,0,0,0,78,11,67,41,37,46,9.86582825973138,11.2974524199602,0.384326246516958,31
"7171","MG","Curvelo",80616,19260.82,31025,"Curvelo",3,"Sudeste",1,"312090",4,68,17,51,26,42,1,1,0,0,1,69,18,51,26,43,45,9.86582825973138,11.2974524199602,0.420344681877737,30
"7172","MG","Curvelo",80616,19260.82,31025,"Curvelo",3,"Sudeste",1,"312090",5,83,25,58,39,44,1,0,1,0,1,84,25,59,39,45,43,9.86582825973138,11.2974524199602,0.408809604714772,31
"7173","MG","Delfinópolis",7131,23222.71,31047,"Passos",3,"Sudeste",0,"312120",2,8,3,5,2,6,1,0,1,1,0,9,3,6,3,6,3,10.0528859581748,8.8722067560283,0.327777173739717,29
"7174","MG","Delfinópolis",7131,23222.71,31047,"Passos",3,"Sudeste",0,"312120",3,4,0,4,2,2,0,0,0,0,0,4,0,4,2,2,8,10.0528859581748,8.8722067560283,0.399111331459421,31
"7175","MG","Delfinópolis",7131,23222.71,31047,"Passos",3,"Sudeste",0,"312120",4,5,2,3,3,2,0,0,0,0,0,5,2,3,3,2,5,10.0528859581748,8.8722067560283,0.4281932370922,30
"7176","MG","Delfinópolis",7131,23222.71,31047,"Passos",3,"Sudeste",0,"312120",5,10,2,8,3,7,1,0,1,1,0,11,2,9,4,7,6,10.0528859581748,8.8722067560283,0.43926218525914,31
"7177","MG","Delta",10768,34012.97,31022,"Uberaba",3,"Sudeste",0,"312125",2,11,3,8,4,7,0,0,0,0,0,11,3,8,4,7,0,10.4344972014451,9.28433405188451,0.329714678737384,29
"7178","MG","Delta",10768,34012.97,31022,"Uberaba",3,"Sudeste",0,"312125",3,11,3,8,2,9,0,0,0,0,0,11,3,8,2,9,1,10.4344972014451,9.28433405188451,0.390796573488555,31
"7179","MG","Delta",10768,34012.97,31022,"Uberaba",3,"Sudeste",0,"312125",4,11,2,9,7,4,0,0,0,0,0,11,2,9,7,4,3,10.4344972014451,9.28433405188451,0.365305158053282,30
"7180","MG","Delta",10768,34012.97,31022,"Uberaba",3,"Sudeste",0,"312125",5,5,2,3,1,4,0,0,0,0,0,5,2,3,1,4,1,10.4344972014451,9.28433405188451,0.369750546910426,31
"7181","MG","Desterro de Entre Rios",7255,18821.67,31034,"Conselheiro Lafaiete",3,"Sudeste",0,"312140",2,9,1,8,3,6,0,0,0,0,0,9,1,8,3,6,5,9.8427641445905,8.88944616531829,0.30769789673404,29
"7182","MG","Desterro de Entre Rios",7255,18821.67,31034,"Conselheiro Lafaiete",3,"Sudeste",0,"312140",3,6,2,4,1,5,0,0,0,0,0,6,2,4,1,5,3,9.8427641445905,8.88944616531829,0.357047883332037,31
"7183","MG","Desterro de Entre Rios",7255,18821.67,31034,"Conselheiro Lafaiete",3,"Sudeste",0,"312140",4,7,1,6,3,4,0,0,0,0,0,7,1,6,3,4,8,9.8427641445905,8.88944616531829,0.409265524622941,30
"7184","MG","Desterro de Entre Rios",7255,18821.67,31034,"Conselheiro Lafaiete",3,"Sudeste",0,"312140",5,7,0,7,4,3,0,0,0,0,0,7,0,7,4,3,5,9.8427641445905,8.88944616531829,0.399947062639132,31
"7185","MG","Diamantina",47825,15911.38,31010,"Diamantina",3,"Sudeste",1,"312160",2,50,8,42,17,33,0,0,0,0,0,50,8,42,17,33,24,9.67478985547101,10.7753037943085,0.323166712348256,29
"7186","MG","Diamantina",47825,15911.38,31010,"Diamantina",3,"Sudeste",1,"312160",3,54,6,48,22,32,1,0,1,0,1,55,6,49,22,33,35,9.67478985547101,10.7753037943085,0.420389932744609,31
"7187","MG","Diamantina",47825,15911.38,31010,"Diamantina",3,"Sudeste",1,"312160",4,49,13,36,13,36,0,0,0,0,0,49,13,36,13,36,18,9.67478985547101,10.7753037943085,0.475551571126117,30
"7188","MG","Diamantina",47825,15911.38,31010,"Diamantina",3,"Sudeste",1,"312160",5,63,10,53,21,42,0,0,0,0,0,63,10,53,21,42,32,9.67478985547101,10.7753037943085,0.462596572985981,31
"7189","MG","Divino",19976,11431.25,31063,"Muriaé",3,"Sudeste",0,"312200",2,16,6,10,8,8,0,0,0,0,0,16,6,10,8,8,11,9.34410611213918,9.90228683195961,0.306811774054941,29
"7190","MG","Divino",19976,11431.25,31063,"Muriaé",3,"Sudeste",0,"312200",3,19,5,14,11,8,0,0,0,0,0,19,5,14,11,8,13,9.34410611213918,9.90228683195961,0.400307887710264,31
"7191","MG","Divino",19976,11431.25,31063,"Muriaé",3,"Sudeste",0,"312200",4,26,10,16,13,13,0,0,0,0,0,26,10,16,13,13,14,9.34410611213918,9.90228683195961,0.435144985277862,30
"7192","MG","Divino",19976,11431.25,31063,"Muriaé",3,"Sudeste",0,"312200",5,23,10,13,13,10,0,0,0,0,0,23,10,13,13,10,14,9.34410611213918,9.90228683195961,0.394435499204785,31
"7193","MG","Divinolândia de Minas",7614,8411.7,31035,"Guanhães",3,"Sudeste",0,"312220",2,6,3,3,3,3,0,0,0,0,0,6,3,3,3,3,2,9.03737887284855,8.93774393694244,0.30129712958469,29
"7194","MG","Divinolândia de Minas",7614,8411.7,31035,"Guanhães",3,"Sudeste",0,"312220",3,5,3,2,1,4,0,0,0,0,0,5,3,2,1,4,5,9.03737887284855,8.93774393694244,0.418105574291886,31
"7195","MG","Divinolândia de Minas",7614,8411.7,31035,"Guanhães",3,"Sudeste",0,"312220",4,9,3,6,2,7,0,0,0,0,0,9,3,6,2,7,4,9.03737887284855,8.93774393694244,0.418352832964987,30
"7196","MG","Divinolândia de Minas",7614,8411.7,31035,"Guanhães",3,"Sudeste",0,"312220",5,7,3,4,1,6,0,0,0,0,0,7,3,4,1,6,3,9.03737887284855,8.93774393694244,0.384035416611056,31
"7197","MG","Divinópolis",240408,27388.18,31043,"Divinópolis",3,"Sudeste",1,"312230",2,196,16,180,44,152,1,1,0,1,0,197,17,180,45,152,104,10.2178668124408,12.3900927589597,0.294641383006694,29
"7198","MG","Divinópolis",240408,27388.18,31043,"Divinópolis",3,"Sudeste",1,"312230",3,203,25,178,51,152,2,0,2,0,2,205,25,180,51,154,120,10.2178668124408,12.3900927589597,0.39004217307999,31
"7199","MG","Divinópolis",240408,27388.18,31043,"Divinópolis",3,"Sudeste",1,"312230",4,189,14,175,43,146,2,0,2,1,1,191,14,177,44,147,104,10.2178668124408,12.3900927589597,0.448682938910804,30
"7200","MG","Divinópolis",240408,27388.18,31043,"Divinópolis",3,"Sudeste",1,"312230",5,237,29,208,56,181,2,1,1,1,1,239,30,209,57,182,107,10.2178668124408,12.3900927589597,0.392229397930489,31
"7201","MG","Divisa Alegre",6868,20598.03,31005,"Salinas",3,"Sudeste",0,"312235",2,2,0,2,2,0,0,0,0,0,0,2,0,2,2,0,2,9.93295071913677,8.83462822201737,0.283991280478862,29
"7202","MG","Divisa Alegre",6868,20598.03,31005,"Salinas",3,"Sudeste",0,"312235",3,0,0,0,0,0,0,0,0,0,0,0,0,0,0,0,3,9.93295071913677,8.83462822201737,0.3750266730662,31
"7203","MG","Divisa Alegre",6868,20598.03,31005,"Salinas",3,"Sudeste",0,"312235",4,2,1,1,0,2,0,0,0,0,0,2,1,1,0,2,3,9.93295071913677,8.83462822201737,0.386902263679319,30
"7204","MG","Divisa Alegre",6868,20598.03,31005,"Salinas",3,"Sudeste",0,"312235",5,1,0,1,1,0,1,1,0,1,0,2,1,1,2,0,1,9.93295071913677,8.83462822201737,0.368545901153518,31
"7205","MG","Divisa Nova",6025,14963.91,31049,"Alfenas",3,"Sudeste",0,"312240",2,5,1,4,1,4,0,0,0,0,0,5,1,4,1,4,4,9.61339658101531,8.70367275835886,0.346301173595201,29
"7206","MG","Divisa Nova",6025,14963.91,31049,"Alfenas",3,"Sudeste",0,"312240",3,5,2,3,2,3,0,0,0,0,0,5,2,3,2,3,2,9.61339658101531,8.70367275835886,0.433541652383258,31
"7207","MG","Divisa Nova",6025,14963.91,31049,"Alfenas",3,"Sudeste",0,"312240",4,6,3,3,4,2,0,0,0,0,0,6,3,3,4,2,6,9.61339658101531,8.70367275835886,0.423471898338718,30
"7208","MG","Divisa Nova",6025,14963.91,31049,"Alfenas",3,"Sudeste",0,"312240",5,7,2,5,3,4,0,0,0,0,0,7,2,5,3,4,4,9.61339658101531,8.70367275835886,0.40735486290363,31
"7209","MG","Divisópolis",11211,6780.22,31014,"Almenara",3,"Sudeste",0,"312245",2,1,0,1,0,1,1,0,1,1,0,2,0,2,1,1,1,8.82176482878559,9.32465071815359,0.312436566076248,29
"7210","MG","Divisópolis",11211,6780.22,31014,"Almenara",3,"Sudeste",0,"312245",3,4,0,4,2,2,0,0,0,0,0,4,0,4,2,2,7,8.82176482878559,9.32465071815359,0.376662675335538,31
"7211","MG","Divisópolis",11211,6780.22,31014,"Almenara",3,"Sudeste",0,"312245",4,1,0,1,0,1,0,0,0,0,0,1,0,1,0,1,0,8.82176482878559,9.32465071815359,0.382815424041452,30
"7212","MG","Divisópolis",11211,6780.22,31014,"Almenara",3,"Sudeste",0,"312245",5,0,0,0,0,0,0,0,0,0,0,0,0,0,0,0,5,8.82176482878559,9.32465071815359,0.37148447642924,31
"7213","MG","Dona Euzébia",6619,11994.99,31066,"Cataguases",3,"Sudeste",0,"312290",2,6,1,5,1,5,0,0,0,0,0,6,1,5,1,5,4,9.39224434159275,8.79769958011892,0.340995307868422,29
"7214","MG","Dona Euzébia",6619,11994.99,31066,"Cataguases",3,"Sudeste",0,"312290",3,3,2,1,1,2,0,0,0,0,0,3,2,1,1,2,3,9.39224434159275,8.79769958011892,0.433615081770687,31
"7215","MG","Dona Euzébia",6619,11994.99,31066,"Cataguases",3,"Sudeste",0,"312290",4,5,1,4,2,3,0,0,0,0,0,5,1,4,2,3,4,9.39224434159275,8.79769958011892,0.443391626381499,30
"7216","MG","Dona Euzébia",6619,11994.99,31066,"Cataguases",3,"Sudeste",0,"312290",5,9,2,7,5,4,0,0,0,0,0,9,2,7,5,4,1,9.39224434159275,8.79769958011892,0.416228803459843,31
"7217","MG","Dores de Campos",10223,26967.82,31058,"São João Del Rei",3,"Sudeste",0,"312300",2,10,2,8,4,6,0,0,0,0,0,10,2,8,4,6,5,10.2023995823143,9.23239536275701,0.358227600867236,29
"7218","MG","Dores de Campos",10223,26967.82,31058,"São João Del Rei",3,"Sudeste",0,"312300",3,15,4,11,3,12,0,0,0,0,0,15,4,11,3,12,7,10.2023995823143,9.23239536275701,0.433771718500452,31
"7219","MG","Dores de Campos",10223,26967.82,31058,"São João Del Rei",3,"Sudeste",0,"312300",4,12,3,9,2,10,0,0,0,0,0,12,3,9,2,10,5,10.2023995823143,9.23239536275701,0.454259002707439,30
"7220","MG","Dores de Campos",10223,26967.82,31058,"São João Del Rei",3,"Sudeste",0,"312300",5,4,1,3,0,4,0,0,0,0,0,4,1,3,0,4,5,10.2023995823143,9.23239536275701,0.438770377546005,31
"7221","MG","Dores do Indaiá",13427,16969.75,31026,"Bom Despacho",3,"Sudeste",1,"312320",2,11,1,10,5,6,0,0,0,0,0,11,1,10,5,6,5,9.73918762623997,9.50502288407271,0.268745140700217,29
"7222","MG","Dores do Indaiá",13427,16969.75,31026,"Bom Despacho",3,"Sudeste",1,"312320",3,4,1,3,1,3,0,0,0,0,0,4,1,3,1,3,11,9.73918762623997,9.50502288407271,0.344943810971092,31
"7223","MG","Dores do Indaiá",13427,16969.75,31026,"Bom Despacho",3,"Sudeste",1,"312320",4,5,2,3,4,1,0,0,0,0,0,5,2,3,4,1,8,9.73918762623997,9.50502288407271,0.383696815725656,30
"7224","MG","Dores do Indaiá",13427,16969.75,31026,"Bom Despacho",3,"Sudeste",1,"312320",5,14,2,12,8,6,0,0,0,0,0,14,2,12,8,6,16,9.73918762623997,9.50502288407271,0.338722279649162,31
"7225","MG","Elói Mendes",28320,18399.4,31050,"Varginha",3,"Sudeste",1,"312360",2,29,7,22,13,16,0,0,0,0,0,29,7,22,13,16,11,9.82007333436975,10.2513235478077,0.314466183370125,29
"7226","MG","Elói Mendes",28320,18399.4,31050,"Varginha",3,"Sudeste",1,"312360",3,29,8,21,10,19,0,0,0,0,0,29,8,21,10,19,14,9.82007333436975,10.2513235478077,0.376677317011607,31
"7227","MG","Elói Mendes",28320,18399.4,31050,"Varginha",3,"Sudeste",1,"312360",4,29,12,17,14,15,0,0,0,0,0,29,12,17,14,15,15,9.82007333436975,10.2513235478077,0.416169384493853,30
"7228","MG","Elói Mendes",28320,18399.4,31050,"Varginha",3,"Sudeste",1,"312360",5,30,9,21,14,16,0,0,0,0,0,30,9,21,14,16,11,9.82007333436975,10.2513235478077,0.383746287003721,31
"7229","MG","Engenheiro Caldas",11202,10464.07,31037,"Governador Valadares",3,"Sudeste",0,"312370",2,8,5,3,2,6,0,0,0,0,0,8,5,3,2,6,9,9.25570276327705,9.32384761276978,0.311147491934136,29
"7230","MG","Engenheiro Caldas",11202,10464.07,31037,"Governador Valadares",3,"Sudeste",0,"312370",3,10,1,9,7,3,0,0,0,0,0,10,1,9,7,3,8,9.25570276327705,9.32384761276978,0.395482671599667,31
"7231","MG","Engenheiro Caldas",11202,10464.07,31037,"Governador Valadares",3,"Sudeste",0,"312370",4,12,2,10,7,5,0,0,0,0,0,12,2,10,7,5,7,9.25570276327705,9.32384761276978,0.411406406666817,30
"7232","MG","Engenheiro Caldas",11202,10464.07,31037,"Governador Valadares",3,"Sudeste",0,"312370",5,15,5,10,9,6,0,0,0,0,0,15,5,10,9,6,14,9.25570276327705,9.32384761276978,0.370645955344792,31
"7233","MG","Engenheiro Navarro",7241,9135.37,31009,"Bocaiúva",3,"Sudeste",0,"312380",2,6,1,5,4,2,0,0,0,0,0,6,1,5,4,2,2,9.11990897154961,8.88751459738882,0.300947546528513,29
"7234","MG","Engenheiro Navarro",7241,9135.37,31009,"Bocaiúva",3,"Sudeste",0,"312380",3,8,2,6,2,6,0,0,0,0,0,8,2,6,2,6,1,9.11990897154961,8.88751459738882,0.403648901373017,31
"7235","MG","Engenheiro Navarro",7241,9135.37,31009,"Bocaiúva",3,"Sudeste",0,"312380",4,6,0,6,4,2,0,0,0,0,0,6,0,6,4,2,6,9.11990897154961,8.88751459738882,0.438923551958041,30
"7236","MG","Engenheiro Navarro",7241,9135.37,31009,"Bocaiúva",3,"Sudeste",0,"312380",5,10,4,6,3,7,0,0,0,0,0,10,4,6,3,7,7,9.11990897154961,8.88751459738882,0.419959961857269,31
"7237","MG","Entre Rios de Minas",15380,13683.27,31034,"Conselheiro Lafaiete",3,"Sudeste",0,"312390",2,18,2,16,5,13,0,0,0,0,0,18,2,16,5,13,8,9.52392919769993,9.64082324305964,0.303576342384209,29
"7238","MG","Entre Rios de Minas",15380,13683.27,31034,"Conselheiro Lafaiete",3,"Sudeste",0,"312390",3,5,2,3,1,4,0,0,0,0,0,5,2,3,1,4,10,9.52392919769993,9.64082324305964,0.398963670099967,31
"7239","MG","Entre Rios de Minas",15380,13683.27,31034,"Conselheiro Lafaiete",3,"Sudeste",0,"312390",4,9,0,9,1,8,0,0,0,0,0,9,0,9,1,8,16,9.52392919769993,9.64082324305964,0.449277179685627,30
"7240","MG","Entre Rios de Minas",15380,13683.27,31034,"Conselheiro Lafaiete",3,"Sudeste",0,"312390",5,24,3,21,5,19,0,0,0,0,0,24,3,21,5,19,5,9.52392919769993,9.64082324305964,0.4248527333168,31
"7241","MG","Ervália",18958,16087.86,31062,"Viçosa",3,"Sudeste",0,"312400",2,13,3,10,3,10,0,0,0,0,0,13,3,10,3,10,14,9.68582022927638,9.84998128501299,0.308926271429056,29
"7242","MG","Ervália",18958,16087.86,31062,"Viçosa",3,"Sudeste",0,"312400",3,18,7,11,9,9,0,0,0,0,0,18,7,11,9,9,12,9.68582022927638,9.84998128501299,0.39637534158211,31
"7243","MG","Ervália",18958,16087.86,31062,"Viçosa",3,"Sudeste",0,"312400",4,14,3,11,3,11,0,0,0,0,0,14,3,11,3,11,13,9.68582022927638,9.84998128501299,0.433779513218989,30
"7244","MG","Ervália",18958,16087.86,31062,"Viçosa",3,"Sudeste",0,"312400",5,19,9,10,6,13,0,0,0,0,0,19,9,10,6,13,10,9.68582022927638,9.84998128501299,0.42237595830682,31
"7245","MG","Esmeraldas",71551,9832.71,31030,"Belo Horizonte",3,"Sudeste",1,"312410",2,68,17,51,24,44,2,1,1,2,0,70,18,52,26,44,37,9.19346986182007,11.1781657611273,0.303956731527607,29
"7246","MG","Esmeraldas",71551,9832.71,31030,"Belo Horizonte",3,"Sudeste",1,"312410",3,59,14,45,19,40,2,1,1,2,0,61,15,46,21,40,38,9.19346986182007,11.1781657611273,0.393097603147712,31
"7247","MG","Esmeraldas",71551,9832.71,31030,"Belo Horizonte",3,"Sudeste",1,"312410",4,71,11,60,26,45,0,0,0,0,0,71,11,60,26,45,31,9.19346986182007,11.1781657611273,0.432897622508791,30
"7248","MG","Esmeraldas",71551,9832.71,31030,"Belo Horizonte",3,"Sudeste",1,"312410",5,77,20,57,31,46,1,1,0,0,1,78,21,57,31,47,27,9.19346986182007,11.1781657611273,0.399919095077078,31
"7249","MG","Espera Feliz",25122,16890.3,31063,"Muriaé",3,"Sudeste",0,"312420",2,12,5,7,6,6,0,0,0,0,0,12,5,7,6,6,15,9.73449477163345,10.1314992352472,0.342016293522833,29
"7250","MG","Espera Feliz",25122,16890.3,31063,"Muriaé",3,"Sudeste",0,"312420",3,26,7,19,9,17,0,0,0,0,0,26,7,19,9,17,11,9.73449477163345,10.1314992352472,0.414691579550091,31
"7251","MG","Espera Feliz",25122,16890.3,31063,"Muriaé",3,"Sudeste",0,"312420",4,30,10,20,15,15,0,0,0,0,0,30,10,20,15,15,9,9.73449477163345,10.1314992352472,0.442894456200855,30
"7252","MG","Espera Feliz",25122,16890.3,31063,"Muriaé",3,"Sudeste",0,"312420",5,30,7,23,15,15,0,0,0,0,0,30,7,23,15,15,11,9.73449477163345,10.1314992352472,0.405362691212751,31
"7253","MG","Espinosa",31610,10154.54,31004,"Janaúba",3,"Sudeste",0,"312430",2,26,9,17,12,14,1,0,1,0,1,27,9,18,12,15,13,9.22567617510569,10.3612288052097,0.262146876709868,29
"7254","MG","Espinosa",31610,10154.54,31004,"Janaúba",3,"Sudeste",0,"312430",3,24,5,19,9,15,0,0,0,0,0,24,5,19,9,15,18,9.22567617510569,10.3612288052097,0.360157711806977,31
"7255","MG","Espinosa",31610,10154.54,31004,"Janaúba",3,"Sudeste",0,"312430",4,17,10,7,8,9,1,0,1,0,1,18,10,8,8,10,10,9.22567617510569,10.3612288052097,0.397434799874105,30
"7256","MG","Espinosa",31610,10154.54,31004,"Janaúba",3,"Sudeste",0,"312430",5,47,12,35,14,33,1,1,0,0,1,48,13,35,14,34,23,9.22567617510569,10.3612288052097,0.391290158951545,31
"7257","MG","Espírito Santo do Dourado",4710,16654.3,31052,"Pouso Alegre",3,"Sudeste",0,"312440",2,8,5,3,4,4,0,0,0,0,0,8,5,3,4,4,4,9.72042372032393,8.45744318701046,0.352702389392797,29
"7258","MG","Espírito Santo do Dourado",4710,16654.3,31052,"Pouso Alegre",3,"Sudeste",0,"312440",3,7,4,3,3,4,0,0,0,0,0,7,4,3,3,4,0,9.72042372032393,8.45744318701046,0.459599715030807,31
"7259","MG","Espírito Santo do Dourado",4710,16654.3,31052,"Pouso Alegre",3,"Sudeste",0,"312440",4,5,0,5,2,3,0,0,0,0,0,5,0,5,2,3,1,9.72042372032393,8.45744318701046,0.483467475618827,30
"7260","MG","Espírito Santo do Dourado",4710,16654.3,31052,"Pouso Alegre",3,"Sudeste",0,"312440",5,6,0,6,5,1,0,0,0,0,0,6,0,6,5,1,5,9.72042372032393,8.45744318701046,0.443407913568076,31
"7261","MG","Estiva",11386,22788.83,31052,"Pouso Alegre",3,"Sudeste",0,"312450",2,9,2,7,3,6,0,0,0,0,0,9,2,7,3,6,3,10.0340257826156,9.34013980951103,0.310690139615418,29
"7262","MG","Estiva",11386,22788.83,31052,"Pouso Alegre",3,"Sudeste",0,"312450",3,7,1,6,3,4,0,0,0,0,0,7,1,6,3,4,6,10.0340257826156,9.34013980951103,0.37176676797216,31
"7263","MG","Estiva",11386,22788.83,31052,"Pouso Alegre",3,"Sudeste",0,"312450",4,6,2,4,0,6,0,0,0,0,0,6,2,4,0,6,9,10.0340257826156,9.34013980951103,0.380304382506399,30
"7264","MG","Estiva",11386,22788.83,31052,"Pouso Alegre",3,"Sudeste",0,"312450",5,9,1,8,3,6,0,0,0,0,0,9,1,8,3,6,5,10.0340257826156,9.34013980951103,0.380170081329469,31
"7265","MG","Estrela do Sul",8018,72318.96,31019,"Patrocínio",3,"Sudeste",0,"312480",2,3,1,2,2,1,0,0,0,0,0,3,1,2,2,1,2,11.1888416144317,8.98944429320245,0.323844056039075,29
"7266","MG","Estrela do Sul",8018,72318.96,31019,"Patrocínio",3,"Sudeste",0,"312480",3,7,2,5,2,5,0,0,0,0,0,7,2,5,2,5,3,11.1888416144317,8.98944429320245,0.358872660359371,31
"7267","MG","Estrela do Sul",8018,72318.96,31019,"Patrocínio",3,"Sudeste",0,"312480",4,6,1,5,4,2,0,0,0,0,0,6,1,5,4,2,3,11.1888416144317,8.98944429320245,0.39870269185169,30
"7268","MG","Estrela do Sul",8018,72318.96,31019,"Patrocínio",3,"Sudeste",0,"312480",5,12,3,9,3,9,0,0,0,0,0,12,3,9,3,9,1,11.1888416144317,8.98944429320245,0.410727355767336,31
"7269","MG","Eugenópolis",11330,14137.88,31063,"Muriaé",3,"Sudeste",0,"312490",2,8,1,7,3,5,0,0,0,0,0,8,1,7,3,5,7,9.5566129989314,9.33520935402205,0.308211023605165,29
"7270","MG","Eugenópolis",11330,14137.88,31063,"Muriaé",3,"Sudeste",0,"312490",3,10,2,8,2,8,0,0,0,0,0,10,2,8,2,8,12,9.5566129989314,9.33520935402205,0.412540298358488,31
"7271","MG","Eugenópolis",11330,14137.88,31063,"Muriaé",3,"Sudeste",0,"312490",4,9,2,7,1,8,0,0,0,0,0,9,2,7,1,8,11,9.5566129989314,9.33520935402205,0.428076817207104,30
"7272","MG","Eugenópolis",11330,14137.88,31063,"Muriaé",3,"Sudeste",0,"312490",5,9,4,5,6,3,0,0,0,0,0,9,4,5,6,3,10,9.5566129989314,9.33520935402205,0.439945422610829,31
"7273","MG","Ewbank da Câmara",3923,9821.09,31065,"Juiz de Fora",3,"Sudeste",1,"312500",2,7,3,4,2,5,0,0,0,0,0,7,3,4,2,5,4,9.19228739315203,8.27461194620955,0.317869800788236,29
"7274","MG","Ewbank da Câmara",3923,9821.09,31065,"Juiz de Fora",3,"Sudeste",1,"312500",3,7,2,5,3,4,0,0,0,0,0,7,2,5,3,4,4,9.19228739315203,8.27461194620955,0.415698594957275,31
"7275","MG","Ewbank da Câmara",3923,9821.09,31065,"Juiz de Fora",3,"Sudeste",1,"312500",4,2,1,1,2,0,0,0,0,0,0,2,1,1,2,0,5,9.19228739315203,8.27461194620955,0.471804597040649,30
"7276","MG","Ewbank da Câmara",3923,9821.09,31065,"Juiz de Fora",3,"Sudeste",1,"312500",5,1,0,1,1,0,0,0,0,0,0,1,0,1,1,0,4,9.19228739315203,8.27461194620955,0.435423280209872,31
"7277","MG","Extrema",36951,268459.18,31052,"Pouso Alegre",3,"Sudeste",0,"312510",2,46,7,39,16,30,0,0,0,0,0,46,7,39,16,30,12,12.5004541515782,10.5173479896096,0.304352814334646,29
"7278","MG","Extrema",36951,268459.18,31052,"Pouso Alegre",3,"Sudeste",0,"312510",3,72,14,58,25,47,1,0,1,0,1,73,14,59,25,48,14,12.5004541515782,10.5173479896096,0.408373688419902,31
"7279","MG","Extrema",36951,268459.18,31052,"Pouso Alegre",3,"Sudeste",0,"312510",4,43,8,35,16,27,0,0,0,0,0,43,8,35,16,27,26,12.5004541515782,10.5173479896096,0.454587947358053,30
"7280","MG","Extrema",36951,268459.18,31052,"Pouso Alegre",3,"Sudeste",0,"312510",5,73,13,60,38,35,0,0,0,0,0,73,13,60,38,35,15,12.5004541515782,10.5173479896096,0.432281625229734,31
"7281","MG","Felixlândia",15433,14606.74,31025,"Curvelo",3,"Sudeste",0,"312570",2,9,3,6,3,6,0,0,0,0,0,9,3,6,3,6,10,9.58923834500731,9.64426335290083,0.348822179028096,29
"7282","MG","Felixlândia",15433,14606.74,31025,"Curvelo",3,"Sudeste",0,"312570",3,14,6,8,3,11,0,0,0,0,0,14,6,8,3,11,10,9.58923834500731,9.64426335290083,0.432964524755635,31
"7283","MG","Felixlândia",15433,14606.74,31025,"Curvelo",3,"Sudeste",0,"312570",4,5,3,2,3,2,0,0,0,0,0,5,3,2,3,2,12,9.58923834500731,9.64426335290083,0.449810652461992,30
"7284","MG","Felixlândia",15433,14606.74,31025,"Curvelo",3,"Sudeste",0,"312570",5,13,5,8,7,6,0,0,0,0,0,13,5,8,7,6,4,9.58923834500731,9.64426335290083,0.433006110980602,31
"7285","MG","Florestal",7533,15181.52,31029,"Pará de Minas",3,"Sudeste",0,"312600",2,5,0,5,2,3,0,0,0,0,0,5,0,5,2,3,1,9.62783417768908,8.92704864782569,0.309775652194961,29
"7286","MG","Florestal",7533,15181.52,31029,"Pará de Minas",3,"Sudeste",0,"312600",3,5,1,4,1,4,0,0,0,0,0,5,1,4,1,4,2,9.62783417768908,8.92704864782569,0.388341376870685,31
"7287","MG","Florestal",7533,15181.52,31029,"Pará de Minas",3,"Sudeste",0,"312600",4,4,0,4,2,2,0,0,0,0,0,4,0,4,2,2,1,9.62783417768908,8.92704864782569,0.468613922817041,30
"7288","MG","Florestal",7533,15181.52,31029,"Pará de Minas",3,"Sudeste",0,"312600",5,8,1,7,1,7,0,0,0,0,0,8,1,7,1,7,4,9.62783417768908,8.92704864782569,0.3924382227682,31
"7289","MG","Formiga",67822,25107.98,31044,"Formiga",3,"Sudeste",1,"312610",2,48,5,43,10,38,1,0,1,0,1,49,5,44,10,39,44,10.1309410028782,11.1246419050708,0.306966930666997,29
"7290","MG","Formiga",67822,25107.98,31044,"Formiga",3,"Sudeste",1,"312610",3,49,7,42,14,35,0,0,0,0,0,49,7,42,14,35,50,10.1309410028782,11.1246419050708,0.384649087454273,31
"7291","MG","Formiga",67822,25107.98,31044,"Formiga",3,"Sudeste",1,"312610",4,56,11,45,18,38,0,0,0,0,0,56,11,45,18,38,46,10.1309410028782,11.1246419050708,0.423367982104083,30
"7292","MG","Formiga",67822,25107.98,31044,"Formiga",3,"Sudeste",1,"312610",5,45,6,39,11,34,0,0,0,0,0,45,6,39,11,34,48,10.1309410028782,11.1246419050708,0.381166290005095,31
"7293","MG","Formoso",9688,21306.62,31001,"Unaí",3,"Sudeste",0,"312620",2,12,4,8,7,5,0,0,0,0,0,12,4,8,7,5,1,9.96677310153185,9.17864328523293,0.271711805316534,29
"7294","MG","Formoso",9688,21306.62,31001,"Unaí",3,"Sudeste",0,"312620",3,8,1,7,2,6,0,0,0,0,0,8,1,7,2,6,1,9.96677310153185,9.17864328523293,0.329368619211117,31
"7295","MG","Formoso",9688,21306.62,31001,"Unaí",3,"Sudeste",0,"312620",4,8,3,5,4,4,0,0,0,0,0,8,3,5,4,4,2,9.96677310153185,9.17864328523293,0.354773472524019,30
"7296","MG","Formoso",9688,21306.62,31001,"Unaí",3,"Sudeste",0,"312620",5,8,2,6,4,4,0,0,0,0,0,8,2,6,4,4,6,9.96677310153185,9.17864328523293,0.382336222604525,31
"7297","MG","Francisco Sá",26369,13826.93,31007,"Montes Claros",3,"Sudeste",0,"312670",2,16,5,11,4,12,0,0,0,0,0,16,5,11,4,12,12,9.53437341881704,10.1799443567474,0.313444163790003,29
"7298","MG","Francisco Sá",26369,13826.93,31007,"Montes Claros",3,"Sudeste",0,"312670",3,22,2,20,8,14,0,0,0,0,0,22,2,20,8,14,14,9.53437341881704,10.1799443567474,0.408687091159034,31
"7299","MG","Francisco Sá",26369,13826.93,31007,"Montes Claros",3,"Sudeste",0,"312670",4,20,6,14,4,16,0,0,0,0,0,20,6,14,4,16,8,9.53437341881704,10.1799443567474,0.428144170460571,30
"7300","MG","Francisco Sá",26369,13826.93,31007,"Montes Claros",3,"Sudeste",0,"312670",5,13,4,9,5,8,1,0,1,0,1,14,4,10,5,9,12,9.53437341881704,10.1799443567474,0.404646580601504,31
"7301","MG","Frei Inocêncio",9664,10640.18,31037,"Governador Valadares",3,"Sudeste",0,"312690",2,7,4,3,3,4,0,0,0,0,0,7,4,3,3,4,3,9.27239268004577,9.1761629201746,0.269397669211093,29
"7302","MG","Frei Inocêncio",9664,10640.18,31037,"Governador Valadares",3,"Sudeste",0,"312690",3,6,3,3,3,3,0,0,0,0,0,6,3,3,3,3,5,9.27239268004577,9.1761629201746,0.354124199359605,31
"7303","MG","Frei Inocêncio",9664,10640.18,31037,"Governador Valadares",3,"Sudeste",0,"312690",4,8,3,5,3,5,0,0,0,0,0,8,3,5,3,5,9,9.27239268004577,9.1761629201746,0.384885007804402,30
"7304","MG","Frei Inocêncio",9664,10640.18,31037,"Governador Valadares",3,"Sudeste",0,"312690",5,8,4,4,3,5,0,0,0,0,0,8,4,4,3,5,9,9.27239268004577,9.1761629201746,0.382098219477454,31
"7305","MG","Fronteira",18492,51725.91,31021,"Frutal",3,"Sudeste",1,"312700",2,8,4,4,2,6,1,0,1,0,1,9,4,5,2,7,8,10.8537140954991,9.82509348510812,0.297763163829756,29
"7306","MG","Fronteira",18492,51725.91,31021,"Frutal",3,"Sudeste",1,"312700",3,13,3,10,6,7,0,0,0,0,0,13,3,10,6,7,9,10.8537140954991,9.82509348510812,0.342437403893751,31
"7307","MG","Fronteira",18492,51725.91,31021,"Frutal",3,"Sudeste",1,"312700",4,11,5,6,6,5,0,0,0,0,0,11,5,6,6,5,3,10.8537140954991,9.82509348510812,0.374493480572076,30
"7308","MG","Fronteira",18492,51725.91,31021,"Frutal",3,"Sudeste",1,"312700",5,5,1,4,3,2,0,0,0,0,0,5,1,4,3,2,11,10.8537140954991,9.82509348510812,0.38878712355723,31
"7309","MG","Frutal",60012,32188.44,31021,"Frutal",3,"Sudeste",1,"312710",2,57,17,40,17,40,0,0,0,0,0,57,17,40,17,40,34,10.3793626608632,11.0022998212069,0.297933099268187,29
"7310","MG","Frutal",60012,32188.44,31021,"Frutal",3,"Sudeste",1,"312710",3,42,9,33,22,20,0,0,0,0,0,42,9,33,22,20,37,10.3793626608632,11.0022998212069,0.385951346401703,31
"7311","MG","Frutal",60012,32188.44,31021,"Frutal",3,"Sudeste",1,"312710",4,56,9,47,25,31,0,0,0,0,0,56,9,47,25,31,33,10.3793626608632,11.0022998212069,0.403467749726643,30
"7312","MG","Frutal",60012,32188.44,31021,"Frutal",3,"Sudeste",1,"312710",5,49,12,37,15,34,0,0,0,0,0,49,12,37,15,34,38,10.3793626608632,11.0022998212069,0.386609557195791,31
"7313","MG","Galiléia",6790,12480,31037,"Governador Valadares",3,"Sudeste",0,"312730",2,8,0,8,2,6,0,0,0,0,0,8,0,8,2,6,4,9.43188264192342,8.82320622055274,0.322179326472059,29
"7314","MG","Galiléia",6790,12480,31037,"Governador Valadares",3,"Sudeste",0,"312730",3,9,3,6,5,4,0,0,0,0,0,9,3,6,5,4,4,9.43188264192342,8.82320622055274,0.39814111047134,31
"7315","MG","Galiléia",6790,12480,31037,"Governador Valadares",3,"Sudeste",0,"312730",4,9,3,6,7,2,0,0,0,0,0,9,3,6,7,2,6,9.43188264192342,8.82320622055274,0.464121398397891,30
"7316","MG","Galiléia",6790,12480,31037,"Governador Valadares",3,"Sudeste",0,"312730",5,8,0,8,3,5,1,0,1,0,1,9,0,9,3,6,1,9.43188264192342,8.82320622055274,0.436130714775054,31
"7317","MG","Goianá",3990,15152.79,31065,"Juiz de Fora",3,"Sudeste",0,"312738",2,3,1,2,1,2,0,0,0,0,0,3,1,2,1,2,2,9.62593995239828,8.29154650988391,0.318365341675045,29
"7318","MG","Goianá",3990,15152.79,31065,"Juiz de Fora",3,"Sudeste",0,"312738",3,5,1,4,1,4,0,0,0,0,0,5,1,4,1,4,2,9.62593995239828,8.29154650988391,0.421876635361177,31
"7319","MG","Goianá",3990,15152.79,31065,"Juiz de Fora",3,"Sudeste",0,"312738",4,2,2,0,0,2,0,0,0,0,0,2,2,0,0,2,2,9.62593995239828,8.29154650988391,0.469872627597573,30
"7320","MG","Goianá",3990,15152.79,31065,"Juiz de Fora",3,"Sudeste",0,"312738",5,1,0,1,0,1,0,0,0,0,0,1,0,1,0,1,4,9.62593995239828,8.29154650988391,0.453260574200998,31
"7321","MG","Gouveia",11818,10951.65,31010,"Diamantina",3,"Sudeste",0,"312760",2,12,3,9,2,10,0,0,0,0,0,12,3,9,2,10,7,9.30124540882432,9.37737907190562,0.317036350082678,29
"7322","MG","Gouveia",11818,10951.65,31010,"Diamantina",3,"Sudeste",0,"312760",3,11,1,10,4,7,0,0,0,0,0,11,1,10,4,7,7,9.30124540882432,9.37737907190562,0.417810718052279,31
"7323","MG","Gouveia",11818,10951.65,31010,"Diamantina",3,"Sudeste",0,"312760",4,11,0,11,2,9,0,0,0,0,0,11,0,11,2,9,8,9.30124540882432,9.37737907190562,0.467550976124634,30
"7324","MG","Gouveia",11818,10951.65,31010,"Diamantina",3,"Sudeste",0,"312760",5,6,2,4,1,5,0,0,0,0,0,6,2,4,1,5,7,9.30124540882432,9.37737907190562,0.433101153452898,31
"7325","MG","Governador Valadares",281046,22278.79,31037,"Governador Valadares",3,"Sudeste",1,"312770",2,248,41,207,76,172,1,0,1,0,1,249,41,208,76,173,157,10.0113903837693,12.5462736359859,0.303924991837402,29
"7326","MG","Governador Valadares",281046,22278.79,31037,"Governador Valadares",3,"Sudeste",1,"312770",3,269,52,217,84,185,1,1,0,0,1,270,53,217,84,186,199,10.0113903837693,12.5462736359859,0.400555579442113,31
"7327","MG","Governador Valadares",281046,22278.79,31037,"Governador Valadares",3,"Sudeste",1,"312770",4,275,60,215,95,180,4,1,3,1,3,279,61,218,96,183,171,10.0113903837693,12.5462736359859,0.432737359690301,30
"7328","MG","Governador Valadares",281046,22278.79,31037,"Governador Valadares",3,"Sudeste",1,"312770",5,339,76,263,133,206,4,1,3,3,1,343,77,266,136,207,210,10.0113903837693,12.5462736359859,0.3908969108907,31
"7329","MG","Grão Mogol",15890,39725.49,31008,"Grão Mogol",3,"Sudeste",0,"312780",2,12,6,6,3,9,0,0,0,0,0,12,6,6,3,9,8,10.5897483261306,9.67344525953076,0.307693509663273,29
"7330","MG","Grão Mogol",15890,39725.49,31008,"Grão Mogol",3,"Sudeste",0,"312780",3,10,3,7,5,5,0,0,0,0,0,10,3,7,5,5,4,10.5897483261306,9.67344525953076,0.385429765818459,31
"7331","MG","Grão Mogol",15890,39725.49,31008,"Grão Mogol",3,"Sudeste",0,"312780",4,12,5,7,3,9,0,0,0,0,0,12,5,7,3,9,9,10.5897483261306,9.67344525953076,0.406622467877854,30
"7332","MG","Grão Mogol",15890,39725.49,31008,"Grão Mogol",3,"Sudeste",0,"312780",5,20,4,16,8,12,0,0,0,0,0,20,4,16,8,12,6,10.5897483261306,9.67344525953076,0.38965183259773,31
"7333","MG","Guanhães",34573,20335.97,31035,"Guanhães",3,"Sudeste",0,"312800",2,30,6,24,11,19,0,0,0,0,0,30,6,24,11,19,25,9.92014651821178,10.4508283095959,0.319965835233322,29
"7334","MG","Guanhães",34573,20335.97,31035,"Guanhães",3,"Sudeste",0,"312800",3,32,5,27,8,24,0,0,0,0,0,32,5,27,8,24,15,9.92014651821178,10.4508283095959,0.417274440137483,31
"7335","MG","Guanhães",34573,20335.97,31035,"Guanhães",3,"Sudeste",0,"312800",4,29,7,22,9,20,0,0,0,0,0,29,7,22,9,20,18,9.92014651821178,10.4508283095959,0.441533461090951,30
"7336","MG","Guanhães",34573,20335.97,31035,"Guanhães",3,"Sudeste",0,"312800",5,40,9,31,15,25,1,1,0,1,0,41,10,31,16,25,13,9.92014651821178,10.4508283095959,0.408008861608968,31
"7337","MG","Guapé",14258,16671.12,31050,"Varginha",3,"Sudeste",0,"312810",2,8,3,5,2,6,0,0,0,0,0,8,3,5,2,6,7,9.72143316005061,9.56507343167757,0.275727411657934,29
"7338","MG","Guapé",14258,16671.12,31050,"Varginha",3,"Sudeste",0,"312810",3,14,3,11,4,10,0,0,0,0,0,14,3,11,4,10,14,9.72143316005061,9.56507343167757,0.338324706178987,31
"7339","MG","Guapé",14258,16671.12,31050,"Varginha",3,"Sudeste",0,"312810",4,11,5,6,4,7,0,0,0,0,0,11,5,6,4,7,12,9.72143316005061,9.56507343167757,0.37633725454719,30
"7340","MG","Guapé",14258,16671.12,31050,"Varginha",3,"Sudeste",0,"312810",5,12,3,9,5,7,0,0,0,0,0,12,3,9,5,7,10,9.72143316005061,9.56507343167757,0.39898733549692,31
"7341","MG","Guaranésia",19017,23027.55,31048,"São Sebastião do Paraíso",3,"Sudeste",1,"312830",2,17,5,12,5,12,0,0,0,0,0,17,5,12,5,12,15,10.0444466041769,9.85308859495228,0.314469993635246,29
"7342","MG","Guaranésia",19017,23027.55,31048,"São Sebastião do Paraíso",3,"Sudeste",1,"312830",3,10,4,6,3,7,0,0,0,0,0,10,4,6,3,7,11,10.0444466041769,9.85308859495228,0.408472732704432,31
"7343","MG","Guaranésia",19017,23027.55,31048,"São Sebastião do Paraíso",3,"Sudeste",1,"312830",4,14,4,10,3,11,0,0,0,0,0,14,4,10,3,11,14,10.0444466041769,9.85308859495228,0.451700882210956,30
"7344","MG","Guaranésia",19017,23027.55,31048,"São Sebastião do Paraíso",3,"Sudeste",1,"312830",5,24,3,21,12,12,0,0,0,0,0,24,3,21,12,12,11,10.0444466041769,9.85308859495228,0.389230277951454,31
"7345","MG","Guarani",8918,14096.53,31064,"Ubá",3,"Sudeste",0,"312840",2,4,1,3,1,3,0,0,0,0,0,4,1,3,1,3,2,9.55368394678808,9.09582698518742,0.284433395061679,29
"7346","MG","Guarani",8918,14096.53,31064,"Ubá",3,"Sudeste",0,"312840",3,6,2,4,0,6,0,0,0,0,0,6,2,4,0,6,10,9.55368394678808,9.09582698518742,0.391729281358263,31
"7347","MG","Guarani",8918,14096.53,31064,"Ubá",3,"Sudeste",0,"312840",4,8,4,4,1,7,0,0,0,0,0,8,4,4,1,7,6,9.55368394678808,9.09582698518742,0.456149631958324,30
"7348","MG","Guarani",8918,14096.53,31064,"Ubá",3,"Sudeste",0,"312840",5,8,4,4,5,3,0,0,0,0,0,8,4,4,5,3,8,9.55368394678808,9.09582698518742,0.425158273562605,31
"7349","MG","Guarda-Mor",6569,56186.8,31002,"Paracatu",3,"Sudeste",0,"312860",2,4,2,2,2,2,0,0,0,0,0,4,2,2,2,2,2,10.9364371328494,8.79011689289247,0.300097333540432,29
"7350","MG","Guarda-Mor",6569,56186.8,31002,"Paracatu",3,"Sudeste",0,"312860",3,6,1,5,1,5,0,0,0,0,0,6,1,5,1,5,2,10.9364371328494,8.79011689289247,0.387504423098038,31
"7351","MG","Guarda-Mor",6569,56186.8,31002,"Paracatu",3,"Sudeste",0,"312860",4,6,1,5,2,4,1,0,1,0,1,7,1,6,2,5,4,10.9364371328494,8.79011689289247,0.40184636836049,30
"7352","MG","Guarda-Mor",6569,56186.8,31002,"Paracatu",3,"Sudeste",0,"312860",5,5,1,4,3,2,0,0,0,0,0,5,1,4,3,2,3,10.9364371328494,8.79011689289247,0.371466200380271,31
"7353","MG","Guaxupé",52078,38992.83,31048,"São Sebastião do Paraíso",3,"Sudeste",1,"312870",2,34,15,19,11,23,0,0,0,0,0,34,15,19,11,23,39,10.5711330620562,10.8604978736873,0.312845105639699,29
"7354","MG","Guaxupé",52078,38992.83,31048,"São Sebastião do Paraíso",3,"Sudeste",1,"312870",3,42,9,33,9,33,0,0,0,0,0,42,9,33,9,33,35,10.5711330620562,10.8604978736873,0.398391261414458,31
"7355","MG","Guaxupé",52078,38992.83,31048,"São Sebastião do Paraíso",3,"Sudeste",1,"312870",4,53,11,42,18,35,1,0,1,1,0,54,11,43,19,35,38,10.5711330620562,10.8604978736873,0.443454672243919,30
"7356","MG","Guaxupé",52078,38992.83,31048,"São Sebastião do Paraíso",3,"Sudeste",1,"312870",5,49,5,44,11,38,1,0,1,1,0,50,5,45,12,38,46,10.5711330620562,10.8604978736873,0.394281484990902,31
"7357","MG","Guidoval",7051,12745.91,31064,"Ubá",3,"Sudeste",0,"312880",2,3,1,2,0,3,0,0,0,0,0,3,1,2,0,3,9,9.45296571481055,8.86092472971904,0.335265842833646,29
"7358","MG","Guidoval",7051,12745.91,31064,"Ubá",3,"Sudeste",0,"312880",3,8,3,5,4,4,0,0,0,0,0,8,3,5,4,4,3,9.45296571481055,8.86092472971904,0.41472151130246,31
"7359","MG","Guidoval",7051,12745.91,31064,"Ubá",3,"Sudeste",0,"312880",4,7,3,4,6,1,0,0,0,0,0,7,3,4,6,1,0,9.45296571481055,8.86092472971904,0.445074719529771,30
"7360","MG","Guidoval",7051,12745.91,31064,"Ubá",3,"Sudeste",0,"312880",5,9,3,6,1,8,0,0,0,0,0,9,3,6,1,8,6,9.45296571481055,8.86092472971904,0.440559857889161,31
"7361","MG","Guimarânia",8105,19467.38,31020,"Patos de Minas",3,"Sudeste",0,"312890",2,12,5,7,3,9,0,0,0,0,0,12,5,7,3,9,6,9.87649552331246,9.00023643416978,0.281857767307682,29
"7362","MG","Guimarânia",8105,19467.38,31020,"Patos de Minas",3,"Sudeste",0,"312890",3,11,5,6,4,7,1,0,1,1,0,12,5,7,5,7,12,9.87649552331246,9.00023643416978,0.39008516535517,31
"7363","MG","Guimarânia",8105,19467.38,31020,"Patos de Minas",3,"Sudeste",0,"312890",4,8,2,6,2,6,0,0,0,0,0,8,2,6,2,6,6,9.87649552331246,9.00023643416978,0.397922310238146,30
"7364","MG","Guimarânia",8105,19467.38,31020,"Patos de Minas",3,"Sudeste",0,"312890",5,10,3,7,5,5,0,0,0,0,0,10,3,7,5,5,7,9.87649552331246,9.00023643416978,0.365774521216588,31
"7365","MG","Iapu",11045,9142.32,31040,"Caratinga",3,"Sudeste",0,"312930",2,7,1,6,3,4,0,0,0,0,0,7,1,6,3,4,1,9.12066946156065,9.30973311585422,0.333654840367984,29
"7366","MG","Iapu",11045,9142.32,31040,"Caratinga",3,"Sudeste",0,"312930",3,6,3,3,3,3,0,0,0,0,0,6,3,3,3,3,6,9.12066946156065,9.30973311585422,0.409091789125917,31
"7367","MG","Iapu",11045,9142.32,31040,"Caratinga",3,"Sudeste",0,"312930",4,10,0,10,6,4,0,0,0,0,0,10,0,10,6,4,3,9.12066946156065,9.30973311585422,0.399469147630615,30
"7368","MG","Iapu",11045,9142.32,31040,"Caratinga",3,"Sudeste",0,"312930",5,9,2,7,3,6,0,0,0,0,0,9,2,7,3,6,5,9.12066946156065,9.30973311585422,0.397898364468267,31
"7369","MG","Ibiá",25358,40152.39,31023,"Araxá",3,"Sudeste",1,"312950",2,21,11,10,10,11,0,0,0,0,0,21,11,10,10,11,15,10.6004372443779,10.1408495410879,0.322850928141116,29
"7370","MG","Ibiá",25358,40152.39,31023,"Araxá",3,"Sudeste",1,"312950",3,28,8,20,17,11,0,0,0,0,0,28,8,20,17,11,8,10.6004372443779,10.1408495410879,0.409835931981406,31
"7371","MG","Ibiá",25358,40152.39,31023,"Araxá",3,"Sudeste",1,"312950",4,21,5,16,10,11,0,0,0,0,0,21,5,16,10,11,14,10.6004372443779,10.1408495410879,0.409909537666126,30
"7372","MG","Ibiá",25358,40152.39,31023,"Araxá",3,"Sudeste",1,"312950",5,19,6,13,8,11,1,1,0,0,1,20,7,13,8,12,18,10.6004372443779,10.1408495410879,0.404954807001834,31
"7373","MG","Ibiaí",8437,8097.31,31006,"Pirapora",3,"Sudeste",0,"312960",2,2,1,1,1,1,0,0,0,0,0,2,1,1,1,1,2,8.99928718673809,9.04038207416563,0.278447356969993,29
"7374","MG","Ibiaí",8437,8097.31,31006,"Pirapora",3,"Sudeste",0,"312960",3,3,2,1,3,0,0,0,0,0,0,3,2,1,3,0,2,8.99928718673809,9.04038207416563,0.36156401206457,31
"7375","MG","Ibiaí",8437,8097.31,31006,"Pirapora",3,"Sudeste",0,"312960",4,7,1,6,3,4,0,0,0,0,0,7,1,6,3,4,4,8.99928718673809,9.04038207416563,0.372956909330013,30
"7376","MG","Ibiaí",8437,8097.31,31006,"Pirapora",3,"Sudeste",0,"312960",5,10,5,5,6,4,0,0,0,0,0,10,5,5,6,4,1,8.99928718673809,9.04038207416563,0.353414265063142,31
"7377","MG","Ibiraci",13986,39083.36,31047,"Passos",3,"Sudeste",0,"312970",2,8,1,7,2,6,0,0,0,0,0,8,1,7,2,6,3,10.573452079943,9.54581210826381,0.349950578253889,29
"7378","MG","Ibiraci",13986,39083.36,31047,"Passos",3,"Sudeste",0,"312970",3,11,2,9,5,6,0,0,0,0,0,11,2,9,5,6,5,10.573452079943,9.54581210826381,0.436864719482762,31
"7379","MG","Ibiraci",13986,39083.36,31047,"Passos",3,"Sudeste",0,"312970",4,12,3,9,3,9,0,0,0,0,0,12,3,9,3,9,4,10.573452079943,9.54581210826381,0.454963182381625,30
"7380","MG","Ibiraci",13986,39083.36,31047,"Passos",3,"Sudeste",0,"312970",5,11,1,10,5,6,0,0,0,0,0,11,1,10,5,6,6,10.573452079943,9.54581210826381,0.463850114440879,31
"7381","MG","Ibirité",182153,12599.35,31030,"Belo Horizonte",3,"Sudeste",1,"312980",2,194,26,168,75,119,3,0,3,1,2,197,26,171,76,121,74,9.44140050430731,12.1126022722434,0.294507509714169,29
"7382","MG","Ibirité",182153,12599.35,31030,"Belo Horizonte",3,"Sudeste",1,"312980",3,217,41,176,79,138,3,0,3,2,1,220,41,179,81,139,87,9.44140050430731,12.1126022722434,0.377134990211173,31
"7383","MG","Ibirité",182153,12599.35,31030,"Belo Horizonte",3,"Sudeste",1,"312980",4,169,22,147,56,113,5,3,2,3,2,174,25,149,59,115,72,9.44140050430731,12.1126022722434,0.429958578260373,30
"7384","MG","Ibirité",182153,12599.35,31030,"Belo Horizonte",3,"Sudeste",1,"312980",5,184,37,147,78,106,2,2,0,1,1,186,39,147,79,107,73,9.44140050430731,12.1126022722434,0.387315105858524,31
"7385","MG","Igarapé",43817,16245.12,31030,"Belo Horizonte",3,"Sudeste",1,"313010",2,38,8,30,11,27,2,1,1,0,2,40,9,31,11,29,21,9.69554783496419,10.6877771489163,0.289992915322992,29
"7386","MG","Igarapé",43817,16245.12,31030,"Belo Horizonte",3,"Sudeste",1,"313010",3,55,12,43,17,38,0,0,0,0,0,55,12,43,17,38,16,9.69554783496419,10.6877771489163,0.371240179129622,31
"7387","MG","Igarapé",43817,16245.12,31030,"Belo Horizonte",3,"Sudeste",1,"313010",4,55,10,45,22,33,0,0,0,0,0,55,10,45,22,33,22,9.69554783496419,10.6877771489163,0.4185650111854,30
"7388","MG","Igarapé",43817,16245.12,31030,"Belo Horizonte",3,"Sudeste",1,"313010",5,49,8,41,14,35,0,0,0,0,0,49,8,41,14,35,16,9.69554783496419,10.6877771489163,0.376171989034943,31
"7389","MG","Igaratinga",11005,34889.03,31043,"Divinópolis",3,"Sudeste",0,"313020",2,11,1,10,6,5,0,0,0,0,0,11,1,10,6,5,3,10.459927732132,9.30610499396056,0.278344637126294,29
"7390","MG","Igaratinga",11005,34889.03,31043,"Divinópolis",3,"Sudeste",0,"313020",3,14,3,11,5,9,0,0,0,0,0,14,3,11,5,9,2,10.459927732132,9.30610499396056,0.360816639250761,31
"7391","MG","Igaratinga",11005,34889.03,31043,"Divinópolis",3,"Sudeste",0,"313020",4,9,2,7,5,4,0,0,0,0,0,9,2,7,5,4,4,10.459927732132,9.30610499396056,0.38198970580344,30
"7392","MG","Igaratinga",11005,34889.03,31043,"Divinópolis",3,"Sudeste",0,"313020",5,7,2,5,0,7,0,0,0,0,0,7,2,5,0,7,5,10.459927732132,9.30610499396056,0.372344403149376,31
"7393","MG","Iguatama",7923,39499.43,31042,"Piuí",3,"Sudeste",0,"313030",2,1,0,1,0,1,0,0,0,0,0,1,0,1,0,1,3,10.5840415204053,8.97752520096524,0.294918195103011,29
"7394","MG","Iguatama",7923,39499.43,31042,"Piuí",3,"Sudeste",0,"313030",3,6,1,5,2,4,0,0,0,0,0,6,1,5,2,4,2,10.5840415204053,8.97752520096524,0.366561310027597,31
"7395","MG","Iguatama",7923,39499.43,31042,"Piuí",3,"Sudeste",0,"313030",4,7,2,5,4,3,0,0,0,0,0,7,2,5,4,3,3,10.5840415204053,8.97752520096524,0.409858308483703,30
"7396","MG","Iguatama",7923,39499.43,31042,"Piuí",3,"Sudeste",0,"313030",5,2,1,1,1,1,0,0,0,0,0,2,1,1,1,1,13,10.5840415204053,8.97752520096524,0.396067356206777,31
"7397","MG","Ilicínea",12444,15260.36,31050,"Varginha",3,"Sudeste",0,"313050",2,8,2,6,5,3,0,0,0,0,0,8,2,6,5,3,3,9.63301389564799,9.42899385801753,0.290181951490591,29
"7398","MG","Ilicínea",12444,15260.36,31050,"Varginha",3,"Sudeste",0,"313050",3,10,2,8,6,4,0,0,0,0,0,10,2,8,6,4,6,9.63301389564799,9.42899385801753,0.3393153645372,31
"7399","MG","Ilicínea",12444,15260.36,31050,"Varginha",3,"Sudeste",0,"313050",4,5,1,4,2,3,0,0,0,0,0,5,1,4,2,3,2,9.63301389564799,9.42899385801753,0.369598309374029,30
"7400","MG","Ilicínea",12444,15260.36,31050,"Varginha",3,"Sudeste",0,"313050",5,12,5,7,4,8,1,1,0,0,1,13,6,7,4,9,8,9.63301389564799,9.42899385801753,0.377032168174484,31
"7401","MG","Inconfidentes",7358,13437.51,31051,"Poços de Caldas",3,"Sudeste",0,"313060",2,1,0,1,0,1,0,0,0,0,0,1,0,1,0,1,6,9.50580532905579,8.90354343566472,0.308310524022979,29
"7402","MG","Inconfidentes",7358,13437.51,31051,"Poços de Caldas",3,"Sudeste",0,"313060",3,3,2,1,1,2,0,0,0,0,0,3,2,1,1,2,4,9.50580532905579,8.90354343566472,0.401075192413017,31
"7403","MG","Inconfidentes",7358,13437.51,31051,"Poços de Caldas",3,"Sudeste",0,"313060",4,8,4,4,3,5,0,0,0,0,0,8,4,4,3,5,3,9.50580532905579,8.90354343566472,0.46728471639649,30
"7404","MG","Inconfidentes",7358,13437.51,31051,"Poços de Caldas",3,"Sudeste",0,"313060",5,10,1,9,2,8,0,0,0,0,0,10,1,9,2,8,3,9.50580532905579,8.90354343566472,0.455653197464174,31
"7405","MG","Indianópolis",6951,63068.38,31018,"Uberlândia",3,"Sudeste",0,"313070",2,2,1,1,2,0,0,0,0,0,0,2,1,1,2,0,2,11.0519748135818,8.84664081310049,0.328566897865754,29
"7406","MG","Indianópolis",6951,63068.38,31018,"Uberlândia",3,"Sudeste",0,"313070",3,3,0,3,2,1,0,0,0,0,0,3,0,3,2,1,2,11.0519748135818,8.84664081310049,0.413406877638356,31
"7407","MG","Indianópolis",6951,63068.38,31018,"Uberlândia",3,"Sudeste",0,"313070",4,2,1,1,1,1,0,0,0,0,0,2,1,1,1,1,2,11.0519748135818,8.84664081310049,0.438568816612364,30
"7408","MG","Indianópolis",6951,63068.38,31018,"Uberlândia",3,"Sudeste",0,"313070",5,3,1,2,2,1,0,0,0,0,0,3,1,2,2,1,2,11.0519748135818,8.84664081310049,0.439446544876408,31
"7409","MG","Inhapim",24079,12610.26,31040,"Caratinga",3,"Sudeste",0,"313090",2,16,5,11,4,12,0,0,0,0,0,16,5,11,4,12,11,9.44226604730311,10.0890953703212,0.333692731595168,29
"7410","MG","Inhapim",24079,12610.26,31040,"Caratinga",3,"Sudeste",0,"313090",3,23,4,19,9,14,1,1,0,1,0,24,5,19,10,14,16,9.44226604730311,10.0890953703212,0.438625346107411,31
"7411","MG","Inhapim",24079,12610.26,31040,"Caratinga",3,"Sudeste",0,"313090",4,16,5,11,3,13,1,0,1,0,1,17,5,12,3,14,12,9.44226604730311,10.0890953703212,0.444566254345401,30
"7412","MG","Inhapim",24079,12610.26,31040,"Caratinga",3,"Sudeste",0,"313090",5,29,7,22,10,19,2,0,2,1,1,31,7,24,11,20,6,9.44226604730311,10.0890953703212,0.420692389670303,31
"7413","MG","Inhaúma",6312,18064.01,31027,"Sete Lagoas",3,"Sudeste",1,"313100",2,3,1,2,2,1,0,0,0,0,0,3,1,2,2,1,4,9.80167683997654,8.75020786252571,0.327992973135408,29
"7414","MG","Inhaúma",6312,18064.01,31027,"Sete Lagoas",3,"Sudeste",1,"313100",3,0,0,0,0,0,0,0,0,0,0,0,0,0,0,0,5,9.80167683997654,8.75020786252571,0.420920215155104,31
"7415","MG","Inhaúma",6312,18064.01,31027,"Sete Lagoas",3,"Sudeste",1,"313100",4,0,0,0,0,0,0,0,0,0,0,0,0,0,0,0,3,9.80167683997654,8.75020786252571,0.440793615187988,30
"7416","MG","Inhaúma",6312,18064.01,31027,"Sete Lagoas",3,"Sudeste",1,"313100",5,0,0,0,0,0,0,0,0,0,0,0,0,0,0,0,3,9.80167683997654,8.75020786252571,0.386738079662719,31
"7417","MG","Ipaba",18769,8130.98,31040,"Caratinga",3,"Sudeste",1,"313115",2,17,5,12,3,14,0,0,0,0,0,17,5,12,3,14,5,9.00343673648276,9.83996185165625,0.336341674406395,29
"7418","MG","Ipaba",18769,8130.98,31040,"Caratinga",3,"Sudeste",1,"313115",3,15,4,11,5,10,0,0,0,0,0,15,4,11,5,10,11,9.00343673648276,9.83996185165625,0.422218942144358,31
"7419","MG","Ipaba",18769,8130.98,31040,"Caratinga",3,"Sudeste",1,"313115",4,12,2,10,9,3,1,0,1,1,0,13,2,11,10,3,7,9.00343673648276,9.83996185165625,0.449635071125371,30
"7420","MG","Ipaba",18769,8130.98,31040,"Caratinga",3,"Sudeste",1,"313115",5,29,9,20,11,18,0,0,0,0,0,29,9,20,11,18,5,9.00343673648276,9.83996185165625,0.406362421940672,31
"7421","MG","Ipanema",20000,10795.26,31041,"Aimorés",3,"Sudeste",1,"313120",2,14,7,7,7,7,0,0,0,0,0,14,7,7,7,7,13,9.2868624278835,9.90348755253613,0.309881335599553,29
"7422","MG","Ipanema",20000,10795.26,31041,"Aimorés",3,"Sudeste",1,"313120",3,24,11,13,11,13,0,0,0,0,0,24,11,13,11,13,15,9.2868624278835,9.90348755253613,0.414895629070501,31
"7423","MG","Ipanema",20000,10795.26,31041,"Aimorés",3,"Sudeste",1,"313120",4,23,8,15,11,12,0,0,0,0,0,23,8,15,11,12,12,9.2868624278835,9.90348755253613,0.417713605648706,30
"7424","MG","Ipanema",20000,10795.26,31041,"Aimorés",3,"Sudeste",1,"313120",5,19,9,10,6,13,0,0,0,0,0,19,9,10,6,13,17,9.2868624278835,9.90348755253613,0.410384137730625,31
"7425","MG","Ipatinga",265409,43757.66,31039,"Ipatinga",3,"Sudeste",1,"313130",2,210,23,187,61,149,4,0,4,3,1,214,23,191,64,150,103,10.6864219621743,12.4890273113829,0.303886097723275,29
"7426","MG","Ipatinga",265409,43757.66,31039,"Ipatinga",3,"Sudeste",1,"313130",3,222,42,180,71,151,4,0,4,1,3,226,42,184,72,154,117,10.6864219621743,12.4890273113829,0.406994696470736,31
"7427","MG","Ipatinga",265409,43757.66,31039,"Ipatinga",3,"Sudeste",1,"313130",4,213,41,172,65,148,3,1,2,0,3,216,42,174,65,151,100,10.6864219621743,12.4890273113829,0.445659893229064,30
"7428","MG","Ipatinga",265409,43757.66,31039,"Ipatinga",3,"Sudeste",1,"313130",5,262,39,223,69,193,0,0,0,0,0,262,39,223,69,193,110,10.6864219621743,12.4890273113829,0.400859670899571,31
"7429","MG","Ipuiúna",10118,13388.44,31052,"Pouso Alegre",3,"Sudeste",0,"313150",2,5,3,2,2,3,0,0,0,0,0,5,3,2,2,3,5,9.50214692704363,9.22207129485188,0.315060752529753,29
"7430","MG","Ipuiúna",10118,13388.44,31052,"Pouso Alegre",3,"Sudeste",0,"313150",3,2,1,1,1,1,0,0,0,0,0,2,1,1,1,1,9,9.50214692704363,9.22207129485188,0.412165587216411,31
"7431","MG","Ipuiúna",10118,13388.44,31052,"Pouso Alegre",3,"Sudeste",0,"313150",4,9,3,6,2,7,0,0,0,0,0,9,3,6,2,7,4,9.50214692704363,9.22207129485188,0.427728233551384,30
"7432","MG","Ipuiúna",10118,13388.44,31052,"Pouso Alegre",3,"Sudeste",0,"313150",5,7,2,5,4,3,1,0,1,0,1,8,2,6,4,4,5,9.50214692704363,9.22207129485188,0.389233563517599,31
"7433","MG","Iraí de Minas",7027,34482.02,31019,"Patrocínio",3,"Sudeste",0,"313160",2,7,4,3,1,6,0,0,0,0,0,7,4,3,1,6,7,10.4481933077484,8.8575151511922,0.338230518703789,29
"7434","MG","Iraí de Minas",7027,34482.02,31019,"Patrocínio",3,"Sudeste",0,"313160",3,7,2,5,4,3,0,0,0,0,0,7,2,5,4,3,3,10.4481933077484,8.8575151511922,0.369986456223749,31
"7435","MG","Iraí de Minas",7027,34482.02,31019,"Patrocínio",3,"Sudeste",0,"313160",4,7,2,5,4,3,0,0,0,0,0,7,2,5,4,3,3,10.4481933077484,8.8575151511922,0.409316175234715,30
"7436","MG","Iraí de Minas",7027,34482.02,31019,"Patrocínio",3,"Sudeste",0,"313160",5,12,4,8,8,4,0,0,0,0,0,12,4,8,8,4,3,10.4481933077484,8.8575151511922,0.370159345008199,31
"7437","MG","Itabira",120904,55544.11,31031,"Itabira",3,"Sudeste",1,"313170",2,85,7,78,24,61,0,0,0,0,0,85,7,78,24,61,64,10.9249327588431,11.70275212125,0.304017129088868,29
"7438","MG","Itabira",120904,55544.11,31031,"Itabira",3,"Sudeste",1,"313170",3,113,19,94,36,77,0,0,0,0,0,113,19,94,36,77,73,10.9249327588431,11.70275212125,0.40003558718923,31
"7439","MG","Itabira",120904,55544.11,31031,"Itabira",3,"Sudeste",1,"313170",4,92,5,87,27,65,1,0,1,0,1,93,5,88,27,66,43,10.9249327588431,11.70275212125,0.458202220269774,30
"7440","MG","Itabira",120904,55544.11,31031,"Itabira",3,"Sudeste",1,"313170",5,108,16,92,31,77,1,0,1,1,0,109,16,93,32,77,58,10.9249327588431,11.70275212125,0.41375553474027,31
"7441","MG","Itabirinha",11576,9841.24,31038,"Mantena",3,"Sudeste",0,"313180",2,9,4,5,2,7,0,0,0,0,0,9,4,5,2,7,14,9.19433699836708,9.35668926831132,0.302976586961267,29
"7442","MG","Itabirinha",11576,9841.24,31038,"Mantena",3,"Sudeste",0,"313180",3,6,0,6,2,4,0,0,0,0,0,6,0,6,2,4,5,9.19433699836708,9.35668926831132,0.348950541205718,31
"7443","MG","Itabirinha",11576,9841.24,31038,"Mantena",3,"Sudeste",0,"313180",4,5,1,4,1,4,0,0,0,0,0,5,1,4,1,4,5,9.19433699836708,9.35668926831132,0.389098398432376,30
"7444","MG","Itabirinha",11576,9841.24,31038,"Mantena",3,"Sudeste",0,"313180",5,5,1,4,2,3,0,0,0,0,0,5,1,4,2,3,5,9.19433699836708,9.35668926831132,0.363288645410507,31
"7445","MG","Itabirito",52446,97711.87,31033,"Ouro Preto",3,"Sudeste",1,"313190",2,58,7,51,21,37,0,0,0,0,0,58,7,51,21,37,21,11.4897783250216,10.8675393478085,0.2820439145992,29
"7446","MG","Itabirito",52446,97711.87,31033,"Ouro Preto",3,"Sudeste",1,"313190",3,54,9,45,18,36,0,0,0,0,0,54,9,45,18,36,28,11.4897783250216,10.8675393478085,0.368357780021473,31
"7447","MG","Itabirito",52446,97711.87,31033,"Ouro Preto",3,"Sudeste",1,"313190",4,49,9,40,15,34,0,0,0,0,0,49,9,40,15,34,25,11.4897783250216,10.8675393478085,0.412911980285222,30
"7448","MG","Itabirito",52446,97711.87,31033,"Ouro Preto",3,"Sudeste",1,"313190",5,59,5,54,21,38,0,0,0,0,0,59,5,54,21,38,20,11.4897783250216,10.8675393478085,0.367829033768402,31
"7449","MG","Itacarambi",18164,10521.6,31003,"Januária",3,"Sudeste",1,"313210",2,18,5,13,6,12,1,0,1,0,1,19,5,14,6,13,8,9.26118556598175,9.80719689221784,0.32140382903589,29
"7450","MG","Itacarambi",18164,10521.6,31003,"Januária",3,"Sudeste",1,"313210",3,14,5,9,7,7,0,0,0,0,0,14,5,9,7,7,6,9.26118556598175,9.80719689221784,0.412441074962888,31
"7451","MG","Itacarambi",18164,10521.6,31003,"Januária",3,"Sudeste",1,"313210",4,15,3,12,7,8,0,0,0,0,0,15,3,12,7,8,12,9.26118556598175,9.80719689221784,0.457469606306518,30
"7452","MG","Itacarambi",18164,10521.6,31003,"Januária",3,"Sudeste",1,"313210",5,32,9,23,13,19,0,0,0,0,0,32,9,23,13,19,11,9.26118556598175,9.80719689221784,0.418129310078108,31
"7453","MG","Itaguara",13435,20690.42,31032,"Itaguara",3,"Sudeste",0,"313220",2,9,1,8,1,8,0,0,0,0,0,9,1,8,1,8,7,9.93742607019523,9.50561852104959,0.299236482964956,29
"7454","MG","Itaguara",13435,20690.42,31032,"Itaguara",3,"Sudeste",0,"313220",3,19,3,16,7,12,0,0,0,0,0,19,3,16,7,12,5,9.93742607019523,9.50561852104959,0.396770072579846,31
"7455","MG","Itaguara",13435,20690.42,31032,"Itaguara",3,"Sudeste",0,"313220",4,17,4,13,4,13,0,0,0,0,0,17,4,13,4,13,6,9.93742607019523,9.50561852104959,0.427812501669122,30
"7456","MG","Itaguara",13435,20690.42,31032,"Itaguara",3,"Sudeste",0,"313220",5,21,6,15,6,15,1,0,1,0,1,22,6,16,6,16,6,9.93742607019523,9.50561852104959,0.397208277930785,31
"7457","MG","Itajubá",97334,31052.96,31056,"Itajubá",3,"Sudeste",1,"313240",2,82,15,67,26,56,0,0,0,0,0,82,15,67,26,56,60,10.3434494129307,11.4859036418739,0.322333087448644,29
"7458","MG","Itajubá",97334,31052.96,31056,"Itajubá",3,"Sudeste",1,"313240",3,75,10,65,23,52,0,0,0,0,0,75,10,65,23,52,50,10.3434494129307,11.4859036418739,0.428884841775487,31
"7459","MG","Itajubá",97334,31052.96,31056,"Itajubá",3,"Sudeste",1,"313240",4,65,8,57,17,48,0,0,0,0,0,65,8,57,17,48,58,10.3434494129307,11.4859036418739,0.487120410336025,30
"7460","MG","Itajubá",97334,31052.96,31056,"Itajubá",3,"Sudeste",1,"313240",5,92,8,84,25,67,0,0,0,0,0,92,8,84,25,67,53,10.3434494129307,11.4859036418739,0.444056671636715,31
"7461","MG","Itamarandiba",34936,14800.82,31011,"Capelinha",3,"Sudeste",0,"313250",2,32,13,19,10,22,0,0,0,0,0,32,13,19,10,22,12,9.60243786362279,10.4612730951654,0.304002783268457,29
"7462","MG","Itamarandiba",34936,14800.82,31011,"Capelinha",3,"Sudeste",0,"313250",3,41,12,29,14,27,0,0,0,0,0,41,12,29,14,27,16,9.60243786362279,10.4612730951654,0.385187548472168,31
"7463","MG","Itamarandiba",34936,14800.82,31011,"Capelinha",3,"Sudeste",0,"313250",4,18,3,15,7,11,0,0,0,0,0,18,3,15,7,11,20,9.60243786362279,10.4612730951654,0.412895517123885,30
"7464","MG","Itamarandiba",34936,14800.82,31011,"Capelinha",3,"Sudeste",0,"313250",5,31,9,22,11,20,0,0,0,0,0,31,9,22,11,20,11,9.60243786362279,10.4612730951654,0.37735862649206,31
"7465","MG","Itambacuri",23209,11670.65,31037,"Governador Valadares",3,"Sudeste",0,"313270",2,11,2,9,2,9,0,0,0,0,0,11,2,9,2,9,16,9.3648324221014,10.0522954134631,0.307526508934888,29
"7466","MG","Itambacuri",23209,11670.65,31037,"Governador Valadares",3,"Sudeste",0,"313270",3,22,3,19,9,13,1,0,1,0,1,23,3,20,9,14,17,9.3648324221014,10.0522954134631,0.398187001029853,31
"7467","MG","Itambacuri",23209,11670.65,31037,"Governador Valadares",3,"Sudeste",0,"313270",4,20,7,13,8,12,0,0,0,0,0,20,7,13,8,12,17,9.3648324221014,10.0522954134631,0.432663929506114,30
"7468","MG","Itambacuri",23209,11670.65,31037,"Governador Valadares",3,"Sudeste",0,"313270",5,32,11,21,9,23,1,0,1,0,1,33,11,22,9,24,12,9.3648324221014,10.0522954134631,0.413934701563933,31
"7469","MG","Itamogi",10157,18075.15,31048,"São Sebastião do Paraíso",3,"Sudeste",0,"313290",2,10,3,7,4,6,1,0,1,0,1,11,3,8,4,7,9,9.80229334574772,9.2259184019395,0.329853023662997,29
"7470","MG","Itamogi",10157,18075.15,31048,"São Sebastião do Paraíso",3,"Sudeste",0,"313290",3,11,2,9,4,7,0,0,0,0,0,11,2,9,4,7,1,9.80229334574772,9.2259184019395,0.425451677356506,31
"7471","MG","Itamogi",10157,18075.15,31048,"São Sebastião do Paraíso",3,"Sudeste",0,"313290",4,5,3,2,3,2,0,0,0,0,0,5,3,2,3,2,8,9.80229334574772,9.2259184019395,0.431904677257415,30
"7472","MG","Itamogi",10157,18075.15,31048,"São Sebastião do Paraíso",3,"Sudeste",0,"313290",5,10,0,10,4,6,0,0,0,0,0,10,0,10,4,6,8,9.80229334574772,9.2259184019395,0.415022938475845,31
"7473","MG","Itamonte",15714,56105.59,31054,"São Lourenço",3,"Sudeste",0,"313300",2,19,9,10,8,11,0,0,0,0,0,19,9,10,8,11,6,10.9349907300405,9.66230731373577,0.315241587381476,29
"7474","MG","Itamonte",15714,56105.59,31054,"São Lourenço",3,"Sudeste",0,"313300",3,14,3,11,6,8,0,0,0,0,0,14,3,11,6,8,8,10.9349907300405,9.66230731373577,0.427590230669681,31
"7475","MG","Itamonte",15714,56105.59,31054,"São Lourenço",3,"Sudeste",0,"313300",4,10,4,6,5,5,0,0,0,0,0,10,4,6,5,5,2,10.9349907300405,9.66230731373577,0.463171911235136,30
"7476","MG","Itamonte",15714,56105.59,31054,"São Lourenço",3,"Sudeste",0,"313300",5,14,2,12,3,11,0,0,0,0,0,14,2,12,3,11,10,10.9349907300405,9.66230731373577,0.413117694116566,31
"7477","MG","Itanhandu",15423,26411.06,31054,"São Lourenço",3,"Sudeste",1,"313310",2,11,2,9,3,8,0,0,0,0,0,11,2,9,3,8,9,10.1815381407977,9.64361518072361,0.264570062507716,29
"7478","MG","Itanhandu",15423,26411.06,31054,"São Lourenço",3,"Sudeste",1,"313310",3,17,3,14,4,13,0,0,0,0,0,17,3,14,4,13,12,10.1815381407977,9.64361518072361,0.406465448283131,31
"7479","MG","Itanhandu",15423,26411.06,31054,"São Lourenço",3,"Sudeste",1,"313310",4,14,4,10,5,9,0,0,0,0,0,14,4,10,5,9,11,10.1815381407977,9.64361518072361,0.472396116354733,30
"7480","MG","Itanhandu",15423,26411.06,31054,"São Lourenço",3,"Sudeste",1,"313310",5,17,6,11,5,12,0,0,0,0,0,17,6,11,5,12,8,10.1815381407977,9.64361518072361,0.424259238234999,31
"7481","MG","Itanhomi",12244,9486.02,31037,"Governador Valadares",3,"Sudeste",0,"313320",2,12,4,8,5,7,0,0,0,0,0,12,4,8,5,7,7,9.15757441480553,9.4127913000653,0.332229554969917,29
"7482","MG","Itanhomi",12244,9486.02,31037,"Governador Valadares",3,"Sudeste",0,"313320",3,13,3,10,7,6,0,0,0,0,0,13,3,10,7,6,8,9.15757441480553,9.4127913000653,0.404923269332006,31
"7483","MG","Itanhomi",12244,9486.02,31037,"Governador Valadares",3,"Sudeste",0,"313320",4,8,6,2,6,2,1,0,1,1,0,9,6,3,7,2,5,9.15757441480553,9.4127913000653,0.403888600548455,30
"7484","MG","Itanhomi",12244,9486.02,31037,"Governador Valadares",3,"Sudeste",0,"313320",5,14,6,8,3,11,0,0,0,0,0,14,6,8,3,11,3,9.15757441480553,9.4127913000653,0.35284385232076,31
"7485","MG","Itaobim",21029,12803.43,31013,"Pedra Azul",3,"Sudeste",0,"313330",2,0,0,0,0,0,0,0,0,0,0,0,0,0,0,0,8,9.4574683827605,9.9536577164487,0.287460000339671,29
"7486","MG","Itaobim",21029,12803.43,31013,"Pedra Azul",3,"Sudeste",0,"313330",3,0,0,0,0,0,0,0,0,0,0,0,0,0,0,0,13,9.4574683827605,9.9536577164487,0.366680291939815,31
"7487","MG","Itaobim",21029,12803.43,31013,"Pedra Azul",3,"Sudeste",0,"313330",4,0,0,0,0,0,0,0,0,0,0,0,0,0,0,0,13,9.4574683827605,9.9536577164487,0.389175087997987,30
"7488","MG","Itaobim",21029,12803.43,31013,"Pedra Azul",3,"Sudeste",0,"313330",5,2,0,2,0,2,0,0,0,0,0,2,0,2,0,2,13,9.4574683827605,9.9536577164487,0.360952537512212,31
"7489","MG","Itapagipe",15379,27161.03,31021,"Frutal",3,"Sudeste",0,"313340",2,7,1,6,5,2,0,0,0,0,0,7,1,6,5,2,9,10.2095385043703,9.64075822143992,0.323491271099584,29
"7490","MG","Itapagipe",15379,27161.03,31021,"Frutal",3,"Sudeste",0,"313340",3,12,0,12,2,10,0,0,0,0,0,12,0,12,2,10,2,10.2095385043703,9.64075822143992,0.371568419131872,31
"7491","MG","Itapagipe",15379,27161.03,31021,"Frutal",3,"Sudeste",0,"313340",4,8,2,6,4,4,0,0,0,0,0,8,2,6,4,4,10,10.2095385043703,9.64075822143992,0.419722331773169,30
"7492","MG","Itapagipe",15379,27161.03,31021,"Frutal",3,"Sudeste",0,"313340",5,11,2,9,5,6,0,0,0,0,0,11,2,9,5,6,12,10.2095385043703,9.64075822143992,0.402869833190173,31
"7493","MG","Itapecerica",21761,22196.09,31044,"Formiga",3,"Sudeste",0,"313350",2,7,4,3,3,4,0,0,0,0,0,7,4,3,3,4,15,10.0076714262222,9.98787465579629,0.296888656125343,29
"7494","MG","Itapecerica",21761,22196.09,31044,"Formiga",3,"Sudeste",0,"313350",3,19,2,17,6,13,0,0,0,0,0,19,2,17,6,13,16,10.0076714262222,9.98787465579629,0.379392470020186,31
"7495","MG","Itapecerica",21761,22196.09,31044,"Formiga",3,"Sudeste",0,"313350",4,16,2,14,3,13,1,0,1,1,0,17,2,15,4,13,14,10.0076714262222,9.98787465579629,0.438227166657066,30
"7496","MG","Itapecerica",21761,22196.09,31044,"Formiga",3,"Sudeste",0,"313350",5,14,2,12,7,7,0,0,0,0,0,14,2,12,7,7,10,10.0076714262222,9.98787465579629,0.393999439291357,31
"7497","MG","Itapeva",9881,53063.75,31052,"Pouso Alegre",3,"Sudeste",0,"313360",2,8,4,4,2,6,0,0,0,0,0,8,4,4,2,6,6,10.8792492999023,9.19836900019496,0.324664824060476,29
"7498","MG","Itapeva",9881,53063.75,31052,"Pouso Alegre",3,"Sudeste",0,"313360",3,8,1,7,2,6,0,0,0,0,0,8,1,7,2,6,6,10.8792492999023,9.19836900019496,0.371561352247729,31
"7499","MG","Itapeva",9881,53063.75,31052,"Pouso Alegre",3,"Sudeste",0,"313360",4,13,3,10,3,10,0,0,0,0,0,13,3,10,3,10,9,10.8792492999023,9.19836900019496,0.419755436447058,30
"7500","MG","Itapeva",9881,53063.75,31052,"Pouso Alegre",3,"Sudeste",0,"313360",5,12,2,10,4,8,0,0,0,0,0,12,2,10,4,8,2,10.8792492999023,9.19836900019496,0.411422152247133,31
"7501","MG","Itatiaiuçu",11252,140310.7,31032,"Itaguara",3,"Sudeste",0,"313370",2,10,4,6,1,9,1,0,1,1,0,11,4,7,2,9,8,11.8516145283286,9.32830116960975,0.319989852713855,29
"7502","MG","Itatiaiuçu",11252,140310.7,31032,"Itaguara",3,"Sudeste",0,"313370",3,8,1,7,5,3,0,0,0,0,0,8,1,7,5,3,4,11.8516145283286,9.32830116960975,0.400780287505563,31
"7503","MG","Itatiaiuçu",11252,140310.7,31032,"Itaguara",3,"Sudeste",0,"313370",4,5,0,5,2,3,0,0,0,0,0,5,0,5,2,3,10,11.8516145283286,9.32830116960975,0.429309634033813,30
"7504","MG","Itatiaiuçu",11252,140310.7,31032,"Itaguara",3,"Sudeste",0,"313370",5,9,3,6,4,5,0,0,0,0,0,9,3,6,4,5,5,11.8516145283286,9.32830116960975,0.40220138511035,31
"7505","MG","Itaú de Minas",16199,28425.16,31047,"Passos",3,"Sudeste",1,"313375",2,8,0,8,5,3,0,0,0,0,0,8,0,8,5,3,5,10.2550299474507,9.69270479092014,0.298810708547908,29
"7506","MG","Itaú de Minas",16199,28425.16,31047,"Passos",3,"Sudeste",1,"313375",3,14,2,12,8,6,0,0,0,0,0,14,2,12,8,6,6,10.2550299474507,9.69270479092014,0.377531874866287,31
"7507","MG","Itaú de Minas",16199,28425.16,31047,"Passos",3,"Sudeste",1,"313375",4,12,3,9,5,7,0,0,0,0,0,12,3,9,5,7,9,10.2550299474507,9.69270479092014,0.408685019844224,30
"7508","MG","Itaú de Minas",16199,28425.16,31047,"Passos",3,"Sudeste",1,"313375",5,19,2,17,8,11,0,0,0,0,0,19,2,17,8,11,7,10.2550299474507,9.69270479092014,0.364958818065706,31
"7509","MG","Itaúna",93847,33505.85,31043,"Divinópolis",3,"Sudeste",1,"313380",2,57,5,52,13,44,1,0,1,1,0,58,5,53,14,44,56,10.4194753294333,11.4494210756007,0.290995510202782,29
"7510","MG","Itaúna",93847,33505.85,31043,"Divinópolis",3,"Sudeste",1,"313380",3,86,9,77,23,63,1,1,0,1,0,87,10,77,24,63,68,10.4194753294333,11.4494210756007,0.375225942250263,31
"7511","MG","Itaúna",93847,33505.85,31043,"Divinópolis",3,"Sudeste",1,"313380",4,81,11,70,22,59,0,0,0,0,0,81,11,70,22,59,57,10.4194753294333,11.4494210756007,0.417165311254721,30
"7512","MG","Itaúna",93847,33505.85,31043,"Divinópolis",3,"Sudeste",1,"313380",5,81,15,66,26,55,1,1,0,0,1,82,16,66,26,56,41,10.4194753294333,11.4494210756007,0.371148577723865,31
"7513","MG","Itinga",15022,8215.84,31012,"Araçuaí",3,"Sudeste",0,"313400",2,6,2,4,0,6,0,0,0,0,0,6,2,4,0,6,9,9.01381927722208,9.61727107224596,0.339681791723179,29
"7514","MG","Itinga",15022,8215.84,31012,"Araçuaí",3,"Sudeste",0,"313400",3,3,0,3,1,2,0,0,0,0,0,3,0,3,1,2,6,9.01381927722208,9.61727107224596,0.43504815739963,31
"7515","MG","Itinga",15022,8215.84,31012,"Araçuaí",3,"Sudeste",0,"313400",4,2,0,2,2,0,1,1,0,0,1,3,1,2,2,1,7,9.01381927722208,9.61727107224596,0.436533684757194,30
"7516","MG","Itinga",15022,8215.84,31012,"Araçuaí",3,"Sudeste",0,"313400",5,3,0,3,1,2,0,0,0,0,0,3,0,3,1,2,7,9.01381927722208,9.61727107224596,0.423534212433904,31
"7517","MG","Ituiutaba",105255,26615.14,31017,"Ituiutaba",3,"Sudeste",1,"313420",2,50,7,43,22,28,0,0,0,0,0,50,7,43,22,28,47,10.1892355057846,11.5641412563545,0.298583782388795,29
"7518","MG","Ituiutaba",105255,26615.14,31017,"Ituiutaba",3,"Sudeste",1,"313420",3,80,19,61,36,44,0,0,0,0,0,80,19,61,36,44,82,10.1892355057846,11.5641412563545,0.386893493711895,31
"7519","MG","Ituiutaba",105255,26615.14,31017,"Ituiutaba",3,"Sudeste",1,"313420",4,90,21,69,32,58,0,0,0,0,0,90,21,69,32,58,56,10.1892355057846,11.5641412563545,0.420470740985694,30
"7520","MG","Ituiutaba",105255,26615.14,31017,"Ituiutaba",3,"Sudeste",1,"313420",5,94,10,84,38,56,1,0,1,0,1,95,10,85,38,57,74,10.1892355057846,11.5641412563545,0.385877068111342,31
"7521","MG","Iturama",39690,55369.21,31021,"Frutal",3,"Sudeste",1,"313440",2,41,8,33,20,21,0,0,0,0,0,41,8,33,20,21,16,10.9217789420613,10.5888545457771,0.304769145910807,29
"7522","MG","Iturama",39690,55369.21,31021,"Frutal",3,"Sudeste",1,"313440",3,38,10,28,16,22,0,0,0,0,0,38,10,28,16,22,26,10.9217789420613,10.5888545457771,0.386421502409617,31
"7523","MG","Iturama",39690,55369.21,31021,"Frutal",3,"Sudeste",1,"313440",4,40,12,28,18,22,0,0,0,0,0,40,12,28,18,22,27,10.9217789420613,10.5888545457771,0.405773933581339,30
"7524","MG","Iturama",39690,55369.21,31021,"Frutal",3,"Sudeste",1,"313440",5,48,11,37,23,25,0,0,0,0,0,48,11,37,23,25,22,10.9217789420613,10.5888545457771,0.372600786561522,31
"7525","MG","Jaboticatubas",20418,11070.98,31027,"Sete Lagoas",3,"Sudeste",0,"313460",2,12,3,9,6,6,0,0,0,0,0,12,3,9,6,6,11,9.31208254933629,9.92417214372896,0.269152737872939,29
"7526","MG","Jaboticatubas",20418,11070.98,31027,"Sete Lagoas",3,"Sudeste",0,"313460",3,26,4,22,10,16,0,0,0,0,0,26,4,22,10,16,12,9.31208254933629,9.92417214372896,0.337498261127948,31
"7527","MG","Jaboticatubas",20418,11070.98,31027,"Sete Lagoas",3,"Sudeste",0,"313460",4,14,1,13,5,9,0,0,0,0,0,14,1,13,5,9,10,9.31208254933629,9.92417214372896,0.396872778852438,30
"7528","MG","Jaboticatubas",20418,11070.98,31027,"Sete Lagoas",3,"Sudeste",0,"313460",5,11,1,10,6,5,0,0,0,0,0,11,1,10,6,5,14,9.31208254933629,9.92417214372896,0.412609934227678,31
"7529","MG","Jacinto",12323,8401.83,31014,"Almenara",3,"Sudeste",0,"313470",2,7,2,5,3,4,0,0,0,0,0,7,2,5,3,4,5,9.03620481824684,9.41922271393812,0.306588002229101,29
"7530","MG","Jacinto",12323,8401.83,31014,"Almenara",3,"Sudeste",0,"313470",3,6,0,6,2,4,1,0,1,0,1,7,0,7,2,5,6,9.03620481824684,9.41922271393812,0.405347459347279,31
"7531","MG","Jacinto",12323,8401.83,31014,"Almenara",3,"Sudeste",0,"313470",4,1,0,1,0,1,0,0,0,0,0,1,0,1,0,1,9,9.03620481824684,9.41922271393812,0.41620613513795,30
"7532","MG","Jacinto",12323,8401.83,31014,"Almenara",3,"Sudeste",0,"313470",5,0,0,0,0,0,0,0,0,0,0,0,0,0,0,0,8,9.03620481824684,9.41922271393812,0.413642340590738,31
"7533","MG","Jacuí",7691,14919.07,31048,"São Sebastião do Paraíso",3,"Sudeste",0,"313480",2,6,2,4,2,4,0,0,0,0,0,6,2,4,2,4,4,9.61039553937533,8.94780609305705,0.353271985683484,29
"7534","MG","Jacuí",7691,14919.07,31048,"São Sebastião do Paraíso",3,"Sudeste",0,"313480",3,10,7,3,5,5,0,0,0,0,0,10,7,3,5,5,4,9.61039553937533,8.94780609305705,0.442883002509099,31
"7535","MG","Jacuí",7691,14919.07,31048,"São Sebastião do Paraíso",3,"Sudeste",0,"313480",4,9,3,6,1,8,0,0,0,0,0,9,3,6,1,8,4,9.61039553937533,8.94780609305705,0.474149434012761,30
"7536","MG","Jacuí",7691,14919.07,31048,"São Sebastião do Paraíso",3,"Sudeste",0,"313480",5,7,1,6,2,5,0,0,0,0,0,7,1,6,2,5,2,9.61039553937533,8.94780609305705,0.445028733879127,31
"7537","MG","Jacutinga",26264,26970.33,31051,"Poços de Caldas",3,"Sudeste",0,"313490",2,21,9,12,6,15,0,0,0,0,0,21,9,12,6,15,13,10.2024926518765,10.1759544591814,0.308006314810791,29
"7538","MG","Jacutinga",26264,26970.33,31051,"Poços de Caldas",3,"Sudeste",0,"313490",3,27,10,17,7,20,0,0,0,0,0,27,10,17,7,20,13,10.2024926518765,10.1759544591814,0.401775886036102,31
"7539","MG","Jacutinga",26264,26970.33,31051,"Poços de Caldas",3,"Sudeste",0,"313490",4,15,5,10,6,9,0,0,0,0,0,15,5,10,6,9,13,10.2024926518765,10.1759544591814,0.41509977344035,30
"7540","MG","Jacutinga",26264,26970.33,31051,"Poços de Caldas",3,"Sudeste",0,"313490",5,30,11,19,10,20,0,0,0,0,0,30,11,19,10,20,15,10.2024926518765,10.1759544591814,0.393474794842266,31
"7541","MG","Jaíba",39388,13854.17,31004,"Janaúba",3,"Sudeste",0,"313505",2,48,17,31,19,29,1,0,1,1,0,49,17,32,20,29,10,9.53634154933158,10.5812164803677,0.308569044599679,29
"7542","MG","Jaíba",39388,13854.17,31004,"Janaúba",3,"Sudeste",0,"313505",3,32,9,23,16,16,2,0,2,0,2,34,9,25,16,18,10,9.53634154933158,10.5812164803677,0.374435024130879,31
"7543","MG","Jaíba",39388,13854.17,31004,"Janaúba",3,"Sudeste",0,"313505",4,37,10,27,8,29,2,0,2,1,1,39,10,29,9,30,12,9.53634154933158,10.5812164803677,0.379228451872922,30
"7544","MG","Jaíba",39388,13854.17,31004,"Janaúba",3,"Sudeste",0,"313505",5,30,9,21,16,14,2,1,1,0,2,32,10,22,16,16,8,9.53634154933158,10.5812164803677,0.368678108217553,31
"7545","MG","Janaúba",72018,15761.25,31004,"Janaúba",3,"Sudeste",1,"313510",2,83,16,67,41,42,2,1,1,2,0,85,17,68,43,42,21,9.66530967498744,11.1846713667534,0.279069812784089,29
"7546","MG","Janaúba",72018,15761.25,31004,"Janaúba",3,"Sudeste",1,"313510",3,59,13,46,15,44,2,1,1,0,2,61,14,47,15,46,32,9.66530967498744,11.1846713667534,0.360181366493735,31
"7547","MG","Janaúba",72018,15761.25,31004,"Janaúba",3,"Sudeste",1,"313510",4,72,11,61,29,43,0,0,0,0,0,72,11,61,29,43,29,9.66530967498744,11.1846713667534,0.390317355041057,30
"7548","MG","Janaúba",72018,15761.25,31004,"Janaúba",3,"Sudeste",1,"313510",5,115,16,99,47,68,0,0,0,0,0,115,16,99,47,68,31,9.66530967498744,11.1846713667534,0.35594120777003,31
"7549","MG","Januária",67852,10162.62,31003,"Januária",3,"Sudeste",1,"313520",2,48,12,36,21,27,0,0,0,0,0,48,12,36,21,27,40,9.22647156190443,11.1250841416156,0.278699918557303,29
"7550","MG","Januária",67852,10162.62,31003,"Januária",3,"Sudeste",1,"313520",3,73,21,52,31,42,1,0,1,1,0,74,21,53,32,42,34,9.22647156190443,11.1250841416156,0.372145027650091,31
"7551","MG","Januária",67852,10162.62,31003,"Januária",3,"Sudeste",1,"313520",4,68,19,49,27,41,0,0,0,0,0,68,19,49,27,41,29,9.22647156190443,11.1250841416156,0.431471738146164,30
"7552","MG","Januária",67852,10162.62,31003,"Januária",3,"Sudeste",1,"313520",5,68,22,46,25,43,2,1,1,2,0,70,23,47,27,43,40,9.22647156190443,11.1250841416156,0.392572104410517,31
"7553","MG","Jequitaí",7468,10300.6,31006,"Pirapora",3,"Sudeste",0,"313560",2,2,0,2,1,1,0,0,0,0,0,2,0,2,1,1,6,9.2399574249483,8.91838250466161,0.270063390946938,29
"7554","MG","Jequitaí",7468,10300.6,31006,"Pirapora",3,"Sudeste",0,"313560",3,9,3,6,2,7,0,0,0,0,0,9,3,6,2,7,1,9.2399574249483,8.91838250466161,0.330550721986454,31
"7555","MG","Jequitaí",7468,10300.6,31006,"Pirapora",3,"Sudeste",0,"313560",4,6,3,3,2,4,0,0,0,0,0,6,3,3,2,4,3,9.2399574249483,8.91838250466161,0.357375046120713,30
"7556","MG","Jequitaí",7468,10300.6,31006,"Pirapora",3,"Sudeste",0,"313560",5,3,0,3,2,1,0,0,0,0,0,3,0,3,2,1,6,9.2399574249483,8.91838250466161,0.336816728114623,31
"7557","MG","Jequitinhonha",25474,9010.66,31014,"Almenara",3,"Sudeste",0,"313580",2,5,1,4,3,2,0,0,0,0,0,5,1,4,3,2,21,9.10616359986188,10.1454136031497,0.310936880954831,29
"7558","MG","Jequitinhonha",25474,9010.66,31014,"Almenara",3,"Sudeste",0,"313580",3,2,1,1,1,1,0,0,0,0,0,2,1,1,1,1,16,9.10616359986188,10.1454136031497,0.379859381819264,31
"7559","MG","Jequitinhonha",25474,9010.66,31014,"Almenara",3,"Sudeste",0,"313580",4,0,0,0,0,0,0,0,0,0,0,0,0,0,0,0,13,9.10616359986188,10.1454136031497,0.390371999145896,30
"7560","MG","Jequitinhonha",25474,9010.66,31014,"Almenara",3,"Sudeste",0,"313580",5,2,0,2,0,2,0,0,0,0,0,2,0,2,0,2,12,9.10616359986188,10.1454136031497,0.401238371200809,31
"7561","MG","Joaíma",15455,8735.99,31014,"Almenara",3,"Sudeste",0,"313600",2,1,1,0,0,1,0,0,0,0,0,1,1,0,0,1,11,9.07520655329539,9.64568785456622,0.28501341693827,29
"7562","MG","Joaíma",15455,8735.99,31014,"Almenara",3,"Sudeste",0,"313600",3,0,0,0,0,0,0,0,0,0,0,0,0,0,0,0,8,9.07520655329539,9.64568785456622,0.343353591860012,31
"7563","MG","Joaíma",15455,8735.99,31014,"Almenara",3,"Sudeste",0,"313600",4,0,0,0,0,0,0,0,0,0,0,0,0,0,0,0,6,9.07520655329539,9.64568785456622,0.34981346818254,30
"7564","MG","Joaíma",15455,8735.99,31014,"Almenara",3,"Sudeste",0,"313600",5,2,2,0,1,1,0,0,0,0,0,2,2,0,1,1,9,9.07520655329539,9.64568785456622,0.352988340808792,31
"7565","MG","João Monlevade",80416,36814.98,31031,"Itabira",3,"Sudeste",1,"313620",2,54,9,45,20,34,1,0,1,0,1,55,9,46,20,35,41,10.5136601065458,11.2949684403433,0.313769410042171,29
"7566","MG","João Monlevade",80416,36814.98,31031,"Itabira",3,"Sudeste",1,"313620",3,62,9,53,17,45,0,0,0,0,0,62,9,53,17,45,60,10.5136601065458,11.2949684403433,0.416109334503294,31
"7567","MG","João Monlevade",80416,36814.98,31031,"Itabira",3,"Sudeste",1,"313620",4,58,10,48,16,42,1,1,0,0,1,59,11,48,16,43,39,10.5136601065458,11.2949684403433,0.464334388674044,30
"7568","MG","João Monlevade",80416,36814.98,31031,"Itabira",3,"Sudeste",1,"313620",5,77,3,74,26,51,1,0,1,0,1,78,3,75,26,52,49,10.5136601065458,11.2949684403433,0.420035045093938,31
"7569","MG","João Pinheiro",47726,30186.66,31002,"Paracatu",3,"Sudeste",1,"313630",2,52,11,41,25,27,0,0,0,0,0,52,11,41,25,27,27,10.3151553839208,10.7732316017532,0.289205129031942,29
"7570","MG","João Pinheiro",47726,30186.66,31002,"Paracatu",3,"Sudeste",1,"313630",3,53,13,40,25,28,0,0,0,0,0,53,13,40,25,28,26,10.3151553839208,10.7732316017532,0.372032797311482,31
"7571","MG","João Pinheiro",47726,30186.66,31002,"Paracatu",3,"Sudeste",1,"313630",4,37,6,31,20,17,0,0,0,0,0,37,6,31,20,17,28,10.3151553839208,10.7732316017532,0.391446598635875,30
"7572","MG","João Pinheiro",47726,30186.66,31002,"Paracatu",3,"Sudeste",1,"313630",5,61,21,40,24,37,1,1,0,1,0,62,22,40,25,37,15,10.3151553839208,10.7732316017532,0.371653096471086,31
"7573","MG","Jordânia",10842,8407.43,31014,"Almenara",3,"Sudeste",0,"313650",2,1,0,1,0,1,0,0,0,0,0,1,0,1,0,1,7,9.03687111768027,9.29118275982028,0.260732852651304,29
"7574","MG","Jordânia",10842,8407.43,31014,"Almenara",3,"Sudeste",0,"313650",3,2,1,1,1,1,0,0,0,0,0,2,1,1,1,1,3,9.03687111768027,9.29118275982028,0.332688842334806,31
"7575","MG","Jordânia",10842,8407.43,31014,"Almenara",3,"Sudeste",0,"313650",4,0,0,0,0,0,0,0,0,0,0,0,0,0,0,0,7,9.03687111768027,9.29118275982028,0.349299209709311,30
"7576","MG","Jordânia",10842,8407.43,31014,"Almenara",3,"Sudeste",0,"313650",5,1,0,1,0,1,0,0,0,0,0,1,0,1,0,1,9,9.03687111768027,9.29118275982028,0.331228560105765,31
"7577","MG","Nova União",5732,14983.42,31031,"Itabira",3,"Sudeste",0,"313660",2,12,2,10,3,9,0,0,0,0,0,12,2,10,3,9,2,9.6146995354196,8.65381978894806,0.306801777509018,29
"7578","MG","Nova União",5732,14983.42,31031,"Itabira",3,"Sudeste",0,"313660",3,3,1,2,0,3,0,0,0,0,0,3,1,2,0,3,3,9.6146995354196,8.65381978894806,0.426510472126001,31
"7579","MG","Nova União",5732,14983.42,31031,"Itabira",3,"Sudeste",0,"313660",4,7,3,4,2,5,0,0,0,0,0,7,3,4,2,5,6,9.6146995354196,8.65381978894806,0.452703233944504,30
"7580","MG","Nova União",5732,14983.42,31031,"Itabira",3,"Sudeste",0,"313660",5,7,1,6,3,4,0,0,0,0,0,7,1,6,3,4,4,9.6146995354196,8.65381978894806,0.403248241682505,31
"7581","MG","Juatuba",27392,45494.8,31030,"Belo Horizonte",3,"Sudeste",1,"313665",2,28,5,23,6,22,0,0,0,0,0,28,5,23,6,22,12,10.7253533126936,10.2180062789415,0.321394103430483,29
"7582","MG","Juatuba",27392,45494.8,31030,"Belo Horizonte",3,"Sudeste",1,"313665",3,33,2,31,12,21,0,0,0,0,0,33,2,31,12,21,20,10.7253533126936,10.2180062789415,0.399555506900674,31
"7583","MG","Juatuba",27392,45494.8,31030,"Belo Horizonte",3,"Sudeste",1,"313665",4,34,14,20,14,20,0,0,0,0,0,34,14,20,14,20,10,10.7253533126936,10.2180062789415,0.457766782046302,30
"7584","MG","Juatuba",27392,45494.8,31030,"Belo Horizonte",3,"Sudeste",1,"313665",5,36,6,30,12,24,0,0,0,0,0,36,6,30,12,24,20,10.7253533126936,10.2180062789415,0.404087654186469,31
"7585","MG","Juiz de Fora",573285,29988.91,31065,"Juiz de Fora",3,"Sudeste",1,"313670",2,413,73,340,122,291,4,0,4,2,2,417,73,344,124,293,365,10.3085829256341,13.2591382542423,0.278042778033743,29
"7586","MG","Juiz de Fora",573285,29988.91,31065,"Juiz de Fora",3,"Sudeste",1,"313670",3,435,86,349,142,293,6,2,4,3,3,441,88,353,145,296,379,10.3085829256341,13.2591382542423,0.398022335618218,31
"7587","MG","Juiz de Fora",573285,29988.91,31065,"Juiz de Fora",3,"Sudeste",1,"313670",4,467,101,366,143,324,3,0,3,1,2,470,101,369,144,326,324,10.3085829256341,13.2591382542423,0.489623191970972,30
"7588","MG","Juiz de Fora",573285,29988.91,31065,"Juiz de Fora",3,"Sudeste",1,"313670",5,460,99,361,151,309,2,0,2,0,2,462,99,363,151,311,360,10.3085829256341,13.2591382542423,0.448769578612149,31
"7589","MG","Juruaia",10681,14673.37,31048,"São Sebastião do Paraíso",3,"Sudeste",0,"313690",2,12,4,8,4,8,0,0,0,0,0,12,4,8,4,8,1,9.59378956527337,9.2762217410897,0.301970186757524,29
"7590","MG","Juruaia",10681,14673.37,31048,"São Sebastião do Paraíso",3,"Sudeste",0,"313690",3,12,1,11,3,9,0,0,0,0,0,12,1,11,3,9,3,9.59378956527337,9.2762217410897,0.398858598744459,31
"7591","MG","Juruaia",10681,14673.37,31048,"São Sebastião do Paraíso",3,"Sudeste",0,"313690",4,15,5,10,4,11,0,0,0,0,0,15,5,10,4,11,4,9.59378956527337,9.2762217410897,0.409141555607437,30
"7592","MG","Juruaia",10681,14673.37,31048,"São Sebastião do Paraíso",3,"Sudeste",0,"313690",5,7,1,6,3,4,0,0,0,0,0,7,1,6,3,4,5,9.59378956527337,9.2762217410897,0.359312955954311,31
"7593","MG","Ladainha",18193,6570.88,31015,"Teófilo Otoni",3,"Sudeste",0,"313700",2,13,5,8,7,6,0,0,0,0,0,13,5,8,7,6,7,8.79040304467055,9.8087921836968,0.316762256520459,29
"7594","MG","Ladainha",18193,6570.88,31015,"Teófilo Otoni",3,"Sudeste",0,"313700",3,15,7,8,7,8,0,0,0,0,0,15,7,8,7,8,10,8.79040304467055,9.8087921836968,0.400045636714174,31
"7595","MG","Ladainha",18193,6570.88,31015,"Teófilo Otoni",3,"Sudeste",0,"313700",4,8,3,5,3,5,0,0,0,0,0,8,3,5,3,5,7,8.79040304467055,9.8087921836968,0.407103951107643,30
"7596","MG","Ladainha",18193,6570.88,31015,"Teófilo Otoni",3,"Sudeste",0,"313700",5,17,8,9,10,7,0,0,0,0,0,17,8,9,10,7,14,8.79040304467055,9.8087921836968,0.400633278295952,31
"7597","MG","Lagoa da Prata",52711,35108.05,31026,"Bom Despacho",3,"Sudeste",1,"313720",2,46,7,39,10,36,0,0,0,0,0,46,7,39,10,36,21,10.4661857278878,10.8725794414014,0.294433881717235,29
"7598","MG","Lagoa da Prata",52711,35108.05,31026,"Bom Despacho",3,"Sudeste",1,"313720",3,49,7,42,20,29,0,0,0,0,0,49,7,42,20,29,25,10.4661857278878,10.8725794414014,0.378475299876143,31
"7599","MG","Lagoa da Prata",52711,35108.05,31026,"Bom Despacho",3,"Sudeste",1,"313720",4,36,7,29,12,24,1,0,1,0,1,37,7,30,12,25,27,10.4661857278878,10.8725794414014,0.398751411878982,30
"7600","MG","Lagoa da Prata",52711,35108.05,31026,"Bom Despacho",3,"Sudeste",1,"313720",5,56,8,48,16,40,0,0,0,0,0,56,8,48,16,40,17,10.4661857278878,10.8725794414014,0.362584527074822,31
"7601","MG","Lagoa Dourada",13063,17148.18,31058,"São João Del Rei",3,"Sudeste",0,"313740",2,19,4,15,6,13,0,0,0,0,0,19,4,15,6,13,5,9.74964732451372,9.47753908548656,0.337811724656525,29
"7602","MG","Lagoa Dourada",13063,17148.18,31058,"São João Del Rei",3,"Sudeste",0,"313740",3,6,3,3,1,5,0,0,0,0,0,6,3,3,1,5,4,9.74964732451372,9.47753908548656,0.425367817252804,31
"7603","MG","Lagoa Dourada",13063,17148.18,31058,"São João Del Rei",3,"Sudeste",0,"313740",4,8,2,6,2,6,0,0,0,0,0,8,2,6,2,6,2,9.74964732451372,9.47753908548656,0.4706255367314,30
"7604","MG","Lagoa Dourada",13063,17148.18,31058,"São João Del Rei",3,"Sudeste",0,"313740",5,10,3,7,2,8,0,0,0,0,0,10,3,7,2,8,5,9.74964732451372,9.47753908548656,0.439629645883372,31
"7605","MG","Lagoa Formosa",18111,19145.32,31020,"Patos de Minas",3,"Sudeste",0,"313750",2,11,4,7,2,9,0,0,0,0,0,11,4,7,2,9,17,9.85981357831859,9.80427476746454,0.335645824879159,29
"7606","MG","Lagoa Formosa",18111,19145.32,31020,"Patos de Minas",3,"Sudeste",0,"313750",3,19,7,12,6,13,0,0,0,0,0,19,7,12,6,13,9,9.85981357831859,9.80427476746454,0.403779853550297,31
"7607","MG","Lagoa Formosa",18111,19145.32,31020,"Patos de Minas",3,"Sudeste",0,"313750",4,13,5,8,3,10,2,0,2,2,0,15,5,10,5,10,9,9.85981357831859,9.80427476746454,0.420197171418849,30
"7608","MG","Lagoa Formosa",18111,19145.32,31020,"Patos de Minas",3,"Sudeste",0,"313750",5,26,6,20,10,16,0,0,0,0,0,26,6,20,10,16,11,9.85981357831859,9.80427476746454,0.424335728812292,31
"7609","MG","Lagoa Grande",9608,25380.96,31002,"Paracatu",3,"Sudeste",0,"313753",2,5,2,3,2,3,0,0,0,0,0,5,2,3,2,3,10,10.1417545656121,9.17035136375982,0.296280195072269,29
"7610","MG","Lagoa Grande",9608,25380.96,31002,"Paracatu",3,"Sudeste",0,"313753",3,8,2,6,2,6,0,0,0,0,0,8,2,6,2,6,4,10.1417545656121,9.17035136375982,0.361565617246723,31
"7611","MG","Lagoa Grande",9608,25380.96,31002,"Paracatu",3,"Sudeste",0,"313753",4,5,2,3,2,3,0,0,0,0,0,5,2,3,2,3,3,10.1417545656121,9.17035136375982,0.3767907632342,30
"7612","MG","Lagoa Grande",9608,25380.96,31002,"Paracatu",3,"Sudeste",0,"313753",5,4,2,2,2,2,0,0,0,0,0,4,2,2,2,2,3,10.1417545656121,9.17035136375982,0.374240756764539,31
"7613","MG","Lagoa Santa",65657,26018.35,31030,"Belo Horizonte",3,"Sudeste",1,"313760",2,62,6,56,7,55,2,1,1,1,1,64,7,57,8,56,34,10.1665573372964,11.092199500094,0.294211005228821,29
"7614","MG","Lagoa Santa",65657,26018.35,31030,"Belo Horizonte",3,"Sudeste",1,"313760",3,53,4,49,19,34,1,0,1,1,0,54,4,50,20,34,19,10.1665573372964,11.092199500094,0.389204274589652,31
"7615","MG","Lagoa Santa",65657,26018.35,31030,"Belo Horizonte",3,"Sudeste",1,"313760",4,63,6,57,15,48,1,0,1,0,1,64,6,58,15,49,29,10.1665573372964,11.092199500094,0.452668504183819,30
"7616","MG","Lagoa Santa",65657,26018.35,31030,"Belo Horizonte",3,"Sudeste",1,"313760",5,85,11,74,18,67,2,2,0,0,2,87,13,74,18,69,24,10.1665573372964,11.092199500094,0.411621187178512,31
"7617","MG","Lajinha",19918,17239.56,31061,"Manhuaçu",3,"Sudeste",0,"313770",2,23,11,12,13,10,1,1,0,0,1,24,12,12,13,11,8,9.75496202185023,9.89937912449158,0.335224681366497,29
"7618","MG","Lajinha",19918,17239.56,31061,"Manhuaçu",3,"Sudeste",0,"313770",3,28,9,19,14,14,0,0,0,0,0,28,9,19,14,14,12,9.75496202185023,9.89937912449158,0.429051748438242,31
"7619","MG","Lajinha",19918,17239.56,31061,"Manhuaçu",3,"Sudeste",0,"313770",4,23,6,17,10,13,0,0,0,0,0,23,6,17,10,13,4,9.75496202185023,9.89937912449158,0.428185849717351,30
"7620","MG","Lajinha",19918,17239.56,31061,"Manhuaçu",3,"Sudeste",0,"313770",5,36,11,25,11,25,0,0,0,0,0,36,11,25,11,25,14,9.75496202185023,9.89937912449158,0.397135988323841,31
"7621","MG","Lambari",20907,15494,31054,"São Lourenço",3,"Sudeste",0,"313780",2,13,3,10,3,10,0,0,0,0,0,13,3,10,3,10,8,9.64820813119185,9.94783931010663,0.317002052196284,29
"7622","MG","Lambari",20907,15494,31054,"São Lourenço",3,"Sudeste",0,"313780",3,15,5,10,5,10,0,0,0,0,0,15,5,10,5,10,16,9.64820813119185,9.94783931010663,0.412858984159627,31
"7623","MG","Lambari",20907,15494,31054,"São Lourenço",3,"Sudeste",0,"313780",4,15,4,11,5,10,0,0,0,0,0,15,4,11,5,10,14,9.64820813119185,9.94783931010663,0.422758833753375,30
"7624","MG","Lambari",20907,15494,31054,"São Lourenço",3,"Sudeste",0,"313780",5,22,4,18,7,15,0,0,0,0,0,22,4,18,7,15,19,9.64820813119185,9.94783931010663,0.424121471941749,31
"7625","MG","Lavras",104783,25458.79,31057,"Lavras",3,"Sudeste",1,"313820",2,90,12,78,24,66,1,0,1,1,0,91,12,79,25,66,47,10.1448163454518,11.5596468239705,0.307051229794084,29
"7626","MG","Lavras",104783,25458.79,31057,"Lavras",3,"Sudeste",1,"313820",3,121,23,98,25,96,2,0,2,0,2,123,23,100,25,98,62,10.1448163454518,11.5596468239705,0.402861077146648,31
"7627","MG","Lavras",104783,25458.79,31057,"Lavras",3,"Sudeste",1,"313820",4,104,18,86,36,68,0,0,0,0,0,104,18,86,36,68,54,10.1448163454518,11.5596468239705,0.475440077034664,30
"7628","MG","Lavras",104783,25458.79,31057,"Lavras",3,"Sudeste",1,"313820",5,109,25,84,45,64,1,0,1,0,1,110,25,85,45,65,61,10.1448163454518,11.5596468239705,0.425058307954036,31
"7629","MG","Leopoldina",52640,19300.12,31066,"Cataguases",3,"Sudeste",1,"313840",2,40,9,31,13,27,1,0,1,1,0,41,9,32,14,27,33,9.86786659249023,10.8712315659992,0.305556516181827,29
"7630","MG","Leopoldina",52640,19300.12,31066,"Cataguases",3,"Sudeste",1,"313840",3,52,13,39,14,38,0,0,0,0,0,52,13,39,14,38,44,9.86786659249023,10.8712315659992,0.418505364355904,31
"7631","MG","Leopoldina",52640,19300.12,31066,"Cataguases",3,"Sudeste",1,"313840",4,42,6,36,14,28,0,0,0,0,0,42,6,36,14,28,32,9.86786659249023,10.8712315659992,0.483876981350175,30
"7632","MG","Leopoldina",52640,19300.12,31066,"Cataguases",3,"Sudeste",1,"313840",5,43,11,32,13,30,0,0,0,0,0,43,11,32,13,30,36,9.86786659249023,10.8712315659992,0.452086517307332,31
"7633","MG","Lima Duarte",16724,16596.5,31065,"Juiz de Fora",3,"Sudeste",0,"313860",2,6,2,4,2,4,0,0,0,0,0,6,2,4,2,4,13,9.71694710874055,9.72460009247646,0.31590694283868,29
"7634","MG","Lima Duarte",16724,16596.5,31065,"Juiz de Fora",3,"Sudeste",0,"313860",3,13,4,9,3,10,0,0,0,0,0,13,4,9,3,10,12,9.71694710874055,9.72460009247646,0.416558670538288,31
"7635","MG","Lima Duarte",16724,16596.5,31065,"Juiz de Fora",3,"Sudeste",0,"313860",4,15,6,9,9,6,0,0,0,0,0,15,6,9,9,6,19,9.71694710874055,9.72460009247646,0.4731422825246,30
"7636","MG","Lima Duarte",16724,16596.5,31065,"Juiz de Fora",3,"Sudeste",0,"313860",5,12,4,8,6,6,0,0,0,0,0,12,4,8,6,6,15,9.71694710874055,9.72460009247646,0.449310064063332,31
"7637","MG","Limeira do Oeste",7589,52101.89,31021,"Frutal",3,"Sudeste",0,"313862",2,8,2,6,4,4,0,0,0,0,0,8,2,6,4,4,7,10.860956503475,8.93445510940391,0.300931288913063,29
"7638","MG","Limeira do Oeste",7589,52101.89,31021,"Frutal",3,"Sudeste",0,"313862",3,6,2,4,2,4,0,0,0,0,0,6,2,4,2,4,3,10.860956503475,8.93445510940391,0.389382297009312,31
"7639","MG","Limeira do Oeste",7589,52101.89,31021,"Frutal",3,"Sudeste",0,"313862",4,1,0,1,0,1,0,0,0,0,0,1,0,1,0,1,6,10.860956503475,8.93445510940391,0.382329590449957,30
"7640","MG","Limeira do Oeste",7589,52101.89,31021,"Frutal",3,"Sudeste",0,"313862",5,13,2,11,5,8,1,0,1,0,1,14,2,12,5,9,10,10.860956503475,8.93445510940391,0.374957688730923,31
"7641","MG","Lontra",9714,7705.26,31007,"Montes Claros",3,"Sudeste",0,"313865",2,7,1,6,0,7,0,0,0,0,0,7,1,6,0,7,6,8.94965849150676,9.18132342290569,0.315024071102657,29
"7642","MG","Lontra",9714,7705.26,31007,"Montes Claros",3,"Sudeste",0,"313865",3,8,4,4,4,4,0,0,0,0,0,8,4,4,4,4,6,8.94965849150676,9.18132342290569,0.406406446598203,31
"7643","MG","Lontra",9714,7705.26,31007,"Montes Claros",3,"Sudeste",0,"313865",4,12,2,10,5,7,0,0,0,0,0,12,2,10,5,7,5,8.94965849150676,9.18132342290569,0.419775580507749,30
"7644","MG","Lontra",9714,7705.26,31007,"Montes Claros",3,"Sudeste",0,"313865",5,8,1,7,2,6,1,0,1,1,0,9,1,8,3,6,3,8.94965849150676,9.18132342290569,0.384327832932346,31
"7645","MG","Luminárias",5438,16610.24,31057,"Lavras",3,"Sudeste",0,"313870",2,5,2,3,3,2,0,0,0,0,0,5,2,3,3,2,1,9.71777465162998,8.60116662519242,0.285020872047627,29
"7646","MG","Luminárias",5438,16610.24,31057,"Lavras",3,"Sudeste",0,"313870",3,10,0,10,2,8,0,0,0,0,0,10,0,10,2,8,6,9.71777465162998,8.60116662519242,0.342935654115846,31
"7647","MG","Luminárias",5438,16610.24,31057,"Lavras",3,"Sudeste",0,"313870",4,3,2,1,0,3,0,0,0,0,0,3,2,1,0,3,4,9.71777465162998,8.60116662519242,0.370911806938975,30
"7648","MG","Luminárias",5438,16610.24,31057,"Lavras",3,"Sudeste",0,"313870",5,3,0,3,1,2,0,0,0,0,0,3,0,3,1,2,2,9.71777465162998,8.60116662519242,0.355928343667268,31
"7649","MG","Luz",18257,27700.42,31026,"Bom Despacho",3,"Sudeste",1,"313880",2,6,1,5,3,3,0,0,0,0,0,6,1,5,3,3,14,10.2292028545154,9.81230384711351,0.311098061252955,29
"7650","MG","Luz",18257,27700.42,31026,"Bom Despacho",3,"Sudeste",1,"313880",3,5,2,3,2,3,0,0,0,0,0,5,2,3,2,3,15,10.2292028545154,9.81230384711351,0.388936001995536,31
"7651","MG","Luz",18257,27700.42,31026,"Bom Despacho",3,"Sudeste",1,"313880",4,9,2,7,4,5,0,0,0,0,0,9,2,7,4,5,13,10.2292028545154,9.81230384711351,0.417443150300709,30
"7652","MG","Luz",18257,27700.42,31026,"Bom Despacho",3,"Sudeste",1,"313880",5,24,4,20,7,17,0,0,0,0,0,24,4,20,7,17,11,10.2292028545154,9.81230384711351,0.375361119311175,31
"7653","MG","Machado",42413,25254.66,31049,"Alfenas",3,"Sudeste",1,"313900",2,42,12,30,16,26,0,0,0,0,0,42,12,30,16,26,20,10.1367659721309,10.6552101980003,0.32422715719631,29
"7654","MG","Machado",42413,25254.66,31049,"Alfenas",3,"Sudeste",1,"313900",3,38,12,26,14,24,0,0,0,0,0,38,12,26,14,24,22,10.1367659721309,10.6552101980003,0.405860015739231,31
"7655","MG","Machado",42413,25254.66,31049,"Alfenas",3,"Sudeste",1,"313900",4,31,9,22,14,17,0,0,0,0,0,31,9,22,14,17,19,10.1367659721309,10.6552101980003,0.44832209938846,30
"7656","MG","Machado",42413,25254.66,31049,"Alfenas",3,"Sudeste",1,"313900",5,52,15,37,15,37,0,0,0,0,0,52,15,37,15,37,24,10.1367659721309,10.6552101980003,0.404707846228473,31
"7657","MG","Malacacheta",18602,10361.92,31015,"Teófilo Otoni",3,"Sudeste",0,"313920",2,16,4,12,8,8,0,0,0,0,0,16,4,12,8,8,19,9.24589282682765,9.83102438080241,0.278365962247831,29
"7658","MG","Malacacheta",18602,10361.92,31015,"Teófilo Otoni",3,"Sudeste",0,"313920",3,21,5,16,7,14,0,0,0,0,0,21,5,16,7,14,15,9.24589282682765,9.83102438080241,0.353407353708253,31
"7659","MG","Malacacheta",18602,10361.92,31015,"Teófilo Otoni",3,"Sudeste",0,"313920",4,13,3,10,5,8,0,0,0,0,0,13,3,10,5,8,13,9.24589282682765,9.83102438080241,0.392060163448949,30
"7660","MG","Malacacheta",18602,10361.92,31015,"Teófilo Otoni",3,"Sudeste",0,"313920",5,19,6,13,8,11,0,0,0,0,0,19,6,13,8,11,17,9.24589282682765,9.83102438080241,0.36740410560833,31
"7661","MG","Manga",18226,10457.97,31003,"Januária",3,"Sudeste",0,"313930",2,33,11,22,11,22,0,0,0,0,0,33,11,22,11,22,9,9.25511964612664,9.81060442505607,0.253083846398134,29
"7662","MG","Manga",18226,10457.97,31003,"Januária",3,"Sudeste",0,"313930",3,15,5,10,5,10,0,0,0,0,0,15,5,10,5,10,17,9.25511964612664,9.81060442505607,0.345816322175121,31
"7663","MG","Manga",18226,10457.97,31003,"Januária",3,"Sudeste",0,"313930",4,22,5,17,9,13,0,0,0,0,0,22,5,17,9,13,13,9.25511964612664,9.81060442505607,0.363499450440645,30
"7664","MG","Manga",18226,10457.97,31003,"Januária",3,"Sudeste",0,"313930",5,22,7,15,14,8,0,0,0,0,0,22,7,15,14,8,12,9.25511964612664,9.81060442505607,0.349818553234955,31
"7665","MG","Manhuaçu",91169,23446.8,31061,"Manhuaçu",3,"Sudeste",1,"313940",2,102,32,70,38,64,2,2,0,2,0,104,34,70,40,64,51,10.0624893040085,11.4204702059984,0.318080610293696,29
"7666","MG","Manhuaçu",91169,23446.8,31061,"Manhuaçu",3,"Sudeste",1,"313940",3,96,31,65,44,52,2,0,2,0,2,98,31,67,44,54,55,10.0624893040085,11.4204702059984,0.419542899240893,31
"7667","MG","Manhuaçu",91169,23446.8,31061,"Manhuaçu",3,"Sudeste",1,"313940",4,97,22,75,41,56,0,0,0,0,0,97,22,75,41,56,47,10.0624893040085,11.4204702059984,0.446852568983971,30
"7668","MG","Manhuaçu",91169,23446.8,31061,"Manhuaçu",3,"Sudeste",1,"313940",5,134,49,85,46,88,1,1,0,1,0,135,50,85,47,88,48,10.0624893040085,11.4204702059984,0.420583902652714,31
"7669","MG","Manhumirim",22802,20869.13,31061,"Manhuaçu",3,"Sudeste",1,"313950",2,15,1,14,9,6,0,0,0,0,0,15,1,14,9,6,14,9.94602631257081,10.0346035303937,0.373981769630921,29
"7670","MG","Manhumirim",22802,20869.13,31061,"Manhuaçu",3,"Sudeste",1,"313950",3,22,4,18,9,13,0,0,0,0,0,22,4,18,9,13,12,9.94602631257081,10.0346035303937,0.490634692143598,31
"7671","MG","Manhumirim",22802,20869.13,31061,"Manhuaçu",3,"Sudeste",1,"313950",4,31,12,19,12,19,0,0,0,0,0,31,12,19,12,19,20,9.94602631257081,10.0346035303937,0.533370611957389,30
"7672","MG","Manhumirim",22802,20869.13,31061,"Manhuaçu",3,"Sudeste",1,"313950",5,24,10,14,8,16,1,1,0,1,0,25,11,14,9,16,8,9.94602631257081,10.0346035303937,0.50634492348093,31
"7673","MG","Mantena",27647,14175.87,31038,"Mantena",3,"Sudeste",0,"313960",2,27,7,20,8,19,0,0,0,0,0,27,7,20,8,19,15,9.55929650237392,10.2272725019682,0.292589520284329,29
"7674","MG","Mantena",27647,14175.87,31038,"Mantena",3,"Sudeste",0,"313960",3,35,8,27,19,16,0,0,0,0,0,35,8,27,19,16,16,9.55929650237392,10.2272725019682,0.388427007142449,31
"7675","MG","Mantena",27647,14175.87,31038,"Mantena",3,"Sudeste",0,"313960",4,29,3,26,12,17,1,1,0,1,0,30,4,26,13,17,10,9.55929650237392,10.2272725019682,0.410939717686816,30
"7676","MG","Mantena",27647,14175.87,31038,"Mantena",3,"Sudeste",0,"313960",5,29,8,21,11,18,0,0,0,0,0,29,8,21,11,18,18,9.55929650237392,10.2272725019682,0.409196710980412,31
"7677","MG","Mar de Espanha",12901,13446.49,31065,"Juiz de Fora",3,"Sudeste",1,"313980",2,10,4,6,3,7,1,0,1,0,1,11,4,7,3,8,11,9.50647338442954,9.46506010672514,0.336200973229522,29
"7678","MG","Mar de Espanha",12901,13446.49,31065,"Juiz de Fora",3,"Sudeste",1,"313980",3,9,4,5,1,8,0,0,0,0,0,9,4,5,1,8,7,9.50647338442954,9.46506010672514,0.433766045593544,31
"7679","MG","Mar de Espanha",12901,13446.49,31065,"Juiz de Fora",3,"Sudeste",1,"313980",4,9,3,6,2,7,0,0,0,0,0,9,3,6,2,7,8,9.50647338442954,9.46506010672514,0.496661351493061,30
"7680","MG","Mar de Espanha",12901,13446.49,31065,"Juiz de Fora",3,"Sudeste",1,"313980",5,13,5,8,7,6,0,0,0,0,0,13,5,8,7,6,12,9.50647338442954,9.46506010672514,0.45530741886573,31
"7681","MG","Maria da Fé",14056,11731.6,31056,"Itajubá",3,"Sudeste",0,"313990",2,20,4,16,10,10,0,0,0,0,0,20,4,16,10,10,6,9.3700413347326,9.55080462986693,0.321499851272137,29
"7682","MG","Maria da Fé",14056,11731.6,31056,"Itajubá",3,"Sudeste",0,"313990",3,10,1,9,5,5,0,0,0,0,0,10,1,9,5,5,14,9.3700413347326,9.55080462986693,0.410714958023356,31
"7683","MG","Maria da Fé",14056,11731.6,31056,"Itajubá",3,"Sudeste",0,"313990",4,12,5,7,5,7,0,0,0,0,0,12,5,7,5,7,8,9.3700413347326,9.55080462986693,0.42988265705668,30
"7684","MG","Maria da Fé",14056,11731.6,31056,"Itajubá",3,"Sudeste",0,"313990",5,11,4,7,4,7,0,0,0,0,0,11,4,7,4,7,6,9.3700413347326,9.55080462986693,0.404035882819258,31
"7685","MG","Mariana",61288,45786.96,31033,"Ouro Preto",3,"Sudeste",1,"314000",2,64,13,51,25,39,0,0,0,0,0,64,13,51,25,39,28,10.7317546134057,11.0233393441967,0.301009755104313,29
"7686","MG","Mariana",61288,45786.96,31033,"Ouro Preto",3,"Sudeste",1,"314000",3,58,14,44,21,37,0,0,0,0,0,58,14,44,21,37,22,10.7317546134057,11.0233393441967,0.420711848757335,31
"7687","MG","Mariana",61288,45786.96,31033,"Ouro Preto",3,"Sudeste",1,"314000",4,51,14,37,20,31,0,0,0,0,0,51,14,37,20,31,23,10.7317546134057,11.0233393441967,0.507115657156122,30
"7688","MG","Mariana",61288,45786.96,31033,"Ouro Preto",3,"Sudeste",1,"314000",5,63,12,51,19,44,0,0,0,0,0,63,12,51,19,44,34,10.7317546134057,11.0233393441967,0.458027294220279,31
"7689","MG","Mário Campos",15619,10246.91,31030,"Belo Horizonte",3,"Sudeste",1,"314015",2,13,2,11,5,8,0,0,0,0,0,13,2,11,5,8,1,9.23473147570269,9.65624340085772,0.300091973488119,29
"7690","MG","Mário Campos",15619,10246.91,31030,"Belo Horizonte",3,"Sudeste",1,"314015",3,23,2,21,6,17,0,0,0,0,0,23,2,21,6,17,4,9.23473147570269,9.65624340085772,0.389686996531355,31
"7691","MG","Mário Campos",15619,10246.91,31030,"Belo Horizonte",3,"Sudeste",1,"314015",4,7,1,6,3,4,0,0,0,0,0,7,1,6,3,4,12,9.23473147570269,9.65624340085772,0.434516827120048,30
"7692","MG","Mário Campos",15619,10246.91,31030,"Belo Horizonte",3,"Sudeste",1,"314015",5,20,3,17,8,12,0,0,0,0,0,20,3,17,8,12,6,9.23473147570269,9.65624340085772,0.377452912454394,31
"7693","MG","Martinho Campos",13443,25038.2,31026,"Bom Despacho",3,"Sudeste",0,"314050",2,6,2,4,3,3,0,0,0,0,0,6,2,4,3,3,6,10.1281579376462,9.50621380345425,0.318056296938355,29
"7694","MG","Martinho Campos",13443,25038.2,31026,"Bom Despacho",3,"Sudeste",0,"314050",3,11,2,9,5,6,0,0,0,0,0,11,2,9,5,6,10,10.1281579376462,9.50621380345425,0.381890354339415,31
"7695","MG","Martinho Campos",13443,25038.2,31026,"Bom Despacho",3,"Sudeste",0,"314050",4,6,0,6,2,4,0,0,0,0,0,6,0,6,2,4,13,10.1281579376462,9.50621380345425,0.408979257560258,30
"7696","MG","Martinho Campos",13443,25038.2,31026,"Bom Despacho",3,"Sudeste",0,"314050",5,11,2,9,5,6,0,0,0,0,0,11,2,9,5,6,8,10.1281579376462,9.50621380345425,0.398651944510696,31
"7697","MG","Martins Soares",8531,24003.32,31061,"Manhuaçu",3,"Sudeste",0,"314053",2,4,2,2,2,2,0,0,0,0,0,4,2,2,2,2,8,10.0859474330962,9.05146186690869,0.368331502784632,29
"7698","MG","Martins Soares",8531,24003.32,31061,"Manhuaçu",3,"Sudeste",0,"314053",3,8,1,7,2,6,0,0,0,0,0,8,1,7,2,6,1,10.0859474330962,9.05146186690869,0.457659335760502,31
"7699","MG","Martins Soares",8531,24003.32,31061,"Manhuaçu",3,"Sudeste",0,"314053",4,12,6,6,6,6,0,0,0,0,0,12,6,6,6,6,4,10.0859474330962,9.05146186690869,0.495965297684819,30
"7700","MG","Martins Soares",8531,24003.32,31061,"Manhuaçu",3,"Sudeste",0,"314053",5,19,8,11,15,4,0,0,0,0,0,19,8,11,15,4,8,10.0859474330962,9.05146186690869,0.458292171135295,31
"7701","MG","Mata Verde",8644,7985.25,31014,"Almenara",3,"Sudeste",0,"314055",2,1,0,1,1,0,0,0,0,0,0,1,0,1,1,0,5,8.98535136886282,9.06462071762678,0.286835264791221,29
"7702","MG","Mata Verde",8644,7985.25,31014,"Almenara",3,"Sudeste",0,"314055",3,3,1,2,0,3,0,0,0,0,0,3,1,2,0,3,2,8.98535136886282,9.06462071762678,0.373333719946342,31
"7703","MG","Mata Verde",8644,7985.25,31014,"Almenara",3,"Sudeste",0,"314055",4,0,0,0,0,0,0,0,0,0,0,0,0,0,0,0,2,8.98535136886282,9.06462071762678,0.396938615558191,30
"7704","MG","Mata Verde",8644,7985.25,31014,"Almenara",3,"Sudeste",0,"314055",5,2,0,2,0,2,0,0,0,0,0,2,0,2,0,2,2,8.98535136886282,9.06462071762678,0.406732250043692,31
"7705","MG","Mateus Leme",31364,22650.53,31030,"Belo Horizonte",3,"Sudeste",0,"314070",2,32,4,28,7,25,0,0,0,0,0,32,4,28,7,25,12,10.0279385301959,10.3534160173508,0.3164791253548,29
"7706","MG","Mateus Leme",31364,22650.53,31030,"Belo Horizonte",3,"Sudeste",0,"314070",3,33,6,27,14,19,0,0,0,0,0,33,6,27,14,19,17,10.0279385301959,10.3534160173508,0.39942523461731,31
"7707","MG","Mateus Leme",31364,22650.53,31030,"Belo Horizonte",3,"Sudeste",0,"314070",4,44,14,30,20,24,2,1,1,1,1,46,15,31,21,25,16,10.0279385301959,10.3534160173508,0.440386557125176,30
"7708","MG","Mateus Leme",31364,22650.53,31030,"Belo Horizonte",3,"Sudeste",0,"314070",5,30,11,19,9,21,1,0,1,0,1,31,11,20,9,22,15,10.0279385301959,10.3534160173508,0.390111475741446,31
"7709","MG","Matias Barbosa",14548,36877.08,31065,"Juiz de Fora",3,"Sudeste",1,"314080",2,9,2,7,5,4,0,0,0,0,0,9,2,7,5,4,7,10.515345498831,9.58520880610688,0.294215508023765,29
"7710","MG","Matias Barbosa",14548,36877.08,31065,"Juiz de Fora",3,"Sudeste",1,"314080",3,10,2,8,3,7,0,0,0,0,0,10,2,8,3,7,12,10.515345498831,9.58520880610688,0.392021846863653,31
"7711","MG","Matias Barbosa",14548,36877.08,31065,"Juiz de Fora",3,"Sudeste",1,"314080",4,8,3,5,3,5,0,0,0,0,0,8,3,5,3,5,13,10.515345498831,9.58520880610688,0.445660071816836,30
"7712","MG","Matias Barbosa",14548,36877.08,31065,"Juiz de Fora",3,"Sudeste",1,"314080",5,16,3,13,8,8,0,0,0,0,0,16,3,13,8,8,10,10.515345498831,9.58520880610688,0.411906014222268,31
"7713","MG","Matipó",19005,20179.73,31061,"Manhuaçu",3,"Sudeste",0,"314090",2,8,2,6,1,7,0,0,0,0,0,8,2,6,1,7,4,9.91243391423435,9.85245738142335,0.336023888305041,29
"7714","MG","Matipó",19005,20179.73,31061,"Manhuaçu",3,"Sudeste",0,"314090",3,15,7,8,9,6,0,0,0,0,0,15,7,8,9,6,7,9.91243391423435,9.85245738142335,0.407883938048469,31
"7715","MG","Matipó",19005,20179.73,31061,"Manhuaçu",3,"Sudeste",0,"314090",4,18,7,11,4,14,0,0,0,0,0,18,7,11,4,14,4,9.91243391423435,9.85245738142335,0.397833244357363,30
"7716","MG","Matipó",19005,20179.73,31061,"Manhuaçu",3,"Sudeste",0,"314090",5,17,6,11,10,7,0,0,0,0,0,17,6,11,10,7,4,9.91243391423435,9.85245738142335,0.385631392873994,31
"7717","MG","Mato Verde",12412,10009.34,31004,"Janaúba",3,"Sudeste",0,"314100",2,5,1,4,3,2,0,0,0,0,0,5,1,4,3,2,6,9.21127393606959,9.42641902556827,0.26049391355246,29
"7718","MG","Mato Verde",12412,10009.34,31004,"Janaúba",3,"Sudeste",0,"314100",3,11,1,10,3,8,0,0,0,0,0,11,1,10,3,8,8,9.21127393606959,9.42641902556827,0.344181233697509,31
"7719","MG","Mato Verde",12412,10009.34,31004,"Janaúba",3,"Sudeste",0,"314100",4,9,1,8,5,4,0,0,0,0,0,9,1,8,5,4,6,9.21127393606959,9.42641902556827,0.333784777068204,30
"7720","MG","Mato Verde",12412,10009.34,31004,"Janaúba",3,"Sudeste",0,"314100",5,7,1,6,2,5,0,0,0,0,0,7,1,6,2,5,7,9.21127393606959,9.42641902556827,0.343849190310605,31
"7721","MG","Matozinhos",38151,27209.92,31027,"Sete Lagoas",3,"Sudeste",1,"314110",2,38,6,32,13,25,1,1,0,1,0,39,7,32,14,25,13,10.2113368916774,10.5493072486889,0.298342935245915,29
"7722","MG","Matozinhos",38151,27209.92,31027,"Sete Lagoas",3,"Sudeste",1,"314110",3,32,4,28,7,25,2,1,1,2,0,34,5,29,9,25,22,10.2113368916774,10.5493072486889,0.36821293599492,31
"7723","MG","Matozinhos",38151,27209.92,31027,"Sete Lagoas",3,"Sudeste",1,"314110",4,35,2,33,15,20,0,0,0,0,0,35,2,33,15,20,14,10.2113368916774,10.5493072486889,0.404576419280234,30
"7724","MG","Matozinhos",38151,27209.92,31027,"Sete Lagoas",3,"Sudeste",1,"314110",5,40,2,38,17,23,0,0,0,0,0,40,2,38,17,23,28,10.2113368916774,10.5493072486889,0.373686913947956,31
"7725","MG","Medina",20759,10135.73,31013,"Pedra Azul",3,"Sudeste",0,"314140",2,15,5,10,10,5,0,0,0,0,0,15,5,10,10,5,11,9.22382208391927,9.94073516656279,0.27683515298267,29
"7726","MG","Medina",20759,10135.73,31013,"Pedra Azul",3,"Sudeste",0,"314140",3,14,2,12,5,9,0,0,0,0,0,14,2,12,5,9,8,9.22382208391927,9.94073516656279,0.376894030460847,31
"7727","MG","Medina",20759,10135.73,31013,"Pedra Azul",3,"Sudeste",0,"314140",4,24,11,13,9,15,0,0,0,0,0,24,11,13,9,15,11,9.22382208391927,9.94073516656279,0.391658679165871,30
"7728","MG","Medina",20759,10135.73,31013,"Pedra Azul",3,"Sudeste",0,"314140",5,29,7,22,16,13,0,0,0,0,0,29,7,22,16,13,6,9.22382208391927,9.94073516656279,0.405723028735263,31
"7729","MG","Mercês",10758,11118.41,31064,"Ubá",3,"Sudeste",0,"314160",2,5,1,4,3,2,0,0,0,0,0,5,1,4,3,2,7,9.31635757196964,9.28340494283319,0.291783464836505,29
"7730","MG","Mercês",10758,11118.41,31064,"Ubá",3,"Sudeste",0,"314160",3,6,2,4,1,5,0,0,0,0,0,6,2,4,1,5,10,9.31635757196964,9.28340494283319,0.382481000016714,31
"7731","MG","Mercês",10758,11118.41,31064,"Ubá",3,"Sudeste",0,"314160",4,10,2,8,3,7,0,0,0,0,0,10,2,8,3,7,9,9.31635757196964,9.28340494283319,0.44813613546752,30
"7732","MG","Mercês",10758,11118.41,31064,"Ubá",3,"Sudeste",0,"314160",5,7,3,4,3,4,0,0,0,0,0,7,3,4,3,4,6,9.31635757196964,9.28340494283319,0.424361726716454,31
"7733","MG","Minas Novas",31497,9476.24,31011,"Capelinha",3,"Sudeste",0,"314180",2,15,2,13,6,9,0,0,0,0,0,15,2,13,6,9,9,9.1565428921002,10.3576475821831,0.302726437525104,29
"7734","MG","Minas Novas",31497,9476.24,31011,"Capelinha",3,"Sudeste",0,"314180",3,30,9,21,8,22,0,0,0,0,0,30,9,21,8,22,8,9.1565428921002,10.3576475821831,0.416124348299575,31
"7735","MG","Minas Novas",31497,9476.24,31011,"Capelinha",3,"Sudeste",0,"314180",4,20,3,17,4,16,0,0,0,0,0,20,3,17,4,16,7,9.1565428921002,10.3576475821831,0.41304618179703,30
"7736","MG","Minas Novas",31497,9476.24,31011,"Capelinha",3,"Sudeste",0,"314180",5,19,2,17,9,10,0,0,0,0,0,19,2,17,9,10,11,9.1565428921002,10.3576475821831,0.390405056372823,31
"7737","MG","Mirabela",13620,9323.97,31007,"Montes Claros",3,"Sudeste",0,"314200",2,17,3,14,4,13,0,0,0,0,0,17,3,14,4,13,5,9.14034378264725,9.5192945797035,0.283680306099064,29
"7738","MG","Mirabela",13620,9323.97,31007,"Montes Claros",3,"Sudeste",0,"314200",3,12,4,8,7,5,0,0,0,0,0,12,4,8,7,5,8,9.14034378264725,9.5192945797035,0.343331604112599,31
"7739","MG","Mirabela",13620,9323.97,31007,"Montes Claros",3,"Sudeste",0,"314200",4,15,2,13,5,10,0,0,0,0,0,15,2,13,5,10,9,9.14034378264725,9.5192945797035,0.352366556745173,30
"7740","MG","Mirabela",13620,9323.97,31007,"Montes Claros",3,"Sudeste",0,"314200",5,13,2,11,7,6,0,0,0,0,0,13,2,11,7,6,8,9.14034378264725,9.5192945797035,0.378677610617301,31
"7741","MG","Miraí",15111,16974.53,31063,"Muriaé",3,"Sudeste",0,"314220",2,6,2,4,1,5,0,0,0,0,0,6,2,4,1,5,9,9.73946926426744,9.62317823441376,0.318205143218585,29
"7742","MG","Miraí",15111,16974.53,31063,"Muriaé",3,"Sudeste",0,"314220",3,1,1,0,1,0,0,0,0,0,0,1,1,0,1,0,8,9.73946926426744,9.62317823441376,0.379914944132261,31
"7743","MG","Miraí",15111,16974.53,31063,"Muriaé",3,"Sudeste",0,"314220",4,2,1,1,1,1,0,0,0,0,0,2,1,1,1,1,13,9.73946926426744,9.62317823441376,0.458311984024367,30
"7744","MG","Miraí",15111,16974.53,31063,"Muriaé",3,"Sudeste",0,"314220",5,4,2,2,1,3,0,0,0,0,0,4,2,2,1,3,8,9.73946926426744,9.62317823441376,0.429387608241612,31
"7745","MG","Moema",7554,15042.17,31026,"Bom Despacho",3,"Sudeste",0,"314240",2,7,2,5,2,5,0,0,0,0,0,7,2,5,2,5,7,9.61861286901109,8.9298325032724,0.330238173838421,29
"7746","MG","Moema",7554,15042.17,31026,"Bom Despacho",3,"Sudeste",0,"314240",3,9,1,8,1,8,0,0,0,0,0,9,1,8,1,8,3,9.61861286901109,8.9298325032724,0.394255375679089,31
"7747","MG","Moema",7554,15042.17,31026,"Bom Despacho",3,"Sudeste",0,"314240",4,3,0,3,0,3,0,0,0,0,0,3,0,3,0,3,2,9.61861286901109,8.9298325032724,0.375438880579838,30
"7748","MG","Moema",7554,15042.17,31026,"Bom Despacho",3,"Sudeste",0,"314240",5,7,1,6,3,4,0,0,0,0,0,7,1,6,3,4,8,9.61861286901109,8.9298325032724,0.346639178364251,31
"7749","MG","Monsenhor Paulo",8727,20368.08,31050,"Varginha",3,"Sudeste",0,"314260",2,3,1,2,0,3,0,0,0,0,0,3,1,2,0,3,4,9.92172424851925,9.07417694716331,0.342239051204838,29
"7750","MG","Monsenhor Paulo",8727,20368.08,31050,"Varginha",3,"Sudeste",0,"314260",3,0,0,0,0,0,0,0,0,0,0,0,0,0,0,0,9,9.92172424851925,9.07417694716331,0.424021135851078,31
"7751","MG","Monsenhor Paulo",8727,20368.08,31050,"Varginha",3,"Sudeste",0,"314260",4,1,0,1,0,1,0,0,0,0,0,1,0,1,0,1,1,9.92172424851925,9.07417694716331,0.469092477112994,30
"7752","MG","Monsenhor Paulo",8727,20368.08,31050,"Varginha",3,"Sudeste",0,"314260",5,5,2,3,2,3,0,0,0,0,0,5,2,3,2,3,4,9.92172424851925,9.07417694716331,0.443743206155192,31
"7753","MG","Montalvânia",14747,8741.65,31003,"Januária",3,"Sudeste",0,"314270",2,14,6,8,7,7,0,0,0,0,0,14,6,8,7,7,6,9.07585423801688,9.59879495125094,0.291182789292959,29
"7754","MG","Montalvânia",14747,8741.65,31003,"Januária",3,"Sudeste",0,"314270",3,15,5,10,5,10,0,0,0,0,0,15,5,10,5,10,6,9.07585423801688,9.59879495125094,0.393743104623151,31
"7755","MG","Montalvânia",14747,8741.65,31003,"Januária",3,"Sudeste",0,"314270",4,10,6,4,4,6,0,0,0,0,0,10,6,4,4,6,7,9.07585423801688,9.59879495125094,0.402760187128799,30
"7756","MG","Montalvânia",14747,8741.65,31003,"Januária",3,"Sudeste",0,"314270",5,9,3,6,3,6,0,0,0,0,0,9,3,6,3,6,9,9.07585423801688,9.59879495125094,0.392825580999506,31
"7757","MG","Monte Alegre de Minas",21236,25230.22,31018,"Uberlândia",3,"Sudeste",0,"314280",2,17,6,11,8,9,0,0,0,0,0,17,6,11,8,9,9,10.1357977613751,9.96345313370356,0.283908432257121,29
"7758","MG","Monte Alegre de Minas",21236,25230.22,31018,"Uberlândia",3,"Sudeste",0,"314280",3,13,4,9,7,6,1,0,1,0,1,14,4,10,7,7,12,10.1357977613751,9.96345313370356,0.35759592642594,31
"7759","MG","Monte Alegre de Minas",21236,25230.22,31018,"Uberlândia",3,"Sudeste",0,"314280",4,14,1,13,6,8,0,0,0,0,0,14,1,13,6,8,13,10.1357977613751,9.96345313370356,0.374636164951679,30
"7760","MG","Monte Alegre de Minas",21236,25230.22,31018,"Uberlândia",3,"Sudeste",0,"314280",5,24,6,18,11,13,0,0,0,0,0,24,6,18,11,13,14,10.1357977613751,9.96345313370356,0.369181286528712,31
"7761","MG","Monte Azul",20696,9231.8,31004,"Janaúba",3,"Sudeste",0,"314290",2,25,7,18,6,19,0,0,0,0,0,25,7,18,6,19,4,9.13040932473506,9.93769572386586,0.269593856489717,29
"7762","MG","Monte Azul",20696,9231.8,31004,"Janaúba",3,"Sudeste",0,"314290",3,15,1,14,8,7,0,0,0,0,0,15,1,14,8,7,17,9.13040932473506,9.93769572386586,0.380472924120353,31
"7763","MG","Monte Azul",20696,9231.8,31004,"Janaúba",3,"Sudeste",0,"314290",4,11,0,11,4,7,0,0,0,0,0,11,0,11,4,7,16,9.13040932473506,9.93769572386586,0.406000811059664,30
"7764","MG","Monte Azul",20696,9231.8,31004,"Janaúba",3,"Sudeste",0,"314290",5,16,3,13,6,10,0,0,0,0,0,16,3,13,6,10,18,9.13040932473506,9.93769572386586,0.389303181800709,31
"7765","MG","Monte Belo",13152,19976.02,31048,"São Sebastião do Paraíso",3,"Sudeste",0,"314300",2,6,2,4,1,5,0,0,0,0,0,6,2,4,1,5,6,9.90228783316055,9.48432911729596,0.318244150170899,29
"7766","MG","Monte Belo",13152,19976.02,31048,"São Sebastião do Paraíso",3,"Sudeste",0,"314300",3,6,1,5,2,4,0,0,0,0,0,6,1,5,2,4,10,9.90228783316055,9.48432911729596,0.373408712399067,31
"7767","MG","Monte Belo",13152,19976.02,31048,"São Sebastião do Paraíso",3,"Sudeste",0,"314300",4,9,4,5,3,6,0,0,0,0,0,9,4,5,3,6,5,9.90228783316055,9.48432911729596,0.406765144613585,30
"7768","MG","Monte Belo",13152,19976.02,31048,"São Sebastião do Paraíso",3,"Sudeste",0,"314300",5,8,3,5,5,3,0,0,0,0,0,8,3,5,5,3,6,9.90228783316055,9.48432911729596,0.396977758384824,31
"7769","MG","Monte Carmelo",47931,23654.49,31019,"Patrocínio",3,"Sudeste",1,"314310",2,35,12,23,13,22,0,0,0,0,0,35,12,23,13,22,27,10.0713082279089,10.7775177556957,0.3102542421209,29
"7770","MG","Monte Carmelo",47931,23654.49,31019,"Patrocínio",3,"Sudeste",1,"314310",3,28,6,22,8,20,0,0,0,0,0,28,6,22,8,20,24,10.0713082279089,10.7775177556957,0.391055981457105,31
"7771","MG","Monte Carmelo",47931,23654.49,31019,"Patrocínio",3,"Sudeste",1,"314310",4,31,6,25,13,18,0,0,0,0,0,31,6,25,13,18,19,10.0713082279089,10.7775177556957,0.40279882685358,30
"7772","MG","Monte Carmelo",47931,23654.49,31019,"Patrocínio",3,"Sudeste",1,"314310",5,48,10,38,15,33,0,0,0,0,0,48,10,38,15,33,18,10.0713082279089,10.7775177556957,0.368823580875256,31
"7773","MG","Monte Santo de Minas",21513,18777.47,31048,"São Sebastião do Paraíso",3,"Sudeste",0,"314320",2,14,5,9,2,12,0,0,0,0,0,14,5,9,2,12,14,9.84041302590212,9.97641268255068,0.330255552942251,29
"7774","MG","Monte Santo de Minas",21513,18777.47,31048,"São Sebastião do Paraíso",3,"Sudeste",0,"314320",3,15,5,10,7,8,0,0,0,0,0,15,5,10,7,8,14,9.84041302590212,9.97641268255068,0.396389888295644,31
"7775","MG","Monte Santo de Minas",21513,18777.47,31048,"São Sebastião do Paraíso",3,"Sudeste",0,"314320",4,18,6,12,10,8,0,0,0,0,0,18,6,12,10,8,10,9.84041302590212,9.97641268255068,0.426239302336822,30
"7776","MG","Monte Santo de Minas",21513,18777.47,31048,"São Sebastião do Paraíso",3,"Sudeste",0,"314320",5,16,4,12,4,12,0,0,0,0,0,16,4,12,4,12,14,9.84041302590212,9.97641268255068,0.401075500822851,31
"7777","MG","Montes Claros",413487,23323.68,31007,"Montes Claros",3,"Sudeste",1,"314330",2,469,59,410,147,322,7,4,3,2,5,476,63,413,149,327,174,10.0572244324743,12.9323813540158,0.280954867835498,29
"7778","MG","Montes Claros",413487,23323.68,31007,"Montes Claros",3,"Sudeste",1,"314330",3,454,55,399,131,323,9,0,9,4,5,463,55,408,135,328,197,10.0572244324743,12.9323813540158,0.381990509714489,31
"7779","MG","Montes Claros",413487,23323.68,31007,"Montes Claros",3,"Sudeste",1,"314330",4,478,71,407,139,339,6,1,5,2,4,484,72,412,141,343,155,10.0572244324743,12.9323813540158,0.434563096647363,30
"7780","MG","Montes Claros",413487,23323.68,31007,"Montes Claros",3,"Sudeste",1,"314330",5,513,65,448,167,346,7,2,5,2,5,520,67,453,169,351,182,10.0572244324743,12.9323813540158,0.387281001010994,31
"7781","MG","Monte Sião",24029,17446.69,31051,"Poços de Caldas",3,"Sudeste",0,"314340",2,13,8,5,6,7,0,0,0,0,0,13,8,5,6,7,4,9.76690522482438,10.0870167132162,0.306958163705994,29
"7782","MG","Monte Sião",24029,17446.69,31051,"Poços de Caldas",3,"Sudeste",0,"314340",3,16,6,10,9,7,0,0,0,0,0,16,6,10,9,7,10,9.76690522482438,10.0870167132162,0.406267517633068,31
"7783","MG","Monte Sião",24029,17446.69,31051,"Poços de Caldas",3,"Sudeste",0,"314340",4,12,5,7,2,10,0,0,0,0,0,12,5,7,2,10,14,9.76690522482438,10.0870167132162,0.41140829691598,30
"7784","MG","Monte Sião",24029,17446.69,31051,"Poços de Caldas",3,"Sudeste",0,"314340",5,14,5,9,1,13,1,0,1,0,1,15,5,10,1,14,11,9.76690522482438,10.0870167132162,0.386740241198099,31
"7785","MG","Morada Nova de Minas",8910,35287.53,31024,"Três Marias",3,"Sudeste",0,"314350",2,5,0,5,2,3,0,0,0,0,0,5,0,5,2,3,2,10.4712849227208,9.09492952046486,0.329243404724126,29
"7786","MG","Morada Nova de Minas",8910,35287.53,31024,"Três Marias",3,"Sudeste",0,"314350",3,4,1,3,0,4,0,0,0,0,0,4,1,3,0,4,4,10.4712849227208,9.09492952046486,0.388996789925967,31
"7787","MG","Morada Nova de Minas",8910,35287.53,31024,"Três Marias",3,"Sudeste",0,"314350",4,3,0,3,1,2,0,0,0,0,0,3,0,3,1,2,2,10.4712849227208,9.09492952046486,0.415689773694552,30
"7788","MG","Morada Nova de Minas",8910,35287.53,31024,"Três Marias",3,"Sudeste",0,"314350",5,3,1,2,1,2,0,0,0,0,0,3,1,2,1,2,3,10.4712849227208,9.09492952046486,0.392163145647624,31
"7789","MG","Muriaé",109392,19884.4,31063,"Muriaé",3,"Sudeste",1,"314390",2,71,21,50,26,45,0,0,0,0,0,71,21,50,26,45,59,9.89769078368895,11.6026930401536,0.32218484293809,29
"7790","MG","Muriaé",109392,19884.4,31063,"Muriaé",3,"Sudeste",1,"314390",3,87,18,69,20,67,0,0,0,0,0,87,18,69,20,67,73,9.89769078368895,11.6026930401536,0.407156023164727,31
"7791","MG","Muriaé",109392,19884.4,31063,"Muriaé",3,"Sudeste",1,"314390",4,75,24,51,34,41,2,0,2,0,2,77,24,53,34,43,55,9.89769078368895,11.6026930401536,0.466656841118984,30
"7792","MG","Muriaé",109392,19884.4,31063,"Muriaé",3,"Sudeste",1,"314390",5,110,21,89,43,67,1,0,1,1,0,111,21,90,44,67,69,9.89769078368895,11.6026930401536,0.42734494216929,31
"7793","MG","Mutum",26961,14005.07,31041,"Aimorés",3,"Sudeste",0,"314400",2,24,8,16,9,15,1,0,1,0,1,25,8,17,9,16,20,9.54717468589664,10.2021466563265,0.325485969524746,29
"7794","MG","Mutum",26961,14005.07,31041,"Aimorés",3,"Sudeste",0,"314400",3,30,15,15,11,19,0,0,0,0,0,30,15,15,11,19,17,9.54717468589664,10.2021466563265,0.407326431962986,31
"7795","MG","Mutum",26961,14005.07,31041,"Aimorés",3,"Sudeste",0,"314400",4,31,8,23,8,23,0,0,0,0,0,31,8,23,8,23,11,9.54717468589664,10.2021466563265,0.40855719330274,30
"7796","MG","Mutum",26961,14005.07,31041,"Aimorés",3,"Sudeste",0,"314400",5,23,5,18,3,20,0,0,0,0,0,23,5,18,3,20,13,9.54717468589664,10.2021466563265,0.414548736192762,31
"7797","MG","Muzambinho",20545,18968.57,31048,"São Sebastião do Paraíso",3,"Sudeste",1,"314410",2,24,7,17,3,21,0,0,0,0,0,24,7,17,3,21,13,9.85053867790529,9.93037288131751,0.30049227283695,29
"7798","MG","Muzambinho",20545,18968.57,31048,"São Sebastião do Paraíso",3,"Sudeste",1,"314410",3,14,5,9,3,11,0,0,0,0,0,14,5,9,3,11,14,9.85053867790529,9.93037288131751,0.381446850001135,31
"7799","MG","Muzambinho",20545,18968.57,31048,"São Sebastião do Paraíso",3,"Sudeste",1,"314410",4,15,5,10,5,10,0,0,0,0,0,15,5,10,5,10,12,9.85053867790529,9.93037288131751,0.443551183897595,30
"7800","MG","Muzambinho",20545,18968.57,31048,"São Sebastião do Paraíso",3,"Sudeste",1,"314410",5,16,2,14,9,7,0,0,0,0,0,16,2,14,9,7,13,9.85053867790529,9.93037288131751,0.382036802705072,31
"7801","MG","Nanuque",40665,17319.35,31016,"Nanuque",3,"Sudeste",1,"314430",2,22,8,14,9,13,0,0,0,0,0,22,8,14,9,13,26,9.75957965254384,10.6131230506009,0.306175400931003,29
"7802","MG","Nanuque",40665,17319.35,31016,"Nanuque",3,"Sudeste",1,"314430",3,21,4,17,8,13,1,1,0,1,0,22,5,17,9,13,36,9.75957965254384,10.6131230506009,0.401448394311159,31
"7803","MG","Nanuque",40665,17319.35,31016,"Nanuque",3,"Sudeste",1,"314430",4,25,4,21,11,14,0,0,0,0,0,25,4,21,11,14,28,9.75957965254384,10.6131230506009,0.419414419605941,30
"7804","MG","Nanuque",40665,17319.35,31016,"Nanuque",3,"Sudeste",1,"314430",5,39,8,31,20,19,0,0,0,0,0,39,8,31,20,19,29,9.75957965254384,10.6131230506009,0.391838805998208,31
"7805","MG","Naque",7051,10708.92,31039,"Ipatinga",3,"Sudeste",1,"314435",2,10,2,8,4,6,0,0,0,0,0,10,2,8,4,6,4,9.27883231802093,8.86092472971904,0.355086998230782,29
"7806","MG","Naque",7051,10708.92,31039,"Ipatinga",3,"Sudeste",1,"314435",3,8,1,7,5,3,0,0,0,0,0,8,1,7,5,3,2,9.27883231802093,8.86092472971904,0.418971603716104,31
"7807","MG","Naque",7051,10708.92,31039,"Ipatinga",3,"Sudeste",1,"314435",4,18,2,16,7,11,1,0,1,1,0,19,2,17,8,11,3,9.27883231802093,8.86092472971904,0.432383334507341,30
"7808","MG","Naque",7051,10708.92,31039,"Ipatinga",3,"Sudeste",1,"314435",5,9,2,7,3,6,0,0,0,0,0,9,2,7,3,6,1,9.27883231802093,8.86092472971904,0.394967089986178,31
"7809","MG","Nepomuceno",26826,17122.86,31057,"Lavras",3,"Sudeste",0,"314460",2,20,9,11,5,15,1,0,1,0,1,21,9,12,5,16,12,9.74816969181819,10.197126845462,0.277098341333535,29
"7810","MG","Nepomuceno",26826,17122.86,31057,"Lavras",3,"Sudeste",0,"314460",3,13,7,6,7,6,0,0,0,0,0,13,7,6,7,6,12,9.74816969181819,10.197126845462,0.350295233465786,31
"7811","MG","Nepomuceno",26826,17122.86,31057,"Lavras",3,"Sudeste",0,"314460",4,17,5,12,9,8,0,0,0,0,0,17,5,12,9,8,13,9.74816969181819,10.197126845462,0.401434247254274,30
"7812","MG","Nepomuceno",26826,17122.86,31057,"Lavras",3,"Sudeste",0,"314460",5,28,11,17,15,13,0,0,0,0,0,28,11,17,15,13,14,9.74816969181819,10.197126845462,0.36693721329036,31
"7813","MG","Nova Era",17551,19564.84,31031,"Itabira",3,"Sudeste",0,"314470",2,14,2,12,4,10,0,0,0,0,0,14,2,12,4,10,12,9.88148935674243,9.77286620732769,0.328897400978817,29
"7814","MG","Nova Era",17551,19564.84,31031,"Itabira",3,"Sudeste",0,"314470",3,6,1,5,1,5,0,0,0,0,0,6,1,5,1,5,11,9.88148935674243,9.77286620732769,0.442193991713601,31
"7815","MG","Nova Era",17551,19564.84,31031,"Itabira",3,"Sudeste",0,"314470",4,11,3,8,0,11,1,0,1,0,1,12,3,9,0,12,6,9.88148935674243,9.77286620732769,0.474465882213947,30
"7816","MG","Nova Era",17551,19564.84,31031,"Itabira",3,"Sudeste",0,"314470",5,9,1,8,5,4,0,0,0,0,0,9,1,8,5,4,8,9.88148935674243,9.77286620732769,0.420869532486839,31
"7817","MG","Nova Lima",96157,111562.61,31030,"Belo Horizonte",3,"Sudeste",1,"314480",2,97,8,89,19,78,1,0,1,0,1,98,8,90,19,79,58,11.62234123695,11.473737551279,0.290188276433893,29
"7818","MG","Nova Lima",96157,111562.61,31030,"Belo Horizonte",3,"Sudeste",1,"314480",3,113,8,105,30,83,1,0,1,0,1,114,8,106,30,84,63,11.62234123695,11.473737551279,0.394559949060379,31
"7819","MG","Nova Lima",96157,111562.61,31030,"Belo Horizonte",3,"Sudeste",1,"314480",4,98,6,92,24,74,1,0,1,1,0,99,6,93,25,74,46,11.62234123695,11.473737551279,0.451251816999746,30
"7820","MG","Nova Lima",96157,111562.61,31030,"Belo Horizonte",3,"Sudeste",1,"314480",5,101,6,95,26,75,0,0,0,0,0,101,6,95,26,75,31,11.62234123695,11.473737551279,0.41177807789972,31
"7821","MG","Nova Ponte",15800,74620.35,31023,"Araxá",3,"Sudeste",0,"314500",2,19,6,13,8,11,0,0,0,0,0,19,6,13,8,11,5,11.2201685371957,9.66776521901506,0.325656845804656,29
"7822","MG","Nova Ponte",15800,74620.35,31023,"Araxá",3,"Sudeste",0,"314500",3,11,1,10,4,7,0,0,0,0,0,11,1,10,4,7,7,11.2201685371957,9.66776521901506,0.407368817599668,31
"7823","MG","Nova Ponte",15800,74620.35,31023,"Araxá",3,"Sudeste",0,"314500",4,9,0,9,3,6,1,0,1,1,0,10,0,10,4,6,7,11.2201685371957,9.66776521901506,0.402692883806458,30
"7824","MG","Nova Ponte",15800,74620.35,31023,"Araxá",3,"Sudeste",0,"314500",5,15,4,11,8,7,0,0,0,0,0,15,4,11,8,7,4,11.2201685371957,9.66776521901506,0.390062377509877,31
"7825","MG","Nova Porteirinha",7497,14062.63,31004,"Janaúba",3,"Sudeste",1,"314505",2,5,1,4,1,4,0,0,0,0,0,5,1,4,1,4,4,9.55127620334849,8.92225821950306,0.320957746279583,29
"7826","MG","Nova Porteirinha",7497,14062.63,31004,"Janaúba",3,"Sudeste",1,"314505",3,8,3,5,1,7,0,0,0,0,0,8,3,5,1,7,3,9.55127620334849,8.92225821950306,0.382213194390193,31
"7827","MG","Nova Porteirinha",7497,14062.63,31004,"Janaúba",3,"Sudeste",1,"314505",4,11,0,11,6,5,0,0,0,0,0,11,0,11,6,5,4,9.55127620334849,8.92225821950306,0.406483225582353,30
"7828","MG","Nova Porteirinha",7497,14062.63,31004,"Janaúba",3,"Sudeste",1,"314505",5,9,2,7,3,6,0,0,0,0,0,9,2,7,3,6,3,9.55127620334849,8.92225821950306,0.40510221205224,31
"7829","MG","Nova Resende",16832,16557.89,31048,"São Sebastião do Paraíso",3,"Sudeste",0,"314510",2,19,5,14,9,10,0,0,0,0,0,19,5,14,9,10,6,9.71461800436227,9.73103711553744,0.312900048321868,29
"7830","MG","Nova Resende",16832,16557.89,31048,"São Sebastião do Paraíso",3,"Sudeste",0,"314510",3,17,5,12,9,8,0,0,0,0,0,17,5,12,9,8,8,9.71461800436227,9.73103711553744,0.383399725670015,31
"7831","MG","Nova Resende",16832,16557.89,31048,"São Sebastião do Paraíso",3,"Sudeste",0,"314510",4,12,4,8,6,6,0,0,0,0,0,12,4,8,6,6,11,9.71461800436227,9.73103711553744,0.402731016918916,30
"7832","MG","Nova Resende",16832,16557.89,31048,"São Sebastião do Paraíso",3,"Sudeste",0,"314510",5,14,4,10,7,7,0,0,0,0,0,14,4,10,7,7,3,9.71461800436227,9.73103711553744,0.420641548355799,31
"7833","MG","Nova Serrana",105520,23734.99,31043,"Divinópolis",3,"Sudeste",1,"314520",2,137,30,107,52,85,4,2,2,0,4,141,32,109,52,89,30,10.0747056096666,11.5666557873912,0.314899244794985,29
"7834","MG","Nova Serrana",105520,23734.99,31043,"Divinópolis",3,"Sudeste",1,"314520",3,123,37,86,48,75,2,2,0,2,0,125,39,86,50,75,30,10.0747056096666,11.5666557873912,0.418255139327568,31
"7835","MG","Nova Serrana",105520,23734.99,31043,"Divinópolis",3,"Sudeste",1,"314520",4,129,32,97,52,77,1,1,0,1,0,130,33,97,53,77,28,10.0747056096666,11.5666557873912,0.457247963997685,30
"7836","MG","Nova Serrana",105520,23734.99,31043,"Divinópolis",3,"Sudeste",1,"314520",5,145,43,102,56,89,0,0,0,0,0,145,43,102,56,89,23,10.0747056096666,11.5666557873912,0.406573908237531,31
"7837","MG","Novo Cruzeiro",31335,7531.17,31012,"Araçuaí",3,"Sudeste",0,"314530",2,33,15,18,12,21,0,0,0,0,0,33,15,18,12,21,21,8.92680568721001,10.3524909626588,0.267805274370122,29
"7838","MG","Novo Cruzeiro",31335,7531.17,31012,"Araçuaí",3,"Sudeste",0,"314530",3,28,11,17,7,21,0,0,0,0,0,28,11,17,7,21,19,8.92680568721001,10.3524909626588,0.332406730760719,31
"7839","MG","Novo Cruzeiro",31335,7531.17,31012,"Araçuaí",3,"Sudeste",0,"314530",4,32,9,23,12,20,0,0,0,0,0,32,9,23,12,20,18,8.92680568721001,10.3524909626588,0.385915624579661,30
"7840","MG","Novo Cruzeiro",31335,7531.17,31012,"Araçuaí",3,"Sudeste",0,"314530",5,30,12,18,8,22,1,0,1,1,0,31,12,19,9,22,19,8.92680568721001,10.3524909626588,0.394885886416867,31
"7841","MG","Oliveira",41840,20643.57,31046,"Oliveira",3,"Sudeste",1,"314560",2,30,5,25,9,21,0,0,0,0,0,30,5,25,9,21,25,9.93515916975504,10.6416080987388,0.280070518666934,29
"7842","MG","Oliveira",41840,20643.57,31046,"Oliveira",3,"Sudeste",1,"314560",3,46,7,39,20,26,0,0,0,0,0,46,7,39,20,26,28,9.93515916975504,10.6416080987388,0.354601954018241,31
"7843","MG","Oliveira",41840,20643.57,31046,"Oliveira",3,"Sudeste",1,"314560",4,26,5,21,3,23,0,0,0,0,0,26,5,21,3,23,33,9.93515916975504,10.6416080987388,0.38515074523007,30
"7844","MG","Oliveira",41840,20643.57,31046,"Oliveira",3,"Sudeste",1,"314560",5,33,7,26,11,22,1,0,1,0,1,34,7,27,11,23,22,9.93515916975504,10.6416080987388,0.347726588739832,31
"7845","MG","Ouro Branco",39867,104169.26,31034,"Conselheiro Lafaiete",3,"Sudeste",1,"314590",2,32,6,26,11,21,0,0,0,0,0,32,6,26,11,21,23,11.5537723551806,10.5933041929996,0.293532178695458,29
"7846","MG","Ouro Branco",39867,104169.26,31034,"Conselheiro Lafaiete",3,"Sudeste",1,"314590",3,43,7,36,7,36,0,0,0,0,0,43,7,36,7,36,19,11.5537723551806,10.5933041929996,0.397633565527846,31
"7847","MG","Ouro Branco",39867,104169.26,31034,"Conselheiro Lafaiete",3,"Sudeste",1,"314590",4,31,5,26,8,23,0,0,0,0,0,31,5,26,8,23,22,11.5537723551806,10.5933041929996,0.472961239841497,30
"7848","MG","Ouro Branco",39867,104169.26,31034,"Conselheiro Lafaiete",3,"Sudeste",1,"314590",5,40,9,31,12,28,0,0,0,0,0,40,9,31,12,28,11,11.5537723551806,10.5933041929996,0.427322569929311,31
"7849","MG","Ouro Fino",33791,21284.3,31051,"Poços de Caldas",3,"Sudeste",0,"314600",2,12,2,10,5,7,0,0,0,0,0,12,2,10,5,7,20,9.96572499071183,10.427949773825,0.308115157147521,29
"7850","MG","Ouro Fino",33791,21284.3,31051,"Poços de Caldas",3,"Sudeste",0,"314600",3,28,6,22,12,16,0,0,0,0,0,28,6,22,12,16,29,9.96572499071183,10.427949773825,0.392052961046931,31
"7851","MG","Ouro Fino",33791,21284.3,31051,"Poços de Caldas",3,"Sudeste",0,"314600",4,25,8,17,14,11,0,0,0,0,0,25,8,17,14,11,16,9.96572499071183,10.427949773825,0.440481565721464,30
"7852","MG","Ouro Fino",33791,21284.3,31051,"Poços de Caldas",3,"Sudeste",0,"314600",5,24,5,19,8,16,0,0,0,0,0,24,5,19,8,16,18,9.96572499071183,10.427949773825,0.399075088488782,31
"7853","MG","Ouro Preto",74558,92319.75,31033,"Ouro Preto",3,"Sudeste",1,"314610",2,52,12,40,13,39,0,0,0,0,0,52,12,40,13,39,39,11.433013373766,11.2193326249654,0.319094901150322,29
"7854","MG","Ouro Preto",74558,92319.75,31033,"Ouro Preto",3,"Sudeste",1,"314610",3,35,6,29,13,22,0,0,0,0,0,35,6,29,13,22,38,11.433013373766,11.2193326249654,0.420626239594797,31
"7855","MG","Ouro Preto",74558,92319.75,31033,"Ouro Preto",3,"Sudeste",1,"314610",4,42,11,31,13,29,0,0,0,0,0,42,11,31,13,29,45,11.433013373766,11.2193326249654,0.485301399088356,30
"7856","MG","Ouro Preto",74558,92319.75,31033,"Ouro Preto",3,"Sudeste",1,"314610",5,58,11,47,11,47,1,1,0,0,1,59,12,47,11,48,53,11.433013373766,11.2193326249654,0.451113507325187,31
"7857","MG","Padre Paraíso",20252,8605.78,31012,"Araçuaí",3,"Sudeste",0,"314630",2,21,8,13,11,10,2,1,1,1,1,23,9,14,12,11,14,9.06018934951148,9.9160088330898,0.291922739195031,29
"7858","MG","Padre Paraíso",20252,8605.78,31012,"Araçuaí",3,"Sudeste",0,"314630",3,18,4,14,5,13,0,0,0,0,0,18,4,14,5,13,13,9.06018934951148,9.9160088330898,0.366308913609904,31
"7859","MG","Padre Paraíso",20252,8605.78,31012,"Araçuaí",3,"Sudeste",0,"314630",4,8,2,6,4,4,0,0,0,0,0,8,2,6,4,4,5,9.06018934951148,9.9160088330898,0.388873587936138,30
"7860","MG","Padre Paraíso",20252,8605.78,31012,"Araçuaí",3,"Sudeste",0,"314630",5,7,0,7,2,5,0,0,0,0,0,7,0,7,2,5,12,9.06018934951148,9.9160088330898,0.375475800109126,31
"7861","MG","Pains",8296,34678.55,31044,"Formiga",3,"Sudeste",0,"314650",2,7,1,6,2,5,0,0,0,0,0,7,1,6,2,5,4,10.4538766191784,9.02352874990936,0.32756459986873,29
"7862","MG","Pains",8296,34678.55,31044,"Formiga",3,"Sudeste",0,"314650",3,14,3,11,5,9,0,0,0,0,0,14,3,11,5,9,4,10.4538766191784,9.02352874990936,0.390042779072292,31
"7863","MG","Pains",8296,34678.55,31044,"Formiga",3,"Sudeste",0,"314650",4,10,2,8,3,7,1,1,0,0,1,11,3,8,3,8,3,10.4538766191784,9.02352874990936,0.430655423113053,30
"7864","MG","Pains",8296,34678.55,31044,"Formiga",3,"Sudeste",0,"314650",5,5,2,3,1,4,0,0,0,0,0,5,2,3,1,4,5,10.4538766191784,9.02352874990936,0.396090494086214,31
"7865","MG","Papagaios",15800,16687.48,31027,"Sete Lagoas",3,"Sudeste",1,"314690",2,15,4,11,11,4,0,0,0,0,0,15,4,11,11,4,8,9.72241401664001,9.66776521901506,0.299212893805719,29
"7866","MG","Papagaios",15800,16687.48,31027,"Sete Lagoas",3,"Sudeste",1,"314690",3,8,2,6,3,5,0,0,0,0,0,8,2,6,3,5,7,9.72241401664001,9.66776521901506,0.350774198493428,31
"7867","MG","Papagaios",15800,16687.48,31027,"Sete Lagoas",3,"Sudeste",1,"314690",4,3,1,2,1,2,0,0,0,0,0,3,1,2,1,2,3,9.72241401664001,9.66776521901506,0.36530493064168,30
"7868","MG","Papagaios",15800,16687.48,31027,"Sete Lagoas",3,"Sudeste",1,"314690",5,2,0,2,1,1,0,0,0,0,0,2,0,2,1,1,9,9.72241401664001,9.66776521901506,0.355447139102668,31
"7869","MG","Paracatu",93862,46629.49,31002,"Paracatu",3,"Sudeste",1,"314700",2,103,18,85,38,65,1,0,1,0,1,104,18,86,38,66,32,10.7499884525776,11.4495808974529,0.302424527648471,29
"7870","MG","Paracatu",93862,46629.49,31002,"Paracatu",3,"Sudeste",1,"314700",3,94,18,76,26,68,1,0,1,0,1,95,18,77,26,69,39,10.7499884525776,11.4495808974529,0.380861758594408,31
"7871","MG","Paracatu",93862,46629.49,31002,"Paracatu",3,"Sudeste",1,"314700",4,102,16,86,43,59,1,0,1,0,1,103,16,87,43,60,41,10.7499884525776,11.4495808974529,0.416036258659772,30
"7872","MG","Paracatu",93862,46629.49,31002,"Paracatu",3,"Sudeste",1,"314700",5,120,18,102,33,87,1,1,0,1,0,121,19,102,34,87,42,10.7499884525776,11.4495808974529,0.390586797407351,31
"7873","MG","Pará de Minas",94808,31080.7,31029,"Pará de Minas",3,"Sudeste",1,"314710",2,79,17,62,25,54,0,0,0,0,0,79,17,62,25,54,36,10.3443423267505,11.4596090728683,0.284019383700232,29
"7874","MG","Pará de Minas",94808,31080.7,31029,"Pará de Minas",3,"Sudeste",1,"314710",3,75,12,63,23,52,0,0,0,0,0,75,12,63,23,52,61,10.3443423267505,11.4596090728683,0.367830893882681,31
"7875","MG","Pará de Minas",94808,31080.7,31029,"Pará de Minas",3,"Sudeste",1,"314710",4,86,12,74,31,55,1,0,1,0,1,87,12,75,31,56,41,10.3443423267505,11.4596090728683,0.407908892904464,30
"7876","MG","Pará de Minas",94808,31080.7,31029,"Pará de Minas",3,"Sudeste",1,"314710",5,103,22,81,35,68,2,1,1,2,0,105,23,82,37,68,48,10.3443423267505,11.4596090728683,0.371866150262095,31
"7877","MG","Paraguaçu",21605,21912.21,31049,"Alfenas",3,"Sudeste",1,"314720",2,21,5,16,5,16,0,0,0,0,0,21,5,16,5,16,10,9.99479929468669,9.98068004836603,0.292527517712834,29
"7878","MG","Paraguaçu",21605,21912.21,31049,"Alfenas",3,"Sudeste",1,"314720",3,22,8,14,10,12,0,0,0,0,0,22,8,14,10,12,15,9.99479929468669,9.98068004836603,0.376269352435718,31
"7879","MG","Paraguaçu",21605,21912.21,31049,"Alfenas",3,"Sudeste",1,"314720",4,19,1,18,5,14,1,0,1,0,1,20,1,19,5,15,18,9.99479929468669,9.98068004836603,0.405648130062302,30
"7880","MG","Paraguaçu",21605,21912.21,31049,"Alfenas",3,"Sudeste",1,"314720",5,13,5,8,5,8,0,0,0,0,0,13,5,8,5,8,22,9.99479929468669,9.98068004836603,0.36188182942684,31
"7881","MG","Paraisópolis",21221,23421.67,31056,"Itajubá",3,"Sudeste",1,"314730",2,16,4,12,6,10,0,0,0,0,0,16,4,12,6,10,10,10.0614169411851,9.96274653641105,0.283009759596156,29
"7882","MG","Paraisópolis",21221,23421.67,31056,"Itajubá",3,"Sudeste",1,"314730",3,15,6,9,6,9,0,0,0,0,0,15,6,9,6,9,4,10.0614169411851,9.96274653641105,0.386205337880993,31
"7883","MG","Paraisópolis",21221,23421.67,31056,"Itajubá",3,"Sudeste",1,"314730",4,17,4,13,9,8,0,0,0,0,0,17,4,13,9,8,14,10.0614169411851,9.96274653641105,0.435062265139477,30
"7884","MG","Paraisópolis",21221,23421.67,31056,"Itajubá",3,"Sudeste",1,"314730",5,16,2,14,7,9,0,0,0,0,0,16,2,14,7,9,14,10.0614169411851,9.96274653641105,0.377824222136526,31
"7885","MG","Paraopeba",24700,30668.71,31027,"Sete Lagoas",3,"Sudeste",1,"314740",2,24,6,18,8,16,0,0,0,0,0,24,6,18,8,16,12,10.3309981955781,10.1145585226161,0.250843075574751,29
"7886","MG","Paraopeba",24700,30668.71,31027,"Sete Lagoas",3,"Sudeste",1,"314740",3,4,1,3,2,2,0,0,0,0,0,4,1,3,2,2,8,10.3309981955781,10.1145585226161,0.341572961315712,31
"7887","MG","Paraopeba",24700,30668.71,31027,"Sete Lagoas",3,"Sudeste",1,"314740",4,2,0,2,0,2,0,0,0,0,0,2,0,2,0,2,7,10.3309981955781,10.1145585226161,0.366462976370965,30
"7888","MG","Paraopeba",24700,30668.71,31027,"Sete Lagoas",3,"Sudeste",1,"314740",5,2,0,2,1,1,0,0,0,0,0,2,0,2,1,1,15,10.3309981955781,10.1145585226161,0.343750295793041,31
"7889","MG","Passa Quatro",16393,22847.44,31054,"São Lourenço",3,"Sudeste",0,"314760",2,14,4,10,5,9,0,0,0,0,0,14,4,10,5,9,7,10.036594355035,9.70460969342646,0.336471773982593,29
"7890","MG","Passa Quatro",16393,22847.44,31054,"São Lourenço",3,"Sudeste",0,"314760",3,14,4,10,6,8,0,0,0,0,0,14,4,10,6,8,13,10.036594355035,9.70460969342646,0.440072094307572,31
"7891","MG","Passa Quatro",16393,22847.44,31054,"São Lourenço",3,"Sudeste",0,"314760",4,18,4,14,7,11,0,0,0,0,0,18,4,14,7,11,4,10.036594355035,9.70460969342646,0.508007803038069,30
"7892","MG","Passa Quatro",16393,22847.44,31054,"São Lourenço",3,"Sudeste",0,"314760",5,5,1,4,3,2,0,0,0,0,0,5,1,4,3,2,10,10.036594355035,9.70460969342646,0.478780755471541,31
"7893","MG","Passa Tempo",8057,30063.78,31046,"Oliveira",3,"Sudeste",0,"314770",2,4,0,4,0,4,0,0,0,0,0,4,0,4,0,4,5,10.3110764039043,8.9942965577772,0.2862078124042,29
"7894","MG","Passa Tempo",8057,30063.78,31046,"Oliveira",3,"Sudeste",0,"314770",3,6,1,5,3,3,0,0,0,0,0,6,1,5,3,3,8,10.3110764039043,8.9942965577772,0.36467871012348,31
"7895","MG","Passa Tempo",8057,30063.78,31046,"Oliveira",3,"Sudeste",0,"314770",4,5,2,3,3,2,1,0,1,1,0,6,2,4,4,2,4,10.3110764039043,8.9942965577772,0.372122690158352,30
"7896","MG","Passa Tempo",8057,30063.78,31046,"Oliveira",3,"Sudeste",0,"314770",5,4,0,4,1,3,0,0,0,0,0,4,0,4,1,3,8,10.3110764039043,8.9942965577772,0.400970546284018,31
"7897","MG","Passos",115337,21745.94,31047,"Passos",3,"Sudeste",1,"314790",2,111,32,79,42,69,0,0,0,0,0,111,32,79,42,69,59,9.98718235242577,11.6556135567739,0.311876665411405,29
"7898","MG","Passos",115337,21745.94,31047,"Passos",3,"Sudeste",1,"314790",3,112,33,79,30,82,1,0,1,0,1,113,33,80,30,83,54,9.98718235242577,11.6556135567739,0.404697824731883,31
"7899","MG","Passos",115337,21745.94,31047,"Passos",3,"Sudeste",1,"314790",4,104,21,83,41,63,0,0,0,0,0,104,21,83,41,63,52,9.98718235242577,11.6556135567739,0.449553024719384,30
"7900","MG","Passos",115337,21745.94,31047,"Passos",3,"Sudeste",1,"314790",5,117,25,92,45,72,0,0,0,0,0,117,25,92,45,72,71,9.98718235242577,11.6556135567739,0.399889845342611,31
"7901","MG","Patos de Minas",153585,31066.32,31020,"Patos de Minas",3,"Sudeste",1,"314800",2,134,20,114,42,92,0,0,0,0,0,134,20,114,42,92,89,10.343879553145,11.942009438677,0.311449596268137,29
"7902","MG","Patos de Minas",153585,31066.32,31020,"Patos de Minas",3,"Sudeste",1,"314800",3,149,22,127,37,112,1,1,0,0,1,150,23,127,37,113,90,10.343879553145,11.942009438677,0.39455626122515,31
"7903","MG","Patos de Minas",153585,31066.32,31020,"Patos de Minas",3,"Sudeste",1,"314800",4,127,20,107,31,96,0,0,0,0,0,127,20,107,31,96,66,10.343879553145,11.942009438677,0.438878963922078,30
"7904","MG","Patos de Minas",153585,31066.32,31020,"Patos de Minas",3,"Sudeste",1,"314800",5,146,24,122,45,101,3,0,3,0,3,149,24,125,45,104,93,10.343879553145,11.942009438677,0.403367956720928,31
"7905","MG","Patrocínio",91449,31937.17,31019,"Patrocínio",3,"Sudeste",1,"314810",2,96,28,68,31,65,0,0,0,0,0,96,28,68,31,65,33,10.3715258142117,11.4235367188221,0.295985283755196,29
"7906","MG","Patrocínio",91449,31937.17,31019,"Patrocínio",3,"Sudeste",1,"314810",3,87,19,68,31,56,1,0,1,0,1,88,19,69,31,57,47,10.3715258142117,11.4235367188221,0.380394495001119,31
"7907","MG","Patrocínio",91449,31937.17,31019,"Patrocínio",3,"Sudeste",1,"314810",4,103,19,84,37,66,1,0,1,0,1,104,19,85,37,67,45,10.3715258142117,11.4235367188221,0.406558192024282,30
"7908","MG","Patrocínio",91449,31937.17,31019,"Patrocínio",3,"Sudeste",1,"314810",5,92,24,68,34,58,0,0,0,0,0,92,24,68,34,58,49,10.3715258142117,11.4235367188221,0.362856498676028,31
"7909","MG","Peçanha",17537,11123.93,31036,"Peçanha",3,"Sudeste",0,"314860",2,12,1,11,5,7,1,0,1,1,0,13,1,12,6,7,6,9.31685392263359,9.77206821366929,0.333758521308774,29
"7910","MG","Peçanha",17537,11123.93,31036,"Peçanha",3,"Sudeste",0,"314860",3,19,7,12,9,10,0,0,0,0,0,19,7,12,9,10,4,9.31685392263359,9.77206821366929,0.433427604172805,31
"7911","MG","Peçanha",17537,11123.93,31036,"Peçanha",3,"Sudeste",0,"314860",4,16,4,12,8,8,0,0,0,0,0,16,4,12,8,8,11,9.31685392263359,9.77206821366929,0.437097826749447,30
"7912","MG","Peçanha",17537,11123.93,31036,"Peçanha",3,"Sudeste",0,"314860",5,15,2,13,6,9,0,0,0,0,0,15,2,13,6,9,6,9.31685392263359,9.77206821366929,0.401134761686422,31
"7913","MG","Pedra Azul",24329,12284.14,31013,"Pedra Azul",3,"Sudeste",1,"314870",2,4,2,2,1,3,0,0,0,0,0,4,2,2,1,3,10,9.41606427843488,10.0994243334121,0.265806484301475,29
"7914","MG","Pedra Azul",24329,12284.14,31013,"Pedra Azul",3,"Sudeste",1,"314870",3,6,1,5,2,4,0,0,0,0,0,6,1,5,2,4,14,9.41606427843488,10.0994243334121,0.343044522717048,31
"7915","MG","Pedra Azul",24329,12284.14,31013,"Pedra Azul",3,"Sudeste",1,"314870",4,7,1,6,1,6,0,0,0,0,0,7,1,6,1,6,16,9.41606427843488,10.0994243334121,0.377303871140885,30
"7916","MG","Pedra Azul",24329,12284.14,31013,"Pedra Azul",3,"Sudeste",1,"314870",5,3,1,2,0,3,0,0,0,0,0,3,1,2,0,3,19,9.41606427843488,10.0994243334121,0.345065553501768,31
"7917","MG","Pedralva",11146,11640.91,31053,"Santa Rita do Sapucaí",3,"Sudeste",0,"314910",2,6,0,6,2,4,0,0,0,0,0,6,0,6,2,4,7,9.36228089692379,9.31883596812948,0.337351806676753,29
"7918","MG","Pedralva",11146,11640.91,31053,"Santa Rita do Sapucaí",3,"Sudeste",0,"314910",3,16,4,12,8,8,0,0,0,0,0,16,4,12,8,8,10,9.36228089692379,9.31883596812948,0.434233188390418,31
"7919","MG","Pedralva",11146,11640.91,31053,"Santa Rita do Sapucaí",3,"Sudeste",0,"314910",4,9,4,5,1,8,0,0,0,0,0,9,4,5,1,8,5,9.36228089692379,9.31883596812948,0.461766712546876,30
"7920","MG","Pedralva",11146,11640.91,31053,"Santa Rita do Sapucaí",3,"Sudeste",0,"314910",5,10,1,9,6,4,0,0,0,0,0,10,1,9,6,4,11,9.36228089692379,9.31883596812948,0.439632153648334,31
"7921","MG","Pedras de Maria da Cruz",12212,7227.5,31003,"Januária",3,"Sudeste",0,"314915",2,8,1,7,4,4,0,0,0,0,0,8,1,7,4,4,1,8.8856484738905,9.41017435385477,0.296928196327635,29
"7922","MG","Pedras de Maria da Cruz",12212,7227.5,31003,"Januária",3,"Sudeste",0,"314915",3,13,3,10,6,7,0,0,0,0,0,13,3,10,6,7,8,8.8856484738905,9.41017435385477,0.366501467891283,31
"7923","MG","Pedras de Maria da Cruz",12212,7227.5,31003,"Januária",3,"Sudeste",0,"314915",4,9,4,5,4,5,0,0,0,0,0,9,4,5,4,5,6,8.8856484738905,9.41017435385477,0.438613681852983,30
"7924","MG","Pedras de Maria da Cruz",12212,7227.5,31003,"Januária",3,"Sudeste",0,"314915",5,8,2,6,3,5,0,0,0,0,0,8,2,6,3,5,8,8.8856484738905,9.41017435385477,0.422553499139467,31
"7925","MG","Pedro Leopoldo",64712,22303.14,31030,"Belo Horizonte",3,"Sudeste",1,"314930",2,46,8,38,17,29,1,0,1,1,0,47,8,39,18,29,24,10.0124827547107,11.0777019346978,0.290213136900489,29
"7926","MG","Pedro Leopoldo",64712,22303.14,31030,"Belo Horizonte",3,"Sudeste",1,"314930",3,58,8,50,25,33,1,0,1,0,1,59,8,51,25,34,35,10.0124827547107,11.0777019346978,0.365422440974432,31
"7927","MG","Pedro Leopoldo",64712,22303.14,31030,"Belo Horizonte",3,"Sudeste",1,"314930",4,60,7,53,17,43,0,0,0,0,0,60,7,53,17,43,29,10.0124827547107,11.0777019346978,0.432141779575241,30
"7928","MG","Pedro Leopoldo",64712,22303.14,31030,"Belo Horizonte",3,"Sudeste",1,"314930",5,60,8,52,19,41,2,0,2,1,1,62,8,54,20,42,26,10.0124827547107,11.0777019346978,0.395619516485652,31
"7929","MG","Perdigão",11755,17654,31043,"Divinópolis",3,"Sudeste",0,"314970",2,12,5,7,1,11,0,0,0,0,0,12,5,7,1,11,4,9.77871766558018,9.37203396097417,0.324868075535441,29
"7930","MG","Perdigão",11755,17654,31043,"Divinópolis",3,"Sudeste",0,"314970",3,18,5,13,6,12,0,0,0,0,0,18,5,13,6,12,6,9.77871766558018,9.37203396097417,0.408022380514096,31
"7931","MG","Perdigão",11755,17654,31043,"Divinópolis",3,"Sudeste",0,"314970",4,15,1,14,4,11,0,0,0,0,0,15,1,14,4,11,11,9.77871766558018,9.37203396097417,0.425826790617858,30
"7932","MG","Perdigão",11755,17654,31043,"Divinópolis",3,"Sudeste",0,"314970",5,18,5,13,6,12,0,0,0,0,0,18,5,13,6,12,2,9.77871766558018,9.37203396097417,0.390001617461854,31
"7933","MG","Perdizes",16321,57084.47,31023,"Araxá",3,"Sudeste",0,"314980",2,11,1,10,7,4,1,1,0,1,0,12,2,10,8,4,5,10.9522873796669,9.7002079011507,0.302944827649118,29
"7934","MG","Perdizes",16321,57084.47,31023,"Araxá",3,"Sudeste",0,"314980",3,17,2,15,7,10,0,0,0,0,0,17,2,15,7,10,11,10.9522873796669,9.7002079011507,0.368957668031599,31
"7935","MG","Perdizes",16321,57084.47,31023,"Araxá",3,"Sudeste",0,"314980",4,12,2,10,5,7,0,0,0,0,0,12,2,10,5,7,6,10.9522873796669,9.7002079011507,0.397345971460947,30
"7936","MG","Perdizes",16321,57084.47,31023,"Araxá",3,"Sudeste",0,"314980",5,18,5,13,9,9,1,0,1,0,1,19,5,14,9,10,7,10.9522873796669,9.7002079011507,0.422973690109267,31
"7937","MG","Perdões",21485,22987.59,31045,"Campo Belo",3,"Sudeste",1,"314990",2,15,2,13,6,9,0,0,0,0,0,15,2,13,6,9,14,10.0427097840762,9.9751102962091,0.280788149023161,29
"7938","MG","Perdões",21485,22987.59,31045,"Campo Belo",3,"Sudeste",1,"314990",3,10,3,7,3,7,0,0,0,0,0,10,3,7,3,7,10,10.0427097840762,9.9751102962091,0.378469261701135,31
"7939","MG","Perdões",21485,22987.59,31045,"Campo Belo",3,"Sudeste",1,"314990",4,14,3,11,6,8,0,0,0,0,0,14,3,11,6,8,10,10.0427097840762,9.9751102962091,0.384285268814643,30
"7940","MG","Perdões",21485,22987.59,31045,"Campo Belo",3,"Sudeste",1,"314990",5,21,4,17,7,14,1,0,1,0,1,22,4,18,7,15,16,10.0427097840762,9.9751102962091,0.359882794978303,31
"7941","MG","Piedade de Caratinga",8702,10611.42,31040,"Caratinga",3,"Sudeste",0,"315015",2,10,2,8,2,8,0,0,0,0,0,10,2,8,2,8,3,9.26968605865656,9.07130816328062,0.312143621226301,29
"7942","MG","Piedade de Caratinga",8702,10611.42,31040,"Caratinga",3,"Sudeste",0,"315015",3,6,3,3,4,2,0,0,0,0,0,6,3,3,4,2,2,9.26968605865656,9.07130816328062,0.435685031095448,31
"7943","MG","Piedade de Caratinga",8702,10611.42,31040,"Caratinga",3,"Sudeste",0,"315015",4,9,4,5,4,5,0,0,0,0,0,9,4,5,4,5,5,9.26968605865656,9.07130816328062,0.443470056996954,30
"7944","MG","Piedade de Caratinga",8702,10611.42,31040,"Caratinga",3,"Sudeste",0,"315015",5,18,10,8,4,14,0,0,0,0,0,18,10,8,4,14,3,9.26968605865656,9.07130816328062,0.406072815081223,31
"7945","MG","Pimenta",8688,21948.87,31044,"Formiga",3,"Sudeste",0,"315050",2,4,1,3,0,4,0,0,0,0,0,4,1,3,0,4,9,9.99647093654033,9.06969804217372,0.335873330301558,29
"7946","MG","Pimenta",8688,21948.87,31044,"Formiga",3,"Sudeste",0,"315050",3,5,1,4,1,4,0,0,0,0,0,5,1,4,1,4,3,9.99647093654033,9.06969804217372,0.408742336661076,31
"7947","MG","Pimenta",8688,21948.87,31044,"Formiga",3,"Sudeste",0,"315050",4,7,3,4,2,5,0,0,0,0,0,7,3,4,2,5,4,9.99647093654033,9.06969804217372,0.426080874184954,30
"7948","MG","Pimenta",8688,21948.87,31044,"Formiga",3,"Sudeste",0,"315050",5,8,2,6,1,7,0,0,0,0,0,8,2,6,1,7,3,9.99647093654033,9.06969804217372,0.399812568905721,31
"7949","MG","Pirajuba",6348,50576.66,31021,"Frutal",3,"Sudeste",0,"315070",2,8,5,3,6,2,0,0,0,0,0,8,5,3,6,2,1,10.8312454840381,8.7558950816463,0.302015902712868,29
"7950","MG","Pirajuba",6348,50576.66,31021,"Frutal",3,"Sudeste",0,"315070",3,6,0,6,2,4,0,0,0,0,0,6,0,6,2,4,5,10.8312454840381,8.7558950816463,0.373257595999968,31
"7951","MG","Pirajuba",6348,50576.66,31021,"Frutal",3,"Sudeste",0,"315070",4,7,5,2,4,3,0,0,0,0,0,7,5,2,4,3,1,10.8312454840381,8.7558950816463,0.357783857944011,30
"7952","MG","Pirajuba",6348,50576.66,31021,"Frutal",3,"Sudeste",0,"315070",5,6,2,4,3,3,0,0,0,0,0,6,2,4,3,3,5,10.8312454840381,8.7558950816463,0.37880835354209,31
"7953","MG","Piranguinho",8640,12794.62,31056,"Itajubá",3,"Sudeste",1,"315100",2,6,2,4,2,4,0,0,0,0,0,6,2,4,2,4,5,9.45678004905165,9.0641578617981,0.317812834721762,29
"7954","MG","Piranguinho",8640,12794.62,31056,"Itajubá",3,"Sudeste",1,"315100",3,19,3,16,3,16,0,0,0,0,0,19,3,16,3,16,8,9.45678004905165,9.0641578617981,0.40959048921808,31
"7955","MG","Piranguinho",8640,12794.62,31056,"Itajubá",3,"Sudeste",1,"315100",4,8,1,7,2,6,0,0,0,0,0,8,1,7,2,6,2,9.45678004905165,9.0641578617981,0.442619970059683,30
"7956","MG","Piranguinho",8640,12794.62,31056,"Itajubá",3,"Sudeste",1,"315100",5,8,2,6,0,8,0,0,0,0,0,8,2,6,0,8,5,9.45678004905165,9.0641578617981,0.40036533014076,31
"7957","MG","Pirapetinga",10772,41809.6,31066,"Cataguases",3,"Sudeste",0,"315110",2,12,1,11,5,7,0,0,0,0,0,12,1,11,5,7,5,10.6408812572156,9.28470545393149,0.310871996234517,29
"7958","MG","Pirapetinga",10772,41809.6,31066,"Cataguases",3,"Sudeste",0,"315110",3,8,6,2,3,5,0,0,0,0,0,8,6,2,3,5,8,10.6408812572156,9.28470545393149,0.404201295212558,31
"7959","MG","Pirapetinga",10772,41809.6,31066,"Cataguases",3,"Sudeste",0,"315110",4,8,1,7,3,5,0,0,0,0,0,8,1,7,3,5,10,10.6408812572156,9.28470545393149,0.42643337760752,30
"7960","MG","Pirapetinga",10772,41809.6,31066,"Cataguases",3,"Sudeste",0,"315110",5,15,9,6,5,10,0,0,0,0,0,15,9,6,5,10,11,10.6408812572156,9.28470545393149,0.421510705305569,31
"7961","MG","Pirapora",56640,40566.3,31006,"Pirapora",3,"Sudeste",1,"315120",2,66,12,54,26,40,0,0,0,0,0,66,12,54,26,40,30,10.6106929516471,10.9444707283676,0.312440005346532,29
"7962","MG","Pirapora",56640,40566.3,31006,"Pirapora",3,"Sudeste",1,"315120",3,58,15,43,25,33,2,0,2,0,2,60,15,45,25,35,25,10.6106929516471,10.9444707283676,0.397806259236752,31
"7963","MG","Pirapora",56640,40566.3,31006,"Pirapora",3,"Sudeste",1,"315120",4,70,18,52,28,42,0,0,0,0,0,70,18,52,28,42,21,10.6106929516471,10.9444707283676,0.426259235537737,30
"7964","MG","Pirapora",56640,40566.3,31006,"Pirapora",3,"Sudeste",1,"315120",5,80,16,64,39,41,0,0,0,0,0,80,16,64,39,41,40,10.6106929516471,10.9444707283676,0.398808652420221,31
"7965","MG","Piraúba",10759,14678.81,31064,"Ubá",3,"Sudeste",0,"315130",2,9,2,7,4,5,0,0,0,0,0,9,2,7,4,5,7,9.59416023621245,9.28349789259391,0.319740838721552,29
"7966","MG","Piraúba",10759,14678.81,31064,"Ubá",3,"Sudeste",0,"315130",3,13,4,9,2,11,1,1,0,0,1,14,5,9,2,12,6,9.59416023621245,9.28349789259391,0.411943692286799,31
"7967","MG","Piraúba",10759,14678.81,31064,"Ubá",3,"Sudeste",0,"315130",4,8,5,3,2,6,0,0,0,0,0,8,5,3,2,6,4,9.59416023621245,9.28349789259391,0.456090377988721,30
"7968","MG","Piraúba",10759,14678.81,31064,"Ubá",3,"Sudeste",0,"315130",5,9,2,7,5,4,0,0,0,0,0,9,2,7,5,4,12,9.59416023621245,9.28349789259391,0.420931302136757,31
"7969","MG","Pitangui",28215,18990.87,31029,"Pará de Minas",3,"Sudeste",1,"315140",2,16,4,12,7,9,0,0,0,0,0,16,4,12,7,9,20,9.85171361634302,10.2476090304032,0.304147417464093,29
"7970","MG","Pitangui",28215,18990.87,31029,"Pará de Minas",3,"Sudeste",1,"315140",3,25,2,23,12,13,1,0,1,1,0,26,2,24,13,13,20,9.85171361634302,10.2476090304032,0.370671212673586,31
"7971","MG","Pitangui",28215,18990.87,31029,"Pará de Minas",3,"Sudeste",1,"315140",4,20,5,15,11,9,0,0,0,0,0,20,5,15,11,9,17,9.85171361634302,10.2476090304032,0.39699323402834,30
"7972","MG","Pitangui",28215,18990.87,31029,"Pará de Minas",3,"Sudeste",1,"315140",5,29,8,21,13,16,1,0,1,1,0,30,8,22,14,16,11,9.85171361634302,10.2476090304032,0.365340216720866,31
"7973","MG","Piumhi",34918,25148.18,31042,"Piuí",3,"Sudeste",1,"315150",2,20,1,19,8,12,0,0,0,0,0,20,1,19,8,12,29,10.1325408071042,10.4607577345447,0.293542180866869,29
"7974","MG","Piumhi",34918,25148.18,31042,"Piuí",3,"Sudeste",1,"315150",3,34,5,29,15,19,1,1,0,0,1,35,6,29,15,20,17,10.1325408071042,10.4607577345447,0.377536921174997,31
"7975","MG","Piumhi",34918,25148.18,31042,"Piuí",3,"Sudeste",1,"315150",4,38,5,33,14,24,0,0,0,0,0,38,5,33,14,24,24,10.1325408071042,10.4607577345447,0.418192037557863,30
"7976","MG","Piumhi",34918,25148.18,31042,"Piuí",3,"Sudeste",1,"315150",5,34,16,18,10,24,0,0,0,0,0,34,16,18,10,24,24,10.1325408071042,10.4607577345447,0.376939138828575,31
"7977","MG","Planura",12292,38010.92,31021,"Frutal",3,"Sudeste",1,"315160",2,5,1,4,1,4,0,0,0,0,0,5,1,4,1,4,7,10.5456287658472,9.41670392325038,0.323913125742555,29
"7978","MG","Planura",12292,38010.92,31021,"Frutal",3,"Sudeste",1,"315160",3,14,3,11,5,9,0,0,0,0,0,14,3,11,5,9,3,10.5456287658472,9.41670392325038,0.414827843184948,31
"7979","MG","Planura",12292,38010.92,31021,"Frutal",3,"Sudeste",1,"315160",4,8,2,6,0,8,0,0,0,0,0,8,2,6,0,8,8,10.5456287658472,9.41670392325038,0.416830545614882,30
"7980","MG","Planura",12292,38010.92,31021,"Frutal",3,"Sudeste",1,"315160",5,6,2,4,4,2,0,0,0,0,0,6,2,4,4,2,6,10.5456287658472,9.41670392325038,0.406609665435771,31
"7981","MG","Poço Fundo",16846,18396.85,31049,"Alfenas",3,"Sudeste",0,"315170",2,11,5,6,2,9,0,0,0,0,0,11,5,6,2,9,4,9.81993473328926,9.73186851887531,0.324672017619979,29
"7982","MG","Poço Fundo",16846,18396.85,31049,"Alfenas",3,"Sudeste",0,"315170",3,12,4,8,1,11,0,0,0,0,0,12,4,8,1,11,12,9.81993473328926,9.73186851887531,0.411991858414902,31
"7983","MG","Poço Fundo",16846,18396.85,31049,"Alfenas",3,"Sudeste",0,"315170",4,5,2,3,2,3,0,0,0,0,0,5,2,3,2,3,6,9.81993473328926,9.73186851887531,0.443722079678853,30
"7984","MG","Poço Fundo",16846,18396.85,31049,"Alfenas",3,"Sudeste",0,"315170",5,16,10,6,2,14,0,0,0,0,0,16,10,6,2,14,8,9.81993473328926,9.73186851887531,0.423357558287279,31
"7985","MG","Poços de Caldas",168641,46028.28,31051,"Poços de Caldas",3,"Sudeste",1,"315180",2,141,27,114,47,94,0,0,0,0,0,141,27,114,47,94,117,10.7370112691785,12.0355274741088,0.308913402111817,29
"7986","MG","Poços de Caldas",168641,46028.28,31051,"Poços de Caldas",3,"Sudeste",1,"315180",3,142,19,123,47,95,0,0,0,0,0,142,19,123,47,95,110,10.7370112691785,12.0355274741088,0.416210887656318,31
"7987","MG","Poços de Caldas",168641,46028.28,31051,"Poços de Caldas",3,"Sudeste",1,"315180",4,120,20,100,38,82,1,1,0,0,1,121,21,100,38,83,86,10.7370112691785,12.0355274741088,0.476327876529441,30
"7988","MG","Poços de Caldas",168641,46028.28,31051,"Poços de Caldas",3,"Sudeste",1,"315180",5,153,19,134,54,99,1,0,1,0,1,154,19,135,54,100,110,10.7370112691785,12.0355274741088,0.416149207359447,31
"7989","MG","Pompéu",32035,24764.51,31024,"Três Marias",3,"Sudeste",1,"315200",2,21,8,13,8,13,0,0,0,0,0,21,8,13,8,13,20,10.1171668588383,10.3745843340731,0.288416021977224,29
"7990","MG","Pompéu",32035,24764.51,31024,"Três Marias",3,"Sudeste",1,"315200",3,11,2,9,8,3,0,0,0,0,0,11,2,9,8,3,28,10.1171668588383,10.3745843340731,0.341273601238036,31
"7991","MG","Pompéu",32035,24764.51,31024,"Três Marias",3,"Sudeste",1,"315200",4,18,8,10,10,8,0,0,0,0,0,18,8,10,10,8,21,10.1171668588383,10.3745843340731,0.364125302907941,30
"7992","MG","Pompéu",32035,24764.51,31024,"Três Marias",3,"Sudeste",1,"315200",5,18,6,12,10,8,0,0,0,0,0,18,6,12,10,8,17,10.1171668588383,10.3745843340731,0.350944229711507,31
"7993","MG","Ponte Nova",59875,27739.09,31060,"Ponte Nova",3,"Sudeste",1,"315210",2,45,14,31,13,32,0,0,0,0,0,45,14,31,13,32,29,10.2305978887165,11.0000143347132,0.31849591669333,29
"7994","MG","Ponte Nova",59875,27739.09,31060,"Ponte Nova",3,"Sudeste",1,"315210",3,46,5,41,12,34,2,0,2,1,1,48,5,43,13,35,47,10.2305978887165,11.0000143347132,0.430294979140649,31
"7995","MG","Ponte Nova",59875,27739.09,31060,"Ponte Nova",3,"Sudeste",1,"315210",4,38,3,35,7,31,1,1,0,1,0,39,4,35,8,31,30,10.2305978887165,11.0000143347132,0.474684967129629,30
"7996","MG","Ponte Nova",59875,27739.09,31060,"Ponte Nova",3,"Sudeste",1,"315210",5,59,22,37,17,42,0,0,0,0,0,59,22,37,17,42,33,10.2305978887165,11.0000143347132,0.432139375615538,31
"7997","MG","Porteirinha",37864,8842.27,31004,"Janaúba",3,"Sudeste",0,"315220",2,35,7,28,18,17,0,0,0,0,0,35,7,28,18,17,20,9.08729890999778,10.5417560715861,0.294386913815012,29
"7998","MG","Porteirinha",37864,8842.27,31004,"Janaúba",3,"Sudeste",0,"315220",3,36,8,28,9,27,0,0,0,0,0,36,8,28,9,27,20,9.08729890999778,10.5417560715861,0.382486944080666,31
"7999","MG","Porteirinha",37864,8842.27,31004,"Janaúba",3,"Sudeste",0,"315220",4,37,4,33,11,26,0,0,0,0,0,37,4,33,11,26,22,9.08729890999778,10.5417560715861,0.381959964319404,30
"8000","MG","Porteirinha",37864,8842.27,31004,"Janaúba",3,"Sudeste",0,"315220",5,38,6,32,15,23,0,0,0,0,0,38,6,32,15,23,24,9.08729890999778,10.5417560715861,0.377029887519313,31
"8001","MG","Porto Firme",11348,8101.28,31062,"Viçosa",3,"Sudeste",0,"315230",2,4,0,4,3,1,0,0,0,0,0,4,0,4,3,1,5,8.9997773528673,9.33679679592874,0.350451539406259,29
"8002","MG","Porto Firme",11348,8101.28,31062,"Viçosa",3,"Sudeste",0,"315230",3,11,1,10,6,5,0,0,0,0,0,11,1,10,6,5,9,8.9997773528673,9.33679679592874,0.374988709835457,31
"8003","MG","Porto Firme",11348,8101.28,31062,"Viçosa",3,"Sudeste",0,"315230",4,5,1,4,1,4,0,0,0,0,0,5,1,4,1,4,7,8.9997773528673,9.33679679592874,0.447469726331182,30
"8004","MG","Porto Firme",11348,8101.28,31062,"Viçosa",3,"Sudeste",0,"315230",5,7,4,3,2,5,0,0,0,0,0,7,4,3,2,5,10,8.9997773528673,9.33679679592874,0.433257222225054,31
"8005","MG","Poté",16616,8565.81,31015,"Teófilo Otoni",3,"Sudeste",0,"315240",2,12,2,10,6,6,0,0,0,0,0,12,2,10,6,6,7,9.05553397721487,9.71812136555595,0.315921455621408,29
"8006","MG","Poté",16616,8565.81,31015,"Teófilo Otoni",3,"Sudeste",0,"315240",3,20,7,13,9,11,0,0,0,0,0,20,7,13,9,11,8,9.05553397721487,9.71812136555595,0.412567293488443,31
"8007","MG","Poté",16616,8565.81,31015,"Teófilo Otoni",3,"Sudeste",0,"315240",4,10,2,8,6,4,0,0,0,0,0,10,2,8,6,4,11,9.05553397721487,9.71812136555595,0.451240945845611,30
"8008","MG","Poté",16616,8565.81,31015,"Teófilo Otoni",3,"Sudeste",0,"315240",5,14,8,6,9,5,0,0,0,0,0,14,8,6,9,5,7,9.05553397721487,9.71812136555595,0.426699309184578,31
"8009","MG","Pouso Alegre",152549,51182.28,31052,"Pouso Alegre",3,"Sudeste",1,"315250",2,144,26,118,43,101,1,1,0,1,0,145,27,118,44,101,57,10.8431486573733,11.9352411348955,0.291224107486211,29
"8010","MG","Pouso Alegre",152549,51182.28,31052,"Pouso Alegre",3,"Sudeste",1,"315250",3,164,25,139,55,109,1,0,1,0,1,165,25,140,55,110,60,10.8431486573733,11.9352411348955,0.381374295936024,31
"8011","MG","Pouso Alegre",152549,51182.28,31052,"Pouso Alegre",3,"Sudeste",1,"315250",4,135,22,113,39,96,1,1,0,0,1,136,23,113,39,97,67,10.8431486573733,11.9352411348955,0.427947101505557,30
"8012","MG","Pouso Alegre",152549,51182.28,31052,"Pouso Alegre",3,"Sudeste",1,"315250",5,167,31,136,39,128,1,0,1,1,0,168,31,137,40,128,67,10.8431486573733,11.9352411348955,0.383337871065197,31
"8013","MG","Prata",28017,35235.94,31018,"Uberlândia",3,"Sudeste",0,"315280",2,23,6,17,8,15,1,0,1,1,0,24,6,18,9,15,16,10.4698218634243,10.2405667477778,0.265679206642005,29
"8014","MG","Prata",28017,35235.94,31018,"Uberlândia",3,"Sudeste",0,"315280",3,29,10,19,11,18,0,0,0,0,0,29,10,19,11,18,15,10.4698218634243,10.2405667477778,0.36204915188702,31
"8015","MG","Prata",28017,35235.94,31018,"Uberlândia",3,"Sudeste",0,"315280",4,40,13,27,17,23,0,0,0,0,0,40,13,27,17,23,13,10.4698218634243,10.2405667477778,0.383066235680478,30
"8016","MG","Prata",28017,35235.94,31018,"Uberlândia",3,"Sudeste",0,"315280",5,28,4,24,11,17,0,0,0,0,0,28,4,24,11,17,12,10.4698218634243,10.2405667477778,0.398098236103522,31
"8017","MG","Pratápolis",8566,17920.31,31047,"Passos",3,"Sudeste",0,"315290",2,7,1,6,4,3,0,0,0,0,0,7,1,6,4,3,5,9.79368998548644,9.05555615817532,0.328648168570733,29
"8018","MG","Pratápolis",8566,17920.31,31047,"Passos",3,"Sudeste",0,"315290",3,4,0,4,2,2,0,0,0,0,0,4,0,4,2,2,7,9.79368998548644,9.05555615817532,0.400252506539623,31
"8019","MG","Pratápolis",8566,17920.31,31047,"Passos",3,"Sudeste",0,"315290",4,2,1,1,2,0,0,0,0,0,0,2,1,1,2,0,8,9.79368998548644,9.05555615817532,0.421285608710659,30
"8020","MG","Pratápolis",8566,17920.31,31047,"Passos",3,"Sudeste",0,"315290",5,11,3,8,6,5,0,0,0,0,0,11,3,8,6,5,11,9.79368998548644,9.05555615817532,0.420937443269171,31
"8021","MG","Presidente Olegário",19627,22596.41,31002,"Paracatu",3,"Sudeste",0,"315340",2,10,2,8,4,6,0,0,0,0,0,10,2,8,4,6,10,10.0255463230849,9.88466144828608,0.335957799565981,29
"8022","MG","Presidente Olegário",19627,22596.41,31002,"Paracatu",3,"Sudeste",0,"315340",3,10,3,7,3,7,0,0,0,0,0,10,3,7,3,7,11,10.0255463230849,9.88466144828608,0.390106772876742,31
"8023","MG","Presidente Olegário",19627,22596.41,31002,"Paracatu",3,"Sudeste",0,"315340",4,15,1,14,5,10,0,0,0,0,0,15,1,14,5,10,11,10.0255463230849,9.88466144828608,0.420809731702733,30
"8024","MG","Presidente Olegário",19627,22596.41,31002,"Paracatu",3,"Sudeste",0,"315340",5,16,4,12,8,8,0,0,0,0,0,16,4,12,8,8,9,10.0255463230849,9.88466144828608,0.426117645891812,31
"8025","MG","Prudente de Morais",10834,13915.92,31027,"Sete Lagoas",3,"Sudeste",1,"315360",2,9,2,7,4,5,0,0,0,0,0,9,2,7,4,5,7,9.54078878747692,9.29044461621784,0.300654240476249,29
"8026","MG","Prudente de Morais",10834,13915.92,31027,"Sete Lagoas",3,"Sudeste",1,"315360",3,6,2,4,3,3,0,0,0,0,0,6,2,4,3,3,6,9.54078878747692,9.29044461621784,0.369597935322702,31
"8027","MG","Prudente de Morais",10834,13915.92,31027,"Sete Lagoas",3,"Sudeste",1,"315360",4,2,0,2,0,2,1,1,0,0,1,3,1,2,0,3,5,9.54078878747692,9.29044461621784,0.405397380185551,30
"8028","MG","Prudente de Morais",10834,13915.92,31027,"Sete Lagoas",3,"Sudeste",1,"315360",5,3,0,3,2,1,0,0,0,0,0,3,0,3,2,1,7,9.54078878747692,9.29044461621784,0.356336369467221,31
"8029","MG","Raposos",16429,11291.86,31030,"Belo Horizonte",3,"Sudeste",1,"315390",2,16,0,16,6,10,0,0,0,0,0,16,0,16,6,10,9,9.33183739113854,9.70680334490634,0.314949812692224,29
"8030","MG","Raposos",16429,11291.86,31030,"Belo Horizonte",3,"Sudeste",1,"315390",3,15,0,15,5,10,0,0,0,0,0,15,0,15,5,10,14,9.33183739113854,9.70680334490634,0.390192109165248,31
"8031","MG","Raposos",16429,11291.86,31030,"Belo Horizonte",3,"Sudeste",1,"315390",4,19,1,18,4,15,1,1,0,0,1,20,2,18,4,16,9,9.33183739113854,9.70680334490634,0.455744174708553,30
"8032","MG","Raposos",16429,11291.86,31030,"Belo Horizonte",3,"Sudeste",1,"315390",5,21,0,21,9,12,1,1,0,1,0,22,1,21,10,12,5,9.33183739113854,9.70680334490634,0.408879844730234,31
"8033","MG","Raul Soares",23711,13138.7,31060,"Ponte Nova",3,"Sudeste",0,"315400",2,10,4,6,6,4,0,0,0,0,0,10,4,6,6,4,14,9.48331735259327,10.073694354467,0.311599928410786,29
"8034","MG","Raul Soares",23711,13138.7,31060,"Ponte Nova",3,"Sudeste",0,"315400",3,16,4,12,8,8,0,0,0,0,0,16,4,12,8,8,23,9.48331735259327,10.073694354467,0.396507221806776,31
"8035","MG","Raul Soares",23711,13138.7,31060,"Ponte Nova",3,"Sudeste",0,"315400",4,25,6,19,8,17,0,0,0,0,0,25,6,19,8,17,13,9.48331735259327,10.073694354467,0.450035762691049,30
"8036","MG","Raul Soares",23711,13138.7,31060,"Ponte Nova",3,"Sudeste",0,"315400",5,24,6,18,12,12,0,0,0,0,0,24,6,18,12,12,15,9.48331735259327,10.073694354467,0.451020755436375,31
"8037","MG","Resende Costa",11540,15789.24,31058,"São João Del Rei",3,"Sudeste",0,"315420",2,7,1,6,3,4,1,0,1,0,1,8,1,7,3,5,8,9.66708397436238,9.35357454006209,0.305414250911027,29
"8038","MG","Resende Costa",11540,15789.24,31058,"São João Del Rei",3,"Sudeste",0,"315420",3,10,3,7,5,5,0,0,0,0,0,10,3,7,5,5,8,9.66708397436238,9.35357454006209,0.381846036596583,31
"8039","MG","Resende Costa",11540,15789.24,31058,"São João Del Rei",3,"Sudeste",0,"315420",4,10,2,8,3,7,0,0,0,0,0,10,2,8,3,7,7,9.66708397436238,9.35357454006209,0.444237816130206,30
"8040","MG","Resende Costa",11540,15789.24,31058,"São João Del Rei",3,"Sudeste",0,"315420",5,9,2,7,3,6,0,0,0,0,0,9,2,7,3,6,10,9.66708397436238,9.35357454006209,0.41245650362635,31
"8041","MG","Resplendor",17396,12808.48,31041,"Aimorés",3,"Sudeste",0,"315430",2,14,7,7,5,9,0,0,0,0,0,14,7,7,5,9,11,9.45786273055146,9.76399557371753,0.346817491018415,29
"8042","MG","Resplendor",17396,12808.48,31041,"Aimorés",3,"Sudeste",0,"315430",3,20,5,15,3,17,1,1,0,0,1,21,6,15,3,18,20,9.45786273055146,9.76399557371753,0.433032120350708,31
"8043","MG","Resplendor",17396,12808.48,31041,"Aimorés",3,"Sudeste",0,"315430",4,6,2,4,1,5,0,0,0,0,0,6,2,4,1,5,19,9.45786273055146,9.76399557371753,0.46096016192383,30
"8044","MG","Resplendor",17396,12808.48,31041,"Aimorés",3,"Sudeste",0,"315430",5,6,3,3,3,3,0,0,0,0,0,6,3,3,3,3,8,9.45786273055146,9.76399557371753,0.460070507519819,31
"8045","MG","Riacho dos Machados",9476,29972.04,31004,"Janaúba",3,"Sudeste",0,"315450",2,9,2,7,5,4,0,0,0,0,0,9,2,7,5,4,1,10.3080202260623,9.15651756527868,0.329123791779514,29
"8046","MG","Riacho dos Machados",9476,29972.04,31004,"Janaúba",3,"Sudeste",0,"315450",3,10,3,7,5,5,1,1,0,1,0,11,4,7,6,5,4,10.3080202260623,9.15651756527868,0.430106981476941,31
"8047","MG","Riacho dos Machados",9476,29972.04,31004,"Janaúba",3,"Sudeste",0,"315450",4,11,1,10,5,6,0,0,0,0,0,11,1,10,5,6,4,10.3080202260623,9.15651756527868,0.443012292409497,30
"8048","MG","Riacho dos Machados",9476,29972.04,31004,"Janaúba",3,"Sudeste",0,"315450",5,6,1,5,2,4,0,0,0,0,0,6,1,5,2,4,4,10.3080202260623,9.15651756527868,0.439640548656781,31
"8049","MG","Ribeirão das Neves",338197,12392.14,31030,"Belo Horizonte",3,"Sudeste",1,"315460",2,321,68,253,104,217,3,1,2,2,1,324,69,255,106,218,127,9.42481767964425,12.7313838449164,0.302668981912362,29
"8050","MG","Ribeirão das Neves",338197,12392.14,31030,"Belo Horizonte",3,"Sudeste",1,"315460",3,333,73,260,130,203,2,0,2,2,0,335,73,262,132,203,126,9.42481767964425,12.7313838449164,0.389198918681017,31
"8051","MG","Ribeirão das Neves",338197,12392.14,31030,"Belo Horizonte",3,"Sudeste",1,"315460",4,338,70,268,129,209,2,1,1,1,1,340,71,269,130,210,113,9.42481767964425,12.7313838449164,0.434953419382116,30
"8052","MG","Ribeirão das Neves",338197,12392.14,31030,"Belo Horizonte",3,"Sudeste",1,"315460",5,335,65,270,122,213,4,0,4,0,4,339,65,274,122,217,140,9.42481767964425,12.7313838449164,0.397458653331174,31
"8053","MG","Rio Acima",10420,18719.75,31030,"Belo Horizonte",3,"Sudeste",1,"315480",2,9,1,8,3,6,0,0,0,0,0,9,1,8,3,6,3,9.83733439524155,9.25148231530736,0.309358470046348,29
"8054","MG","Rio Acima",10420,18719.75,31030,"Belo Horizonte",3,"Sudeste",1,"315480",3,7,2,5,2,5,0,0,0,0,0,7,2,5,2,5,4,9.83733439524155,9.25148231530736,0.404441324337627,31
"8055","MG","Rio Acima",10420,18719.75,31030,"Belo Horizonte",3,"Sudeste",1,"315480",4,6,0,6,2,4,0,0,0,0,0,6,0,6,2,4,4,9.83733439524155,9.25148231530736,0.427732261200693,30
"8056","MG","Rio Acima",10420,18719.75,31030,"Belo Horizonte",3,"Sudeste",1,"315480",5,12,1,11,7,5,0,0,0,0,0,12,1,11,7,5,4,9.83733439524155,9.25148231530736,0.406140643544812,31
"8057","MG","Rio Casca",13473,14225.73,31060,"Ponte Nova",3,"Sudeste",0,"315490",2,12,1,11,6,6,0,0,0,0,0,12,1,11,6,6,13,9.56280757577974,9.50844296175585,0.319919811215537,29
"8058","MG","Rio Casca",13473,14225.73,31060,"Ponte Nova",3,"Sudeste",0,"315490",3,16,3,13,6,10,1,1,0,1,0,17,4,13,7,10,11,9.56280757577974,9.50844296175585,0.402514860559289,31
"8059","MG","Rio Casca",13473,14225.73,31060,"Ponte Nova",3,"Sudeste",0,"315490",4,8,1,7,3,5,0,0,0,0,0,8,1,7,3,5,9,9.56280757577974,9.50844296175585,0.434946198223845,30
"8060","MG","Rio Casca",13473,14225.73,31060,"Ponte Nova",3,"Sudeste",0,"315490",5,11,1,10,3,8,0,0,0,0,0,11,1,10,3,8,8,9.56280757577974,9.50844296175585,0.429048561709612,31
"8061","MG","Rio Manso",5879,14769.81,31032,"Itaguara",3,"Sudeste",0,"315530",2,3,1,2,0,3,0,0,0,0,0,3,1,2,0,3,0,9.60034051152935,8.67914195840225,0.283619342219003,29
"8062","MG","Rio Manso",5879,14769.81,31032,"Itaguara",3,"Sudeste",0,"315530",3,5,0,5,1,4,0,0,0,0,0,5,0,5,1,4,1,9.60034051152935,8.67914195840225,0.353474195800777,31
"8063","MG","Rio Manso",5879,14769.81,31032,"Itaguara",3,"Sudeste",0,"315530",4,5,1,4,1,4,0,0,0,0,0,5,1,4,1,4,2,9.60034051152935,8.67914195840225,0.382012038740763,30
"8064","MG","Rio Manso",5879,14769.81,31032,"Itaguara",3,"Sudeste",0,"315530",5,4,2,2,4,0,0,0,0,0,0,4,2,2,4,0,6,9.60034051152935,8.67914195840225,0.378508204985188,31
"8065","MG","Rio Novo",8957,11938.85,31065,"Juiz de Fora",3,"Sudeste",0,"315540",2,5,1,4,2,3,0,0,0,0,0,5,1,4,2,3,0,9.38755306740014,9.10019062847519,0.334594607620276,29
"8066","MG","Rio Novo",8957,11938.85,31065,"Juiz de Fora",3,"Sudeste",0,"315540",3,6,3,3,3,3,0,0,0,0,0,6,3,3,3,3,5,9.38755306740014,9.10019062847519,0.42684117064213,31
"8067","MG","Rio Novo",8957,11938.85,31065,"Juiz de Fora",3,"Sudeste",0,"315540",4,6,0,6,3,3,0,0,0,0,0,6,0,6,3,3,4,9.38755306740014,9.10019062847519,0.474420600294287,30
"8068","MG","Rio Novo",8957,11938.85,31065,"Juiz de Fora",3,"Sudeste",0,"315540",5,7,3,4,3,4,0,0,0,0,0,7,3,4,3,4,8,9.38755306740014,9.10019062847519,0.429307369190773,31
"8069","MG","Rio Paranaíba",12335,41984.26,31020,"Patos de Minas",3,"Sudeste",0,"315550",2,15,2,13,8,7,0,0,0,0,0,15,2,13,8,7,9,10.64505006512,9.42019602896346,0.293059676615018,29
"8070","MG","Rio Paranaíba",12335,41984.26,31020,"Patos de Minas",3,"Sudeste",0,"315550",3,9,5,4,5,4,0,0,0,0,0,9,5,4,5,4,5,10.64505006512,9.42019602896346,0.390012215876106,31
"8071","MG","Rio Paranaíba",12335,41984.26,31020,"Patos de Minas",3,"Sudeste",0,"315550",4,8,4,4,3,5,0,0,0,0,0,8,4,4,3,5,10,10.64505006512,9.42019602896346,0.405101226792141,30
"8072","MG","Rio Paranaíba",12335,41984.26,31020,"Patos de Minas",3,"Sudeste",0,"315550",5,12,5,7,4,8,2,0,2,1,1,14,5,9,5,9,16,10.64505006512,9.42019602896346,0.391549221640011,31
"8073","MG","Rio Pardo de Minas",31045,8931.83,31005,"Salinas",3,"Sudeste",0,"315560",2,23,2,21,8,15,0,0,0,0,0,23,2,21,8,15,11,9.09737658008748,10.343193043799,0.302624003477544,29
"8074","MG","Rio Pardo de Minas",31045,8931.83,31005,"Salinas",3,"Sudeste",0,"315560",3,28,4,24,13,15,1,1,0,1,0,29,5,24,14,15,16,9.09737658008748,10.343193043799,0.377770142736049,31
"8075","MG","Rio Pardo de Minas",31045,8931.83,31005,"Salinas",3,"Sudeste",0,"315560",4,27,8,19,10,17,0,0,0,0,0,27,8,19,10,17,16,9.09737658008748,10.343193043799,0.380496820245856,30
"8076","MG","Rio Pardo de Minas",31045,8931.83,31005,"Salinas",3,"Sudeste",0,"315560",5,36,6,30,18,18,0,0,0,0,0,36,6,30,18,18,13,9.09737658008748,10.343193043799,0.381344760966009,31
"8077","MG","Rio Piracicaba",14332,39144.44,31031,"Itabira",3,"Sudeste",0,"315570",2,13,3,10,2,11,0,0,0,0,0,13,3,10,2,11,6,10.5750136734535,9.57025007842484,0.309385470426451,29
"8078","MG","Rio Piracicaba",14332,39144.44,31031,"Itabira",3,"Sudeste",0,"315570",3,7,0,7,1,6,0,0,0,0,0,7,0,7,1,6,9,10.5750136734535,9.57025007842484,0.392668367257839,31
"8079","MG","Rio Piracicaba",14332,39144.44,31031,"Itabira",3,"Sudeste",0,"315570",4,10,0,10,4,6,0,0,0,0,0,10,0,10,4,6,6,10.5750136734535,9.57025007842484,0.419148564180374,30
"8080","MG","Rio Piracicaba",14332,39144.44,31031,"Itabira",3,"Sudeste",0,"315570",5,7,2,5,2,5,0,0,0,0,0,7,2,5,2,5,11,10.5750136734535,9.57025007842484,0.397740694112803,31
"8081","MG","Rio Pomba",17959,19070.37,31064,"Ubá",3,"Sudeste",1,"315580",2,12,4,8,5,7,0,0,0,0,0,12,4,8,5,7,12,9.85589110060866,9.79584666101874,0.30768208161906,29
"8082","MG","Rio Pomba",17959,19070.37,31064,"Ubá",3,"Sudeste",1,"315580",3,16,4,12,3,13,0,0,0,0,0,16,4,12,3,13,11,9.85589110060866,9.79584666101874,0.386323276320457,31
"8083","MG","Rio Pomba",17959,19070.37,31064,"Ubá",3,"Sudeste",1,"315580",4,14,4,10,6,8,0,0,0,0,0,14,4,10,6,8,7,9.85589110060866,9.79584666101874,0.468558600705989,30
"8084","MG","Rio Pomba",17959,19070.37,31064,"Ubá",3,"Sudeste",1,"315580",5,13,1,12,4,9,2,0,2,0,2,15,1,14,4,11,19,9.85589110060866,9.79584666101874,0.422395518690611,31
"8085","MG","Rodeiro",8224,49500.09,31064,"Ubá",3,"Sudeste",1,"315630",2,7,5,2,2,5,0,0,0,0,0,7,5,2,2,5,5,10.8097297667369,9.01481198769495,0.324737192393529,29
"8086","MG","Rodeiro",8224,49500.09,31064,"Ubá",3,"Sudeste",1,"315630",3,11,4,7,4,7,0,0,0,0,0,11,4,7,4,7,7,10.8097297667369,9.01481198769495,0.413119180762595,31
"8087","MG","Rodeiro",8224,49500.09,31064,"Ubá",3,"Sudeste",1,"315630",4,10,3,7,5,5,0,0,0,0,0,10,3,7,5,5,4,10.8097297667369,9.01481198769495,0.433186225740365,30
"8088","MG","Rodeiro",8224,49500.09,31064,"Ubá",3,"Sudeste",1,"315630",5,9,2,7,4,5,0,0,0,0,0,9,2,7,4,5,8,10.8097297667369,9.01481198769495,0.398806775791338,31
"8089","MG","Rubim",10256,8319.29,31014,"Almenara",3,"Sudeste",0,"315660",2,0,0,0,0,0,0,0,0,0,0,0,0,0,0,0,8,9.02633219363542,9.23561817916045,0.306668507039608,29
"8090","MG","Rubim",10256,8319.29,31014,"Almenara",3,"Sudeste",0,"315660",3,0,0,0,0,0,0,0,0,0,0,0,0,0,0,0,3,9.02633219363542,9.23561817916045,0.38174519444252,31
"8091","MG","Rubim",10256,8319.29,31014,"Almenara",3,"Sudeste",0,"315660",4,0,0,0,0,0,0,0,0,0,0,0,0,0,0,0,8,9.02633219363542,9.23561817916045,0.41502822100831,30
"8092","MG","Rubim",10256,8319.29,31014,"Almenara",3,"Sudeste",0,"315660",5,0,0,0,0,0,1,1,0,0,1,1,1,0,0,1,5,9.02633219363542,9.23561817916045,0.36629774005622,31
"8093","MG","Sabará",137125,21561.12,31030,"Belo Horizonte",3,"Sudeste",1,"315670",2,117,19,98,46,71,0,0,0,0,0,117,19,98,46,71,65,9.97864697172563,11.8286481975775,0.297355819358716,29
"8094","MG","Sabará",137125,21561.12,31030,"Belo Horizonte",3,"Sudeste",1,"315670",3,120,25,95,47,73,5,1,4,4,1,125,26,99,51,74,71,9.97864697172563,11.8286481975775,0.390028849205376,31
"8095","MG","Sabará",137125,21561.12,31030,"Belo Horizonte",3,"Sudeste",1,"315670",4,109,15,94,29,80,2,0,2,1,1,111,15,96,30,81,48,9.97864697172563,11.8286481975775,0.445439390488218,30
"8096","MG","Sabará",137125,21561.12,31030,"Belo Horizonte",3,"Sudeste",1,"315670",5,165,28,137,68,97,6,2,4,1,5,171,30,141,69,102,57,9.97864697172563,11.8286481975775,0.402606717152755,31
"8097","MG","Sabinópolis",15416,11632.37,31035,"Guanhães",3,"Sudeste",0,"315680",2,10,3,7,2,8,0,0,0,0,0,10,3,7,2,8,11,9.36154700807071,9.6431612100942,0.29403510857177,29
"8098","MG","Sabinópolis",15416,11632.37,31035,"Guanhães",3,"Sudeste",0,"315680",3,12,3,9,2,10,0,0,0,0,0,12,3,9,2,10,11,9.36154700807071,9.6431612100942,0.374744119437561,31
"8099","MG","Sabinópolis",15416,11632.37,31035,"Guanhães",3,"Sudeste",0,"315680",4,7,3,4,2,5,0,0,0,0,0,7,3,4,2,5,9,9.36154700807071,9.6431612100942,0.462953852009196,30
"8100","MG","Sabinópolis",15416,11632.37,31035,"Guanhães",3,"Sudeste",0,"315680",5,9,1,8,6,3,0,0,0,0,0,9,1,8,6,3,8,9.36154700807071,9.6431612100942,0.426240972732643,31
"8101","MG","Sacramento",26374,51491.7,31023,"Araxá",3,"Sudeste",1,"315690",2,21,2,19,8,13,0,0,0,0,0,21,2,19,8,13,14,10.8491759086148,10.1801339553676,0.307836789876123,29
"8102","MG","Sacramento",26374,51491.7,31023,"Araxá",3,"Sudeste",1,"315690",3,22,1,21,7,15,0,0,0,0,0,22,1,21,7,15,14,10.8491759086148,10.1801339553676,0.381294467713087,31
"8103","MG","Sacramento",26374,51491.7,31023,"Araxá",3,"Sudeste",1,"315690",4,17,3,14,9,8,0,0,0,0,0,17,3,14,9,8,9,10.8491759086148,10.1801339553676,0.409112776545093,30
"8104","MG","Sacramento",26374,51491.7,31023,"Araxá",3,"Sudeste",1,"315690",5,24,3,21,11,13,0,0,0,0,0,24,3,21,11,13,21,10.8491759086148,10.1801339553676,0.401570331374032,31
"8105","MG","Salinas",41699,13184.48,31005,"Salinas",3,"Sudeste",1,"315700",2,34,8,26,11,23,0,0,0,0,0,34,8,26,11,23,23,9.4867956592535,10.638232426684,0.273483644404184,29
"8106","MG","Salinas",41699,13184.48,31005,"Salinas",3,"Sudeste",1,"315700",3,45,9,36,14,31,1,0,1,0,1,46,9,37,14,32,26,9.4867956592535,10.638232426684,0.369398487977064,31
"8107","MG","Salinas",41699,13184.48,31005,"Salinas",3,"Sudeste",1,"315700",4,34,5,29,12,22,0,0,0,0,0,34,5,29,12,22,27,9.4867956592535,10.638232426684,0.382558628148459,30
"8108","MG","Salinas",41699,13184.48,31005,"Salinas",3,"Sudeste",1,"315700",5,39,12,27,8,31,0,0,0,0,0,39,12,27,8,31,17,9.4867956592535,10.638232426684,0.347671165640897,31
"8109","MG","Salto da Divisa",7012,14698.14,31014,"Almenara",3,"Sudeste",0,"315710",2,1,0,1,1,0,0,0,0,0,0,1,0,1,1,0,4,9.59547623414891,8.85537824604113,0.294667624257181,29
"8110","MG","Salto da Divisa",7012,14698.14,31014,"Almenara",3,"Sudeste",0,"315710",3,5,4,1,2,3,0,0,0,0,0,5,4,1,2,3,8,9.59547623414891,8.85537824604113,0.374532879207477,31
"8111","MG","Salto da Divisa",7012,14698.14,31014,"Almenara",3,"Sudeste",0,"315710",4,0,0,0,0,0,0,0,0,0,0,0,0,0,0,0,4,9.59547623414891,8.85537824604113,0.384549341039142,30
"8112","MG","Salto da Divisa",7012,14698.14,31014,"Almenara",3,"Sudeste",0,"315710",5,0,0,0,0,0,0,0,0,0,0,0,0,0,0,0,4,9.59547623414891,8.85537824604113,0.347590640374133,31
"8113","MG","Santa Bárbara",31604,26833.95,31031,"Itabira",3,"Sudeste",1,"315720",2,22,2,20,10,12,0,0,0,0,0,22,2,20,10,12,7,10.1974231558409,10.3610389738426,0.297500800748733,29
"8114","MG","Santa Bárbara",31604,26833.95,31031,"Itabira",3,"Sudeste",1,"315720",3,31,5,26,11,20,0,0,0,0,0,31,5,26,11,20,17,10.1974231558409,10.3610389738426,0.394566074359617,31
"8115","MG","Santa Bárbara",31604,26833.95,31031,"Itabira",3,"Sudeste",1,"315720",4,23,1,22,8,15,0,0,0,0,0,23,1,22,8,15,6,10.1974231558409,10.3610389738426,0.426976319215333,30
"8116","MG","Santa Bárbara",31604,26833.95,31031,"Itabira",3,"Sudeste",1,"315720",5,35,6,29,9,26,0,0,0,0,0,35,6,29,9,26,13,10.1974231558409,10.3610389738426,0.408048449613332,31
"8117","MG","Santa Cruz de Minas",8664,10772.82,31058,"São João Del Rei",3,"Sudeste",1,"315733",2,2,1,1,0,2,0,0,0,0,0,2,1,1,0,2,3,9.28478157431684,9.06693178868083,0.303582984106889,29
"8118","MG","Santa Cruz de Minas",8664,10772.82,31058,"São João Del Rei",3,"Sudeste",1,"315733",3,5,3,2,3,2,0,0,0,0,0,5,3,2,3,2,6,9.28478157431684,9.06693178868083,0.433268702468953,31
"8119","MG","Santa Cruz de Minas",8664,10772.82,31058,"São João Del Rei",3,"Sudeste",1,"315733",4,7,1,6,5,2,0,0,0,0,0,7,1,6,5,2,2,9.28478157431684,9.06693178868083,0.463249747657363,30
"8120","MG","Santa Cruz de Minas",8664,10772.82,31058,"São João Del Rei",3,"Sudeste",1,"315733",5,5,2,3,4,1,0,0,0,0,0,5,2,3,4,1,8,9.28478157431684,9.06693178868083,0.446083615046992,31
"8121","MG","Santa Juliana",14255,55902.26,31023,"Araxá",3,"Sudeste",0,"315770",2,15,6,9,8,7,0,0,0,0,0,15,6,9,8,7,8,10.931360087664,9.56486300134677,0.328988859093595,29
"8122","MG","Santa Juliana",14255,55902.26,31023,"Araxá",3,"Sudeste",0,"315770",3,13,6,7,7,6,0,0,0,0,0,13,6,7,7,6,8,10.931360087664,9.56486300134677,0.403009623278158,31
"8123","MG","Santa Juliana",14255,55902.26,31023,"Araxá",3,"Sudeste",0,"315770",4,15,2,13,6,9,0,0,0,0,0,15,2,13,6,9,1,10.931360087664,9.56486300134677,0.406534400794179,30
"8124","MG","Santa Juliana",14255,55902.26,31023,"Araxá",3,"Sudeste",0,"315770",5,15,4,11,7,8,0,0,0,0,0,15,4,11,7,8,9,10.931360087664,9.56486300134677,0.401439107101936,31
"8125","MG","Santa Luzia",220444,18272.1,31030,"Belo Horizonte",3,"Sudeste",1,"315780",2,210,35,175,79,131,2,0,2,0,2,212,35,177,79,133,108,9.8131305852954,12.3033989733597,0.291617770900182,29
"8126","MG","Santa Luzia",220444,18272.1,31030,"Belo Horizonte",3,"Sudeste",1,"315780",3,248,37,211,98,150,2,1,1,0,2,250,38,212,98,152,117,9.8131305852954,12.3033989733597,0.385530151140592,31
"8127","MG","Santa Luzia",220444,18272.1,31030,"Belo Horizonte",3,"Sudeste",1,"315780",4,238,41,197,87,151,3,0,3,0,3,241,41,200,87,154,96,9.8131305852954,12.3033989733597,0.440024198856008,30
"8128","MG","Santa Luzia",220444,18272.1,31030,"Belo Horizonte",3,"Sudeste",1,"315780",5,270,52,218,91,179,3,2,1,0,3,273,54,219,91,182,113,9.8131305852954,12.3033989733597,0.392540930877152,31
"8129","MG","Santa Margarida",16302,16369.37,31061,"Manhuaçu",3,"Sudeste",0,"315790",2,15,4,11,7,8,0,0,0,0,0,15,4,11,7,8,6,9.70316718459102,9.6990430786544,0.343637487652702,29
"8130","MG","Santa Margarida",16302,16369.37,31061,"Manhuaçu",3,"Sudeste",0,"315790",3,17,4,13,8,9,0,0,0,0,0,17,4,13,8,9,9,9.70316718459102,9.6990430786544,0.415170325890214,31
"8131","MG","Santa Margarida",16302,16369.37,31061,"Manhuaçu",3,"Sudeste",0,"315790",4,13,4,9,7,6,0,0,0,0,0,13,4,9,7,6,6,9.70316718459102,9.6990430786544,0.434259898707572,30
"8132","MG","Santa Margarida",16302,16369.37,31061,"Manhuaçu",3,"Sudeste",0,"315790",5,13,5,8,8,5,0,0,0,0,0,13,5,8,8,5,9,9.70316718459102,9.6990430786544,0.455646009134242,31
"8133","MG","Santa Maria de Itabira",10857,15053.07,31031,"Itabira",3,"Sudeste",0,"315800",2,9,3,6,4,5,0,0,0,0,0,9,3,6,4,5,2,9.61933723608552,9.29256531223185,0.28525345298227,29
"8134","MG","Santa Maria de Itabira",10857,15053.07,31031,"Itabira",3,"Sudeste",0,"315800",3,9,2,7,1,8,0,0,0,0,0,9,2,7,1,8,5,9.61933723608552,9.29256531223185,0.361360955843046,31
"8135","MG","Santa Maria de Itabira",10857,15053.07,31031,"Itabira",3,"Sudeste",0,"315800",4,6,0,6,3,3,0,0,0,0,0,6,0,6,3,3,10,9.61933723608552,9.29256531223185,0.426533570968612,30
"8136","MG","Santa Maria de Itabira",10857,15053.07,31031,"Itabira",3,"Sudeste",0,"315800",5,10,0,10,4,6,0,0,0,0,0,10,0,10,4,6,3,9.61933723608552,9.29256531223185,0.399758942384115,31
"8137","MG","Santa Maria do Suaçuí",14611,9499.6,31036,"Peçanha",3,"Sudeste",0,"315820",2,15,7,8,11,4,0,0,0,0,0,15,7,8,11,4,8,9.15900497143902,9.58952994867208,0.316355926778223,29
"8138","MG","Santa Maria do Suaçuí",14611,9499.6,31036,"Peçanha",3,"Sudeste",0,"315820",3,10,1,9,0,10,0,0,0,0,0,10,1,9,0,10,7,9.15900497143902,9.58952994867208,0.381252819946418,31
"8139","MG","Santa Maria do Suaçuí",14611,9499.6,31036,"Peçanha",3,"Sudeste",0,"315820",4,12,3,9,4,8,0,0,0,0,0,12,3,9,4,8,6,9.15900497143902,9.58952994867208,0.393825489595568,30
"8140","MG","Santa Maria do Suaçuí",14611,9499.6,31036,"Peçanha",3,"Sudeste",0,"315820",5,15,5,10,3,12,0,0,0,0,0,15,5,10,3,12,3,9.15900497143902,9.58952994867208,0.376671929333519,31
"8141","MG","Santana da Vargem",7073,19230.58,31050,"Varginha",3,"Sudeste",0,"315830",2,8,1,7,2,6,0,0,0,0,0,8,1,7,2,6,4,9.86425699933443,8.86403999703599,0.285928827747269,29
"8142","MG","Santana da Vargem",7073,19230.58,31050,"Varginha",3,"Sudeste",0,"315830",3,3,0,3,1,2,0,0,0,0,0,3,0,3,1,2,1,9.86425699933443,8.86403999703599,0.362384721882726,31
"8143","MG","Santana da Vargem",7073,19230.58,31050,"Varginha",3,"Sudeste",0,"315830",4,8,1,7,4,4,0,0,0,0,0,8,1,7,4,4,3,9.86425699933443,8.86403999703599,0.406850508686297,30
"8144","MG","Santana da Vargem",7073,19230.58,31050,"Varginha",3,"Sudeste",0,"315830",5,7,0,7,2,5,0,0,0,0,0,7,0,7,2,5,1,9.86425699933443,8.86403999703599,0.381112126139728,31
"8145","MG","Santana do Paraíso",35369,19077.44,31039,"Ipatinga",3,"Sudeste",1,"315895",2,53,6,47,10,43,1,0,1,1,0,54,6,48,11,43,17,9.85626176409266,10.4735910092525,0.315946984089872,29
"8146","MG","Santana do Paraíso",35369,19077.44,31039,"Ipatinga",3,"Sudeste",1,"315895",3,70,7,63,27,43,0,0,0,0,0,70,7,63,27,43,12,9.85626176409266,10.4735910092525,0.418995944255225,31
"8147","MG","Santana do Paraíso",35369,19077.44,31039,"Ipatinga",3,"Sudeste",1,"315895",4,59,7,52,13,46,0,0,0,0,0,59,7,52,13,46,17,9.85626176409266,10.4735910092525,0.444613285541444,30
"8148","MG","Santana do Paraíso",35369,19077.44,31039,"Ipatinga",3,"Sudeste",1,"315895",5,88,12,76,24,64,2,0,2,1,1,90,12,78,25,65,11,9.85626176409266,10.4735910092525,0.397830048915077,31
"8149","MG","Santana do Riacho",4315,14824.43,31027,"Sete Lagoas",3,"Sudeste",0,"315900",2,5,3,2,0,5,0,0,0,0,0,5,3,2,0,5,7,9.60403177456015,8.36985260351753,0.336877055763338,29
"8150","MG","Santana do Riacho",4315,14824.43,31027,"Sete Lagoas",3,"Sudeste",0,"315900",3,3,1,2,2,1,1,0,1,0,1,4,1,3,2,2,1,9.60403177456015,8.36985260351753,0.406362286314035,31
"8151","MG","Santana do Riacho",4315,14824.43,31027,"Sete Lagoas",3,"Sudeste",0,"315900",4,6,2,4,3,3,0,0,0,0,0,6,2,4,3,3,0,9.60403177456015,8.36985260351753,0.467707080153585,30
"8152","MG","Santana do Riacho",4315,14824.43,31027,"Sete Lagoas",3,"Sudeste",0,"315900",5,5,1,4,1,4,0,0,0,0,0,5,1,4,1,4,3,9.60403177456015,8.36985260351753,0.432604502306783,31
"8153","MG","Santa Rita de Caldas",8924,17534.41,31051,"Poços de Caldas",3,"Sudeste",0,"315920",2,4,1,3,2,2,0,0,0,0,0,4,1,3,2,2,8,9.77192051501648,9.09649955555242,0.317262990560797,29
"8154","MG","Santa Rita de Caldas",8924,17534.41,31051,"Poços de Caldas",3,"Sudeste",0,"315920",3,8,2,6,4,4,0,0,0,0,0,8,2,6,4,4,5,9.77192051501648,9.09649955555242,0.415655439571225,31
"8155","MG","Santa Rita de Caldas",8924,17534.41,31051,"Poços de Caldas",3,"Sudeste",0,"315920",4,6,2,4,1,5,0,0,0,0,0,6,2,4,1,5,9,9.77192051501648,9.09649955555242,0.41866696459054,30
"8156","MG","Santa Rita de Caldas",8924,17534.41,31051,"Poços de Caldas",3,"Sudeste",0,"315920",5,4,0,4,0,4,0,0,0,0,0,4,0,4,0,4,9,9.77192051501648,9.09649955555242,0.397902885026139,31
"8157","MG","Santa Rita do Sapucaí",43753,34369.18,31053,"Santa Rita do Sapucaí",3,"Sudeste",1,"315960",2,33,4,29,7,26,0,0,0,0,0,33,4,29,7,26,10,10.4449155115436,10.6863154608634,0.291366618063621,29
"8158","MG","Santa Rita do Sapucaí",43753,34369.18,31053,"Santa Rita do Sapucaí",3,"Sudeste",1,"315960",3,31,7,24,8,23,0,0,0,0,0,31,7,24,8,23,19,10.4449155115436,10.6863154608634,0.374905191782445,31
"8159","MG","Santa Rita do Sapucaí",43753,34369.18,31053,"Santa Rita do Sapucaí",3,"Sudeste",1,"315960",4,51,9,42,20,31,0,0,0,0,0,51,9,42,20,31,14,10.4449155115436,10.6863154608634,0.439083210065235,30
"8160","MG","Santa Rita do Sapucaí",43753,34369.18,31053,"Santa Rita do Sapucaí",3,"Sudeste",1,"315960",5,36,9,27,10,26,0,0,0,0,0,36,9,27,10,26,24,10.4449155115436,10.6863154608634,0.383734620708332,31
"8161","MG","Santa Vitória",19872,68299.27,31017,"Ituiutaba",3,"Sudeste",0,"315980",2,15,2,13,6,9,0,0,0,0,0,15,2,13,6,9,10,11.1316543573612,9.89706698473321,0.27888954139692,29
"8162","MG","Santa Vitória",19872,68299.27,31017,"Ituiutaba",3,"Sudeste",0,"315980",3,13,3,10,5,8,0,0,0,0,0,13,3,10,5,8,12,11.1316543573612,9.89706698473321,0.370221253163666,31
"8163","MG","Santa Vitória",19872,68299.27,31017,"Ituiutaba",3,"Sudeste",0,"315980",4,19,1,18,6,13,1,0,1,1,0,20,1,19,7,13,12,11.1316543573612,9.89706698473321,0.390823042844159,30
"8164","MG","Santa Vitória",19872,68299.27,31017,"Ituiutaba",3,"Sudeste",0,"315980",5,23,2,21,11,12,1,0,1,0,1,24,2,22,11,13,11,11.1316543573612,9.89706698473321,0.357566322612376,31
"8165","MG","Santo Antônio do Amparo",18613,15431.54,31046,"Oliveira",3,"Sudeste",1,"315990",2,11,2,9,3,8,0,0,0,0,0,11,2,9,3,8,4,9.64416874595052,9.83161554029833,0.288205594276709,29
"8166","MG","Santo Antônio do Amparo",18613,15431.54,31046,"Oliveira",3,"Sudeste",1,"315990",3,11,1,10,6,5,0,0,0,0,0,11,1,10,6,5,9,9.64416874595052,9.83161554029833,0.33746268425604,31
"8167","MG","Santo Antônio do Amparo",18613,15431.54,31046,"Oliveira",3,"Sudeste",1,"315990",4,12,1,11,4,8,0,0,0,0,0,12,1,11,4,8,9,9.64416874595052,9.83161554029833,0.358299623384663,30
"8168","MG","Santo Antônio do Amparo",18613,15431.54,31046,"Oliveira",3,"Sudeste",1,"315990",5,16,1,15,4,12,0,0,0,0,0,16,1,15,4,12,12,9.64416874595052,9.83161554029833,0.381278082111961,31
"8169","MG","Santo Antônio do Jacinto",11604,7582.83,31014,"Almenara",3,"Sudeste",0,"316030",2,4,1,3,2,2,0,0,0,0,0,4,1,3,2,2,9,8.93364175988179,9.35910514524129,0.289045621041268,29
"8170","MG","Santo Antônio do Jacinto",11604,7582.83,31014,"Almenara",3,"Sudeste",0,"316030",3,2,0,2,2,0,0,0,0,0,0,2,0,2,2,0,9,8.93364175988179,9.35910514524129,0.361629231031338,31
"8171","MG","Santo Antônio do Jacinto",11604,7582.83,31014,"Almenara",3,"Sudeste",0,"316030",4,0,0,0,0,0,0,0,0,0,0,0,0,0,0,0,4,8.93364175988179,9.35910514524129,0.369921368092951,30
"8172","MG","Santo Antônio do Jacinto",11604,7582.83,31014,"Almenara",3,"Sudeste",0,"316030",5,0,0,0,0,0,0,0,0,0,0,0,0,0,0,0,4,8.93364175988179,9.35910514524129,0.409261253177085,31
"8173","MG","Santo Antônio do Monte",28427,20489.23,31043,"Divinópolis",3,"Sudeste",1,"316040",2,29,6,23,6,23,0,0,0,0,0,29,6,23,6,23,9,9.92765466121985,10.2550946767416,0.276751370131284,29
"8174","MG","Santo Antônio do Monte",28427,20489.23,31043,"Divinópolis",3,"Sudeste",1,"316040",3,26,8,18,9,17,0,0,0,0,0,26,8,18,9,17,10,9.92765466121985,10.2550946767416,0.34061032631234,31
"8175","MG","Santo Antônio do Monte",28427,20489.23,31043,"Divinópolis",3,"Sudeste",1,"316040",4,31,9,22,10,21,0,0,0,0,0,31,9,22,10,21,16,9.92765466121985,10.2550946767416,0.362024647655152,30
"8176","MG","Santo Antônio do Monte",28427,20489.23,31043,"Divinópolis",3,"Sudeste",1,"316040",5,33,6,27,12,21,0,0,0,0,0,33,6,27,12,21,13,9.92765466121985,10.2550946767416,0.336816725569402,31
"8177","MG","Santos Dumont",46421,20163.48,31065,"Juiz de Fora",3,"Sudeste",1,"316070",2,38,5,33,12,26,0,0,0,0,0,38,5,33,12,26,27,9.91162832633597,10.745507222035,0.331025184362039,29
"8178","MG","Santos Dumont",46421,20163.48,31065,"Juiz de Fora",3,"Sudeste",1,"316070",3,24,5,19,9,15,0,0,0,0,0,24,5,19,9,15,28,9.91162832633597,10.745507222035,0.41579506177271,31
"8179","MG","Santos Dumont",46421,20163.48,31065,"Juiz de Fora",3,"Sudeste",1,"316070",4,30,9,21,12,18,0,0,0,0,0,30,9,21,12,18,22,9.91162832633597,10.745507222035,0.474089656869254,30
"8180","MG","Santos Dumont",46421,20163.48,31065,"Juiz de Fora",3,"Sudeste",1,"316070",5,36,9,27,15,21,1,0,1,0,1,37,9,28,15,22,26,9.91162832633597,10.745507222035,0.436722219837552,31
"8181","MG","São Brás do Suaçuí",3754,14594.01,31034,"Conselheiro Lafaiete",3,"Sudeste",1,"316090",2,0,0,0,0,0,0,0,0,0,0,0,0,0,0,0,3,9.58836644953843,8.23057721714645,0.237335315896999,29
"8182","MG","São Brás do Suaçuí",3754,14594.01,31034,"Conselheiro Lafaiete",3,"Sudeste",1,"316090",3,1,1,0,0,1,0,0,0,0,0,1,1,0,0,1,6,9.58836644953843,8.23057721714645,0.330150953618129,31
"8183","MG","São Brás do Suaçuí",3754,14594.01,31034,"Conselheiro Lafaiete",3,"Sudeste",1,"316090",4,3,0,3,2,1,0,0,0,0,0,3,0,3,2,1,3,9.58836644953843,8.23057721714645,0.390166096422656,30
"8184","MG","São Brás do Suaçuí",3754,14594.01,31034,"Conselheiro Lafaiete",3,"Sudeste",1,"316090",5,1,0,1,0,1,0,0,0,0,0,1,0,1,0,1,3,9.58836644953843,8.23057721714645,0.34903796062337,31
"8185","MG","São Domingos do Prata",17327,14477.39,31031,"Itabira",3,"Sudeste",0,"316100",2,15,5,10,3,12,0,0,0,0,0,15,5,10,3,12,7,9.58034340107419,9.76002125751085,0.293227737626205,29
"8186","MG","São Domingos do Prata",17327,14477.39,31031,"Itabira",3,"Sudeste",0,"316100",3,8,1,7,3,5,0,0,0,0,0,8,1,7,3,5,13,9.58034340107419,9.76002125751085,0.375869116861946,31
"8187","MG","São Domingos do Prata",17327,14477.39,31031,"Itabira",3,"Sudeste",0,"316100",4,12,3,9,3,9,0,0,0,0,0,12,3,9,3,9,15,9.58034340107419,9.76002125751085,0.413872287208245,30
"8188","MG","São Domingos do Prata",17327,14477.39,31031,"Itabira",3,"Sudeste",0,"316100",5,12,4,8,3,9,0,0,0,0,0,12,4,8,3,9,21,9.58034340107419,9.76002125751085,0.390543082048049,31
"8189","MG","São Francisco",56477,8995.29,31003,"Januária",3,"Sudeste",1,"316110",2,48,11,37,17,31,0,0,0,0,0,48,11,37,17,31,26,9.10445638599834,10.9415887546091,0.305297125782655,29
"8190","MG","São Francisco",56477,8995.29,31003,"Januária",3,"Sudeste",1,"316110",3,55,19,36,23,32,2,1,1,0,2,57,20,37,23,34,24,9.10445638599834,10.9415887546091,0.389303583676969,31
"8191","MG","São Francisco",56477,8995.29,31003,"Januária",3,"Sudeste",1,"316110",4,54,16,38,21,33,0,0,0,0,0,54,16,38,21,33,30,9.10445638599834,10.9415887546091,0.410631597360783,30
"8192","MG","São Francisco",56477,8995.29,31003,"Januária",3,"Sudeste",1,"316110",5,55,12,43,24,31,2,2,0,1,1,57,14,43,25,32,28,9.10445638599834,10.9415887546091,0.380511076807841,31
"8193","MG","São Francisco de Paula",6520,15103.39,31046,"Oliveira",3,"Sudeste",0,"316120",2,8,2,6,2,6,1,0,1,1,0,9,2,7,3,6,6,9.62267450091718,8.7826296549207,0.33268506372365,29
"8194","MG","São Francisco de Paula",6520,15103.39,31046,"Oliveira",3,"Sudeste",0,"316120",3,5,0,5,1,4,0,0,0,0,0,5,0,5,1,4,5,9.62267450091718,8.7826296549207,0.422853252349173,31
"8195","MG","São Francisco de Paula",6520,15103.39,31046,"Oliveira",3,"Sudeste",0,"316120",4,5,1,4,1,4,1,0,1,0,1,6,1,5,1,5,3,9.62267450091718,8.7826296549207,0.440947253817228,30
"8196","MG","São Francisco de Paula",6520,15103.39,31046,"Oliveira",3,"Sudeste",0,"316120",5,4,0,4,1,3,0,0,0,0,0,4,0,4,1,3,1,9.62267450091718,8.7826296549207,0.411193832092242,31
"8197","MG","São Geraldo",12562,16451.74,31064,"Ubá",3,"Sudeste",0,"316150",2,7,5,2,5,2,0,0,0,0,0,7,5,2,5,2,6,9.70818652567572,9.43843166301433,0.30364664459873,29
"8198","MG","São Geraldo",12562,16451.74,31064,"Ubá",3,"Sudeste",0,"316150",3,6,1,5,1,5,0,0,0,0,0,6,1,5,1,5,4,9.70818652567572,9.43843166301433,0.405377427229169,31
"8199","MG","São Geraldo",12562,16451.74,31064,"Ubá",3,"Sudeste",0,"316150",4,9,3,6,2,7,0,0,0,0,0,9,3,6,2,7,5,9.70818652567572,9.43843166301433,0.453664608341195,30
"8200","MG","São Geraldo",12562,16451.74,31064,"Ubá",3,"Sudeste",0,"316150",5,11,4,7,5,6,0,0,0,0,0,11,4,7,5,6,5,9.70818652567572,9.43843166301433,0.446175940314066,31
"8201","MG","São Gonçalo do Abaeté",8459,32932.42,31002,"Paracatu",3,"Sudeste",0,"316170",2,5,1,4,3,2,0,0,0,0,0,5,1,4,3,2,0,10.4022128618898,9.04298624230401,0.310055267629317,29
"8202","MG","São Gonçalo do Abaeté",8459,32932.42,31002,"Paracatu",3,"Sudeste",0,"316170",3,5,0,5,1,4,1,0,1,1,0,6,0,6,2,4,2,10.4022128618898,9.04298624230401,0.381506622106711,31
"8203","MG","São Gonçalo do Abaeté",8459,32932.42,31002,"Paracatu",3,"Sudeste",0,"316170",4,5,1,4,3,2,0,0,0,0,0,5,1,4,3,2,1,10.4022128618898,9.04298624230401,0.405732421010941,30
"8204","MG","São Gonçalo do Abaeté",8459,32932.42,31002,"Paracatu",3,"Sudeste",0,"316170",5,6,0,6,6,0,0,0,0,0,0,6,0,6,6,0,2,10.4022128618898,9.04298624230401,0.376846171289345,31
"8205","MG","São Gonçalo do Pará",12597,19992.67,31043,"Divinópolis",3,"Sudeste",0,"316180",2,7,2,5,1,6,0,0,0,0,0,7,2,5,1,6,5,9.90312098535859,9.4412139693523,0.28945492005516,29
"8206","MG","São Gonçalo do Pará",12597,19992.67,31043,"Divinópolis",3,"Sudeste",0,"316180",3,5,0,5,0,5,0,0,0,0,0,5,0,5,0,5,5,9.90312098535859,9.4412139693523,0.382132344605545,31
"8207","MG","São Gonçalo do Pará",12597,19992.67,31043,"Divinópolis",3,"Sudeste",0,"316180",4,11,1,10,4,7,0,0,0,0,0,11,1,10,4,7,5,9.90312098535859,9.4412139693523,0.417978638506397,30
"8208","MG","São Gonçalo do Pará",12597,19992.67,31043,"Divinópolis",3,"Sudeste",0,"316180",5,13,1,12,4,9,0,0,0,0,0,13,1,12,4,9,5,9.90312098535859,9.4412139693523,0.377866958156889,31
"8209","MG","São Gonçalo do Rio Abaixo",11019,337288.81,31031,"Itabira",3,"Sudeste",0,"316190",2,13,3,10,2,11,0,0,0,0,0,13,3,10,2,11,4,12.7286948452845,9.30737633448778,0.28124002174295,29
"8210","MG","São Gonçalo do Rio Abaixo",11019,337288.81,31031,"Itabira",3,"Sudeste",0,"316190",3,12,3,9,6,6,0,0,0,0,0,12,3,9,6,6,6,12.7286948452845,9.30737633448778,0.39215931810198,31
"8211","MG","São Gonçalo do Rio Abaixo",11019,337288.81,31031,"Itabira",3,"Sudeste",0,"316190",4,8,1,7,3,5,0,0,0,0,0,8,1,7,3,5,5,12.7286948452845,9.30737633448778,0.425376784092406,30
"8212","MG","São Gonçalo do Rio Abaixo",11019,337288.81,31031,"Itabira",3,"Sudeste",0,"316190",5,12,5,7,6,6,0,0,0,0,0,12,5,7,6,6,7,12.7286948452845,9.30737633448778,0.401782190966954,31
"8213","MG","São Gonçalo do Sapucaí",25561,24300.45,31053,"Santa Rita do Sapucaí",3,"Sudeste",1,"316200",2,17,5,12,7,10,0,0,0,0,0,17,5,12,7,10,12,10.0982501476757,10.1488230313568,0.314587773788398,29
"8214","MG","São Gonçalo do Sapucaí",25561,24300.45,31053,"Santa Rita do Sapucaí",3,"Sudeste",1,"316200",3,29,8,21,10,19,0,0,0,0,0,29,8,21,10,19,20,10.0982501476757,10.1488230313568,0.385974918358618,31
"8215","MG","São Gonçalo do Sapucaí",25561,24300.45,31053,"Santa Rita do Sapucaí",3,"Sudeste",1,"316200",4,20,7,13,3,17,1,0,1,0,1,21,7,14,3,18,17,10.0982501476757,10.1488230313568,0.411355010764505,30
"8216","MG","São Gonçalo do Sapucaí",25561,24300.45,31053,"Santa Rita do Sapucaí",3,"Sudeste",1,"316200",5,26,5,21,12,14,0,0,0,0,0,26,5,21,12,14,16,10.0982501476757,10.1488230313568,0.375227178774719,31
"8217","MG","São Gotardo",35782,23553.3,31020,"Patos de Minas",3,"Sudeste",1,"316210",2,50,23,27,19,31,2,0,2,0,2,52,23,29,19,33,15,10.0670212170162,10.4852002526498,0.325106921287855,29
"8218","MG","São Gotardo",35782,23553.3,31020,"Patos de Minas",3,"Sudeste",1,"316210",3,37,9,28,14,23,1,1,0,1,0,38,10,28,15,23,13,10.0670212170162,10.4852002526498,0.376999857920171,31
"8219","MG","São Gotardo",35782,23553.3,31020,"Patos de Minas",3,"Sudeste",1,"316210",4,47,18,29,16,31,1,0,1,0,1,48,18,30,16,32,16,10.0670212170162,10.4852002526498,0.385145166920263,30
"8220","MG","São Gotardo",35782,23553.3,31020,"Patos de Minas",3,"Sudeste",1,"316210",5,56,21,35,24,32,0,0,0,0,0,56,21,35,24,32,21,10.0670212170162,10.4852002526498,0.379884591175927,31
"8221","MG","São João Batista do Glória",7498,19889.43,31047,"Passos",3,"Sudeste",0,"316220",2,9,4,5,3,6,1,0,1,0,1,10,4,6,3,7,5,9.89794371382049,8.92239159729586,0.277240571543506,29
"8222","MG","São João Batista do Glória",7498,19889.43,31047,"Passos",3,"Sudeste",0,"316220",3,3,0,3,0,3,0,0,0,0,0,3,0,3,0,3,5,9.89794371382049,8.92239159729586,0.351890757435822,31
"8223","MG","São João Batista do Glória",7498,19889.43,31047,"Passos",3,"Sudeste",0,"316220",4,11,2,9,6,5,0,0,0,0,0,11,2,9,6,5,2,9.89794371382049,8.92239159729586,0.409018813694043,30
"8224","MG","São João Batista do Glória",7498,19889.43,31047,"Passos",3,"Sudeste",0,"316220",5,11,2,9,5,6,0,0,0,0,0,11,2,9,5,6,3,9.89794371382049,8.92239159729586,0.376206840191702,31
"8225","MG","São João da Ponte",25098,7861.66,31007,"Montes Claros",3,"Sudeste",0,"316240",2,19,4,15,10,9,0,0,0,0,0,19,4,15,10,9,13,8.96975305905328,10.1305434406703,0.281299877386142,29
"8226","MG","São João da Ponte",25098,7861.66,31007,"Montes Claros",3,"Sudeste",0,"316240",3,17,8,9,5,12,1,0,1,0,1,18,8,10,5,13,12,8.96975305905328,10.1305434406703,0.353138859996543,31
"8227","MG","São João da Ponte",25098,7861.66,31007,"Montes Claros",3,"Sudeste",0,"316240",4,30,5,25,10,20,0,0,0,0,0,30,5,25,10,20,17,8.96975305905328,10.1305434406703,0.40523995342315,30
"8228","MG","São João da Ponte",25098,7861.66,31007,"Montes Claros",3,"Sudeste",0,"316240",5,21,9,12,9,12,0,0,0,0,0,21,9,12,9,12,16,8.96975305905328,10.1305434406703,0.364195313022838,31
"8229","MG","São João del Rei",90497,23958.57,31058,"São João Del Rei",3,"Sudeste",1,"316250",2,67,11,56,25,42,1,1,0,1,0,68,12,56,26,42,54,10.0840813676436,11.4130719799673,0.32142763385576,29
"8230","MG","São João del Rei",90497,23958.57,31058,"São João Del Rei",3,"Sudeste",1,"316250",3,82,7,75,22,60,0,0,0,0,0,82,7,75,22,60,70,10.0840813676436,11.4130719799673,0.430792530665121,31
"8231","MG","São João del Rei",90497,23958.57,31058,"São João Del Rei",3,"Sudeste",1,"316250",4,51,8,43,16,35,0,0,0,0,0,51,8,43,16,35,42,10.0840813676436,11.4130719799673,0.496287867386865,30
"8232","MG","São João del Rei",90497,23958.57,31058,"São João Del Rei",3,"Sudeste",1,"316250",5,91,17,74,37,54,0,0,0,0,0,91,17,74,37,54,60,10.0840813676436,11.4130719799673,0.459462196212083,31
"8233","MG","São João do Manhuaçu",11674,10132.18,31061,"Manhuaçu",3,"Sudeste",0,"316255",2,12,4,8,5,7,0,0,0,0,0,12,4,8,5,7,6,9.22347177645922,9.36511942576374,0.345251619346493,29
"8234","MG","São João do Manhuaçu",11674,10132.18,31061,"Manhuaçu",3,"Sudeste",0,"316255",3,10,6,4,6,4,0,0,0,0,0,10,6,4,6,4,0,9.22347177645922,9.36511942576374,0.413343027355996,31
"8235","MG","São João do Manhuaçu",11674,10132.18,31061,"Manhuaçu",3,"Sudeste",0,"316255",4,11,3,8,3,8,0,0,0,0,0,11,3,8,3,8,3,9.22347177645922,9.36511942576374,0.415568955814569,30
"8236","MG","São João do Manhuaçu",11674,10132.18,31061,"Manhuaçu",3,"Sudeste",0,"316255",5,10,3,7,1,9,0,0,0,0,0,10,3,7,1,9,5,9.22347177645922,9.36511942576374,0.409397456627844,31
"8237","MG","São João do Paraíso",23709,9179.02,31005,"Salinas",3,"Sudeste",0,"316270",2,21,2,19,2,19,0,0,0,0,0,21,2,19,2,19,13,9.12467572410331,10.0736100018731,0.260068625771712,29
"8238","MG","São João do Paraíso",23709,9179.02,31005,"Salinas",3,"Sudeste",0,"316270",3,22,3,19,11,11,0,0,0,0,0,22,3,19,11,11,15,9.12467572410331,10.0736100018731,0.363972374039542,31
"8239","MG","São João do Paraíso",23709,9179.02,31005,"Salinas",3,"Sudeste",0,"316270",4,27,4,23,12,15,0,0,0,0,0,27,4,23,12,15,13,9.12467572410331,10.0736100018731,0.378044581756786,30
"8240","MG","São João do Paraíso",23709,9179.02,31005,"Salinas",3,"Sudeste",0,"316270",5,13,4,9,5,8,1,1,0,0,1,14,5,9,5,9,12,9.12467572410331,10.0736100018731,0.363069405827437,31
"8241","MG","São João Evangelista",15767,10810.67,31035,"Guanhães",3,"Sudeste",0,"316280",2,19,7,12,7,12,0,0,0,0,0,19,7,12,7,12,12,9.28828888836107,9.66567442723748,0.288789412996028,29
"8242","MG","São João Evangelista",15767,10810.67,31035,"Guanhães",3,"Sudeste",0,"316280",3,10,1,9,6,4,0,0,0,0,0,10,1,9,6,4,13,9.28828888836107,9.66567442723748,0.380349701552855,31
"8243","MG","São João Evangelista",15767,10810.67,31035,"Guanhães",3,"Sudeste",0,"316280",4,15,4,11,6,9,0,0,0,0,0,15,4,11,6,9,10,9.28828888836107,9.66567442723748,0.447894845430699,30
"8244","MG","São João Evangelista",15767,10810.67,31035,"Guanhães",3,"Sudeste",0,"316280",5,19,7,12,6,13,0,0,0,0,0,19,7,12,6,13,15,9.28828888836107,9.66567442723748,0.397080838124041,31
"8245","MG","São João Nepomuceno",26447,15048.38,31065,"Juiz de Fora",3,"Sudeste",1,"316290",2,21,9,12,6,15,1,1,0,0,1,22,10,12,6,16,16,9.61902562318728,10.1828980093036,0.310997533646783,29
"8246","MG","São João Nepomuceno",26447,15048.38,31065,"Juiz de Fora",3,"Sudeste",1,"316290",3,24,10,14,13,11,0,0,0,0,0,24,10,14,13,11,15,9.61902562318728,10.1828980093036,0.392112640802805,31
"8247","MG","São João Nepomuceno",26447,15048.38,31065,"Juiz de Fora",3,"Sudeste",1,"316290",4,28,11,17,8,20,0,0,0,0,0,28,11,17,8,20,14,9.61902562318728,10.1828980093036,0.462228187447367,30
"8248","MG","São João Nepomuceno",26447,15048.38,31065,"Juiz de Fora",3,"Sudeste",1,"316290",5,20,10,10,11,9,0,0,0,0,0,20,10,10,11,9,28,9.61902562318728,10.1828980093036,0.438543178425612,31
"8249","MG","São Joaquim de Bicas",32148,20150.18,31030,"Belo Horizonte",3,"Sudeste",1,"316292",2,32,7,25,15,17,1,0,1,1,0,33,7,26,16,17,17,9.91096850033741,10.3781055193326,0.318084370531364,29
"8250","MG","São Joaquim de Bicas",32148,20150.18,31030,"Belo Horizonte",3,"Sudeste",1,"316292",3,37,7,30,14,23,0,0,0,0,0,37,7,30,14,23,18,9.91096850033741,10.3781055193326,0.400436774173105,31
"8251","MG","São Joaquim de Bicas",32148,20150.18,31030,"Belo Horizonte",3,"Sudeste",1,"316292",4,30,6,24,12,18,0,0,0,0,0,30,6,24,12,18,7,9.91096850033741,10.3781055193326,0.431955364721105,30
"8252","MG","São Joaquim de Bicas",32148,20150.18,31030,"Belo Horizonte",3,"Sudeste",1,"316292",5,36,9,27,11,25,0,0,0,0,0,36,9,27,11,25,14,9.91096850033741,10.3781055193326,0.398144881063273,31
"8253","MG","São José da Barra",7480,75480.47,31047,"Passos",3,"Sudeste",0,"316294",2,6,2,4,1,5,0,0,0,0,0,6,2,4,1,5,1,11.2316292262781,8.91998807096852,0.327367848621629,29
"8254","MG","São José da Barra",7480,75480.47,31047,"Passos",3,"Sudeste",0,"316294",3,8,4,4,2,6,0,0,0,0,0,8,4,4,2,6,4,11.2316292262781,8.91998807096852,0.403959827268078,31
"8255","MG","São José da Barra",7480,75480.47,31047,"Passos",3,"Sudeste",0,"316294",4,13,1,12,5,8,0,0,0,0,0,13,1,12,5,8,1,11.2316292262781,8.91998807096852,0.444491550455944,30
"8256","MG","São José da Barra",7480,75480.47,31047,"Passos",3,"Sudeste",0,"316294",5,9,4,5,4,5,1,0,1,0,1,10,4,6,4,6,4,11.2316292262781,8.91998807096852,0.419863204422523,31
"8257","MG","São José da Lapa",24135,20297.82,31030,"Belo Horizonte",3,"Sudeste",1,"316295",2,27,4,23,8,19,1,0,1,0,1,28,4,24,8,20,12,9.91826877010069,10.0914183480946,0.296932389281103,29
"8258","MG","São José da Lapa",24135,20297.82,31030,"Belo Horizonte",3,"Sudeste",1,"316295",3,32,0,32,8,24,2,0,2,0,2,34,0,34,8,26,8,9.91826877010069,10.0914183480946,0.379828116926614,31
"8259","MG","São José da Lapa",24135,20297.82,31030,"Belo Horizonte",3,"Sudeste",1,"316295",4,26,5,21,7,19,0,0,0,0,0,26,5,21,7,19,8,9.91826877010069,10.0914183480946,0.432851233317924,30
"8260","MG","São José da Lapa",24135,20297.82,31030,"Belo Horizonte",3,"Sudeste",1,"316295",5,27,1,26,8,19,0,0,0,0,0,27,1,26,8,19,9,9.91826877010069,10.0914183480946,0.385210343180007,31
"8261","MG","São Lourenço",46202,22953.42,31054,"São Lourenço",3,"Sudeste",1,"316370",2,32,7,25,11,21,0,0,0,0,0,32,7,25,11,21,21,10.0412222239942,10.7407783661761,0.300047851749495,29
"8262","MG","São Lourenço",46202,22953.42,31054,"São Lourenço",3,"Sudeste",1,"316370",3,36,9,27,10,26,0,0,0,0,0,36,9,27,10,26,47,10.0412222239942,10.7407783661761,0.418972275393269,31
"8263","MG","São Lourenço",46202,22953.42,31054,"São Lourenço",3,"Sudeste",1,"316370",4,31,3,28,16,15,0,0,0,0,0,31,3,28,16,15,25,10.0412222239942,10.7407783661761,0.479484046615562,30
"8264","MG","São Lourenço",46202,22953.42,31054,"São Lourenço",3,"Sudeste",1,"316370",5,44,5,39,16,28,1,0,1,0,1,45,5,40,16,29,30,10.0412222239942,10.7407783661761,0.428728569032089,31
"8265","MG","São Romão",12529,13260.42,31006,"Pirapora",3,"Sudeste",0,"316420",2,9,2,7,6,3,0,0,0,0,0,9,2,7,6,3,6,9.49253893744638,9.43580123624555,0.297311998434529,29
"8266","MG","São Romão",12529,13260.42,31006,"Pirapora",3,"Sudeste",0,"316420",3,4,0,4,0,4,0,0,0,0,0,4,0,4,0,4,4,9.49253893744638,9.43580123624555,0.386219318916859,31
"8267","MG","São Romão",12529,13260.42,31006,"Pirapora",3,"Sudeste",0,"316420",4,8,5,3,4,4,0,0,0,0,0,8,5,3,4,4,6,9.49253893744638,9.43580123624555,0.412147620813274,30
"8268","MG","São Romão",12529,13260.42,31006,"Pirapora",3,"Sudeste",0,"316420",5,6,1,5,3,3,0,0,0,0,0,6,1,5,3,3,5,9.49253893744638,9.43580123624555,0.409112207523473,31
"8269","MG","São Roque de Minas",7076,29238.25,31042,"Piuí",3,"Sudeste",0,"316430",2,5,0,5,3,2,0,0,0,0,0,5,0,5,3,2,2,10.2832330625515,8.86446405527968,0.317544358834648,29
"8270","MG","São Roque de Minas",7076,29238.25,31042,"Piuí",3,"Sudeste",0,"316430",3,6,2,4,3,3,0,0,0,0,0,6,2,4,3,3,0,10.2832330625515,8.86446405527968,0.399300682343565,31
"8271","MG","São Roque de Minas",7076,29238.25,31042,"Piuí",3,"Sudeste",0,"316430",4,5,2,3,1,4,0,0,0,0,0,5,2,3,1,4,5,10.2832330625515,8.86446405527968,0.464654047802249,30
"8272","MG","São Roque de Minas",7076,29238.25,31042,"Piuí",3,"Sudeste",0,"316430",5,9,3,6,3,6,0,0,0,0,0,9,3,6,3,6,4,10.2832330625515,8.86446405527968,0.458329402609399,31
"8273","MG","São Sebastião da Bela Vista",5552,68401.03,31053,"Santa Rita do Sapucaí",3,"Sudeste",0,"316440",2,4,2,2,0,4,0,0,0,0,0,4,2,2,0,4,3,11.1331431619768,8.62191350218664,0.324786022441031,29
"8274","MG","São Sebastião da Bela Vista",5552,68401.03,31053,"Santa Rita do Sapucaí",3,"Sudeste",0,"316440",3,6,2,4,3,3,0,0,0,0,0,6,2,4,3,3,4,11.1331431619768,8.62191350218664,0.402649709333793,31
"8275","MG","São Sebastião da Bela Vista",5552,68401.03,31053,"Santa Rita do Sapucaí",3,"Sudeste",0,"316440",4,6,2,4,2,4,0,0,0,0,0,6,2,4,2,4,2,11.1331431619768,8.62191350218664,0.43842715814634,30
"8276","MG","São Sebastião da Bela Vista",5552,68401.03,31053,"Santa Rita do Sapucaí",3,"Sudeste",0,"316440",5,13,3,10,3,10,0,0,0,0,0,13,3,10,3,10,2,11.1331431619768,8.62191350218664,0.440501046553656,31
"8277","MG","São Sebastião do Oeste",6863,60425.52,31043,"Divinópolis",3,"Sudeste",0,"316460",2,9,0,9,6,3,0,0,0,0,0,9,0,9,6,3,0,11.0091668112442,8.83389994290864,0.329843853296256,29
"8278","MG","São Sebastião do Oeste",6863,60425.52,31043,"Divinópolis",3,"Sudeste",0,"316460",3,5,1,4,2,3,0,0,0,0,0,5,1,4,2,3,3,11.0091668112442,8.83389994290864,0.411298081724832,31
"8279","MG","São Sebastião do Oeste",6863,60425.52,31043,"Divinópolis",3,"Sudeste",0,"316460",4,13,3,10,6,7,0,0,0,0,0,13,3,10,6,7,3,11.0091668112442,8.83389994290864,0.452139453131414,30
"8280","MG","São Sebastião do Oeste",6863,60425.52,31043,"Divinópolis",3,"Sudeste",0,"316460",5,19,5,14,9,10,0,0,0,0,0,19,5,14,9,10,4,11.0091668112442,8.83389994290864,0.456363284836803,31
"8281","MG","São Sebastião do Paraíso",71445,25070.34,31048,"São Sebastião do Paraíso",3,"Sudeste",1,"316470",2,63,12,51,22,41,1,1,0,1,0,64,13,51,23,41,50,10.1294407530867,11.1766832019031,0.317723118882249,29
"8282","MG","São Sebastião do Paraíso",71445,25070.34,31048,"São Sebastião do Paraíso",3,"Sudeste",1,"316470",3,59,15,44,21,38,0,0,0,0,0,59,15,44,21,38,47,10.1294407530867,11.1766832019031,0.396430644188151,31
"8283","MG","São Sebastião do Paraíso",71445,25070.34,31048,"São Sebastião do Paraíso",3,"Sudeste",1,"316470",4,45,13,32,14,31,0,0,0,0,0,45,13,32,14,31,55,10.1294407530867,11.1766832019031,0.44164339118247,30
"8284","MG","São Sebastião do Paraíso",71445,25070.34,31048,"São Sebastião do Paraíso",3,"Sudeste",1,"316470",5,70,18,52,23,47,1,0,1,1,0,71,18,53,24,47,41,10.1294407530867,11.1766832019031,0.400389050306613,31
"8285","MG","São Tiago",10960,15526.4,31058,"São João Del Rei",3,"Sudeste",0,"316500",2,16,5,11,8,8,0,0,0,0,0,16,5,11,8,8,4,9.65029707986962,9.30200756050201,0.300531496958403,29
"8286","MG","São Tiago",10960,15526.4,31058,"São João Del Rei",3,"Sudeste",0,"316500",3,10,2,8,4,6,0,0,0,0,0,10,2,8,4,6,5,9.65029707986962,9.30200756050201,0.374200397459225,31
"8287","MG","São Tiago",10960,15526.4,31058,"São João Del Rei",3,"Sudeste",0,"316500",4,7,1,6,1,6,0,0,0,0,0,7,1,6,1,6,6,9.65029707986962,9.30200756050201,0.413391486270893,30
"8288","MG","São Tiago",10960,15526.4,31058,"São João Del Rei",3,"Sudeste",0,"316500",5,10,2,8,3,7,0,0,0,0,0,10,2,8,3,7,7,9.65029707986962,9.30200756050201,0.37146726844334,31
"8289","MG","São Tomé das Letras",7120,12957.1,31050,"Varginha",3,"Sudeste",0,"316520",2,4,1,3,0,4,0,0,0,0,0,4,1,3,0,4,4,9.46939917943495,8.87066300440602,0.370675899464405,29
"8290","MG","São Tomé das Letras",7120,12957.1,31050,"Varginha",3,"Sudeste",0,"316520",3,5,0,5,2,3,0,0,0,0,0,5,0,5,2,3,2,9.46939917943495,8.87066300440602,0.508701868726717,31
"8291","MG","São Tomé das Letras",7120,12957.1,31050,"Varginha",3,"Sudeste",0,"316520",4,5,1,4,1,4,0,0,0,0,0,5,1,4,1,4,5,9.46939917943495,8.87066300440602,0.526648571784948,30
"8292","MG","São Tomé das Letras",7120,12957.1,31050,"Varginha",3,"Sudeste",0,"316520",5,8,2,6,4,4,0,0,0,0,0,8,2,6,4,4,1,9.46939917943495,8.87066300440602,0.537047200087738,31
"8293","MG","São Vicente de Minas",7815,20991.43,31055,"Andrelândia",3,"Sudeste",0,"316530",2,5,3,2,2,3,0,0,0,0,0,5,3,2,2,3,3,9.95186953817394,8.96380024285558,0.303610124382563,29
"8294","MG","São Vicente de Minas",7815,20991.43,31055,"Andrelândia",3,"Sudeste",0,"316530",3,5,2,3,2,3,0,0,0,0,0,5,2,3,2,3,7,9.95186953817394,8.96380024285558,0.422569448289313,31
"8295","MG","São Vicente de Minas",7815,20991.43,31055,"Andrelândia",3,"Sudeste",0,"316530",4,9,4,5,3,6,0,0,0,0,0,9,4,5,3,6,5,9.95186953817394,8.96380024285558,0.426692739785759,30
"8296","MG","São Vicente de Minas",7815,20991.43,31055,"Andrelândia",3,"Sudeste",0,"316530",5,6,2,4,1,5,0,0,0,0,0,6,2,4,1,5,3,9.95186953817394,8.96380024285558,0.424292682881309,31
"8297","MG","Sapucaí-Mirim",6989,14784.21,31052,"Pouso Alegre",3,"Sudeste",0,"316540",2,3,0,3,2,1,0,0,0,0,0,3,0,3,2,1,6,9.60131499832604,8.85209276347713,0.323633890641153,29
"8298","MG","Sapucaí-Mirim",6989,14784.21,31052,"Pouso Alegre",3,"Sudeste",0,"316540",3,4,1,3,3,1,0,0,0,0,0,4,1,3,3,1,3,9.60131499832604,8.85209276347713,0.435992640969222,31
"8299","MG","Sapucaí-Mirim",6989,14784.21,31052,"Pouso Alegre",3,"Sudeste",0,"316540",4,5,1,4,0,5,0,0,0,0,0,5,1,4,0,5,0,9.60131499832604,8.85209276347713,0.452224690872141,30
"8300","MG","Sapucaí-Mirim",6989,14784.21,31052,"Pouso Alegre",3,"Sudeste",0,"316540",5,7,5,2,2,5,0,0,0,0,0,7,5,2,2,5,3,9.60131499832604,8.85209276347713,0.436409549532792,31
"8301","MG","Sarzedo",33413,28322.86,31030,"Belo Horizonte",3,"Sudeste",1,"316553",2,42,4,38,11,31,0,0,0,0,0,42,4,38,11,31,12,10.2514245314092,10.4167003247946,0.296907766548582,29
"8302","MG","Sarzedo",33413,28322.86,31030,"Belo Horizonte",3,"Sudeste",1,"316553",3,52,13,39,22,30,1,0,1,1,0,53,13,40,23,30,15,10.2514245314092,10.4167003247946,0.377656977826165,31
"8303","MG","Sarzedo",33413,28322.86,31030,"Belo Horizonte",3,"Sudeste",1,"316553",4,43,6,37,10,33,1,0,1,0,1,44,6,38,10,34,13,10.2514245314092,10.4167003247946,0.426013036610211,30
"8304","MG","Sarzedo",33413,28322.86,31030,"Belo Horizonte",3,"Sudeste",1,"316553",5,40,5,35,9,31,1,0,1,0,1,41,5,36,9,32,16,10.2514245314092,10.4167003247946,0.379950471151044,31
"8305","MG","Senador Amaral",5361,11305.13,31052,"Pouso Alegre",3,"Sudeste",0,"316557",2,4,1,3,1,3,0,0,0,0,0,4,1,3,1,3,4,9.33301188398253,8.58690580382754,0.294960643575555,29
"8306","MG","Senador Amaral",5361,11305.13,31052,"Pouso Alegre",3,"Sudeste",0,"316557",3,12,3,9,3,9,0,0,0,0,0,12,3,9,3,9,1,9.33301188398253,8.58690580382754,0.361114789510976,31
"8307","MG","Senador Amaral",5361,11305.13,31052,"Pouso Alegre",3,"Sudeste",0,"316557",4,13,4,9,5,8,0,0,0,0,0,13,4,9,5,8,2,9.33301188398253,8.58690580382754,0.360908335065563,30
"8308","MG","Senador Amaral",5361,11305.13,31052,"Pouso Alegre",3,"Sudeste",0,"316557",5,14,6,8,8,6,0,0,0,0,0,14,6,8,8,6,6,9.33301188398253,8.58690580382754,0.377911039520745,31
"8309","MG","Senador Firmino",7858,10326.95,31064,"Ubá",3,"Sudeste",0,"316570",2,6,0,6,3,3,0,0,0,0,0,6,0,6,3,3,5,9.24251226198253,8.96928740011841,0.257765085264655,29
"8310","MG","Senador Firmino",7858,10326.95,31064,"Ubá",3,"Sudeste",0,"316570",3,4,0,4,0,4,0,0,0,0,0,4,0,4,0,4,3,9.24251226198253,8.96928740011841,0.374303694248024,31
"8311","MG","Senador Firmino",7858,10326.95,31064,"Ubá",3,"Sudeste",0,"316570",4,9,0,9,3,6,0,0,0,0,0,9,0,9,3,6,4,9.24251226198253,8.96928740011841,0.465762484569178,30
"8312","MG","Senador Firmino",7858,10326.95,31064,"Ubá",3,"Sudeste",0,"316570",5,7,3,4,2,5,0,0,0,0,0,7,3,4,2,5,4,9.24251226198253,8.96928740011841,0.422054518925651,31
"8313","MG","Serra dos Aimorés",8713,10141.67,31016,"Nanuque",3,"Sudeste",0,"316670",2,8,1,7,3,5,0,0,0,0,0,8,1,7,3,5,4,9.22440795786464,9.07257144223129,0.335371240522123,29
"8314","MG","Serra dos Aimorés",8713,10141.67,31016,"Nanuque",3,"Sudeste",0,"316670",3,9,4,5,3,6,0,0,0,0,0,9,4,5,3,6,8,9.22440795786464,9.07257144223129,0.382176204256605,31
"8315","MG","Serra dos Aimorés",8713,10141.67,31016,"Nanuque",3,"Sudeste",0,"316670",4,3,0,3,1,2,0,0,0,0,0,3,0,3,1,2,1,9.22440795786464,9.07257144223129,0.427388314965476,30
"8316","MG","Serra dos Aimorés",8713,10141.67,31016,"Nanuque",3,"Sudeste",0,"316670",5,6,0,6,2,4,0,0,0,0,0,6,0,6,2,4,4,9.22440795786464,9.07257144223129,0.390868696570179,31
"8317","MG","Serra do Salitre",11668,41452.35,31019,"Patrocínio",3,"Sudeste",0,"316680",2,18,8,10,8,10,0,0,0,0,0,18,8,10,8,10,4,10.6322998537694,9.36460533098761,0.287055789314168,29
"8318","MG","Serra do Salitre",11668,41452.35,31019,"Patrocínio",3,"Sudeste",0,"316680",3,12,2,10,7,5,0,0,0,0,0,12,2,10,7,5,7,10.6322998537694,9.36460533098761,0.373937960011194,31
"8319","MG","Serra do Salitre",11668,41452.35,31019,"Patrocínio",3,"Sudeste",0,"316680",4,18,4,14,9,9,0,0,0,0,0,18,4,14,9,9,5,10.6322998537694,9.36460533098761,0.36812311353309,30
"8320","MG","Serra do Salitre",11668,41452.35,31019,"Patrocínio",3,"Sudeste",0,"316680",5,17,1,16,4,13,0,0,0,0,0,17,1,16,4,13,8,10.6322998537694,9.36460533098761,0.382173524818918,31
"8321","MG","Serrania",7668,17414.29,31049,"Alfenas",3,"Sudeste",0,"316690",2,7,0,7,3,4,0,0,0,0,0,7,0,7,3,4,4,9.76504641251738,8.94481110416553,0.32406458582621,29
"8322","MG","Serrania",7668,17414.29,31049,"Alfenas",3,"Sudeste",0,"316690",3,6,2,4,3,3,0,0,0,0,0,6,2,4,3,3,3,9.76504641251738,8.94481110416553,0.40658742056726,31
"8323","MG","Serrania",7668,17414.29,31049,"Alfenas",3,"Sudeste",0,"316690",4,9,4,5,5,4,0,0,0,0,0,9,4,5,5,4,4,9.76504641251738,8.94481110416553,0.449725266226252,30
"8324","MG","Serrania",7668,17414.29,31049,"Alfenas",3,"Sudeste",0,"316690",5,6,3,3,3,3,0,0,0,0,0,6,3,3,3,3,3,9.76504641251738,8.94481110416553,0.399146786024309,31
"8325","MG","Serro",20940,11074.52,31028,"Conceição do Mato Dentro",3,"Sudeste",0,"316710",2,16,6,10,8,8,0,0,0,0,0,16,6,10,8,8,15,9.31240225311631,9.94941648442453,0.336722067313076,29
"8326","MG","Serro",20940,11074.52,31028,"Conceição do Mato Dentro",3,"Sudeste",0,"316710",3,19,9,10,7,12,0,0,0,0,0,19,9,10,7,12,18,9.31240225311631,9.94941648442453,0.412272467167351,31
"8327","MG","Serro",20940,11074.52,31028,"Conceição do Mato Dentro",3,"Sudeste",0,"316710",4,14,1,13,4,10,0,0,0,0,0,14,1,13,4,10,9,9.31240225311631,9.94941648442453,0.46102590380386,30
"8328","MG","Serro",20940,11074.52,31028,"Conceição do Mato Dentro",3,"Sudeste",0,"316710",5,23,10,13,8,15,0,0,0,0,0,23,10,13,8,15,12,9.31240225311631,9.94941648442453,0.436927941084447,31
"8329","MG","Sete Lagoas",241835,35933.26,31027,"Sete Lagoas",3,"Sudeste",1,"316720",2,178,22,156,51,127,0,0,0,0,0,178,22,156,51,127,103,10.4894186079705,12.3960109544133,0.289424269921891,29
"8330","MG","Sete Lagoas",241835,35933.26,31027,"Sete Lagoas",3,"Sudeste",1,"316720",3,188,28,160,56,132,2,0,2,1,1,190,28,162,57,133,139,10.4894186079705,12.3960109544133,0.387684379311361,31
"8331","MG","Sete Lagoas",241835,35933.26,31027,"Sete Lagoas",3,"Sudeste",1,"316720",4,45,6,39,17,28,0,0,0,0,0,45,6,39,17,28,96,10.4894186079705,12.3960109544133,0.430299381697617,30
"8332","MG","Sete Lagoas",241835,35933.26,31027,"Sete Lagoas",3,"Sudeste",1,"316720",5,21,3,18,5,16,0,0,0,0,0,21,3,18,5,16,111,10.4894186079705,12.3960109544133,0.382001525017762,31
"8333","MG","Silvianópolis",6248,15179.07,31053,"Santa Rita do Sapucaí",3,"Sudeste",0,"316740",2,5,1,4,2,3,0,0,0,0,0,5,1,4,2,3,2,9.62767278425072,8.74001669151952,0.309349076161455,29
"8334","MG","Silvianópolis",6248,15179.07,31053,"Santa Rita do Sapucaí",3,"Sudeste",0,"316740",3,3,1,2,0,3,0,0,0,0,0,3,1,2,0,3,6,9.62767278425072,8.74001669151952,0.361423573853723,31
"8335","MG","Silvianópolis",6248,15179.07,31053,"Santa Rita do Sapucaí",3,"Sudeste",0,"316740",4,4,3,1,0,4,0,0,0,0,0,4,3,1,0,4,4,9.62767278425072,8.74001669151952,0.425331055947847,30
"8336","MG","Silvianópolis",6248,15179.07,31053,"Santa Rita do Sapucaí",3,"Sudeste",0,"316740",5,1,0,1,0,1,0,0,0,0,0,1,0,1,0,1,2,9.62767278425072,8.74001669151952,0.450192973052169,31
"8337","MG","Simonésia",19736,9536.48,31061,"Manhuaçu",3,"Sudeste",0,"316760",2,26,11,15,12,14,0,0,0,0,0,26,11,15,12,14,11,9.16287972360881,9.89019965820919,0.328004614298543,29
"8338","MG","Simonésia",19736,9536.48,31061,"Manhuaçu",3,"Sudeste",0,"316760",3,24,12,12,7,17,0,0,0,0,0,24,12,12,7,17,9,9.16287972360881,9.89019965820919,0.429639853632524,31
"8339","MG","Simonésia",19736,9536.48,31061,"Manhuaçu",3,"Sudeste",0,"316760",4,21,8,13,6,15,0,0,0,0,0,21,8,13,6,15,9,9.16287972360881,9.89019965820919,0.437638211512,30
"8340","MG","Simonésia",19736,9536.48,31061,"Manhuaçu",3,"Sudeste",0,"316760",5,19,10,9,13,6,0,0,0,0,0,19,10,9,13,6,9,9.16287972360881,9.89019965820919,0.437974089516462,31
"8341","MG","Tabuleiro",3708,13311.92,31064,"Ubá",3,"Sudeste",0,"316790",2,4,0,4,2,2,0,0,0,0,0,4,0,4,2,2,6,9.49641515342755,8.21824792668574,0.311454659144931,29
"8342","MG","Tabuleiro",3708,13311.92,31064,"Ubá",3,"Sudeste",0,"316790",3,3,1,2,1,2,0,0,0,0,0,3,1,2,1,2,3,9.49641515342755,8.21824792668574,0.407540255347991,31
"8343","MG","Tabuleiro",3708,13311.92,31064,"Ubá",3,"Sudeste",0,"316790",4,2,1,1,0,2,0,0,0,0,0,2,1,1,0,2,2,9.49641515342755,8.21824792668574,0.438261109753283,30
"8344","MG","Tabuleiro",3708,13311.92,31064,"Ubá",3,"Sudeste",0,"316790",5,4,1,3,1,3,0,0,0,0,0,4,1,3,1,3,2,9.49641515342755,8.21824792668574,0.407132104289259,31
"8345","MG","Taiobeiras",34397,13049.39,31005,"Salinas",3,"Sudeste",1,"316800",2,34,12,22,13,21,0,0,0,0,0,34,12,22,13,21,12,9.47649666836332,10.4457246302562,0.284403309046819,29
"8346","MG","Taiobeiras",34397,13049.39,31005,"Salinas",3,"Sudeste",1,"316800",3,44,10,34,14,30,0,0,0,0,0,44,10,34,14,30,21,9.47649666836332,10.4457246302562,0.349748519610822,31
"8347","MG","Taiobeiras",34397,13049.39,31005,"Salinas",3,"Sudeste",1,"316800",4,42,10,32,18,24,0,0,0,0,0,42,10,32,18,24,14,9.47649666836332,10.4457246302562,0.371534318821136,30
"8348","MG","Taiobeiras",34397,13049.39,31005,"Salinas",3,"Sudeste",1,"316800",5,48,8,40,13,35,0,0,0,0,0,48,8,40,13,35,13,9.47649666836332,10.4457246302562,0.360053449993481,31
"8349","MG","Tarumirim",14302,10076.86,31040,"Caratinga",3,"Sudeste",0,"316840",2,16,5,11,5,11,0,0,0,0,0,16,5,11,5,11,9,9.21799698516018,9.56815466660834,0.340141401339992,29
"8350","MG","Tarumirim",14302,10076.86,31040,"Caratinga",3,"Sudeste",0,"316840",3,13,5,8,6,7,0,0,0,0,0,13,5,8,6,7,12,9.21799698516018,9.56815466660834,0.444894530986442,31
"8351","MG","Tarumirim",14302,10076.86,31040,"Caratinga",3,"Sudeste",0,"316840",4,11,1,10,3,8,0,0,0,0,0,11,1,10,3,8,14,9.21799698516018,9.56815466660834,0.470457798666397,30
"8352","MG","Tarumirim",14302,10076.86,31040,"Caratinga",3,"Sudeste",0,"316840",5,15,3,12,4,11,0,0,0,0,0,15,3,12,4,11,9,9.21799698516018,9.56815466660834,0.43486878511504,31
"8353","MG","Teixeiras",11670,12179.61,31062,"Viçosa",3,"Sudeste",0,"316850",2,8,2,6,5,3,0,0,0,0,0,8,2,6,5,3,4,9.40751852104681,9.3647767252806,0.331013655400018,29
"8354","MG","Teixeiras",11670,12179.61,31062,"Viçosa",3,"Sudeste",0,"316850",3,10,8,2,4,6,0,0,0,0,0,10,8,2,4,6,10,9.40751852104681,9.3647767252806,0.415336064588199,31
"8355","MG","Teixeiras",11670,12179.61,31062,"Viçosa",3,"Sudeste",0,"316850",4,8,2,6,1,7,0,0,0,0,0,8,2,6,1,7,5,9.40751852104681,9.3647767252806,0.472785988164839,30
"8356","MG","Teixeiras",11670,12179.61,31062,"Viçosa",3,"Sudeste",0,"316850",5,9,3,6,1,8,0,0,0,0,0,9,3,6,1,8,5,9.40751852104681,9.3647767252806,0.44010565633072,31
"8357","MG","Teófilo Otoni",140937,17942.67,31015,"Teófilo Otoni",3,"Sudeste",1,"316860",2,127,33,94,47,80,0,0,0,0,0,127,33,94,47,80,89,9.79493695397022,11.856068261001,0.295766013160971,29
"8358","MG","Teófilo Otoni",140937,17942.67,31015,"Teófilo Otoni",3,"Sudeste",1,"316860",3,131,21,110,50,81,2,0,2,1,1,133,21,112,51,82,91,9.79493695397022,11.856068261001,0.388947338241796,31
"8359","MG","Teófilo Otoni",140937,17942.67,31015,"Teófilo Otoni",3,"Sudeste",1,"316860",4,124,31,93,49,75,2,2,0,2,0,126,33,93,51,75,69,9.79493695397022,11.856068261001,0.429882192213851,30
"8360","MG","Teófilo Otoni",140937,17942.67,31015,"Teófilo Otoni",3,"Sudeste",1,"316860",5,158,32,126,50,108,2,0,2,0,2,160,32,128,50,110,111,9.79493695397022,11.856068261001,0.406808990406389,31
"8361","MG","Timóteo",90568,36154.09,31039,"Ipatinga",3,"Sudeste",1,"316870",2,65,9,56,12,53,0,0,0,0,0,65,9,56,12,53,36,10.4955453608828,11.4138562287579,0.311602274582896,29
"8362","MG","Timóteo",90568,36154.09,31039,"Ipatinga",3,"Sudeste",1,"316870",3,53,7,46,18,35,1,0,1,0,1,54,7,47,18,36,52,10.4955453608828,11.4138562287579,0.426188611437378,31
"8363","MG","Timóteo",90568,36154.09,31039,"Ipatinga",3,"Sudeste",1,"316870",4,63,6,57,21,42,0,0,0,0,0,63,6,57,21,42,39,10.4955453608828,11.4138562287579,0.463212266531294,30
"8364","MG","Timóteo",90568,36154.09,31039,"Ipatinga",3,"Sudeste",1,"316870",5,76,19,57,21,55,0,0,0,0,0,76,19,57,21,55,53,10.4955453608828,11.4138562287579,0.421206059210922,31
"8365","MG","Tiradentes",8072,20633.71,31058,"São João Del Rei",3,"Sudeste",1,"316880",2,7,2,5,2,5,0,0,0,0,0,7,2,5,2,5,6,9.93468142508836,8.99615656203344,0.288088186242613,29
"8366","MG","Tiradentes",8072,20633.71,31058,"São João Del Rei",3,"Sudeste",1,"316880",3,11,2,9,3,8,0,0,0,0,0,11,2,9,3,8,8,9.93468142508836,8.99615656203344,0.456986772435244,31
"8367","MG","Tiradentes",8072,20633.71,31058,"São João Del Rei",3,"Sudeste",1,"316880",4,7,0,7,3,4,0,0,0,0,0,7,0,7,3,4,3,9.93468142508836,8.99615656203344,0.510574619600884,30
"8368","MG","Tiradentes",8072,20633.71,31058,"São João Del Rei",3,"Sudeste",1,"316880",5,4,1,3,2,2,0,0,0,0,0,4,1,3,2,2,5,9.93468142508836,8.99615656203344,0.474734390406265,31
"8369","MG","Tocantins",16715,16569.31,31064,"Ubá",3,"Sudeste",1,"316900",2,9,1,8,6,3,0,0,0,0,0,9,1,8,6,3,14,9.71530746803275,9.7240617988542,0.33782338559975,29
"8370","MG","Tocantins",16715,16569.31,31064,"Ubá",3,"Sudeste",1,"316900",3,11,4,7,3,8,0,0,0,0,0,11,4,7,3,8,12,9.71530746803275,9.7240617988542,0.424239450188568,31
"8371","MG","Tocantins",16715,16569.31,31064,"Ubá",3,"Sudeste",1,"316900",4,9,5,4,6,3,0,0,0,0,0,9,5,4,6,3,7,9.71530746803275,9.7240617988542,0.480162982024625,30
"8372","MG","Tocantins",16715,16569.31,31064,"Ubá",3,"Sudeste",1,"316900",5,15,3,12,4,11,0,0,0,0,0,15,3,12,4,11,5,9.71530746803275,9.7240617988542,0.438559417359758,31
"8373","MG","Toledo",6297,12033.88,31052,"Pouso Alegre",3,"Sudeste",0,"316910",2,4,2,2,3,1,0,0,0,0,0,4,2,2,3,1,2,9.39548128398386,8.74782860848874,0.308541422799052,29
"8374","MG","Toledo",6297,12033.88,31052,"Pouso Alegre",3,"Sudeste",0,"316910",3,5,0,5,2,3,0,0,0,0,0,5,0,5,2,3,5,9.39548128398386,8.74782860848874,0.406270018303659,31
"8375","MG","Toledo",6297,12033.88,31052,"Pouso Alegre",3,"Sudeste",0,"316910",4,6,2,4,2,4,0,0,0,0,0,6,2,4,2,4,4,9.39548128398386,8.74782860848874,0.390689997311591,30
"8376","MG","Toledo",6297,12033.88,31052,"Pouso Alegre",3,"Sudeste",0,"316910",5,7,2,5,3,4,0,0,0,0,0,7,2,5,3,4,4,9.39548128398386,8.74782860848874,0.3696401047526,31
"8377","MG","Tombos",7850,11970.93,31063,"Muriaé",3,"Sudeste",0,"316920",2,6,0,6,0,6,0,0,0,0,0,6,0,6,0,6,8,9.39023648976957,8.96826881077645,0.341524998153332,29
"8378","MG","Tombos",7850,11970.93,31063,"Muriaé",3,"Sudeste",0,"316920",3,6,0,6,3,3,0,0,0,0,0,6,0,6,3,3,5,9.39023648976957,8.96826881077645,0.411507716910192,31
"8379","MG","Tombos",7850,11970.93,31063,"Muriaé",3,"Sudeste",0,"316920",4,7,1,6,2,5,0,0,0,0,0,7,1,6,2,5,12,9.39023648976957,8.96826881077645,0.458107674454573,30
"8380","MG","Tombos",7850,11970.93,31063,"Muriaé",3,"Sudeste",0,"316920",5,5,1,4,3,2,0,0,0,0,0,5,1,4,3,2,8,9.39023648976957,8.96826881077645,0.442927185369233,31
"8381","MG","Três Corações",80032,29300.4,31050,"Varginha",3,"Sudeste",1,"316930",2,85,14,71,31,54,0,0,0,0,0,85,14,71,31,54,30,10.2853564467891,11.2901818336773,0.314981276225323,29
"8382","MG","Três Corações",80032,29300.4,31050,"Varginha",3,"Sudeste",1,"316930",3,80,19,61,30,50,1,0,1,1,0,81,19,62,31,50,55,10.2853564467891,11.2901818336773,0.407098107104121,31
"8383","MG","Três Corações",80032,29300.4,31050,"Varginha",3,"Sudeste",1,"316930",4,71,17,54,25,46,0,0,0,0,0,71,17,54,25,46,36,10.2853564467891,11.2901818336773,0.451663262802511,30
"8384","MG","Três Corações",80032,29300.4,31050,"Varginha",3,"Sudeste",1,"316930",5,86,20,66,25,61,1,0,1,0,1,87,20,67,25,62,50,10.2853564467891,11.2901818336773,0.419062230008501,31
"8385","MG","Três Marias",32716,84505.37,31024,"Três Marias",3,"Sudeste",1,"316935",2,29,5,24,11,18,0,0,0,0,0,29,5,24,11,18,9,11.3445703616219,10.3956195338549,0.297254793836236,29
"8386","MG","Três Marias",32716,84505.37,31024,"Três Marias",3,"Sudeste",1,"316935",3,28,6,22,7,21,0,0,0,0,0,28,6,22,7,21,16,11.3445703616219,10.3956195338549,0.384535278643337,31
"8387","MG","Três Marias",32716,84505.37,31024,"Três Marias",3,"Sudeste",1,"316935",4,29,7,22,13,16,0,0,0,0,0,29,7,22,13,16,11,11.3445703616219,10.3956195338549,0.421651828667076,30
"8388","MG","Três Marias",32716,84505.37,31024,"Três Marias",3,"Sudeste",1,"316935",5,26,6,20,8,18,0,0,0,0,0,26,6,20,8,18,11,11.3445703616219,10.3956195338549,0.378574252353724,31
"8389","MG","Três Pontas",56940,23810.73,31050,"Varginha",3,"Sudeste",1,"316940",2,55,8,47,17,38,2,2,0,1,1,57,10,47,18,39,33,10.0778915983977,10.949753360832,0.289933119296769,29
"8390","MG","Três Pontas",56940,23810.73,31050,"Varginha",3,"Sudeste",1,"316940",3,58,9,49,25,33,1,1,0,1,0,59,10,49,26,33,30,10.0778915983977,10.949753360832,0.369878654942571,31
"8391","MG","Três Pontas",56940,23810.73,31050,"Varginha",3,"Sudeste",1,"316940",4,64,16,48,22,42,0,0,0,0,0,64,16,48,22,42,37,10.0778915983977,10.949753360832,0.394728405033851,30
"8392","MG","Três Pontas",56940,23810.73,31050,"Varginha",3,"Sudeste",1,"316940",5,67,14,53,25,42,0,0,0,0,0,67,14,53,25,42,32,10.0778915983977,10.949753360832,0.349362035642922,31
"8393","MG","Tumiritinga",6765,8351.16,31037,"Governador Valadares",3,"Sudeste",0,"316950",2,5,1,4,2,3,0,0,0,0,0,5,1,4,2,3,7,9.0301557303518,8.81951754060489,0.327382307363638,29
"8394","MG","Tumiritinga",6765,8351.16,31037,"Governador Valadares",3,"Sudeste",0,"316950",3,9,6,3,6,3,0,0,0,0,0,9,6,3,6,3,5,9.0301557303518,8.81951754060489,0.400053419866564,31
"8395","MG","Tumiritinga",6765,8351.16,31037,"Governador Valadares",3,"Sudeste",0,"316950",4,10,1,9,8,2,0,0,0,0,0,10,1,9,8,2,4,9.0301557303518,8.81951754060489,0.411487093299333,30
"8396","MG","Tumiritinga",6765,8351.16,31037,"Governador Valadares",3,"Sudeste",0,"316950",5,8,3,5,5,3,0,0,0,0,0,8,3,5,5,3,8,9.0301557303518,8.81951754060489,0.399222562878992,31
"8397","MG","Tupaciguara",25398,25776.82,31018,"Uberlândia",3,"Sudeste",1,"316960",2,15,3,12,9,6,0,0,0,0,0,15,3,12,9,6,17,10.1572309174495,10.142425709749,0.300027620575825,29
"8398","MG","Tupaciguara",25398,25776.82,31018,"Uberlândia",3,"Sudeste",1,"316960",3,25,8,17,12,13,0,0,0,0,0,25,8,17,12,13,19,10.1572309174495,10.142425709749,0.356450328661338,31
"8399","MG","Tupaciguara",25398,25776.82,31018,"Uberlândia",3,"Sudeste",1,"316960",4,20,6,14,7,13,0,0,0,0,0,20,6,14,7,13,22,10.1572309174495,10.142425709749,0.380009075598274,30
"8400","MG","Tupaciguara",25398,25776.82,31018,"Uberlândia",3,"Sudeste",1,"316960",5,19,6,13,6,13,0,0,0,0,0,19,6,13,6,13,17,10.1572309174495,10.142425709749,0.36070707235076,31
"8401","MG","Turmalina",20125,18784.34,31011,"Capelinha",3,"Sudeste",0,"316970",2,7,0,7,0,7,0,0,0,0,0,7,0,7,0,7,2,9.84077882297508,9.90971810228676,0.285300448566424,29
"8402","MG","Turmalina",20125,18784.34,31011,"Capelinha",3,"Sudeste",0,"316970",3,4,0,4,0,4,0,0,0,0,0,4,0,4,0,4,14,9.84077882297508,9.90971810228676,0.367449634127295,31
"8403","MG","Turmalina",20125,18784.34,31011,"Capelinha",3,"Sudeste",0,"316970",4,4,0,4,1,3,0,0,0,0,0,4,0,4,1,3,8,9.84077882297508,9.90971810228676,0.381737557656394,30
"8404","MG","Turmalina",20125,18784.34,31011,"Capelinha",3,"Sudeste",0,"316970",5,2,0,2,0,2,0,0,0,0,0,2,0,2,0,2,5,9.84077882297508,9.90971810228676,0.368436689699272,31
"8405","MG","Turvolândia",5070,20030.16,31053,"Santa Rita do Sapucaí",3,"Sudeste",0,"316980",2,7,3,4,1,6,0,0,0,0,0,7,3,4,1,6,3,9.90499441664593,8.53109609658523,0.29219194654925,29
"8406","MG","Turvolândia",5070,20030.16,31053,"Santa Rita do Sapucaí",3,"Sudeste",0,"316980",3,4,1,3,2,2,0,0,0,0,0,4,1,3,2,2,1,9.90499441664593,8.53109609658523,0.352704292238558,31
"8407","MG","Turvolândia",5070,20030.16,31053,"Santa Rita do Sapucaí",3,"Sudeste",0,"316980",4,6,2,4,2,4,0,0,0,0,0,6,2,4,2,4,1,9.90499441664593,8.53109609658523,0.350951354181848,30
"8408","MG","Turvolândia",5070,20030.16,31053,"Santa Rita do Sapucaí",3,"Sudeste",0,"316980",5,7,3,4,1,6,0,0,0,0,0,7,3,4,1,6,4,9.90499441664593,8.53109609658523,0.345968725502554,31
"8409","MG","Ubá",116797,23884.41,31064,"Ubá",3,"Sudeste",1,"316990",2,90,28,62,29,61,0,0,0,0,0,90,28,62,29,61,51,10.0809812238233,11.6681926641149,0.324049990956275,29
"8410","MG","Ubá",116797,23884.41,31064,"Ubá",3,"Sudeste",1,"316990",3,102,28,74,35,67,0,0,0,0,0,102,28,74,35,67,55,10.0809812238233,11.6681926641149,0.424718922633908,31
"8411","MG","Ubá",116797,23884.41,31064,"Ubá",3,"Sudeste",1,"316990",4,84,28,56,28,56,1,0,1,1,0,85,28,57,29,56,46,10.0809812238233,11.6681926641149,0.471596402463597,30
"8412","MG","Ubá",116797,23884.41,31064,"Ubá",3,"Sudeste",1,"316990",5,110,29,81,39,71,1,0,1,1,0,111,29,82,40,71,57,10.0809812238233,11.6681926641149,0.422800259661824,31
"8413","MG","Ubaí",12599,7889.85,31007,"Montes Claros",3,"Sudeste",0,"317000",2,11,6,5,2,9,0,0,0,0,0,11,6,5,2,9,2,8.97333240225236,9.44137272471063,0.275731469042967,29
"8414","MG","Ubaí",12599,7889.85,31007,"Montes Claros",3,"Sudeste",0,"317000",3,14,4,10,5,9,0,0,0,0,0,14,4,10,5,9,3,8.97333240225236,9.44137272471063,0.304883607815745,31
"8415","MG","Ubaí",12599,7889.85,31007,"Montes Claros",3,"Sudeste",0,"317000",4,9,1,8,5,4,0,0,0,0,0,9,1,8,5,4,6,8.97333240225236,9.44137272471063,0.332090829227664,30
"8416","MG","Ubaí",12599,7889.85,31007,"Montes Claros",3,"Sudeste",0,"317000",5,16,4,12,9,7,1,0,1,1,0,17,4,13,10,7,6,8.97333240225236,9.44137272471063,0.367266901520242,31
"8417","MG","Ubaporanga",12493,9860.17,31040,"Caratinga",3,"Sudeste",0,"317005",2,9,7,2,5,4,0,0,0,0,0,9,7,2,5,4,8,9.19625868882736,9.43292376643183,0.392728241158306,29
"8418","MG","Ubaporanga",12493,9860.17,31040,"Caratinga",3,"Sudeste",0,"317005",3,17,7,10,3,14,0,0,0,0,0,17,7,10,3,14,8,9.19625868882736,9.43292376643183,0.483742420201878,31
"8419","MG","Ubaporanga",12493,9860.17,31040,"Caratinga",3,"Sudeste",0,"317005",4,11,3,8,4,7,0,0,0,0,0,11,3,8,4,7,3,9.19625868882736,9.43292376643183,0.490536847166826,30
"8420","MG","Ubaporanga",12493,9860.17,31040,"Caratinga",3,"Sudeste",0,"317005",5,13,5,8,6,7,0,0,0,0,0,13,5,8,6,7,6,9.19625868882736,9.43292376643183,0.449234222417576,31
"8421","MG","Uberaba",337092,44522.83,31022,"Uberaba",3,"Sudeste",1,"317010",2,264,61,203,91,173,2,0,2,2,0,266,61,205,93,173,178,10.7037573703054,12.7281111691102,0.303888214565446,29
"8422","MG","Uberaba",337092,44522.83,31022,"Uberaba",3,"Sudeste",1,"317010",3,305,55,250,106,199,1,0,1,0,1,306,55,251,106,200,182,10.7037573703054,12.7281111691102,0.394076937556525,31
"8423","MG","Uberaba",337092,44522.83,31022,"Uberaba",3,"Sudeste",1,"317010",4,274,56,218,88,186,4,3,1,1,3,278,59,219,89,189,180,10.7037573703054,12.7281111691102,0.444801517457035,30
"8424","MG","Uberaba",337092,44522.83,31022,"Uberaba",3,"Sudeste",1,"317010",5,375,65,310,117,258,7,1,6,1,6,382,66,316,118,264,199,10.7037573703054,12.7281111691102,0.409007936892943,31
"8425","MG","Uberlândia",699097,54801.25,31018,"Uberlândia",3,"Sudeste",1,"317020",2,643,81,562,214,429,4,1,3,2,2,647,82,565,216,431,324,10.9114682828949,13.4575447812593,0.29027344445019,29
"8426","MG","Uberlândia",699097,54801.25,31018,"Uberlândia",3,"Sudeste",1,"317020",3,710,89,621,220,490,3,0,3,1,2,713,89,624,221,492,343,10.9114682828949,13.4575447812593,0.389025372805157,31
"8427","MG","Uberlândia",699097,54801.25,31018,"Uberlândia",3,"Sudeste",1,"317020",4,664,80,584,219,445,4,0,4,3,1,668,80,588,222,446,285,10.9114682828949,13.4575447812593,0.441818316409381,30
"8428","MG","Uberlândia",699097,54801.25,31018,"Uberlândia",3,"Sudeste",1,"317020",5,818,103,715,259,559,4,2,2,2,2,822,105,717,261,561,333,10.9114682828949,13.4575447812593,0.395485822951862,31
"8429","MG","Unaí",84930,38850.78,31001,"Unaí",3,"Sudeste",1,"317040",2,84,16,68,35,49,1,0,1,1,0,85,16,69,36,49,37,10.5674834328143,11.3495826667741,0.287141768811402,29
"8430","MG","Unaí",84930,38850.78,31001,"Unaí",3,"Sudeste",1,"317040",3,81,14,67,26,55,1,1,0,1,0,82,15,67,27,55,43,10.5674834328143,11.3495826667741,0.369022651448369,31
"8431","MG","Unaí",84930,38850.78,31001,"Unaí",3,"Sudeste",1,"317040",4,88,17,71,29,59,0,0,0,0,0,88,17,71,29,59,49,10.5674834328143,11.3495826667741,0.395960436052639,30
"8432","MG","Unaí",84930,38850.78,31001,"Unaí",3,"Sudeste",1,"317040",5,98,18,80,31,67,0,0,0,0,0,98,18,80,31,67,30,10.5674834328143,11.3495826667741,0.36796043596961,31
"8433","MG","Urucânia",10345,16470.83,31060,"Ponte Nova",3,"Sudeste",0,"317050",2,4,3,1,3,1,0,0,0,0,0,4,3,1,3,1,7,9.70934621655887,9.24425859017964,0.313468473608364,29
"8434","MG","Urucânia",10345,16470.83,31060,"Ponte Nova",3,"Sudeste",0,"317050",3,13,4,9,6,7,0,0,0,0,0,13,4,9,6,7,9,9.70934621655887,9.24425859017964,0.38600662672882,31
"8435","MG","Urucânia",10345,16470.83,31060,"Ponte Nova",3,"Sudeste",0,"317050",4,14,6,8,5,9,0,0,0,0,0,14,6,8,5,9,5,9.70934621655887,9.24425859017964,0.394864175445109,30
"8436","MG","Urucânia",10345,16470.83,31060,"Ponte Nova",3,"Sudeste",0,"317050",5,7,2,5,2,5,0,0,0,0,0,7,2,5,2,5,7,9.70934621655887,9.24425859017964,0.421659935424799,31
"8437","MG","Urucuia",17173,7926.62,31003,"Januária",3,"Sudeste",0,"317052",2,6,2,4,2,4,0,0,0,0,0,6,2,4,2,4,1,8.97798199425908,9.75109366198386,0.306373650023218,29
"8438","MG","Urucuia",17173,7926.62,31003,"Januária",3,"Sudeste",0,"317052",3,9,4,5,4,5,0,0,0,0,0,9,4,5,4,5,1,8.97798199425908,9.75109366198386,0.349841067434455,31
"8439","MG","Urucuia",17173,7926.62,31003,"Januária",3,"Sudeste",0,"317052",4,11,4,7,4,7,0,0,0,0,0,11,4,7,4,7,4,8.97798199425908,9.75109366198386,0.398496254756232,30
"8440","MG","Urucuia",17173,7926.62,31003,"Januária",3,"Sudeste",0,"317052",5,10,5,5,4,6,0,0,0,0,0,10,5,5,4,6,7,8.97798199425908,9.75109366198386,0.392707756636226,31
"8441","MG","Varginha",136602,40994.76,31050,"Varginha",3,"Sudeste",1,"317070",2,131,18,113,33,98,0,0,0,0,0,131,18,113,33,98,65,10.6211995326407,11.8248268673001,0.301405842490639,29
"8442","MG","Varginha",136602,40994.76,31050,"Varginha",3,"Sudeste",1,"317070",3,144,22,122,46,98,2,1,1,0,2,146,23,123,46,100,76,10.6211995326407,11.8248268673001,0.391648445570203,31
"8443","MG","Varginha",136602,40994.76,31050,"Varginha",3,"Sudeste",1,"317070",4,128,29,99,47,81,0,0,0,0,0,128,29,99,47,81,50,10.6211995326407,11.8248268673001,0.445379714197129,30
"8444","MG","Varginha",136602,40994.76,31050,"Varginha",3,"Sudeste",1,"317070",5,144,24,120,38,106,0,0,0,0,0,144,24,120,38,106,70,10.6211995326407,11.8248268673001,0.387676583918838,31
"8445","MG","Varjão de Minas",7138,21166.17,31002,"Paracatu",3,"Sudeste",0,"317075",2,9,2,7,3,6,0,0,0,0,0,9,2,7,3,6,4,9.96015943137045,8.87318790405011,0.311352515084984,29
"8446","MG","Varjão de Minas",7138,21166.17,31002,"Paracatu",3,"Sudeste",0,"317075",3,9,3,6,1,8,0,0,0,0,0,9,3,6,1,8,4,9.96015943137045,8.87318790405011,0.375900172637942,31
"8447","MG","Varjão de Minas",7138,21166.17,31002,"Paracatu",3,"Sudeste",0,"317075",4,9,2,7,5,4,0,0,0,0,0,9,2,7,5,4,1,9.96015943137045,8.87318790405011,0.408954981039517,30
"8448","MG","Varjão de Minas",7138,21166.17,31002,"Paracatu",3,"Sudeste",0,"317075",5,13,5,8,3,10,0,0,0,0,0,13,5,8,3,10,3,9.96015943137045,8.87318790405011,0.381622111100145,31
"8449","MG","Várzea da Palma",39803,18288.2,31006,"Pirapora",3,"Sudeste",1,"317080",2,27,8,19,8,19,0,0,0,0,0,27,8,19,8,19,13,9.81401132210778,10.5916975653163,0.310210471219627,29
"8450","MG","Várzea da Palma",39803,18288.2,31006,"Pirapora",3,"Sudeste",1,"317080",3,43,13,30,18,25,0,0,0,0,0,43,13,30,18,25,10,9.81401132210778,10.5916975653163,0.383759160270818,31
"8451","MG","Várzea da Palma",39803,18288.2,31006,"Pirapora",3,"Sudeste",1,"317080",4,33,9,24,17,16,1,0,1,1,0,34,9,25,18,16,17,9.81401132210778,10.5916975653163,0.405945479104516,30
"8452","MG","Várzea da Palma",39803,18288.2,31006,"Pirapora",3,"Sudeste",1,"317080",5,38,8,30,18,20,0,0,0,0,0,38,8,30,18,20,19,9.81401132210778,10.5916975653163,0.375951291576053,31
"8453","MG","Varzelândia",19305,8142.56,31007,"Montes Claros",3,"Sudeste",0,"317090",2,20,8,12,6,14,0,0,0,0,0,20,8,12,6,14,6,9.00485990586748,9.86811940869834,0.273443822967974,29
"8454","MG","Varzelândia",19305,8142.56,31007,"Montes Claros",3,"Sudeste",0,"317090",3,20,7,13,9,11,0,0,0,0,0,20,7,13,9,11,7,9.00485990586748,9.86811940869834,0.340145617328905,31
"8455","MG","Varzelândia",19305,8142.56,31007,"Montes Claros",3,"Sudeste",0,"317090",4,23,6,17,11,12,0,0,0,0,0,23,6,17,11,12,10,9.00485990586748,9.86811940869834,0.367255541650371,30
"8456","MG","Varzelândia",19305,8142.56,31007,"Montes Claros",3,"Sudeste",0,"317090",5,21,4,17,9,12,1,0,1,1,0,22,4,18,10,12,11,9.00485990586748,9.86811940869834,0.343426716041922,31
"8457","MG","Vazante",20642,34956.17,31002,"Paracatu",3,"Sudeste",1,"317100",2,16,2,14,4,12,1,0,1,1,0,17,2,15,5,12,12,10.4618502699923,9.93508311412588,0.305690967139512,29
"8458","MG","Vazante",20642,34956.17,31002,"Paracatu",3,"Sudeste",1,"317100",3,17,3,14,9,8,0,0,0,0,0,17,3,14,9,8,7,10.4618502699923,9.93508311412588,0.399849137487734,31
"8459","MG","Vazante",20642,34956.17,31002,"Paracatu",3,"Sudeste",1,"317100",4,8,0,8,4,4,0,0,0,0,0,8,0,8,4,4,11,10.4618502699923,9.93508311412588,0.433210226564884,30
"8460","MG","Vazante",20642,34956.17,31002,"Paracatu",3,"Sudeste",1,"317100",5,22,4,18,5,17,1,0,1,1,0,23,4,19,6,17,13,10.4618502699923,9.93508311412588,0.412904364510191,31
"8461","MG","Vespasiano",129765,19415.59,31030,"Belo Horizonte",3,"Sudeste",1,"317120",2,122,23,99,42,80,3,0,3,0,3,125,23,102,42,83,40,9.87383163057862,11.7734804012826,0.289902744629112,29
"8462","MG","Vespasiano",129765,19415.59,31030,"Belo Horizonte",3,"Sudeste",1,"317120",3,158,41,117,64,94,0,0,0,0,0,158,41,117,64,94,55,9.87383163057862,11.7734804012826,0.383964994525225,31
"8463","MG","Vespasiano",129765,19415.59,31030,"Belo Horizonte",3,"Sudeste",1,"317120",4,141,27,114,51,90,2,1,1,2,0,143,28,115,53,90,48,9.87383163057862,11.7734804012826,0.433224143572469,30
"8464","MG","Vespasiano",129765,19415.59,31030,"Belo Horizonte",3,"Sudeste",1,"317120",5,150,28,122,49,101,3,0,3,1,2,153,28,125,50,103,44,9.87383163057862,11.7734804012826,0.393431082674489,31
"8465","MG","Viçosa",79388,20832.2,31062,"Viçosa",3,"Sudeste",1,"317130",2,76,12,64,21,55,0,0,0,0,0,76,12,64,21,55,28,9.94425514557665,11.2821025023121,0.313038161447552,29
"8466","MG","Viçosa",79388,20832.2,31062,"Viçosa",3,"Sudeste",1,"317130",3,65,8,57,16,49,0,0,0,0,0,65,8,57,16,49,39,9.94425514557665,11.2821025023121,0.446273517280114,31
"8467","MG","Viçosa",79388,20832.2,31062,"Viçosa",3,"Sudeste",1,"317130",4,66,8,58,18,48,0,0,0,0,0,66,8,58,18,48,48,9.94425514557665,11.2821025023121,0.53934331252323,30
"8468","MG","Viçosa",79388,20832.2,31062,"Viçosa",3,"Sudeste",1,"317130",5,72,8,64,18,54,0,0,0,0,0,72,8,64,18,54,34,9.94425514557665,11.2821025023121,0.482658412829937,31
"8469","MG","Virgem da Lapa",13740,8435.13,31012,"Araçuaí",3,"Sudeste",0,"317160",2,10,3,7,5,5,2,1,1,0,2,12,4,8,5,7,5,9.04016040683522,9.52806656577634,0.284502320381293,29
"8470","MG","Virgem da Lapa",13740,8435.13,31012,"Araçuaí",3,"Sudeste",0,"317160",3,10,3,7,4,6,1,1,0,0,1,11,4,7,4,7,11,9.04016040683522,9.52806656577634,0.389805131673394,31
"8471","MG","Virgem da Lapa",13740,8435.13,31012,"Araçuaí",3,"Sudeste",0,"317160",4,7,3,4,5,2,0,0,0,0,0,7,3,4,5,2,7,9.04016040683522,9.52806656577634,0.410933920359618,30
"8472","MG","Virgem da Lapa",13740,8435.13,31012,"Araçuaí",3,"Sudeste",0,"317160",5,14,4,10,4,10,0,0,0,0,0,14,4,10,4,10,4,9.04016040683522,9.52806656577634,0.413635452130949,31
"8473","MG","Virgínia",8663,13312.72,31056,"Itajubá",3,"Sudeste",0,"317170",2,10,0,10,7,3,0,0,0,0,0,10,0,10,7,3,8,9.49647524813683,9.06681636189014,0.331593923627322,29
"8474","MG","Virgínia",8663,13312.72,31056,"Itajubá",3,"Sudeste",0,"317170",3,8,0,8,5,3,0,0,0,0,0,8,0,8,5,3,4,9.49647524813683,9.06681636189014,0.431589020308054,31
"8475","MG","Virgínia",8663,13312.72,31056,"Itajubá",3,"Sudeste",0,"317170",4,9,1,8,3,6,0,0,0,0,0,9,1,8,3,6,0,9.49647524813683,9.06681636189014,0.493750694938982,30
"8476","MG","Virgínia",8663,13312.72,31056,"Itajubá",3,"Sudeste",0,"317170",5,4,2,2,3,1,0,0,0,0,0,4,2,2,3,1,9,9.49647524813683,9.06681636189014,0.467163624603811,31
"8477","MG","Virginópolis",10484,14031.09,31035,"Guanhães",3,"Sudeste",0,"317180",2,9,6,3,2,7,0,0,0,0,0,9,6,3,2,7,10,9.54903086074161,9.2576055644433,0.331929029789117,29
"8478","MG","Virginópolis",10484,14031.09,31035,"Guanhães",3,"Sudeste",0,"317180",3,5,2,3,2,3,0,0,0,0,0,5,2,3,2,3,4,9.54903086074161,9.2576055644433,0.408953824651075,31
"8479","MG","Virginópolis",10484,14031.09,31035,"Guanhães",3,"Sudeste",0,"317180",4,9,3,6,3,6,0,0,0,0,0,9,3,6,3,6,2,9.54903086074161,9.2576055644433,0.455902736353522,30
"8480","MG","Virginópolis",10484,14031.09,31035,"Guanhães",3,"Sudeste",0,"317180",5,9,2,7,2,7,0,0,0,0,0,9,2,7,2,7,5,9.54903086074161,9.2576055644433,0.421639950951209,31
"8481","MG","Visconde do Rio Branco",42965,26638.5,31064,"Ubá",3,"Sudeste",1,"317200",2,38,14,24,8,30,0,0,0,0,0,38,14,24,8,30,23,10.1901128167628,10.6681411097473,0.315287980903337,29
"8482","MG","Visconde do Rio Branco",42965,26638.5,31064,"Ubá",3,"Sudeste",1,"317200",3,36,17,19,12,24,0,0,0,0,0,36,17,19,12,24,26,10.1901128167628,10.6681411097473,0.414824198742395,31
"8483","MG","Visconde do Rio Branco",42965,26638.5,31064,"Ubá",3,"Sudeste",1,"317200",4,41,14,27,16,25,1,0,1,0,1,42,14,28,16,26,14,10.1901128167628,10.6681411097473,0.459855524184286,30
"8484","MG","Visconde do Rio Branco",42965,26638.5,31064,"Ubá",3,"Sudeste",1,"317200",5,46,15,31,17,29,0,0,0,0,0,46,15,31,17,29,34,10.1901128167628,10.6681411097473,0.41111534858466,31
"8485","ES","Afonso Cláudio",30455,15115.94,32007,"Afonso Cláudio",3,"Sudeste",0,"320010",2,31,6,25,7,24,0,0,0,0,0,31,6,25,7,24,11,9.62350509515745,10.3240054632706,0.313867370588825,29
"8486","ES","Afonso Cláudio",30455,15115.94,32007,"Afonso Cláudio",3,"Sudeste",0,"320010",3,38,17,21,20,18,1,0,1,0,1,39,17,22,20,19,18,9.62350509515745,10.3240054632706,0.390353489338522,31
"8487","ES","Afonso Cláudio",30455,15115.94,32007,"Afonso Cláudio",3,"Sudeste",0,"320010",4,32,9,23,16,16,0,0,0,0,0,32,9,23,16,16,22,9.62350509515745,10.3240054632706,0.441635351875493,30
"8488","ES","Afonso Cláudio",30455,15115.94,32007,"Afonso Cláudio",3,"Sudeste",0,"320010",5,24,11,13,9,15,1,1,0,1,0,25,12,13,10,15,18,9.62350509515745,10.3240054632706,0.427597901730409,31
"8489","ES","Água Doce do Norte",10909,12516.19,32001,"Barra de São Francisco",3,"Sudeste",0,"320016",2,20,8,12,9,11,0,0,0,0,0,20,8,12,9,11,5,9.43477828524242,9.29734341559776,0.338230060598948,29
"8490","ES","Água Doce do Norte",10909,12516.19,32001,"Barra de São Francisco",3,"Sudeste",0,"320016",3,15,6,9,7,8,1,0,1,0,1,16,6,10,7,9,12,9.43477828524242,9.29734341559776,0.401698580422487,31
"8491","ES","Água Doce do Norte",10909,12516.19,32001,"Barra de São Francisco",3,"Sudeste",0,"320016",4,12,3,9,6,6,0,0,0,0,0,12,3,9,6,6,4,9.43477828524242,9.29734341559776,0.46666750365755,30
"8492","ES","Água Doce do Norte",10909,12516.19,32001,"Barra de São Francisco",3,"Sudeste",0,"320016",5,11,3,8,2,9,0,0,0,0,0,11,3,8,2,9,12,9.43477828524242,9.29734341559776,0.495564147451543,31
"8493","ES","Alegre",29975,16201.29,32011,"Alegre",3,"Sudeste",0,"320020",2,16,4,12,3,13,0,0,0,0,0,16,4,12,3,13,20,9.69284614767983,10.3081189798957,0.304541460681388,29
"8494","ES","Alegre",29975,16201.29,32011,"Alegre",3,"Sudeste",0,"320020",3,26,6,20,9,17,0,0,0,0,0,26,6,20,9,17,18,9.69284614767983,10.3081189798957,0.413503401662895,31
"8495","ES","Alegre",29975,16201.29,32011,"Alegre",3,"Sudeste",0,"320020",4,32,2,30,11,21,0,0,0,0,0,32,2,30,11,21,16,9.69284614767983,10.3081189798957,0.461565091098452,30
"8496","ES","Alegre",29975,16201.29,32011,"Alegre",3,"Sudeste",0,"320020",5,35,8,27,11,24,0,0,0,0,0,35,8,27,11,24,24,9.69284614767983,10.3081189798957,0.421855761335575,31
"8497","ES","Alfredo Chaves",14636,22464.53,32010,"Guarapari",3,"Sudeste",0,"320030",2,11,3,8,2,9,1,1,0,1,0,12,4,8,3,9,4,10.0196928998521,9.5912395261391,0.304812371127357,29
"8498","ES","Alfredo Chaves",14636,22464.53,32010,"Guarapari",3,"Sudeste",0,"320030",3,8,1,7,2,6,0,0,0,0,0,8,1,7,2,6,7,10.0196928998521,9.5912395261391,0.389701240715273,31
"8499","ES","Alfredo Chaves",14636,22464.53,32010,"Guarapari",3,"Sudeste",0,"320030",4,7,0,7,6,1,1,1,0,0,1,8,1,7,6,2,7,10.0196928998521,9.5912395261391,0.450788317029282,30
"8500","ES","Alfredo Chaves",14636,22464.53,32010,"Guarapari",3,"Sudeste",0,"320030",5,8,3,5,5,3,1,0,1,0,1,9,3,6,5,4,7,10.0196928998521,9.5912395261391,0.458593552020694,31
"8501","ES","Alto Rio Novo",7874,11172.03,32003,"Colatina",3,"Sudeste",0,"320035",2,10,5,5,5,5,0,0,0,0,0,10,5,5,5,5,1,9.3211686123461,8.97132147150368,0.288486170968654,29
"8502","ES","Alto Rio Novo",7874,11172.03,32003,"Colatina",3,"Sudeste",0,"320035",3,4,1,3,1,3,0,0,0,0,0,4,1,3,1,3,3,9.3211686123461,8.97132147150368,0.370378905818608,31
"8503","ES","Alto Rio Novo",7874,11172.03,32003,"Colatina",3,"Sudeste",0,"320035",4,6,1,5,3,3,0,0,0,0,0,6,1,5,3,3,2,9.3211686123461,8.97132147150368,0.41036780550229,30
"8504","ES","Alto Rio Novo",7874,11172.03,32003,"Colatina",3,"Sudeste",0,"320035",5,8,2,6,4,4,0,0,0,0,0,8,2,6,4,4,2,9.3211686123461,8.97132147150368,0.382537500102302,31
"8505","ES","Anchieta",29779,32801.07,32010,"Guarapari",3,"Sudeste",0,"320040",2,35,11,24,13,22,0,0,0,0,0,35,11,24,13,22,5,10.3982164157914,10.3015587260906,0.296245519065778,29
"8506","ES","Anchieta",29779,32801.07,32010,"Guarapari",3,"Sudeste",0,"320040",3,29,7,22,11,18,0,0,0,0,0,29,7,22,11,18,19,10.3982164157914,10.3015587260906,0.399206879791331,31
"8507","ES","Anchieta",29779,32801.07,32010,"Guarapari",3,"Sudeste",0,"320040",4,39,10,29,14,25,0,0,0,0,0,39,10,29,14,25,12,10.3982164157914,10.3015587260906,0.451562443182934,30
"8508","ES","Anchieta",29779,32801.07,32010,"Guarapari",3,"Sudeste",0,"320040",5,40,7,33,19,21,0,0,0,0,0,40,7,33,19,21,12,10.3982164157914,10.3015587260906,0.424686899095169,31
"8509","ES","Apiacá",7554,13264.07,32012,"Cachoeiro de Itapemirim",3,"Sudeste",0,"320050",2,6,0,6,2,4,0,0,0,0,0,6,0,6,2,4,1,9.49281415480385,8.9298325032724,0.325701711311545,29
"8510","ES","Apiacá",7554,13264.07,32012,"Cachoeiro de Itapemirim",3,"Sudeste",0,"320050",3,8,0,8,2,6,0,0,0,0,0,8,0,8,2,6,7,9.49281415480385,8.9298325032724,0.435950793340469,31
"8511","ES","Apiacá",7554,13264.07,32012,"Cachoeiro de Itapemirim",3,"Sudeste",0,"320050",4,7,2,5,2,5,0,0,0,0,0,7,2,5,2,5,6,9.49281415480385,8.9298325032724,0.456362265385729,30
"8512","ES","Apiacá",7554,13264.07,32012,"Cachoeiro de Itapemirim",3,"Sudeste",0,"320050",5,3,2,1,1,2,0,0,0,0,0,3,2,1,1,2,6,9.49281415480385,8.9298325032724,0.455279353365769,31
"8513","ES","Aracruz",103101,53275.98,32006,"Linhares",3,"Sudeste",1,"320060",2,110,25,85,44,66,0,0,0,0,0,110,25,85,44,66,28,10.8832408519173,11.5434643692791,0.297916797313062,29
"8514","ES","Aracruz",103101,53275.98,32006,"Linhares",3,"Sudeste",1,"320060",3,100,21,79,34,66,2,1,1,1,1,102,22,80,35,67,37,10.8832408519173,11.5434643692791,0.39480388441482,31
"8515","ES","Aracruz",103101,53275.98,32006,"Linhares",3,"Sudeste",1,"320060",4,108,22,86,36,72,1,0,1,1,0,109,22,87,37,72,38,10.8832408519173,11.5434643692791,0.451242294551509,30
"8516","ES","Aracruz",103101,53275.98,32006,"Linhares",3,"Sudeste",1,"320060",5,131,22,109,40,91,2,1,1,1,1,133,23,110,41,92,45,10.8832408519173,11.5434643692791,0.410756577994945,31
"8517","ES","Atílio Vivácqua",12105,23595.12,32012,"Cachoeiro de Itapemirim",3,"Sudeste",0,"320070",2,14,2,12,6,8,0,0,0,0,0,14,2,12,6,8,5,10.0687951899708,9.40137386937216,0.311539895057337,29
"8518","ES","Atílio Vivácqua",12105,23595.12,32012,"Cachoeiro de Itapemirim",3,"Sudeste",0,"320070",3,12,4,8,4,8,0,0,0,0,0,12,4,8,4,8,6,10.0687951899708,9.40137386937216,0.384209999724584,31
"8519","ES","Atílio Vivácqua",12105,23595.12,32012,"Cachoeiro de Itapemirim",3,"Sudeste",0,"320070",4,10,2,8,6,4,0,0,0,0,0,10,2,8,6,4,4,10.0687951899708,9.40137386937216,0.416040050163785,30
"8520","ES","Atílio Vivácqua",12105,23595.12,32012,"Cachoeiro de Itapemirim",3,"Sudeste",0,"320070",5,13,2,11,3,10,0,0,0,0,0,13,2,11,3,10,6,10.0687951899708,9.40137386937216,0.399696698119205,31
"8521","ES","Baixo Guandu",31132,23458.52,32003,"Colatina",3,"Sudeste",0,"320080",2,31,10,21,10,21,0,0,0,0,0,31,10,21,10,21,16,10.0629890341134,10.3459915080793,0.330831481247917,29
"8522","ES","Baixo Guandu",31132,23458.52,32003,"Colatina",3,"Sudeste",0,"320080",3,29,8,21,5,24,0,0,0,0,0,29,8,21,5,24,25,10.0629890341134,10.3459915080793,0.397364254460877,31
"8523","ES","Baixo Guandu",31132,23458.52,32003,"Colatina",3,"Sudeste",0,"320080",4,19,7,12,7,12,0,0,0,0,0,19,7,12,7,12,21,10.0629890341134,10.3459915080793,0.425768742702776,30
"8524","ES","Baixo Guandu",31132,23458.52,32003,"Colatina",3,"Sudeste",0,"320080",5,21,4,17,6,15,1,0,1,0,1,22,4,18,6,16,19,10.0629890341134,10.3459915080793,0.438382997999098,31
"8525","ES","Barra de São Francisco",44979,19565.97,32001,"Barra de São Francisco",3,"Sudeste",0,"320090",2,37,11,26,9,28,0,0,0,0,0,37,11,26,9,28,25,9.8815471117442,10.713950993163,0.308395600301728,29
"8526","ES","Barra de São Francisco",44979,19565.97,32001,"Barra de São Francisco",3,"Sudeste",0,"320090",3,50,17,33,25,25,0,0,0,0,0,50,17,33,25,25,21,9.8815471117442,10.713950993163,0.375441073997317,31
"8527","ES","Barra de São Francisco",44979,19565.97,32001,"Barra de São Francisco",3,"Sudeste",0,"320090",4,61,12,49,21,40,0,0,0,0,0,61,12,49,21,40,21,9.8815471117442,10.713950993163,0.398084971407107,30
"8528","ES","Barra de São Francisco",44979,19565.97,32001,"Barra de São Francisco",3,"Sudeste",0,"320090",5,61,21,40,29,32,0,0,0,0,0,61,21,40,29,32,28,9.8815471117442,10.713950993163,0.408770051148641,31
"8529","ES","Boa Esperança",15092,14821.67,32002,"Nova Venécia",3,"Sudeste",0,"320100",2,9,2,7,6,3,0,0,0,0,0,9,2,7,6,3,12,9.60384557806159,9.6219200810842,0.273848933051992,29
"8530","ES","Boa Esperança",15092,14821.67,32002,"Nova Venécia",3,"Sudeste",0,"320100",3,12,4,8,4,8,1,0,1,0,1,13,4,9,4,9,11,9.60384557806159,9.6219200810842,0.338342098350856,31
"8531","ES","Boa Esperança",15092,14821.67,32002,"Nova Venécia",3,"Sudeste",0,"320100",4,15,4,11,7,8,0,0,0,0,0,15,4,11,7,8,3,9.60384557806159,9.6219200810842,0.358549456410005,30
"8532","ES","Boa Esperança",15092,14821.67,32002,"Nova Venécia",3,"Sudeste",0,"320100",5,15,4,11,5,10,0,0,0,0,0,15,4,11,5,10,9,9.60384557806159,9.6219200810842,0.387121060450373,31
"8533","ES","Bom Jesus do Norte",9962,15306.98,32012,"Cachoeiro de Itapemirim",3,"Sudeste",1,"320110",2,8,1,7,4,4,0,0,0,0,0,8,1,7,4,4,5,9.6360642124991,9.20653313363323,0.341346543764206,29
"8534","ES","Bom Jesus do Norte",9962,15306.98,32012,"Cachoeiro de Itapemirim",3,"Sudeste",1,"320110",3,5,1,4,3,2,0,0,0,0,0,5,1,4,3,2,7,9.6360642124991,9.20653313363323,0.431902753685234,31
"8535","ES","Bom Jesus do Norte",9962,15306.98,32012,"Cachoeiro de Itapemirim",3,"Sudeste",1,"320110",4,8,2,6,2,6,0,0,0,0,0,8,2,6,2,6,5,9.6360642124991,9.20653313363323,0.470807074775485,30
"8536","ES","Bom Jesus do Norte",9962,15306.98,32012,"Cachoeiro de Itapemirim",3,"Sudeste",1,"320110",5,10,2,8,5,5,0,0,0,0,0,10,2,8,5,5,9,9.6360642124991,9.20653313363323,0.449337803409706,31
"8537","ES","Brejetuba",12427,19755.05,32007,"Afonso Cláudio",3,"Sudeste",0,"320115",2,10,3,7,4,6,0,0,0,0,0,10,3,7,4,6,5,9.8911644338471,9.42762680380599,0.30895933067779,29
"8538","ES","Brejetuba",12427,19755.05,32007,"Afonso Cláudio",3,"Sudeste",0,"320115",3,14,5,9,7,7,1,1,0,0,1,15,6,9,7,8,7,9.8911644338471,9.42762680380599,0.413768857943515,31
"8539","ES","Brejetuba",12427,19755.05,32007,"Afonso Cláudio",3,"Sudeste",0,"320115",4,16,9,7,5,11,0,0,0,0,0,16,9,7,5,11,7,9.8911644338471,9.42762680380599,0.444439917497532,30
"8540","ES","Brejetuba",12427,19755.05,32007,"Afonso Cláudio",3,"Sudeste",0,"320115",5,22,6,16,7,15,0,0,0,0,0,22,6,16,7,15,3,9.8911644338471,9.42762680380599,0.426939690454363,31
"8541","ES","Cachoeiro de Itapemirim",210589,23955.74,32012,"Cachoeiro de Itapemirim",3,"Sudeste",1,"320120",2,177,41,136,61,116,0,0,0,0,0,177,41,136,61,116,96,10.0839632400945,12.257663645599,0.308102565292155,29
"8542","ES","Cachoeiro de Itapemirim",210589,23955.74,32012,"Cachoeiro de Itapemirim",3,"Sudeste",1,"320120",3,191,44,147,62,129,2,1,1,1,1,193,45,148,63,130,117,10.0839632400945,12.257663645599,0.399998334994765,31
"8543","ES","Cachoeiro de Itapemirim",210589,23955.74,32012,"Cachoeiro de Itapemirim",3,"Sudeste",1,"320120",4,223,37,186,78,145,0,0,0,0,0,223,37,186,78,145,105,10.0839632400945,12.257663645599,0.43616881349333,30
"8544","ES","Cachoeiro de Itapemirim",210589,23955.74,32012,"Cachoeiro de Itapemirim",3,"Sudeste",1,"320120",5,200,52,148,74,126,1,0,1,0,1,201,52,149,74,127,135,10.0839632400945,12.257663645599,0.401839065227253,31
"8545","ES","Cariacica",383917,25849.32,32009,"Vitória",3,"Sudeste",1,"320130",2,391,98,293,140,251,2,2,0,1,1,393,100,293,141,252,205,10.1600395739813,12.8581816623737,0.302930224161744,29
"8546","ES","Cariacica",383917,25849.32,32009,"Vitória",3,"Sudeste",1,"320130",3,393,107,286,157,236,4,2,2,3,1,397,109,288,160,237,255,10.1600395739813,12.8581816623737,0.402127111283115,31
"8547","ES","Cariacica",383917,25849.32,32009,"Vitória",3,"Sudeste",1,"320130",4,411,93,318,142,269,3,1,2,0,3,414,94,320,142,272,243,10.1600395739813,12.8581816623737,0.449384264481152,30
"8548","ES","Cariacica",383917,25849.32,32009,"Vitória",3,"Sudeste",1,"320130",5,447,126,321,182,265,4,1,3,2,2,451,127,324,184,267,318,10.1600395739813,12.8581816623737,0.42176433869806,31
"8549","ES","Castelo",37747,25359.43,32012,"Cachoeiro de Itapemirim",3,"Sudeste",0,"320140",2,26,8,18,3,23,0,0,0,0,0,26,8,18,3,23,21,10.1409059319579,10.5386612813206,0.301626934126646,29
"8550","ES","Castelo",37747,25359.43,32012,"Cachoeiro de Itapemirim",3,"Sudeste",0,"320140",3,33,5,28,9,24,0,0,0,0,0,33,5,28,9,24,18,10.1409059319579,10.5386612813206,0.386625303271478,31
"8551","ES","Castelo",37747,25359.43,32012,"Cachoeiro de Itapemirim",3,"Sudeste",0,"320140",4,30,4,26,7,23,1,0,1,1,0,31,4,27,8,23,16,10.1409059319579,10.5386612813206,0.423968369555021,30
"8552","ES","Castelo",37747,25359.43,32012,"Cachoeiro de Itapemirim",3,"Sudeste",0,"320140",5,32,9,23,11,21,0,0,0,0,0,32,9,23,11,21,21,10.1409059319579,10.5386612813206,0.393456383180271,31
"8553","ES","Colatina",123400,28661.78,32003,"Colatina",3,"Sudeste",1,"320150",2,117,23,94,40,77,1,0,1,0,1,118,23,95,40,78,66,10.2633198069204,11.7231863904534,0.303809732334419,29
"8554","ES","Colatina",123400,28661.78,32003,"Colatina",3,"Sudeste",1,"320150",3,131,30,101,43,88,1,0,1,0,1,132,30,102,43,89,58,10.2633198069204,11.7231863904534,0.400949923403841,31
"8555","ES","Colatina",123400,28661.78,32003,"Colatina",3,"Sudeste",1,"320150",4,114,22,92,43,71,3,3,0,0,3,117,25,92,43,74,58,10.2633198069204,11.7231863904534,0.463005166158852,30
"8556","ES","Colatina",123400,28661.78,32003,"Colatina",3,"Sudeste",1,"320150",5,121,29,92,36,85,1,0,1,1,0,122,29,93,37,85,72,10.2633198069204,11.7231863904534,0.420473075965752,31
"8557","ES","Conceição da Barra",31273,15291.37,32005,"São Mateus",3,"Sudeste",0,"320160",2,32,9,23,9,23,0,0,0,0,0,32,9,23,9,23,17,9.63504389595561,10.3505103844494,0.289017742685388,29
"8558","ES","Conceição da Barra",31273,15291.37,32005,"São Mateus",3,"Sudeste",0,"320160",3,28,6,22,9,19,0,0,0,0,0,28,6,22,9,19,14,9.63504389595561,10.3505103844494,0.373446528356678,31
"8559","ES","Conceição da Barra",31273,15291.37,32005,"São Mateus",3,"Sudeste",0,"320160",4,36,9,27,16,20,2,1,1,1,1,38,10,28,17,21,12,9.63504389595561,10.3505103844494,0.402239843725544,30
"8560","ES","Conceição da Barra",31273,15291.37,32005,"São Mateus",3,"Sudeste",0,"320160",5,36,8,28,15,21,1,1,0,1,0,37,9,28,16,21,17,9.63504389595561,10.3505103844494,0.381718900160492,31
"8561","ES","Conceição do Castelo",12806,17291.89,32007,"Afonso Cláudio",3,"Sudeste",0,"320170",2,17,5,12,5,12,1,1,0,0,1,18,6,12,5,13,12,9.75799288444413,9.45766909007875,0.279183498291586,29
"8562","ES","Conceição do Castelo",12806,17291.89,32007,"Afonso Cláudio",3,"Sudeste",0,"320170",3,17,11,6,7,10,0,0,0,0,0,17,11,6,7,10,8,9.75799288444413,9.45766909007875,0.353526383508966,31
"8563","ES","Conceição do Castelo",12806,17291.89,32007,"Afonso Cláudio",3,"Sudeste",0,"320170",4,12,3,9,2,10,0,0,0,0,0,12,3,9,2,10,7,9.75799288444413,9.45766909007875,0.374595375719163,30
"8564","ES","Conceição do Castelo",12806,17291.89,32007,"Afonso Cláudio",3,"Sudeste",0,"320170",5,9,0,9,1,8,0,0,0,0,0,9,0,9,1,8,9,9.75799288444413,9.45766909007875,0.369666065935397,31
"8565","ES","Domingos Martins",33986,21809.72,32007,"Afonso Cláudio",3,"Sudeste",0,"320190",2,42,16,26,11,31,0,0,0,0,0,42,16,26,11,31,20,9.99011102096563,10.4337039540941,0.287658817547014,29
"8566","ES","Domingos Martins",33986,21809.72,32007,"Afonso Cláudio",3,"Sudeste",0,"320190",3,23,8,15,5,18,0,0,0,0,0,23,8,15,5,18,14,9.99011102096563,10.4337039540941,0.392554954272269,31
"8567","ES","Domingos Martins",33986,21809.72,32007,"Afonso Cláudio",3,"Sudeste",0,"320190",4,33,10,23,8,25,0,0,0,0,0,33,10,23,8,25,14,9.99011102096563,10.4337039540941,0.457031986756163,30
"8568","ES","Domingos Martins",33986,21809.72,32007,"Afonso Cláudio",3,"Sudeste",0,"320190",5,39,19,20,15,24,0,0,0,0,0,39,19,20,15,24,21,9.99011102096563,10.4337039540941,0.44515249224291,31
"8569","ES","Dores do Rio Preto",6771,21173.21,32011,"Alegre",3,"Sudeste",0,"320200",2,8,2,6,3,5,0,0,0,0,0,8,2,6,3,5,9,9.96049198229892,8.82040406548565,0.332421376960002,29
"8570","ES","Dores do Rio Preto",6771,21173.21,32011,"Alegre",3,"Sudeste",0,"320200",3,5,3,2,2,3,0,0,0,0,0,5,3,2,2,3,1,9.96049198229892,8.82040406548565,0.386320859666728,31
"8571","ES","Dores do Rio Preto",6771,21173.21,32011,"Alegre",3,"Sudeste",0,"320200",4,8,2,6,5,3,0,0,0,0,0,8,2,6,5,3,2,9.96049198229892,8.82040406548565,0.420319595469416,30
"8572","ES","Dores do Rio Preto",6771,21173.21,32011,"Alegre",3,"Sudeste",0,"320200",5,6,2,4,3,3,0,0,0,0,0,6,2,4,3,3,2,9.96049198229892,8.82040406548565,0.423445333176733,31
"8573","ES","Ecoporanga",22835,13488.06,32001,"Barra de São Francisco",3,"Sudeste",0,"320210",2,20,8,12,10,10,0,0,0,0,0,20,8,12,10,10,11,9.50956012863032,10.0360497256191,0.293881035085578,29
"8574","ES","Ecoporanga",22835,13488.06,32001,"Barra de São Francisco",3,"Sudeste",0,"320210",3,25,7,18,8,17,0,0,0,0,0,25,7,18,8,17,17,9.50956012863032,10.0360497256191,0.379193645448363,31
"8575","ES","Ecoporanga",22835,13488.06,32001,"Barra de São Francisco",3,"Sudeste",0,"320210",4,19,5,14,6,13,0,0,0,0,0,19,5,14,6,13,18,9.50956012863032,10.0360497256191,0.409586104372037,30
"8576","ES","Ecoporanga",22835,13488.06,32001,"Barra de São Francisco",3,"Sudeste",0,"320210",5,23,11,12,9,14,1,0,1,1,0,24,11,13,10,14,23,9.50956012863032,10.0360497256191,0.437473521901671,31
"8577","ES","Fundão",21948,22597.47,32006,"Linhares",3,"Sudeste",1,"320220",2,17,5,12,6,11,0,0,0,0,0,17,5,12,6,11,16,10.0255932320912,9.99643129817887,0.315407869385428,29
"8578","ES","Fundão",21948,22597.47,32006,"Linhares",3,"Sudeste",1,"320220",3,33,10,23,12,21,0,0,0,0,0,33,10,23,12,21,14,10.0255932320912,9.99643129817887,0.406954597759696,31
"8579","ES","Fundão",21948,22597.47,32006,"Linhares",3,"Sudeste",1,"320220",4,18,8,10,4,14,1,0,1,1,0,19,8,11,5,14,10,10.0255932320912,9.99643129817887,0.453495381961444,30
"8580","ES","Fundão",21948,22597.47,32006,"Linhares",3,"Sudeste",1,"320220",5,25,11,14,14,11,1,0,1,0,1,26,11,15,14,12,17,10.0255932320912,9.99643129817887,0.437211881263596,31
"8581","ES","Governador Lindenberg",12880,16570.49,32003,"Colatina",3,"Sudeste",0,"320225",2,8,3,5,2,6,0,0,0,0,0,8,3,5,2,6,2,9.71537868149817,9.46343099965834,0.296080079469787,29
"8582","ES","Governador Lindenberg",12880,16570.49,32003,"Colatina",3,"Sudeste",0,"320225",3,14,3,11,1,13,0,0,0,0,0,14,3,11,1,13,5,9.71537868149817,9.46343099965834,0.372797439190413,31
"8583","ES","Governador Lindenberg",12880,16570.49,32003,"Colatina",3,"Sudeste",0,"320225",4,16,3,13,5,11,0,0,0,0,0,16,3,13,5,11,6,9.71537868149817,9.46343099965834,0.386506614231806,30
"8584","ES","Governador Lindenberg",12880,16570.49,32003,"Colatina",3,"Sudeste",0,"320225",5,10,0,10,6,4,0,0,0,0,0,10,0,10,6,4,3,9.71537868149817,9.46343099965834,0.427164514697635,31
"8585","ES","Guaçuí",31122,17266.14,32011,"Alegre",3,"Sudeste",0,"320230",2,26,8,18,6,20,0,0,0,0,0,26,8,18,6,20,11,9.75650263718377,10.3456702435795,0.312385321743385,29
"8586","ES","Guaçuí",31122,17266.14,32011,"Alegre",3,"Sudeste",0,"320230",3,23,8,15,12,11,0,0,0,0,0,23,8,15,12,11,24,9.75650263718377,10.3456702435795,0.391149066383839,31
"8587","ES","Guaçuí",31122,17266.14,32011,"Alegre",3,"Sudeste",0,"320230",4,38,20,18,12,26,0,0,0,0,0,38,20,18,12,26,23,9.75650263718377,10.3456702435795,0.442569984586322,30
"8588","ES","Guaçuí",31122,17266.14,32011,"Alegre",3,"Sudeste",0,"320230",5,33,14,19,13,20,0,0,0,0,0,33,14,19,13,20,19,9.75650263718377,10.3456702435795,0.412946587164795,31
"8589","ES","Guarapari",126701,18759.57,32010,"Guarapari",3,"Sudeste",1,"320240",2,134,51,83,49,85,0,0,0,0,0,134,51,83,49,85,61,9.83945930118878,11.7495852589379,0.292293663030855,29
"8590","ES","Guarapari",126701,18759.57,32010,"Guarapari",3,"Sudeste",1,"320240",3,134,40,94,54,80,0,0,0,0,0,134,40,94,54,80,57,9.83945930118878,11.7495852589379,0.402010877878864,31
"8591","ES","Guarapari",126701,18759.57,32010,"Guarapari",3,"Sudeste",1,"320240",4,145,33,112,54,91,3,2,1,1,2,148,35,113,55,93,62,9.83945930118878,11.7495852589379,0.451579028843603,30
"8592","ES","Guarapari",126701,18759.57,32010,"Guarapari",3,"Sudeste",1,"320240",5,134,47,87,47,87,1,0,1,0,1,135,47,88,47,88,78,9.83945930118878,11.7495852589379,0.416429217779189,31
"8593","ES","Ibatiba",26426,13471.54,32011,"Alegre",3,"Sudeste",0,"320245",2,36,12,24,16,20,1,1,0,1,0,37,13,24,17,20,9,9.50833459100605,10.1821036529742,0.30647984105059,29
"8594","ES","Ibatiba",26426,13471.54,32011,"Alegre",3,"Sudeste",0,"320245",3,27,7,20,8,19,0,0,0,0,0,27,7,20,8,19,13,9.50833459100605,10.1821036529742,0.395566750281087,31
"8595","ES","Ibatiba",26426,13471.54,32011,"Alegre",3,"Sudeste",0,"320245",4,28,14,14,13,15,1,1,0,0,1,29,15,14,13,16,17,9.50833459100605,10.1821036529742,0.424964699765649,30
"8596","ES","Ibatiba",26426,13471.54,32011,"Alegre",3,"Sudeste",0,"320245",5,23,9,14,10,13,1,1,0,0,1,24,10,14,10,14,15,9.50833459100605,10.1821036529742,0.420250742440867,31
"8597","ES","Ibiraçu",12591,21114.9,32006,"Linhares",3,"Sudeste",0,"320250",2,10,1,9,5,5,0,0,0,0,0,10,1,9,5,5,4,9.95773423138714,9.4407375520017,0.297042108981978,29
"8598","ES","Ibiraçu",12591,21114.9,32006,"Linhares",3,"Sudeste",0,"320250",3,15,3,12,7,8,0,0,0,0,0,15,3,12,7,8,10,9.95773423138714,9.4407375520017,0.388869716093947,31
"8599","ES","Ibiraçu",12591,21114.9,32006,"Linhares",3,"Sudeste",0,"320250",4,16,1,15,5,11,1,1,0,1,0,17,2,15,6,11,1,9.95773423138714,9.4407375520017,0.457556810400405,30
"8600","ES","Ibiraçu",12591,21114.9,32006,"Linhares",3,"Sudeste",0,"320250",5,12,4,8,5,7,1,1,0,0,1,13,5,8,5,8,5,9.95773423138714,9.4407375520017,0.439877789499099,31
"8601","ES","Ibitirama",8859,13916.44,32011,"Alegre",3,"Sudeste",0,"320255",2,13,7,6,5,8,0,0,0,0,0,13,7,6,5,8,5,9.5408261540531,9.08918917041203,0.28594466527458,29
"8602","ES","Ibitirama",8859,13916.44,32011,"Alegre",3,"Sudeste",0,"320255",3,12,5,7,5,7,0,0,0,0,0,12,5,7,5,7,7,9.5408261540531,9.08918917041203,0.361938016746398,31
"8603","ES","Ibitirama",8859,13916.44,32011,"Alegre",3,"Sudeste",0,"320255",4,7,5,2,5,2,0,0,0,0,0,7,5,2,5,2,2,9.5408261540531,9.08918917041203,0.382054634851033,30
"8604","ES","Ibitirama",8859,13916.44,32011,"Alegre",3,"Sudeste",0,"320255",5,14,6,8,6,8,0,0,0,0,0,14,6,8,6,8,11,9.5408261540531,9.08918917041203,0.390614138806518,31
"8605","ES","Iconha",13973,24144.49,32010,"Guarapari",3,"Sudeste",0,"320260",2,9,5,4,4,5,0,0,0,0,0,9,5,4,4,5,4,10.091811475699,9.54488217508045,0.271007956851516,29
"8606","ES","Iconha",13973,24144.49,32010,"Guarapari",3,"Sudeste",0,"320260",3,13,2,11,5,8,0,0,0,0,0,13,2,11,5,8,4,10.091811475699,9.54488217508045,0.348163465653437,31
"8607","ES","Iconha",13973,24144.49,32010,"Guarapari",3,"Sudeste",0,"320260",4,11,2,9,1,10,0,0,0,0,0,11,2,9,1,10,9,10.091811475699,9.54488217508045,0.402113302903211,30
"8608","ES","Iconha",13973,24144.49,32010,"Guarapari",3,"Sudeste",0,"320260",5,15,3,12,5,10,0,0,0,0,0,15,3,12,5,10,15,10.091811475699,9.54488217508045,0.379017483461689,31
"8609","ES","Irupi",13526,16516.01,32011,"Alegre",3,"Sudeste",0,"320265",2,11,5,6,2,9,0,0,0,0,0,11,5,6,2,9,5,9.71208549247928,9.51236903813489,0.33469677015204,29
"8610","ES","Irupi",13526,16516.01,32011,"Alegre",3,"Sudeste",0,"320265",3,14,7,7,5,9,0,0,0,0,0,14,7,7,5,9,9,9.71208549247928,9.51236903813489,0.42300605590301,31
"8611","ES","Irupi",13526,16516.01,32011,"Alegre",3,"Sudeste",0,"320265",4,11,5,6,7,4,0,0,0,0,0,11,5,6,7,4,6,9.71208549247928,9.51236903813489,0.445827737921123,30
"8612","ES","Irupi",13526,16516.01,32011,"Alegre",3,"Sudeste",0,"320265",5,13,5,8,6,7,0,0,0,0,0,13,5,8,6,7,13,9.71208549247928,9.51236903813489,0.431701434473093,31
"8613","ES","Itaguaçu",14023,18351.45,32008,"Santa Teresa",3,"Sudeste",0,"320270",2,20,6,14,12,8,0,0,0,0,0,20,6,14,12,8,14,9.81746386943444,9.54845411772665,0.281176910413492,29
"8614","ES","Itaguaçu",14023,18351.45,32008,"Santa Teresa",3,"Sudeste",0,"320270",3,14,6,8,6,8,0,0,0,0,0,14,6,8,6,8,13,9.81746386943444,9.54845411772665,0.356631822671224,31
"8615","ES","Itaguaçu",14023,18351.45,32008,"Santa Teresa",3,"Sudeste",0,"320270",4,7,1,6,1,6,0,0,0,0,0,7,1,6,1,6,8,9.81746386943444,9.54845411772665,0.400348051549557,30
"8616","ES","Itaguaçu",14023,18351.45,32008,"Santa Teresa",3,"Sudeste",0,"320270",5,11,5,6,6,5,0,0,0,0,0,11,5,6,6,5,10,9.81746386943444,9.54845411772665,0.418929443939971,31
"8617","ES","Itapemirim",34656,167621.34,32013,"Itapemirim",3,"Sudeste",0,"320280",2,37,11,26,13,24,0,0,0,0,0,37,11,26,13,24,24,12.0294627858937,10.4532261498007,0.319891328528066,29
"8618","ES","Itapemirim",34656,167621.34,32013,"Itapemirim",3,"Sudeste",0,"320280",3,41,10,31,16,25,0,0,0,0,0,41,10,31,16,25,13,12.0294627858937,10.4532261498007,0.419151460264102,31
"8619","ES","Itapemirim",34656,167621.34,32013,"Itapemirim",3,"Sudeste",0,"320280",4,45,10,35,24,21,0,0,0,0,0,45,10,35,24,21,14,12.0294627858937,10.4532261498007,0.455489450081892,30
"8620","ES","Itapemirim",34656,167621.34,32013,"Itapemirim",3,"Sudeste",0,"320280",5,45,12,33,15,30,1,1,0,1,0,46,13,33,16,30,29,12.0294627858937,10.4532261498007,0.444361758453027,31
"8621","ES","Itarana",10494,20500.74,32008,"Santa Teresa",3,"Sudeste",0,"320290",2,9,1,8,4,5,0,0,0,0,0,9,1,8,4,5,3,9.92821626203597,9.25855894424666,0.301034260771035,29
"8622","ES","Itarana",10494,20500.74,32008,"Santa Teresa",3,"Sudeste",0,"320290",3,3,1,2,1,2,0,0,0,0,0,3,1,2,1,2,7,9.92821626203597,9.25855894424666,0.405708722467377,31
"8623","ES","Itarana",10494,20500.74,32008,"Santa Teresa",3,"Sudeste",0,"320290",4,6,1,5,3,3,0,0,0,0,0,6,1,5,3,3,4,9.92821626203597,9.25855894424666,0.441556489502511,30
"8624","ES","Itarana",10494,20500.74,32008,"Santa Teresa",3,"Sudeste",0,"320290",5,12,3,9,6,6,0,0,0,0,0,12,3,9,6,6,10,9.92821626203597,9.25855894424666,0.456020116183865,31
"8625","ES","Iúna",29290,14802.25,32011,"Alegre",3,"Sudeste",0,"320300",2,22,10,12,6,16,0,0,0,0,0,22,10,12,6,16,18,9.6025344752243,10.2850014398218,0.307170543724685,29
"8626","ES","Iúna",29290,14802.25,32011,"Alegre",3,"Sudeste",0,"320300",3,27,13,14,9,18,1,0,1,0,1,28,13,15,9,19,26,9.6025344752243,10.2850014398218,0.394663249530602,31
"8627","ES","Iúna",29290,14802.25,32011,"Alegre",3,"Sudeste",0,"320300",4,16,7,9,5,11,0,0,0,0,0,16,7,9,5,11,13,9.6025344752243,10.2850014398218,0.408307787449589,30
"8628","ES","Iúna",29290,14802.25,32011,"Alegre",3,"Sudeste",0,"320300",5,16,11,5,9,7,0,0,0,0,0,16,11,5,9,7,18,9.6025344752243,10.2850014398218,0.389195242026931,31
"8629","ES","Jaguaré",31039,20307.12,32005,"São Mateus",3,"Sudeste",0,"320305",2,31,16,15,11,20,0,0,0,0,0,31,16,15,11,20,15,9.91872684245162,10.3429997572833,0.293030103528092,29
"8630","ES","Jaguaré",31039,20307.12,32005,"São Mateus",3,"Sudeste",0,"320305",3,30,10,20,12,18,0,0,0,0,0,30,10,20,12,18,15,9.91872684245162,10.3429997572833,0.371545977551885,31
"8631","ES","Jaguaré",31039,20307.12,32005,"São Mateus",3,"Sudeste",0,"320305",4,40,17,23,17,23,0,0,0,0,0,40,17,23,17,23,11,9.91872684245162,10.3429997572833,0.371129968860853,30
"8632","ES","Jaguaré",31039,20307.12,32005,"São Mateus",3,"Sudeste",0,"320305",5,43,17,26,21,22,2,0,2,1,1,45,17,28,22,23,10,9.91872684245162,10.3429997572833,0.369571398595498,31
"8633","ES","Jerônimo Monteiro",12265,12602.63,32012,"Cachoeiro de Itapemirim",3,"Sudeste",0,"320310",2,8,4,4,5,3,0,0,0,0,0,8,4,4,5,3,12,9.44166080131719,9.41450495669259,0.299756297148409,29
"8634","ES","Jerônimo Monteiro",12265,12602.63,32012,"Cachoeiro de Itapemirim",3,"Sudeste",0,"320310",3,9,4,5,6,3,0,0,0,0,0,9,4,5,6,3,7,9.44166080131719,9.41450495669259,0.383426168210137,31
"8635","ES","Jerônimo Monteiro",12265,12602.63,32012,"Cachoeiro de Itapemirim",3,"Sudeste",0,"320310",4,7,2,5,3,4,0,0,0,0,0,7,2,5,3,4,8,9.44166080131719,9.41450495669259,0.444373706463403,30
"8636","ES","Jerônimo Monteiro",12265,12602.63,32012,"Cachoeiro de Itapemirim",3,"Sudeste",0,"320310",5,18,2,16,6,12,0,0,0,0,0,18,2,16,6,12,6,9.44166080131719,9.41450495669259,0.418370766188787,31
"8637","ES","João Neiva",16722,29701.16,32006,"Linhares",3,"Sudeste",0,"320313",2,13,1,12,2,11,0,0,0,0,0,13,1,12,2,11,6,10.2989413812671,9.72448049671,0.276752530630408,29
"8638","ES","João Neiva",16722,29701.16,32006,"Linhares",3,"Sudeste",0,"320313",3,15,3,12,8,7,0,0,0,0,0,15,3,12,8,7,10,10.2989413812671,9.72448049671,0.362220683439482,31
"8639","ES","João Neiva",16722,29701.16,32006,"Linhares",3,"Sudeste",0,"320313",4,15,3,12,6,9,0,0,0,0,0,15,3,12,6,9,11,10.2989413812671,9.72448049671,0.414384998133369,30
"8640","ES","João Neiva",16722,29701.16,32006,"Linhares",3,"Sudeste",0,"320313",5,21,6,15,6,15,0,0,0,0,0,21,6,15,6,15,13,10.2989413812671,9.72448049671,0.392393027228395,31
"8641","ES","Laranja da Terra",10933,12066.3,32007,"Afonso Cláudio",3,"Sudeste",0,"320316",2,6,4,2,6,0,0,0,0,0,0,6,4,2,6,0,7,9.39817172194373,9.29954101743449,0.340292060974319,29
"8642","ES","Laranja da Terra",10933,12066.3,32007,"Afonso Cláudio",3,"Sudeste",0,"320316",3,17,5,12,5,12,0,0,0,0,0,17,5,12,5,12,7,9.39817172194373,9.29954101743449,0.409618877451984,31
"8643","ES","Laranja da Terra",10933,12066.3,32007,"Afonso Cláudio",3,"Sudeste",0,"320316",4,11,3,8,5,6,0,0,0,0,0,11,3,8,5,6,5,9.39817172194373,9.29954101743449,0.475122960843672,30
"8644","ES","Laranja da Terra",10933,12066.3,32007,"Afonso Cláudio",3,"Sudeste",0,"320316",5,10,1,9,2,8,0,0,0,0,0,10,1,9,2,8,8,9.39817172194373,9.29954101743449,0.455598817197777,31
"8645","ES","Linhares",176688,35738.53,32006,"Linhares",3,"Sudeste",1,"320320",2,181,53,128,61,120,1,0,1,0,1,182,53,129,61,121,68,10.4839846574814,12.0821407442869,0.29601506818644,29
"8646","ES","Linhares",176688,35738.53,32006,"Linhares",3,"Sudeste",1,"320320",3,164,43,121,50,114,0,0,0,0,0,164,43,121,50,114,93,10.4839846574814,12.0821407442869,0.397545367304404,31
"8647","ES","Linhares",176688,35738.53,32006,"Linhares",3,"Sudeste",1,"320320",4,215,61,154,77,138,2,2,0,2,0,217,63,154,79,138,78,10.4839846574814,12.0821407442869,0.443760484998008,30
"8648","ES","Linhares",176688,35738.53,32006,"Linhares",3,"Sudeste",1,"320320",5,202,53,149,86,116,0,0,0,0,0,202,53,149,86,116,74,10.4839846574814,12.0821407442869,0.398362153078918,31
"8649","ES","Mantenópolis",15503,10723.04,32001,"Barra de São Francisco",3,"Sudeste",0,"320330",2,10,4,6,2,8,0,0,0,0,0,10,4,6,2,8,10,9.28014997651255,9.64878883256636,0.298137873521294,29
"8650","ES","Mantenópolis",15503,10723.04,32001,"Barra de São Francisco",3,"Sudeste",0,"320330",3,14,3,11,5,9,0,0,0,0,0,14,3,11,5,9,4,9.28014997651255,9.64878883256636,0.425418132831877,31
"8651","ES","Mantenópolis",15503,10723.04,32001,"Barra de São Francisco",3,"Sudeste",0,"320330",4,15,4,11,9,6,1,0,1,0,1,16,4,12,9,7,9,9.28014997651255,9.64878883256636,0.443490608220246,30
"8652","ES","Mantenópolis",15503,10723.04,32001,"Barra de São Francisco",3,"Sudeste",0,"320330",5,24,11,13,6,18,0,0,0,0,0,24,11,13,6,18,9,9.28014997651255,9.64878883256636,0.43651544903599,31
"8653","ES","Marataízes",38883,66685.28,32013,"Itapemirim",3,"Sudeste",0,"320332",2,54,17,37,28,26,1,1,0,1,0,55,18,37,29,26,21,11.107739517893,10.5683124160915,0.325509975553341,29
"8654","ES","Marataízes",38883,66685.28,32013,"Itapemirim",3,"Sudeste",0,"320332",3,43,20,23,13,30,0,0,0,0,0,43,20,23,13,30,22,11.107739517893,10.5683124160915,0.408782039257735,31
"8655","ES","Marataízes",38883,66685.28,32013,"Itapemirim",3,"Sudeste",0,"320332",4,46,15,31,13,33,1,0,1,0,1,47,15,32,13,34,29,11.107739517893,10.5683124160915,0.448810123224463,30
"8656","ES","Marataízes",38883,66685.28,32013,"Itapemirim",3,"Sudeste",0,"320332",5,55,10,45,20,35,1,1,0,0,1,56,11,45,20,36,42,11.107739517893,10.5683124160915,0.46262437173313,31
"8657","ES","Marechal Floriano",16920,26330.81,32007,"Afonso Cláudio",3,"Sudeste",0,"320334",2,17,9,8,9,8,1,1,0,0,1,18,10,8,9,9,16,10.1784950154049,9.73625163316022,0.279773671723521,29
"8658","ES","Marechal Floriano",16920,26330.81,32007,"Afonso Cláudio",3,"Sudeste",0,"320334",3,9,2,7,3,6,0,0,0,0,0,9,2,7,3,6,13,10.1784950154049,9.73625163316022,0.373175591898957,31
"8659","ES","Marechal Floriano",16920,26330.81,32007,"Afonso Cláudio",3,"Sudeste",0,"320334",4,18,4,14,7,11,0,0,0,0,0,18,4,14,7,11,7,10.1784950154049,9.73625163316022,0.416478072842225,30
"8660","ES","Marechal Floriano",16920,26330.81,32007,"Afonso Cláudio",3,"Sudeste",0,"320334",5,15,6,9,9,6,0,0,0,0,0,15,6,9,9,6,12,10.1784950154049,9.73625163316022,0.396349304562665,31
"8661","ES","Marilândia",12963,20678.32,32003,"Colatina",3,"Sudeste",0,"320335",2,13,7,6,4,9,0,0,0,0,0,13,7,6,4,9,4,9.93684108741136,9.46985442460004,0.312164332892051,29
"8662","ES","Marilândia",12963,20678.32,32003,"Colatina",3,"Sudeste",0,"320335",3,11,7,4,3,8,0,0,0,0,0,11,7,4,3,8,6,9.93684108741136,9.46985442460004,0.402324288615944,31
"8663","ES","Marilândia",12963,20678.32,32003,"Colatina",3,"Sudeste",0,"320335",4,13,5,8,3,10,0,0,0,0,0,13,5,8,3,10,7,9.93684108741136,9.46985442460004,0.426951180268726,30
"8664","ES","Marilândia",12963,20678.32,32003,"Colatina",3,"Sudeste",0,"320335",5,21,8,13,7,14,0,0,0,0,0,21,8,13,7,14,7,9.93684108741136,9.46985442460004,0.40680015989169,31
"8665","ES","Mimoso do Sul",26115,17691.26,32012,"Cachoeiro de Itapemirim",3,"Sudeste",0,"320340",2,16,7,9,5,11,1,0,1,1,0,17,7,10,6,11,14,9.78082601129907,10.1702651408704,0.322802185338369,29
"8666","ES","Mimoso do Sul",26115,17691.26,32012,"Cachoeiro de Itapemirim",3,"Sudeste",0,"320340",3,19,8,11,7,12,0,0,0,0,0,19,8,11,7,12,23,9.78082601129907,10.1702651408704,0.409752961388081,31
"8667","ES","Mimoso do Sul",26115,17691.26,32012,"Cachoeiro de Itapemirim",3,"Sudeste",0,"320340",4,27,10,17,13,14,0,0,0,0,0,27,10,17,13,14,16,9.78082601129907,10.1702651408704,0.439582085402261,30
"8668","ES","Mimoso do Sul",26115,17691.26,32012,"Cachoeiro de Itapemirim",3,"Sudeste",0,"320340",5,24,8,16,9,15,0,0,0,0,0,24,8,16,9,15,19,9.78082601129907,10.1702651408704,0.466105151627413,31
"8669","ES","Montanha",18894,18305.47,32004,"Montanha",3,"Sudeste",0,"320350",2,23,13,10,11,12,0,0,0,0,0,23,13,10,11,12,14,9.81495520126951,9.84659969032908,0.285341767177726,29
"8670","ES","Montanha",18894,18305.47,32004,"Montanha",3,"Sudeste",0,"320350",3,14,6,8,8,6,1,0,1,0,1,15,6,9,8,7,12,9.81495520126951,9.84659969032908,0.357465630646164,31
"8671","ES","Montanha",18894,18305.47,32004,"Montanha",3,"Sudeste",0,"320350",4,12,5,7,5,7,0,0,0,0,0,12,5,7,5,7,15,9.81495520126951,9.84659969032908,0.376066247909218,30
"8672","ES","Montanha",18894,18305.47,32004,"Montanha",3,"Sudeste",0,"320350",5,17,5,12,3,14,1,0,1,0,1,18,5,13,3,15,9,9.81495520126951,9.84659969032908,0.36256113551689,31
"8673","ES","Mucurici",5496,12570.44,32004,"Montanha",3,"Sudeste",0,"320360",2,6,3,3,2,4,0,0,0,0,0,6,3,3,2,4,4,9.43910330494939,8.61177583390219,0.268877052531973,29
"8674","ES","Mucurici",5496,12570.44,32004,"Montanha",3,"Sudeste",0,"320360",3,3,2,1,0,3,0,0,0,0,0,3,2,1,0,3,5,9.43910330494939,8.61177583390219,0.343194345618261,31
"8675","ES","Mucurici",5496,12570.44,32004,"Montanha",3,"Sudeste",0,"320360",4,8,0,8,2,6,0,0,0,0,0,8,0,8,2,6,3,9.43910330494939,8.61177583390219,0.390480770114377,30
"8676","ES","Mucurici",5496,12570.44,32004,"Montanha",3,"Sudeste",0,"320360",5,9,3,6,5,4,0,0,0,0,0,9,3,6,5,4,5,9.43910330494939,8.61177583390219,0.386530249403203,31
"8677","ES","Muniz Freire",17319,17532.19,32011,"Alegre",3,"Sudeste",0,"320370",2,16,6,10,5,11,0,0,0,0,0,16,6,10,5,11,10,9.77179389880601,9.75955944372904,0.330939334514476,29
"8678","ES","Muniz Freire",17319,17532.19,32011,"Alegre",3,"Sudeste",0,"320370",3,19,7,12,4,15,0,0,0,0,0,19,7,12,4,15,9,9.77179389880601,9.75955944372904,0.411970018712936,31
"8679","ES","Muniz Freire",17319,17532.19,32011,"Alegre",3,"Sudeste",0,"320370",4,15,7,8,6,9,0,0,0,0,0,15,7,8,6,9,6,9.77179389880601,9.75955944372904,0.444946269126772,30
"8680","ES","Muniz Freire",17319,17532.19,32011,"Alegre",3,"Sudeste",0,"320370",5,15,6,9,6,9,0,0,0,0,0,15,6,9,6,9,7,9.77179389880601,9.75955944372904,0.428010282894022,31
"8681","ES","Muqui",15526,12174.39,32012,"Cachoeiro de Itapemirim",3,"Sudeste",0,"320380",2,14,4,10,3,11,0,0,0,0,0,14,4,10,3,11,10,9.4070898440262,9.65027131696563,0.328841526462391,29
"8682","ES","Muqui",15526,12174.39,32012,"Cachoeiro de Itapemirim",3,"Sudeste",0,"320380",3,19,3,16,7,12,0,0,0,0,0,19,3,16,7,12,2,9.4070898440262,9.65027131696563,0.395036685487679,31
"8683","ES","Muqui",15526,12174.39,32012,"Cachoeiro de Itapemirim",3,"Sudeste",0,"320380",4,13,1,12,6,7,0,0,0,0,0,13,1,12,6,7,6,9.4070898440262,9.65027131696563,0.444685251828403,30
"8684","ES","Muqui",15526,12174.39,32012,"Cachoeiro de Itapemirim",3,"Sudeste",0,"320380",5,14,7,7,5,9,1,0,1,1,0,15,7,8,6,9,9,9.4070898440262,9.65027131696563,0.427808300721974,31
"8685","ES","Nova Venécia",50434,20207.87,32002,"Nova Venécia",3,"Sudeste",1,"320390",2,65,14,51,29,36,0,0,0,0,0,65,14,51,29,36,27,9.91382741147378,10.8284208297916,0.280893425997614,29
"8686","ES","Nova Venécia",50434,20207.87,32002,"Nova Venécia",3,"Sudeste",1,"320390",3,54,15,39,16,38,1,0,1,1,0,55,15,40,17,38,26,9.91382741147378,10.8284208297916,0.350651282213775,31
"8687","ES","Nova Venécia",50434,20207.87,32002,"Nova Venécia",3,"Sudeste",1,"320390",4,69,21,48,26,43,0,0,0,0,0,69,21,48,26,43,14,9.91382741147378,10.8284208297916,0.386340951041966,30
"8688","ES","Nova Venécia",50434,20207.87,32002,"Nova Venécia",3,"Sudeste",1,"320390",5,57,12,45,20,37,0,0,0,0,0,57,12,45,20,37,30,9.91382741147378,10.8284208297916,0.358558918020873,31
"8689","ES","Pancas",23306,12013.11,32003,"Colatina",3,"Sudeste",0,"320400",2,16,5,11,7,9,0,0,0,0,0,16,5,11,7,9,12,9.39375383242631,10.0564661171332,0.302896873197074,29
"8690","ES","Pancas",23306,12013.11,32003,"Colatina",3,"Sudeste",0,"320400",3,19,4,15,6,13,0,0,0,0,0,19,4,15,6,13,10,9.39375383242631,10.0564661171332,0.406048631991404,31
"8691","ES","Pancas",23306,12013.11,32003,"Colatina",3,"Sudeste",0,"320400",4,13,2,11,4,9,0,0,0,0,0,13,2,11,4,9,7,9.39375383242631,10.0564661171332,0.411501222589772,30
"8692","ES","Pancas",23306,12013.11,32003,"Colatina",3,"Sudeste",0,"320400",5,25,5,20,9,16,0,0,0,0,0,25,5,20,9,16,8,9.39375383242631,10.0564661171332,0.458090497147965,31
"8693","ES","Pedro Canário",26381,11672.75,32005,"São Mateus",3,"Sudeste",0,"320405",2,21,9,12,8,13,0,0,0,0,0,21,9,12,8,13,9,9.36501234447823,10.1803993330585,0.276071135941557,29
"8694","ES","Pedro Canário",26381,11672.75,32005,"São Mateus",3,"Sudeste",0,"320405",3,18,4,14,9,9,0,0,0,0,0,18,4,14,9,9,12,9.36501234447823,10.1803993330585,0.369043058422292,31
"8695","ES","Pedro Canário",26381,11672.75,32005,"São Mateus",3,"Sudeste",0,"320405",4,25,7,18,12,13,0,0,0,0,0,25,7,18,12,13,19,9.36501234447823,10.1803993330585,0.40097836748903,30
"8696","ES","Pedro Canário",26381,11672.75,32005,"São Mateus",3,"Sudeste",0,"320405",5,34,13,21,16,18,0,0,0,0,0,34,13,21,16,18,6,9.36501234447823,10.1803993330585,0.363562970892901,31
"8697","ES","Pinheiros",27327,18152.61,32004,"Montanha",3,"Sudeste",0,"320410",2,29,10,19,17,12,0,0,0,0,0,29,10,19,17,12,13,9.80656963100742,10.2156305034129,0.266728643523219,29
"8698","ES","Pinheiros",27327,18152.61,32004,"Montanha",3,"Sudeste",0,"320410",3,32,10,22,17,15,0,0,0,0,0,32,10,22,17,15,11,9.80656963100742,10.2156305034129,0.358422044047068,31
"8699","ES","Pinheiros",27327,18152.61,32004,"Montanha",3,"Sudeste",0,"320410",4,23,7,16,14,9,0,0,0,0,0,23,7,16,14,9,12,9.80656963100742,10.2156305034129,0.382956930901593,30
"8700","ES","Pinheiros",27327,18152.61,32004,"Montanha",3,"Sudeste",0,"320410",5,21,8,13,13,8,1,0,1,0,1,22,8,14,13,9,15,9.80656963100742,10.2156305034129,0.368260654956124,31
"8701","ES","Piúma",22053,30016.32,32010,"Guarapari",3,"Sudeste",1,"320420",2,25,6,19,8,17,1,1,0,1,0,26,7,19,9,17,10,10.3094965127299,10.0012039260422,0.296155730336535,29
"8702","ES","Piúma",22053,30016.32,32010,"Guarapari",3,"Sudeste",1,"320420",3,28,4,24,11,17,0,0,0,0,0,28,4,24,11,17,11,10.3094965127299,10.0012039260422,0.414103516722051,31
"8703","ES","Piúma",22053,30016.32,32010,"Guarapari",3,"Sudeste",1,"320420",4,35,9,26,10,25,0,0,0,0,0,35,9,26,10,25,13,10.3094965127299,10.0012039260422,0.441759683209563,30
"8704","ES","Piúma",22053,30016.32,32010,"Guarapari",3,"Sudeste",1,"320420",5,26,8,18,14,12,0,0,0,0,0,26,8,18,14,12,6,10.3094965127299,10.0012039260422,0.415901786520469,31
"8705","ES","Ponto Belo",7940,10550.44,32004,"Montanha",3,"Sudeste",0,"320425",2,10,5,5,5,5,0,0,0,0,0,10,5,5,5,5,3,9.26392284419567,8.97966855424118,0.254214118622816,29
"8706","ES","Ponto Belo",7940,10550.44,32004,"Montanha",3,"Sudeste",0,"320425",3,3,1,2,0,3,0,0,0,0,0,3,1,2,0,3,6,9.26392284419567,8.97966855424118,0.345172023788978,31
"8707","ES","Ponto Belo",7940,10550.44,32004,"Montanha",3,"Sudeste",0,"320425",4,7,4,3,4,3,0,0,0,0,0,7,4,3,4,3,3,9.26392284419567,8.97966855424118,0.37336512227707,30
"8708","ES","Ponto Belo",7940,10550.44,32004,"Montanha",3,"Sudeste",0,"320425",5,9,3,6,3,6,0,0,0,0,0,9,3,6,3,6,5,9.26392284419567,8.97966855424118,0.371414092096511,31
"8709","ES","Presidente Kennedy",11658,583171.85,32013,"Itapemirim",3,"Sudeste",0,"320430",2,18,6,12,6,12,0,0,0,0,0,18,6,12,6,12,5,13.2762371903361,9.3637479186055,0.329894492364428,29
"8710","ES","Presidente Kennedy",11658,583171.85,32013,"Itapemirim",3,"Sudeste",0,"320430",3,17,3,14,7,10,0,0,0,0,0,17,3,14,7,10,3,13.2762371903361,9.3637479186055,0.383663876350967,31
"8711","ES","Presidente Kennedy",11658,583171.85,32013,"Itapemirim",3,"Sudeste",0,"320430",4,16,2,14,8,8,0,0,0,0,0,16,2,14,8,8,6,13.2762371903361,9.3637479186055,0.419912314746531,30
"8712","ES","Presidente Kennedy",11658,583171.85,32013,"Itapemirim",3,"Sudeste",0,"320430",5,15,2,13,7,8,0,0,0,0,0,15,2,13,7,8,10,13.2762371903361,9.3637479186055,0.440378409339679,31
"8713","ES","Rio Bananal",19271,20163.84,32006,"Linhares",3,"Sudeste",0,"320435",2,22,11,11,5,17,0,0,0,0,0,22,11,11,5,17,8,9.9116461802375,9.86635665419792,0.296451946578211,29
"8714","ES","Rio Bananal",19271,20163.84,32006,"Linhares",3,"Sudeste",0,"320435",3,24,12,12,8,16,0,0,0,0,0,24,12,12,8,16,8,9.9116461802375,9.86635665419792,0.364830521970985,31
"8715","ES","Rio Bananal",19271,20163.84,32006,"Linhares",3,"Sudeste",0,"320435",4,25,6,19,8,17,0,0,0,0,0,25,6,19,8,17,5,9.9116461802375,9.86635665419792,0.406988280507944,30
"8716","ES","Rio Bananal",19271,20163.84,32006,"Linhares",3,"Sudeste",0,"320435",5,23,10,13,10,13,0,0,0,0,0,23,10,13,10,13,11,9.9116461802375,9.86635665419792,0.420165460223772,31
"8717","ES","Rio Novo do Sul",11626,16926,32010,"Guarapari",3,"Sudeste",0,"320440",2,11,1,10,6,5,0,0,0,0,0,11,1,10,6,5,2,9.73660618023005,9.3609992482613,0.298476117583023,29
"8718","ES","Rio Novo do Sul",11626,16926,32010,"Guarapari",3,"Sudeste",0,"320440",3,8,3,5,3,5,0,0,0,0,0,8,3,5,3,5,3,9.73660618023005,9.3609992482613,0.394560274117573,31
"8719","ES","Rio Novo do Sul",11626,16926,32010,"Guarapari",3,"Sudeste",0,"320440",4,12,4,8,5,7,0,0,0,0,0,12,4,8,5,7,5,9.73660618023005,9.3609992482613,0.45176089172463,30
"8720","ES","Rio Novo do Sul",11626,16926,32010,"Guarapari",3,"Sudeste",0,"320440",5,13,5,8,2,11,0,0,0,0,0,13,5,8,2,11,7,9.73660618023005,9.3609992482613,0.412327553792582,31
"8721","ES","Santa Leopoldina",12197,16663.7,32008,"Santa Teresa",3,"Sudeste",0,"320450",2,9,3,6,4,5,0,0,0,0,0,9,3,6,4,5,3,9.72098797989829,9.40894529884324,0.336056978055392,29
"8722","ES","Santa Leopoldina",12197,16663.7,32008,"Santa Teresa",3,"Sudeste",0,"320450",3,9,2,7,4,5,0,0,0,0,0,9,2,7,4,5,11,9.72098797989829,9.40894529884324,0.453934277698825,31
"8723","ES","Santa Leopoldina",12197,16663.7,32008,"Santa Teresa",3,"Sudeste",0,"320450",4,11,4,7,6,5,0,0,0,0,0,11,4,7,6,5,5,9.72098797989829,9.40894529884324,0.487376231908422,30
"8724","ES","Santa Leopoldina",12197,16663.7,32008,"Santa Teresa",3,"Sudeste",0,"320450",5,12,0,12,5,7,0,0,0,0,0,12,0,12,5,7,12,9.72098797989829,9.40894529884324,0.485791888094207,31
"8725","ES","Santa Maria de Jetibá",41015,34213.23,32008,"Santa Teresa",3,"Sudeste",0,"320455",2,23,12,11,6,17,0,0,0,0,0,23,12,11,6,17,16,10.4403676903518,10.6216931324368,0.304215498553696,29
"8726","ES","Santa Maria de Jetibá",41015,34213.23,32008,"Santa Teresa",3,"Sudeste",0,"320455",3,50,22,28,15,35,0,0,0,0,0,50,22,28,15,35,22,10.4403676903518,10.6216931324368,0.377653824418012,31
"8727","ES","Santa Maria de Jetibá",41015,34213.23,32008,"Santa Teresa",3,"Sudeste",0,"320455",4,39,16,23,20,19,1,1,0,1,0,40,17,23,21,19,23,10.4403676903518,10.6216931324368,0.413769888748435,30
"8728","ES","Santa Maria de Jetibá",41015,34213.23,32008,"Santa Teresa",3,"Sudeste",0,"320455",5,61,34,27,19,42,2,1,1,1,1,63,35,28,20,43,29,10.4403676903518,10.6216931324368,0.424622879317873,31
"8729","ES","Santa Teresa",23724,20612.88,32008,"Santa Teresa",3,"Sudeste",0,"320460",2,27,11,16,7,20,0,0,0,0,0,27,11,16,7,20,9,9.93367140211333,10.0742424729586,0.284807408378298,29
"8730","ES","Santa Teresa",23724,20612.88,32008,"Santa Teresa",3,"Sudeste",0,"320460",3,14,3,11,3,11,0,0,0,0,0,14,3,11,3,11,10,9.93367140211333,10.0742424729586,0.376985909676698,31
"8731","ES","Santa Teresa",23724,20612.88,32008,"Santa Teresa",3,"Sudeste",0,"320460",4,31,10,21,5,26,0,0,0,0,0,31,10,21,5,26,9,9.93367140211333,10.0742424729586,0.436497427787366,30
"8732","ES","Santa Teresa",23724,20612.88,32008,"Santa Teresa",3,"Sudeste",0,"320460",5,23,8,15,7,16,0,0,0,0,0,23,8,15,7,16,12,9.93367140211333,10.0742424729586,0.418573032218319,31
"8733","ES","São Domingos do Norte",8687,29410.1,32003,"Colatina",3,"Sudeste",0,"320465",2,18,6,12,6,12,0,0,0,0,0,18,6,12,6,12,3,10.2890934317463,9.06958293425992,0.294922056737606,29
"8734","ES","São Domingos do Norte",8687,29410.1,32003,"Colatina",3,"Sudeste",0,"320465",3,4,2,2,2,2,0,0,0,0,0,4,2,2,2,2,4,10.2890934317463,9.06958293425992,0.383415584558609,31
"8735","ES","São Domingos do Norte",8687,29410.1,32003,"Colatina",3,"Sudeste",0,"320465",4,9,2,7,3,6,0,0,0,0,0,9,2,7,3,6,6,10.2890934317463,9.06958293425992,0.414230654720923,30
"8736","ES","São Domingos do Norte",8687,29410.1,32003,"Colatina",3,"Sudeste",0,"320465",5,9,3,6,3,6,1,0,1,0,1,10,3,7,3,7,5,10.2890934317463,9.06958293425992,0.425004432597559,31
"8737","ES","São Gabriel da Palha",38522,16148.84,32002,"Nova Venécia",3,"Sudeste",0,"320470",2,38,14,24,13,25,0,0,0,0,0,38,14,24,13,25,21,9.68960349944576,10.5589847856442,0.29426990700246,29
"8738","ES","São Gabriel da Palha",38522,16148.84,32002,"Nova Venécia",3,"Sudeste",0,"320470",3,32,10,22,15,17,0,0,0,0,0,32,10,22,15,17,14,9.68960349944576,10.5589847856442,0.363009470503493,31
"8739","ES","São Gabriel da Palha",38522,16148.84,32002,"Nova Venécia",3,"Sudeste",0,"320470",4,24,8,16,13,11,2,1,1,1,1,26,9,17,14,12,16,9.68960349944576,10.5589847856442,0.403773886518124,30
"8740","ES","São Gabriel da Palha",38522,16148.84,32002,"Nova Venécia",3,"Sudeste",0,"320470",5,29,10,19,10,19,0,0,0,0,0,29,10,19,10,19,14,9.68960349944576,10.5589847856442,0.385421072491357,31
"8741","ES","São José do Calçado",10546,15150.14,32012,"Cachoeiro de Itapemirim",3,"Sudeste",0,"320480",2,6,2,4,3,3,0,0,0,0,0,6,2,4,3,3,7,9.62576505181891,9.26350192009041,0.313364091031138,29
"8742","ES","São José do Calçado",10546,15150.14,32012,"Cachoeiro de Itapemirim",3,"Sudeste",0,"320480",3,5,3,2,2,3,0,0,0,0,0,5,3,2,2,3,6,9.62576505181891,9.26350192009041,0.401287063381874,31
"8743","ES","São José do Calçado",10546,15150.14,32012,"Cachoeiro de Itapemirim",3,"Sudeste",0,"320480",4,14,5,9,6,8,1,1,0,0,1,15,6,9,6,9,8,9.62576505181891,9.26350192009041,0.451042231994104,30
"8744","ES","São José do Calçado",10546,15150.14,32012,"Cachoeiro de Itapemirim",3,"Sudeste",0,"320480",5,17,7,10,9,8,0,0,0,0,0,17,7,10,9,8,5,9.62576505181891,9.26350192009041,0.454946288211066,31
"8745","ES","São Mateus",132642,18764.1,32005,"São Mateus",3,"Sudeste",1,"320490",2,154,33,121,58,96,1,0,1,0,1,155,33,122,58,97,50,9.83970074878823,11.7954090486632,0.307397439431112,29
"8746","ES","São Mateus",132642,18764.1,32005,"São Mateus",3,"Sudeste",1,"320490",3,152,34,118,50,102,3,1,2,1,2,155,35,120,51,104,64,9.83970074878823,11.7954090486632,0.40841948808146,31
"8747","ES","São Mateus",132642,18764.1,32005,"São Mateus",3,"Sudeste",1,"320490",4,162,40,122,66,96,2,1,1,1,1,164,41,123,67,97,54,9.83970074878823,11.7954090486632,0.459253812121449,30
"8748","ES","São Mateus",132642,18764.1,32005,"São Mateus",3,"Sudeste",1,"320490",5,170,44,126,70,100,2,1,1,1,1,172,45,127,71,101,58,9.83970074878823,11.7954090486632,0.421941848891532,31
"8749","ES","São Roque do Canaã",12510,16068.91,32008,"Santa Teresa",3,"Sudeste",0,"320495",2,4,1,3,1,3,0,0,0,0,0,4,1,3,1,3,4,9.68464162817972,9.43428360346096,0.328115561213222,29
"8750","ES","São Roque do Canaã",12510,16068.91,32008,"Santa Teresa",3,"Sudeste",0,"320495",3,9,0,9,4,5,0,0,0,0,0,9,0,9,4,5,2,9.68464162817972,9.43428360346096,0.404594145285878,31
"8751","ES","São Roque do Canaã",12510,16068.91,32008,"Santa Teresa",3,"Sudeste",0,"320495",4,9,5,4,4,5,0,0,0,0,0,9,5,4,4,5,10,9.68464162817972,9.43428360346096,0.457005387563312,30
"8752","ES","São Roque do Canaã",12510,16068.91,32008,"Santa Teresa",3,"Sudeste",0,"320495",5,10,4,6,2,8,0,0,0,0,0,10,4,6,2,8,8,9.68464162817972,9.43428360346096,0.460982672704937,31
"8753","ES","Serra",527240,45544.8,32009,"Vitória",3,"Sudeste",1,"320500",2,573,130,443,194,379,3,2,1,0,3,576,132,444,194,382,207,10.7264517359079,13.1754111318264,0.299189844593956,29
"8754","ES","Serra",527240,45544.8,32009,"Vitória",3,"Sudeste",1,"320500",3,601,137,464,203,398,5,3,2,3,2,606,140,466,206,400,239,10.7264517359079,13.1754111318264,0.399873956314979,31
"8755","ES","Serra",527240,45544.8,32009,"Vitória",3,"Sudeste",1,"320500",4,571,136,435,222,349,6,3,3,2,4,577,139,438,224,353,263,10.7264517359079,13.1754111318264,0.455164219059088,30
"8756","ES","Serra",527240,45544.8,32009,"Vitória",3,"Sudeste",1,"320500",5,617,135,482,201,416,5,1,4,3,2,622,136,486,204,418,395,10.7264517359079,13.1754111318264,0.423564510147948,31
"8757","ES","Sooretama",30680,17473.16,32006,"Linhares",3,"Sudeste",0,"320501",2,28,9,19,13,15,0,0,0,0,0,28,9,19,13,15,12,9.76842126828218,10.3313662554812,0.287787633037124,29
"8758","ES","Sooretama",30680,17473.16,32006,"Linhares",3,"Sudeste",0,"320501",3,33,10,23,15,18,0,0,0,0,0,33,10,23,15,18,10,9.76842126828218,10.3313662554812,0.374220314422144,31
"8759","ES","Sooretama",30680,17473.16,32006,"Linhares",3,"Sudeste",0,"320501",4,31,7,24,14,17,0,0,0,0,0,31,7,24,14,17,15,9.76842126828218,10.3313662554812,0.399542965714371,30
"8760","ES","Sooretama",30680,17473.16,32006,"Linhares",3,"Sudeste",0,"320501",5,48,15,33,25,23,1,1,0,0,1,49,16,33,25,24,13,9.76842126828218,10.3313662554812,0.37094267195135,31
"8761","ES","Vargem Alta",21591,16157.61,32012,"Cachoeiro de Itapemirim",3,"Sudeste",0,"320503",2,14,4,10,2,12,0,0,0,0,0,14,4,10,2,12,13,9.69014642509778,9.98003184017591,0.306439036956394,29
"8762","ES","Vargem Alta",21591,16157.61,32012,"Cachoeiro de Itapemirim",3,"Sudeste",0,"320503",3,23,10,13,4,19,0,0,0,0,0,23,10,13,4,19,13,9.69014642509778,9.98003184017591,0.383283299115769,31
"8763","ES","Vargem Alta",21591,16157.61,32012,"Cachoeiro de Itapemirim",3,"Sudeste",0,"320503",4,16,4,12,7,9,0,0,0,0,0,16,4,12,7,9,7,9.69014642509778,9.98003184017591,0.429047720332379,30
"8764","ES","Vargem Alta",21591,16157.61,32012,"Cachoeiro de Itapemirim",3,"Sudeste",0,"320503",5,20,9,11,5,15,0,0,0,0,0,20,9,11,5,15,9,9.69014642509778,9.98003184017591,0.419392410191602,31
"8765","ES","Venda Nova do Imigrante",25745,24715.68,32007,"Afonso Cláudio",3,"Sudeste",0,"320506",2,28,9,19,13,15,0,0,0,0,0,28,9,19,13,15,11,10.1151931390182,10.1559957124802,0.286524390178457,29
"8766","ES","Venda Nova do Imigrante",25745,24715.68,32007,"Afonso Cláudio",3,"Sudeste",0,"320506",3,32,6,26,10,22,0,0,0,0,0,32,6,26,10,22,10,10.1151931390182,10.1559957124802,0.368460379014457,31
"8767","ES","Venda Nova do Imigrante",25745,24715.68,32007,"Afonso Cláudio",3,"Sudeste",0,"320506",4,27,6,21,8,19,0,0,0,0,0,27,6,21,8,19,9,10.1151931390182,10.1559957124802,0.400080585357974,30
"8768","ES","Venda Nova do Imigrante",25745,24715.68,32007,"Afonso Cláudio",3,"Sudeste",0,"320506",5,32,7,25,10,22,2,0,2,1,1,34,7,27,11,23,14,10.1151931390182,10.1559957124802,0.37589901034651,31
"8769","ES","Viana",79500,32060.09,32009,"Vitória",3,"Sudeste",1,"320510",2,71,17,54,30,41,0,0,0,0,0,71,17,54,30,41,35,10.375367233396,11.2835123006424,0.302359688217756,29
"8770","ES","Viana",79500,32060.09,32009,"Vitória",3,"Sudeste",1,"320510",3,65,21,44,21,44,0,0,0,0,0,65,21,44,21,44,30,10.375367233396,11.2835123006424,0.401971435489193,31
"8771","ES","Viana",79500,32060.09,32009,"Vitória",3,"Sudeste",1,"320510",4,88,22,66,35,53,1,1,0,1,0,89,23,66,36,53,45,10.375367233396,11.2835123006424,0.441194268835351,30
"8772","ES","Viana",79500,32060.09,32009,"Vitória",3,"Sudeste",1,"320510",5,102,33,69,45,57,2,1,1,1,1,104,34,70,46,58,61,10.375367233396,11.2835123006424,0.409926278850816,31
"8773","ES","Vila Valério",14073,19623.3,32002,"Nova Venécia",3,"Sudeste",0,"320517",2,14,5,9,7,7,0,0,0,0,0,14,5,9,7,7,5,9.88447291469469,9.55201334699657,0.303838461440983,29
"8774","ES","Vila Valério",14073,19623.3,32002,"Nova Venécia",3,"Sudeste",0,"320517",3,15,2,13,8,7,0,0,0,0,0,15,2,13,8,7,9,9.88447291469469,9.55201334699657,0.376831730338744,31
"8775","ES","Vila Valério",14073,19623.3,32002,"Nova Venécia",3,"Sudeste",0,"320517",4,13,10,3,6,7,0,0,0,0,0,13,10,3,6,7,6,9.88447291469469,9.55201334699657,0.387567908039018,30
"8776","ES","Vila Valério",14073,19623.3,32002,"Nova Venécia",3,"Sudeste",0,"320517",5,21,13,8,10,11,0,0,0,0,0,21,13,8,10,11,3,9.88447291469469,9.55201334699657,0.416477296445015,31
"8777","ES","Vila Velha",501325,24936.1,32009,"Vitória",3,"Sudeste",1,"320520",2,478,83,395,140,338,6,2,4,4,2,484,85,399,144,340,215,10.1240718317054,13.1250098723452,0.294691226091355,29
"8778","ES","Vila Velha",501325,24936.1,32009,"Vitória",3,"Sudeste",1,"320520",3,471,110,361,162,309,3,0,3,0,3,474,110,364,162,312,267,10.1240718317054,13.1250098723452,0.410586443568186,31
"8779","ES","Vila Velha",501325,24936.1,32009,"Vitória",3,"Sudeste",1,"320520",4,506,108,398,161,345,2,1,1,1,1,508,109,399,162,346,242,10.1240718317054,13.1250098723452,0.473360443464968,30
"8780","ES","Vila Velha",501325,24936.1,32009,"Vitória",3,"Sudeste",1,"320520",5,484,90,394,154,330,8,5,3,2,6,492,95,397,156,336,375,10.1240718317054,13.1250098723452,0.437541545200927,31
"8781","ES","Vitória",365855,73632.55,32009,"Vitória",3,"Sudeste",1,"320530",2,336,40,296,82,254,3,1,2,1,2,339,41,298,83,256,164,11.2068424623856,12.8099923590221,0.297352230963646,29
"8782","ES","Vitória",365855,73632.55,32009,"Vitória",3,"Sudeste",1,"320530",3,293,50,243,80,213,2,1,1,0,2,295,51,244,80,215,177,11.2068424623856,12.8099923590221,0.420007459712876,31
"8783","ES","Vitória",365855,73632.55,32009,"Vitória",3,"Sudeste",1,"320530",4,313,49,264,78,235,2,0,2,0,2,315,49,266,78,237,195,11.2068424623856,12.8099923590221,0.500839161976316,30
"8784","ES","Vitória",365855,73632.55,32009,"Vitória",3,"Sudeste",1,"320530",5,368,71,297,114,254,2,1,1,2,0,370,72,298,116,254,276,11.2068424623856,12.8099923590221,0.461849179820131,31
"8785","RJ","Angra dos Reis",207044,44590.88,33013,"Baía da Ilha Grande",3,"Sudeste",1,"330010",2,151,49,102,59,92,4,1,3,0,4,155,50,105,59,96,80,10.7052846327935,12.2406866100462,0.320001253577249,29
"8786","RJ","Angra dos Reis",207044,44590.88,33013,"Baía da Ilha Grande",3,"Sudeste",1,"330010",3,171,55,116,65,106,2,1,1,1,1,173,56,117,66,107,98,10.7052846327935,12.2406866100462,0.423003328141277,31
"8787","RJ","Angra dos Reis",207044,44590.88,33013,"Baía da Ilha Grande",3,"Sudeste",1,"330010",4,151,40,111,57,94,4,2,2,1,3,155,42,113,58,97,99,10.7052846327935,12.2406866100462,0.485068940698803,30
"8788","RJ","Angra dos Reis",207044,44590.88,33013,"Baía da Ilha Grande",3,"Sudeste",1,"330010",5,193,61,132,79,114,3,2,1,2,1,196,63,133,81,115,125,10.7052846327935,12.2406866100462,0.459238522938283,31
"8789","RJ","Aperibé",11901,15625.88,33002,"Santo Antônio de Pádua",3,"Sudeste",0,"330015",2,5,0,5,1,4,0,0,0,0,0,5,0,5,1,4,12,9.65668379301869,9.38437770918244,0.340526409985025,29
"8790","RJ","Aperibé",11901,15625.88,33002,"Santo Antônio de Pádua",3,"Sudeste",0,"330015",3,9,1,8,3,6,2,0,2,1,1,11,1,10,4,7,4,9.65668379301869,9.38437770918244,0.447247426499924,31
"8791","RJ","Aperibé",11901,15625.88,33002,"Santo Antônio de Pádua",3,"Sudeste",0,"330015",4,11,1,10,5,6,0,0,0,0,0,11,1,10,5,6,3,9.65668379301869,9.38437770918244,0.493841765766041,30
"8792","RJ","Aperibé",11901,15625.88,33002,"Santo Antônio de Pádua",3,"Sudeste",0,"330015",5,8,2,6,3,5,0,0,0,0,0,8,2,6,3,5,6,9.65668379301869,9.38437770918244,0.466533290314987,31
"8793","RJ","Araruama",134293,20480.15,33010,"Lagos",3,"Sudeste",1,"330020",2,116,23,93,52,64,2,2,0,0,2,118,25,93,52,66,81,9.92721140334537,11.8077792590383,0.31364637125268,29
"8794","RJ","Araruama",134293,20480.15,33010,"Lagos",3,"Sudeste",1,"330020",3,136,45,91,49,87,0,0,0,0,0,136,45,91,49,87,81,9.92721140334537,11.8077792590383,0.417922745746036,31
"8795","RJ","Araruama",134293,20480.15,33010,"Lagos",3,"Sudeste",1,"330020",4,111,35,76,54,57,1,0,1,1,0,112,35,77,55,57,93,9.92721140334537,11.8077792590383,0.482337538157604,30
"8796","RJ","Araruama",134293,20480.15,33010,"Lagos",3,"Sudeste",1,"330020",5,117,35,82,45,72,2,0,2,0,2,119,35,84,45,74,120,9.92721140334537,11.8077792590383,0.45756195095621,31
"8797","RJ","Areal",12669,25200.29,33005,"Três Rios",3,"Sudeste",1,"330022",2,12,4,8,3,9,0,0,0,0,0,12,4,8,3,9,8,10.1346107813698,9.44691334360205,0.310268224945155,29
"8798","RJ","Areal",12669,25200.29,33005,"Três Rios",3,"Sudeste",1,"330022",3,8,0,8,2,6,0,0,0,0,0,8,0,8,2,6,5,10.1346107813698,9.44691334360205,0.403194639826432,31
"8799","RJ","Areal",12669,25200.29,33005,"Três Rios",3,"Sudeste",1,"330022",4,8,2,6,2,6,1,1,0,1,0,9,3,6,3,6,6,10.1346107813698,9.44691334360205,0.454139237850973,30
"8800","RJ","Areal",12669,25200.29,33005,"Três Rios",3,"Sudeste",1,"330022",5,7,1,6,3,4,0,0,0,0,0,7,1,6,3,4,9,10.1346107813698,9.44691334360205,0.446469514653407,31
"8801","RJ","Armação dos Búzios",34477,76723.42,33010,"Lagos",3,"Sudeste",1,"330023",2,39,5,34,15,24,0,0,0,0,0,39,5,34,15,24,18,11.2479622862489,10.4480477140317,0.294032745737854,29
"8802","RJ","Armação dos Búzios",34477,76723.42,33010,"Lagos",3,"Sudeste",1,"330023",3,50,9,41,11,39,1,0,1,0,1,51,9,42,11,40,27,11.2479622862489,10.4480477140317,0.422849193242235,31
"8803","RJ","Armação dos Búzios",34477,76723.42,33010,"Lagos",3,"Sudeste",1,"330023",4,45,10,35,16,29,1,1,0,0,1,46,11,35,16,30,20,11.2479622862489,10.4480477140317,0.504051486663293,30
"8804","RJ","Armação dos Búzios",34477,76723.42,33010,"Lagos",3,"Sudeste",1,"330023",5,64,19,45,19,45,0,0,0,0,0,64,19,45,19,45,34,11.2479622862489,10.4480477140317,0.479457767995625,31
"8805","RJ","Arraial do Cabo",30593,42927.02,33010,"Lagos",3,"Sudeste",1,"330025",2,24,3,21,5,19,0,0,0,0,0,24,3,21,5,19,17,10.667256743482,10.3285265036014,0.325275492044767,29
"8806","RJ","Arraial do Cabo",30593,42927.02,33010,"Lagos",3,"Sudeste",1,"330025",3,31,13,18,18,13,0,0,0,0,0,31,13,18,18,13,25,10.667256743482,10.3285265036014,0.452708785318548,31
"8807","RJ","Arraial do Cabo",30593,42927.02,33010,"Lagos",3,"Sudeste",1,"330025",4,33,11,22,19,14,1,1,0,1,0,34,12,22,20,14,16,10.667256743482,10.3285265036014,0.523236229933154,30
"8808","RJ","Arraial do Cabo",30593,42927.02,33010,"Lagos",3,"Sudeste",1,"330025",5,39,9,30,16,23,0,0,0,0,0,39,9,30,16,23,30,10.667256743482,10.3285265036014,0.494396178187599,31
"8809","RJ","Barra do Piraí",100764,20602.24,33012,"Barra do Piraí",3,"Sudeste",1,"330030",2,79,21,58,36,43,1,0,1,1,0,80,21,59,37,43,70,9.93315508673022,11.5205364279716,0.31285672468186,29
"8810","RJ","Barra do Piraí",100764,20602.24,33012,"Barra do Piraí",3,"Sudeste",1,"330030",3,68,15,53,25,43,0,0,0,0,0,68,15,53,25,43,82,9.93315508673022,11.5205364279716,0.426240020807304,31
"8811","RJ","Barra do Piraí",100764,20602.24,33012,"Barra do Piraí",3,"Sudeste",1,"330030",4,89,28,61,41,48,1,0,1,0,1,90,28,62,41,49,57,9.93315508673022,11.5205364279716,0.486599172673159,30
"8812","RJ","Barra do Piraí",100764,20602.24,33012,"Barra do Piraí",3,"Sudeste",1,"330030",5,111,23,88,42,69,1,1,0,1,0,112,24,88,43,69,78,9.93315508673022,11.5205364279716,0.44557830100426,31
"8813","RJ","Barra Mansa",184833,28067.77,33011,"Vale do Paraíba Fluminense",3,"Sudeste",1,"330040",2,173,30,143,55,118,0,0,0,0,0,173,30,143,55,118,125,10.2423772219535,12.1272079936763,0.310781614680448,29
"8814","RJ","Barra Mansa",184833,28067.77,33011,"Vale do Paraíba Fluminense",3,"Sudeste",1,"330040",3,166,32,134,54,112,3,0,3,2,1,169,32,137,56,113,143,10.2423772219535,12.1272079936763,0.416971560287717,31
"8815","RJ","Barra Mansa",184833,28067.77,33011,"Vale do Paraíba Fluminense",3,"Sudeste",1,"330040",4,157,32,125,47,110,2,0,2,0,2,159,32,127,47,112,125,10.2423772219535,12.1272079936763,0.489319025007656,30
"8816","RJ","Barra Mansa",184833,28067.77,33011,"Vale do Paraíba Fluminense",3,"Sudeste",1,"330040",5,169,32,137,54,115,1,0,1,1,0,170,32,138,55,115,167,10.2423772219535,12.1272079936763,0.43564768466941,31
"8817","RJ","Belford Roxo",513118,15598.12,33018,"Rio de Janeiro",3,"Sudeste",1,"330045",2,416,130,286,209,207,10,5,5,7,3,426,135,291,216,210,284,9.65490567315486,13.1482611171957,0.318177535973946,29
"8818","RJ","Belford Roxo",513118,15598.12,33018,"Rio de Janeiro",3,"Sudeste",1,"330045",3,513,141,372,230,283,3,1,2,3,0,516,142,374,233,283,305,9.65490567315486,13.1482611171957,0.409612247596741,31
"8819","RJ","Belford Roxo",513118,15598.12,33018,"Rio de Janeiro",3,"Sudeste",1,"330045",4,479,132,347,221,258,11,2,9,7,4,490,134,356,228,262,462,9.65490567315486,13.1482611171957,0.473746525423469,30
"8820","RJ","Belford Roxo",513118,15598.12,33018,"Rio de Janeiro",3,"Sudeste",1,"330045",5,523,183,340,231,292,12,7,5,6,6,535,190,345,237,298,600,9.65490567315486,13.1482611171957,0.440421280778108,31
"8821","RJ","Bom Jardim",27616,24638.06,33007,"Nova Friburgo",3,"Sudeste",0,"330050",2,8,3,5,1,7,0,0,0,0,0,8,3,5,1,7,17,10.1120476807816,10.2261505938832,0.337199530380444,29
"8822","RJ","Bom Jardim",27616,24638.06,33007,"Nova Friburgo",3,"Sudeste",0,"330050",3,4,0,4,1,3,1,1,0,0,1,5,1,4,1,4,19,10.1120476807816,10.2261505938832,0.452825536414567,31
"8823","RJ","Bom Jardim",27616,24638.06,33007,"Nova Friburgo",3,"Sudeste",0,"330050",4,5,1,4,3,2,0,0,0,0,0,5,1,4,3,2,21,10.1120476807816,10.2261505938832,0.488671916100926,30
"8824","RJ","Bom Jardim",27616,24638.06,33007,"Nova Friburgo",3,"Sudeste",0,"330050",5,6,1,5,1,5,0,0,0,0,0,6,1,5,1,5,20,10.1120476807816,10.2261505938832,0.450501314282371,31
"8825","RJ","Bom Jesus do Itabapoana",37203,20586.07,33001,"Itaperuna",3,"Sudeste",1,"330060",2,33,3,30,11,22,0,0,0,0,0,33,3,30,11,22,27,9.93236991244991,10.5241446821709,0.320163183594769,29
"8826","RJ","Bom Jesus do Itabapoana",37203,20586.07,33001,"Itaperuna",3,"Sudeste",1,"330060",3,33,5,28,18,15,2,1,1,1,1,35,6,29,19,16,40,9.93236991244991,10.5241446821709,0.405890407213688,31
"8827","RJ","Bom Jesus do Itabapoana",37203,20586.07,33001,"Itaperuna",3,"Sudeste",1,"330060",4,34,10,24,12,22,0,0,0,0,0,34,10,24,12,22,26,9.93236991244991,10.5241446821709,0.453115432159662,30
"8828","RJ","Bom Jesus do Itabapoana",37203,20586.07,33001,"Itaperuna",3,"Sudeste",1,"330060",5,38,13,25,19,19,0,0,0,0,0,38,13,25,19,19,33,9.93236991244991,10.5241446821709,0.438513551699823,31
"8829","RJ","Cabo Frio",230378,49297.56,33010,"Lagos",3,"Sudeste",1,"330070",2,186,65,121,87,99,2,1,1,1,1,188,66,122,88,100,131,10.8056298659054,12.3474767171337,0.31560872276284,29
"8830","RJ","Cabo Frio",230378,49297.56,33010,"Lagos",3,"Sudeste",1,"330070",3,193,64,129,74,119,6,4,2,1,5,199,68,131,75,124,145,10.8056298659054,12.3474767171337,0.433518081014369,31
"8831","RJ","Cabo Frio",230378,49297.56,33010,"Lagos",3,"Sudeste",1,"330070",4,194,71,123,73,121,1,0,1,1,0,195,71,124,74,121,124,10.8056298659054,12.3474767171337,0.494950194118257,30
"8832","RJ","Cabo Frio",230378,49297.56,33010,"Lagos",3,"Sudeste",1,"330070",5,179,62,117,75,104,6,3,3,2,4,185,65,120,77,108,205,10.8056298659054,12.3474767171337,0.467208716909778,31
"8833","RJ","Cachoeiras de Macacu",59303,17638.69,33016,"Macacu-Caceribu",3,"Sudeste",1,"330080",2,47,10,37,24,23,0,0,0,0,0,47,10,37,24,23,37,9.7778500637646,10.9904151739254,0.323725265394776,29
"8834","RJ","Cachoeiras de Macacu",59303,17638.69,33016,"Macacu-Caceribu",3,"Sudeste",1,"330080",3,38,17,21,21,17,0,0,0,0,0,38,17,21,21,17,34,9.7778500637646,10.9904151739254,0.410852615456287,31
"8835","RJ","Cachoeiras de Macacu",59303,17638.69,33016,"Macacu-Caceribu",3,"Sudeste",1,"330080",4,45,14,31,19,26,2,1,1,0,2,47,15,32,19,28,36,9.7778500637646,10.9904151739254,0.473623875054533,30
"8836","RJ","Cachoeiras de Macacu",59303,17638.69,33016,"Macacu-Caceribu",3,"Sudeste",1,"330080",5,51,8,43,19,32,0,0,0,0,0,51,8,43,19,32,72,9.7778500637646,10.9904151739254,0.45972389783208,31
"8837","RJ","Cambuci",15514,21730.91,33002,"Santo Antônio de Pádua",3,"Sudeste",0,"330090",2,8,2,6,5,3,0,0,0,0,0,8,2,6,5,3,11,9.98649094996222,9.64949812105082,0.341384483564682,29
"8838","RJ","Cambuci",15514,21730.91,33002,"Santo Antônio de Pádua",3,"Sudeste",0,"330090",3,11,7,4,5,6,0,0,0,0,0,11,7,4,5,6,12,9.98649094996222,9.64949812105082,0.462880823551944,31
"8839","RJ","Cambuci",15514,21730.91,33002,"Santo Antônio de Pádua",3,"Sudeste",0,"330090",4,11,0,11,9,2,0,0,0,0,0,11,0,11,9,2,9,9.98649094996222,9.64949812105082,0.511517277013776,30
"8840","RJ","Cambuci",15514,21730.91,33002,"Santo Antônio de Pádua",3,"Sudeste",0,"330090",5,7,3,4,5,2,0,0,0,0,0,7,3,4,5,2,13,9.98649094996222,9.64949812105082,0.504869786105601,31
"8841","RJ","Carapebus",16586,32536.67,33004,"Macaé",3,"Sudeste",1,"330093",2,16,7,9,9,7,0,0,0,0,0,16,7,9,9,7,6,10.3901230399494,9.71631424501115,0.286256359033422,29
"8842","RJ","Carapebus",16586,32536.67,33004,"Macaé",3,"Sudeste",1,"330093",3,9,1,8,4,5,0,0,0,0,0,9,1,8,4,5,18,10.3901230399494,9.71631424501115,0.397221265129156,31
"8843","RJ","Carapebus",16586,32536.67,33004,"Macaé",3,"Sudeste",1,"330093",4,15,2,13,8,7,0,0,0,0,0,15,2,13,8,7,7,10.3901230399494,9.71631424501115,0.463714005156799,30
"8844","RJ","Carapebus",16586,32536.67,33004,"Macaé",3,"Sudeste",1,"330093",5,10,4,6,4,6,0,0,0,0,0,10,4,6,4,6,8,10.3901230399494,9.71631424501115,0.421014793558861,31
"8845","RJ","Comendador Levy Gasparian",8576,45550.65,33005,"Três Rios",3,"Sudeste",1,"330095",2,4,0,4,1,3,0,0,0,0,0,4,0,4,1,3,8,10.7265801726192,9.05672288331058,0.301036927657617,29
"8846","RJ","Comendador Levy Gasparian",8576,45550.65,33005,"Três Rios",3,"Sudeste",1,"330095",3,8,4,4,2,6,0,0,0,0,0,8,4,4,2,6,5,10.7265801726192,9.05672288331058,0.437950022953752,31
"8847","RJ","Comendador Levy Gasparian",8576,45550.65,33005,"Três Rios",3,"Sudeste",1,"330095",4,10,4,6,4,6,0,0,0,0,0,10,4,6,4,6,6,10.7265801726192,9.05672288331058,0.496947378284795,30
"8848","RJ","Comendador Levy Gasparian",8576,45550.65,33005,"Três Rios",3,"Sudeste",1,"330095",5,6,1,5,1,5,0,0,0,0,0,6,1,5,1,5,5,10.7265801726192,9.05672288331058,0.471813145529058,31
"8849","RJ","Campos dos Goytacazes",511168,64186.76,33003,"Campos dos Goytacazes",3,"Sudeste",1,"330100",2,469,142,327,210,259,4,2,2,2,2,473,144,329,212,261,337,11.06955223788,13.1444535822771,0.311972176560822,29
"8850","RJ","Campos dos Goytacazes",511168,64186.76,33003,"Campos dos Goytacazes",3,"Sudeste",1,"330100",3,521,160,361,198,323,4,3,1,3,1,525,163,362,201,324,328,11.06955223788,13.1444535822771,0.406299977112229,31
"8851","RJ","Campos dos Goytacazes",511168,64186.76,33003,"Campos dos Goytacazes",3,"Sudeste",1,"330100",4,533,161,372,219,314,8,2,6,4,4,541,163,378,223,318,320,11.06955223788,13.1444535822771,0.465948919218481,30
"8852","RJ","Campos dos Goytacazes",511168,64186.76,33003,"Campos dos Goytacazes",3,"Sudeste",1,"330100",5,566,191,375,252,314,8,3,5,3,5,574,194,380,255,319,427,11.06955223788,13.1444535822771,0.452282888022122,31
"8853","RJ","Cantagalo",20168,36562.36,33006,"Cantagalo-Cordeiro",3,"Sudeste",1,"330110",2,21,9,12,11,10,0,0,0,0,0,21,9,12,11,10,17,10.5067745749071,9.91185246886775,0.359125848511255,29
"8854","RJ","Cantagalo",20168,36562.36,33006,"Cantagalo-Cordeiro",3,"Sudeste",1,"330110",3,16,4,12,5,11,0,0,0,0,0,16,4,12,5,11,19,10.5067745749071,9.91185246886775,0.444149337982761,31
"8855","RJ","Cantagalo",20168,36562.36,33006,"Cantagalo-Cordeiro",3,"Sudeste",1,"330110",4,24,4,20,8,16,0,0,0,0,0,24,4,20,8,16,0,10.5067745749071,9.91185246886775,0.495053402141793,30
"8856","RJ","Cantagalo",20168,36562.36,33006,"Cantagalo-Cordeiro",3,"Sudeste",1,"330110",5,20,5,15,9,11,0,0,0,0,0,20,5,15,9,11,14,10.5067745749071,9.91185246886775,0.479503287554384,31
"8857","RJ","Cardoso Moreira",12821,21776.17,33003,"Campos dos Goytacazes",3,"Sudeste",0,"330115",2,12,1,11,3,9,0,0,0,0,0,12,1,11,3,9,7,9.98857153162051,9.4588397305527,0.326641507698337,29
"8858","RJ","Cardoso Moreira",12821,21776.17,33003,"Campos dos Goytacazes",3,"Sudeste",0,"330115",3,7,2,5,2,5,0,0,0,0,0,7,2,5,2,5,14,9.98857153162051,9.4588397305527,0.413173599691054,31
"8859","RJ","Cardoso Moreira",12821,21776.17,33003,"Campos dos Goytacazes",3,"Sudeste",0,"330115",4,15,5,10,6,9,0,0,0,0,0,15,5,10,6,9,9,9.98857153162051,9.4588397305527,0.44768802466938,30
"8860","RJ","Cardoso Moreira",12821,21776.17,33003,"Campos dos Goytacazes",3,"Sudeste",0,"330115",5,13,4,9,3,10,0,0,0,0,0,13,4,9,3,10,8,9.98857153162051,9.4588397305527,0.479652088672562,31
"8861","RJ","Carmo",19030,24286.12,33006,"Cantagalo-Cordeiro",3,"Sudeste",1,"330120",2,19,5,14,4,15,0,0,0,0,0,19,5,14,4,15,13,10.0976602727199,9.8537719602902,0.33213261133848,29
"8862","RJ","Carmo",19030,24286.12,33006,"Cantagalo-Cordeiro",3,"Sudeste",1,"330120",3,10,3,7,3,7,0,0,0,0,0,10,3,7,3,7,13,10.0976602727199,9.8537719602902,0.457195269645232,31
"8863","RJ","Carmo",19030,24286.12,33006,"Cantagalo-Cordeiro",3,"Sudeste",1,"330120",4,13,3,10,4,9,0,0,0,0,0,13,3,10,4,9,7,10.0976602727199,9.8537719602902,0.51318862324937,30
"8864","RJ","Carmo",19030,24286.12,33006,"Cantagalo-Cordeiro",3,"Sudeste",1,"330120",5,18,4,14,5,13,0,0,0,0,0,18,4,14,5,13,7,10.0976602727199,9.8537719602902,0.507841464346422,31
"8865","RJ","Casimiro de Abreu",45041,50532.71,33009,"Bacia de São João",3,"Sudeste",1,"330130",2,44,11,33,15,29,1,0,1,0,1,45,11,34,15,30,22,10.8303761283539,10.7153284650538,0.319317652949358,29
"8866","RJ","Casimiro de Abreu",45041,50532.71,33009,"Bacia de São João",3,"Sudeste",1,"330130",3,48,8,40,16,32,0,0,0,0,0,48,8,40,16,32,21,10.8303761283539,10.7153284650538,0.423216071469266,31
"8867","RJ","Casimiro de Abreu",45041,50532.71,33009,"Bacia de São João",3,"Sudeste",1,"330130",4,44,3,41,11,33,0,0,0,0,0,44,3,41,11,33,19,10.8303761283539,10.7153284650538,0.483025656251773,30
"8868","RJ","Casimiro de Abreu",45041,50532.71,33009,"Bacia de São João",3,"Sudeste",1,"330130",5,41,8,33,14,27,1,1,0,0,1,42,9,33,14,28,34,10.8303761283539,10.7153284650538,0.455454536379197,31
"8869","RJ","Conceição de Macabu",23398,15397.59,33004,"Macaé",3,"Sudeste",1,"330140",2,22,6,16,10,12,0,0,0,0,0,22,6,16,10,12,9,9.64196628264884,10.0604058276075,0.322913648040029,29
"8870","RJ","Conceição de Macabu",23398,15397.59,33004,"Macaé",3,"Sudeste",1,"330140",3,23,4,19,8,15,0,0,0,0,0,23,4,19,8,15,12,9.64196628264884,10.0604058276075,0.423701367911398,31
"8871","RJ","Conceição de Macabu",23398,15397.59,33004,"Macaé",3,"Sudeste",1,"330140",4,24,6,18,9,15,0,0,0,0,0,24,6,18,9,15,8,9.64196628264884,10.0604058276075,0.494431194502747,30
"8872","RJ","Conceição de Macabu",23398,15397.59,33004,"Macaé",3,"Sudeste",1,"330140",5,23,4,19,10,13,0,0,0,0,0,23,4,19,10,13,12,9.64196628264884,10.0604058276075,0.449966800652853,31
"8873","RJ","Cordeiro",22041,23270.95,33006,"Cantagalo-Cordeiro",3,"Sudeste",1,"330150",2,18,5,13,9,9,1,0,1,0,1,19,5,14,9,10,10,10.0549610805597,10.0006596342884,0.309530065915486,29
"8874","RJ","Cordeiro",22041,23270.95,33006,"Cantagalo-Cordeiro",3,"Sudeste",1,"330150",3,20,4,16,8,12,0,0,0,0,0,20,4,16,8,12,9,10.0549610805597,10.0006596342884,0.418341792454188,31
"8875","RJ","Cordeiro",22041,23270.95,33006,"Cantagalo-Cordeiro",3,"Sudeste",1,"330150",4,23,5,18,5,18,1,0,1,0,1,24,5,19,5,19,14,10.0549610805597,10.0006596342884,0.47004977695064,30
"8876","RJ","Cordeiro",22041,23270.95,33006,"Cantagalo-Cordeiro",3,"Sudeste",1,"330150",5,21,4,17,12,9,0,0,0,0,0,21,4,17,12,9,11,10.0549610805597,10.0006596342884,0.453752767396938,31
"8877","RJ","Duas Barras",11528,18294.71,33007,"Nova Friburgo",3,"Sudeste",0,"330160",2,3,0,3,0,3,0,0,0,0,0,3,0,3,0,3,12,9.81436722600217,9.35253413767936,0.308228396469948,29
"8878","RJ","Duas Barras",11528,18294.71,33007,"Nova Friburgo",3,"Sudeste",0,"330160",3,5,1,4,4,1,0,0,0,0,0,5,1,4,4,1,8,9.81436722600217,9.35253413767936,0.389446421535958,31
"8879","RJ","Duas Barras",11528,18294.71,33007,"Nova Friburgo",3,"Sudeste",0,"330160",4,2,0,2,0,2,0,0,0,0,0,2,0,2,0,2,10,9.81436722600217,9.35253413767936,0.442408233367937,30
"8880","RJ","Duas Barras",11528,18294.71,33007,"Nova Friburgo",3,"Sudeste",0,"330160",5,2,1,1,2,0,1,1,0,0,1,3,2,1,2,1,4,9.81436722600217,9.35253413767936,0.436019425089996,31
"8881","RJ","Duque de Caxias",924624,45490.61,33018,"Rio de Janeiro",3,"Sudeste",1,"330170",2,843,254,589,358,485,16,8,8,6,10,859,262,597,364,495,555,10.7252612100147,13.73714244737,0.320465185220025,29
"8882","RJ","Duque de Caxias",924624,45490.61,33018,"Rio de Janeiro",3,"Sudeste",1,"330170",3,864,276,588,389,475,17,8,9,8,9,881,284,597,397,484,595,10.7252612100147,13.73714244737,0.412055298473254,31
"8883","RJ","Duque de Caxias",924624,45490.61,33018,"Rio de Janeiro",3,"Sudeste",1,"330170",4,914,275,639,418,496,13,6,7,8,5,927,281,646,426,501,947,10.7252612100147,13.73714244737,0.483115989954693,30
"8884","RJ","Duque de Caxias",924624,45490.61,33018,"Rio de Janeiro",3,"Sudeste",1,"330170",5,996,309,687,430,566,12,8,4,9,3,1008,317,691,439,569,1251,10.7252612100147,13.73714244737,0.452638537962506,31
"8885","RJ","Engenheiro Paulo de Frontin",14071,18695.44,33014,"Vassouras",3,"Sudeste",0,"330180",2,5,1,4,2,3,0,0,0,0,0,5,1,4,2,3,8,9.83603492283899,9.55187122078826,0.346472425591654,29
"8886","RJ","Engenheiro Paulo de Frontin",14071,18695.44,33014,"Vassouras",3,"Sudeste",0,"330180",3,11,2,9,5,6,0,0,0,0,0,11,2,9,5,6,7,9.83603492283899,9.55187122078826,0.438530404386004,31
"8887","RJ","Engenheiro Paulo de Frontin",14071,18695.44,33014,"Vassouras",3,"Sudeste",0,"330180",4,11,2,9,3,8,0,0,0,0,0,11,2,9,3,8,8,9.83603492283899,9.55187122078826,0.505010716441506,30
"8888","RJ","Engenheiro Paulo de Frontin",14071,18695.44,33014,"Vassouras",3,"Sudeste",0,"330180",5,5,3,2,2,3,0,0,0,0,0,5,3,2,2,3,14,9.83603492283899,9.55187122078826,0.494999012128521,31
"8889","RJ","Guapimirim",61388,16377.56,33018,"Rio de Janeiro",3,"Sudeste",1,"330185",2,53,11,42,19,34,0,0,0,0,0,53,11,42,19,34,31,9.70366738416214,11.024969655295,0.338983144066769,29
"8890","RJ","Guapimirim",61388,16377.56,33018,"Rio de Janeiro",3,"Sudeste",1,"330185",3,46,14,32,20,26,0,0,0,0,0,46,14,32,20,26,36,9.70366738416214,11.024969655295,0.441778688206916,31
"8891","RJ","Guapimirim",61388,16377.56,33018,"Rio de Janeiro",3,"Sudeste",1,"330185",4,51,17,34,28,23,1,0,1,0,1,52,17,35,28,24,47,9.70366738416214,11.024969655295,0.503348903739455,30
"8892","RJ","Guapimirim",61388,16377.56,33018,"Rio de Janeiro",3,"Sudeste",1,"330185",5,49,10,39,21,28,0,0,0,0,0,49,10,39,21,28,62,9.70366738416214,11.024969655295,0.478179960882556,31
"8893","RJ","Iguaba Grande",28837,17622.8,33010,"Lagos",3,"Sudeste",1,"330187",2,27,6,21,14,13,0,0,0,0,0,27,6,21,14,13,24,9.77694879719443,10.2694145637968,0.325030259839656,29
"8894","RJ","Iguaba Grande",28837,17622.8,33010,"Lagos",3,"Sudeste",1,"330187",3,23,1,22,8,15,0,0,0,0,0,23,1,22,8,15,19,9.77694879719443,10.2694145637968,0.435774552755078,31
"8895","RJ","Iguaba Grande",28837,17622.8,33010,"Lagos",3,"Sudeste",1,"330187",4,24,3,21,10,14,0,0,0,0,0,24,3,21,10,14,35,9.77694879719443,10.2694145637968,0.489957011493051,30
"8896","RJ","Iguaba Grande",28837,17622.8,33010,"Lagos",3,"Sudeste",1,"330187",5,29,7,22,12,17,0,0,0,0,0,29,7,22,12,17,27,9.77694879719443,10.2694145637968,0.461986527127145,31
"8897","RJ","Itaboraí",242543,18746.84,33018,"Rio de Janeiro",3,"Sudeste",1,"330190",2,223,69,154,105,118,3,0,3,3,0,226,69,157,108,118,134,9.83878048386189,12.398934293228,0.315409868392409,29
"8898","RJ","Itaboraí",242543,18746.84,33018,"Rio de Janeiro",3,"Sudeste",1,"330190",3,233,66,167,102,131,1,0,1,1,0,234,66,168,103,131,184,9.83878048386189,12.398934293228,0.418050640665063,31
"8899","RJ","Itaboraí",242543,18746.84,33018,"Rio de Janeiro",3,"Sudeste",1,"330190",4,219,68,151,94,125,5,1,4,4,1,224,69,155,98,126,202,9.83878048386189,12.398934293228,0.487581554100176,30
"8900","RJ","Itaboraí",242543,18746.84,33018,"Rio de Janeiro",3,"Sudeste",1,"330190",5,209,65,144,100,109,3,3,0,2,1,212,68,144,102,110,275,9.83878048386189,12.398934293228,0.458360203187554,31
"8901","RJ","Itaguaí",134819,63968.12,33017,"Itaguaí",3,"Sudeste",1,"330200",2,127,28,99,49,78,4,0,4,3,1,131,28,103,52,79,78,11.0661401132363,11.8116884170828,0.321778223739235,29
"8902","RJ","Itaguaí",134819,63968.12,33017,"Itaguaí",3,"Sudeste",1,"330200",3,142,52,90,69,73,2,1,1,0,2,144,53,91,69,75,93,11.0661401132363,11.8116884170828,0.410454855944518,31
"8903","RJ","Itaguaí",134819,63968.12,33017,"Itaguaí",3,"Sudeste",1,"330200",4,135,41,94,59,76,1,1,0,0,1,136,42,94,59,77,115,11.0661401132363,11.8116884170828,0.466973482145361,30
"8904","RJ","Itaguaí",134819,63968.12,33017,"Itaguaí",3,"Sudeste",1,"330200",5,138,31,107,67,71,1,0,1,1,0,139,31,108,68,71,152,11.0661401132363,11.8116884170828,0.444005005966295,31
"8905","RJ","Italva",15299,20276.49,33001,"Itaperuna",3,"Sudeste",0,"330205",2,17,3,14,11,6,0,0,0,0,0,17,3,14,11,6,14,9.9172173658025,9.63554274576738,0.324507186249775,29
"8906","RJ","Italva",15299,20276.49,33001,"Itaperuna",3,"Sudeste",0,"330205",3,7,1,6,5,2,0,0,0,0,0,7,1,6,5,2,7,9.9172173658025,9.63554274576738,0.402679076829218,31
"8907","RJ","Italva",15299,20276.49,33001,"Itaperuna",3,"Sudeste",0,"330205",4,19,4,15,10,9,0,0,0,0,0,19,4,15,10,9,10,9.9172173658025,9.63554274576738,0.478244158995042,30
"8908","RJ","Italva",15299,20276.49,33001,"Itaperuna",3,"Sudeste",0,"330205",5,16,5,11,5,11,0,0,0,0,0,16,5,11,5,11,20,9.9172173658025,9.63554274576738,0.47698189210594,31
"8909","RJ","Itaocara",23222,23342.04,33002,"Santo Antônio de Pádua",3,"Sudeste",0,"330210",2,18,0,18,5,13,0,0,0,0,0,18,0,18,5,13,19,10.05801130562,10.052855384187,0.320004811162521,29
"8910","RJ","Itaocara",23222,23342.04,33002,"Santo Antônio de Pádua",3,"Sudeste",0,"330210",3,21,2,19,7,14,0,0,0,0,0,21,2,19,7,14,21,10.05801130562,10.052855384187,0.426883375876765,31
"8911","RJ","Itaocara",23222,23342.04,33002,"Santo Antônio de Pádua",3,"Sudeste",0,"330210",4,17,4,13,7,10,0,0,0,0,0,17,4,13,7,10,20,10.05801130562,10.052855384187,0.45754480191983,30
"8912","RJ","Itaocara",23222,23342.04,33002,"Santo Antônio de Pádua",3,"Sudeste",0,"330210",5,24,4,20,14,10,0,0,0,0,0,24,4,20,14,10,24,10.05801130562,10.052855384187,0.441026508260664,31
"8913","RJ","Itaperuna",103800,27161.66,33001,"Itaperuna",3,"Sudeste",1,"330220",2,72,14,58,22,50,2,0,2,1,1,74,14,60,23,51,78,10.209561699098,11.5502212497139,0.349500654106252,29
"8914","RJ","Itaperuna",103800,27161.66,33001,"Itaperuna",3,"Sudeste",1,"330220",3,86,15,71,25,61,3,1,2,1,2,89,16,73,26,63,82,10.209561699098,11.5502212497139,0.457382387574392,31
"8915","RJ","Itaperuna",103800,27161.66,33001,"Itaperuna",3,"Sudeste",1,"330220",4,87,13,74,45,42,0,0,0,0,0,87,13,74,45,42,68,10.209561699098,11.5502212497139,0.52051963953753,30
"8916","RJ","Itaperuna",103800,27161.66,33001,"Itaperuna",3,"Sudeste",1,"330220",5,108,22,86,42,66,0,0,0,0,0,108,22,86,42,66,69,10.209561699098,11.5502212497139,0.482308745771474,31
"8917","RJ","Itatiaia",32064,156381.39,33011,"Vale do Paraíba Fluminense",3,"Sudeste",1,"330225",2,25,6,19,8,17,1,0,1,0,1,26,6,20,8,18,15,11.9600531102437,10.3754891844445,0.326827964789897,29
"8918","RJ","Itatiaia",32064,156381.39,33011,"Vale do Paraíba Fluminense",3,"Sudeste",1,"330225",3,23,7,16,9,14,0,0,0,0,0,23,7,16,9,14,22,11.9600531102437,10.3754891844445,0.425527188562259,31
"8919","RJ","Itatiaia",32064,156381.39,33011,"Vale do Paraíba Fluminense",3,"Sudeste",1,"330225",4,29,7,22,10,19,1,0,1,0,1,30,7,23,10,20,18,11.9600531102437,10.3754891844445,0.497019839043622,30
"8920","RJ","Itatiaia",32064,156381.39,33011,"Vale do Paraíba Fluminense",3,"Sudeste",1,"330225",5,28,9,19,14,14,0,0,0,0,0,28,9,19,14,14,24,11.9600531102437,10.3754891844445,0.451711054614703,31
"8921","RJ","Japeri",105548,13825.88,33018,"Rio de Janeiro",3,"Sudeste",1,"330227",2,82,23,59,37,45,0,0,0,0,0,82,23,59,37,45,55,9.53429747716767,11.5669211047312,0.33593514864446,29
"8922","RJ","Japeri",105548,13825.88,33018,"Rio de Janeiro",3,"Sudeste",1,"330227",3,92,24,68,40,52,0,0,0,0,0,92,24,68,40,52,61,9.53429747716767,11.5669211047312,0.414343993571184,31
"8923","RJ","Japeri",105548,13825.88,33018,"Rio de Janeiro",3,"Sudeste",1,"330227",4,84,31,53,38,46,0,0,0,0,0,84,31,53,38,46,71,9.53429747716767,11.5669211047312,0.463278900560132,30
"8924","RJ","Japeri",105548,13825.88,33018,"Rio de Janeiro",3,"Sudeste",1,"330227",5,90,22,68,32,58,2,0,2,0,2,92,22,70,32,60,80,9.53429747716767,11.5669211047312,0.444502724270106,31
"8925","RJ","Macaé",261501,61223.07,33004,"Macaé",3,"Sudeste",1,"330240",2,252,53,199,106,146,2,1,1,0,2,254,54,200,106,148,108,11.0222793582529,12.4741933865716,0.305165749304361,29
"8926","RJ","Macaé",261501,61223.07,33004,"Macaé",3,"Sudeste",1,"330240",3,236,56,180,100,136,2,1,1,1,1,238,57,181,101,137,148,11.0222793582529,12.4741933865716,0.426953543447155,31
"8927","RJ","Macaé",261501,61223.07,33004,"Macaé",3,"Sudeste",1,"330240",4,231,62,169,87,144,3,1,2,1,2,234,63,171,88,146,127,11.0222793582529,12.4741933865716,0.50448892092576,30
"8928","RJ","Macaé",261501,61223.07,33004,"Macaé",3,"Sudeste",1,"330240",5,252,61,191,87,165,2,0,2,0,2,254,61,193,87,167,155,11.0222793582529,12.4741933865716,0.46332830987024,31
"8929","RJ","Magé",246433,15926.84,33018,"Rio de Janeiro",3,"Sudeste",1,"330250",2,244,59,185,112,132,1,0,1,1,0,245,59,186,113,132,168,9.6757610153672,12.4148454302453,0.328171187049575,29
"8930","RJ","Magé",246433,15926.84,33018,"Rio de Janeiro",3,"Sudeste",1,"330250",3,268,75,193,105,163,3,2,1,3,0,271,77,194,108,163,182,9.6757610153672,12.4148454302453,0.429686057582688,31
"8931","RJ","Magé",246433,15926.84,33018,"Rio de Janeiro",3,"Sudeste",1,"330250",4,287,98,189,130,157,2,0,2,1,1,289,98,191,131,158,209,9.6757610153672,12.4148454302453,0.48841717418813,30
"8932","RJ","Magé",246433,15926.84,33018,"Rio de Janeiro",3,"Sudeste",1,"330250",5,303,88,215,141,162,6,3,3,2,4,309,91,218,143,166,305,9.6757610153672,12.4148454302453,0.468905329326373,31
"8933","RJ","Mangaratiba",45220,82215.21,33017,"Itaguaí",3,"Sudeste",1,"330260",2,22,3,19,10,12,1,0,1,1,0,23,3,20,11,12,18,11.3170956004235,10.719294745832,0.333486310888347,29
"8934","RJ","Mangaratiba",45220,82215.21,33017,"Itaguaí",3,"Sudeste",1,"330260",3,33,11,22,19,14,0,0,0,0,0,33,11,22,19,14,28,11.3170956004235,10.719294745832,0.426846413998681,31
"8935","RJ","Mangaratiba",45220,82215.21,33017,"Itaguaí",3,"Sudeste",1,"330260",4,56,14,42,28,28,0,0,0,0,0,56,14,42,28,28,33,11.3170956004235,10.719294745832,0.486785325318593,30
"8936","RJ","Mangaratiba",45220,82215.21,33017,"Itaguaí",3,"Sudeste",1,"330260",5,40,8,32,20,20,1,1,0,1,0,41,9,32,21,20,55,11.3170956004235,10.719294745832,0.468973996890677,31
"8937","RJ","Maricá",164504,171003.42,33018,"Rio de Janeiro",3,"Sudeste",1,"330270",2,120,18,102,38,82,3,0,3,1,2,123,18,105,39,84,110,12.0494388352848,12.0106901650014,0.315731165898546,29
"8938","RJ","Maricá",164504,171003.42,33018,"Rio de Janeiro",3,"Sudeste",1,"330270",3,119,28,91,44,75,3,2,1,0,3,122,30,92,44,78,130,12.0494388352848,12.0106901650014,0.428188740808765,31
"8939","RJ","Maricá",164504,171003.42,33018,"Rio de Janeiro",3,"Sudeste",1,"330270",4,100,19,81,37,63,3,0,3,0,3,103,19,84,37,66,129,12.0494388352848,12.0106901650014,0.497933650316664,30
"8940","RJ","Maricá",164504,171003.42,33018,"Rio de Janeiro",3,"Sudeste",1,"330270",5,133,29,104,43,90,0,0,0,0,0,133,29,104,43,90,170,12.0494388352848,12.0106901650014,0.470344336556557,31
"8941","RJ","Mendes",18648,17324.86,33014,"Vassouras",3,"Sudeste",0,"330280",2,14,3,11,4,10,0,0,0,0,0,14,3,11,4,10,18,9.75989774321737,9.83349418071559,0.33114236298887,29
"8942","RJ","Mendes",18648,17324.86,33014,"Vassouras",3,"Sudeste",0,"330280",3,14,3,11,4,10,0,0,0,0,0,14,3,11,4,10,13,9.75989774321737,9.83349418071559,0.419658169684306,31
"8943","RJ","Mendes",18648,17324.86,33014,"Vassouras",3,"Sudeste",0,"330280",4,14,3,11,7,7,0,0,0,0,0,14,3,11,7,7,10,9.75989774321737,9.83349418071559,0.463200625344744,30
"8944","RJ","Mendes",18648,17324.86,33014,"Vassouras",3,"Sudeste",0,"330280",5,10,1,9,4,6,0,0,0,0,0,10,1,9,4,6,17,9.75989774321737,9.83349418071559,0.462561617317165,31
"8945","RJ","Mesquita",176569,12879.91,33018,"Rio de Janeiro",3,"Sudeste",1,"330285",2,156,40,116,65,91,3,1,2,2,1,159,41,118,67,92,119,9.46342401205629,12.0814670138046,0.323591476511296,29
"8946","RJ","Mesquita",176569,12879.91,33018,"Rio de Janeiro",3,"Sudeste",1,"330285",3,162,33,129,69,93,2,1,1,1,1,164,34,130,70,94,135,9.46342401205629,12.0814670138046,0.423200827813339,31
"8947","RJ","Mesquita",176569,12879.91,33018,"Rio de Janeiro",3,"Sudeste",1,"330285",4,141,36,105,62,79,3,2,1,2,1,144,38,106,64,80,211,9.46342401205629,12.0814670138046,0.489084765713909,30
"8948","RJ","Mesquita",176569,12879.91,33018,"Rio de Janeiro",3,"Sudeste",1,"330285",5,204,56,148,88,116,0,0,0,0,0,204,56,148,88,116,240,9.46342401205629,12.0814670138046,0.461964966631779,31
"8949","RJ","Miguel Pereira",25581,23125.78,33014,"Vassouras",3,"Sudeste",1,"330290",2,23,7,16,10,13,0,0,0,0,0,23,7,16,10,13,20,10.0487032915415,10.1496051674102,0.317917213903533,29
"8950","RJ","Miguel Pereira",25581,23125.78,33014,"Vassouras",3,"Sudeste",1,"330290",3,17,5,12,11,6,0,0,0,0,0,17,5,12,11,6,22,10.0487032915415,10.1496051674102,0.439670817832229,31
"8951","RJ","Miguel Pereira",25581,23125.78,33014,"Vassouras",3,"Sudeste",1,"330290",4,30,10,20,13,17,1,1,0,0,1,31,11,20,13,18,22,10.0487032915415,10.1496051674102,0.510613036832187,30
"8952","RJ","Miguel Pereira",25581,23125.78,33014,"Vassouras",3,"Sudeste",1,"330290",5,25,11,14,13,12,0,0,0,0,0,25,11,14,13,12,28,10.0487032915415,10.1496051674102,0.479547261509428,31
"8953","RJ","Miracema",27154,19458.25,33002,"Santo Antônio de Pádua",3,"Sudeste",1,"330300",2,17,6,11,7,10,1,1,0,1,0,18,7,11,8,10,21,9.87602642363867,10.2092796441602,0.341796693334391,29
"8954","RJ","Miracema",27154,19458.25,33002,"Santo Antônio de Pádua",3,"Sudeste",1,"330300",3,21,9,12,15,6,0,0,0,0,0,21,9,12,15,6,23,9.87602642363867,10.2092796441602,0.418393209716543,31
"8955","RJ","Miracema",27154,19458.25,33002,"Santo Antônio de Pádua",3,"Sudeste",1,"330300",4,26,7,19,10,16,0,0,0,0,0,26,7,19,10,16,19,9.87602642363867,10.2092796441602,0.477908153856945,30
"8956","RJ","Miracema",27154,19458.25,33002,"Santo Antônio de Pádua",3,"Sudeste",1,"330300",5,33,7,26,11,22,0,0,0,0,0,33,7,26,11,22,29,9.87602642363867,10.2092796441602,0.460937744341373,31
"8957","RJ","Natividade",15311,18319.22,33001,"Itaperuna",3,"Sudeste",0,"330310",2,11,1,10,6,5,0,0,0,0,0,11,1,10,6,5,10,9.81570606090251,9.6363268033051,0.335679300218368,29
"8958","RJ","Natividade",15311,18319.22,33001,"Itaperuna",3,"Sudeste",0,"330310",3,15,3,12,5,10,0,0,0,0,0,15,3,12,5,10,12,9.81570606090251,9.6363268033051,0.454241097126895,31
"8959","RJ","Natividade",15311,18319.22,33001,"Itaperuna",3,"Sudeste",0,"330310",4,8,3,5,3,5,0,0,0,0,0,8,3,5,3,5,11,9.81570606090251,9.6363268033051,0.496255492129317,30
"8960","RJ","Natividade",15311,18319.22,33001,"Itaperuna",3,"Sudeste",0,"330310",5,14,2,12,10,4,0,0,0,0,0,14,2,12,10,4,14,9.81570606090251,9.6363268033051,0.459721706933721,31
"8961","RJ","Nilópolis",162693,17270.92,33018,"Rio de Janeiro",3,"Sudeste",1,"330320",2,105,18,87,43,62,1,0,1,0,1,106,18,88,43,63,112,9.75677944129104,11.9996202683111,0.326609460535163,29
"8962","RJ","Nilópolis",162693,17270.92,33018,"Rio de Janeiro",3,"Sudeste",1,"330320",3,102,16,86,42,60,0,0,0,0,0,102,16,86,42,60,126,9.75677944129104,11.9996202683111,0.43716044867544,31
"8963","RJ","Nilópolis",162693,17270.92,33018,"Rio de Janeiro",3,"Sudeste",1,"330320",4,87,20,67,27,60,2,0,2,0,2,89,20,69,27,62,214,9.75677944129104,11.9996202683111,0.514223867351902,30
"8964","RJ","Nilópolis",162693,17270.92,33018,"Rio de Janeiro",3,"Sudeste",1,"330320",5,137,23,114,52,85,1,0,1,1,0,138,23,115,53,85,244,9.75677944129104,11.9996202683111,0.487020473172684,31
"8965","RJ","Niterói",515317,78854.6,33018,"Rio de Janeiro",3,"Sudeste",1,"330330",2,407,69,338,128,279,5,3,2,2,3,412,72,340,130,282,375,11.2753609293072,13.1525375242631,0.315151147447759,29
"8966","RJ","Niterói",515317,78854.6,33018,"Rio de Janeiro",3,"Sudeste",1,"330330",3,401,96,305,125,276,2,0,2,1,1,403,96,307,126,277,437,11.2753609293072,13.1525375242631,0.453198433926807,31
"8967","RJ","Niterói",515317,78854.6,33018,"Rio de Janeiro",3,"Sudeste",1,"330330",4,366,74,292,109,257,4,0,4,2,2,370,74,296,111,259,457,11.2753609293072,13.1525375242631,0.553697236820028,30
"8968","RJ","Niterói",515317,78854.6,33018,"Rio de Janeiro",3,"Sudeste",1,"330330",5,439,85,354,133,306,8,5,3,6,2,447,90,357,139,308,696,11.2753609293072,13.1525375242631,0.521772840653641,31
"8969","RJ","Nova Friburgo",191158,27435.52,33007,"Nova Friburgo",3,"Sudeste",1,"330340",2,116,50,66,39,77,4,3,1,1,3,120,53,67,40,80,116,10.2195938032045,12.1608555901975,0.312957368771799,29
"8970","RJ","Nova Friburgo",191158,27435.52,33007,"Nova Friburgo",3,"Sudeste",1,"330340",3,174,60,114,64,110,0,0,0,0,0,174,60,114,64,110,138,10.2195938032045,12.1608555901975,0.433184072216839,31
"8971","RJ","Nova Friburgo",191158,27435.52,33007,"Nova Friburgo",3,"Sudeste",1,"330340",4,143,61,82,53,90,2,1,1,1,1,145,62,83,54,91,148,10.2195938032045,12.1608555901975,0.507711307638115,30
"8972","RJ","Nova Friburgo",191158,27435.52,33007,"Nova Friburgo",3,"Sudeste",1,"330340",5,108,43,65,37,71,0,0,0,0,0,108,43,65,37,71,161,10.2195938032045,12.1608555901975,0.468276590371735,31
"8973","RJ","Nova Iguaçu",823302,20538.67,33018,"Rio de Janeiro",3,"Sudeste",1,"330350",2,740,170,570,313,427,5,0,5,1,4,745,170,575,314,431,510,9.93006472968207,13.6210783625317,0.323763495789465,29
"8974","RJ","Nova Iguaçu",823302,20538.67,33018,"Rio de Janeiro",3,"Sudeste",1,"330350",3,819,194,625,365,454,5,1,4,3,2,824,195,629,368,456,579,9.93006472968207,13.6210783625317,0.42230828187456,31
"8975","RJ","Nova Iguaçu",823302,20538.67,33018,"Rio de Janeiro",3,"Sudeste",1,"330350",4,808,209,599,349,459,9,3,6,4,5,817,212,605,353,464,807,9.93006472968207,13.6210783625317,0.48630953730837,30
"8976","RJ","Nova Iguaçu",823302,20538.67,33018,"Rio de Janeiro",3,"Sudeste",1,"330350",5,867,204,663,340,527,13,7,6,6,7,880,211,669,346,534,1011,9.93006472968207,13.6210783625317,0.459489125736686,31
"8977","RJ","Paracambi",52683,18799.04,33014,"Vassouras",3,"Sudeste",1,"330360",2,25,6,19,11,14,0,0,0,0,0,25,6,19,11,14,40,9.84156108368445,10.872048101844,0.331208290374173,29
"8978","RJ","Paracambi",52683,18799.04,33014,"Vassouras",3,"Sudeste",1,"330360",3,46,9,37,19,27,0,0,0,0,0,46,9,37,19,27,37,9.84156108368445,10.872048101844,0.436996760631775,31
"8979","RJ","Paracambi",52683,18799.04,33014,"Vassouras",3,"Sudeste",1,"330360",4,37,5,32,14,23,0,0,0,0,0,37,5,32,14,23,35,9.84156108368445,10.872048101844,0.48507527045158,30
"8980","RJ","Paracambi",52683,18799.04,33014,"Vassouras",3,"Sudeste",1,"330360",5,35,7,28,11,24,0,0,0,0,0,35,7,28,11,24,51,9.84156108368445,10.872048101844,0.465533724960501,31
"8981","RJ","Paraíba do Sul",44518,22562.99,33005,"Três Rios",3,"Sudeste",1,"330370",2,40,15,25,19,21,0,0,0,0,0,40,15,25,19,21,39,10.0240662322909,10.7036488807506,0.321937186440317,29
"8982","RJ","Paraíba do Sul",44518,22562.99,33005,"Três Rios",3,"Sudeste",1,"330370",3,40,10,30,20,20,1,0,1,0,1,41,10,31,20,21,31,10.0240662322909,10.7036488807506,0.41791744782187,31
"8983","RJ","Paraíba do Sul",44518,22562.99,33005,"Três Rios",3,"Sudeste",1,"330370",4,43,10,33,14,29,0,0,0,0,0,43,10,33,14,29,37,10.0240662322909,10.7036488807506,0.46738949044249,30
"8984","RJ","Paraíba do Sul",44518,22562.99,33005,"Três Rios",3,"Sudeste",1,"330370",5,52,12,40,27,25,1,1,0,1,0,53,13,40,28,25,29,10.0240662322909,10.7036488807506,0.454411542467629,31
"8985","RJ","Paraty",43680,61447.75,33013,"Baía da Ilha Grande",3,"Sudeste",0,"330380",2,54,25,29,29,25,1,1,0,1,0,55,26,29,30,25,30,11.0259424991896,10.6846456104188,0.307510483028208,29
"8986","RJ","Paraty",43680,61447.75,33013,"Baía da Ilha Grande",3,"Sudeste",0,"330380",3,33,6,27,16,17,1,0,1,0,1,34,6,28,16,18,15,11.0259424991896,10.6846456104188,0.44335914244331,31
"8987","RJ","Paraty",43680,61447.75,33013,"Baía da Ilha Grande",3,"Sudeste",0,"330380",4,42,14,28,16,26,0,0,0,0,0,42,14,28,16,26,23,11.0259424991896,10.6846456104188,0.525533171179312,30
"8988","RJ","Paraty",43680,61447.75,33013,"Baía da Ilha Grande",3,"Sudeste",0,"330380",5,53,21,32,24,29,1,1,0,0,1,54,22,32,24,30,23,11.0259424991896,10.6846456104188,0.498828638001528,31
"8989","RJ","Paty do Alferes",27858,19606.08,33014,"Vassouras",3,"Sudeste",1,"330385",2,26,8,18,12,14,0,0,0,0,0,26,8,18,12,14,12,9.8835950011969,10.234875457248,0.322765542803058,29
"8990","RJ","Paty do Alferes",27858,19606.08,33014,"Vassouras",3,"Sudeste",1,"330385",3,23,5,18,11,12,2,0,2,0,2,25,5,20,11,14,20,9.8835950011969,10.234875457248,0.432214022716187,31
"8991","RJ","Paty do Alferes",27858,19606.08,33014,"Vassouras",3,"Sudeste",1,"330385",4,29,9,20,14,15,0,0,0,0,0,29,9,20,14,15,28,9.8835950011969,10.234875457248,0.467598413108458,30
"8992","RJ","Paty do Alferes",27858,19606.08,33014,"Vassouras",3,"Sudeste",1,"330385",5,34,16,18,12,22,0,0,0,0,0,34,16,18,12,22,19,9.8835950011969,10.234875457248,0.445829258081828,31
"8993","RJ","Petrópolis",306678,41456.25,33015,"Serrana",3,"Sudeste",1,"330390",2,247,54,193,83,164,1,1,0,0,1,248,55,193,83,165,180,10.6323939332739,12.633553616196,0.320026604084536,29
"8994","RJ","Petrópolis",306678,41456.25,33015,"Serrana",3,"Sudeste",1,"330390",3,249,61,188,67,182,2,1,1,1,1,251,62,189,68,183,219,10.6323939332739,12.633553616196,0.430928731963446,31
"8995","RJ","Petrópolis",306678,41456.25,33015,"Serrana",3,"Sudeste",1,"330390",4,264,78,186,100,164,3,2,1,1,2,267,80,187,101,166,218,10.6323939332739,12.633553616196,0.510542508889697,30
"8996","RJ","Petrópolis",306678,41456.25,33015,"Serrana",3,"Sudeste",1,"330390",5,286,75,211,101,185,1,1,0,0,1,287,76,211,101,186,289,10.6323939332739,12.633553616196,0.471119118998859,31
"8997","RJ","Pinheiral",25364,21732.84,33011,"Vale do Paraíba Fluminense",3,"Sudeste",1,"330395",2,17,3,14,3,14,0,0,0,0,0,17,3,14,3,14,17,9.9865797596025,10.1410861248199,0.306181542045721,29
"8998","RJ","Pinheiral",25364,21732.84,33011,"Vale do Paraíba Fluminense",3,"Sudeste",1,"330395",3,28,8,20,16,12,1,0,1,0,1,29,8,21,16,13,23,9.9865797596025,10.1410861248199,0.415667419010727,31
"8999","RJ","Pinheiral",25364,21732.84,33011,"Vale do Paraíba Fluminense",3,"Sudeste",1,"330395",4,29,9,20,17,12,0,0,0,0,0,29,9,20,17,12,15,9.9865797596025,10.1410861248199,0.478775461871883,30
"9000","RJ","Pinheiral",25364,21732.84,33011,"Vale do Paraíba Fluminense",3,"Sudeste",1,"330395",5,36,9,27,14,22,0,0,0,0,0,36,9,27,14,22,7,9.9865797596025,10.1410861248199,0.439716671227692,31
"9001","RJ","Piraí",29545,63885,33011,"Vale do Paraíba Fluminense",3,"Sudeste",0,"330400",2,24,6,18,7,17,0,0,0,0,0,24,6,18,7,17,17,11.0648398710254,10.2936698037798,0.322633831262625,29
"9002","RJ","Piraí",29545,63885,33011,"Vale do Paraíba Fluminense",3,"Sudeste",0,"330400",3,29,6,23,9,20,0,0,0,0,0,29,6,23,9,20,25,11.0648398710254,10.2936698037798,0.424769989362746,31
"9003","RJ","Piraí",29545,63885,33011,"Vale do Paraíba Fluminense",3,"Sudeste",0,"330400",4,22,4,18,12,10,0,0,0,0,0,22,4,18,12,10,14,11.0648398710254,10.2936698037798,0.480655955720986,30
"9004","RJ","Piraí",29545,63885,33011,"Vale do Paraíba Fluminense",3,"Sudeste",0,"330400",5,21,8,13,8,13,0,0,0,0,0,21,8,13,8,13,37,11.0648398710254,10.2936698037798,0.443361561946506,31
"9005","RJ","Porciúncula",18960,18689.85,33001,"Itaperuna",3,"Sudeste",0,"330410",2,12,6,6,5,7,0,0,0,0,0,12,6,6,5,7,11,9.83573587473522,9.85008677580901,0.307860958046241,29
"9006","RJ","Porciúncula",18960,18689.85,33001,"Itaperuna",3,"Sudeste",0,"330410",3,17,5,12,9,8,0,0,0,0,0,17,5,12,9,8,11,9.83573587473522,9.85008677580901,0.402043996208468,31
"9007","RJ","Porciúncula",18960,18689.85,33001,"Itaperuna",3,"Sudeste",0,"330410",4,12,3,9,7,5,1,1,0,0,1,13,4,9,7,6,9,9.83573587473522,9.85008677580901,0.481694668188431,30
"9008","RJ","Porciúncula",18960,18689.85,33001,"Itaperuna",3,"Sudeste",0,"330410",5,24,2,22,11,13,0,0,0,0,0,24,2,22,11,13,13,9.83573587473522,9.85008677580901,0.476157991312703,31
"9009","RJ","Porto Real",19974,147371.58,33011,"Vale do Paraíba Fluminense",3,"Sudeste",1,"330411",2,16,5,11,6,10,0,0,0,0,0,16,5,11,6,10,6,11.9007124314635,9.90218670680308,0.311488621920633,29
"9010","RJ","Porto Real",19974,147371.58,33011,"Vale do Paraíba Fluminense",3,"Sudeste",1,"330411",3,31,4,27,10,21,0,0,0,0,0,31,4,27,10,21,8,11.9007124314635,9.90218670680308,0.422414957203604,31
"9011","RJ","Porto Real",19974,147371.58,33011,"Vale do Paraíba Fluminense",3,"Sudeste",1,"330411",4,23,5,18,10,13,0,0,0,0,0,23,5,18,10,13,4,11.9007124314635,9.90218670680308,0.492942054121904,30
"9012","RJ","Porto Real",19974,147371.58,33011,"Vale do Paraíba Fluminense",3,"Sudeste",1,"330411",5,20,4,16,10,10,0,0,0,0,0,20,4,16,10,10,10,11.9007124314635,9.90218670680308,0.439333198550403,31
"9013","RJ","Quatis",14435,18706.57,33011,"Vale do Paraíba Fluminense",3,"Sudeste",1,"330412",2,15,4,11,8,7,0,0,0,0,0,15,4,11,8,7,5,9.83663007803672,9.57741109209704,0.310639217279276,29
"9014","RJ","Quatis",14435,18706.57,33011,"Vale do Paraíba Fluminense",3,"Sudeste",1,"330412",3,13,3,10,5,8,0,0,0,0,0,13,3,10,5,8,7,9.83663007803672,9.57741109209704,0.400231272808899,31
"9015","RJ","Quatis",14435,18706.57,33011,"Vale do Paraíba Fluminense",3,"Sudeste",1,"330412",4,10,2,8,4,6,0,0,0,0,0,10,2,8,4,6,8,9.83663007803672,9.57741109209704,0.479241594346387,30
"9016","RJ","Quatis",14435,18706.57,33011,"Vale do Paraíba Fluminense",3,"Sudeste",1,"330412",5,10,3,7,5,5,0,0,0,0,0,10,3,7,5,5,7,9.83663007803672,9.57741109209704,0.443636167482291,31
"9017","RJ","Queimados",151335,24050.05,33018,"Rio de Janeiro",3,"Sudeste",1,"330414",2,130,23,107,54,76,3,1,2,0,3,133,24,109,54,79,91,10.0878923545338,11.9272512015106,0.321250010267698,29
"9018","RJ","Queimados",151335,24050.05,33018,"Rio de Janeiro",3,"Sudeste",1,"330414",3,165,43,122,80,85,6,3,3,1,5,171,46,125,81,90,114,10.0878923545338,11.9272512015106,0.418132660213685,31
"9019","RJ","Queimados",151335,24050.05,33018,"Rio de Janeiro",3,"Sudeste",1,"330414",4,123,28,95,53,70,5,2,3,2,3,128,30,98,55,73,129,10.0878923545338,11.9272512015106,0.471367054407463,30
"9020","RJ","Queimados",151335,24050.05,33018,"Rio de Janeiro",3,"Sudeste",1,"330414",5,89,17,72,25,64,5,1,4,4,1,94,18,76,29,65,192,10.0878923545338,11.9272512015106,0.448859735443559,31
"9021","RJ","Quissamã",25126,101931.44,33004,"Macaé",3,"Sudeste",0,"330415",2,25,5,20,13,12,0,0,0,0,0,25,5,20,13,12,10,11.532055709405,10.1316584455644,0.280160479171559,29
"9022","RJ","Quissamã",25126,101931.44,33004,"Macaé",3,"Sudeste",0,"330415",3,25,6,19,14,11,0,0,0,0,0,25,6,19,14,11,9,11.532055709405,10.1316584455644,0.363038623624628,31
"9023","RJ","Quissamã",25126,101931.44,33004,"Macaé",3,"Sudeste",0,"330415",4,33,13,20,11,22,0,0,0,0,0,33,13,20,11,22,7,11.532055709405,10.1316584455644,0.429227616658036,30
"9024","RJ","Quissamã",25126,101931.44,33004,"Macaé",3,"Sudeste",0,"330415",5,26,9,17,13,13,1,0,1,0,1,27,9,18,13,14,10,11.532055709405,10.1316584455644,0.392758346399954,31
"9025","RJ","Resende",132312,64649.16,33011,"Vale do Paraíba Fluminense",3,"Sudeste",1,"330420",2,99,19,80,29,70,1,0,1,1,0,100,19,81,30,70,75,11.0767303910762,11.7929180489376,0.310991415814018,29
"9026","RJ","Resende",132312,64649.16,33011,"Vale do Paraíba Fluminense",3,"Sudeste",1,"330420",3,130,29,101,46,84,1,0,1,1,0,131,29,102,47,84,100,11.0767303910762,11.7929180489376,0.411602368107734,31
"9027","RJ","Resende",132312,64649.16,33011,"Vale do Paraíba Fluminense",3,"Sudeste",1,"330420",4,127,25,102,55,72,2,1,1,1,1,129,26,103,56,73,57,11.0767303910762,11.7929180489376,0.483680118464177,30
"9028","RJ","Resende",132312,64649.16,33011,"Vale do Paraíba Fluminense",3,"Sudeste",1,"330420",5,142,28,114,52,90,0,0,0,0,0,142,28,114,52,90,83,11.0767303910762,11.7929180489376,0.440606283743607,31
"9029","RJ","Rio Bonito",60573,27755.96,33016,"Macacu-Caceribu",3,"Sudeste",1,"330430",2,64,20,44,21,43,0,0,0,0,0,64,20,44,21,43,24,10.2312058708886,11.0116045282185,0.309189164653365,29
"9030","RJ","Rio Bonito",60573,27755.96,33016,"Macacu-Caceribu",3,"Sudeste",1,"330430",3,69,24,45,30,39,0,0,0,0,0,69,24,45,30,39,42,10.2312058708886,11.0116045282185,0.411073474505554,31
"9031","RJ","Rio Bonito",60573,27755.96,33016,"Macacu-Caceribu",3,"Sudeste",1,"330430",4,59,22,37,24,35,2,1,1,1,1,61,23,38,25,36,35,10.2312058708886,11.0116045282185,0.478868935086518,30
"9032","RJ","Rio Bonito",60573,27755.96,33016,"Macacu-Caceribu",3,"Sudeste",1,"330430",5,48,14,34,15,33,1,0,1,1,0,49,14,35,16,33,43,10.2312058708886,11.0116045282185,0.446969986087084,31
"9033","RJ","Rio Claro",18605,21763.04,33011,"Vale do Paraíba Fluminense",3,"Sudeste",0,"330440",2,12,4,8,6,6,0,0,0,0,0,12,4,8,6,6,16,9.98796839709427,9.83118564078072,0.318259098481606,29
"9034","RJ","Rio Claro",18605,21763.04,33011,"Vale do Paraíba Fluminense",3,"Sudeste",0,"330440",3,21,8,13,7,14,0,0,0,0,0,21,8,13,7,14,3,9.98796839709427,9.83118564078072,0.405313206758758,31
"9035","RJ","Rio Claro",18605,21763.04,33011,"Vale do Paraíba Fluminense",3,"Sudeste",0,"330440",4,11,2,9,5,6,0,0,0,0,0,11,2,9,5,6,9,9.98796839709427,9.83118564078072,0.470985478667159,30
"9036","RJ","Rio Claro",18605,21763.04,33011,"Vale do Paraíba Fluminense",3,"Sudeste",0,"330440",5,11,4,7,6,5,0,0,0,0,0,11,4,7,6,5,16,9.98796839709427,9.83118564078072,0.44864646289019,31
"9037","RJ","Rio das Flores",9344,22263.47,33012,"Barra do Piraí",3,"Sudeste",0,"330450",2,7,3,4,4,3,0,0,0,0,0,7,3,4,4,3,3,10.0107024976762,9.14248970506801,0.339148359216572,29
"9038","RJ","Rio das Flores",9344,22263.47,33012,"Barra do Piraí",3,"Sudeste",0,"330450",3,6,2,4,2,4,0,0,0,0,0,6,2,4,2,4,7,10.0107024976762,9.14248970506801,0.452294723682856,31
"9039","RJ","Rio das Flores",9344,22263.47,33012,"Barra do Piraí",3,"Sudeste",0,"330450",4,14,1,13,6,8,0,0,0,0,0,14,1,13,6,8,4,10.0107024976762,9.14248970506801,0.5156480308944,30
"9040","RJ","Rio das Flores",9344,22263.47,33012,"Barra do Piraí",3,"Sudeste",0,"330450",5,8,2,6,0,8,0,0,0,0,0,8,2,6,0,8,3,10.0107024976762,9.14248970506801,0.501533320451523,31
"9041","RJ","Rio das Ostras",155193,58789.09,33009,"Bacia de São João",3,"Sudeste",1,"330452",2,96,18,78,31,65,0,0,0,0,0,96,18,78,31,65,74,10.9817115724536,11.9524247826213,0.310311706213652,29
"9042","RJ","Rio das Ostras",155193,58789.09,33009,"Bacia de São João",3,"Sudeste",1,"330452",3,67,7,60,14,53,2,1,1,1,1,69,8,61,15,54,78,10.9817115724536,11.9524247826213,0.433539230398965,31
"9043","RJ","Rio das Ostras",155193,58789.09,33009,"Bacia de São João",3,"Sudeste",1,"330452",4,92,19,73,25,67,0,0,0,0,0,92,19,73,25,67,93,10.9817115724536,11.9524247826213,0.511070109273589,30
"9044","RJ","Rio das Ostras",155193,58789.09,33009,"Bacia de São João",3,"Sudeste",1,"330452",5,97,19,78,38,59,1,0,1,0,1,98,19,79,38,60,88,10.9817115724536,11.9524247826213,0.470913377972585,31
"9045","RJ","Rio de Janeiro",6747815,54426.08,33018,"Rio de Janeiro",3,"Sudeste",1,"330455",2,5249,1034,4215,1831,3418,47,19,28,16,31,5296,1053,4243,1847,3449,4469,10.9045987297276,15.7247293067417,0.312230422202507,29
"9046","RJ","Rio de Janeiro",6747815,54426.08,33018,"Rio de Janeiro",3,"Sudeste",1,"330455",3,5409,1070,4339,1943,3466,54,27,27,16,38,5463,1097,4366,1959,3504,5051,10.9045987297276,15.7247293067417,0.429409806801603,31
"9047","RJ","Rio de Janeiro",6747815,54426.08,33018,"Rio de Janeiro",3,"Sudeste",1,"330455",4,5187,1048,4139,1906,3281,56,21,35,22,34,5243,1069,4174,1928,3315,7890,10.9045987297276,15.7247293067417,0.517651736238194,30
"9048","RJ","Rio de Janeiro",6747815,54426.08,33018,"Rio de Janeiro",3,"Sudeste",1,"330455",5,5870,1137,4733,2072,3798,58,16,42,21,37,5928,1153,4775,2093,3835,9589,10.9045987297276,15.7247293067417,0.487807019349933,31
"9049","RJ","Santa Maria Madalena",10392,17415.87,33008,"Santa Maria Madalena",3,"Sudeste",0,"330460",2,3,2,1,2,1,0,0,0,0,0,3,2,1,2,1,6,9.76513713848597,9.24879155835043,0.282968906364581,29
"9050","RJ","Santa Maria Madalena",10392,17415.87,33008,"Santa Maria Madalena",3,"Sudeste",0,"330460",3,5,2,3,2,3,0,0,0,0,0,5,2,3,2,3,9,9.76513713848597,9.24879155835043,0.357744247135629,31
"9051","RJ","Santa Maria Madalena",10392,17415.87,33008,"Santa Maria Madalena",3,"Sudeste",0,"330460",4,5,1,4,1,4,0,0,0,0,0,5,1,4,1,4,1,9.76513713848597,9.24879155835043,0.401843807532084,30
"9052","RJ","Santa Maria Madalena",10392,17415.87,33008,"Santa Maria Madalena",3,"Sudeste",0,"330460",5,6,0,6,2,4,0,0,0,0,0,6,0,6,2,4,4,9.76513713848597,9.24879155835043,0.38801895636325,31
"9053","RJ","Santo Antônio de Pádua",42594,25660.26,33002,"Santo Antônio de Pádua",3,"Sudeste",1,"330470",2,35,4,31,11,24,0,0,0,0,0,35,4,31,11,24,31,10.1526987706202,10.6594686772674,0.345906512870476,29
"9054","RJ","Santo Antônio de Pádua",42594,25660.26,33002,"Santo Antônio de Pádua",3,"Sudeste",1,"330470",3,41,6,35,15,26,0,0,0,0,0,41,6,35,15,26,27,10.1526987706202,10.6594686772674,0.440345148560621,31
"9055","RJ","Santo Antônio de Pádua",42594,25660.26,33002,"Santo Antônio de Pádua",3,"Sudeste",1,"330470",4,40,9,31,22,18,0,0,0,0,0,40,9,31,22,18,21,10.1526987706202,10.6594686772674,0.48742380625207,30
"9056","RJ","Santo Antônio de Pádua",42594,25660.26,33002,"Santo Antônio de Pádua",3,"Sudeste",1,"330470",5,42,6,36,23,19,0,0,0,0,0,42,6,36,23,19,36,10.1526987706202,10.6594686772674,0.447756525200391,31
"9057","RJ","São Francisco de Itabapoana",42210,24249.19,33003,"Campos dos Goytacazes",3,"Sudeste",0,"330475",2,42,19,23,21,21,1,1,0,0,1,43,20,23,21,22,24,10.0961384937459,10.6504124387765,0.328206678982657,29
"9058","RJ","São Francisco de Itabapoana",42210,24249.19,33003,"Campos dos Goytacazes",3,"Sudeste",0,"330475",3,59,28,31,30,29,0,0,0,0,0,59,28,31,30,29,33,10.0961384937459,10.6504124387765,0.41363782142037,31
"9059","RJ","São Francisco de Itabapoana",42210,24249.19,33003,"Campos dos Goytacazes",3,"Sudeste",0,"330475",4,43,14,29,20,23,0,0,0,0,0,43,14,29,20,23,21,10.0961384937459,10.6504124387765,0.449168462884339,30
"9060","RJ","São Francisco de Itabapoana",42210,24249.19,33003,"Campos dos Goytacazes",3,"Sudeste",0,"330475",5,47,19,28,17,30,0,0,0,0,0,47,19,28,17,30,33,10.0961384937459,10.6504124387765,0.428087204702022,31
"9061","RJ","São Fidélis",38710,17997.75,33003,"Campos dos Goytacazes",3,"Sudeste",0,"330480",2,33,11,22,14,19,0,0,0,0,0,33,11,22,14,19,31,9.79800202906515,10.5638532435717,0.312720195251256,29
"9062","RJ","São Fidélis",38710,17997.75,33003,"Campos dos Goytacazes",3,"Sudeste",0,"330480",3,37,13,24,13,24,0,0,0,0,0,37,13,24,13,24,24,9.79800202906515,10.5638532435717,0.419248295701123,31
"9063","RJ","São Fidélis",38710,17997.75,33003,"Campos dos Goytacazes",3,"Sudeste",0,"330480",4,30,8,22,12,18,0,0,0,0,0,30,8,22,12,18,22,9.79800202906515,10.5638532435717,0.462062527553306,30
"9064","RJ","São Fidélis",38710,17997.75,33003,"Campos dos Goytacazes",3,"Sudeste",0,"330480",5,29,6,23,11,18,1,1,0,1,0,30,7,23,12,18,43,9.79800202906515,10.5638532435717,0.45451612839143,31
"9065","RJ","São Gonçalo",1091737,17167.6,33018,"Rio de Janeiro",3,"Sudeste",1,"330490",2,668,182,486,267,401,7,3,4,1,6,675,185,490,268,407,628,9.75077916543782,13.9032805637889,0.320679272785624,29
"9066","RJ","São Gonçalo",1091737,17167.6,33018,"Rio de Janeiro",3,"Sudeste",1,"330490",3,762,194,568,309,453,8,3,5,3,5,770,197,573,312,458,662,9.75077916543782,13.9032805637889,0.428236103230491,31
"9067","RJ","São Gonçalo",1091737,17167.6,33018,"Rio de Janeiro",3,"Sudeste",1,"330490",4,789,200,589,342,447,3,3,0,0,3,792,203,589,342,450,781,9.75077916543782,13.9032805637889,0.499611108072121,30
"9068","RJ","São Gonçalo",1091737,17167.6,33018,"Rio de Janeiro",3,"Sudeste",1,"330490",5,812,230,582,346,466,14,6,8,2,12,826,236,590,348,478,1111,9.75077916543782,13.9032805637889,0.474031093024106,31
"9069","RJ","São João da Barra",36423,199339.81,33003,"Campos dos Goytacazes",3,"Sudeste",1,"330500",2,44,17,27,17,27,2,1,1,1,1,46,18,28,18,28,23,12.2027662353756,10.5029557222121,0.304008472087175,29
"9070","RJ","São João da Barra",36423,199339.81,33003,"Campos dos Goytacazes",3,"Sudeste",1,"330500",3,36,10,26,15,21,0,0,0,0,0,36,10,26,15,21,21,12.2027662353756,10.5029557222121,0.406392544031153,31
"9071","RJ","São João da Barra",36423,199339.81,33003,"Campos dos Goytacazes",3,"Sudeste",1,"330500",4,49,18,31,24,25,0,0,0,0,0,49,18,31,24,25,22,12.2027662353756,10.5029557222121,0.468593656179092,30
"9072","RJ","São João da Barra",36423,199339.81,33003,"Campos dos Goytacazes",3,"Sudeste",1,"330500",5,52,20,32,24,28,1,0,1,0,1,53,20,33,24,29,36,12.2027662353756,10.5029557222121,0.452917307794765,31
"9073","RJ","São João de Meriti",472906,19726.47,33018,"Rio de Janeiro",3,"Sudeste",1,"330510",2,387,99,288,173,214,6,2,4,2,4,393,101,292,175,218,310,9.88971666765208,13.0666519162233,0.322728711665459,29
"9074","RJ","São João de Meriti",472906,19726.47,33018,"Rio de Janeiro",3,"Sudeste",1,"330510",3,429,115,314,198,231,2,1,1,1,1,431,116,315,199,232,306,9.88971666765208,13.0666519162233,0.423447993280488,31
"9075","RJ","São João de Meriti",472906,19726.47,33018,"Rio de Janeiro",3,"Sudeste",1,"330510",4,423,117,306,191,232,3,1,2,1,2,426,118,308,192,234,517,9.88971666765208,13.0666519162233,0.493465351361548,30
"9076","RJ","São João de Meriti",472906,19726.47,33018,"Rio de Janeiro",3,"Sudeste",1,"330510",5,448,118,330,216,232,13,3,10,4,9,461,121,340,220,241,612,9.88971666765208,13.0666519162233,0.460937709017261,31
"9077","RJ","São José do Vale do Rio Preto",21916,24555.29,33015,"Serrana",3,"Sudeste",0,"330515",2,21,12,9,5,16,0,0,0,0,0,21,12,9,5,16,16,10.1086825886256,9.99497224265831,0.331865449695562,29
"9078","RJ","São José do Vale do Rio Preto",21916,24555.29,33015,"Serrana",3,"Sudeste",0,"330515",3,19,7,12,3,16,0,0,0,0,0,19,7,12,3,16,12,10.1086825886256,9.99497224265831,0.406442303442474,31
"9079","RJ","São José do Vale do Rio Preto",21916,24555.29,33015,"Serrana",3,"Sudeste",0,"330515",4,21,9,12,6,15,0,0,0,0,0,21,9,12,6,15,10,10.1086825886256,9.99497224265831,0.441213184428639,30
"9080","RJ","São José do Vale do Rio Preto",21916,24555.29,33015,"Serrana",3,"Sudeste",0,"330515",5,20,5,15,10,10,0,0,0,0,0,20,5,15,10,10,29,10.1086825886256,9.99497224265831,0.453966307097408,31
"9081","RJ","São Pedro da Aldeia",106049,22259.41,33010,"Lagos",3,"Sudeste",1,"330520",2,118,22,96,28,90,1,0,1,0,1,119,22,97,28,91,46,10.0105201195367,11.571656530434,0.312087161758223,29
"9082","RJ","São Pedro da Aldeia",106049,22259.41,33010,"Lagos",3,"Sudeste",1,"330520",3,146,33,113,59,87,0,0,0,0,0,146,33,113,59,87,66,10.0105201195367,11.571656530434,0.419376377926794,31
"9083","RJ","São Pedro da Aldeia",106049,22259.41,33010,"Lagos",3,"Sudeste",1,"330520",4,120,25,95,50,70,1,1,0,1,0,121,26,95,51,70,65,10.0105201195367,11.571656530434,0.480960047689767,30
"9084","RJ","São Pedro da Aldeia",106049,22259.41,33010,"Lagos",3,"Sudeste",1,"330520",5,142,25,117,53,89,0,0,0,0,0,142,25,117,53,89,78,10.0105201195367,11.571656530434,0.448338995017022,31
"9085","RJ","São Sebastião do Alto",9387,21801.76,33008,"Santa Maria Madalena",3,"Sudeste",0,"330530",2,5,0,5,1,4,0,0,0,0,0,5,0,5,1,4,4,9.98974597946333,9.14708103233699,0.333244931747477,29
"9086","RJ","São Sebastião do Alto",9387,21801.76,33008,"Santa Maria Madalena",3,"Sudeste",0,"330530",3,13,4,9,6,7,0,0,0,0,0,13,4,9,6,7,9,9.98974597946333,9.14708103233699,0.441720418711284,31
"9087","RJ","São Sebastião do Alto",9387,21801.76,33008,"Santa Maria Madalena",3,"Sudeste",0,"330530",4,7,4,3,5,2,0,0,0,0,0,7,4,3,5,2,3,9.98974597946333,9.14708103233699,0.510206742349621,30
"9088","RJ","São Sebastião do Alto",9387,21801.76,33008,"Santa Maria Madalena",3,"Sudeste",0,"330530",5,8,3,5,7,1,0,0,0,0,0,8,3,5,7,1,13,9.98974597946333,9.14708103233699,0.479364725092051,31
"9089","RJ","Sapucaia",18249,40457.4,33005,"Três Rios",3,"Sudeste",0,"330540",2,10,1,9,3,7,0,0,0,0,0,10,1,9,3,7,10,10.6080048476584,9.81186556298882,0.325600789745398,29
"9090","RJ","Sapucaia",18249,40457.4,33005,"Três Rios",3,"Sudeste",0,"330540",3,12,3,9,7,5,1,0,1,0,1,13,3,10,7,6,11,10.6080048476584,9.81186556298882,0.419310034687085,31
"9091","RJ","Sapucaia",18249,40457.4,33005,"Três Rios",3,"Sudeste",0,"330540",4,16,4,12,7,9,1,0,1,1,0,17,4,13,8,9,15,10.6080048476584,9.81186556298882,0.470225451337272,30
"9092","RJ","Sapucaia",18249,40457.4,33005,"Três Rios",3,"Sudeste",0,"330540",5,17,9,8,7,10,0,0,0,0,0,17,9,8,7,10,18,10.6080048476584,9.81186556298882,0.478554393698706,31
"9093","RJ","Saquarema",90583,35244.56,33010,"Lagos",3,"Sudeste",1,"330550",2,86,27,59,34,52,2,1,1,1,1,88,28,60,35,53,60,10.4700664700898,11.4140218364558,0.324148380282005,29
"9094","RJ","Saquarema",90583,35244.56,33010,"Lagos",3,"Sudeste",1,"330550",3,87,31,56,44,43,0,0,0,0,0,87,31,56,44,43,59,10.4700664700898,11.4140218364558,0.430829986149148,31
"9095","RJ","Saquarema",90583,35244.56,33010,"Lagos",3,"Sudeste",1,"330550",4,92,28,64,33,59,0,0,0,0,0,92,28,64,33,59,75,10.4700664700898,11.4140218364558,0.496208041311874,30
"9096","RJ","Saquarema",90583,35244.56,33010,"Lagos",3,"Sudeste",1,"330550",5,89,29,60,32,57,0,0,0,0,0,89,29,60,32,57,81,10.4700664700898,11.4140218364558,0.481213850739666,31
"9097","RJ","Seropédica",83092,51442.5,33017,"Itaguaí",3,"Sudeste",1,"330555",2,65,20,45,28,37,0,0,0,0,0,65,20,45,28,37,51,10.8482199580416,11.3277037066546,0.319352795566222,29
"9098","RJ","Seropédica",83092,51442.5,33017,"Itaguaí",3,"Sudeste",1,"330555",3,79,29,50,39,40,1,0,1,0,1,80,29,51,39,41,54,10.8482199580416,11.3277037066546,0.416114100687053,31
"9099","RJ","Seropédica",83092,51442.5,33017,"Itaguaí",3,"Sudeste",1,"330555",4,85,22,63,35,50,0,0,0,0,0,85,22,63,35,50,51,10.8482199580416,11.3277037066546,0.467004416155803,30
"9100","RJ","Seropédica",83092,51442.5,33017,"Itaguaí",3,"Sudeste",1,"330555",5,82,20,62,33,49,0,0,0,0,0,82,20,62,33,49,80,10.8482199580416,11.3277037066546,0.440333008148532,31
"9101","RJ","Silva Jardim",21774,21389.03,33009,"Bacia de São João",3,"Sudeste",0,"330560",2,16,7,9,9,7,0,0,0,0,0,16,7,9,9,7,20,9.97063345275459,9.98847187644112,0.330199948888309,29
"9102","RJ","Silva Jardim",21774,21389.03,33009,"Bacia de São João",3,"Sudeste",0,"330560",3,20,10,10,11,9,0,0,0,0,0,20,10,10,11,9,21,9.97063345275459,9.98847187644112,0.419806219603621,31
"9103","RJ","Silva Jardim",21774,21389.03,33009,"Bacia de São João",3,"Sudeste",0,"330560",4,19,3,16,6,13,0,0,0,0,0,19,3,16,6,13,13,9.97063345275459,9.98847187644112,0.474482060127202,30
"9104","RJ","Silva Jardim",21774,21389.03,33009,"Bacia de São João",3,"Sudeste",0,"330560",5,20,7,13,13,7,0,0,0,0,0,20,7,13,13,7,23,9.97063345275459,9.98847187644112,0.451206640849965,31
"9105","RJ","Sumidouro",15667,28758.27,33007,"Nova Friburgo",3,"Sudeste",0,"330570",2,16,8,8,8,8,0,0,0,0,0,16,8,8,8,8,6,10.2666806570355,9.65931186839349,0.365513584786969,29
"9106","RJ","Sumidouro",15667,28758.27,33007,"Nova Friburgo",3,"Sudeste",0,"330570",3,17,5,12,6,11,0,0,0,0,0,17,5,12,6,11,9,10.2666806570355,9.65931186839349,0.480781931615449,31
"9107","RJ","Sumidouro",15667,28758.27,33007,"Nova Friburgo",3,"Sudeste",0,"330570",4,23,15,8,10,13,0,0,0,0,0,23,15,8,10,13,6,10.2666806570355,9.65931186839349,0.535500309097708,30
"9108","RJ","Sumidouro",15667,28758.27,33007,"Nova Friburgo",3,"Sudeste",0,"330570",5,13,7,6,5,8,0,0,0,0,0,13,7,6,5,8,15,10.2666806570355,9.65931186839349,0.507922766757753,31
"9109","RJ","Tanguá",34610,16249.55,33018,"Rio de Janeiro",3,"Sudeste",1,"330575",2,35,12,23,13,22,1,0,1,1,0,36,12,24,14,22,25,9.69582049506675,10.4518979366294,0.309351514046782,29
"9110","RJ","Tanguá",34610,16249.55,33018,"Rio de Janeiro",3,"Sudeste",1,"330575",3,42,13,29,16,26,0,0,0,0,0,42,13,29,16,26,19,9.69582049506675,10.4518979366294,0.414254869405995,31
"9111","RJ","Tanguá",34610,16249.55,33018,"Rio de Janeiro",3,"Sudeste",1,"330575",4,33,13,20,16,17,1,0,1,1,0,34,13,21,17,17,21,9.69582049506675,10.4518979366294,0.471407210405351,30
"9112","RJ","Tanguá",34610,16249.55,33018,"Rio de Janeiro",3,"Sudeste",1,"330575",5,41,14,27,18,23,2,2,0,1,1,43,16,27,19,24,40,9.69582049506675,10.4518979366294,0.4503135699,31
"9113","RJ","Teresópolis",184240,28503.62,33015,"Serrana",3,"Sudeste",1,"330580",2,173,41,132,58,115,1,0,1,0,1,174,41,133,58,116,97,10.2577863757346,12.1239945344946,0.313907379927712,29
"9114","RJ","Teresópolis",184240,28503.62,33015,"Serrana",3,"Sudeste",1,"330580",3,180,57,123,67,113,0,0,0,0,0,180,57,123,67,113,117,10.2577863757346,12.1239945344946,0.423841297166081,31
"9115","RJ","Teresópolis",184240,28503.62,33015,"Serrana",3,"Sudeste",1,"330580",4,145,45,100,62,83,3,1,2,1,2,148,46,102,63,85,111,10.2577863757346,12.1239945344946,0.494195529258969,30
"9116","RJ","Teresópolis",184240,28503.62,33015,"Serrana",3,"Sudeste",1,"330580",5,140,42,98,46,94,2,2,0,2,0,142,44,98,48,94,148,10.2577863757346,12.1239945344946,0.492556550641512,31
"9117","RJ","Três Rios",82142,48575.26,33005,"Três Rios",3,"Sudeste",1,"330600",2,61,13,48,21,40,1,0,1,1,0,62,13,49,22,40,57,10.7908696267789,11.3162047358871,0.326808196236245,29
"9118","RJ","Três Rios",82142,48575.26,33005,"Três Rios",3,"Sudeste",1,"330600",3,82,21,61,33,49,3,1,2,2,1,85,22,63,35,50,66,10.7908696267789,11.3162047358871,0.432498297672477,31
"9119","RJ","Três Rios",82142,48575.26,33005,"Três Rios",3,"Sudeste",1,"330600",4,84,29,55,34,50,1,1,0,1,0,85,30,55,35,50,41,10.7908696267789,11.3162047358871,0.487799179206972,30
"9120","RJ","Três Rios",82142,48575.26,33005,"Três Rios",3,"Sudeste",1,"330600",5,82,31,51,32,50,0,0,0,0,0,82,31,51,32,50,70,10.7908696267789,11.3162047358871,0.453580154684486,31
"9121","RJ","Valença",76869,33675.61,33012,"Barra do Piraí",3,"Sudeste",1,"330610",2,52,21,31,24,28,0,0,0,0,0,52,21,31,24,28,59,10.4245291154426,11.2498579532824,0.326476157238412,29
"9122","RJ","Valença",76869,33675.61,33012,"Barra do Piraí",3,"Sudeste",1,"330610",3,55,11,44,21,34,1,0,1,1,0,56,11,45,22,34,54,10.4245291154426,11.2498579532824,0.430306200213877,31
"9123","RJ","Valença",76869,33675.61,33012,"Barra do Piraí",3,"Sudeste",1,"330610",4,60,12,48,26,34,0,0,0,0,0,60,12,48,26,34,52,10.4245291154426,11.2498579532824,0.488112313598349,30
"9124","RJ","Valença",76869,33675.61,33012,"Barra do Piraí",3,"Sudeste",1,"330610",5,60,17,43,33,27,0,0,0,0,0,60,17,43,33,27,68,10.4245291154426,11.2498579532824,0.467941296650784,31
"9125","RJ","Vassouras",37083,26624.86,33014,"Vassouras",3,"Sudeste",0,"330620",2,38,11,27,15,23,0,0,0,0,0,38,11,27,15,23,23,10.1896006447819,10.5209139225559,0.317586532582632,29
"9126","RJ","Vassouras",37083,26624.86,33014,"Vassouras",3,"Sudeste",0,"330620",3,38,10,28,14,24,1,0,1,0,1,39,10,29,14,25,21,10.1896006447819,10.5209139225559,0.432682655541565,31
"9127","RJ","Vassouras",37083,26624.86,33014,"Vassouras",3,"Sudeste",0,"330620",4,33,9,24,17,16,0,0,0,0,0,33,9,24,17,16,24,10.1896006447819,10.5209139225559,0.492222162357808,30
"9128","RJ","Vassouras",37083,26624.86,33014,"Vassouras",3,"Sudeste",0,"330620",5,51,15,36,21,30,2,1,1,0,2,53,16,37,21,32,40,10.1896006447819,10.5209139225559,0.464633614346738,31
"9129","RJ","Volta Redonda",273988,50606.58,33011,"Vale do Paraíba Fluminense",3,"Sudeste",1,"330630",2,197,37,160,58,139,1,1,0,0,1,198,38,160,58,140,197,10.8318368863468,12.5208395887907,0.301948480375674,29
"9130","RJ","Volta Redonda",273988,50606.58,33011,"Vale do Paraíba Fluminense",3,"Sudeste",1,"330630",3,211,51,160,62,149,1,0,1,0,1,212,51,161,62,150,205,10.8318368863468,12.5208395887907,0.421275859845469,31
"9131","RJ","Volta Redonda",273988,50606.58,33011,"Vale do Paraíba Fluminense",3,"Sudeste",1,"330630",4,169,36,133,60,109,2,0,2,2,0,171,36,135,62,109,198,10.8318368863468,12.5208395887907,0.506966992398053,30
"9132","RJ","Volta Redonda",273988,50606.58,33011,"Vale do Paraíba Fluminense",3,"Sudeste",1,"330630",5,221,49,172,71,150,0,0,0,0,0,221,49,172,71,150,235,10.8318368863468,12.5208395887907,0.456034591543692,31
"9133","SP","Adamantina",35111,30962.66,35035,"Adamantina",3,"Sudeste",1,"350010",2,29,6,23,8,21,0,0,0,0,0,29,6,23,8,21,22,10.3405372413256,10.4662697506709,0.285892827327684,29
"9134","SP","Adamantina",35111,30962.66,35035,"Adamantina",3,"Sudeste",1,"350010",3,45,5,40,16,29,0,0,0,0,0,45,5,40,16,29,23,10.3405372413256,10.4662697506709,0.375560322623394,31
"9135","SP","Adamantina",35111,30962.66,35035,"Adamantina",3,"Sudeste",1,"350010",4,31,5,26,8,23,0,0,0,0,0,31,5,26,8,23,21,10.3405372413256,10.4662697506709,0.412273907419282,30
"9136","SP","Adamantina",35111,30962.66,35035,"Adamantina",3,"Sudeste",1,"350010",5,35,7,28,12,23,0,0,0,0,0,35,7,28,12,23,25,10.3405372413256,10.4662697506709,0.385233827594624,31
"9137","SP","Adolfo",3554,25867.75,35004,"São José do Rio Preto",3,"Sudeste",0,"350020",2,2,1,1,0,2,0,0,0,0,0,2,1,1,0,2,3,10.1607522980695,8.1758290087146,0.314795498275409,29
"9138","SP","Adolfo",3554,25867.75,35004,"São José do Rio Preto",3,"Sudeste",0,"350020",3,4,0,4,1,3,0,0,0,0,0,4,0,4,1,3,0,10.1607522980695,8.1758290087146,0.380051300855474,31
"9139","SP","Adolfo",3554,25867.75,35004,"São José do Rio Preto",3,"Sudeste",0,"350020",4,4,0,4,1,3,0,0,0,0,0,4,0,4,1,3,2,10.1607522980695,8.1758290087146,0.412221075765828,30
"9140","SP","Adolfo",3554,25867.75,35004,"São José do Rio Preto",3,"Sudeste",0,"350020",5,9,0,9,2,7,0,0,0,0,0,9,0,9,2,7,1,10.1607522980695,8.1758290087146,0.417563100655585,31
"9141","SP","Aguaí",36648,28041.03,35029,"Pirassununga",3,"Sudeste",1,"350030",2,25,9,16,9,16,1,0,1,0,1,26,9,17,9,17,20,10.2414240737121,10.5091141355666,0.320115183457376,29
"9142","SP","Aguaí",36648,28041.03,35029,"Pirassununga",3,"Sudeste",1,"350030",3,29,13,16,9,20,0,0,0,0,0,29,13,16,9,20,23,10.2414240737121,10.5091141355666,0.398288033552511,31
"9143","SP","Aguaí",36648,28041.03,35029,"Pirassununga",3,"Sudeste",1,"350030",4,26,10,16,11,15,0,0,0,0,0,26,10,16,11,15,19,10.2414240737121,10.5091141355666,0.447323948642965,30
"9144","SP","Aguaí",36648,28041.03,35029,"Pirassununga",3,"Sudeste",1,"350030",5,33,12,21,11,22,0,0,0,0,0,33,12,21,11,22,21,10.2414240737121,10.5091141355666,0.416598793219898,31
"9145","SP","Águas da Prata",8221,20683.88,35030,"São João da Boa Vista",3,"Sudeste",1,"350040",2,3,2,1,0,3,0,0,0,0,0,3,2,1,0,3,5,9.93710993191352,9.01444713515213,0.349662968300654,29
"9146","SP","Águas da Prata",8221,20683.88,35030,"São João da Boa Vista",3,"Sudeste",1,"350040",3,4,0,4,2,2,0,0,0,0,0,4,0,4,2,2,4,9.93710993191352,9.01444713515213,0.436290161093114,31
"9147","SP","Águas da Prata",8221,20683.88,35030,"São João da Boa Vista",3,"Sudeste",1,"350040",4,4,1,3,0,4,0,0,0,0,0,4,1,3,0,4,3,9.93710993191352,9.01444713515213,0.465495417744342,30
"9148","SP","Águas da Prata",8221,20683.88,35030,"São João da Boa Vista",3,"Sudeste",1,"350040",5,7,0,7,3,4,0,0,0,0,0,7,0,7,3,4,6,9.93710993191352,9.01444713515213,0.440427348829124,31
"9149","SP","Águas de Lindóia",18808,26427.34,35033,"Amparo",3,"Sudeste",0,"350050",2,17,5,12,5,12,0,0,0,0,0,17,5,12,5,12,16,10.182154359325,9.84203759021991,0.305094583332865,29
"9150","SP","Águas de Lindóia",18808,26427.34,35033,"Amparo",3,"Sudeste",0,"350050",3,18,4,14,5,13,0,0,0,0,0,18,4,14,5,13,13,10.182154359325,9.84203759021991,0.417636589662645,31
"9151","SP","Águas de Lindóia",18808,26427.34,35033,"Amparo",3,"Sudeste",0,"350050",4,9,3,6,3,6,0,0,0,0,0,9,3,6,3,6,16,10.182154359325,9.84203759021991,0.500528884505245,30
"9152","SP","Águas de Lindóia",18808,26427.34,35033,"Amparo",3,"Sudeste",0,"350050",5,23,7,16,7,16,0,0,0,0,0,23,7,16,7,16,14,10.182154359325,9.84203759021991,0.444688699487201,31
"9153","SP","Águas de Santa Bárbara",6109,27620.94,35022,"Avaré",3,"Sudeste",0,"350055",2,8,0,8,4,4,0,0,0,0,0,8,0,8,4,4,2,10.2263294596934,8.71751837264977,0.312770808085817,29
"9154","SP","Águas de Santa Bárbara",6109,27620.94,35022,"Avaré",3,"Sudeste",0,"350055",3,5,0,5,1,4,0,0,0,0,0,5,0,5,1,4,3,10.2263294596934,8.71751837264977,0.414013982122477,31
"9155","SP","Águas de Santa Bárbara",6109,27620.94,35022,"Avaré",3,"Sudeste",0,"350055",4,6,0,6,4,2,0,0,0,0,0,6,0,6,4,2,4,10.2263294596934,8.71751837264977,0.466199711792634,30
"9156","SP","Águas de Santa Bárbara",6109,27620.94,35022,"Avaré",3,"Sudeste",0,"350055",5,9,1,8,2,7,0,0,0,0,0,9,1,8,2,7,3,10.2263294596934,8.71751837264977,0.448817544747207,31
"9157","SP","Águas de São Pedro",3521,40220.9,35028,"Piracicaba",3,"Sudeste",0,"350060",2,4,0,4,1,3,0,0,0,0,0,4,0,4,1,3,3,10.6021420400032,8.16650031915505,0.285225310794901,29
"9158","SP","Águas de São Pedro",3521,40220.9,35028,"Piracicaba",3,"Sudeste",0,"350060",3,2,0,2,2,0,0,0,0,0,0,2,0,2,2,0,2,10.6021420400032,8.16650031915505,0.411874593933548,31
"9159","SP","Águas de São Pedro",3521,40220.9,35028,"Piracicaba",3,"Sudeste",0,"350060",4,3,0,3,1,2,0,0,0,0,0,3,0,3,1,2,2,10.6021420400032,8.16650031915505,0.523679832883359,30
"9160","SP","Águas de São Pedro",3521,40220.9,35028,"Piracicaba",3,"Sudeste",0,"350060",5,2,1,1,0,2,0,0,0,0,0,2,1,1,0,2,2,10.6021420400032,8.16650031915505,0.471394995962706,31
"9161","SP","Agudos",37401,59513.01,35020,"Bauru",3,"Sudeste",1,"350070",2,34,8,26,11,23,0,0,0,0,0,34,8,26,11,23,20,10.9939502230943,10.5294527210131,0.30138177499537,29
"9162","SP","Agudos",37401,59513.01,35020,"Bauru",3,"Sudeste",1,"350070",3,48,15,33,14,34,0,0,0,0,0,48,15,33,14,34,19,10.9939502230943,10.5294527210131,0.375326287909715,31
"9163","SP","Agudos",37401,59513.01,35020,"Bauru",3,"Sudeste",1,"350070",4,31,9,22,14,17,0,0,0,0,0,31,9,22,14,17,24,10.9939502230943,10.5294527210131,0.428069335319837,30
"9164","SP","Agudos",37401,59513.01,35020,"Bauru",3,"Sudeste",1,"350070",5,50,10,40,17,33,0,0,0,0,0,50,10,40,17,33,22,10.9939502230943,10.5294527210131,0.392999198184968,31
"9165","SP","Alambari",6129,16981.63,35042,"Itapetininga",3,"Sudeste",1,"350075",2,2,0,2,0,2,0,0,0,0,0,2,0,2,0,2,0,9.73988745054666,8.72078688348573,0.310065461504422,29
"9166","SP","Alambari",6129,16981.63,35042,"Itapetininga",3,"Sudeste",1,"350075",3,1,0,1,1,0,0,0,0,0,0,1,0,1,1,0,5,9.73988745054666,8.72078688348573,0.422607172237107,31
"9167","SP","Alambari",6129,16981.63,35042,"Itapetininga",3,"Sudeste",1,"350075",4,5,3,2,1,4,0,0,0,0,0,5,3,2,1,4,4,9.73988745054666,8.72078688348573,0.461839790456766,30
"9168","SP","Alambari",6129,16981.63,35042,"Itapetininga",3,"Sudeste",1,"350075",5,10,2,8,4,6,0,0,0,0,0,10,2,8,4,6,2,9.73988745054666,8.72078688348573,0.405415763316388,31
"9169","SP","Alfredo Marcondes",4184,20104.35,35036,"Presidente Prudente",3,"Sudeste",1,"350080",2,5,0,5,2,3,0,0,0,0,0,5,0,5,2,3,2,9.90869148854264,8.33902300574476,0.293834121563739,29
"9170","SP","Alfredo Marcondes",4184,20104.35,35036,"Presidente Prudente",3,"Sudeste",1,"350080",3,4,1,3,3,1,0,0,0,0,0,4,1,3,3,1,4,9.90869148854264,8.33902300574476,0.374870388097527,31
"9171","SP","Alfredo Marcondes",4184,20104.35,35036,"Presidente Prudente",3,"Sudeste",1,"350080",4,5,0,5,1,4,0,0,0,0,0,5,0,5,1,4,6,9.90869148854264,8.33902300574476,0.400805741246294,30
"9172","SP","Alfredo Marcondes",4184,20104.35,35036,"Presidente Prudente",3,"Sudeste",1,"350080",5,9,1,8,1,8,0,0,0,0,0,9,1,8,1,8,2,9.90869148854264,8.33902300574476,0.399111084836391,31
"9173","SP","Altair",4186,25842.48,35004,"São José do Rio Preto",3,"Sudeste",0,"350090",2,2,1,1,1,1,0,0,0,0,0,2,1,1,1,1,0,10.1597749285234,8.33950090300594,0.305794130833296,29
"9174","SP","Altair",4186,25842.48,35004,"São José do Rio Preto",3,"Sudeste",0,"350090",3,0,0,0,0,0,0,0,0,0,0,0,0,0,0,0,3,10.1597749285234,8.33950090300594,0.37926174255205,31
"9175","SP","Altair",4186,25842.48,35004,"São José do Rio Preto",3,"Sudeste",0,"350090",4,1,0,1,1,0,0,0,0,0,0,1,0,1,1,0,2,10.1597749285234,8.33950090300594,0.391160910733788,30
"9176","SP","Altair",4186,25842.48,35004,"São José do Rio Preto",3,"Sudeste",0,"350090",5,1,0,1,0,1,0,0,0,0,0,1,0,1,0,1,2,10.1597749285234,8.33950090300594,0.398116781673797,31
"9177","SP","Altinópolis",16203,30792.08,35015,"Batatais",3,"Sudeste",1,"350100",2,10,5,5,2,8,0,0,0,0,0,10,5,5,2,8,7,10.3350127930376,9.692951689261,0.301358686417736,29
"9178","SP","Altinópolis",16203,30792.08,35015,"Batatais",3,"Sudeste",1,"350100",3,11,1,10,5,6,0,0,0,0,0,11,1,10,5,6,9,10.3350127930376,9.692951689261,0.375012759999679,31
"9179","SP","Altinópolis",16203,30792.08,35015,"Batatais",3,"Sudeste",1,"350100",4,10,1,9,2,8,0,0,0,0,0,10,1,9,2,8,13,10.3350127930376,9.692951689261,0.407224417250085,30
"9180","SP","Altinópolis",16203,30792.08,35015,"Batatais",3,"Sudeste",1,"350100",5,19,7,12,8,11,1,0,1,1,0,20,7,13,9,11,8,10.3350127930376,9.692951689261,0.380608281423269,31
"9181","SP","Alumínio",18767,113887.93,35046,"Sorocaba",3,"Sudeste",1,"350115",2,11,0,11,2,9,0,0,0,0,0,11,0,11,2,9,6,11.6429701736708,9.83985528729127,0.317915507807581,29
"9182","SP","Alumínio",18767,113887.93,35046,"Sorocaba",3,"Sudeste",1,"350115",3,29,3,26,9,20,0,0,0,0,0,29,3,26,9,20,8,11.6429701736708,9.83985528729127,0.406057270781013,31
"9183","SP","Alumínio",18767,113887.93,35046,"Sorocaba",3,"Sudeste",1,"350115",4,17,1,16,5,12,0,0,0,0,0,17,1,16,5,12,9,11.6429701736708,9.83985528729127,0.474214544498362,30
"9184","SP","Alumínio",18767,113887.93,35046,"Sorocaba",3,"Sudeste",1,"350115",5,17,1,16,7,10,2,1,1,1,1,19,2,17,8,11,8,11.6429701736708,9.83985528729127,0.436420391161825,31
"9185","SP","Álvares Machado",24998,21374.06,35036,"Presidente Prudente",3,"Sudeste",1,"350130",2,20,3,17,8,12,2,0,2,0,2,22,3,19,8,14,19,9.96993331622977,10.1265511006502,0.28825292757747,29
"9186","SP","Álvares Machado",24998,21374.06,35036,"Presidente Prudente",3,"Sudeste",1,"350130",3,19,5,14,5,14,0,0,0,0,0,19,5,14,5,14,13,9.96993331622977,10.1265511006502,0.383849551138077,31
"9187","SP","Álvares Machado",24998,21374.06,35036,"Presidente Prudente",3,"Sudeste",1,"350130",4,36,1,35,8,28,0,0,0,0,0,36,1,35,8,28,19,9.96993331622977,10.1265511006502,0.434002044777181,30
"9188","SP","Álvares Machado",24998,21374.06,35036,"Presidente Prudente",3,"Sudeste",1,"350130",5,22,4,18,8,14,0,0,0,0,0,22,4,18,8,14,20,9.96993331622977,10.1265511006502,0.405369614359149,31
"9189","SP","Americana",242018,47793.48,35032,"Campinas",3,"Sudeste",1,"350160",2,178,22,156,41,137,1,0,1,0,1,179,22,157,41,138,127,10.7746445075024,12.396767382538,0.280081638192556,29
"9190","SP","Americana",242018,47793.48,35032,"Campinas",3,"Sudeste",1,"350160",3,162,9,153,38,124,2,0,2,0,2,164,9,155,38,126,142,10.7746445075024,12.396767382538,0.381406317483989,31
"9191","SP","Americana",242018,47793.48,35032,"Campinas",3,"Sudeste",1,"350160",4,178,16,162,47,131,1,0,1,0,1,179,16,163,47,132,107,10.7746445075024,12.396767382538,0.451075208243716,30
"9192","SP","Americana",242018,47793.48,35032,"Campinas",3,"Sudeste",1,"350160",5,216,30,186,59,157,0,0,0,0,0,216,30,186,59,157,125,10.7746445075024,12.396767382538,0.405261210966345,31
"9193","SP","Américo Brasiliense",41032,24008.7,35024,"Araraquara",3,"Sudeste",1,"350170",2,33,2,31,11,22,0,0,0,0,0,33,2,31,11,22,19,10.0861715436428,10.6221075290691,0.313063936216966,29
"9194","SP","Américo Brasiliense",41032,24008.7,35024,"Araraquara",3,"Sudeste",1,"350170",3,25,4,21,11,14,1,1,0,1,0,26,5,21,12,14,18,10.0861715436428,10.6221075290691,0.387855358628848,31
"9195","SP","Américo Brasiliense",41032,24008.7,35024,"Araraquara",3,"Sudeste",1,"350170",4,31,8,23,13,18,0,0,0,0,0,31,8,23,13,18,17,10.0861715436428,10.6221075290691,0.433945642106823,30
"9196","SP","Américo Brasiliense",41032,24008.7,35024,"Araraquara",3,"Sudeste",1,"350170",5,35,4,31,11,24,0,0,0,0,0,35,4,31,11,24,21,10.0861715436428,10.6221075290691,0.415928914213177,31
"9197","SP","Américo de Campos",5981,19767.04,35003,"Votuporanga",3,"Sudeste",0,"350180",2,7,3,4,4,3,0,0,0,0,0,7,3,4,4,3,2,9.89177118315453,8.69634305704456,0.270886812303985,29
"9198","SP","Américo de Campos",5981,19767.04,35003,"Votuporanga",3,"Sudeste",0,"350180",3,4,0,4,3,1,0,0,0,0,0,4,0,4,3,1,2,9.89177118315453,8.69634305704456,0.313949017038506,31
"9199","SP","Américo de Campos",5981,19767.04,35003,"Votuporanga",3,"Sudeste",0,"350180",4,2,1,1,0,2,0,0,0,0,0,2,1,1,0,2,1,9.89177118315453,8.69634305704456,0.358880116981532,30
"9200","SP","Américo de Campos",5981,19767.04,35003,"Votuporanga",3,"Sudeste",0,"350180",5,2,0,2,1,1,0,0,0,0,0,2,0,2,1,1,5,9.89177118315453,8.69634305704456,0.353274827974052,31
"9201","SP","Amparo",72677,64804.88,35033,"Amparo",3,"Sudeste",1,"350190",2,71,7,64,25,46,0,0,0,0,0,71,7,64,25,46,42,11.0791361881468,11.1937802448283,0.285596055459308,29
"9202","SP","Amparo",72677,64804.88,35033,"Amparo",3,"Sudeste",1,"350190",3,62,8,54,27,35,0,0,0,0,0,62,8,54,27,35,47,11.0791361881468,11.1937802448283,0.383209715231181,31
"9203","SP","Amparo",72677,64804.88,35033,"Amparo",3,"Sudeste",1,"350190",4,57,7,50,25,32,1,0,1,0,1,58,7,51,25,33,49,11.0791361881468,11.1937802448283,0.440881158550767,30
"9204","SP","Amparo",72677,64804.88,35033,"Amparo",3,"Sudeste",1,"350190",5,76,10,66,26,50,0,0,0,0,0,76,10,66,26,50,44,11.0791361881468,11.1937802448283,0.406473964108057,31
"9205","SP","Analândia",5056,37298.53,35025,"São Carlos",3,"Sudeste",0,"350200",2,4,2,2,0,4,0,0,0,0,0,4,2,2,0,4,0,10.5267091946676,8.52833093582669,0.257511147535471,29
"9206","SP","Analândia",5056,37298.53,35025,"São Carlos",3,"Sudeste",0,"350200",3,3,2,1,1,2,0,0,0,0,0,3,2,1,1,2,3,10.5267091946676,8.52833093582669,0.333117461198195,31
"9207","SP","Analândia",5056,37298.53,35025,"São Carlos",3,"Sudeste",0,"350200",4,5,2,3,4,1,0,0,0,0,0,5,2,3,4,1,2,10.5267091946676,8.52833093582669,0.438555660072974,30
"9208","SP","Analândia",5056,37298.53,35025,"São Carlos",3,"Sudeste",0,"350200",5,6,0,6,0,6,0,0,0,0,0,6,0,6,0,6,1,10.5267091946676,8.52833093582669,0.439842061451041,31
"9209","SP","Andradina",57202,33661.69,35016,"Andradina",3,"Sudeste",1,"350210",2,34,3,31,12,22,0,0,0,0,0,34,3,31,12,22,43,10.4241156744464,10.9543441417916,0.300566496318223,29
"9210","SP","Andradina",57202,33661.69,35016,"Andradina",3,"Sudeste",1,"350210",3,52,2,50,18,34,0,0,0,0,0,52,2,50,18,34,49,10.4241156744464,10.9543441417916,0.388020912471669,31
"9211","SP","Andradina",57202,33661.69,35016,"Andradina",3,"Sudeste",1,"350210",4,58,6,52,18,40,0,0,0,0,0,58,6,52,18,40,45,10.4241156744464,10.9543441417916,0.431032615129155,30
"9212","SP","Andradina",57202,33661.69,35016,"Andradina",3,"Sudeste",1,"350210",5,57,5,52,16,41,1,0,1,1,0,58,5,53,17,41,45,10.4241156744464,10.9543441417916,0.404704462196383,31
"9213","SP","Angatuba",25479,40386.56,35042,"Itapetininga",3,"Sudeste",0,"350220",2,26,9,17,7,19,0,0,0,0,0,26,9,17,7,19,11,10.6062523353339,10.1456098624481,0.32622812624094,29
"9214","SP","Angatuba",25479,40386.56,35042,"Itapetininga",3,"Sudeste",0,"350220",3,33,12,21,13,20,1,0,1,0,1,34,12,22,13,21,20,10.6062523353339,10.1456098624481,0.424261817560676,31
"9215","SP","Angatuba",25479,40386.56,35042,"Itapetininga",3,"Sudeste",0,"350220",4,30,9,21,11,19,1,1,0,0,1,31,10,21,11,20,7,10.6062523353339,10.1456098624481,0.450173930878411,30
"9216","SP","Angatuba",25479,40386.56,35042,"Itapetininga",3,"Sudeste",0,"350220",5,31,10,21,12,19,0,0,0,0,0,31,10,21,12,19,16,10.6062523353339,10.1456098624481,0.429414314282975,31
"9217","SP","Anhumas",4144,18317.06,35036,"Presidente Prudente",3,"Sudeste",1,"350240",2,3,0,3,2,1,0,0,0,0,0,3,0,3,2,1,5,9.81558814500043,8.32941678393932,0.283681585053031,29
"9218","SP","Anhumas",4144,18317.06,35036,"Presidente Prudente",3,"Sudeste",1,"350240",3,5,2,3,3,2,0,0,0,0,0,5,2,3,3,2,0,9.81558814500043,8.32941678393932,0.394424093164388,31
"9219","SP","Anhumas",4144,18317.06,35036,"Presidente Prudente",3,"Sudeste",1,"350240",4,6,0,6,3,3,0,0,0,0,0,6,0,6,3,3,2,9.81558814500043,8.32941678393932,0.461207762350891,30
"9220","SP","Anhumas",4144,18317.06,35036,"Presidente Prudente",3,"Sudeste",1,"350240",5,4,1,3,4,0,0,0,0,0,0,4,1,3,4,0,1,9.81558814500043,8.32941678393932,0.413029400021206,31
"9221","SP","Aparecida",36185,29969.65,35051,"Guaratinguetá",3,"Sudeste",1,"350250",2,24,4,20,4,20,0,0,0,0,0,24,4,20,4,20,29,10.3079404818975,10.4963999473002,0.304551299599148,29
"9222","SP","Aparecida",36185,29969.65,35051,"Guaratinguetá",3,"Sudeste",1,"350250",3,39,9,30,11,28,0,0,0,0,0,39,9,30,11,28,21,10.3079404818975,10.4963999473002,0.425374035317168,31
"9223","SP","Aparecida",36185,29969.65,35051,"Guaratinguetá",3,"Sudeste",1,"350250",4,28,6,22,7,21,0,0,0,0,0,28,6,22,7,21,18,10.3079404818975,10.4963999473002,0.480858744909323,30
"9224","SP","Aparecida",36185,29969.65,35051,"Guaratinguetá",3,"Sudeste",1,"350250",5,32,3,29,17,15,0,0,0,0,0,32,3,29,17,15,22,10.3079404818975,10.4963999473002,0.453552681268256,31
"9225","SP","Apiaí",24226,24247.23,35044,"Capão Bonito",3,"Sudeste",0,"350270",2,30,5,25,12,18,0,0,0,0,0,30,5,25,12,18,15,10.0960576630371,10.0951817155767,0.332448063503328,29
"9226","SP","Apiaí",24226,24247.23,35044,"Capão Bonito",3,"Sudeste",0,"350270",3,32,6,26,12,20,0,0,0,0,0,32,6,26,12,20,16,10.0960576630371,10.0951817155767,0.402498315980523,31
"9227","SP","Apiaí",24226,24247.23,35044,"Capão Bonito",3,"Sudeste",0,"350270",4,25,3,22,8,17,0,0,0,0,0,25,3,22,8,17,12,10.0960576630371,10.0951817155767,0.458105944782827,30
"9228","SP","Apiaí",24226,24247.23,35044,"Capão Bonito",3,"Sudeste",0,"350270",5,20,8,12,11,9,0,0,0,0,0,20,8,12,11,9,14,10.0960576630371,10.0951817155767,0.415216403513239,31
"9229","SP","Araçariguama",22860,149668.66,35046,"Sorocaba",3,"Sudeste",0,"350275",2,27,5,22,12,15,0,0,0,0,0,27,5,22,12,15,9,11.9161791964531,10.0371439373488,0.301327264865037,29
"9230","SP","Araçariguama",22860,149668.66,35046,"Sorocaba",3,"Sudeste",0,"350275",3,30,10,20,9,21,0,0,0,0,0,30,10,20,9,21,8,11.9161791964531,10.0371439373488,0.386908769141114,31
"9231","SP","Araçariguama",22860,149668.66,35046,"Sorocaba",3,"Sudeste",0,"350275",4,18,4,14,9,9,0,0,0,0,0,18,4,14,9,9,11,11.9161791964531,10.0371439373488,0.430852723792965,30
"9232","SP","Araçariguama",22860,149668.66,35046,"Sorocaba",3,"Sudeste",0,"350275",5,21,7,14,8,13,0,0,0,0,0,21,7,14,8,13,8,11.9161791964531,10.0371439373488,0.417301531273853,31
"9233","SP","Araçatuba",198129,37521.17,35017,"Araçatuba",3,"Sudeste",1,"350280",2,166,21,145,52,114,2,0,2,1,1,168,21,147,53,115,109,10.5326605860028,12.1966736126843,0.280669555950814,29
"9234","SP","Araçatuba",198129,37521.17,35017,"Araçatuba",3,"Sudeste",1,"350280",3,185,24,161,55,130,2,0,2,0,2,187,24,163,55,132,139,10.5326605860028,12.1966736126843,0.374206517342691,31
"9235","SP","Araçatuba",198129,37521.17,35017,"Araçatuba",3,"Sudeste",1,"350280",4,178,19,159,63,115,2,0,2,0,2,180,19,161,63,117,130,10.5326605860028,12.1966736126843,0.429416209838149,30
"9236","SP","Araçatuba",198129,37521.17,35017,"Araçatuba",3,"Sudeste",1,"350280",5,168,24,144,56,112,0,0,0,0,0,168,24,144,56,112,149,10.5326605860028,12.1966736126843,0.392265270118208,31
"9237","SP","Araçoiaba da Serra",34776,25731.56,35046,"Sorocaba",3,"Sudeste",1,"350290",2,35,5,30,13,22,0,0,0,0,0,35,5,30,13,22,19,10.1554735330531,10.4566827726686,0.303414480286802,29
"9238","SP","Araçoiaba da Serra",34776,25731.56,35046,"Sorocaba",3,"Sudeste",1,"350290",3,31,4,27,12,19,1,0,1,0,1,32,4,28,12,20,22,10.1554735330531,10.4566827726686,0.403567092494069,31
"9239","SP","Araçoiaba da Serra",34776,25731.56,35046,"Sorocaba",3,"Sudeste",1,"350290",4,27,5,22,10,17,0,0,0,0,0,27,5,22,10,17,12,10.1554735330531,10.4566827726686,0.46560286578841,30
"9240","SP","Araçoiaba da Serra",34776,25731.56,35046,"Sorocaba",3,"Sudeste",1,"350290",5,37,4,33,15,22,0,0,0,0,0,37,4,33,15,22,27,10.1554735330531,10.4566827726686,0.425596237688983,31
"9241","SP","Aramina",5655,22669.33,35011,"Ituverava",3,"Sudeste",0,"350300",2,5,0,5,1,4,0,0,0,0,0,5,0,5,1,4,5,10.0287681885876,8.64029538855022,0.356529940365121,29
"9242","SP","Aramina",5655,22669.33,35011,"Ituverava",3,"Sudeste",0,"350300",3,6,2,4,2,4,0,0,0,0,0,6,2,4,2,4,4,10.0287681885876,8.64029538855022,0.408464592116552,31
"9243","SP","Aramina",5655,22669.33,35011,"Ituverava",3,"Sudeste",0,"350300",4,2,0,2,0,2,0,0,0,0,0,2,0,2,0,2,4,10.0287681885876,8.64029538855022,0.403740745749486,30
"9244","SP","Aramina",5655,22669.33,35011,"Ituverava",3,"Sudeste",0,"350300",5,5,1,4,2,3,0,0,0,0,0,5,1,4,2,3,4,10.0287681885876,8.64029538855022,0.388817457766245,31
"9245","SP","Araraquara",238339,40253.93,35024,"Araraquara",3,"Sudeste",1,"350320",2,210,31,179,48,162,2,1,1,1,1,212,32,180,49,163,135,10.6029629178318,12.3814493089492,0.298484642294555,29
"9246","SP","Araraquara",238339,40253.93,35024,"Araraquara",3,"Sudeste",1,"350320",3,202,28,174,53,149,2,0,2,0,2,204,28,176,53,151,168,10.6029629178318,12.3814493089492,0.398019789260874,31
"9247","SP","Araraquara",238339,40253.93,35024,"Araraquara",3,"Sudeste",1,"350320",4,201,28,173,56,145,3,0,3,0,3,204,28,176,56,148,134,10.6029629178318,12.3814493089492,0.474534279117517,30
"9248","SP","Araraquara",238339,40253.93,35024,"Araraquara",3,"Sudeste",1,"350320",5,249,38,211,74,175,4,0,4,0,4,253,38,215,74,179,139,10.6029629178318,12.3814493089492,0.431174047891834,31
"9249","SP","Araras",135506,41863.92,35027,"Limeira",3,"Sudeste",1,"350330",2,118,22,96,40,78,1,0,1,0,1,119,22,97,40,79,73,10.6421796371005,11.8167711987643,0.294912716310675,29
"9250","SP","Araras",135506,41863.92,35027,"Limeira",3,"Sudeste",1,"350330",3,101,14,87,31,70,1,0,1,0,1,102,14,88,31,71,66,10.6421796371005,11.8167711987643,0.387406886269399,31
"9251","SP","Araras",135506,41863.92,35027,"Limeira",3,"Sudeste",1,"350330",4,113,12,101,33,80,1,0,1,0,1,114,12,102,33,81,80,10.6421796371005,11.8167711987643,0.440725051982887,30
"9252","SP","Araras",135506,41863.92,35027,"Limeira",3,"Sudeste",1,"350330",5,123,23,100,41,82,0,0,0,0,0,123,23,100,41,82,73,10.6421796371005,11.8167711987643,0.404541627600657,31
"9253","SP","Arealva",8613,27135.55,35020,"Bauru",3,"Sudeste",0,"350340",2,4,2,2,2,2,0,0,0,0,0,4,2,2,2,2,4,10.2085999553173,9.06102796878917,0.267276791152525,29
"9254","SP","Arealva",8613,27135.55,35020,"Bauru",3,"Sudeste",0,"350340",3,3,0,3,2,1,0,0,0,0,0,3,0,3,2,1,8,10.2085999553173,9.06102796878917,0.363581987919638,31
"9255","SP","Arealva",8613,27135.55,35020,"Bauru",3,"Sudeste",0,"350340",4,2,0,2,0,2,0,0,0,0,0,2,0,2,0,2,3,10.2085999553173,9.06102796878917,0.406533505329079,30
"9256","SP","Arealva",8613,27135.55,35020,"Bauru",3,"Sudeste",0,"350340",5,4,1,3,2,2,0,0,0,0,0,4,1,3,2,2,6,10.2085999553173,9.06102796878917,0.39119825967729,31
"9257","SP","Areiópolis",11158,12884.23,35020,"Bauru",3,"Sudeste",0,"350360",2,9,2,7,2,7,0,0,0,0,0,9,2,7,2,7,1,9.46375936189063,9.31991200840547,0.325765713843852,29
"9258","SP","Areiópolis",11158,12884.23,35020,"Bauru",3,"Sudeste",0,"350360",3,11,2,9,4,7,0,0,0,0,0,11,2,9,4,7,4,9.46375936189063,9.31991200840547,0.401064531738256,31
"9259","SP","Areiópolis",11158,12884.23,35020,"Bauru",3,"Sudeste",0,"350360",4,8,2,6,2,6,0,0,0,0,0,8,2,6,2,6,3,9.46375936189063,9.31991200840547,0.452227198529813,30
"9260","SP","Areiópolis",11158,12884.23,35020,"Bauru",3,"Sudeste",0,"350360",5,6,3,3,3,3,0,0,0,0,0,6,3,3,3,3,7,9.46375936189063,9.31991200840547,0.43858498849144,31
"9261","SP","Ariranha",9761,76108.12,35005,"Catanduva",3,"Sudeste",0,"350370",2,4,0,4,1,3,0,0,0,0,0,4,0,4,1,3,6,11.2399102398658,9.18615013317497,0.289134409179117,29
"9262","SP","Ariranha",9761,76108.12,35005,"Catanduva",3,"Sudeste",0,"350370",3,3,1,2,1,2,0,0,0,0,0,3,1,2,1,2,6,11.2399102398658,9.18615013317497,0.343028023566342,31
"9263","SP","Ariranha",9761,76108.12,35005,"Catanduva",3,"Sudeste",0,"350370",4,4,0,4,3,1,0,0,0,0,0,4,0,4,3,1,4,11.2399102398658,9.18615013317497,0.372124114167467,30
"9264","SP","Ariranha",9761,76108.12,35005,"Catanduva",3,"Sudeste",0,"350370",5,9,0,9,1,8,0,0,0,0,0,9,0,9,1,8,6,11.2399102398658,9.18615013317497,0.319919309989159,31
"9265","SP","Artur Nogueira",55340,22156.59,35031,"Mogi Mirim",3,"Sudeste",1,"350380",2,16,2,14,6,10,0,0,0,0,0,16,2,14,6,10,17,10.0058902481539,10.9212512533409,0.299114090897078,29
"9266","SP","Artur Nogueira",55340,22156.59,35031,"Mogi Mirim",3,"Sudeste",1,"350380",3,18,2,16,4,14,0,0,0,0,0,18,2,16,4,14,29,10.0058902481539,10.9212512533409,0.389363413752408,31
"9267","SP","Artur Nogueira",55340,22156.59,35031,"Mogi Mirim",3,"Sudeste",1,"350380",4,23,4,19,6,17,2,1,1,1,1,25,5,20,7,18,31,10.0058902481539,10.9212512533409,0.427389192765963,30
"9268","SP","Artur Nogueira",55340,22156.59,35031,"Mogi Mirim",3,"Sudeste",1,"350380",5,23,2,21,3,20,1,0,1,0,1,24,2,22,3,21,30,10.0058902481539,10.9212512533409,0.393642908243195,31
"9269","SP","Arujá",91157,69588.09,35059,"Guarulhos",3,"Sudeste",1,"350390",2,111,13,98,43,68,1,0,1,1,0,112,13,99,44,68,37,11.15034871099,11.4203385736474,0.312903778167102,29
"9270","SP","Arujá",91157,69588.09,35059,"Guarulhos",3,"Sudeste",1,"350390",3,116,13,103,36,80,2,0,2,2,0,118,13,105,38,80,40,11.15034871099,11.4203385736474,0.410495604404237,31
"9271","SP","Arujá",91157,69588.09,35059,"Guarulhos",3,"Sudeste",1,"350390",4,78,9,69,30,48,0,0,0,0,0,78,9,69,30,48,41,11.15034871099,11.4203385736474,0.478018128109578,30
"9272","SP","Arujá",91157,69588.09,35059,"Guarulhos",3,"Sudeste",1,"350390",5,131,10,121,49,82,1,0,1,0,1,132,10,122,49,83,71,11.15034871099,11.4203385736474,0.447715993797102,31
"9273","SP","Assis",105087,32443.96,35039,"Assis",3,"Sudeste",1,"350400",2,84,15,69,16,68,0,0,0,0,0,84,15,69,16,68,63,10.3872695722959,11.5625438574924,0.298051203618176,29
"9274","SP","Assis",105087,32443.96,35039,"Assis",3,"Sudeste",1,"350400",3,94,12,82,33,61,0,0,0,0,0,94,12,82,33,61,64,10.3872695722959,11.5625438574924,0.395081474191084,31
"9275","SP","Assis",105087,32443.96,35039,"Assis",3,"Sudeste",1,"350400",4,66,7,59,22,44,2,0,2,0,2,68,7,61,22,46,52,10.3872695722959,11.5625438574924,0.457154723356578,30
"9276","SP","Assis",105087,32443.96,35039,"Assis",3,"Sudeste",1,"350400",5,87,11,76,18,69,1,0,1,1,0,88,11,77,19,69,87,10.3872695722959,11.5625438574924,0.425999334948319,31
"9277","SP","Atibaia",144088,50498.62,35048,"Bragança Paulista",3,"Sudeste",1,"350410",2,139,26,113,52,87,0,0,0,0,0,139,26,113,52,87,94,10.8297012881574,11.8781795030169,0.303130055693013,29
"9278","SP","Atibaia",144088,50498.62,35048,"Bragança Paulista",3,"Sudeste",1,"350410",3,160,24,136,63,97,1,1,0,1,0,161,25,136,64,97,92,10.8297012881574,11.8781795030169,0.40468383910866,31
"9279","SP","Atibaia",144088,50498.62,35048,"Bragança Paulista",3,"Sudeste",1,"350410",4,169,30,139,53,116,1,0,1,0,1,170,30,140,53,117,82,10.8297012881574,11.8781795030169,0.475208716874262,30
"9280","SP","Atibaia",144088,50498.62,35048,"Bragança Paulista",3,"Sudeste",1,"350410",5,174,22,152,49,125,0,0,0,0,0,174,22,152,49,125,97,10.8297012881574,11.8781795030169,0.43872527221838,31
"9281","SP","Avaí",5436,50644.08,35020,"Bauru",3,"Sudeste",0,"350430",2,3,0,3,2,1,0,0,0,0,0,3,0,3,2,1,2,10.832577622293,8.60079877527103,0.313093868990664,29
"9282","SP","Avaí",5436,50644.08,35020,"Bauru",3,"Sudeste",0,"350430",3,8,1,7,2,6,0,0,0,0,0,8,1,7,2,6,3,10.832577622293,8.60079877527103,0.402433642258869,31
"9283","SP","Avaí",5436,50644.08,35020,"Bauru",3,"Sudeste",0,"350430",4,6,2,4,1,5,0,0,0,0,0,6,2,4,1,5,4,10.832577622293,8.60079877527103,0.428839915734747,30
"9284","SP","Avaí",5436,50644.08,35020,"Bauru",3,"Sudeste",0,"350430",5,7,0,7,3,4,0,0,0,0,0,7,0,7,3,4,4,10.832577622293,8.60079877527103,0.381409584135876,31
"9285","SP","Avanhandava",13859,23782.13,35018,"Birigui",3,"Sudeste",0,"350440",2,11,1,10,7,4,1,0,1,1,0,12,1,11,8,4,1,10.0766897373016,9.5366901200688,0.3155880034251,29
"9286","SP","Avanhandava",13859,23782.13,35018,"Birigui",3,"Sudeste",0,"350440",3,5,1,4,2,3,0,0,0,0,0,5,1,4,2,3,6,10.0766897373016,9.5366901200688,0.378756139028487,31
"9287","SP","Avanhandava",13859,23782.13,35018,"Birigui",3,"Sudeste",0,"350440",4,7,1,6,4,3,0,0,0,0,0,7,1,6,4,3,4,10.0766897373016,9.5366901200688,0.398892113063551,30
"9288","SP","Avanhandava",13859,23782.13,35018,"Birigui",3,"Sudeste",0,"350440",5,17,7,10,3,14,0,0,0,0,0,17,7,10,3,14,2,10.0766897373016,9.5366901200688,0.376237721376794,31
"9289","SP","Avaré",91232,30391.62,35022,"Avaré",3,"Sudeste",1,"350450",2,95,28,67,34,61,2,1,1,0,2,97,29,68,34,63,57,10.321922191499,11.4211609917124,0.302891854227786,29
"9290","SP","Avaré",91232,30391.62,35022,"Avaré",3,"Sudeste",1,"350450",3,86,12,74,34,52,1,0,1,1,0,87,12,75,35,52,61,10.321922191499,11.4211609917124,0.407102179800881,31
"9291","SP","Avaré",91232,30391.62,35022,"Avaré",3,"Sudeste",1,"350450",4,106,24,82,36,70,0,0,0,0,0,106,24,82,36,70,49,10.321922191499,11.4211609917124,0.473798231345446,30
"9292","SP","Avaré",91232,30391.62,35022,"Avaré",3,"Sudeste",1,"350450",5,104,13,91,40,64,0,0,0,0,0,104,13,91,40,64,54,10.321922191499,11.4211609917124,0.433258583088228,31
"9293","SP","Bady Bassitt",17761,20504.81,35004,"São José do Rio Preto",3,"Sudeste",1,"350460",2,25,4,21,9,16,0,0,0,0,0,25,4,21,9,16,9,9.92841477175056,9.78476032126733,0.286991910824047,29
"9294","SP","Bady Bassitt",17761,20504.81,35004,"São José do Rio Preto",3,"Sudeste",1,"350460",3,24,6,18,7,17,0,0,0,0,0,24,6,18,7,17,13,9.92841477175056,9.78476032126733,0.372172372216496,31
"9295","SP","Bady Bassitt",17761,20504.81,35004,"São José do Rio Preto",3,"Sudeste",1,"350460",4,24,5,19,5,19,0,0,0,0,0,24,5,19,5,19,15,9.92841477175056,9.78476032126733,0.413490263366061,30
"9296","SP","Bady Bassitt",17761,20504.81,35004,"São José do Rio Preto",3,"Sudeste",1,"350460",5,20,3,17,5,15,1,0,1,0,1,21,3,18,5,16,17,9.92841477175056,9.78476032126733,0.378784394275893,31
"9297","SP","Bálsamo",9139,22575.02,35004,"São José do Rio Preto",3,"Sudeste",1,"350480",2,8,2,6,4,4,0,0,0,0,0,8,2,6,4,4,3,10.0245992642206,9.1203062492722,0.276479949067265,29
"9298","SP","Bálsamo",9139,22575.02,35004,"São José do Rio Preto",3,"Sudeste",1,"350480",3,9,1,8,1,8,0,0,0,0,0,9,1,8,1,8,5,10.0245992642206,9.1203062492722,0.335250927815582,31
"9299","SP","Bálsamo",9139,22575.02,35004,"São José do Rio Preto",3,"Sudeste",1,"350480",4,5,0,5,3,2,0,0,0,0,0,5,0,5,3,2,3,10.0245992642206,9.1203062492722,0.365972039884955,30
"9300","SP","Bálsamo",9139,22575.02,35004,"São José do Rio Preto",3,"Sudeste",1,"350480",5,9,1,8,1,8,0,0,0,0,0,9,1,8,1,8,4,10.0245992642206,9.1203062492722,0.349100050200312,31
"9301","SP","Bananal",10993,16937.75,35052,"Bananal",3,"Sudeste",0,"350490",2,6,0,6,2,4,0,0,0,0,0,6,0,6,2,4,4,9.73730013766073,9.30501398557886,0.32614474736644,29
"9302","SP","Bananal",10993,16937.75,35052,"Bananal",3,"Sudeste",0,"350490",3,11,2,9,4,7,0,0,0,0,0,11,2,9,4,7,9,9.73730013766073,9.30501398557886,0.42595681672632,31
"9303","SP","Bananal",10993,16937.75,35052,"Bananal",3,"Sudeste",0,"350490",4,4,0,4,0,4,0,0,0,0,0,4,0,4,0,4,4,9.73730013766073,9.30501398557886,0.464797468081196,30
"9304","SP","Bananal",10993,16937.75,35052,"Bananal",3,"Sudeste",0,"350490",5,6,2,4,1,5,0,0,0,0,0,6,2,4,1,5,4,9.73730013766073,9.30501398557886,0.450643297140917,31
"9305","SP","Barbosa",7468,12939.48,35018,"Birigui",3,"Sudeste",0,"350510",2,3,0,3,2,1,0,0,0,0,0,3,0,3,2,1,2,9.46803838177603,8.91838250466161,0.299632172248153,29
"9306","SP","Barbosa",7468,12939.48,35018,"Birigui",3,"Sudeste",0,"350510",3,3,1,2,0,3,0,0,0,0,0,3,1,2,0,3,7,9.46803838177603,8.91838250466161,0.397350965382668,31
"9307","SP","Barbosa",7468,12939.48,35018,"Birigui",3,"Sudeste",0,"350510",4,8,2,6,4,4,0,0,0,0,0,8,2,6,4,4,3,9.46803838177603,8.91838250466161,0.407728375751699,30
"9308","SP","Barbosa",7468,12939.48,35018,"Birigui",3,"Sudeste",0,"350510",5,6,1,5,2,4,0,0,0,0,0,6,1,5,2,4,0,9.46803838177603,8.91838250466161,0.402805223744549,31
"9309","SP","Bariri",35558,33185.53,35021,"Jaú",3,"Sudeste",1,"350520",2,25,8,17,8,17,0,0,0,0,0,25,8,17,8,17,21,10.4098692165238,10.4789204450765,0.319285325024022,29
"9310","SP","Bariri",35558,33185.53,35021,"Jaú",3,"Sudeste",1,"350520",3,35,13,22,17,18,0,0,0,0,0,35,13,22,17,18,25,10.4098692165238,10.4789204450765,0.396348589646932,31
"9311","SP","Bariri",35558,33185.53,35021,"Jaú",3,"Sudeste",1,"350520",4,25,5,20,11,14,2,0,2,0,2,27,5,22,11,16,23,10.4098692165238,10.4789204450765,0.44113425988879,30
"9312","SP","Bariri",35558,33185.53,35021,"Jaú",3,"Sudeste",1,"350520",5,28,5,23,9,19,1,0,1,1,0,29,5,24,10,19,22,10.4098692165238,10.4789204450765,0.407739079780509,31
"9313","SP","Barra Bonita",36126,35500.64,35021,"Jaú",3,"Sudeste",1,"350530",2,18,2,16,3,15,0,0,0,0,0,18,2,16,3,15,17,10.47730600347,10.4947681066925,0.305167348021126,29
"9314","SP","Barra Bonita",36126,35500.64,35021,"Jaú",3,"Sudeste",1,"350530",3,18,3,15,1,17,0,0,0,0,0,18,3,15,1,17,29,10.47730600347,10.4947681066925,0.38236209819432,31
"9315","SP","Barra Bonita",36126,35500.64,35021,"Jaú",3,"Sudeste",1,"350530",4,33,5,28,6,27,0,0,0,0,0,33,5,28,6,27,29,10.47730600347,10.4947681066925,0.42410526453805,30
"9316","SP","Barra Bonita",36126,35500.64,35021,"Jaú",3,"Sudeste",1,"350530",5,29,4,25,7,22,1,0,1,0,1,30,4,26,7,23,22,10.47730600347,10.4947681066925,0.391295678626371,31
"9317","SP","Barretos",122833,40046.22,35009,"Barretos",3,"Sudeste",1,"350550",2,130,19,111,45,85,1,0,1,0,1,131,19,112,45,86,76,10.5977895660198,11.7185809882355,0.308835454545938,29
"9318","SP","Barretos",122833,40046.22,35009,"Barretos",3,"Sudeste",1,"350550",3,127,12,115,39,88,2,0,2,0,2,129,12,117,39,90,95,10.5977895660198,11.7185809882355,0.395192856961483,31
"9319","SP","Barretos",122833,40046.22,35009,"Barretos",3,"Sudeste",1,"350550",4,104,14,90,33,71,1,0,1,0,1,105,14,91,33,72,64,10.5977895660198,11.7185809882355,0.459119761072965,30
"9320","SP","Barretos",122833,40046.22,35009,"Barretos",3,"Sudeste",1,"350550",5,139,15,124,28,111,3,1,2,2,1,142,16,126,30,112,88,10.5977895660198,11.7185809882355,0.419007692575849,31
"9321","SP","Barrinha",33180,15960.29,35014,"Ribeirão Preto",3,"Sudeste",1,"350560",2,28,7,21,11,17,0,0,0,0,0,28,7,21,11,17,11,9.67785904126479,10.4097025637444,0.295722080764169,29
"9322","SP","Barrinha",33180,15960.29,35014,"Ribeirão Preto",3,"Sudeste",1,"350560",3,42,7,35,16,26,0,0,0,0,0,42,7,35,16,26,17,9.67785904126479,10.4097025637444,0.37602092095196,31
"9323","SP","Barrinha",33180,15960.29,35014,"Ribeirão Preto",3,"Sudeste",1,"350560",4,47,13,34,21,26,0,0,0,0,0,47,13,34,21,26,15,9.67785904126479,10.4097025637444,0.412808092642868,30
"9324","SP","Barrinha",33180,15960.29,35014,"Ribeirão Preto",3,"Sudeste",1,"350560",5,28,4,24,8,20,1,0,1,0,1,29,4,25,8,21,24,9.67785904126479,10.4097025637444,0.384658717475054,31
"9325","SP","Barueri",276982,186382.33,35057,"Osasco",3,"Sudeste",1,"350570",2,429,47,382,127,302,3,1,2,2,1,432,48,384,129,303,144,12.1355553806029,12.5317078011086,0.278923394585825,29
"9326","SP","Barueri",276982,186382.33,35057,"Osasco",3,"Sudeste",1,"350570",3,428,42,386,130,298,6,1,5,3,3,434,43,391,133,301,194,12.1355553806029,12.5317078011086,0.393772978721328,31
"9327","SP","Barueri",276982,186382.33,35057,"Osasco",3,"Sudeste",1,"350570",4,383,27,356,130,253,7,1,6,0,7,390,28,362,130,260,191,12.1355553806029,12.5317078011086,0.500641627875048,30
"9328","SP","Barueri",276982,186382.33,35057,"Osasco",3,"Sudeste",1,"350570",5,449,34,415,135,314,5,1,4,1,4,454,35,419,136,318,244,12.1355553806029,12.5317078011086,0.477973468778956,31
"9329","SP","Bastos",20953,45791.98,35037,"Tupã",3,"Sudeste",1,"350580",2,22,2,20,4,18,0,0,0,0,0,22,2,20,4,18,13,10.7318642455986,9.95003711318911,0.293320279793809,29
"9330","SP","Bastos",20953,45791.98,35037,"Tupã",3,"Sudeste",1,"350580",3,16,5,11,6,10,0,0,0,0,0,16,5,11,6,10,15,10.7318642455986,9.95003711318911,0.354850629768048,31
"9331","SP","Bastos",20953,45791.98,35037,"Tupã",3,"Sudeste",1,"350580",4,23,4,19,7,16,0,0,0,0,0,23,4,19,7,16,22,10.7318642455986,9.95003711318911,0.391381565063771,30
"9332","SP","Bastos",20953,45791.98,35037,"Tupã",3,"Sudeste",1,"350580",5,24,1,23,15,9,0,0,0,0,0,24,1,23,15,9,10,10.7318642455986,9.95003711318911,0.381014080577037,31
"9333","SP","Batatais",62980,25636.34,35015,"Batatais",3,"Sudeste",1,"350590",2,47,12,35,13,34,1,0,1,0,1,48,12,36,13,35,31,10.1517661551356,11.050572494655,0.296361307827424,29
"9334","SP","Batatais",62980,25636.34,35015,"Batatais",3,"Sudeste",1,"350590",3,53,8,45,17,36,1,1,0,1,0,54,9,45,18,36,37,10.1517661551356,11.050572494655,0.382572117427081,31
"9335","SP","Batatais",62980,25636.34,35015,"Batatais",3,"Sudeste",1,"350590",4,52,12,40,22,30,0,0,0,0,0,52,12,40,22,30,34,10.1517661551356,11.050572494655,0.43739222460017,30
"9336","SP","Batatais",62980,25636.34,35015,"Batatais",3,"Sudeste",1,"350590",5,70,18,52,24,46,1,0,1,0,1,71,18,53,24,47,50,10.1517661551356,11.050572494655,0.394373844104665,31
"9337","SP","Bauru",379297,39121.44,35020,"Bauru",3,"Sudeste",1,"350600",2,345,74,271,118,227,2,2,0,2,0,347,76,271,120,227,208,10.5744259332872,12.8460748183391,0.290464287875174,29
"9338","SP","Bauru",379297,39121.44,35020,"Bauru",3,"Sudeste",1,"350600",3,323,53,270,112,211,3,0,3,2,1,326,53,273,114,212,219,10.5744259332872,12.8460748183391,0.385345877222743,31
"9339","SP","Bauru",379297,39121.44,35020,"Bauru",3,"Sudeste",1,"350600",4,342,51,291,122,220,3,0,3,2,1,345,51,294,124,221,195,10.5744259332872,12.8460748183391,0.448915617353387,30
"9340","SP","Bauru",379297,39121.44,35020,"Bauru",3,"Sudeste",1,"350600",5,382,68,314,122,260,2,0,2,1,1,384,68,316,123,261,210,10.5744259332872,12.8460748183391,0.406704868083557,31
"9341","SP","Bebedouro",77555,43191.17,35013,"Jaboticabal",3,"Sudeste",1,"350610",2,62,9,53,23,39,1,0,1,0,1,63,9,54,23,40,37,10.6733913551919,11.2587426410589,0.301082650060408,29
"9342","SP","Bebedouro",77555,43191.17,35013,"Jaboticabal",3,"Sudeste",1,"350610",3,77,19,58,26,51,0,0,0,0,0,77,19,58,26,51,58,10.6733913551919,11.2587426410589,0.397578928687763,31
"9343","SP","Bebedouro",77555,43191.17,35013,"Jaboticabal",3,"Sudeste",1,"350610",4,54,8,46,20,34,0,0,0,0,0,54,8,46,20,34,37,10.6733913551919,11.2587426410589,0.458618769583113,30
"9344","SP","Bebedouro",77555,43191.17,35013,"Jaboticabal",3,"Sudeste",1,"350610",5,90,17,73,25,65,0,0,0,0,0,90,17,73,25,65,37,10.6733913551919,11.2587426410589,0.403981365997673,31
"9345","SP","Bento de Abreu",3005,56699.61,35017,"Araçatuba",3,"Sudeste",0,"350620",2,3,0,3,0,3,0,0,0,0,0,3,0,3,0,3,1,10.9455226113853,8.00803284696931,0.314168052317647,29
"9346","SP","Bento de Abreu",3005,56699.61,35017,"Araçatuba",3,"Sudeste",0,"350620",3,3,0,3,0,3,0,0,0,0,0,3,0,3,0,3,4,10.9455226113853,8.00803284696931,0.407054104721576,31
"9347","SP","Bento de Abreu",3005,56699.61,35017,"Araçatuba",3,"Sudeste",0,"350620",4,1,0,1,0,1,0,0,0,0,0,1,0,1,0,1,2,10.9455226113853,8.00803284696931,0.384178067674769,30
"9348","SP","Bento de Abreu",3005,56699.61,35017,"Araçatuba",3,"Sudeste",0,"350620",5,5,0,5,1,4,0,0,0,0,0,5,0,5,1,4,2,10.9455226113853,8.00803284696931,0.36483410641731,31
"9349","SP","Bernardino de Campos",11158,19777.19,35040,"Ourinhos",3,"Sudeste",0,"350630",2,8,2,6,3,5,0,0,0,0,0,8,2,6,3,5,7,9.89228453239526,9.31991200840547,0.311205455302388,29
"9350","SP","Bernardino de Campos",11158,19777.19,35040,"Ourinhos",3,"Sudeste",0,"350630",3,14,1,13,10,4,0,0,0,0,0,14,1,13,10,4,10,9.89228453239526,9.31991200840547,0.350911752155392,31
"9351","SP","Bernardino de Campos",11158,19777.19,35040,"Ourinhos",3,"Sudeste",0,"350630",4,3,0,3,1,2,0,0,0,0,0,3,0,3,1,2,9,9.89228453239526,9.31991200840547,0.401055633790943,30
"9352","SP","Bernardino de Campos",11158,19777.19,35040,"Ourinhos",3,"Sudeste",0,"350630",5,8,2,6,4,4,0,0,0,0,0,8,2,6,4,4,7,9.89228453239526,9.31991200840547,0.385441918551521,31
"9353","SP","Bertioga",64723,27384.29,35063,"Santos",3,"Sudeste",1,"350635",2,59,9,50,17,42,0,0,0,0,0,59,9,50,17,42,31,10.2177247702796,11.077871904181,0.289768531439753,29
"9354","SP","Bertioga",64723,27384.29,35063,"Santos",3,"Sudeste",1,"350635",3,69,14,55,28,41,1,0,1,0,1,70,14,56,28,42,32,10.2177247702796,11.077871904181,0.379467702515331,31
"9355","SP","Bertioga",64723,27384.29,35063,"Santos",3,"Sudeste",1,"350635",4,74,22,52,40,34,2,1,1,1,1,76,23,53,41,35,40,10.2177247702796,11.077871904181,0.431055873252439,30
"9356","SP","Bertioga",64723,27384.29,35063,"Santos",3,"Sudeste",1,"350635",5,99,20,79,41,58,3,2,1,2,1,102,22,80,43,59,30,10.2177247702796,11.077871904181,0.411737605828292,31
"9357","SP","Bilac",8117,24284.98,35018,"Birigui",3,"Sudeste",0,"350640",2,6,2,4,2,4,1,0,1,0,1,7,2,5,2,5,4,10.0976133312259,9.00171590676118,0.281335993278159,29
"9358","SP","Bilac",8117,24284.98,35018,"Birigui",3,"Sudeste",0,"350640",3,4,1,3,2,2,0,0,0,0,0,4,1,3,2,2,5,10.0976133312259,9.00171590676118,0.361023811719267,31
"9359","SP","Bilac",8117,24284.98,35018,"Birigui",3,"Sudeste",0,"350640",4,1,1,0,0,1,0,0,0,0,0,1,1,0,0,1,3,10.0976133312259,9.00171590676118,0.399335779967291,30
"9360","SP","Bilac",8117,24284.98,35018,"Birigui",3,"Sudeste",0,"350640",5,4,1,3,1,3,0,0,0,0,0,4,1,3,1,3,2,10.0976133312259,9.00171590676118,0.362710520272075,31
"9361","SP","Birigui",124883,27268.69,35018,"Birigui",3,"Sudeste",1,"350650",2,86,5,81,31,55,0,0,0,0,0,86,5,81,31,55,57,10.2134944365486,11.7351325779629,0.280298039908935,29
"9362","SP","Birigui",124883,27268.69,35018,"Birigui",3,"Sudeste",1,"350650",3,97,15,82,25,72,1,0,1,1,0,98,15,83,26,72,63,10.2134944365486,11.7351325779629,0.367747299349915,31
"9363","SP","Birigui",124883,27268.69,35018,"Birigui",3,"Sudeste",1,"350650",4,98,9,89,26,72,0,0,0,0,0,98,9,89,26,72,66,10.2134944365486,11.7351325779629,0.417626949929717,30
"9364","SP","Birigui",124883,27268.69,35018,"Birigui",3,"Sudeste",1,"350650",5,93,9,84,30,63,0,0,0,0,0,93,9,84,30,63,62,10.2134944365486,11.7351325779629,0.376491981776061,31
"9365","SP","Biritiba Mirim",32936,21320.35,35062,"Mogi das Cruzes",3,"Sudeste",1,"350660",2,29,3,26,14,15,1,0,1,0,1,30,3,27,14,16,21,9.96741729465535,10.4023215634497,0.321883382768879,29
"9366","SP","Biritiba Mirim",32936,21320.35,35062,"Mogi das Cruzes",3,"Sudeste",1,"350660",3,28,5,23,13,15,1,0,1,0,1,29,5,24,13,16,19,9.96741729465535,10.4023215634497,0.414056167746316,31
"9367","SP","Biritiba Mirim",32936,21320.35,35062,"Mogi das Cruzes",3,"Sudeste",1,"350660",4,21,4,17,7,14,0,0,0,0,0,21,4,17,7,14,13,9.96741729465535,10.4023215634497,0.475197276020508,30
"9368","SP","Biritiba Mirim",32936,21320.35,35062,"Mogi das Cruzes",3,"Sudeste",1,"350660",5,32,12,20,18,14,0,0,0,0,0,32,12,20,18,14,24,9.96741729465535,10.4023215634497,0.441784407910169,31
"9369","SP","Boa Esperança do Sul",15018,20877.23,35024,"Araraquara",3,"Sudeste",1,"350670",2,16,3,13,5,11,0,0,0,0,0,16,3,13,5,11,7,9.94641437036083,9.61700476065983,0.33671149317166,29
"9370","SP","Boa Esperança do Sul",15018,20877.23,35024,"Araraquara",3,"Sudeste",1,"350670",3,12,1,11,6,6,0,0,0,0,0,12,1,11,6,6,9,9.94641437036083,9.61700476065983,0.399594874594722,31
"9371","SP","Boa Esperança do Sul",15018,20877.23,35024,"Araraquara",3,"Sudeste",1,"350670",4,14,8,6,6,8,0,0,0,0,0,14,8,6,6,8,7,9.94641437036083,9.61700476065983,0.420684729672546,30
"9372","SP","Boa Esperança do Sul",15018,20877.23,35024,"Araraquara",3,"Sudeste",1,"350670",5,18,4,14,11,7,0,0,0,0,0,18,4,14,11,7,9,9.94641437036083,9.61700476065983,0.412004942098505,31
"9373","SP","Bocaina",12452,17819.21,35021,"Jaú",3,"Sudeste",0,"350680",2,13,5,8,7,6,0,0,0,0,0,13,5,8,7,6,10,9.7880323678311,9.4296365315615,0.31335169177939,29
"9374","SP","Bocaina",12452,17819.21,35021,"Jaú",3,"Sudeste",0,"350680",3,9,2,7,5,4,0,0,0,0,0,9,2,7,5,4,5,9.7880323678311,9.4296365315615,0.389155891620638,31
"9375","SP","Bocaina",12452,17819.21,35021,"Jaú",3,"Sudeste",0,"350680",4,7,2,5,3,4,0,0,0,0,0,7,2,5,3,4,8,9.7880323678311,9.4296365315615,0.415376777880788,30
"9376","SP","Bocaina",12452,17819.21,35021,"Jaú",3,"Sudeste",0,"350680",5,10,3,7,1,9,0,0,0,0,0,10,3,7,1,9,8,9.7880323678311,9.4296365315615,0.390879769375349,31
"9377","SP","Bofete",11921,16223,35023,"Botucatu",3,"Sudeste",0,"350690",2,9,4,5,4,5,0,0,0,0,0,9,4,5,4,5,6,9.6941852674104,9.386056829718,0.329639397930712,29
"9378","SP","Bofete",11921,16223,35023,"Botucatu",3,"Sudeste",0,"350690",3,14,3,11,6,8,0,0,0,0,0,14,3,11,6,8,1,9.6941852674104,9.386056829718,0.417224810804927,31
"9379","SP","Bofete",11921,16223,35023,"Botucatu",3,"Sudeste",0,"350690",4,7,2,5,0,7,0,0,0,0,0,7,2,5,0,7,6,9.6941852674104,9.386056829718,0.467936088428276,30
"9380","SP","Bofete",11921,16223,35023,"Botucatu",3,"Sudeste",0,"350690",5,7,4,3,3,4,0,0,0,0,0,7,4,3,3,4,12,9.6941852674104,9.386056829718,0.488362855244925,31
"9381","SP","Boituva",62170,39829.36,35043,"Tatuí",3,"Sudeste",1,"350700",2,40,9,31,20,20,0,0,0,0,0,40,9,31,20,20,33,10.5923596077564,11.0376278472634,0.30317973225337,29
"9382","SP","Boituva",62170,39829.36,35043,"Tatuí",3,"Sudeste",1,"350700",3,55,10,45,18,37,1,0,1,1,0,56,10,46,19,37,21,10.5923596077564,11.0376278472634,0.398512411587936,31
"9383","SP","Boituva",62170,39829.36,35043,"Tatuí",3,"Sudeste",1,"350700",4,75,14,61,25,50,1,0,1,0,1,76,14,62,25,51,27,10.5923596077564,11.0376278472634,0.446622690198252,30
"9384","SP","Boituva",62170,39829.36,35043,"Tatuí",3,"Sudeste",1,"350700",5,74,10,64,21,53,0,0,0,0,0,74,10,64,21,53,33,10.5923596077564,11.0376278472634,0.415470320609716,31
"9385","SP","Bom Jesus dos Perdões",25985,36485.98,35048,"Bragança Paulista",3,"Sudeste",1,"350710",2,21,3,18,7,14,0,0,0,0,0,21,3,18,7,14,4,10.5046833561926,10.1652747274425,0.31912769616262,29
"9386","SP","Bom Jesus dos Perdões",25985,36485.98,35048,"Bragança Paulista",3,"Sudeste",1,"350710",3,26,4,22,6,20,0,0,0,0,0,26,4,22,6,20,7,10.5046833561926,10.1652747274425,0.406770125385871,31
"9387","SP","Bom Jesus dos Perdões",25985,36485.98,35048,"Bragança Paulista",3,"Sudeste",1,"350710",4,14,1,13,2,12,1,0,1,1,0,15,1,14,3,12,16,10.5046833561926,10.1652747274425,0.458330835676473,30
"9388","SP","Bom Jesus dos Perdões",25985,36485.98,35048,"Bragança Paulista",3,"Sudeste",1,"350710",5,24,5,19,12,12,0,0,0,0,0,24,5,19,12,12,17,10.5046833561926,10.1652747274425,0.438294512293055,31
"9389","SP","Boracéia",4868,80228.55,35021,"Jaú",3,"Sudeste",0,"350730",2,4,0,4,3,1,0,0,0,0,0,4,0,4,3,1,2,11.2926347155444,8.49043845410742,0.351621526985509,29
"9390","SP","Boracéia",4868,80228.55,35021,"Jaú",3,"Sudeste",0,"350730",3,4,2,2,1,3,0,0,0,0,0,4,2,2,1,3,2,11.2926347155444,8.49043845410742,0.43186420777784,31
"9391","SP","Boracéia",4868,80228.55,35021,"Jaú",3,"Sudeste",0,"350730",4,6,0,6,0,6,0,0,0,0,0,6,0,6,0,6,2,11.2926347155444,8.49043845410742,0.444346858652646,30
"9392","SP","Boracéia",4868,80228.55,35021,"Jaú",3,"Sudeste",0,"350730",5,10,2,8,4,6,0,0,0,0,0,10,2,8,4,6,2,11.2926347155444,8.49043845410742,0.405737947052615,31
"9393","SP","Borborema",16164,23374.91,35024,"Araraquara",3,"Sudeste",1,"350740",2,10,1,9,4,6,0,0,0,0,0,10,1,9,4,6,8,10.0594185038821,9.69054182619836,0.278995094975303,29
"9394","SP","Borborema",16164,23374.91,35024,"Araraquara",3,"Sudeste",1,"350740",3,15,4,11,8,7,0,0,0,0,0,15,4,11,8,7,14,10.0594185038821,9.69054182619836,0.357783150019167,31
"9395","SP","Borborema",16164,23374.91,35024,"Araraquara",3,"Sudeste",1,"350740",4,8,3,5,1,7,1,1,0,1,0,9,4,5,2,7,9,10.0594185038821,9.69054182619836,0.391240315154991,30
"9396","SP","Borborema",16164,23374.91,35024,"Araraquara",3,"Sudeste",1,"350740",5,10,3,7,4,6,0,0,0,0,0,10,3,7,4,6,6,10.0594185038821,9.69054182619836,0.364026147970896,31
"9397","SP","Botucatu",148130,31925.21,35023,"Botucatu",3,"Sudeste",1,"350750",2,138,18,120,38,100,0,0,0,0,0,138,18,120,38,100,89,10.3711512587961,11.9058455455761,0.303453362053688,29
"9398","SP","Botucatu",148130,31925.21,35023,"Botucatu",3,"Sudeste",1,"350750",3,128,27,101,52,76,5,1,4,0,5,133,28,105,52,81,93,10.3711512587961,11.9058455455761,0.404690067986004,31
"9399","SP","Botucatu",148130,31925.21,35023,"Botucatu",3,"Sudeste",1,"350750",4,131,25,106,46,85,2,1,1,0,2,133,26,107,46,87,78,10.3711512587961,11.9058455455761,0.478892880311156,30
"9400","SP","Botucatu",148130,31925.21,35023,"Botucatu",3,"Sudeste",1,"350750",5,144,19,125,55,89,1,0,1,1,0,145,19,126,56,89,99,10.3711512587961,11.9058455455761,0.434385179451978,31
"9401","SP","Bragança Paulista",170533,37813.45,35048,"Bragança Paulista",3,"Sudeste",1,"350760",2,178,27,151,53,125,0,0,0,0,0,178,27,151,53,125,75,10.5404201384245,12.0466841053647,0.304627987888721,29
"9402","SP","Bragança Paulista",170533,37813.45,35048,"Bragança Paulista",3,"Sudeste",1,"350760",3,163,24,139,61,102,1,0,1,0,1,164,24,140,61,103,105,10.5404201384245,12.0466841053647,0.409135060796171,31
"9403","SP","Bragança Paulista",170533,37813.45,35048,"Bragança Paulista",3,"Sudeste",1,"350760",4,152,23,129,37,115,1,1,0,0,1,153,24,129,37,116,92,10.5404201384245,12.0466841053647,0.472955364107545,30
"9404","SP","Bragança Paulista",170533,37813.45,35048,"Bragança Paulista",3,"Sudeste",1,"350760",5,188,25,163,57,131,0,0,0,0,0,188,25,163,57,131,96,10.5404201384245,12.0466841053647,0.435456089412355,31
"9405","SP","Braúna",5741,17435.66,35018,"Birigui",3,"Sudeste",1,"350770",2,4,0,4,1,3,0,0,0,0,0,4,0,4,1,3,3,9.76627281328286,8.65538869016764,0.297483052599661,29
"9406","SP","Braúna",5741,17435.66,35018,"Birigui",3,"Sudeste",1,"350770",3,4,0,4,3,1,0,0,0,0,0,4,0,4,3,1,6,9.76627281328286,8.65538869016764,0.388475103493545,31
"9407","SP","Braúna",5741,17435.66,35018,"Birigui",3,"Sudeste",1,"350770",4,6,0,6,1,5,0,0,0,0,0,6,0,6,1,5,7,9.76627281328286,8.65538869016764,0.398749166690975,30
"9408","SP","Braúna",5741,17435.66,35018,"Birigui",3,"Sudeste",1,"350770",5,11,1,10,3,8,0,0,0,0,0,11,1,10,3,8,4,9.76627281328286,8.65538869016764,0.371345474976636,31
"9409","SP","Brodowski",25277,27203.14,35014,"Ribeirão Preto",3,"Sudeste",1,"350780",2,18,6,12,7,11,1,0,1,1,0,19,6,13,8,11,11,10.2110876867977,10.1376501703328,0.296382540839969,29
"9410","SP","Brodowski",25277,27203.14,35014,"Ribeirão Preto",3,"Sudeste",1,"350780",3,20,6,14,7,13,0,0,0,0,0,20,6,14,7,13,14,10.2110876867977,10.1376501703328,0.373954794379021,31
"9411","SP","Brodowski",25277,27203.14,35014,"Ribeirão Preto",3,"Sudeste",1,"350780",4,27,8,19,8,19,0,0,0,0,0,27,8,19,8,19,17,10.2110876867977,10.1376501703328,0.412452772628481,30
"9412","SP","Brodowski",25277,27203.14,35014,"Ribeirão Preto",3,"Sudeste",1,"350780",5,32,11,21,11,21,0,0,0,0,0,32,11,21,11,21,18,10.2110876867977,10.1376501703328,0.363225202891322,31
"9413","SP","Brotas",24636,27225.67,35026,"Rio Claro",3,"Sudeste",1,"350790",2,26,5,21,7,19,1,0,1,0,1,27,5,22,7,20,16,10.211915557232,10.1119640668069,0.296763765239639,29
"9414","SP","Brotas",24636,27225.67,35026,"Rio Claro",3,"Sudeste",1,"350790",3,22,4,18,10,12,0,0,0,0,0,22,4,18,10,12,14,10.211915557232,10.1119640668069,0.373845009658491,31
"9415","SP","Brotas",24636,27225.67,35026,"Rio Claro",3,"Sudeste",1,"350790",4,23,4,19,11,12,0,0,0,0,0,23,4,19,11,12,16,10.211915557232,10.1119640668069,0.440071616917222,30
"9416","SP","Brotas",24636,27225.67,35026,"Rio Claro",3,"Sudeste",1,"350790",5,31,9,22,6,25,1,1,0,0,1,32,10,22,6,26,10,10.211915557232,10.1119640668069,0.402138911750838,31
"9417","SP","Buri",19965,20905.86,35041,"Itapeva",3,"Sudeste",1,"350800",2,14,4,10,8,6,0,0,0,0,0,14,4,10,8,6,11,9.94778478142812,9.90173601949732,0.360390402937043,29
"9418","SP","Buri",19965,20905.86,35041,"Itapeva",3,"Sudeste",1,"350800",3,28,15,13,13,15,0,0,0,0,0,28,15,13,13,15,10,9.94778478142812,9.90173601949732,0.42701985423457,31
"9419","SP","Buri",19965,20905.86,35041,"Itapeva",3,"Sudeste",1,"350800",4,25,11,14,14,11,0,0,0,0,0,25,11,14,14,11,7,9.94778478142812,9.90173601949732,0.45038061359993,30
"9420","SP","Buri",19965,20905.86,35041,"Itapeva",3,"Sudeste",1,"350800",5,24,5,19,10,14,1,0,1,1,0,25,5,20,11,14,12,9.94778478142812,9.90173601949732,0.435655285516486,31
"9421","SP","Buritama",17281,37385.31,35018,"Birigui",3,"Sudeste",1,"350810",2,8,1,7,3,5,0,0,0,0,0,8,1,7,3,5,12,10.5290331254954,9.75736291105399,0.304510565028887,29
"9422","SP","Buritama",17281,37385.31,35018,"Birigui",3,"Sudeste",1,"350810",3,17,0,17,9,8,0,0,0,0,0,17,0,17,9,8,14,10.5290331254954,9.75736291105399,0.369009914959276,31
"9423","SP","Buritama",17281,37385.31,35018,"Birigui",3,"Sudeste",1,"350810",4,13,2,11,4,9,0,0,0,0,0,13,2,11,4,9,11,10.5290331254954,9.75736291105399,0.395617659128751,30
"9424","SP","Buritama",17281,37385.31,35018,"Birigui",3,"Sudeste",1,"350810",5,17,4,13,3,14,0,0,0,0,0,17,4,13,3,14,21,10.5290331254954,9.75736291105399,0.370790955472483,31
"9425","SP","Cabrália Paulista",4243,19260.49,35020,"Bauru",3,"Sudeste",0,"350830",2,5,2,3,5,0,0,0,0,0,0,5,2,3,5,0,5,9.86581112635767,8.35302584520232,0.301992290880669,29
"9426","SP","Cabrália Paulista",4243,19260.49,35020,"Bauru",3,"Sudeste",0,"350830",3,4,2,2,1,3,0,0,0,0,0,4,2,2,1,3,4,9.86581112635767,8.35302584520232,0.403189987597681,31
"9427","SP","Cabrália Paulista",4243,19260.49,35020,"Bauru",3,"Sudeste",0,"350830",4,5,0,5,3,2,0,0,0,0,0,5,0,5,3,2,4,9.86581112635767,8.35302584520232,0.445625842256309,30
"9428","SP","Cabrália Paulista",4243,19260.49,35020,"Bauru",3,"Sudeste",0,"350830",5,4,0,4,1,3,0,0,0,0,0,4,0,4,1,3,5,9.86581112635767,8.35302584520232,0.409195782324485,31
"9429","SP","Cabreúva",50429,95518.16,35046,"Sorocaba",3,"Sudeste",1,"350840",2,54,8,46,21,33,0,0,0,0,0,54,8,46,21,33,25,11.4670716654593,10.8283216854076,0.315538398204293,29
"9430","SP","Cabreúva",50429,95518.16,35046,"Sorocaba",3,"Sudeste",1,"350840",3,51,12,39,19,32,0,0,0,0,0,51,12,39,19,32,12,11.4670716654593,10.8283216854076,0.403414712672565,31
"9431","SP","Cabreúva",50429,95518.16,35046,"Sorocaba",3,"Sudeste",1,"350840",4,64,15,49,27,37,0,0,0,0,0,64,15,49,27,37,21,11.4670716654593,10.8283216854076,0.452239951320567,30
"9432","SP","Cabreúva",50429,95518.16,35046,"Sorocaba",3,"Sudeste",1,"350840",5,62,7,55,17,45,0,0,0,0,0,62,7,55,17,45,26,11.4670716654593,10.8283216854076,0.429886024023345,31
"9433","SP","Caçapava",95018,46192.5,35050,"São José dos Campos",3,"Sudeste",1,"350850",2,86,13,73,16,70,1,1,0,1,0,87,14,73,17,70,44,10.7405727262293,11.461821626319,0.297222353187608,29
"9434","SP","Caçapava",95018,46192.5,35050,"São José dos Campos",3,"Sudeste",1,"350850",3,96,15,81,28,68,1,0,1,0,1,97,15,82,28,69,50,10.7405727262293,11.461821626319,0.406251645017929,31
"9435","SP","Caçapava",95018,46192.5,35050,"São José dos Campos",3,"Sudeste",1,"350850",4,90,13,77,32,58,0,0,0,0,0,90,13,77,32,58,48,10.7405727262293,11.461821626319,0.468437013245193,30
"9436","SP","Caçapava",95018,46192.5,35050,"São José dos Campos",3,"Sudeste",1,"350850",5,109,13,96,37,72,0,0,0,0,0,109,13,96,37,72,57,10.7405727262293,11.461821626319,0.418117995195614,31
"9437","SP","Cachoeira Paulista",33581,18401.78,35051,"Guaratinguetá",3,"Sudeste",1,"350860",2,33,4,29,11,22,0,0,0,0,0,33,4,29,11,22,17,9.82020267804858,10.4217157098189,0.333930975460049,29
"9438","SP","Cachoeira Paulista",33581,18401.78,35051,"Guaratinguetá",3,"Sudeste",1,"350860",3,29,3,26,11,18,0,0,0,0,0,29,3,26,11,18,31,9.82020267804858,10.4217157098189,0.438826381678792,31
"9439","SP","Cachoeira Paulista",33581,18401.78,35051,"Guaratinguetá",3,"Sudeste",1,"350860",4,28,4,24,10,18,0,0,0,0,0,28,4,24,10,18,17,9.82020267804858,10.4217157098189,0.497893242181289,30
"9440","SP","Cachoeira Paulista",33581,18401.78,35051,"Guaratinguetá",3,"Sudeste",1,"350860",5,33,4,29,11,22,0,0,0,0,0,33,4,29,11,22,21,9.82020267804858,10.4217157098189,0.446606835078408,31
"9441","SP","Caconde",19009,18846.16,35030,"São João da Boa Vista",3,"Sudeste",0,"350870",2,15,3,12,8,7,0,0,0,0,0,15,3,12,8,7,15,9.84406445859589,9.85266783020615,0.330122274124872,29
"9442","SP","Caconde",19009,18846.16,35030,"São João da Boa Vista",3,"Sudeste",0,"350870",3,13,2,11,5,8,0,0,0,0,0,13,2,11,5,8,11,9.84406445859589,9.85266783020615,0.416739217305446,31
"9443","SP","Caconde",19009,18846.16,35030,"São João da Boa Vista",3,"Sudeste",0,"350870",4,11,1,10,2,9,0,0,0,0,0,11,1,10,2,9,13,9.84406445859589,9.85266783020615,0.453189310614348,30
"9444","SP","Caconde",19009,18846.16,35030,"São João da Boa Vista",3,"Sudeste",0,"350870",5,23,6,17,13,10,0,0,0,0,0,23,6,17,13,10,7,9.84406445859589,9.85266783020615,0.435286799926208,31
"9445","SP","Cafelândia",17843,28550.67,35019,"Lins",3,"Sudeste",1,"350880",2,16,4,12,5,11,0,0,0,0,0,16,4,12,5,11,16,10.2594356824095,9.78936655343143,0.300136640017131,29
"9446","SP","Cafelândia",17843,28550.67,35019,"Lins",3,"Sudeste",1,"350880",3,20,7,13,8,12,0,0,0,0,0,20,7,13,8,12,14,10.2594356824095,9.78936655343143,0.375210902518683,31
"9447","SP","Cafelândia",17843,28550.67,35019,"Lins",3,"Sudeste",1,"350880",4,15,4,11,5,10,0,0,0,0,0,15,4,11,5,10,14,10.2594356824095,9.78936655343143,0.419934330180135,30
"9448","SP","Cafelândia",17843,28550.67,35019,"Lins",3,"Sudeste",1,"350880",5,22,2,20,11,11,0,0,0,0,0,22,2,20,11,11,12,10.2594356824095,9.78936655343143,0.397918707660097,31
"9449","SP","Caieiras",102775,35517.31,35058,"Franco da Rocha",3,"Sudeste",1,"350900",2,94,11,83,33,61,0,0,0,0,0,94,11,83,33,61,45,10.4777754622563,11.5402974117661,0.300037635482226,29
"9450","SP","Caieiras",102775,35517.31,35058,"Franco da Rocha",3,"Sudeste",1,"350900",3,105,15,90,37,68,0,0,0,0,0,105,15,90,37,68,44,10.4777754622563,11.5402974117661,0.407562259118462,31
"9451","SP","Caieiras",102775,35517.31,35058,"Franco da Rocha",3,"Sudeste",1,"350900",4,106,7,99,43,63,1,0,1,0,1,107,7,100,43,64,68,10.4777754622563,11.5402974117661,0.49432969490801,30
"9452","SP","Caieiras",102775,35517.31,35058,"Franco da Rocha",3,"Sudeste",1,"350900",5,119,14,105,50,69,1,0,1,1,0,120,14,106,51,69,59,10.4777754622563,11.5402974117661,0.470536980846473,31
"9453","SP","Cajamar",77934,224359.59,35057,"Osasco",3,"Sudeste",1,"350920",2,105,18,87,27,78,0,0,0,0,0,105,18,87,27,78,29,12.3210053562004,11.2636175936353,0.273058392181122,29
"9454","SP","Cajamar",77934,224359.59,35057,"Osasco",3,"Sudeste",1,"350920",3,112,12,100,33,79,1,0,1,0,1,113,12,101,33,80,38,12.3210053562004,11.2636175936353,0.373471683141708,31
"9455","SP","Cajamar",77934,224359.59,35057,"Osasco",3,"Sudeste",1,"350920",4,105,13,92,26,79,0,0,0,0,0,105,13,92,26,79,37,12.3210053562004,11.2636175936353,0.458711494112005,30
"9456","SP","Cajamar",77934,224359.59,35057,"Osasco",3,"Sudeste",1,"350920",5,108,13,95,30,78,0,0,0,0,0,108,13,95,30,78,51,12.3210053562004,11.2636175936353,0.432849927906822,31
"9457","SP","Cajati",28494,50776.98,35055,"Registro",3,"Sudeste",0,"350925",2,18,7,11,6,12,0,0,0,0,0,18,7,11,6,12,15,10.835198381257,10.2574488177772,0.345112542536613,29
"9458","SP","Cajati",28494,50776.98,35055,"Registro",3,"Sudeste",0,"350925",3,32,6,26,11,21,0,0,0,0,0,32,6,26,11,21,16,10.835198381257,10.2574488177772,0.439675702458187,31
"9459","SP","Cajati",28494,50776.98,35055,"Registro",3,"Sudeste",0,"350925",4,27,9,18,15,12,0,0,0,0,0,27,9,18,15,12,16,10.835198381257,10.2574488177772,0.471870550002221,30
"9460","SP","Cajati",28494,50776.98,35055,"Registro",3,"Sudeste",0,"350925",5,31,3,28,12,19,0,0,0,0,0,31,3,28,12,19,19,10.835198381257,10.2574488177772,0.427176546723394,31
"9461","SP","Cajobi",10596,14873.72,35005,"Catanduva",3,"Sudeste",0,"350930",2,10,3,7,3,7,0,0,0,0,0,10,3,7,3,7,7,9.60735117629111,9.26823185039196,0.318810680743667,29
"9462","SP","Cajobi",10596,14873.72,35005,"Catanduva",3,"Sudeste",0,"350930",3,7,2,5,5,2,0,0,0,0,0,7,2,5,5,2,8,9.60735117629111,9.26823185039196,0.406052559995861,31
"9463","SP","Cajobi",10596,14873.72,35005,"Catanduva",3,"Sudeste",0,"350930",4,7,3,4,1,6,1,0,1,1,0,8,3,5,2,6,4,9.60735117629111,9.26823185039196,0.427711544816656,30
"9464","SP","Cajobi",10596,14873.72,35005,"Catanduva",3,"Sudeste",0,"350930",5,10,3,7,5,5,0,0,0,0,0,10,3,7,5,5,11,9.60735117629111,9.26823185039196,0.39709534559122,31
"9465","SP","Cajuru",26393,22061.52,35015,"Batatais",3,"Sudeste",1,"350940",2,11,0,11,6,5,0,0,0,0,0,11,0,11,6,5,14,10.0015901934256,10.1808541024604,0.317175766134156,29
"9466","SP","Cajuru",26393,22061.52,35015,"Batatais",3,"Sudeste",1,"350940",3,13,3,10,7,6,0,0,0,0,0,13,3,10,7,6,13,10.0015901934256,10.1808541024604,0.391356337387366,31
"9467","SP","Cajuru",26393,22061.52,35015,"Batatais",3,"Sudeste",1,"350940",4,16,3,13,7,9,0,0,0,0,0,16,3,13,7,9,12,10.0015901934256,10.1808541024604,0.421163644573035,30
"9468","SP","Cajuru",26393,22061.52,35015,"Batatais",3,"Sudeste",1,"350940",5,28,3,25,12,16,1,1,0,1,0,29,4,25,13,16,13,10.0015901934256,10.1808541024604,0.410035540838873,31
"9469","SP","Campina do Monte Alegre",6057,18135.71,35042,"Itapetininga",3,"Sudeste",0,"350945",2,7,0,7,3,4,0,0,0,0,0,7,0,7,3,4,2,9.80563820176397,8.70896990698095,0.33941899203368,29
"9470","SP","Campina do Monte Alegre",6057,18135.71,35042,"Itapetininga",3,"Sudeste",0,"350945",3,6,1,5,3,3,0,0,0,0,0,6,1,5,3,3,2,9.80563820176397,8.70896990698095,0.411290123044549,31
"9471","SP","Campina do Monte Alegre",6057,18135.71,35042,"Itapetininga",3,"Sudeste",0,"350945",4,8,4,4,3,5,0,0,0,0,0,8,4,4,3,5,3,9.80563820176397,8.70896990698095,0.442857288327802,30
"9472","SP","Campina do Monte Alegre",6057,18135.71,35042,"Itapetininga",3,"Sudeste",0,"350945",5,4,0,4,2,2,0,0,0,0,0,4,0,4,2,2,3,9.80563820176397,8.70896990698095,0.417525154791057,31
"9473","SP","Campinas",1213792,51417.44,35032,"Campinas",3,"Sudeste",1,"350950",2,981,147,834,307,674,3,0,3,1,2,984,147,837,308,676,529,10.8477326935051,14.0092599014905,0.277223228185247,29
"9474","SP","Campinas",1213792,51417.44,35032,"Campinas",3,"Sudeste",1,"350950",3,1063,143,920,306,757,4,1,3,0,4,1067,144,923,306,761,694,10.8477326935051,14.0092599014905,0.392790333187556,31
"9475","SP","Campinas",1213792,51417.44,35032,"Campinas",3,"Sudeste",1,"350950",4,1022,168,854,305,717,4,1,3,2,2,1026,169,857,307,719,602,10.8477326935051,14.0092599014905,0.476892207744692,30
"9476","SP","Campinas",1213792,51417.44,35032,"Campinas",3,"Sudeste",1,"350950",5,1126,178,948,320,806,6,1,5,2,4,1132,179,953,322,810,694,10.8477326935051,14.0092599014905,0.438082191952141,31
"9477","SP","Campo Limpo Paulista",85541,25211.06,35047,"Jundiaí",3,"Sudeste",1,"350960",2,44,4,40,9,35,0,0,0,0,0,44,4,40,9,35,37,10.1350380661048,11.3567510721498,0.314024224078656,29
"9478","SP","Campo Limpo Paulista",85541,25211.06,35047,"Jundiaí",3,"Sudeste",1,"350960",3,68,11,57,25,43,0,0,0,0,0,68,11,57,25,43,37,10.1350380661048,11.3567510721498,0.411009361563606,31
"9479","SP","Campo Limpo Paulista",85541,25211.06,35047,"Jundiaí",3,"Sudeste",1,"350960",4,79,9,70,31,48,1,0,1,0,1,80,9,71,31,49,43,10.1350380661048,11.3567510721498,0.480443005447099,30
"9480","SP","Campo Limpo Paulista",85541,25211.06,35047,"Jundiaí",3,"Sudeste",1,"350960",5,73,9,64,31,42,2,1,1,1,1,75,10,65,32,43,53,10.1350380661048,11.3567510721498,0.44642497020149,31
"9481","SP","Campos do Jordão",52405,24107.48,35049,"Campos do Jordão",3,"Sudeste",1,"350970",2,37,4,33,12,25,0,0,0,0,0,37,4,33,12,25,25,10.0902774447669,10.8667572856043,0.306901112133353,29
"9482","SP","Campos do Jordão",52405,24107.48,35049,"Campos do Jordão",3,"Sudeste",1,"350970",3,67,15,52,23,44,1,1,0,0,1,68,16,52,23,45,32,10.0902774447669,10.8667572856043,0.408075286814263,31
"9483","SP","Campos do Jordão",52405,24107.48,35049,"Campos do Jordão",3,"Sudeste",1,"350970",4,59,15,44,24,35,0,0,0,0,0,59,15,44,24,35,19,10.0902774447669,10.8667572856043,0.462399309480393,30
"9484","SP","Campos do Jordão",52405,24107.48,35049,"Campos do Jordão",3,"Sudeste",1,"350970",5,54,16,38,21,33,0,0,0,0,0,54,16,38,21,33,29,10.0902774447669,10.8667572856043,0.43045946067188,31
"9485","SP","Cananéia",12541,23977.74,35055,"Registro",3,"Sudeste",0,"350990",2,11,3,8,6,5,0,0,0,0,0,11,3,8,6,5,9,10.0848811789358,9.43675855582405,0.312926147272288,29
"9486","SP","Cananéia",12541,23977.74,35055,"Registro",3,"Sudeste",0,"350990",3,10,3,7,5,5,0,0,0,0,0,10,3,7,5,5,8,10.0848811789358,9.43675855582405,0.437347124922594,31
"9487","SP","Cananéia",12541,23977.74,35055,"Registro",3,"Sudeste",0,"350990",4,7,1,6,4,3,0,0,0,0,0,7,1,6,4,3,14,10.0848811789358,9.43675855582405,0.499031692781263,30
"9488","SP","Cananéia",12541,23977.74,35055,"Registro",3,"Sudeste",0,"350990",5,19,5,14,6,13,0,0,0,0,0,19,5,14,6,13,10,10.0848811789358,9.43675855582405,0.488082880646877,31
"9489","SP","Canas",5204,20623.06,35051,"Guaratinguetá",3,"Sudeste",1,"350995",2,3,0,3,0,3,0,0,0,0,0,3,0,3,0,3,3,9.93416514617284,8.5571828396324,0.284769388037138,29
"9490","SP","Canas",5204,20623.06,35051,"Guaratinguetá",3,"Sudeste",1,"350995",3,7,2,5,3,4,0,0,0,0,0,7,2,5,3,4,2,9.93416514617284,8.5571828396324,0.37988038157205,31
"9491","SP","Canas",5204,20623.06,35051,"Guaratinguetá",3,"Sudeste",1,"350995",4,8,1,7,4,4,0,0,0,0,0,8,1,7,4,4,2,9.93416514617284,8.5571828396324,0.401322532931347,30
"9492","SP","Canas",5204,20623.06,35051,"Guaratinguetá",3,"Sudeste",1,"350995",5,6,2,4,5,1,0,0,0,0,0,6,2,4,5,1,5,9.93416514617284,8.5571828396324,0.390987845357251,31
"9493","SP","Cândido Mota",31346,37372.6,35039,"Assis",3,"Sudeste",1,"351000",2,22,4,18,10,12,1,0,1,0,1,23,4,19,10,13,19,10.5286930945844,10.352841946214,0.309352776031323,29
"9494","SP","Cândido Mota",31346,37372.6,35039,"Assis",3,"Sudeste",1,"351000",3,25,0,25,11,14,0,0,0,0,0,25,0,25,11,14,25,10.5286930945844,10.352841946214,0.406464152450331,31
"9495","SP","Cândido Mota",31346,37372.6,35039,"Assis",3,"Sudeste",1,"351000",4,23,1,22,11,12,0,0,0,0,0,23,1,22,11,12,22,10.5286930945844,10.352841946214,0.43558845975257,30
"9496","SP","Cândido Mota",31346,37372.6,35039,"Assis",3,"Sudeste",1,"351000",5,28,2,26,10,18,0,0,0,0,0,28,2,26,10,18,18,10.5286930945844,10.352841946214,0.419250731285146,31
"9497","SP","Canitar",5292,36713.02,35040,"Ourinhos",3,"Sudeste",1,"351015",2,10,2,8,5,5,0,0,0,0,0,10,2,8,5,5,0,10.5108867395196,8.57395152523485,0.353238833407378,29
"9498","SP","Canitar",5292,36713.02,35040,"Ourinhos",3,"Sudeste",1,"351015",3,9,2,7,3,6,0,0,0,0,0,9,2,7,3,6,3,10.5108867395196,8.57395152523485,0.448211766361985,31
"9499","SP","Canitar",5292,36713.02,35040,"Ourinhos",3,"Sudeste",1,"351015",4,4,2,2,2,2,0,0,0,0,0,4,2,2,2,2,7,10.5108867395196,8.57395152523485,0.492011670115323,30
"9500","SP","Canitar",5292,36713.02,35040,"Ourinhos",3,"Sudeste",1,"351015",5,6,1,5,1,5,0,0,0,0,0,6,1,5,1,5,2,10.5108867395196,8.57395152523485,0.467237056324665,31
"9501","SP","Capão Bonito",47118,19221.42,35044,"Capão Bonito",3,"Sudeste",1,"351020",2,39,5,34,17,22,1,0,1,1,0,40,5,35,18,22,28,9.86378056116876,10.7604103726029,0.310401126886369,29
"9502","SP","Capão Bonito",47118,19221.42,35044,"Capão Bonito",3,"Sudeste",1,"351020",3,60,12,48,28,32,1,0,1,0,1,61,12,49,28,33,33,9.86378056116876,10.7604103726029,0.402935213449368,31
"9503","SP","Capão Bonito",47118,19221.42,35044,"Capão Bonito",3,"Sudeste",1,"351020",4,47,10,37,19,28,0,0,0,0,0,47,10,37,19,28,24,9.86378056116876,10.7604103726029,0.443829744326743,30
"9504","SP","Capão Bonito",47118,19221.42,35044,"Capão Bonito",3,"Sudeste",1,"351020",5,60,19,41,17,43,0,0,0,0,0,60,19,41,17,43,25,9.86378056116876,10.7604103726029,0.418778102730178,31
"9505","SP","Capela do Alto",20985,13344.01,35046,"Sorocaba",3,"Sudeste",0,"351030",2,24,7,17,15,9,0,0,0,0,0,24,7,17,15,9,9,9.49882287399873,9.95156317576769,0.29178582589236,29
"9506","SP","Capela do Alto",20985,13344.01,35046,"Sorocaba",3,"Sudeste",0,"351030",3,22,4,18,4,18,0,0,0,0,0,22,4,18,4,18,12,9.49882287399873,9.95156317576769,0.368569107649367,31
"9507","SP","Capela do Alto",20985,13344.01,35046,"Sorocaba",3,"Sudeste",0,"351030",4,25,2,23,14,11,0,0,0,0,0,25,2,23,14,11,13,9.49882287399873,9.95156317576769,0.400338627041895,30
"9508","SP","Capela do Alto",20985,13344.01,35046,"Sorocaba",3,"Sudeste",0,"351030",5,28,2,26,12,16,0,0,0,0,0,28,2,26,12,16,9,9.49882287399873,9.95156317576769,0.381242873794897,31
"9509","SP","Capivari",56379,37353.4,35028,"Piracicaba",3,"Sudeste",1,"351040",2,38,6,32,13,25,1,0,1,0,1,39,6,33,13,26,26,10.5281792172077,10.9398520277247,0.309387779245708,29
"9510","SP","Capivari",56379,37353.4,35028,"Piracicaba",3,"Sudeste",1,"351040",3,58,6,52,28,30,0,0,0,0,0,58,6,52,28,30,18,10.5281792172077,10.9398520277247,0.397126508295617,31
"9511","SP","Capivari",56379,37353.4,35028,"Piracicaba",3,"Sudeste",1,"351040",4,45,7,38,13,32,0,0,0,0,0,45,7,38,13,32,28,10.5281792172077,10.9398520277247,0.434952171372489,30
"9512","SP","Capivari",56379,37353.4,35028,"Piracicaba",3,"Sudeste",1,"351040",5,43,14,29,15,28,1,0,1,1,0,44,14,30,16,28,21,10.5281792172077,10.9398520277247,0.41067618606053,31
"9513","SP","Caraguatatuba",123389,27802.88,35054,"Caraguatatuba",3,"Sudeste",1,"351050",2,125,17,108,46,79,0,0,0,0,0,125,17,108,46,79,66,10.2328948914352,11.7230972454753,0.314066822651273,29
"9514","SP","Caraguatatuba",123389,27802.88,35054,"Caraguatatuba",3,"Sudeste",1,"351050",3,122,22,100,46,76,0,0,0,0,0,122,22,100,46,76,74,10.2328948914352,11.7230972454753,0.435164898308575,31
"9515","SP","Caraguatatuba",123389,27802.88,35054,"Caraguatatuba",3,"Sudeste",1,"351050",4,139,18,121,47,92,1,0,1,1,0,140,18,122,48,92,73,10.2328948914352,11.7230972454753,0.499380068795041,30
"9516","SP","Caraguatatuba",123389,27802.88,35054,"Caraguatatuba",3,"Sudeste",1,"351050",5,114,13,101,48,66,1,0,1,1,0,115,13,102,49,66,96,10.2328948914352,11.7230972454753,0.461503464558868,31
"9517","SP","Carapicuíba",403183,14413.33,35057,"Osasco",3,"Sudeste",1,"351060",2,339,40,299,132,207,3,1,2,1,2,342,41,301,133,209,157,9.57590875181766,12.907145832152,0.292261990189653,29
"9518","SP","Carapicuíba",403183,14413.33,35057,"Osasco",3,"Sudeste",1,"351060",3,379,42,337,138,241,2,2,0,0,2,381,44,337,138,243,184,9.57590875181766,12.907145832152,0.393434597953515,31
"9519","SP","Carapicuíba",403183,14413.33,35057,"Osasco",3,"Sudeste",1,"351060",4,469,63,406,192,277,5,1,4,1,4,474,64,410,193,281,233,9.57590875181766,12.907145832152,0.473863301458813,30
"9520","SP","Carapicuíba",403183,14413.33,35057,"Osasco",3,"Sudeste",1,"351060",5,487,66,421,174,313,4,1,3,2,2,491,67,424,176,315,339,9.57590875181766,12.907145832152,0.452429931771117,31
"9521","SP","Cardoso",12349,20770.49,35003,"Votuporanga",3,"Sudeste",0,"351070",2,6,1,5,0,6,0,0,0,0,0,6,1,5,0,6,8,9.9412885083107,9.42133036711782,0.291420512792425,29
"9522","SP","Cardoso",12349,20770.49,35003,"Votuporanga",3,"Sudeste",0,"351070",3,5,0,5,0,5,0,0,0,0,0,5,0,5,0,5,11,9.9412885083107,9.42133036711782,0.367823674597585,31
"9523","SP","Cardoso",12349,20770.49,35003,"Votuporanga",3,"Sudeste",0,"351070",4,11,0,11,5,6,0,0,0,0,0,11,0,11,5,6,6,9.9412885083107,9.42133036711782,0.377239109282629,30
"9524","SP","Cardoso",12349,20770.49,35003,"Votuporanga",3,"Sudeste",0,"351070",5,7,0,7,2,5,0,0,0,0,0,7,0,7,2,5,12,9.9412885083107,9.42133036711782,0.377529437408142,31
"9525","SP","Casa Branca",30520,27488.44,35030,"São João da Boa Vista",3,"Sudeste",0,"351080",2,14,1,13,5,9,0,0,0,0,0,14,1,13,5,9,22,10.2215208316407,10.3261374853984,0.334655898605926,29
"9526","SP","Casa Branca",30520,27488.44,35030,"São João da Boa Vista",3,"Sudeste",0,"351080",3,25,3,22,5,20,0,0,0,0,0,25,3,22,5,20,22,10.2215208316407,10.3261374853984,0.410373163210187,31
"9527","SP","Casa Branca",30520,27488.44,35030,"São João da Boa Vista",3,"Sudeste",0,"351080",4,20,3,17,4,16,0,0,0,0,0,20,3,17,4,16,27,10.2215208316407,10.3261374853984,0.469287541588189,30
"9528","SP","Casa Branca",30520,27488.44,35030,"São João da Boa Vista",3,"Sudeste",0,"351080",5,18,5,13,6,12,0,0,0,0,0,18,5,13,6,12,14,10.2215208316407,10.3261374853984,0.437599767155863,31
"9529","SP","Castilho",21267,41708.15,35016,"Andradina",3,"Sudeste",0,"351100",2,13,3,10,7,6,0,0,0,0,0,13,3,10,7,6,8,10.6384518323354,9.96491185452313,0.314958311532494,29
"9530","SP","Castilho",21267,41708.15,35016,"Andradina",3,"Sudeste",0,"351100",3,11,1,10,4,7,0,0,0,0,0,11,1,10,4,7,8,10.6384518323354,9.96491185452313,0.400501468450552,31
"9531","SP","Castilho",21267,41708.15,35016,"Andradina",3,"Sudeste",0,"351100",4,17,6,11,8,9,0,0,0,0,0,17,6,11,8,9,9,10.6384518323354,9.96491185452313,0.433243006432169,30
"9532","SP","Castilho",21267,41708.15,35016,"Andradina",3,"Sudeste",0,"351100",5,22,5,17,7,15,0,0,0,0,0,22,5,17,7,15,13,10.6384518323354,9.96491185452313,0.402730821252083,31
"9533","SP","Catanduva",122497,34611.18,35005,"Catanduva",3,"Sudeste",1,"351110",2,77,10,67,22,55,1,1,0,1,0,78,11,67,23,55,98,10.4519320302406,11.7158418188711,0.2955602017474,29
"9534","SP","Catanduva",122497,34611.18,35005,"Catanduva",3,"Sudeste",1,"351110",3,102,15,87,34,68,2,2,0,0,2,104,17,87,34,70,101,10.4519320302406,11.7158418188711,0.375021144272751,31
"9535","SP","Catanduva",122497,34611.18,35005,"Catanduva",3,"Sudeste",1,"351110",4,97,10,87,24,73,0,0,0,0,0,97,10,87,24,73,82,10.4519320302406,11.7158418188711,0.42838332007521,30
"9536","SP","Catanduva",122497,34611.18,35005,"Catanduva",3,"Sudeste",1,"351110",5,103,9,94,33,70,1,0,1,0,1,104,9,95,33,71,85,10.4519320302406,11.7158418188711,0.394122133849119,31
"9537","SP","Catiguá",7855,15079.11,35005,"Catanduva",3,"Sudeste",1,"351120",2,6,0,6,4,2,0,0,0,0,0,6,0,6,4,2,4,9.62106562125264,8.96890555068972,0.314520733833449,29
"9538","SP","Catiguá",7855,15079.11,35005,"Catanduva",3,"Sudeste",1,"351120",3,4,1,3,1,3,0,0,0,0,0,4,1,3,1,3,4,9.62106562125264,8.96890555068972,0.386426764516512,31
"9539","SP","Catiguá",7855,15079.11,35005,"Catanduva",3,"Sudeste",1,"351120",4,2,0,2,0,2,0,0,0,0,0,2,0,2,0,2,5,9.62106562125264,8.96890555068972,0.412646834609733,30
"9540","SP","Catiguá",7855,15079.11,35005,"Catanduva",3,"Sudeste",1,"351120",5,8,0,8,3,5,0,0,0,0,0,8,0,8,3,5,2,9.62106562125264,8.96890555068972,0.389866529765315,31
"9541","SP","Cedral",9346,34238.37,35004,"São José do Rio Preto",3,"Sudeste",1,"351130",2,7,1,6,5,2,0,0,0,0,0,7,1,6,5,2,9,10.4411022239823,9.14270372326037,0.284664917079802,29
"9542","SP","Cedral",9346,34238.37,35004,"São José do Rio Preto",3,"Sudeste",1,"351130",3,9,1,8,2,7,0,0,0,0,0,9,1,8,2,7,8,10.4411022239823,9.14270372326037,0.368611541086753,31
"9543","SP","Cedral",9346,34238.37,35004,"São José do Rio Preto",3,"Sudeste",1,"351130",4,11,3,8,4,7,0,0,0,0,0,11,3,8,4,7,4,10.4411022239823,9.14270372326037,0.408061514267961,30
"9544","SP","Cedral",9346,34238.37,35004,"São José do Rio Preto",3,"Sudeste",1,"351130",5,13,4,9,1,12,0,0,0,0,0,13,4,9,1,12,10,10.4411022239823,9.14270372326037,0.370551824006861,31
"9545","SP","Cerqueira César",20191,30605.21,35022,"Avaré",3,"Sudeste",1,"351140",2,15,3,12,6,9,0,0,0,0,0,15,3,12,6,9,4,10.3289255348855,9.91299223955037,0.322497017476675,29
"9546","SP","Cerqueira César",20191,30605.21,35022,"Avaré",3,"Sudeste",1,"351140",3,19,5,14,6,13,0,0,0,0,0,19,5,14,6,13,11,10.3289255348855,9.91299223955037,0.409189329673813,31
"9547","SP","Cerqueira César",20191,30605.21,35022,"Avaré",3,"Sudeste",1,"351140",4,19,5,14,4,15,1,0,1,1,0,20,5,15,5,15,15,10.3289255348855,9.91299223955037,0.439465819065462,30
"9548","SP","Cerqueira César",20191,30605.21,35022,"Avaré",3,"Sudeste",1,"351140",5,24,5,19,14,10,0,0,0,0,0,24,5,19,14,10,16,10.3289255348855,9.91299223955037,0.409489220686582,31
"9549","SP","Cerquilho",49802,38133.41,35043,"Tatuí",3,"Sudeste",1,"351150",2,41,6,35,10,31,0,0,0,0,0,41,6,35,10,31,17,10.5488460797472,10.8158104228489,0.306385776951592,29
"9550","SP","Cerquilho",49802,38133.41,35043,"Tatuí",3,"Sudeste",1,"351150",3,36,4,32,13,23,0,0,0,0,0,36,4,32,13,23,21,10.5488460797472,10.8158104228489,0.394282695420062,31
"9551","SP","Cerquilho",49802,38133.41,35043,"Tatuí",3,"Sudeste",1,"351150",4,31,5,26,12,19,0,0,0,0,0,31,5,26,12,19,21,10.5488460797472,10.8158104228489,0.446865083564567,30
"9552","SP","Cerquilho",49802,38133.41,35043,"Tatuí",3,"Sudeste",1,"351150",5,40,2,38,13,27,2,1,1,1,1,42,3,39,14,28,22,10.5488460797472,10.8158104228489,0.408417327276077,31
"9553","SP","Cesário Lange",18375,24128.03,35043,"Tatuí",3,"Sudeste",0,"351160",2,11,4,7,1,10,0,0,0,0,0,11,4,7,1,10,14,10.0911295141756,9.81874632408104,0.308959808202603,29
"9554","SP","Cesário Lange",18375,24128.03,35043,"Tatuí",3,"Sudeste",0,"351160",3,18,2,16,7,11,0,0,0,0,0,18,2,16,7,11,14,10.0911295141756,9.81874632408104,0.396086629270076,31
"9555","SP","Cesário Lange",18375,24128.03,35043,"Tatuí",3,"Sudeste",0,"351160",4,15,3,12,5,10,0,0,0,0,0,15,3,12,5,10,11,10.0911295141756,9.81874632408104,0.458121341655575,30
"9556","SP","Cesário Lange",18375,24128.03,35043,"Tatuí",3,"Sudeste",0,"351160",5,24,7,17,9,15,0,0,0,0,0,24,7,17,9,15,16,10.0911295141756,9.81874632408104,0.432982966464747,31
"9557","SP","Charqueada",17367,20806.95,35028,"Piracicaba",3,"Sudeste",1,"351170",2,11,1,10,8,3,0,0,0,0,0,11,1,10,8,3,9,9.94304234449426,9.76232713274711,0.31205089490268,29
"9558","SP","Charqueada",17367,20806.95,35028,"Piracicaba",3,"Sudeste",1,"351170",3,14,1,13,1,13,0,0,0,0,0,14,1,13,1,13,8,9.94304234449426,9.76232713274711,0.391534594000913,31
"9559","SP","Charqueada",17367,20806.95,35028,"Piracicaba",3,"Sudeste",1,"351170",4,21,5,16,5,16,1,0,1,0,1,22,5,17,5,17,15,9.94304234449426,9.76232713274711,0.418124371734343,30
"9560","SP","Charqueada",17367,20806.95,35028,"Piracicaba",3,"Sudeste",1,"351170",5,20,6,14,7,13,0,0,0,0,0,20,6,14,7,13,19,9.94304234449426,9.76232713274711,0.43413592893407,31
"9561","SP","Clementina",8757,25945.35,35018,"Birigui",3,"Sudeste",0,"351190",2,5,1,4,2,3,0,0,0,0,0,5,1,4,2,3,3,10.163747681786,9.07760865952222,0.289545304996928,29
"9562","SP","Clementina",8757,25945.35,35018,"Birigui",3,"Sudeste",0,"351190",3,5,0,5,2,3,0,0,0,0,0,5,0,5,2,3,1,10.163747681786,9.07760865952222,0.371763075952815,31
"9563","SP","Clementina",8757,25945.35,35018,"Birigui",3,"Sudeste",0,"351190",4,4,1,3,2,2,0,0,0,0,0,4,1,3,2,2,5,10.163747681786,9.07760865952222,0.381910783197279,30
"9564","SP","Clementina",8757,25945.35,35018,"Birigui",3,"Sudeste",0,"351190",5,9,1,8,5,4,0,0,0,0,0,9,1,8,5,4,3,10.163747681786,9.07760865952222,0.363414504840017,31
"9565","SP","Colina",18535,60218.14,35009,"Barretos",3,"Sudeste",1,"351200",2,12,5,7,1,11,0,0,0,0,0,12,5,7,1,11,10,11.0057289148101,9.82741611558483,0.312420817316295,29
"9566","SP","Colina",18535,60218.14,35009,"Barretos",3,"Sudeste",1,"351200",3,23,5,18,9,14,1,0,1,0,1,24,5,19,9,15,10,11.0057289148101,9.82741611558483,0.379618969164093,31
"9567","SP","Colina",18535,60218.14,35009,"Barretos",3,"Sudeste",1,"351200",4,16,1,15,8,8,0,0,0,0,0,16,1,15,8,8,14,11.0057289148101,9.82741611558483,0.404645164680055,30
"9568","SP","Colina",18535,60218.14,35009,"Barretos",3,"Sudeste",1,"351200",5,21,7,14,12,9,2,0,2,1,1,23,7,16,13,10,10,11.0057289148101,9.82741611558483,0.369511692268557,31
"9569","SP","Colômbia",6216,53207.43,35009,"Barretos",3,"Sudeste",1,"351210",2,7,0,7,4,3,0,0,0,0,0,7,0,7,4,3,3,10.8819533272321,8.73488189204748,0.35933432182181,29
"9570","SP","Colômbia",6216,53207.43,35009,"Barretos",3,"Sudeste",1,"351210",3,7,2,5,2,5,0,0,0,0,0,7,2,5,2,5,5,10.8819533272321,8.73488189204748,0.424751260537912,31
"9571","SP","Colômbia",6216,53207.43,35009,"Barretos",3,"Sudeste",1,"351210",4,9,2,7,4,5,0,0,0,0,0,9,2,7,4,5,3,10.8819533272321,8.73488189204748,0.43146384726265,30
"9572","SP","Colômbia",6216,53207.43,35009,"Barretos",3,"Sudeste",1,"351210",5,4,0,4,1,3,0,0,0,0,0,4,0,4,1,3,3,10.8819533272321,8.73488189204748,0.418031807910656,31
"9573","SP","Conchal",28273,24884.49,35027,"Limeira",3,"Sudeste",1,"351220",2,35,10,25,17,18,0,0,0,0,0,35,10,25,17,18,12,10.121999996809,10.2496625646187,0.305411669813229,29
"9574","SP","Conchal",28273,24884.49,35027,"Limeira",3,"Sudeste",1,"351220",3,31,7,24,11,20,0,0,0,0,0,31,7,24,11,20,14,10.121999996809,10.2496625646187,0.397601412309487,31
"9575","SP","Conchal",28273,24884.49,35027,"Limeira",3,"Sudeste",1,"351220",4,32,9,23,13,19,0,0,0,0,0,32,9,23,13,19,18,10.121999996809,10.2496625646187,0.437185825938463,30
"9576","SP","Conchal",28273,24884.49,35027,"Limeira",3,"Sudeste",1,"351220",5,35,6,29,19,16,0,0,0,0,0,35,6,29,19,16,25,10.121999996809,10.2496625646187,0.403633397228869,31
"9577","SP","Conchas",18019,19830.73,35023,"Botucatu",3,"Sudeste",0,"351230",2,10,2,8,4,6,0,0,0,0,0,10,2,8,4,6,11,9.894988033746,9.79918203572681,0.313656467031812,29
"9578","SP","Conchas",18019,19830.73,35023,"Botucatu",3,"Sudeste",0,"351230",3,16,3,13,9,7,0,0,0,0,0,16,3,13,9,7,13,9.894988033746,9.79918203572681,0.408693665117491,31
"9579","SP","Conchas",18019,19830.73,35023,"Botucatu",3,"Sudeste",0,"351230",4,15,6,9,7,8,0,0,0,0,0,15,6,9,7,8,10,9.894988033746,9.79918203572681,0.440343974710149,30
"9580","SP","Conchas",18019,19830.73,35023,"Botucatu",3,"Sudeste",0,"351230",5,17,4,13,8,9,0,0,0,0,0,17,4,13,8,9,12,9.894988033746,9.79918203572681,0.441335734199353,31
"9581","SP","Cordeirópolis",24826,116519.63,35027,"Limeira",3,"Sudeste",1,"351240",2,15,3,12,4,11,0,0,0,0,0,15,3,12,4,11,16,11.6658150356478,10.1196467700759,0.303056905984753,29
"9582","SP","Cordeirópolis",24826,116519.63,35027,"Limeira",3,"Sudeste",1,"351240",3,36,5,31,11,25,0,0,0,0,0,36,5,31,11,25,10,11.6658150356478,10.1196467700759,0.388388446439111,31
"9583","SP","Cordeirópolis",24826,116519.63,35027,"Limeira",3,"Sudeste",1,"351240",4,13,3,10,5,8,0,0,0,0,0,13,3,10,5,8,16,11.6658150356478,10.1196467700759,0.436218714894517,30
"9584","SP","Cordeirópolis",24826,116519.63,35027,"Limeira",3,"Sudeste",1,"351240",5,21,2,19,8,13,0,0,0,0,0,21,2,19,8,13,14,11.6658150356478,10.1196467700759,0.40362436850296,31
"9585","SP","Coroados",6129,27648.49,35018,"Birigui",3,"Sudeste",1,"351250",2,4,0,4,1,3,0,0,0,0,0,4,0,4,1,3,5,10.2273263942477,8.72078688348573,0.302329065036651,29
"9586","SP","Coroados",6129,27648.49,35018,"Birigui",3,"Sudeste",1,"351250",3,7,2,5,5,2,0,0,0,0,0,7,2,5,5,2,1,10.2273263942477,8.72078688348573,0.392620838422675,31
"9587","SP","Coroados",6129,27648.49,35018,"Birigui",3,"Sudeste",1,"351250",4,5,1,4,0,5,0,0,0,0,0,5,1,4,0,5,0,10.2273263942477,8.72078688348573,0.43272880475329,30
"9588","SP","Coroados",6129,27648.49,35018,"Birigui",3,"Sudeste",1,"351250",5,3,0,3,2,1,0,0,0,0,0,3,0,3,2,1,5,10.2273263942477,8.72078688348573,0.401190900049079,31
"9589","SP","Corumbataí",4064,61418.68,35026,"Rio Claro",3,"Sudeste",0,"351270",2,4,0,4,2,2,0,0,0,0,0,4,0,4,2,2,4,11.025469302393,8.30992298925832,0.31450265207166,29
"9590","SP","Corumbataí",4064,61418.68,35026,"Rio Claro",3,"Sudeste",0,"351270",3,6,2,4,2,4,0,0,0,0,0,6,2,4,2,4,2,11.025469302393,8.30992298925832,0.37527150193013,31
"9591","SP","Corumbataí",4064,61418.68,35026,"Rio Claro",3,"Sudeste",0,"351270",4,6,0,6,1,5,0,0,0,0,0,6,0,6,1,5,1,11.025469302393,8.30992298925832,0.386143110755906,30
"9592","SP","Corumbataí",4064,61418.68,35026,"Rio Claro",3,"Sudeste",0,"351270",5,3,0,3,0,3,0,0,0,0,0,3,0,3,0,3,8,11.025469302393,8.30992298925832,0.393197766870133,31
"9593","SP","Cosmópolis",73474,22410.36,35032,"Campinas",3,"Sudeste",1,"351280",2,42,11,31,14,28,0,0,0,0,0,42,11,31,14,28,15,10.017278630923,11.204686881123,0.308711261894681,29
"9594","SP","Cosmópolis",73474,22410.36,35032,"Campinas",3,"Sudeste",1,"351280",3,50,11,39,15,35,0,0,0,0,0,50,11,39,15,35,31,10.017278630923,11.204686881123,0.39488674361418,31
"9595","SP","Cosmópolis",73474,22410.36,35032,"Campinas",3,"Sudeste",1,"351280",4,52,11,41,16,36,1,0,1,1,0,53,11,42,17,36,38,10.017278630923,11.204686881123,0.442076004405461,30
"9596","SP","Cosmópolis",73474,22410.36,35032,"Campinas",3,"Sudeste",1,"351280",5,59,9,50,15,44,0,0,0,0,0,59,9,50,15,44,36,10.017278630923,11.204686881123,0.419813058112352,31
"9597","SP","Cosmorama",7298,45912.53,35003,"Votuporanga",3,"Sudeste",0,"351290",2,4,1,3,1,3,0,0,0,0,0,4,1,3,1,3,4,10.7344933435445,8.89535561699639,0.319459259626676,29
"9598","SP","Cosmorama",7298,45912.53,35003,"Votuporanga",3,"Sudeste",0,"351290",3,10,1,9,4,6,0,0,0,0,0,10,1,9,4,6,5,10.7344933435445,8.89535561699639,0.393087372583662,31
"9599","SP","Cosmorama",7298,45912.53,35003,"Votuporanga",3,"Sudeste",0,"351290",4,6,2,4,2,4,0,0,0,0,0,6,2,4,2,4,7,10.7344933435445,8.89535561699639,0.405782205233928,30
"9600","SP","Cosmorama",7298,45912.53,35003,"Votuporanga",3,"Sudeste",0,"351290",5,5,1,4,1,4,0,0,0,0,0,5,1,4,1,4,9,10.7344933435445,8.89535561699639,0.390690993339852,31
"9601","SP","Cotia",253608,51225.49,35060,"Itapecerica da Serra",3,"Sudeste",1,"351300",2,307,51,256,96,211,5,0,5,2,3,312,51,261,98,214,117,10.8439925387031,12.443545046789,0.30135480648115,29
"9602","SP","Cotia",253608,51225.49,35060,"Itapecerica da Serra",3,"Sudeste",1,"351300",3,296,41,255,91,205,0,0,0,0,0,296,41,255,91,205,128,10.8439925387031,12.443545046789,0.404594640595443,31
"9603","SP","Cotia",253608,51225.49,35060,"Itapecerica da Serra",3,"Sudeste",1,"351300",4,325,40,285,119,206,3,1,2,2,1,328,41,287,121,207,137,10.8439925387031,12.443545046789,0.485098527734779,30
"9604","SP","Cotia",253608,51225.49,35060,"Itapecerica da Serra",3,"Sudeste",1,"351300",5,323,57,266,104,219,3,0,3,2,1,326,57,269,106,220,164,10.8439925387031,12.443545046789,0.456906314815962,31
"9605","SP","Cravinhos",35579,34165.63,35014,"Ribeirão Preto",3,"Sudeste",1,"351310",2,34,9,25,14,20,0,0,0,0,0,34,9,25,14,20,12,10.4389754469688,10.4795108551475,0.28770311736933,29
"9606","SP","Cravinhos",35579,34165.63,35014,"Ribeirão Preto",3,"Sudeste",1,"351310",3,29,5,24,12,17,0,0,0,0,0,29,5,24,12,17,20,10.4389754469688,10.4795108551475,0.369544014281035,31
"9607","SP","Cravinhos",35579,34165.63,35014,"Ribeirão Preto",3,"Sudeste",1,"351310",4,26,4,22,6,20,0,0,0,0,0,26,4,22,6,20,20,10.4389754469688,10.4795108551475,0.416172337281536,30
"9608","SP","Cravinhos",35579,34165.63,35014,"Ribeirão Preto",3,"Sudeste",1,"351310",5,32,7,25,6,26,0,0,0,0,0,32,7,25,6,26,26,10.4389754469688,10.4795108551475,0.36945209566874,31
"9609","SP","Cristais Paulista",8718,22617.1,35012,"Franca",3,"Sudeste",1,"351320",2,6,1,5,3,3,0,0,0,0,0,6,1,5,3,3,2,10.0264615363229,9.07314513279834,0.285227227709591,29
"9610","SP","Cristais Paulista",8718,22617.1,35012,"Franca",3,"Sudeste",1,"351320",3,11,2,9,2,9,0,0,0,0,0,11,2,9,2,9,4,10.0264615363229,9.07314513279834,0.381917464733399,31
"9611","SP","Cristais Paulista",8718,22617.1,35012,"Franca",3,"Sudeste",1,"351320",4,10,2,8,1,9,0,0,0,0,0,10,2,8,1,9,3,10.0264615363229,9.07314513279834,0.428705003214516,30
"9612","SP","Cristais Paulista",8718,22617.1,35012,"Franca",3,"Sudeste",1,"351320",5,11,3,8,3,8,0,0,0,0,0,11,3,8,3,8,9,10.0264615363229,9.07314513279834,0.39441364153711,31
"9613","SP","Cruzeiro",82571,29743.19,35051,"Guaratinguetá",3,"Sudeste",1,"351340",2,66,7,59,18,48,0,0,0,0,0,66,7,59,18,48,60,10.3003554772074,11.3214138082743,0.31017063371217,29
"9614","SP","Cruzeiro",82571,29743.19,35051,"Guaratinguetá",3,"Sudeste",1,"351340",3,82,11,71,29,53,0,0,0,0,0,82,11,71,29,53,59,10.3003554772074,11.3214138082743,0.416749405544124,31
"9615","SP","Cruzeiro",82571,29743.19,35051,"Guaratinguetá",3,"Sudeste",1,"351340",4,51,5,46,22,29,0,0,0,0,0,51,5,46,22,29,43,10.3003554772074,11.3214138082743,0.491598885001895,30
"9616","SP","Cruzeiro",82571,29743.19,35051,"Guaratinguetá",3,"Sudeste",1,"351340",5,77,5,72,26,51,0,0,0,0,0,77,5,72,26,51,52,10.3003554772074,11.3214138082743,0.444864840036321,31
"9617","SP","Cubatão",131626,101597.09,35063,"Santos",3,"Sudeste",1,"351350",2,103,19,84,35,68,3,1,2,0,3,106,20,86,35,71,63,11.5287701719841,11.7877198467483,0.315945337929793,29
"9618","SP","Cubatão",131626,101597.09,35063,"Santos",3,"Sudeste",1,"351350",3,110,22,88,42,68,0,0,0,0,0,110,22,88,42,68,67,11.5287701719841,11.7877198467483,0.412489237702583,31
"9619","SP","Cubatão",131626,101597.09,35063,"Santos",3,"Sudeste",1,"351350",4,98,19,79,35,63,1,0,1,0,1,99,19,80,35,64,70,11.5287701719841,11.7877198467483,0.470257834188711,30
"9620","SP","Cubatão",131626,101597.09,35063,"Santos",3,"Sudeste",1,"351350",5,103,25,78,34,69,1,1,0,1,0,104,26,78,35,69,136,11.5287701719841,11.7877198467483,0.455891576848363,31
"9621","SP","Cunha",21459,11971.43,35053,"Paraibuna/Paraitinga",3,"Sudeste",0,"351360",2,22,4,18,6,16,0,0,0,0,0,22,4,18,6,16,12,9.3902782567466,9.97389941677649,0.336479237155338,29
"9622","SP","Cunha",21459,11971.43,35053,"Paraibuna/Paraitinga",3,"Sudeste",0,"351360",3,12,4,8,1,11,0,0,0,0,0,12,4,8,1,11,20,9.3902782567466,9.97389941677649,0.443845312377337,31
"9623","SP","Cunha",21459,11971.43,35053,"Paraibuna/Paraitinga",3,"Sudeste",0,"351360",4,18,5,13,4,14,1,0,1,0,1,19,5,14,4,15,14,9.3902782567466,9.97389941677649,0.465243714526511,30
"9624","SP","Cunha",21459,11971.43,35053,"Paraibuna/Paraitinga",3,"Sudeste",0,"351360",5,23,9,14,10,13,0,0,0,0,0,23,9,14,10,13,14,9.3902782567466,9.97389941677649,0.447686456294915,31
"9625","SP","Descalvado",33910,47327.8,35025,"São Carlos",3,"Sudeste",1,"351370",2,30,5,25,15,15,0,0,0,0,0,30,5,25,15,15,15,10.7648531396733,10.4314652351197,0.317582021472799,29
"9626","SP","Descalvado",33910,47327.8,35025,"São Carlos",3,"Sudeste",1,"351370",3,38,7,31,14,24,0,0,0,0,0,38,7,31,14,24,18,10.7648531396733,10.4314652351197,0.393115562136824,31
"9627","SP","Descalvado",33910,47327.8,35025,"São Carlos",3,"Sudeste",1,"351370",4,26,4,22,9,17,1,0,1,0,1,27,4,23,9,18,21,10.7648531396733,10.4314652351197,0.42990870343612,30
"9628","SP","Descalvado",33910,47327.8,35025,"São Carlos",3,"Sudeste",1,"351370",5,34,5,29,9,25,0,0,0,0,0,34,5,29,9,25,22,10.7648531396733,10.4314652351197,0.408430746899722,31
"9629","SP","Diadema",426757,34855.75,35061,"São Paulo",3,"Sudeste",1,"351380",2,373,39,334,140,233,1,0,1,0,1,374,39,335,140,234,185,10.4589733954053,12.9639700435684,0.289745681118719,29
"9630","SP","Diadema",426757,34855.75,35061,"São Paulo",3,"Sudeste",1,"351380",3,351,41,310,110,241,4,0,4,2,2,355,41,314,112,243,200,10.4589733954053,12.9639700435684,0.404070489307883,31
"9631","SP","Diadema",426757,34855.75,35061,"São Paulo",3,"Sudeste",1,"351380",4,363,41,322,108,255,4,1,3,0,4,367,42,325,108,259,231,10.4589733954053,12.9639700435684,0.496914475835012,30
"9632","SP","Diadema",426757,34855.75,35061,"São Paulo",3,"Sudeste",1,"351380",5,372,40,332,125,247,0,0,0,0,0,372,40,332,125,247,281,10.4589733954053,12.9639700435684,0.466000028212017,31
"9633","SP","Divinolândia",11086,24940.84,35030,"São João da Boa Vista",3,"Sudeste",0,"351390",2,8,0,8,1,7,0,0,0,0,0,8,0,8,1,7,13,10.1242618995008,9.31343832997975,0.309830457939522,29
"9634","SP","Divinolândia",11086,24940.84,35030,"São João da Boa Vista",3,"Sudeste",0,"351390",3,10,2,8,1,9,0,0,0,0,0,10,2,8,1,9,12,10.1242618995008,9.31343832997975,0.383244088144063,31
"9635","SP","Divinolândia",11086,24940.84,35030,"São João da Boa Vista",3,"Sudeste",0,"351390",4,13,2,11,2,11,0,0,0,0,0,13,2,11,2,11,6,10.1242618995008,9.31343832997975,0.415317569256327,30
"9636","SP","Divinolândia",11086,24940.84,35030,"São João da Boa Vista",3,"Sudeste",0,"351390",5,11,3,8,3,8,1,0,1,0,1,12,3,9,3,9,11,10.1242618995008,9.31343832997975,0.414557427239985,31
"9637","SP","Dobrada",9010,13045.55,35024,"Araraquara",3,"Sudeste",0,"351400",2,7,1,6,3,4,0,0,0,0,0,7,1,6,3,4,2,9.47620235842984,9.10609035060238,0.334781258809056,29
"9638","SP","Dobrada",9010,13045.55,35024,"Araraquara",3,"Sudeste",0,"351400",3,9,1,8,4,5,0,0,0,0,0,9,1,8,4,5,4,9.47620235842984,9.10609035060238,0.432970034293918,31
"9639","SP","Dobrada",9010,13045.55,35024,"Araraquara",3,"Sudeste",0,"351400",4,11,1,10,2,9,0,0,0,0,0,11,1,10,2,9,6,9.47620235842984,9.10609035060238,0.438746049431099,30
"9640","SP","Dobrada",9010,13045.55,35024,"Araraquara",3,"Sudeste",0,"351400",5,11,2,9,2,9,0,0,0,0,0,11,2,9,2,9,3,9.47620235842984,9.10609035060238,0.414951727604668,31
"9641","SP","Dois Córregos",27512,23896.69,35021,"Jaú",3,"Sudeste",1,"351410",2,7,1,6,1,6,0,0,0,0,0,7,1,6,1,6,13,10.0814952346046,10.2223775521121,0.332462787005719,29
"9642","SP","Dois Córregos",27512,23896.69,35021,"Jaú",3,"Sudeste",1,"351410",3,9,2,7,4,5,1,1,0,1,0,10,3,7,5,5,15,10.0814952346046,10.2223775521121,0.397365910904459,31
"9643","SP","Dois Córregos",27512,23896.69,35021,"Jaú",3,"Sudeste",1,"351410",4,6,1,5,1,5,0,0,0,0,0,6,1,5,1,5,5,10.0814952346046,10.2223775521121,0.440349552019569,30
"9644","SP","Dois Córregos",27512,23896.69,35021,"Jaú",3,"Sudeste",1,"351410",5,7,1,6,3,4,0,0,0,0,0,7,1,6,3,4,22,10.0814952346046,10.2223775521121,0.417845229739914,31
"9645","SP","Dourado",8878,70723.95,35025,"São Carlos",3,"Sudeste",0,"351430",2,7,1,6,4,3,0,0,0,0,0,7,1,6,4,3,10,11.1665395498241,9.09133158539398,0.301684004886141,29
"9646","SP","Dourado",8878,70723.95,35025,"São Carlos",3,"Sudeste",0,"351430",3,7,0,7,1,6,0,0,0,0,0,7,0,7,1,6,7,11.1665395498241,9.09133158539398,0.373107779065429,31
"9647","SP","Dourado",8878,70723.95,35025,"São Carlos",3,"Sudeste",0,"351430",4,7,0,7,5,2,0,0,0,0,0,7,0,7,5,2,7,11.1665395498241,9.09133158539398,0.42208969673846,30
"9648","SP","Dourado",8878,70723.95,35025,"São Carlos",3,"Sudeste",0,"351430",5,1,0,1,0,1,0,0,0,0,0,1,0,1,0,1,6,11.1665395498241,9.09133158539398,0.348243191372715,31
"9649","SP","Dracena",47043,25779.84,35034,"Dracena",3,"Sudeste",1,"351440",2,39,4,35,5,34,0,0,0,0,0,39,4,35,5,34,37,10.1573480701124,10.7588173560491,0.286334891439384,29
"9650","SP","Dracena",47043,25779.84,35034,"Dracena",3,"Sudeste",1,"351440",3,36,6,30,12,24,0,0,0,0,0,36,6,30,12,24,36,10.1573480701124,10.7588173560491,0.371157111419075,31
"9651","SP","Dracena",47043,25779.84,35034,"Dracena",3,"Sudeste",1,"351440",4,33,3,30,5,28,1,0,1,0,1,34,3,31,5,29,39,10.1573480701124,10.7588173560491,0.431850954690068,30
"9652","SP","Dracena",47043,25779.84,35034,"Dracena",3,"Sudeste",1,"351440",5,43,5,38,14,29,0,0,0,0,0,43,5,38,14,29,24,10.1573480701124,10.7588173560491,0.399915802404008,31
"9653","SP","Duartina",12433,19047.83,35020,"Bauru",3,"Sudeste",1,"351450",2,10,2,8,2,8,0,0,0,0,0,10,2,8,2,8,8,9.85470846330537,9.42810950695294,0.278217562795481,29
"9654","SP","Duartina",12433,19047.83,35020,"Bauru",3,"Sudeste",1,"351450",3,11,3,8,4,7,0,0,0,0,0,11,3,8,4,7,9,9.85470846330537,9.42810950695294,0.360058990508974,31
"9655","SP","Duartina",12433,19047.83,35020,"Bauru",3,"Sudeste",1,"351450",4,7,1,6,1,6,0,0,0,0,0,7,1,6,1,6,5,9.85470846330537,9.42810950695294,0.388503038066897,30
"9656","SP","Duartina",12433,19047.83,35020,"Bauru",3,"Sudeste",1,"351450",5,18,3,15,8,10,0,0,0,0,0,18,3,15,8,10,10,9.85470846330537,9.42810950695294,0.340514242890883,31
"9657","SP","Dumont",10023,23587.84,35014,"Ribeirão Preto",3,"Sudeste",0,"351460",2,4,1,3,1,3,0,0,0,0,0,4,1,3,1,3,4,10.0684866039873,9.21263773102487,0.283256398172354,29
"9658","SP","Dumont",10023,23587.84,35014,"Ribeirão Preto",3,"Sudeste",0,"351460",3,6,0,6,2,4,0,0,0,0,0,6,0,6,2,4,5,10.0684866039873,9.21263773102487,0.365197753130804,31
"9659","SP","Dumont",10023,23587.84,35014,"Ribeirão Preto",3,"Sudeste",0,"351460",4,7,3,4,4,3,0,0,0,0,0,7,3,4,4,3,1,10.0684866039873,9.21263773102487,0.415901467059976,30
"9660","SP","Dumont",10023,23587.84,35014,"Ribeirão Preto",3,"Sudeste",0,"351460",5,7,3,4,3,4,0,0,0,0,0,7,3,4,3,4,6,10.0684866039873,9.21263773102487,0.375574331550696,31
"9661","SP","Echaporã",6064,20426.97,35038,"Marília",3,"Sudeste",0,"351470",2,6,1,5,2,4,0,0,0,0,0,6,1,5,2,4,3,9.92461136550556,8.71012492732221,0.310089791162104,29
"9662","SP","Echaporã",6064,20426.97,35038,"Marília",3,"Sudeste",0,"351470",3,8,4,4,3,5,0,0,0,0,0,8,4,4,3,5,1,9.92461136550556,8.71012492732221,0.359726091142074,31
"9663","SP","Echaporã",6064,20426.97,35038,"Marília",3,"Sudeste",0,"351470",4,3,0,3,2,1,0,0,0,0,0,3,0,3,2,1,4,9.92461136550556,8.71012492732221,0.404803551111324,30
"9664","SP","Echaporã",6064,20426.97,35038,"Marília",3,"Sudeste",0,"351470",5,4,1,3,1,3,0,0,0,0,0,4,1,3,1,3,5,9.92461136550556,8.71012492732221,0.400867622385273,31
"9665","SP","Eldorado",15544,20795.32,35055,"Registro",3,"Sudeste",0,"351480",2,12,4,8,2,10,0,0,0,0,0,12,4,8,2,10,3,9.94248324037311,9.65142999105728,0.374759167392436,29
"9666","SP","Eldorado",15544,20795.32,35055,"Registro",3,"Sudeste",0,"351480",3,18,2,16,7,11,0,0,0,0,0,18,2,16,7,11,6,9.94248324037311,9.65142999105728,0.444685379537662,31
"9667","SP","Eldorado",15544,20795.32,35055,"Registro",3,"Sudeste",0,"351480",4,22,5,17,13,9,0,0,0,0,0,22,5,17,13,9,14,9.94248324037311,9.65142999105728,0.473518551883161,30
"9668","SP","Eldorado",15544,20795.32,35055,"Registro",3,"Sudeste",0,"351480",5,15,6,9,4,11,0,0,0,0,0,15,6,9,4,11,10,9.94248324037311,9.65142999105728,0.464321255727978,31
"9669","SP","Elias Fausto",17936,40144.54,35032,"Campinas",3,"Sudeste",0,"351490",2,15,4,11,9,6,0,0,0,0,0,15,4,11,9,6,12,10.6002417200901,9.79456514531194,0.316088644798476,29
"9670","SP","Elias Fausto",17936,40144.54,35032,"Campinas",3,"Sudeste",0,"351490",3,15,1,14,6,9,1,0,1,0,1,16,1,15,6,10,6,10.6002417200901,9.79456514531194,0.394772264280279,31
"9671","SP","Elias Fausto",17936,40144.54,35032,"Campinas",3,"Sudeste",0,"351490",4,14,1,13,7,7,0,0,0,0,0,14,1,13,7,7,8,10.6002417200901,9.79456514531194,0.442060343699911,30
"9672","SP","Elias Fausto",17936,40144.54,35032,"Campinas",3,"Sudeste",0,"351490",5,21,4,17,6,15,1,1,0,0,1,22,5,17,6,16,7,10.6002417200901,9.79456514531194,0.424767244260321,31
"9673","SP","Embu das Artes",276535,48914.66,35060,"Itapecerica da Serra",3,"Sudeste",1,"351500",2,302,55,247,101,201,2,0,2,0,2,304,55,249,101,203,116,10.7978324260343,12.5300926742121,0.295948871906387,29
"9674","SP","Embu das Artes",276535,48914.66,35060,"Itapecerica da Serra",3,"Sudeste",1,"351500",3,258,39,219,95,163,1,0,1,0,1,259,39,220,95,164,124,10.7978324260343,12.5300926742121,0.394668983513191,31
"9675","SP","Embu das Artes",276535,48914.66,35060,"Itapecerica da Serra",3,"Sudeste",1,"351500",4,281,34,247,103,178,3,2,1,2,1,284,36,248,105,179,141,10.7978324260343,12.5300926742121,0.465093771780397,30
"9676","SP","Embu das Artes",276535,48914.66,35060,"Itapecerica da Serra",3,"Sudeste",1,"351500",5,306,50,256,113,193,4,1,3,1,3,310,51,259,114,196,179,10.7978324260343,12.5300926742121,0.440972854609784,31
"9677","SP","Embu-Guaçu",69901,16293.33,35060,"Itapecerica da Serra",3,"Sudeste",1,"351510",2,56,10,46,22,34,0,0,0,0,0,56,10,46,22,34,41,9.6985111005947,11.1548352342712,0.306180109528439,29
"9678","SP","Embu-Guaçu",69901,16293.33,35060,"Itapecerica da Serra",3,"Sudeste",1,"351510",3,59,6,53,19,40,0,0,0,0,0,59,6,53,19,40,39,9.6985111005947,11.1548352342712,0.40050503387585,31
"9679","SP","Embu-Guaçu",69901,16293.33,35060,"Itapecerica da Serra",3,"Sudeste",1,"351510",4,84,8,76,42,42,0,0,0,0,0,84,8,76,42,42,35,9.6985111005947,11.1548352342712,0.470725369883483,30
"9680","SP","Embu-Guaçu",69901,16293.33,35060,"Itapecerica da Serra",3,"Sudeste",1,"351510",5,80,11,69,27,53,1,0,1,0,1,81,11,70,27,54,68,9.6985111005947,11.1548352342712,0.4601658984391,31
"9681","SP","Engenheiro Coelho",21249,32701.36,35031,"Mogi Mirim",3,"Sudeste",1,"351515",2,18,4,14,7,11,0,0,0,0,0,18,4,14,7,11,6,10.3951719462346,9.96406511442173,0.339590188718698,29
"9682","SP","Engenheiro Coelho",21249,32701.36,35031,"Mogi Mirim",3,"Sudeste",1,"351515",3,23,5,18,11,12,0,0,0,0,0,23,5,18,11,12,2,10.3951719462346,9.96406511442173,0.418391656078969,31
"9683","SP","Engenheiro Coelho",21249,32701.36,35031,"Mogi Mirim",3,"Sudeste",1,"351515",4,14,4,10,5,9,0,0,0,0,0,14,4,10,5,9,6,10.3951719462346,9.96406511442173,0.452240347091368,30
"9684","SP","Engenheiro Coelho",21249,32701.36,35031,"Mogi Mirim",3,"Sudeste",1,"351515",5,22,5,17,8,14,0,0,0,0,0,22,5,17,8,14,9,10.3951719462346,9.96406511442173,0.432798935231908,31
"9685","SP","Espírito Santo do Pinhal",44471,32436.36,35030,"São João da Boa Vista",3,"Sudeste",1,"351518",2,43,6,37,6,37,0,0,0,0,0,43,6,37,6,37,19,10.387035294782,10.7025925703218,0.312085260819353,29
"9686","SP","Espírito Santo do Pinhal",44471,32436.36,35030,"São João da Boa Vista",3,"Sudeste",1,"351518",3,38,7,31,10,28,1,0,1,0,1,39,7,32,10,29,36,10.387035294782,10.7025925703218,0.394483306203252,31
"9687","SP","Espírito Santo do Pinhal",44471,32436.36,35030,"São João da Boa Vista",3,"Sudeste",1,"351518",4,34,7,27,18,16,0,0,0,0,0,34,7,27,18,16,24,10.387035294782,10.7025925703218,0.471672322324153,30
"9688","SP","Espírito Santo do Pinhal",44471,32436.36,35030,"São João da Boa Vista",3,"Sudeste",1,"351518",5,34,5,29,11,23,1,0,1,1,0,35,5,30,12,23,25,10.387035294782,10.7025925703218,0.423228886512786,31
"9689","SP","Espírito Santo do Turvo",4878,16466.12,35040,"Ourinhos",3,"Sudeste",0,"351519",2,4,1,3,3,1,0,0,0,0,0,4,1,3,3,1,4,9.70906021557626,8.49249057877587,0.334266656487765,29
"9690","SP","Espírito Santo do Turvo",4878,16466.12,35040,"Ourinhos",3,"Sudeste",0,"351519",3,3,0,3,0,3,0,0,0,0,0,3,0,3,0,3,3,9.70906021557626,8.49249057877587,0.424799678961449,31
"9691","SP","Espírito Santo do Turvo",4878,16466.12,35040,"Ourinhos",3,"Sudeste",0,"351519",4,7,1,6,3,4,0,0,0,0,0,7,1,6,3,4,0,9.70906021557626,8.49249057877587,0.455479666113297,30
"9692","SP","Espírito Santo do Turvo",4878,16466.12,35040,"Ourinhos",3,"Sudeste",0,"351519",5,4,2,2,3,1,0,0,0,0,0,4,2,2,3,1,3,9.70906021557626,8.49249057877587,0.431682267763804,31
"9693","SP","Estrela d'Oeste",8419,74377.84,35002,"Fernandópolis",3,"Sudeste",0,"351520",2,6,1,5,1,5,0,0,0,0,0,6,1,5,1,5,5,11.2169133269929,9.03824633533766,0.334988919676203,29
"9694","SP","Estrela d'Oeste",8419,74377.84,35002,"Fernandópolis",3,"Sudeste",0,"351520",3,9,1,8,3,6,0,0,0,0,0,9,1,8,3,6,5,11.2169133269929,9.03824633533766,0.415533974129348,31
"9695","SP","Estrela d'Oeste",8419,74377.84,35002,"Fernandópolis",3,"Sudeste",0,"351520",4,5,0,5,2,3,0,0,0,0,0,5,0,5,2,3,1,11.2169133269929,9.03824633533766,0.423089293966053,30
"9696","SP","Estrela d'Oeste",8419,74377.84,35002,"Fernandópolis",3,"Sudeste",0,"351520",5,3,2,1,2,1,0,0,0,0,0,3,2,1,2,1,1,11.2169133269929,9.03824633533766,0.408665416266736,31
"9697","SP","Euclides da Cunha Paulista",9325,16893.29,35036,"Presidente Prudente",3,"Sudeste",0,"351535",2,6,1,5,4,2,0,0,0,0,0,6,1,5,4,2,2,9.73467178064923,9.14045424451202,0.314456315796278,29
"9698","SP","Euclides da Cunha Paulista",9325,16893.29,35036,"Presidente Prudente",3,"Sudeste",0,"351535",3,8,0,8,4,4,1,0,1,1,0,9,0,9,5,4,6,9.73467178064923,9.14045424451202,0.377020204757609,31
"9699","SP","Euclides da Cunha Paulista",9325,16893.29,35036,"Presidente Prudente",3,"Sudeste",0,"351535",4,5,0,5,1,4,1,0,1,1,0,6,0,6,2,4,11,9.73467178064923,9.14045424451202,0.452485802841875,30
"9700","SP","Euclides da Cunha Paulista",9325,16893.29,35036,"Presidente Prudente",3,"Sudeste",0,"351535",5,5,0,5,2,3,0,0,0,0,0,5,0,5,2,3,4,9.73467178064923,9.14045424451202,0.439923523805736,31
"9701","SP","Fartura",16070,23162.82,35040,"Ourinhos",3,"Sudeste",1,"351540",2,13,2,11,6,7,0,0,0,0,0,13,2,11,6,7,9,10.0503036859326,9.68470945873156,0.292674801795417,29
"9702","SP","Fartura",16070,23162.82,35040,"Ourinhos",3,"Sudeste",1,"351540",3,15,4,11,4,11,0,0,0,0,0,15,4,11,4,11,9,10.0503036859326,9.68470945873156,0.41170615319583,31
"9703","SP","Fartura",16070,23162.82,35040,"Ourinhos",3,"Sudeste",1,"351540",4,14,6,8,4,10,0,0,0,0,0,14,6,8,4,10,10,10.0503036859326,9.68470945873156,0.455514945213517,30
"9704","SP","Fartura",16070,23162.82,35040,"Ourinhos",3,"Sudeste",1,"351540",5,5,1,4,2,3,0,0,0,0,0,5,1,4,2,3,7,10.0503036859326,9.68470945873156,0.439223356925101,31
"9705","SP","Fernandópolis",69402,29148.74,35002,"Fernandópolis",3,"Sudeste",1,"351550",2,39,4,35,18,21,0,0,0,0,0,39,4,35,18,21,42,10.2801669661446,11.1476709645235,0.283164379218736,29
"9706","SP","Fernandópolis",69402,29148.74,35002,"Fernandópolis",3,"Sudeste",1,"351550",3,52,3,49,16,36,2,0,2,1,1,54,3,51,17,37,61,10.2801669661446,11.1476709645235,0.374926515740774,31
"9707","SP","Fernandópolis",69402,29148.74,35002,"Fernandópolis",3,"Sudeste",1,"351550",4,49,4,45,11,38,0,0,0,0,0,49,4,45,11,38,51,10.2801669661446,11.1476709645235,0.406193037588461,30
"9708","SP","Fernandópolis",69402,29148.74,35002,"Fernandópolis",3,"Sudeste",1,"351550",5,79,5,74,18,61,0,0,0,0,0,79,5,74,18,61,47,10.2801669661446,11.1476709645235,0.373666673361012,31
"9709","SP","Fernando Prestes",5794,33167.17,35013,"Jaboticabal",3,"Sudeste",0,"351560",2,2,0,2,2,0,0,0,0,0,0,2,0,2,2,0,3,10.4093158102428,8.66457817832929,0.316944532468725,29
"9710","SP","Fernando Prestes",5794,33167.17,35013,"Jaboticabal",3,"Sudeste",0,"351560",3,2,0,2,1,1,0,0,0,0,0,2,0,2,1,1,7,10.4093158102428,8.66457817832929,0.391210857747344,31
"9711","SP","Fernando Prestes",5794,33167.17,35013,"Jaboticabal",3,"Sudeste",0,"351560",4,7,0,7,3,4,0,0,0,0,0,7,0,7,3,4,2,10.4093158102428,8.66457817832929,0.391521934538952,30
"9712","SP","Fernando Prestes",5794,33167.17,35013,"Jaboticabal",3,"Sudeste",0,"351560",5,5,0,5,1,4,0,0,0,0,0,5,0,5,1,4,2,10.4093158102428,8.66457817832929,0.423214662578914,31
"9713","SP","Ferraz de Vasconcelos",196500,16344.03,35062,"Mogi das Cruzes",3,"Sudeste",1,"351570",2,210,21,189,80,130,1,0,1,1,0,211,21,190,81,130,75,9.70161797203175,12.1884177102915,0.313842431729062,29
"9714","SP","Ferraz de Vasconcelos",196500,16344.03,35062,"Mogi das Cruzes",3,"Sudeste",1,"351570",3,188,22,166,72,116,3,1,2,1,2,191,23,168,73,118,97,9.70161797203175,12.1884177102915,0.413187185997892,31
"9715","SP","Ferraz de Vasconcelos",196500,16344.03,35062,"Mogi das Cruzes",3,"Sudeste",1,"351570",4,200,28,172,79,121,2,0,2,1,1,202,28,174,80,122,102,9.70161797203175,12.1884177102915,0.486244487164243,30
"9716","SP","Ferraz de Vasconcelos",196500,16344.03,35062,"Mogi das Cruzes",3,"Sudeste",1,"351570",5,182,27,155,69,113,3,2,1,2,1,185,29,156,71,114,123,9.70161797203175,12.1884177102915,0.458302417325471,31
"9717","SP","Flórida Paulista",14790,14264.37,35035,"Adamantina",3,"Sudeste",0,"351600",2,5,1,4,1,4,0,0,0,0,0,5,1,4,1,4,10,9.56552009863448,9.60170655570485,0.303405794746449,29
"9718","SP","Flórida Paulista",14790,14264.37,35035,"Adamantina",3,"Sudeste",0,"351600",3,12,3,9,4,8,0,0,0,0,0,12,3,9,4,8,9,9.56552009863448,9.60170655570485,0.368464653470412,31
"9719","SP","Flórida Paulista",14790,14264.37,35035,"Adamantina",3,"Sudeste",0,"351600",4,5,0,5,1,4,1,1,0,0,1,6,1,5,1,5,5,9.56552009863448,9.60170655570485,0.388263747871354,30
"9720","SP","Flórida Paulista",14790,14264.37,35035,"Adamantina",3,"Sudeste",0,"351600",5,9,1,8,3,6,0,0,0,0,0,9,1,8,3,6,9,9.56552009863448,9.60170655570485,0.383482313958515,31
"9721","SP","Franca",355901,28518.78,35012,"Franca",3,"Sudeste",1,"351620",2,279,40,239,80,199,1,0,1,1,0,280,40,240,81,199,189,10.2583180966147,12.7824078812724,0.290944993734147,29
"9722","SP","Franca",355901,28518.78,35012,"Franca",3,"Sudeste",1,"351620",3,364,45,319,118,246,1,0,1,0,1,365,45,320,118,247,214,10.2583180966147,12.7824078812724,0.39719104733744,31
"9723","SP","Franca",355901,28518.78,35012,"Franca",3,"Sudeste",1,"351620",4,341,50,291,101,240,2,0,2,0,2,343,50,293,101,242,164,10.2583180966147,12.7824078812724,0.45414244973925,30
"9724","SP","Franca",355901,28518.78,35012,"Franca",3,"Sudeste",1,"351620",5,388,51,337,132,256,2,0,2,0,2,390,51,339,132,258,187,10.2583180966147,12.7824078812724,0.405402627484471,31
"9725","SP","Francisco Morato",177633,8719.4,35058,"Franco da Rocha",3,"Sudeste",1,"351630",2,165,23,142,66,99,5,2,3,2,3,170,25,145,68,102,85,9.07330570719624,12.0874749030903,0.309516825871049,29
"9726","SP","Francisco Morato",177633,8719.4,35058,"Franco da Rocha",3,"Sudeste",1,"351630",3,196,32,164,75,121,5,1,4,0,5,201,33,168,75,126,79,9.07330570719624,12.0874749030903,0.403663045168326,31
"9727","SP","Francisco Morato",177633,8719.4,35058,"Franco da Rocha",3,"Sudeste",1,"351630",4,181,28,153,74,107,2,0,2,1,1,183,28,155,75,108,113,9.07330570719624,12.0874749030903,0.470887921373119,30
"9728","SP","Francisco Morato",177633,8719.4,35058,"Franco da Rocha",3,"Sudeste",1,"351630",5,236,28,208,90,146,0,0,0,0,0,236,28,208,90,146,142,9.07330570719624,12.0874749030903,0.44982568451252,31
"9729","SP","Franco da Rocha",156492,19650.05,35058,"Franco da Rocha",3,"Sudeste",1,"351640",2,143,18,125,60,83,3,0,3,2,1,146,18,128,62,84,70,9.88583516182343,11.9607601694449,0.301302708126721,29
"9730","SP","Franco da Rocha",156492,19650.05,35058,"Franco da Rocha",3,"Sudeste",1,"351640",3,158,22,136,62,96,2,0,2,2,0,160,22,138,64,96,65,9.88583516182343,11.9607601694449,0.404198660836383,31
"9731","SP","Franco da Rocha",156492,19650.05,35058,"Franco da Rocha",3,"Sudeste",1,"351640",4,162,17,145,55,107,2,0,2,0,2,164,17,147,55,109,96,9.88583516182343,11.9607601694449,0.473127796556608,30
"9732","SP","Franco da Rocha",156492,19650.05,35058,"Franco da Rocha",3,"Sudeste",1,"351640",5,179,14,165,63,116,3,1,2,1,2,182,15,167,64,118,120,9.88583516182343,11.9607601694449,0.449699727406308,31
"9733","SP","Gália",6482,21643.97,35038,"Marília",3,"Sudeste",0,"351660",2,4,0,4,2,2,0,0,0,0,0,4,0,4,2,2,3,9.98248217269624,8.77678438370149,0.313580776280485,29
"9734","SP","Gália",6482,21643.97,35038,"Marília",3,"Sudeste",0,"351660",3,4,1,3,0,4,0,0,0,0,0,4,1,3,0,4,5,9.98248217269624,8.77678438370149,0.371681825106487,31
"9735","SP","Gália",6482,21643.97,35038,"Marília",3,"Sudeste",0,"351660",4,2,1,1,0,2,0,0,0,0,0,2,1,1,0,2,4,9.98248217269624,8.77678438370149,0.384970873226692,30
"9736","SP","Gália",6482,21643.97,35038,"Marília",3,"Sudeste",0,"351660",5,4,2,2,1,3,0,0,0,0,0,4,2,2,1,3,5,9.98248217269624,8.77678438370149,0.38044556886876,31
"9737","SP","Garça",44409,26874.37,35038,"Marília",3,"Sudeste",1,"351670",2,25,1,24,9,16,0,0,0,0,0,25,1,24,9,16,19,10.1989283232947,10.7011974305816,0.292253493536571,29
"9738","SP","Garça",44409,26874.37,35038,"Marília",3,"Sudeste",1,"351670",3,38,2,36,12,26,0,0,0,0,0,38,2,36,12,26,31,10.1989283232947,10.7011974305816,0.372564546646567,31
"9739","SP","Garça",44409,26874.37,35038,"Marília",3,"Sudeste",1,"351670",4,29,6,23,10,19,0,0,0,0,0,29,6,23,10,19,26,10.1989283232947,10.7011974305816,0.412753948586862,30
"9740","SP","Garça",44409,26874.37,35038,"Marília",3,"Sudeste",1,"351670",5,57,5,52,22,35,0,0,0,0,0,57,5,52,22,35,34,10.1989283232947,10.7011974305816,0.392316368247893,31
"9741","SP","Gavião Peixoto",4815,186287.72,35024,"Araraquara",3,"Sudeste",1,"351685",2,5,1,4,3,2,0,0,0,0,0,5,1,4,3,2,1,12.1350476392266,8.47949132423223,0.31719974858599,29
"9742","SP","Gavião Peixoto",4815,186287.72,35024,"Araraquara",3,"Sudeste",1,"351685",3,4,0,4,1,3,0,0,0,0,0,4,0,4,1,3,3,12.1350476392266,8.47949132423223,0.412909208893437,31
"9743","SP","Gavião Peixoto",4815,186287.72,35024,"Araraquara",3,"Sudeste",1,"351685",4,4,1,3,2,2,0,0,0,0,0,4,1,3,2,2,3,12.1350476392266,8.47949132423223,0.45047971896094,30
"9744","SP","Gavião Peixoto",4815,186287.72,35024,"Araraquara",3,"Sudeste",1,"351685",5,3,0,3,2,1,0,0,0,0,0,3,0,3,2,1,2,12.1350476392266,8.47949132423223,0.401017445444662,31
"9745","SP","Getulina",11447,16284.53,35019,"Lins",3,"Sudeste",0,"351700",2,4,1,3,2,2,0,0,0,0,0,4,1,3,2,2,7,9.6979708563789,9.34548296591848,0.288239212716691,29
"9746","SP","Getulina",11447,16284.53,35019,"Lins",3,"Sudeste",0,"351700",3,6,0,6,2,4,0,0,0,0,0,6,0,6,2,4,8,9.6979708563789,9.34548296591848,0.393332143884382,31
"9747","SP","Getulina",11447,16284.53,35019,"Lins",3,"Sudeste",0,"351700",4,5,0,5,1,4,0,0,0,0,0,5,0,5,1,4,4,9.6979708563789,9.34548296591848,0.394485820149521,30
"9748","SP","Getulina",11447,16284.53,35019,"Lins",3,"Sudeste",0,"351700",5,7,2,5,1,6,0,0,0,0,0,7,2,5,1,6,8,9.6979708563789,9.34548296591848,0.352521167856379,31
"9749","SP","Glicério",4829,21142.62,35018,"Birigui",3,"Sudeste",0,"351710",2,3,0,3,3,0,0,0,0,0,0,3,0,3,3,0,0,9.95904618741182,8.48239468587354,0.298543987907332,29
"9750","SP","Glicério",4829,21142.62,35018,"Birigui",3,"Sudeste",0,"351710",3,3,1,2,1,2,0,0,0,0,0,3,1,2,1,2,1,9.95904618741182,8.48239468587354,0.37300793928013,31
"9751","SP","Glicério",4829,21142.62,35018,"Birigui",3,"Sudeste",0,"351710",4,4,0,4,1,3,0,0,0,0,0,4,0,4,1,3,2,9.95904618741182,8.48239468587354,0.411216561198475,30
"9752","SP","Glicério",4829,21142.62,35018,"Birigui",3,"Sudeste",0,"351710",5,6,0,6,3,3,0,0,0,0,0,6,0,6,3,3,0,9.95904618741182,8.48239468587354,0.409777672496918,31
"9753","SP","Guaiçara",12294,16298.89,35019,"Lins",3,"Sudeste",0,"351720",2,8,4,4,4,4,0,0,0,0,0,8,4,4,4,4,9,9.69885228631656,9.41686661746695,0.318222036187001,29
"9754","SP","Guaiçara",12294,16298.89,35019,"Lins",3,"Sudeste",0,"351720",3,9,1,8,7,2,0,0,0,0,0,9,1,8,7,2,6,9.69885228631656,9.41686661746695,0.414954133822396,31
"9755","SP","Guaiçara",12294,16298.89,35019,"Lins",3,"Sudeste",0,"351720",4,18,6,12,10,8,0,0,0,0,0,18,6,12,10,8,7,9.69885228631656,9.41686661746695,0.42585226917841,30
"9756","SP","Guaiçara",12294,16298.89,35019,"Lins",3,"Sudeste",0,"351720",5,13,4,9,6,7,0,0,0,0,0,13,4,9,6,7,2,9.69885228631656,9.41686661746695,0.404067074843447,31
"9757","SP","Guaimbê",5785,13163.82,35019,"Lins",3,"Sudeste",0,"351730",2,5,3,2,0,5,0,0,0,0,0,5,3,2,0,5,1,9.48522743631432,8.66302363962778,0.286356950385448,29
"9758","SP","Guaimbê",5785,13163.82,35019,"Lins",3,"Sudeste",0,"351730",3,7,3,4,2,5,0,0,0,0,0,7,3,4,2,5,4,9.48522743631432,8.66302363962778,0.38663851647881,31
"9759","SP","Guaimbê",5785,13163.82,35019,"Lins",3,"Sudeste",0,"351730",4,4,1,3,2,2,0,0,0,0,0,4,1,3,2,2,2,9.48522743631432,8.66302363962778,0.382374333526003,30
"9760","SP","Guaimbê",5785,13163.82,35019,"Lins",3,"Sudeste",0,"351730",5,5,1,4,3,2,0,0,0,0,0,5,1,4,3,2,2,9.48522743631432,8.66302363962778,0.393013050252482,31
"9761","SP","Guaíra",41040,80169.84,35010,"São Joaquim da Barra",3,"Sudeste",1,"351740",2,33,3,30,7,26,0,0,0,0,0,33,3,30,7,26,29,11.291902663276,10.6223024798447,0.303441864415813,29
"9762","SP","Guaíra",41040,80169.84,35010,"São Joaquim da Barra",3,"Sudeste",1,"351740",3,40,9,31,15,25,0,0,0,0,0,40,9,31,15,25,19,11.291902663276,10.6223024798447,0.371857407253804,31
"9763","SP","Guaíra",41040,80169.84,35010,"São Joaquim da Barra",3,"Sudeste",1,"351740",4,38,5,33,22,16,1,0,1,1,0,39,5,34,23,16,20,11.291902663276,10.6223024798447,0.398375914658695,30
"9764","SP","Guaíra",41040,80169.84,35010,"São Joaquim da Barra",3,"Sudeste",1,"351740",5,41,5,36,20,21,1,0,1,0,1,42,5,37,20,22,21,11.291902663276,10.6223024798447,0.383766657355857,31
"9765","SP","Guapiaçu",21775,26008.59,35004,"São José do Rio Preto",3,"Sudeste",1,"351750",2,16,1,15,6,10,0,0,0,0,0,16,1,15,6,10,12,10.166182147054,9.9885178017207,0.285875150178923,29
"9766","SP","Guapiaçu",21775,26008.59,35004,"São José do Rio Preto",3,"Sudeste",1,"351750",3,20,4,16,9,11,0,0,0,0,0,20,4,16,9,11,18,10.166182147054,9.9885178017207,0.356142377295424,31
"9767","SP","Guapiaçu",21775,26008.59,35004,"São José do Rio Preto",3,"Sudeste",1,"351750",4,17,3,14,6,11,0,0,0,0,0,17,3,14,6,11,9,10.166182147054,9.9885178017207,0.386563263443519,30
"9768","SP","Guapiaçu",21775,26008.59,35004,"São José do Rio Preto",3,"Sudeste",1,"351750",5,26,6,20,7,19,0,0,0,0,0,26,6,20,7,19,14,10.166182147054,9.9885178017207,0.370478634294465,31
"9769","SP","Guapiara",17025,18874.32,35044,"Capão Bonito",3,"Sudeste",0,"351760",2,17,4,13,11,6,1,0,1,1,0,18,4,14,12,6,13,9.84555754697819,9.74243813101771,0.326047955041798,29
"9770","SP","Guapiara",17025,18874.32,35044,"Capão Bonito",3,"Sudeste",0,"351760",3,11,4,7,6,5,0,0,0,0,0,11,4,7,6,5,14,9.84555754697819,9.74243813101771,0.411363073053679,31
"9771","SP","Guapiara",17025,18874.32,35044,"Capão Bonito",3,"Sudeste",0,"351760",4,16,5,11,2,14,0,0,0,0,0,16,5,11,2,14,8,9.84555754697819,9.74243813101771,0.448850420554975,30
"9772","SP","Guapiara",17025,18874.32,35044,"Capão Bonito",3,"Sudeste",0,"351760",5,26,7,19,13,13,0,0,0,0,0,26,7,19,13,13,17,9.84555754697819,9.74243813101771,0.458427319742581,31
"9773","SP","Guará",21308,20804.61,35011,"Ituverava",3,"Sudeste",1,"351770",2,12,4,8,4,8,0,0,0,0,0,12,4,8,4,8,15,9.94292987574747,9.96683786803689,0.316024074528613,29
"9774","SP","Guará",21308,20804.61,35011,"Ituverava",3,"Sudeste",1,"351770",3,14,2,12,4,10,0,0,0,0,0,14,2,12,4,10,13,9.94292987574747,9.96683786803689,0.394726395108511,31
"9775","SP","Guará",21308,20804.61,35011,"Ituverava",3,"Sudeste",1,"351770",4,15,5,10,3,12,0,0,0,0,0,15,5,10,3,12,11,9.94292987574747,9.96683786803689,0.428534539083815,30
"9776","SP","Guará",21308,20804.61,35011,"Ituverava",3,"Sudeste",1,"351770",5,16,2,14,6,10,0,0,0,0,0,16,2,14,6,10,11,9.94292987574747,9.96683786803689,0.393122945599237,31
"9777","SP","Guaraçaí",8290,32770.4,35016,"Andradina",3,"Sudeste",0,"351780",2,4,0,4,1,3,0,0,0,0,0,4,0,4,1,3,5,10.3972809479046,9.02280524812934,0.317011265468815,29
"9778","SP","Guaraçaí",8290,32770.4,35016,"Andradina",3,"Sudeste",0,"351780",3,2,0,2,1,1,0,0,0,0,0,2,0,2,1,1,7,10.3972809479046,9.02280524812934,0.398550554508881,31
"9779","SP","Guaraçaí",8290,32770.4,35016,"Andradina",3,"Sudeste",0,"351780",4,6,1,5,3,3,0,0,0,0,0,6,1,5,3,3,8,10.3972809479046,9.02280524812934,0.39019267426631,30
"9780","SP","Guaraçaí",8290,32770.4,35016,"Andradina",3,"Sudeste",0,"351780",5,10,1,9,6,4,0,0,0,0,0,10,1,9,6,4,5,10.3972809479046,9.02280524812934,0.397912231728437,31
"9781","SP","Guaraci",11287,29683.17,35004,"São José do Rio Preto",3,"Sudeste",0,"351790",2,5,1,4,1,4,0,0,0,0,0,5,1,4,1,4,6,10.2983354975079,9.33140689995563,0.309920597366927,29
"9782","SP","Guaraci",11287,29683.17,35004,"São José do Rio Preto",3,"Sudeste",0,"351790",3,14,2,12,7,7,0,0,0,0,0,14,2,12,7,7,3,10.2983354975079,9.33140689995563,0.374306575648268,31
"9783","SP","Guaraci",11287,29683.17,35004,"São José do Rio Preto",3,"Sudeste",0,"351790",4,12,0,12,4,8,0,0,0,0,0,12,0,12,4,8,5,10.2983354975079,9.33140689995563,0.406142292617258,30
"9784","SP","Guaraci",11287,29683.17,35004,"São José do Rio Preto",3,"Sudeste",0,"351790",5,11,2,9,4,7,0,0,0,0,0,11,2,9,4,7,10,10.2983354975079,9.33140689995563,0.389562995185624,31
"9785","SP","Guarantã",6675,26176.16,35020,"Bauru",3,"Sudeste",0,"351810",2,3,1,2,2,1,0,0,0,0,0,3,1,2,2,1,6,10.1726043518532,8.80612448326845,0.280351582775077,29
"9786","SP","Guarantã",6675,26176.16,35020,"Bauru",3,"Sudeste",0,"351810",3,6,4,2,2,4,0,0,0,0,0,6,4,2,2,4,1,10.1726043518532,8.80612448326845,0.323865273910453,31
"9787","SP","Guarantã",6675,26176.16,35020,"Bauru",3,"Sudeste",0,"351810",4,5,0,5,3,2,1,0,1,0,1,6,0,6,3,3,3,10.1726043518532,8.80612448326845,0.374117623922945,30
"9788","SP","Guarantã",6675,26176.16,35020,"Bauru",3,"Sudeste",0,"351810",5,3,1,2,1,2,0,0,0,0,0,3,1,2,1,2,2,10.1726043518532,8.80612448326845,0.355087553555299,31
"9789","SP","Guararapes",33100,27764.52,35017,"Araçatuba",3,"Sudeste",1,"351820",2,17,4,13,1,16,0,0,0,0,0,17,4,13,1,16,16,10.2315142255738,10.4072885613652,0.280633634799145,29
"9790","SP","Guararapes",33100,27764.52,35017,"Araçatuba",3,"Sudeste",1,"351820",3,24,6,18,8,16,0,0,0,0,0,24,6,18,8,16,36,10.2315142255738,10.4072885613652,0.364054542908432,31
"9791","SP","Guararapes",33100,27764.52,35017,"Araçatuba",3,"Sudeste",1,"351820",4,32,2,30,13,19,0,0,0,0,0,32,2,30,13,19,12,10.2315142255738,10.4072885613652,0.406458793366623,30
"9792","SP","Guararapes",33100,27764.52,35017,"Araçatuba",3,"Sudeste",1,"351820",5,26,3,23,6,20,0,0,0,0,0,26,3,23,6,20,20,10.2315142255738,10.4072885613652,0.374933713237845,31
"9793","SP","Guararema",30136,47997.77,35062,"Mogi das Cruzes",3,"Sudeste",0,"351830",2,24,6,18,12,12,1,0,1,1,0,25,6,19,13,12,19,10.7789098304775,10.3134757493719,0.323768060644139,29
"9794","SP","Guararema",30136,47997.77,35062,"Mogi das Cruzes",3,"Sudeste",0,"351830",3,38,6,32,13,25,0,0,0,0,0,38,6,32,13,25,22,10.7789098304775,10.3134757493719,0.414303575502883,31
"9795","SP","Guararema",30136,47997.77,35062,"Mogi das Cruzes",3,"Sudeste",0,"351830",4,45,7,38,12,33,0,0,0,0,0,45,7,38,12,33,14,10.7789098304775,10.3134757493719,0.481558060097245,30
"9796","SP","Guararema",30136,47997.77,35062,"Mogi das Cruzes",3,"Sudeste",0,"351830",5,38,4,34,17,21,0,0,0,0,0,38,4,34,17,21,21,10.7789098304775,10.3134757493719,0.457037917364935,31
"9797","SP","Guaratinguetá",122505,46849.29,35051,"Guaratinguetá",3,"Sudeste",1,"351840",2,108,14,94,33,75,0,0,0,0,0,108,14,94,33,75,92,10.7546911328025,11.7159071244605,0.31103024895106,29
"9798","SP","Guaratinguetá",122505,46849.29,35051,"Guaratinguetá",3,"Sudeste",1,"351840",3,107,15,92,34,73,0,0,0,0,0,107,15,92,34,73,94,10.7546911328025,11.7159071244605,0.417080657567317,31
"9799","SP","Guaratinguetá",122505,46849.29,35051,"Guaratinguetá",3,"Sudeste",1,"351840",4,102,10,92,32,70,0,0,0,0,0,102,10,92,32,70,62,10.7546911328025,11.7159071244605,0.478356679902007,30
"9800","SP","Guaratinguetá",122505,46849.29,35051,"Guaratinguetá",3,"Sudeste",1,"351840",5,117,12,105,33,84,0,0,0,0,0,117,12,105,33,84,84,10.7546911328025,11.7159071244605,0.435113378030011,31
"9801","SP","Guareí",18887,12279.22,35042,"Itapetininga",3,"Sudeste",0,"351850",2,9,3,6,5,4,0,0,0,0,0,9,3,6,5,4,8,9.41566368176847,9.84622913369585,0.336780746926013,29
"9802","SP","Guareí",18887,12279.22,35042,"Itapetininga",3,"Sudeste",0,"351850",3,10,4,6,5,5,0,0,0,0,0,10,4,6,5,5,2,9.41566368176847,9.84622913369585,0.43597718680573,31
"9803","SP","Guareí",18887,12279.22,35042,"Itapetininga",3,"Sudeste",0,"351850",4,11,4,7,8,3,0,0,0,0,0,11,4,7,8,3,10,9.41566368176847,9.84622913369585,0.497445877812038,30
"9804","SP","Guareí",18887,12279.22,35042,"Itapetininga",3,"Sudeste",0,"351850",5,6,1,5,2,4,0,0,0,0,0,6,1,5,2,4,13,9.41566368176847,9.84622913369585,0.458446606109104,31
"9805","SP","Guariba",40487,22657.16,35013,"Jaboticabal",3,"Sudeste",1,"351860",2,32,4,28,7,25,0,0,0,0,0,32,4,28,7,25,15,10.0282311957477,10.6087362139127,0.301065305904714,29
"9806","SP","Guariba",40487,22657.16,35013,"Jaboticabal",3,"Sudeste",1,"351860",3,44,10,34,14,30,0,0,0,0,0,44,10,34,14,30,28,10.0282311957477,10.6087362139127,0.391576783360987,31
"9807","SP","Guariba",40487,22657.16,35013,"Jaboticabal",3,"Sudeste",1,"351860",4,38,8,30,13,25,1,1,0,1,0,39,9,30,14,25,18,10.0282311957477,10.6087362139127,0.419103131686065,30
"9808","SP","Guariba",40487,22657.16,35013,"Jaboticabal",3,"Sudeste",1,"351860",5,37,8,29,14,23,0,0,0,0,0,37,8,29,14,23,14,10.0282311957477,10.6087362139127,0.385389518696989,31
"9809","SP","Guarujá",322750,27031.81,35063,"Santos",3,"Sudeste",1,"351870",2,264,53,211,94,170,0,0,0,0,0,264,53,211,94,170,169,10.2047695996627,12.6846333087089,0.304558702331443,29
"9810","SP","Guarujá",322750,27031.81,35063,"Santos",3,"Sudeste",1,"351870",3,298,81,217,117,181,1,0,1,1,0,299,81,218,118,181,198,10.2047695996627,12.6846333087089,0.4165959361391,31
"9811","SP","Guarujá",322750,27031.81,35063,"Santos",3,"Sudeste",1,"351870",4,322,71,251,124,198,3,1,2,0,3,325,72,253,124,201,186,10.2047695996627,12.6846333087089,0.480033618138546,30
"9812","SP","Guarujá",322750,27031.81,35063,"Santos",3,"Sudeste",1,"351870",5,358,76,282,153,205,1,1,0,0,1,359,77,282,153,206,324,10.2047695996627,12.6846333087089,0.449269727002177,31
"9813","SP","Guarulhos",1392121,44897.7,35059,"Guarulhos",3,"Sudeste",1,"351880",2,1419,209,1210,530,889,19,2,17,4,15,1438,211,1227,534,904,602,10.712141847474,14.1463390413861,0.286477699810231,29
"9814","SP","Guarulhos",1392121,44897.7,35059,"Guarulhos",3,"Sudeste",1,"351880",3,1486,219,1267,534,952,15,7,8,6,9,1501,226,1275,540,961,704,10.712141847474,14.1463390413861,0.390637936573535,31
"9815","SP","Guarulhos",1392121,44897.7,35059,"Guarulhos",3,"Sudeste",1,"351880",4,1465,210,1255,533,932,20,5,15,11,9,1485,215,1270,544,941,804,10.712141847474,14.1463390413861,0.480276462119812,30
"9816","SP","Guarulhos",1392121,44897.7,35059,"Guarulhos",3,"Sudeste",1,"351880",5,1590,249,1341,553,1037,23,5,18,7,16,1613,254,1359,560,1053,1071,10.712141847474,14.1463390413861,0.449839826021212,31
"9817","SP","Guatapará",7709,28000.56,35014,"Ribeirão Preto",3,"Sudeste",0,"351885",2,4,2,2,1,3,0,0,0,0,0,4,2,2,1,3,4,10.2399797889573,8.95014375645926,0.28198806548308,29
"9818","SP","Guatapará",7709,28000.56,35014,"Ribeirão Preto",3,"Sudeste",0,"351885",3,4,2,2,2,2,0,0,0,0,0,4,2,2,2,2,3,10.2399797889573,8.95014375645926,0.362182615301989,31
"9819","SP","Guatapará",7709,28000.56,35014,"Ribeirão Preto",3,"Sudeste",0,"351885",4,6,3,3,1,5,0,0,0,0,0,6,3,3,1,5,2,10.2399797889573,8.95014375645926,0.397529289231441,30
"9820","SP","Guatapará",7709,28000.56,35014,"Ribeirão Preto",3,"Sudeste",0,"351885",5,15,3,12,9,6,0,0,0,0,0,15,3,12,9,6,3,10.2399797889573,8.95014375645926,0.375883564041849,31
"9821","SP","Herculândia",9588,33182.41,35037,"Tupã",3,"Sudeste",0,"351900",2,8,1,7,4,4,0,0,0,0,0,8,1,7,4,4,5,10.4097751952236,9.16826759555427,0.294888022738427,29
"9822","SP","Herculândia",9588,33182.41,35037,"Tupã",3,"Sudeste",0,"351900",3,6,0,6,3,3,1,1,0,1,0,7,1,6,4,3,9,10.4097751952236,9.16826759555427,0.353199643376727,31
"9823","SP","Herculândia",9588,33182.41,35037,"Tupã",3,"Sudeste",0,"351900",4,9,3,6,2,7,0,0,0,0,0,9,3,6,2,7,4,10.4097751952236,9.16826759555427,0.395999802064698,30
"9824","SP","Herculândia",9588,33182.41,35037,"Tupã",3,"Sudeste",0,"351900",5,10,2,8,4,6,0,0,0,0,0,10,2,8,4,6,7,10.4097751952236,9.16826759555427,0.394472585847288,31
"9825","SP","Holambra",15272,66537.66,35032,"Campinas",3,"Sudeste",0,"351905",2,17,5,12,3,14,0,0,0,0,0,17,5,12,3,14,5,11.1055233821371,9.63377636540558,0.305225285736482,29
"9826","SP","Holambra",15272,66537.66,35032,"Campinas",3,"Sudeste",0,"351905",3,15,3,12,6,9,0,0,0,0,0,15,3,12,6,9,7,11.1055233821371,9.63377636540558,0.413629051035329,31
"9827","SP","Holambra",15272,66537.66,35032,"Campinas",3,"Sudeste",0,"351905",4,17,3,14,5,12,0,0,0,0,0,17,3,14,5,12,7,11.1055233821371,9.63377636540558,0.445123772561864,30
"9828","SP","Holambra",15272,66537.66,35032,"Campinas",3,"Sudeste",0,"351905",5,12,2,10,5,7,0,0,0,0,0,12,2,10,5,7,4,11.1055233821371,9.63377636540558,0.399672734006189,31
"9829","SP","Hortolândia",234259,57691.75,35032,"Campinas",3,"Sudeste",1,"351907",2,201,29,172,59,142,0,0,0,0,0,201,29,172,59,142,87,10.9628694613376,12.3641826198535,0.283113693252157,29
"9830","SP","Hortolândia",234259,57691.75,35032,"Campinas",3,"Sudeste",1,"351907",3,222,22,200,65,157,0,0,0,0,0,222,22,200,65,157,120,10.9628694613376,12.3641826198535,0.386622557480552,31
"9831","SP","Hortolândia",234259,57691.75,35032,"Campinas",3,"Sudeste",1,"351907",4,227,28,199,73,154,2,0,2,2,0,229,28,201,75,154,92,10.9628694613376,12.3641826198535,0.449819876235371,30
"9832","SP","Hortolândia",234259,57691.75,35032,"Campinas",3,"Sudeste",1,"351907",5,249,33,216,74,175,1,0,1,1,0,250,33,217,75,175,108,10.9628694613376,12.3641826198535,0.412108574321136,31
"9833","SP","Iacanga",11858,37023.57,35020,"Bauru",3,"Sudeste",0,"351910",2,10,3,7,2,8,1,0,1,0,1,11,3,8,2,9,6,10.5193100158378,9.38075802426731,0.28426441820295,29
"9834","SP","Iacanga",11858,37023.57,35020,"Bauru",3,"Sudeste",0,"351910",3,13,3,10,6,7,0,0,0,0,0,13,3,10,6,7,9,10.5193100158378,9.38075802426731,0.364935586983368,31
"9835","SP","Iacanga",11858,37023.57,35020,"Bauru",3,"Sudeste",0,"351910",4,16,1,15,6,10,0,0,0,0,0,16,1,15,6,10,4,10.5193100158378,9.38075802426731,0.384154128396556,30
"9836","SP","Iacanga",11858,37023.57,35020,"Bauru",3,"Sudeste",0,"351910",5,6,0,6,3,3,0,0,0,0,0,6,0,6,3,3,6,10.5193100158378,9.38075802426731,0.360108607538302,31
"9837","SP","Iacri",6295,30157.75,35037,"Tupã",3,"Sudeste",0,"351920",2,6,1,5,3,3,0,0,0,0,0,6,1,5,3,3,7,10.314197217217,8.74751094647845,0.295979654306699,29
"9838","SP","Iacri",6295,30157.75,35037,"Tupã",3,"Sudeste",0,"351920",3,5,2,3,3,2,1,0,1,0,1,6,2,4,3,3,6,10.314197217217,8.74751094647845,0.346324608818506,31
"9839","SP","Iacri",6295,30157.75,35037,"Tupã",3,"Sudeste",0,"351920",4,2,0,2,1,1,0,0,0,0,0,2,0,2,1,1,2,10.314197217217,8.74751094647845,0.375569727376311,30
"9840","SP","Iacri",6295,30157.75,35037,"Tupã",3,"Sudeste",0,"351920",5,5,1,4,1,4,0,0,0,0,0,5,1,4,1,4,2,10.314197217217,8.74751094647845,0.360958929708898,31
"9841","SP","Ibaté",35472,24454.14,35025,"São Carlos",3,"Sudeste",1,"351930",2,33,4,29,14,19,1,0,1,0,1,34,4,30,14,20,14,10.1045548057225,10.4764989318561,0.309207280024393,29
"9842","SP","Ibaté",35472,24454.14,35025,"São Carlos",3,"Sudeste",1,"351930",3,34,2,32,15,19,0,0,0,0,0,34,2,32,15,19,20,10.1045548057225,10.4764989318561,0.401710152128189,31
"9843","SP","Ibaté",35472,24454.14,35025,"São Carlos",3,"Sudeste",1,"351930",4,33,8,25,13,20,0,0,0,0,0,33,8,25,13,20,21,10.1045548057225,10.4764989318561,0.454622089107685,30
"9844","SP","Ibaté",35472,24454.14,35025,"São Carlos",3,"Sudeste",1,"351930",5,35,5,30,7,28,0,0,0,0,0,35,5,30,7,28,20,10.1045548057225,10.4764989318561,0.419681337412359,31
"9845","SP","Ibirá",12518,20475.08,35004,"São José do Rio Preto",3,"Sudeste",0,"351940",2,10,3,7,2,8,0,0,0,0,0,10,3,7,2,8,9,9.92696381591754,9.43492288748465,0.302316112351438,29
"9846","SP","Ibirá",12518,20475.08,35004,"São José do Rio Preto",3,"Sudeste",0,"351940",3,11,1,10,7,4,0,0,0,0,0,11,1,10,7,4,8,9.92696381591754,9.43492288748465,0.379926435880364,31
"9847","SP","Ibirá",12518,20475.08,35004,"São José do Rio Preto",3,"Sudeste",0,"351940",4,8,0,8,3,5,0,0,0,0,0,8,0,8,3,5,9,9.92696381591754,9.43492288748465,0.415857118671682,30
"9848","SP","Ibirá",12518,20475.08,35004,"São José do Rio Preto",3,"Sudeste",0,"351940",5,22,3,19,7,15,1,0,1,0,1,23,3,20,7,16,6,9.92696381591754,9.43492288748465,0.393240584571558,31
"9849","SP","Ibirarema",7841,23951.1,35039,"Assis",3,"Sudeste",0,"351950",2,6,4,2,2,4,0,0,0,0,0,6,4,2,2,4,9,10.0837695308031,8.96712165623092,0.290291767493687,29
"9850","SP","Ibirarema",7841,23951.1,35039,"Assis",3,"Sudeste",0,"351950",3,2,1,1,0,2,0,0,0,0,0,2,1,1,0,2,4,10.0837695308031,8.96712165623092,0.36110024734944,31
"9851","SP","Ibirarema",7841,23951.1,35039,"Assis",3,"Sudeste",0,"351950",4,7,2,5,7,0,0,0,0,0,0,7,2,5,7,0,4,10.0837695308031,8.96712165623092,0.420143166905765,30
"9852","SP","Ibirarema",7841,23951.1,35039,"Assis",3,"Sudeste",0,"351950",5,4,2,2,1,3,0,0,0,0,0,4,2,2,1,3,2,10.0837695308031,8.96712165623092,0.392619454157687,31
"9853","SP","Ibitinga",60600,25630.47,35024,"Araraquara",3,"Sudeste",1,"351960",2,46,10,36,20,26,0,0,0,0,0,46,10,36,20,26,25,10.1515371570753,11.0120501720574,0.302890098673502,29
"9854","SP","Ibitinga",60600,25630.47,35024,"Araraquara",3,"Sudeste",1,"351960",3,51,10,41,15,36,2,1,1,1,1,53,11,42,16,37,41,10.1515371570753,11.0120501720574,0.401201922274481,31
"9855","SP","Ibitinga",60600,25630.47,35024,"Araraquara",3,"Sudeste",1,"351960",4,54,12,42,15,39,0,0,0,0,0,54,12,42,15,39,34,10.1515371570753,11.0120501720574,0.439891801266445,30
"9856","SP","Ibitinga",60600,25630.47,35024,"Araraquara",3,"Sudeste",1,"351960",5,56,13,43,24,32,1,0,1,0,1,57,13,44,24,33,41,10.1515371570753,11.0120501720574,0.402276542119348,31
"9857","SP","Ibiúna",79479,21746.5,35045,"Piedade",3,"Sudeste",0,"351970",2,87,32,55,34,53,0,0,0,0,0,87,32,55,34,53,57,9.98720810402766,11.283248114805,0.306632788472888,29
"9858","SP","Ibiúna",79479,21746.5,35045,"Piedade",3,"Sudeste",0,"351970",3,78,20,58,26,52,0,0,0,0,0,78,20,58,26,52,35,9.98720810402766,11.283248114805,0.386593677546395,31
"9859","SP","Ibiúna",79479,21746.5,35045,"Piedade",3,"Sudeste",0,"351970",4,84,13,71,34,50,1,1,0,0,1,85,14,71,34,51,39,9.98720810402766,11.283248114805,0.430600163304843,30
"9860","SP","Ibiúna",79479,21746.5,35045,"Piedade",3,"Sudeste",0,"351970",5,77,22,55,35,42,1,0,1,1,0,78,22,56,36,42,61,9.98720810402766,11.283248114805,0.424995068113279,31
"9861","SP","Icém",8304,21243.2,35004,"São José do Rio Preto",3,"Sudeste",0,"351980",2,12,2,10,3,9,0,0,0,0,0,12,2,10,3,9,6,9.96379212314164,9.02449260540567,0.285642834324786,29
"9862","SP","Icém",8304,21243.2,35004,"São José do Rio Preto",3,"Sudeste",0,"351980",3,2,0,2,0,2,0,0,0,0,0,2,0,2,0,2,1,9.96379212314164,9.02449260540567,0.363560664547054,31
"9863","SP","Icém",8304,21243.2,35004,"São José do Rio Preto",3,"Sudeste",0,"351980",4,11,3,8,3,8,0,0,0,0,0,11,3,8,3,8,1,9.96379212314164,9.02449260540567,0.397558418856601,30
"9864","SP","Icém",8304,21243.2,35004,"São José do Rio Preto",3,"Sudeste",0,"351980",5,11,2,9,7,4,0,0,0,0,0,11,2,9,7,4,5,9.96379212314164,9.02449260540567,0.367286831985401,31
"9865","SP","Iepê",8194,30435.64,35039,"Assis",3,"Sudeste",0,"351990",2,4,0,4,3,1,0,0,0,0,0,4,0,4,3,1,3,10.3233695691282,9.01115745810682,0.300582347291519,29
"9866","SP","Iepê",8194,30435.64,35039,"Assis",3,"Sudeste",0,"351990",3,9,2,7,3,6,0,0,0,0,0,9,2,7,3,6,5,10.3233695691282,9.01115745810682,0.398234059146699,31
"9867","SP","Iepê",8194,30435.64,35039,"Assis",3,"Sudeste",0,"351990",4,9,1,8,6,3,0,0,0,0,0,9,1,8,6,3,5,10.3233695691282,9.01115745810682,0.390992063442006,30
"9868","SP","Iepê",8194,30435.64,35039,"Assis",3,"Sudeste",0,"351990",5,8,0,8,6,2,0,0,0,0,0,8,0,8,6,2,8,10.3233695691282,9.01115745810682,0.387579485601312,31
"9869","SP","Igaraçu do Tietê",24749,12335.36,35021,"Jaú",3,"Sudeste",1,"352000",2,14,1,13,10,4,0,0,0,0,0,14,1,13,10,4,12,9.42022521378281,10.1165403631402,0.33653676794915,29
"9870","SP","Igaraçu do Tietê",24749,12335.36,35021,"Jaú",3,"Sudeste",1,"352000",3,18,4,14,11,7,0,0,0,0,0,18,4,14,11,7,16,9.42022521378281,10.1165403631402,0.407989035570935,31
"9871","SP","Igaraçu do Tietê",24749,12335.36,35021,"Jaú",3,"Sudeste",1,"352000",4,14,3,11,3,11,1,0,1,0,1,15,3,12,3,12,11,9.42022521378281,10.1165403631402,0.449541480281062,30
"9872","SP","Igaraçu do Tietê",24749,12335.36,35021,"Jaú",3,"Sudeste",1,"352000",5,25,3,22,10,15,2,1,1,1,1,27,4,23,11,16,21,9.42022521378281,10.1165403631402,0.419536451544386,31
"9873","SP","Igarapava",30614,39002.62,35011,"Ituverava",3,"Sudeste",1,"352010",2,24,4,20,10,14,0,0,0,0,0,24,4,20,10,14,15,10.5713841023425,10.3292126996517,0.313247189119589,29
"9874","SP","Igarapava",30614,39002.62,35011,"Ituverava",3,"Sudeste",1,"352010",3,23,6,17,2,21,0,0,0,0,0,23,6,17,2,21,23,10.5713841023425,10.3292126996517,0.402616274924577,31
"9875","SP","Igarapava",30614,39002.62,35011,"Ituverava",3,"Sudeste",1,"352010",4,17,2,15,9,8,0,0,0,0,0,17,2,15,9,8,18,10.5713841023425,10.3292126996517,0.439326176630272,30
"9876","SP","Igarapava",30614,39002.62,35011,"Ituverava",3,"Sudeste",1,"352010",5,21,5,16,6,15,0,0,0,0,0,21,5,16,6,15,18,10.5713841023425,10.3292126996517,0.408481941622362,31
"9877","SP","Igaratá",9583,19049.08,35050,"São José dos Campos",3,"Sudeste",0,"352020",2,12,1,11,5,7,0,0,0,0,0,12,1,11,5,7,5,9.8547740854254,9.16774597434376,0.302095872484639,29
"9878","SP","Igaratá",9583,19049.08,35050,"São José dos Campos",3,"Sudeste",0,"352020",3,10,1,9,2,8,1,0,1,1,0,11,1,10,3,8,6,9.8547740854254,9.16774597434376,0.376922954266778,31
"9879","SP","Igaratá",9583,19049.08,35050,"São José dos Campos",3,"Sudeste",0,"352020",4,8,1,7,5,3,0,0,0,0,0,8,1,7,5,3,8,9.8547740854254,9.16774597434376,0.43113751013433,30
"9880","SP","Igaratá",9583,19049.08,35050,"São José dos Campos",3,"Sudeste",0,"352020",5,13,1,12,4,9,0,0,0,0,0,13,1,12,4,9,10,9.8547740854254,9.16774597434376,0.425847907837246,31
"9881","SP","Iguape",30989,38078.83,35055,"Registro",3,"Sudeste",0,"352030",2,28,6,22,15,13,0,0,0,0,0,28,6,22,15,13,11,10.5474137636434,10.3413875817875,0.319469154705836,29
"9882","SP","Iguape",30989,38078.83,35055,"Registro",3,"Sudeste",0,"352030",3,27,4,23,16,11,0,0,0,0,0,27,4,23,16,11,18,10.5474137636434,10.3413875817875,0.447452564278926,31
"9883","SP","Iguape",30989,38078.83,35055,"Registro",3,"Sudeste",0,"352030",4,22,6,16,13,9,0,0,0,0,0,22,6,16,13,9,16,10.5474137636434,10.3413875817875,0.501772172813458,30
"9884","SP","Iguape",30989,38078.83,35055,"Registro",3,"Sudeste",0,"352030",5,27,8,19,13,14,0,0,0,0,0,27,8,19,13,14,26,10.5474137636434,10.3413875817875,0.479722924376485,31
"9885","SP","Ilhabela",35591,419457.22,35054,"Caraguatatuba",3,"Sudeste",1,"352040",2,24,1,23,10,14,0,0,0,0,0,24,1,23,10,14,11,12.9467168211433,10.4798480758898,0.270920225672191,29
"9886","SP","Ilhabela",35591,419457.22,35054,"Caraguatatuba",3,"Sudeste",1,"352040",3,25,3,22,12,13,0,0,0,0,0,25,3,22,12,13,13,12.9467168211433,10.4798480758898,0.401707901504587,31
"9887","SP","Ilhabela",35591,419457.22,35054,"Caraguatatuba",3,"Sudeste",1,"352040",4,24,3,21,8,16,1,0,1,0,1,25,3,22,8,17,6,12.9467168211433,10.4798480758898,0.488947201649469,30
"9888","SP","Ilhabela",35591,419457.22,35054,"Caraguatatuba",3,"Sudeste",1,"352040",5,28,4,24,9,19,0,0,0,0,0,28,4,24,9,19,19,12.9467168211433,10.4798480758898,0.463680045686137,31
"9889","SP","Ilha Comprida",11362,122204.12,35055,"Registro",3,"Sudeste",0,"352042",2,10,2,8,3,7,0,0,0,0,0,10,2,8,3,7,5,11.7134480403722,9.33802973311707,0.362546070214183,29
"9890","SP","Ilha Comprida",11362,122204.12,35055,"Registro",3,"Sudeste",0,"352042",3,7,5,2,5,2,0,0,0,0,0,7,5,2,5,2,2,11.7134480403722,9.33802973311707,0.468372844249901,31
"9891","SP","Ilha Comprida",11362,122204.12,35055,"Registro",3,"Sudeste",0,"352042",4,7,2,5,1,6,0,0,0,0,0,7,2,5,1,6,7,11.7134480403722,9.33802973311707,0.535229460038992,30
"9892","SP","Ilha Comprida",11362,122204.12,35055,"Registro",3,"Sudeste",0,"352042",5,7,0,7,3,4,0,0,0,0,0,7,0,7,3,4,6,11.7134480403722,9.33802973311707,0.505081261154447,31
"9893","SP","Ilha Solteira",26788,23525.05,35016,"Andradina",3,"Sudeste",1,"352044",2,13,3,10,2,11,0,0,0,0,0,13,3,10,2,11,24,10.0658210898498,10.1957093050299,0.314993043461341,29
"9894","SP","Ilha Solteira",26788,23525.05,35016,"Andradina",3,"Sudeste",1,"352044",3,5,1,4,0,5,0,0,0,0,0,5,1,4,0,5,27,10.0658210898498,10.1957093050299,0.408997132918555,31
"9895","SP","Ilha Solteira",26788,23525.05,35016,"Andradina",3,"Sudeste",1,"352044",4,6,1,5,2,4,0,0,0,0,0,6,1,5,2,4,14,10.0658210898498,10.1957093050299,0.483668855693571,30
"9896","SP","Ilha Solteira",26788,23525.05,35016,"Andradina",3,"Sudeste",1,"352044",5,2,1,1,0,2,1,0,1,0,1,3,1,2,0,3,12,10.0658210898498,10.1957093050299,0.437216615522385,31
"9897","SP","Indaiatuba",256223,63166.46,35032,"Campinas",3,"Sudeste",1,"352050",2,228,26,202,55,173,1,1,0,0,1,229,27,202,55,174,103,11.0535287430633,12.4538034380297,0.281780456345839,29
"9898","SP","Indaiatuba",256223,63166.46,35032,"Campinas",3,"Sudeste",1,"352050",3,214,32,182,74,140,4,0,4,2,2,218,32,186,76,142,130,11.0535287430633,12.4538034380297,0.386987287042884,31
"9899","SP","Indaiatuba",256223,63166.46,35032,"Campinas",3,"Sudeste",1,"352050",4,236,37,199,68,168,3,0,3,0,3,239,37,202,68,171,97,11.0535287430633,12.4538034380297,0.459749829504272,30
"9900","SP","Indaiatuba",256223,63166.46,35032,"Campinas",3,"Sudeste",1,"352050",5,256,38,218,66,190,1,0,1,0,1,257,38,219,66,191,157,11.0535287430633,12.4538034380297,0.419103711733172,31
"9901","SP","Indiana",4879,13109.17,35036,"Presidente Prudente",3,"Sudeste",1,"352060",2,5,0,5,3,2,0,0,0,0,0,5,0,5,3,2,4,9.48106726430352,8.49269555981584,0.308867401950304,29
"9902","SP","Indiana",4879,13109.17,35036,"Presidente Prudente",3,"Sudeste",1,"352060",3,1,0,1,0,1,0,0,0,0,0,1,0,1,0,1,0,9.48106726430352,8.49269555981584,0.40940339991422,31
"9903","SP","Indiana",4879,13109.17,35036,"Presidente Prudente",3,"Sudeste",1,"352060",4,0,0,0,0,0,0,0,0,0,0,0,0,0,0,0,1,9.48106726430352,8.49269555981584,0.450353483861963,30
"9904","SP","Indiana",4879,13109.17,35036,"Presidente Prudente",3,"Sudeste",1,"352060",5,2,0,2,0,2,0,0,0,0,0,2,0,2,0,2,1,9.48106726430352,8.49269555981584,0.433500994907905,31
"9905","SP","Inúbia Paulista",4019,34888.1,35035,"Adamantina",3,"Sudeste",1,"352080",2,5,1,4,0,5,0,0,0,0,0,5,1,4,0,5,0,10.4599010758336,8.2987883944492,0.287072272963157,29
"9906","SP","Inúbia Paulista",4019,34888.1,35035,"Adamantina",3,"Sudeste",1,"352080",3,4,1,3,4,0,0,0,0,0,0,4,1,3,4,0,4,10.4599010758336,8.2987883944492,0.338522030729506,31
"9907","SP","Inúbia Paulista",4019,34888.1,35035,"Adamantina",3,"Sudeste",1,"352080",4,2,0,2,0,2,0,0,0,0,0,2,0,2,0,2,1,10.4599010758336,8.2987883944492,0.381470491295428,30
"9908","SP","Inúbia Paulista",4019,34888.1,35035,"Adamantina",3,"Sudeste",1,"352080",5,3,0,3,1,2,0,0,0,0,0,3,0,3,1,2,2,10.4599010758336,8.2987883944492,0.391928302886518,31
"9909","SP","Ipaussu",15069,25086.47,35040,"Ourinhos",3,"Sudeste",1,"352090",2,9,3,6,3,6,0,0,0,0,0,9,3,6,3,6,9,10.1300839359588,9.62039493241815,0.321317707310747,29
"9910","SP","Ipaussu",15069,25086.47,35040,"Ourinhos",3,"Sudeste",1,"352090",3,21,5,16,7,14,0,0,0,0,0,21,5,16,7,14,9,10.1300839359588,9.62039493241815,0.391002094119962,31
"9911","SP","Ipaussu",15069,25086.47,35040,"Ourinhos",3,"Sudeste",1,"352090",4,8,3,5,2,6,0,0,0,0,0,8,3,5,2,6,12,10.1300839359588,9.62039493241815,0.425228712130731,30
"9912","SP","Ipaussu",15069,25086.47,35040,"Ourinhos",3,"Sudeste",1,"352090",5,12,1,11,4,8,0,0,0,0,0,12,1,11,4,8,14,10.1300839359588,9.62039493241815,0.384783724528581,31
"9913","SP","Iperó",37964,17873,35046,"Sorocaba",3,"Sudeste",1,"352100",2,29,5,24,11,18,0,0,0,0,0,29,5,24,11,18,19,9.79104647319038,10.5443936212504,0.31548193737484,29
"9914","SP","Iperó",37964,17873,35046,"Sorocaba",3,"Sudeste",1,"352100",3,29,6,23,9,20,0,0,0,0,0,29,6,23,9,20,20,9.79104647319038,10.5443936212504,0.397547019011195,31
"9915","SP","Iperó",37964,17873,35046,"Sorocaba",3,"Sudeste",1,"352100",4,32,7,25,14,18,0,0,0,0,0,32,7,25,14,18,14,9.79104647319038,10.5443936212504,0.441537825542895,30
"9916","SP","Iperó",37964,17873,35046,"Sorocaba",3,"Sudeste",1,"352100",5,28,5,23,10,18,0,0,0,0,0,28,5,23,10,18,21,9.79104647319038,10.5443936212504,0.415713714566312,31
"9917","SP","Ipeúna",7687,94080.97,35026,"Rio Claro",3,"Sudeste",1,"352110",2,4,1,3,1,3,0,0,0,0,0,4,1,3,1,3,3,11.4519110734535,8.94728586934913,0.312992685452317,29
"9918","SP","Ipeúna",7687,94080.97,35026,"Rio Claro",3,"Sudeste",1,"352110",3,7,3,4,4,3,0,0,0,0,0,7,3,4,4,3,10,11.4519110734535,8.94728586934913,0.376849377018908,31
"9919","SP","Ipeúna",7687,94080.97,35026,"Rio Claro",3,"Sudeste",1,"352110",4,6,2,4,1,5,0,0,0,0,0,6,2,4,1,5,5,11.4519110734535,8.94728586934913,0.418276345495432,30
"9920","SP","Ipeúna",7687,94080.97,35026,"Rio Claro",3,"Sudeste",1,"352110",5,9,2,7,3,6,0,0,0,0,0,9,2,7,3,6,2,11.4519110734535,8.94728586934913,0.383349406695748,31
"9921","SP","Ipiguá",5476,20253.65,35004,"São José do Rio Preto",3,"Sudeste",1,"352115",2,8,3,5,3,5,0,0,0,0,0,8,3,5,3,5,3,9.91609030320574,8.60813018640834,0.273583944511221,29
"9922","SP","Ipiguá",5476,20253.65,35004,"São José do Rio Preto",3,"Sudeste",1,"352115",3,8,3,5,0,8,0,0,0,0,0,8,3,5,0,8,2,9.91609030320574,8.60813018640834,0.366726798181798,31
"9923","SP","Ipiguá",5476,20253.65,35004,"São José do Rio Preto",3,"Sudeste",1,"352115",4,5,0,5,1,4,0,0,0,0,0,5,0,5,1,4,2,9.91609030320574,8.60813018640834,0.405827510706721,30
"9924","SP","Ipiguá",5476,20253.65,35004,"São José do Rio Preto",3,"Sudeste",1,"352115",5,5,0,5,2,3,0,0,0,0,0,5,0,5,2,3,5,9.91609030320574,8.60813018640834,0.397287622923241,31
"9925","SP","Ipuã",16604,22139.12,35010,"São Joaquim da Barra",3,"Sudeste",1,"352130",2,17,2,15,4,13,0,0,0,0,0,17,2,15,4,13,5,10.0051014584086,9.71739890917293,0.314952376685277,29
"9926","SP","Ipuã",16604,22139.12,35010,"São Joaquim da Barra",3,"Sudeste",1,"352130",3,20,6,14,11,9,0,0,0,0,0,20,6,14,11,9,6,10.0051014584086,9.71739890917293,0.391062858652681,31
"9927","SP","Ipuã",16604,22139.12,35010,"São Joaquim da Barra",3,"Sudeste",1,"352130",4,10,3,7,5,5,0,0,0,0,0,10,3,7,5,5,8,10.0051014584086,9.71739890917293,0.407802184810719,30
"9928","SP","Ipuã",16604,22139.12,35010,"São Joaquim da Barra",3,"Sudeste",1,"352130",5,19,1,18,9,10,0,0,0,0,0,19,1,18,9,10,11,10.0051014584086,9.71739890917293,0.415277906019611,31
"9929","SP","Iracemápolis",24614,83477.19,35027,"Limeira",3,"Sudeste",1,"352140",2,16,3,13,3,13,0,0,0,0,0,16,3,13,3,13,9,11.3323286998675,10.1110706657323,0.295949210613663,29
"9930","SP","Iracemápolis",24614,83477.19,35027,"Limeira",3,"Sudeste",1,"352140",3,21,2,19,7,14,0,0,0,0,0,21,2,19,7,14,6,11.3323286998675,10.1110706657323,0.38970885816042,31
"9931","SP","Iracemápolis",24614,83477.19,35027,"Limeira",3,"Sudeste",1,"352140",4,21,3,18,8,13,0,0,0,0,0,21,3,18,8,13,2,11.3323286998675,10.1110706657323,0.433865489705313,30
"9932","SP","Iracemápolis",24614,83477.19,35027,"Limeira",3,"Sudeste",1,"352140",5,28,2,26,7,21,0,0,0,0,0,28,2,26,7,21,16,11.3323286998675,10.1110706657323,0.394634902501812,31
"9933","SP","Irapuã",8048,19748.75,35008,"Novo Horizonte",3,"Sudeste",0,"352150",2,5,1,4,2,3,0,0,0,0,0,5,1,4,2,3,6,9.89084547718706,8.99317889233952,0.28060834571496,29
"9934","SP","Irapuã",8048,19748.75,35008,"Novo Horizonte",3,"Sudeste",0,"352150",3,6,2,4,2,4,0,0,0,0,0,6,2,4,2,4,2,9.89084547718706,8.99317889233952,0.339075400924234,31
"9935","SP","Irapuã",8048,19748.75,35008,"Novo Horizonte",3,"Sudeste",0,"352150",4,10,5,5,4,6,0,0,0,0,0,10,5,5,4,6,2,9.89084547718706,8.99317889233952,0.372038980140538,30
"9936","SP","Irapuã",8048,19748.75,35008,"Novo Horizonte",3,"Sudeste",0,"352150",5,6,0,6,3,3,0,0,0,0,0,6,0,6,3,3,5,9.89084547718706,8.99317889233952,0.363601224851426,31
"9937","SP","Irapuru",8325,10659.85,35035,"Adamantina",3,"Sudeste",0,"352160",2,5,1,4,3,2,0,0,0,0,0,5,1,4,3,2,6,9.27423962632627,9.02701831484864,0.286982417472897,29
"9938","SP","Irapuru",8325,10659.85,35035,"Adamantina",3,"Sudeste",0,"352160",3,4,0,4,2,2,0,0,0,0,0,4,0,4,2,2,2,9.27423962632627,9.02701831484864,0.393351493067222,31
"9939","SP","Irapuru",8325,10659.85,35035,"Adamantina",3,"Sudeste",0,"352160",4,6,1,5,0,6,0,0,0,0,0,6,1,5,0,6,4,9.27423962632627,9.02701831484864,0.425665726524551,30
"9940","SP","Irapuru",8325,10659.85,35035,"Adamantina",3,"Sudeste",0,"352160",5,7,2,5,1,6,0,0,0,0,0,7,2,5,1,6,7,9.27423962632627,9.02701831484864,0.440632696513268,31
"9941","SP","Itaberá",17480,29569.7,35041,"Itapeva",3,"Sudeste",0,"352170",2,16,3,13,6,10,0,0,0,0,0,16,3,13,6,10,12,10.2945054673774,9.76881264920953,0.315559387575212,29
"9942","SP","Itaberá",17480,29569.7,35041,"Itapeva",3,"Sudeste",0,"352170",3,14,2,12,9,5,0,0,0,0,0,14,2,12,9,5,10,10.2945054673774,9.76881264920953,0.409620680934336,31
"9943","SP","Itaberá",17480,29569.7,35041,"Itapeva",3,"Sudeste",0,"352170",4,11,1,10,6,5,0,0,0,0,0,11,1,10,6,5,10,10.2945054673774,9.76881264920953,0.455089283315809,30
"9944","SP","Itaberá",17480,29569.7,35041,"Itapeva",3,"Sudeste",0,"352170",5,22,3,19,8,14,0,0,0,0,0,22,3,19,8,14,8,10.2945054673774,9.76881264920953,0.456423001965969,31
"9945","SP","Itaí",27382,22376.97,35022,"Avaré",3,"Sudeste",1,"352180",2,24,5,19,11,13,0,0,0,0,0,24,5,19,11,13,16,10.0157875839601,10.2176411421937,0.341753233405522,29
"9946","SP","Itaí",27382,22376.97,35022,"Avaré",3,"Sudeste",1,"352180",3,28,10,18,15,13,0,0,0,0,0,28,10,18,15,13,12,10.0157875839601,10.2176411421937,0.425473096909511,31
"9947","SP","Itaí",27382,22376.97,35022,"Avaré",3,"Sudeste",1,"352180",4,21,7,14,8,13,0,0,0,0,0,21,7,14,8,13,15,10.0157875839601,10.2176411421937,0.452171835779816,30
"9948","SP","Itaí",27382,22376.97,35022,"Avaré",3,"Sudeste",1,"352180",5,24,5,19,8,16,1,0,1,0,1,25,5,20,8,17,21,10.0157875839601,10.2176411421937,0.444766289712887,31
"9949","SP","Itajobi",15297,105038.02,35008,"Novo Horizonte",3,"Sudeste",1,"352190",2,13,3,10,3,10,0,0,0,0,0,13,3,10,3,10,14,11.5620776588371,9.63541200972327,0.280312484513708,29
"9950","SP","Itajobi",15297,105038.02,35008,"Novo Horizonte",3,"Sudeste",1,"352190",3,13,3,10,2,11,0,0,0,0,0,13,3,10,2,11,11,11.5620776588371,9.63541200972327,0.355507080331945,31
"9951","SP","Itajobi",15297,105038.02,35008,"Novo Horizonte",3,"Sudeste",1,"352190",4,24,6,18,11,13,0,0,0,0,0,24,6,18,11,13,12,11.5620776588371,9.63541200972327,0.383112354587911,30
"9952","SP","Itajobi",15297,105038.02,35008,"Novo Horizonte",3,"Sudeste",1,"352190",5,8,3,5,3,5,0,0,0,0,0,8,3,5,3,5,11,11.5620776588371,9.63541200972327,0.373986481392607,31
"9953","SP","Itanhaém",103102,18763.24,35056,"Itanhaém",3,"Sudeste",1,"352210",2,107,19,88,43,64,0,0,0,0,0,107,19,88,43,64,63,9.83965491553705,11.543474068459,0.338110764394249,29
"9954","SP","Itanhaém",103102,18763.24,35056,"Itanhaém",3,"Sudeste",1,"352210",3,92,20,72,34,58,0,0,0,0,0,92,20,72,34,58,62,9.83965491553705,11.543474068459,0.442067075823124,31
"9955","SP","Itanhaém",103102,18763.24,35056,"Itanhaém",3,"Sudeste",1,"352210",4,121,24,97,48,73,1,0,1,0,1,122,24,98,48,74,67,9.83965491553705,11.543474068459,0.49074275595581,30
"9956","SP","Itanhaém",103102,18763.24,35056,"Itanhaém",3,"Sudeste",1,"352210",5,115,13,102,54,61,2,0,2,1,1,117,13,104,55,62,117,9.83965491553705,11.543474068459,0.457358528596528,31
"9957","SP","Itapecerica da Serra",177662,21079.61,35060,"Itapecerica da Serra",3,"Sudeste",1,"352220",2,168,22,146,68,100,5,0,5,3,2,173,22,151,71,102,74,9.95606150153539,12.0876381477184,0.306044558515994,29
"9958","SP","Itapecerica da Serra",177662,21079.61,35060,"Itapecerica da Serra",3,"Sudeste",1,"352220",3,165,30,135,55,110,3,1,2,2,1,168,31,137,57,111,76,9.95606150153539,12.0876381477184,0.403305813441984,31
"9959","SP","Itapecerica da Serra",177662,21079.61,35060,"Itapecerica da Serra",3,"Sudeste",1,"352220",4,160,24,136,61,99,0,0,0,0,0,160,24,136,61,99,88,9.95606150153539,12.0876381477184,0.47816495242322,30
"9960","SP","Itapecerica da Serra",177662,21079.61,35060,"Itapecerica da Serra",3,"Sudeste",1,"352220",5,197,26,171,65,132,6,1,5,3,3,203,27,176,68,135,124,9.95606150153539,12.0876381477184,0.455532386222844,31
"9961","SP","Itapetininga",165526,29304.81,35042,"Itapetininga",3,"Sudeste",1,"352230",2,124,19,105,43,81,0,0,0,0,0,124,19,105,43,81,78,10.2855069453543,12.0168835611583,0.295688279044915,29
"9962","SP","Itapetininga",165526,29304.81,35042,"Itapetininga",3,"Sudeste",1,"352230",3,147,17,130,54,93,0,0,0,0,0,147,17,130,54,93,96,10.2855069453543,12.0168835611583,0.391130704289526,31
"9963","SP","Itapetininga",165526,29304.81,35042,"Itapetininga",3,"Sudeste",1,"352230",4,158,14,144,70,88,0,0,0,0,0,158,14,144,70,88,74,10.2855069453543,12.0168835611583,0.448680412130867,30
"9964","SP","Itapetininga",165526,29304.81,35042,"Itapetininga",3,"Sudeste",1,"352230",5,170,22,148,65,105,1,0,1,0,1,171,22,149,65,106,78,10.2855069453543,12.0168835611583,0.412467161488047,31
"9965","SP","Itapeva",94804,26860.38,35041,"Itapeva",3,"Sudeste",1,"352240",2,100,19,81,42,58,1,1,0,1,0,101,20,81,43,58,51,10.1984076174083,11.4595668814458,0.332534363808986,29
"9966","SP","Itapeva",94804,26860.38,35041,"Itapeva",3,"Sudeste",1,"352240",3,100,18,82,41,59,0,0,0,0,0,100,18,82,41,59,56,10.1984076174083,11.4595668814458,0.434157391403704,31
"9967","SP","Itapeva",94804,26860.38,35041,"Itapeva",3,"Sudeste",1,"352240",4,138,29,109,62,76,0,0,0,0,0,138,29,109,62,76,68,10.1984076174083,11.4595668814458,0.491498639920407,30
"9968","SP","Itapeva",94804,26860.38,35041,"Itapeva",3,"Sudeste",1,"352240",5,122,27,95,43,79,2,0,2,2,0,124,27,97,45,79,59,10.1984076174083,11.4595668814458,0.456784795573876,31
"9969","SP","Itapevi",240961,51939.22,35057,"Osasco",3,"Sudeste",1,"352250",2,275,28,247,117,158,0,0,0,0,0,275,28,247,117,158,99,10.8578294677763,12.3923903736515,0.296982920370828,29
"9970","SP","Itapevi",240961,51939.22,35057,"Osasco",3,"Sudeste",1,"352250",3,292,45,247,118,174,2,0,2,0,2,294,45,249,118,176,107,10.8578294677763,12.3923903736515,0.394798207973219,31
"9971","SP","Itapevi",240961,51939.22,35057,"Osasco",3,"Sudeste",1,"352250",4,293,49,244,105,188,3,0,3,2,1,296,49,247,107,189,118,10.8578294677763,12.3923903736515,0.466955617700889,30
"9972","SP","Itapevi",240961,51939.22,35057,"Osasco",3,"Sudeste",1,"352250",5,345,53,292,139,206,3,1,2,2,1,348,54,294,141,207,156,10.8578294677763,12.3923903736515,0.447760343680669,31
"9973","SP","Itapira",75234,52565.34,35031,"Mogi Mirim",3,"Sudeste",1,"352260",2,54,10,44,17,37,0,0,0,0,0,54,10,44,17,37,41,10.8698122461713,11.2283585354186,0.301580947282249,29
"9974","SP","Itapira",75234,52565.34,35031,"Mogi Mirim",3,"Sudeste",1,"352260",3,53,8,45,14,39,1,0,1,0,1,54,8,46,14,40,50,10.8698122461713,11.2283585354186,0.385841194797841,31
"9975","SP","Itapira",75234,52565.34,35031,"Mogi Mirim",3,"Sudeste",1,"352260",4,58,9,49,18,40,0,0,0,0,0,58,9,49,18,40,37,10.8698122461713,11.2283585354186,0.43955459403842,30
"9976","SP","Itapira",75234,52565.34,35031,"Mogi Mirim",3,"Sudeste",1,"352260",5,61,13,48,20,41,1,0,1,0,1,62,13,49,20,42,44,10.8698122461713,11.2283585354186,0.401200187187737,31
"9977","SP","Itápolis",43331,30504.92,35024,"Araraquara",3,"Sudeste",1,"352270",2,22,4,18,4,18,1,0,1,1,0,23,4,19,5,18,27,10.3256432610616,10.676623593166,0.289804955931916,29
"9978","SP","Itápolis",43331,30504.92,35024,"Araraquara",3,"Sudeste",1,"352270",3,28,3,25,9,19,0,0,0,0,0,28,3,25,9,19,26,10.3256432610616,10.676623593166,0.361444151837737,31
"9979","SP","Itápolis",43331,30504.92,35024,"Araraquara",3,"Sudeste",1,"352270",4,24,2,22,6,18,0,0,0,0,0,24,2,22,6,18,39,10.3256432610616,10.676623593166,0.387189178612275,30
"9980","SP","Itápolis",43331,30504.92,35024,"Araraquara",3,"Sudeste",1,"352270",5,32,10,22,11,21,1,0,1,0,1,33,10,23,11,22,27,10.3256432610616,10.676623593166,0.360093323311194,31
"9981","SP","Itaporanga",15173,21229.91,35041,"Itapeva",3,"Sudeste",0,"352280",2,21,2,19,7,14,0,0,0,0,0,21,2,19,7,14,6,9.96316631540428,9.62727281152524,0.339722366626179,29
"9982","SP","Itaporanga",15173,21229.91,35041,"Itapeva",3,"Sudeste",0,"352280",3,11,1,10,6,5,0,0,0,0,0,11,1,10,6,5,11,9.96316631540428,9.62727281152524,0.403839652431756,31
"9983","SP","Itaporanga",15173,21229.91,35041,"Itapeva",3,"Sudeste",0,"352280",4,14,1,13,6,8,0,0,0,0,0,14,1,13,6,8,13,9.96316631540428,9.62727281152524,0.467042311392468,30
"9984","SP","Itaporanga",15173,21229.91,35041,"Itapeva",3,"Sudeste",0,"352280",5,23,2,21,11,12,1,0,1,1,0,24,2,22,12,12,11,9.96316631540428,9.62727281152524,0.449513705671898,31
"9985","SP","Itapuí",14147,48103.23,35021,"Jaú",3,"Sudeste",1,"352290",2,16,3,13,6,10,0,0,0,0,0,16,3,13,6,10,5,10.7811046056064,9.55725786645893,0.328844745823676,29
"9986","SP","Itapuí",14147,48103.23,35021,"Jaú",3,"Sudeste",1,"352290",3,13,3,10,8,5,0,0,0,0,0,13,3,10,8,5,7,10.7811046056064,9.55725786645893,0.398078184722689,31
"9987","SP","Itapuí",14147,48103.23,35021,"Jaú",3,"Sudeste",1,"352290",4,14,6,8,5,9,0,0,0,0,0,14,6,8,5,9,10,10.7811046056064,9.55725786645893,0.414072577716551,30
"9988","SP","Itapuí",14147,48103.23,35021,"Jaú",3,"Sudeste",1,"352290",5,15,5,10,6,9,0,0,0,0,0,15,5,10,6,9,11,10.7811046056064,9.55725786645893,0.396989651021673,31
"9989","SP","Itaquaquecetuba",375011,19678.54,35062,"Mogi das Cruzes",3,"Sudeste",1,"352310",2,433,59,374,156,277,4,0,4,0,4,437,59,378,156,281,144,9.88728398086238,12.8347106378557,0.311356492757643,29
"9990","SP","Itaquaquecetuba",375011,19678.54,35062,"Mogi das Cruzes",3,"Sudeste",1,"352310",3,439,63,376,160,279,7,1,6,7,0,446,64,382,167,279,166,9.88728398086238,12.8347106378557,0.407161103384832,31
"9991","SP","Itaquaquecetuba",375011,19678.54,35062,"Mogi das Cruzes",3,"Sudeste",1,"352310",4,422,54,368,177,245,4,2,2,2,2,426,56,370,179,247,153,9.88728398086238,12.8347106378557,0.470026238423693,30
"9992","SP","Itaquaquecetuba",375011,19678.54,35062,"Mogi das Cruzes",3,"Sudeste",1,"352310",5,435,76,359,179,256,4,1,3,2,2,439,77,362,181,258,220,9.88728398086238,12.8347106378557,0.442384387514782,31
"9993","SP","Itararé",50642,17452.03,35041,"Itapeva",3,"Sudeste",1,"352320",2,42,11,31,19,23,0,0,0,0,0,42,11,31,19,23,21,9.76721125324271,10.8325365505089,0.352624718604682,29
"9994","SP","Itararé",50642,17452.03,35041,"Itapeva",3,"Sudeste",1,"352320",3,51,11,40,18,33,0,0,0,0,0,51,11,40,18,33,29,9.76721125324271,10.8325365505089,0.453991857778372,31
"9995","SP","Itararé",50642,17452.03,35041,"Itapeva",3,"Sudeste",1,"352320",4,48,12,36,22,26,0,0,0,0,0,48,12,36,22,26,31,9.76721125324271,10.8325365505089,0.494344454343134,30
"9996","SP","Itararé",50642,17452.03,35041,"Itapeva",3,"Sudeste",1,"352320",5,42,9,33,11,31,0,0,0,0,0,42,9,33,11,31,28,9.76721125324271,10.8325365505089,0.471846482957205,31
"9997","SP","Itariri",17598,15990.63,35056,"Itanhaém",3,"Sudeste",0,"352330",2,7,3,4,3,4,0,0,0,0,0,7,3,4,3,4,5,9.67975820467662,9.77554053820551,0.319496081779983,29
"9998","SP","Itariri",17598,15990.63,35056,"Itanhaém",3,"Sudeste",0,"352330",3,17,5,12,5,12,0,0,0,0,0,17,5,12,5,12,8,9.67975820467662,9.77554053820551,0.416705790715265,31
"9999","SP","Itariri",17598,15990.63,35056,"Itanhaém",3,"Sudeste",0,"352330",4,10,3,7,4,6,0,0,0,0,0,10,3,7,4,6,10,9.67975820467662,9.77554053820551,0.453534690582353,30
"10000","SP","Itariri",17598,15990.63,35056,"Itanhaém",3,"Sudeste",0,"352330",5,10,3,7,4,6,0,0,0,0,0,10,3,7,4,6,6,9.67975820467662,9.77554053820551,0.4499740271472,31
"10001","SP","Itatiba",122581,50811.86,35048,"Bragança Paulista",3,"Sudeste",1,"352340",2,109,20,89,43,66,0,0,0,0,0,109,20,89,43,66,48,10.8358850708849,11.7165273149441,0.287845093206482,29
"10002","SP","Itatiba",122581,50811.86,35048,"Bragança Paulista",3,"Sudeste",1,"352340",3,130,19,111,40,90,1,0,1,0,1,131,19,112,40,91,57,10.8358850708849,11.7165273149441,0.388885759156476,31
"10003","SP","Itatiba",122581,50811.86,35048,"Bragança Paulista",3,"Sudeste",1,"352340",4,93,10,83,34,59,1,1,0,0,1,94,11,83,34,60,63,10.8358850708849,11.7165273149441,0.450609152912754,30
"10004","SP","Itatiba",122581,50811.86,35048,"Bragança Paulista",3,"Sudeste",1,"352340",5,114,12,102,33,81,1,1,0,1,0,115,13,102,34,81,58,10.8358850708849,11.7165273149441,0.413580116391391,31
"10005","SP","Itatinga",20921,20051.45,35022,"Avaré",3,"Sudeste",1,"352350",2,19,2,17,7,12,0,0,0,0,0,19,2,17,7,12,5,9.9060567493218,9.94850871818365,0.31127711525479,29
"10006","SP","Itatinga",20921,20051.45,35022,"Avaré",3,"Sudeste",1,"352350",3,19,4,15,6,13,0,0,0,0,0,19,4,15,6,13,9,9.9060567493218,9.94850871818365,0.375837936627032,31
"10007","SP","Itatinga",20921,20051.45,35022,"Avaré",3,"Sudeste",1,"352350",4,14,5,9,6,8,0,0,0,0,0,14,5,9,6,8,11,9.9060567493218,9.94850871818365,0.429854602635451,30
"10008","SP","Itatinga",20921,20051.45,35022,"Avaré",3,"Sudeste",1,"352350",5,25,9,16,8,17,1,1,0,0,1,26,10,16,8,18,11,9.9060567493218,9.94850871818365,0.409249968238009,31
"10009","SP","Itirapina",18387,22943.13,35026,"Rio Claro",3,"Sudeste",1,"352360",2,15,3,12,5,10,0,0,0,0,0,15,3,12,5,10,8,10.0407738242704,9.81939917215384,0.333716028580802,29
"10010","SP","Itirapina",18387,22943.13,35026,"Rio Claro",3,"Sudeste",1,"352360",3,13,4,9,6,7,0,0,0,0,0,13,4,9,6,7,7,10.0407738242704,9.81939917215384,0.419246621200418,31
"10011","SP","Itirapina",18387,22943.13,35026,"Rio Claro",3,"Sudeste",1,"352360",4,13,2,11,6,7,0,0,0,0,0,13,2,11,6,7,6,10.0407738242704,9.81939917215384,0.463020836777078,30
"10012","SP","Itirapina",18387,22943.13,35026,"Rio Claro",3,"Sudeste",1,"352360",5,16,3,13,4,12,0,0,0,0,0,16,3,13,4,12,13,10.0407738242704,9.81939917215384,0.449204283160754,31
"10013","SP","Itirapuã",6543,15275.66,35012,"Franca",3,"Sudeste",1,"352370",2,5,0,5,1,4,0,0,0,0,0,5,0,5,1,4,3,9.63401599096234,8.78615105486974,0.348306259241582,29
"10014","SP","Itirapuã",6543,15275.66,35012,"Franca",3,"Sudeste",1,"352370",3,6,2,4,2,4,0,0,0,0,0,6,2,4,2,4,4,9.63401599096234,8.78615105486974,0.418639651152263,31
"10015","SP","Itirapuã",6543,15275.66,35012,"Franca",3,"Sudeste",1,"352370",4,3,0,3,0,3,0,0,0,0,0,3,0,3,0,3,1,9.63401599096234,8.78615105486974,0.421464979474004,30
"10016","SP","Itirapuã",6543,15275.66,35012,"Franca",3,"Sudeste",1,"352370",5,4,1,3,1,3,0,0,0,0,0,4,1,3,1,3,1,9.63401599096234,8.78615105486974,0.421107820072567,31
"10017","SP","Itobi",7852,15939.55,35030,"São João da Boa Vista",3,"Sudeste",0,"352380",2,7,1,6,3,4,0,0,0,0,0,7,1,6,3,4,4,9.67655872107996,8.96852355539635,0.349166652188021,29
"10018","SP","Itobi",7852,15939.55,35030,"São João da Boa Vista",3,"Sudeste",0,"352380",3,5,1,4,2,3,0,0,0,0,0,5,1,4,2,3,4,9.67655872107996,8.96852355539635,0.417180705499436,31
"10019","SP","Itobi",7852,15939.55,35030,"São João da Boa Vista",3,"Sudeste",0,"352380",4,4,1,3,2,2,0,0,0,0,0,4,1,3,2,2,2,9.67655872107996,8.96852355539635,0.446275734415939,30
"10020","SP","Itobi",7852,15939.55,35030,"São João da Boa Vista",3,"Sudeste",0,"352380",5,1,0,1,0,1,0,0,0,0,0,1,0,1,0,1,3,9.67655872107996,8.96852355539635,0.433992508053991,31
"10021","SP","Itu",175568,45461.13,35046,"Sorocaba",3,"Sudeste",1,"352390",2,174,38,136,62,112,0,0,0,0,0,174,38,136,62,112,82,10.7246129541148,12.0757817112306,0.299399741250974,29
"10022","SP","Itu",175568,45461.13,35046,"Sorocaba",3,"Sudeste",1,"352390",3,152,25,127,64,88,3,0,3,3,0,155,25,130,67,88,105,10.7246129541148,12.0757817112306,0.394287960860746,31
"10023","SP","Itu",175568,45461.13,35046,"Sorocaba",3,"Sudeste",1,"352390",4,183,34,149,60,123,0,0,0,0,0,183,34,149,60,123,89,10.7246129541148,12.0757817112306,0.463799722234761,30
"10024","SP","Itu",175568,45461.13,35046,"Sorocaba",3,"Sudeste",1,"352390",5,184,36,148,55,129,0,0,0,0,0,184,36,148,55,129,109,10.7246129541148,12.0757817112306,0.435236135130579,31
"10025","SP","Itupeva",62813,112159.24,35047,"Jundiaí",3,"Sudeste",1,"352400",2,61,10,51,17,44,0,0,0,0,0,61,10,51,17,44,19,11.6276749262112,11.0479173374029,0.298307081477348,29
"10026","SP","Itupeva",62813,112159.24,35047,"Jundiaí",3,"Sudeste",1,"352400",3,69,8,61,23,46,0,0,0,0,0,69,8,61,23,46,32,11.6276749262112,11.0479173374029,0.391526516325771,31
"10027","SP","Itupeva",62813,112159.24,35047,"Jundiaí",3,"Sudeste",1,"352400",4,72,13,59,24,48,0,0,0,0,0,72,13,59,24,48,19,11.6276749262112,11.0479173374029,0.444253622469286,30
"10028","SP","Itupeva",62813,112159.24,35047,"Jundiaí",3,"Sudeste",1,"352400",5,59,10,49,19,40,0,0,0,0,0,59,10,49,19,40,31,11.6276749262112,11.0479173374029,0.416066697299573,31
"10029","SP","Ituverava",42045,36651.33,35011,"Ituverava",3,"Sudeste",1,"352410",2,38,8,30,8,30,0,0,0,0,0,38,8,30,8,30,20,10.5092049958787,10.646495752267,0.300515273150552,29
"10030","SP","Ituverava",42045,36651.33,35011,"Ituverava",3,"Sudeste",1,"352410",3,47,11,36,21,26,2,0,2,1,1,49,11,38,22,27,22,10.5092049958787,10.646495752267,0.38323758941725,31
"10031","SP","Ituverava",42045,36651.33,35011,"Ituverava",3,"Sudeste",1,"352410",4,23,1,22,5,18,0,0,0,0,0,23,1,22,5,18,25,10.5092049958787,10.646495752267,0.434819991296465,30
"10032","SP","Ituverava",42045,36651.33,35011,"Ituverava",3,"Sudeste",1,"352410",5,34,4,30,10,24,0,0,0,0,0,34,4,30,10,24,27,10.5092049958787,10.646495752267,0.412519488546092,31
"10033","SP","Jaborandi",6946,19946.28,35010,"São Joaquim da Barra",3,"Sudeste",0,"352420",2,3,0,3,1,2,0,0,0,0,0,3,0,3,1,2,5,9.90079793876562,8.84592123330402,0.301426670545728,29
"10034","SP","Jaborandi",6946,19946.28,35010,"São Joaquim da Barra",3,"Sudeste",0,"352420",3,7,2,5,2,5,0,0,0,0,0,7,2,5,2,5,2,9.90079793876562,8.84592123330402,0.372300969155299,31
"10035","SP","Jaborandi",6946,19946.28,35010,"São Joaquim da Barra",3,"Sudeste",0,"352420",4,3,1,2,1,2,0,0,0,0,0,3,1,2,1,2,2,9.90079793876562,8.84592123330402,0.403424318914426,30
"10036","SP","Jaborandi",6946,19946.28,35010,"São Joaquim da Barra",3,"Sudeste",0,"352420",5,5,1,4,2,3,0,0,0,0,0,5,1,4,2,3,6,9.90079793876562,8.84592123330402,0.364496031421012,31
"10037","SP","Jaboticabal",77652,37818.06,35013,"Jaboticabal",3,"Sudeste",1,"352430",2,65,12,53,21,44,0,0,0,0,0,65,12,53,21,44,44,10.540542045286,11.2599925848453,0.298251446371844,29
"10038","SP","Jaboticabal",77652,37818.06,35013,"Jaboticabal",3,"Sudeste",1,"352430",3,55,9,46,20,35,1,0,1,1,0,56,9,47,21,35,53,10.540542045286,11.2599925848453,0.389718376576362,31
"10039","SP","Jaboticabal",77652,37818.06,35013,"Jaboticabal",3,"Sudeste",1,"352430",4,55,12,43,18,37,0,0,0,0,0,55,12,43,18,37,50,10.540542045286,11.2599925848453,0.446797677047785,30
"10040","SP","Jaboticabal",77652,37818.06,35013,"Jaboticabal",3,"Sudeste",1,"352430",5,66,7,59,21,45,1,0,1,1,0,67,7,60,22,45,54,10.540542045286,11.2599925848453,0.404201687889292,31
"10041","SP","Jacareí",235416,54796.98,35050,"São José dos Campos",3,"Sudeste",1,"352440",2,244,23,221,75,169,2,0,2,0,2,246,23,223,75,171,128,10.9113903619285,12.3691094409123,0.291465064479926,29
"10042","SP","Jacareí",235416,54796.98,35050,"São José dos Campos",3,"Sudeste",1,"352440",3,222,9,213,70,152,0,0,0,0,0,222,9,213,70,152,102,10.9113903619285,12.3691094409123,0.395094093072184,31
"10043","SP","Jacareí",235416,54796.98,35050,"São José dos Campos",3,"Sudeste",1,"352440",4,197,26,171,65,132,2,0,2,1,1,199,26,173,66,133,124,10.9113903619285,12.3691094409123,0.463255415756845,30
"10044","SP","Jacareí",235416,54796.98,35050,"São José dos Campos",3,"Sudeste",1,"352440",5,248,26,222,77,171,0,0,0,0,0,248,26,222,77,171,120,10.9113903619285,12.3691094409123,0.424712664143398,31
"10045","SP","Jaci",7196,56703.27,35004,"São José do Rio Preto",3,"Sudeste",1,"352450",2,6,0,6,1,5,0,0,0,0,0,6,0,6,1,5,7,10.9455871600106,8.88128059507042,0.295285651292995,29
"10046","SP","Jaci",7196,56703.27,35004,"São José do Rio Preto",3,"Sudeste",1,"352450",3,4,1,3,1,3,0,0,0,0,0,4,1,3,1,3,4,10.9455871600106,8.88128059507042,0.357099347648909,31
"10047","SP","Jaci",7196,56703.27,35004,"São José do Rio Preto",3,"Sudeste",1,"352450",4,14,8,6,4,10,0,0,0,0,0,14,8,6,4,10,7,10.9455871600106,8.88128059507042,0.392838359895935,30
"10048","SP","Jaci",7196,56703.27,35004,"São José do Rio Preto",3,"Sudeste",1,"352450",5,7,1,6,3,4,0,0,0,0,0,7,1,6,3,4,5,10.9455871600106,8.88128059507042,0.36868164656929,31
"10049","SP","Jacupiranga",17889,29728.97,35055,"Registro",3,"Sudeste",0,"352460",2,10,2,8,3,7,0,0,0,0,0,10,2,8,3,7,7,10.2998772702524,9.79194127779122,0.341756610644657,29
"10050","SP","Jacupiranga",17889,29728.97,35055,"Registro",3,"Sudeste",0,"352460",3,16,4,12,9,7,0,0,0,0,0,16,4,12,9,7,10,10.2998772702524,9.79194127779122,0.410485726991866,31
"10051","SP","Jacupiranga",17889,29728.97,35055,"Registro",3,"Sudeste",0,"352460",4,13,3,10,8,5,0,0,0,0,0,13,3,10,8,5,11,10.2998772702524,9.79194127779122,0.472935345739583,30
"10052","SP","Jacupiranga",17889,29728.97,35055,"Registro",3,"Sudeste",0,"352460",5,27,10,17,12,15,1,0,1,0,1,28,10,18,12,16,10,10.2998772702524,9.79194127779122,0.460457187024388,31
"10053","SP","Jaguariúna",58722,205080.73,35032,"Campinas",3,"Sudeste",1,"352470",2,46,3,43,17,29,1,0,1,0,1,47,3,44,17,30,21,12.2311589854778,10.9805697226539,0.303735341798058,29
"10054","SP","Jaguariúna",58722,205080.73,35032,"Campinas",3,"Sudeste",1,"352470",3,61,7,54,20,41,0,0,0,0,0,61,7,54,20,41,33,12.2311589854778,10.9805697226539,0.405540413813654,31
"10055","SP","Jaguariúna",58722,205080.73,35032,"Campinas",3,"Sudeste",1,"352470",4,54,6,48,17,37,0,0,0,0,0,54,6,48,17,37,24,12.2311589854778,10.9805697226539,0.476003199183793,30
"10056","SP","Jaguariúna",58722,205080.73,35032,"Campinas",3,"Sudeste",1,"352470",5,69,5,64,21,48,0,0,0,0,0,69,5,64,21,48,29,12.2311589854778,10.9805697226539,0.438746476189531,31
"10057","SP","Jales",49201,31555.69,35001,"Jales",3,"Sudeste",1,"352480",2,31,2,29,11,20,0,0,0,0,0,31,2,29,11,20,33,10.3595092003614,10.8036692274771,0.282059020942632,29
"10058","SP","Jales",49201,31555.69,35001,"Jales",3,"Sudeste",1,"352480",3,52,2,50,15,37,0,0,0,0,0,52,2,50,15,37,41,10.3595092003614,10.8036692274771,0.368020357310283,31
"10059","SP","Jales",49201,31555.69,35001,"Jales",3,"Sudeste",1,"352480",4,33,2,31,8,25,1,0,1,0,1,34,2,32,8,26,28,10.3595092003614,10.8036692274771,0.40242635211409,30
"10060","SP","Jales",49201,31555.69,35001,"Jales",3,"Sudeste",1,"352480",5,52,6,46,17,35,0,0,0,0,0,52,6,46,17,35,33,10.3595092003614,10.8036692274771,0.351730470046715,31
"10061","SP","Jambeiro",6717,36754,35053,"Paraibuna/Paraitinga",3,"Sudeste",1,"352490",2,5,2,3,1,4,0,0,0,0,0,5,2,3,1,4,5,10.5120023422554,8.81239690526686,0.305901014806696,29
"10062","SP","Jambeiro",6717,36754,35053,"Paraibuna/Paraitinga",3,"Sudeste",1,"352490",3,3,0,3,1,2,0,0,0,0,0,3,0,3,1,2,6,10.5120023422554,8.81239690526686,0.385478112509685,31
"10063","SP","Jambeiro",6717,36754,35053,"Paraibuna/Paraitinga",3,"Sudeste",1,"352490",4,4,1,3,1,3,0,0,0,0,0,4,1,3,1,3,2,10.5120023422554,8.81239690526686,0.431636570721137,30
"10064","SP","Jambeiro",6717,36754,35053,"Paraibuna/Paraitinga",3,"Sudeste",1,"352490",5,6,2,4,2,4,0,0,0,0,0,6,2,4,2,4,3,10.5120023422554,8.81239690526686,0.418345286163291,31
"10065","SP","Jandira",126356,32512.79,35057,"Osasco",3,"Sudeste",1,"352500",2,105,8,97,37,68,0,0,0,0,0,105,8,97,37,68,37,10.3893888293634,11.7468585988278,0.290770191042463,29
"10066","SP","Jandira",126356,32512.79,35057,"Osasco",3,"Sudeste",1,"352500",3,121,16,105,45,76,1,0,1,1,0,122,16,106,46,76,51,10.3893888293634,11.7468585988278,0.391441673304435,31
"10067","SP","Jandira",126356,32512.79,35057,"Osasco",3,"Sudeste",1,"352500",4,109,16,93,39,70,0,0,0,0,0,109,16,93,39,70,63,10.3893888293634,11.7468585988278,0.475962146545321,30
"10068","SP","Jandira",126356,32512.79,35057,"Osasco",3,"Sudeste",1,"352500",5,122,20,102,43,79,1,0,1,0,1,123,20,103,43,80,71,10.3893888293634,11.7468585988278,0.450182457856318,31
"10069","SP","Jardinópolis",44970,25060.21,35014,"Ribeirão Preto",3,"Sudeste",1,"352510",2,34,9,25,11,23,0,0,0,0,0,34,9,25,11,23,25,10.1290366083032,10.7137508797648,0.282332386118555,29
"10070","SP","Jardinópolis",44970,25060.21,35014,"Ribeirão Preto",3,"Sudeste",1,"352510",3,21,7,14,7,14,1,0,1,0,1,22,7,15,7,15,21,10.1290366083032,10.7137508797648,0.370035770342547,31
"10071","SP","Jardinópolis",44970,25060.21,35014,"Ribeirão Preto",3,"Sudeste",1,"352510",4,45,12,33,18,27,0,0,0,0,0,45,12,33,18,27,23,10.1290366083032,10.7137508797648,0.414666539846692,30
"10072","SP","Jardinópolis",44970,25060.21,35014,"Ribeirão Preto",3,"Sudeste",1,"352510",5,50,13,37,18,32,0,0,0,0,0,50,13,37,18,32,25,10.1290366083032,10.7137508797648,0.381394235016112,31
"10073","SP","Jarinu",30617,85221.43,35048,"Bragança Paulista",3,"Sudeste",1,"352520",2,35,4,31,11,24,0,0,0,0,0,35,4,31,11,24,17,11.3530082070117,10.3293106892322,0.318041342489161,29
"10074","SP","Jarinu",30617,85221.43,35048,"Bragança Paulista",3,"Sudeste",1,"352520",3,30,8,22,13,17,0,0,0,0,0,30,8,22,13,17,19,11.3530082070117,10.3293106892322,0.414663429600877,31
"10075","SP","Jarinu",30617,85221.43,35048,"Bragança Paulista",3,"Sudeste",1,"352520",4,27,0,27,6,21,0,0,0,0,0,27,0,27,6,21,22,11.3530082070117,10.3293106892322,0.463104298200445,30
"10076","SP","Jarinu",30617,85221.43,35048,"Bragança Paulista",3,"Sudeste",1,"352520",5,45,12,33,16,29,0,0,0,0,0,45,12,33,16,29,26,11.3530082070117,10.3293106892322,0.443170062728707,31
"10077","SP","Jaú",151881,31855.35,35021,"Jaú",3,"Sudeste",1,"352530",2,93,25,68,37,56,1,0,1,0,1,94,25,69,37,57,78,10.3689606217764,11.9308525984694,0.293791175147489,29
"10078","SP","Jaú",151881,31855.35,35021,"Jaú",3,"Sudeste",1,"352530",3,121,23,98,46,75,3,1,2,0,3,124,24,100,46,78,94,10.3689606217764,11.9308525984694,0.391750611526838,31
"10079","SP","Jaú",151881,31855.35,35021,"Jaú",3,"Sudeste",1,"352530",4,92,11,81,20,72,0,0,0,0,0,92,11,81,20,72,68,10.3689606217764,11.9308525984694,0.449530233260508,30
"10080","SP","Jaú",151881,31855.35,35021,"Jaú",3,"Sudeste",1,"352530",5,117,29,88,41,76,1,0,1,0,1,118,29,89,41,77,100,10.3689606217764,11.9308525984694,0.419671669337911,31
"10081","SP","Joanópolis",13338,16262.42,35048,"Bragança Paulista",3,"Sudeste",0,"352550",2,13,5,8,6,7,0,0,0,0,0,13,5,8,6,7,7,9.69661220351581,9.49837238319225,0.280714078323224,29
"10082","SP","Joanópolis",13338,16262.42,35048,"Bragança Paulista",3,"Sudeste",0,"352550",3,13,3,10,5,8,0,0,0,0,0,13,3,10,5,8,9,9.69661220351581,9.49837238319225,0.376664905131459,31
"10083","SP","Joanópolis",13338,16262.42,35048,"Bragança Paulista",3,"Sudeste",0,"352550",4,9,1,8,4,5,0,0,0,0,0,9,1,8,4,5,11,9.69661220351581,9.49837238319225,0.440841432885144,30
"10084","SP","Joanópolis",13338,16262.42,35048,"Bragança Paulista",3,"Sudeste",0,"352550",5,8,4,4,5,3,0,0,0,0,0,8,4,4,5,3,19,9.69661220351581,9.49837238319225,0.445998604888714,31
"10085","SP","João Ramalho",4551,26890.88,35036,"Presidente Prudente",3,"Sudeste",0,"352560",2,7,0,7,3,4,0,0,0,0,0,7,0,7,3,4,2,10.1995424746478,8.42310226801664,0.311155510776289,29
"10086","SP","João Ramalho",4551,26890.88,35036,"Presidente Prudente",3,"Sudeste",0,"352560",3,4,1,3,1,3,0,0,0,0,0,4,1,3,1,3,2,10.1995424746478,8.42310226801664,0.415057103102121,31
"10087","SP","João Ramalho",4551,26890.88,35036,"Presidente Prudente",3,"Sudeste",0,"352560",4,2,0,2,1,1,0,0,0,0,0,2,0,2,1,1,1,10.1995424746478,8.42310226801664,0.406837550405219,30
"10088","SP","João Ramalho",4551,26890.88,35036,"Presidente Prudente",3,"Sudeste",0,"352560",5,6,1,5,3,3,0,0,0,0,0,6,1,5,3,3,1,10.1995424746478,8.42310226801664,0.389727772106648,31
"10089","SP","José Bonifácio",37366,36031.7,35004,"São José do Rio Preto",3,"Sudeste",1,"352570",2,29,3,26,8,21,1,0,1,0,1,30,3,27,8,22,19,10.4921543855322,10.5285164790198,0.283963325258898,29
"10090","SP","José Bonifácio",37366,36031.7,35004,"São José do Rio Preto",3,"Sudeste",1,"352570",3,39,6,33,17,22,0,0,0,0,0,39,6,33,17,22,24,10.4921543855322,10.5285164790198,0.360497697493203,31
"10091","SP","José Bonifácio",37366,36031.7,35004,"São José do Rio Preto",3,"Sudeste",1,"352570",4,43,9,34,9,34,1,0,1,0,1,44,9,35,9,35,23,10.4921543855322,10.5285164790198,0.399236033130776,30
"10092","SP","José Bonifácio",37366,36031.7,35004,"São José do Rio Preto",3,"Sudeste",1,"352570",5,44,5,39,14,30,0,0,0,0,0,44,5,39,14,30,23,10.4921543855322,10.5285164790198,0.37113028792605,31
"10093","SP","Júlio Mesquita",4800,10759.02,35019,"Lins",3,"Sudeste",0,"352580",2,4,1,3,0,4,0,0,0,0,0,4,1,3,0,4,1,9.283499751501,8.47637119689598,0.302216590086739,29
"10094","SP","Júlio Mesquita",4800,10759.02,35019,"Lins",3,"Sudeste",0,"352580",3,6,1,5,3,3,0,0,0,0,0,6,1,5,3,3,2,9.283499751501,8.47637119689598,0.374483727776159,31
"10095","SP","Júlio Mesquita",4800,10759.02,35019,"Lins",3,"Sudeste",0,"352580",4,6,0,6,2,4,0,0,0,0,0,6,0,6,2,4,2,9.283499751501,8.47637119689598,0.436359471444222,30
"10096","SP","Júlio Mesquita",4800,10759.02,35019,"Lins",3,"Sudeste",0,"352580",5,8,2,6,1,7,0,0,0,0,0,8,2,6,1,7,4,9.283499751501,8.47637119689598,0.395884529694941,31
"10097","SP","Jundiaí",423006,105187.65,35047,"Jundiaí",3,"Sudeste",1,"352590",2,438,36,402,106,332,5,0,5,2,3,443,36,407,108,335,220,11.5635011769571,12.955141642325,0.288008895796955,29
"10098","SP","Jundiaí",423006,105187.65,35047,"Jundiaí",3,"Sudeste",1,"352590",3,435,30,405,107,328,0,0,0,0,0,435,30,405,107,328,239,11.5635011769571,12.955141642325,0.401949664225892,31
"10099","SP","Jundiaí",423006,105187.65,35047,"Jundiaí",3,"Sudeste",1,"352590",4,459,38,421,135,324,1,1,0,0,1,460,39,421,135,325,243,11.5635011769571,12.955141642325,0.483668886811076,30
"10100","SP","Jundiaí",423006,105187.65,35047,"Jundiaí",3,"Sudeste",1,"352590",5,488,40,448,143,345,2,0,2,0,2,490,40,450,143,347,311,11.5635011769571,12.955141642325,0.443451129392041,31
"10101","SP","Junqueirópolis",20831,28071.57,35034,"Dracena",3,"Sudeste",1,"352600",2,18,3,15,9,9,0,0,0,0,0,18,3,15,9,9,14,10.2425125993914,9.94419754078391,0.291372351927367,29
"10102","SP","Junqueirópolis",20831,28071.57,35034,"Dracena",3,"Sudeste",1,"352600",3,13,2,11,3,10,0,0,0,0,0,13,2,11,3,10,14,10.2425125993914,9.94419754078391,0.380223976906791,31
"10103","SP","Junqueirópolis",20831,28071.57,35034,"Dracena",3,"Sudeste",1,"352600",4,13,0,13,1,12,1,0,1,1,0,14,0,14,2,12,16,10.2425125993914,9.94419754078391,0.406509874757565,30
"10104","SP","Junqueirópolis",20831,28071.57,35034,"Dracena",3,"Sudeste",1,"352600",5,27,1,26,5,22,0,0,0,0,0,27,1,26,5,22,19,10.2425125993914,9.94419754078391,0.373455679481871,31
"10105","SP","Juquiá",18718,17394.7,35055,"Registro",3,"Sudeste",0,"352610",2,14,2,12,3,11,0,0,0,0,0,14,2,12,3,11,14,9.76392084110217,9.8372409067172,0.309872150880901,29
"10106","SP","Juquiá",18718,17394.7,35055,"Registro",3,"Sudeste",0,"352610",3,12,4,8,7,5,0,0,0,0,0,12,4,8,7,5,14,9.76392084110217,9.8372409067172,0.399006103397176,31
"10107","SP","Juquiá",18718,17394.7,35055,"Registro",3,"Sudeste",0,"352610",4,16,3,13,8,8,0,0,0,0,0,16,3,13,8,8,20,9.76392084110217,9.8372409067172,0.448870274988665,30
"10108","SP","Juquiá",18718,17394.7,35055,"Registro",3,"Sudeste",0,"352610",5,16,3,13,4,12,1,0,1,1,0,17,3,14,5,12,10,9.76392084110217,9.8372409067172,0.434815229029977,31
"10109","SP","Juquitiba",31646,16452.82,35060,"Itapecerica da Serra",3,"Sudeste",0,"352620",2,38,7,31,18,20,1,1,0,1,0,39,8,31,19,20,8,9.70825217007275,10.3623670372789,0.329802479431275,29
"10110","SP","Juquitiba",31646,16452.82,35060,"Itapecerica da Serra",3,"Sudeste",0,"352620",3,26,1,25,9,17,0,0,0,0,0,26,1,25,9,17,25,9.70825217007275,10.3623670372789,0.396204579944374,31
"10111","SP","Juquitiba",31646,16452.82,35060,"Itapecerica da Serra",3,"Sudeste",0,"352620",4,29,3,26,10,19,0,0,0,0,0,29,3,26,10,19,27,9.70825217007275,10.3623670372789,0.459869929046042,30
"10112","SP","Juquitiba",31646,16452.82,35060,"Itapecerica da Serra",3,"Sudeste",0,"352620",5,24,8,16,14,10,1,1,0,0,1,25,9,16,14,11,16,9.70825217007275,10.3623670372789,0.463403719515089,31
"10113","SP","Laranjal Paulista",28785,39397.31,35043,"Tatuí",3,"Sudeste",1,"352640",2,28,9,19,6,22,1,0,1,0,1,29,9,20,6,23,19,10.5814528188436,10.2676096971099,0.32542365594982,29
"10114","SP","Laranjal Paulista",28785,39397.31,35043,"Tatuí",3,"Sudeste",1,"352640",3,29,10,19,13,16,1,1,0,1,0,30,11,19,14,16,18,10.5814528188436,10.2676096971099,0.411666884592704,31
"10115","SP","Laranjal Paulista",28785,39397.31,35043,"Tatuí",3,"Sudeste",1,"352640",4,32,11,21,13,19,0,0,0,0,0,32,11,21,13,19,14,10.5814528188436,10.2676096971099,0.469737010702235,30
"10116","SP","Laranjal Paulista",28785,39397.31,35043,"Tatuí",3,"Sudeste",1,"352640",5,38,16,22,18,20,0,0,0,0,0,38,16,22,18,20,20,10.5814528188436,10.2676096971099,0.433381098165882,31
"10117","SP","Lavínia",12285,13500.89,35017,"Araçatuba",3,"Sudeste",0,"352650",2,5,3,2,2,3,0,0,0,0,0,5,3,2,2,3,7,9.51051088817943,9.41613428495528,0.274732970668364,29
"10118","SP","Lavínia",12285,13500.89,35017,"Araçatuba",3,"Sudeste",0,"352650",3,3,0,3,2,1,0,0,0,0,0,3,0,3,2,1,4,9.51051088817943,9.41613428495528,0.358854481825106,31
"10119","SP","Lavínia",12285,13500.89,35017,"Araçatuba",3,"Sudeste",0,"352650",4,3,1,2,2,1,0,0,0,0,0,3,1,2,2,1,3,9.51051088817943,9.41613428495528,0.39482198272939,30
"10120","SP","Lavínia",12285,13500.89,35017,"Araçatuba",3,"Sudeste",0,"352650",5,0,0,0,0,0,0,0,0,0,0,0,0,0,0,0,0,9.51051088817943,9.41613428495528,0.388218977002959,31
"10121","SP","Lavrinhas",7311,15256.91,35051,"Guaratinguetá",3,"Sudeste",1,"352660",2,7,2,5,1,6,0,0,0,0,0,7,2,5,1,6,3,9.63278779416417,8.89713534229332,0.327157978570099,29
"10122","SP","Lavrinhas",7311,15256.91,35051,"Guaratinguetá",3,"Sudeste",1,"352660",3,11,2,9,6,5,0,0,0,0,0,11,2,9,6,5,6,9.63278779416417,8.89713534229332,0.451802158104104,31
"10123","SP","Lavrinhas",7311,15256.91,35051,"Guaratinguetá",3,"Sudeste",1,"352660",4,5,0,5,2,3,0,0,0,0,0,5,0,5,2,3,3,9.63278779416417,8.89713534229332,0.48799168301759,30
"10124","SP","Lavrinhas",7311,15256.91,35051,"Guaratinguetá",3,"Sudeste",1,"352660",5,5,0,5,1,4,0,0,0,0,0,5,0,5,1,4,1,9.63278779416417,8.89713534229332,0.460097006899411,31
"10125","SP","Leme",104346,31320.57,35027,"Limeira",3,"Sudeste",1,"352670",2,76,20,56,29,47,0,0,0,0,0,76,20,56,29,47,55,10.3520303491729,11.5554675792359,0.305611224707322,29
"10126","SP","Leme",104346,31320.57,35027,"Limeira",3,"Sudeste",1,"352670",3,90,20,70,41,49,1,1,0,0,1,91,21,70,41,50,65,10.3520303491729,11.5554675792359,0.391205912459731,31
"10127","SP","Leme",104346,31320.57,35027,"Limeira",3,"Sudeste",1,"352670",4,95,24,71,41,54,0,0,0,0,0,95,24,71,41,54,65,10.3520303491729,11.5554675792359,0.430712880486166,30
"10128","SP","Leme",104346,31320.57,35027,"Limeira",3,"Sudeste",1,"352670",5,86,21,65,31,55,0,0,0,0,0,86,21,65,31,55,57,10.3520303491729,11.5554675792359,0.398136601327735,31
"10129","SP","Lençóis Paulista",68990,38890.38,35020,"Bauru",3,"Sudeste",1,"352680",2,53,4,49,20,33,3,1,2,0,3,56,5,51,20,36,25,10.5685021982515,11.1417168455402,0.302256832776233,29
"10130","SP","Lençóis Paulista",68990,38890.38,35020,"Bauru",3,"Sudeste",1,"352680",3,61,4,57,18,43,0,0,0,0,0,61,4,57,18,43,45,10.5685021982515,11.1417168455402,0.388457834400965,31
"10131","SP","Lençóis Paulista",68990,38890.38,35020,"Bauru",3,"Sudeste",1,"352680",4,61,9,52,20,41,3,0,3,1,2,64,9,55,21,43,25,10.5685021982515,11.1417168455402,0.431000991655311,30
"10132","SP","Lençóis Paulista",68990,38890.38,35020,"Bauru",3,"Sudeste",1,"352680",5,71,11,60,25,46,0,0,0,0,0,71,11,60,25,46,43,10.5685021982515,11.1417168455402,0.399544111321524,31
"10133","SP","Limeira",308482,43440.26,35027,"Limeira",3,"Sudeste",1,"352690",2,225,31,194,68,157,4,1,3,3,1,229,32,197,71,158,167,10.6791419398569,12.6394187737858,0.2979343624418,29
"10134","SP","Limeira",308482,43440.26,35027,"Limeira",3,"Sudeste",1,"352690",3,254,40,214,76,178,2,0,2,1,1,256,40,216,77,179,181,10.6791419398569,12.6394187737858,0.391117388071003,31
"10135","SP","Limeira",308482,43440.26,35027,"Limeira",3,"Sudeste",1,"352690",4,254,42,212,71,183,1,1,0,0,1,255,43,212,71,184,156,10.6791419398569,12.6394187737858,0.456012826952887,30
"10136","SP","Limeira",308482,43440.26,35027,"Limeira",3,"Sudeste",1,"352690",5,250,39,211,86,164,0,0,0,0,0,250,39,211,86,164,207,10.6791419398569,12.6394187737858,0.412903684036494,31
"10137","SP","Lindóia",8092,23184.72,35033,"Amparo",3,"Sudeste",0,"352700",2,3,1,2,0,3,0,0,0,0,0,3,1,2,0,3,3,10.0512487199789,8.99863119828764,0.328770103751395,29
"10138","SP","Lindóia",8092,23184.72,35033,"Amparo",3,"Sudeste",0,"352700",3,6,2,4,4,2,0,0,0,0,0,6,2,4,4,2,1,10.0512487199789,8.99863119828764,0.42061039628366,31
"10139","SP","Lindóia",8092,23184.72,35033,"Amparo",3,"Sudeste",0,"352700",4,9,4,5,3,6,0,0,0,0,0,9,4,5,3,6,3,10.0512487199789,8.99863119828764,0.457701789710091,30
"10140","SP","Lindóia",8092,23184.72,35033,"Amparo",3,"Sudeste",0,"352700",5,9,3,6,2,7,0,0,0,0,0,9,3,6,2,7,4,10.0512487199789,8.99863119828764,0.427669803271841,31
"10141","SP","Lins",78503,48837.12,35019,"Lins",3,"Sudeste",1,"352710",2,74,9,65,22,52,2,0,2,0,2,76,9,67,22,54,60,10.796245958427,11.2708921196008,0.287605503422052,29
"10142","SP","Lins",78503,48837.12,35019,"Lins",3,"Sudeste",1,"352710",3,72,14,58,27,45,1,0,1,0,1,73,14,59,27,46,44,10.796245958427,11.2708921196008,0.365904708704596,31
"10143","SP","Lins",78503,48837.12,35019,"Lins",3,"Sudeste",1,"352710",4,71,14,57,19,52,0,0,0,0,0,71,14,57,19,52,59,10.796245958427,11.2708921196008,0.416257867541013,30
"10144","SP","Lins",78503,48837.12,35019,"Lins",3,"Sudeste",1,"352710",5,74,17,57,20,54,0,0,0,0,0,74,17,57,20,54,57,10.796245958427,11.2708921196008,0.385085047109545,31
"10145","SP","Lorena",89125,32021.36,35051,"Guaratinguetá",3,"Sudeste",1,"352720",2,76,12,64,22,54,0,0,0,0,0,76,12,64,22,54,59,10.3741584591028,11.3977951577166,0.316227259530304,29
"10146","SP","Lorena",89125,32021.36,35051,"Guaratinguetá",3,"Sudeste",1,"352720",3,81,11,70,30,51,2,0,2,1,1,83,11,72,31,52,69,10.3741584591028,11.3977951577166,0.421319515559794,31
"10147","SP","Lorena",89125,32021.36,35051,"Guaratinguetá",3,"Sudeste",1,"352720",4,69,11,58,24,45,1,1,0,0,1,70,12,58,24,46,55,10.3741584591028,11.3977951577166,0.487431603600654,30
"10148","SP","Lorena",89125,32021.36,35051,"Guaratinguetá",3,"Sudeste",1,"352720",5,83,11,72,35,48,2,1,1,1,1,85,12,73,36,49,52,10.3741584591028,11.3977951577166,0.455425309587424,31
"10149","SP","Louveira",49993,229610.7,35047,"Jundiaí",3,"Sudeste",1,"352730",2,48,2,46,14,34,1,0,1,0,1,49,2,47,14,35,18,12.3441405451291,10.8196382746094,0.282433548520583,29
"10150","SP","Louveira",49993,229610.7,35047,"Jundiaí",3,"Sudeste",1,"352730",3,51,5,46,17,34,0,0,0,0,0,51,5,46,17,34,26,12.3441405451291,10.8196382746094,0.37544365321042,31
"10151","SP","Louveira",49993,229610.7,35047,"Jundiaí",3,"Sudeste",1,"352730",4,64,7,57,13,51,0,0,0,0,0,64,7,57,13,51,25,12.3441405451291,10.8196382746094,0.427448992956722,30
"10152","SP","Louveira",49993,229610.7,35047,"Jundiaí",3,"Sudeste",1,"352730",5,70,8,62,28,42,0,0,0,0,0,70,8,62,28,42,20,12.3441405451291,10.8196382746094,0.406255195320763,31
"10153","SP","Lucélia",21886,20420.77,35035,"Adamantina",3,"Sudeste",1,"352740",2,15,1,14,5,10,0,0,0,0,0,15,1,14,5,10,25,9.92430779913701,9.99360244197839,0.295564236001661,29
"10154","SP","Lucélia",21886,20420.77,35035,"Adamantina",3,"Sudeste",1,"352740",3,10,3,7,5,5,0,0,0,0,0,10,3,7,5,5,17,9.92430779913701,9.99360244197839,0.380232538989088,31
"10155","SP","Lucélia",21886,20420.77,35035,"Adamantina",3,"Sudeste",1,"352740",4,7,1,6,4,3,0,0,0,0,0,7,1,6,4,3,23,9.92430779913701,9.99360244197839,0.406202675123456,30
"10156","SP","Lucélia",21886,20420.77,35035,"Adamantina",3,"Sudeste",1,"352740",5,15,4,11,6,9,1,0,1,0,1,16,4,12,6,10,18,9.92430779913701,9.99360244197839,0.387719216790332,31
"10157","SP","Luís Antônio",15292,103433.56,35014,"Ribeirão Preto",3,"Sudeste",1,"352760",2,14,3,11,5,9,0,0,0,0,0,14,3,11,5,9,4,11.5466847531936,9.6350850948163,0.304152442600711,29
"10158","SP","Luís Antônio",15292,103433.56,35014,"Ribeirão Preto",3,"Sudeste",1,"352760",3,12,3,9,2,10,0,0,0,0,0,12,3,9,2,10,4,11.5466847531936,9.6350850948163,0.390533007089868,31
"10159","SP","Luís Antônio",15292,103433.56,35014,"Ribeirão Preto",3,"Sudeste",1,"352760",4,9,2,7,4,5,0,0,0,0,0,9,2,7,4,5,6,11.5466847531936,9.6350850948163,0.451894144558556,30
"10160","SP","Luís Antônio",15292,103433.56,35014,"Ribeirão Preto",3,"Sudeste",1,"352760",5,4,0,4,1,3,0,0,0,0,0,4,0,4,1,3,5,11.5466847531936,9.6350850948163,0.424071916241724,31
"10161","SP","Luiziânia",5855,12536.56,35018,"Birigui",3,"Sudeste",0,"352770",2,4,2,2,3,1,0,0,0,0,0,4,2,2,3,1,4,9.43640445438464,8.67505127603182,0.343997304535995,29
"10162","SP","Luiziânia",5855,12536.56,35018,"Birigui",3,"Sudeste",0,"352770",3,3,0,3,0,3,0,0,0,0,0,3,0,3,0,3,3,9.43640445438464,8.67505127603182,0.394371887363958,31
"10163","SP","Luiziânia",5855,12536.56,35018,"Birigui",3,"Sudeste",0,"352770",4,5,1,4,1,4,0,0,0,0,0,5,1,4,1,4,2,9.43640445438464,8.67505127603182,0.41208525470288,30
"10164","SP","Luiziânia",5855,12536.56,35018,"Birigui",3,"Sudeste",0,"352770",5,6,3,3,5,1,0,0,0,0,0,6,3,3,5,1,0,9.43640445438464,8.67505127603182,0.423793070661181,31
"10165","SP","Lupércio",4596,16923.63,35038,"Marília",3,"Sudeste",0,"352780",2,4,1,3,3,1,0,0,0,0,0,4,1,3,3,1,1,9.7364661491571,8.43294163896865,0.31950290098422,29
"10166","SP","Lupércio",4596,16923.63,35038,"Marília",3,"Sudeste",0,"352780",3,4,1,3,1,3,0,0,0,0,0,4,1,3,1,3,2,9.7364661491571,8.43294163896865,0.378064772901852,31
"10167","SP","Lupércio",4596,16923.63,35038,"Marília",3,"Sudeste",0,"352780",4,4,1,3,2,2,0,0,0,0,0,4,1,3,2,2,3,9.7364661491571,8.43294163896865,0.425157991250127,30
"10168","SP","Lupércio",4596,16923.63,35038,"Marília",3,"Sudeste",0,"352780",5,6,0,6,3,3,0,0,0,0,0,6,0,6,3,3,1,9.7364661491571,8.43294163896865,0.382407440609546,31
"10169","SP","Macatuba",17214,36723.03,35021,"Jaú",3,"Sudeste",1,"352800",2,16,2,14,4,12,0,0,0,0,0,16,2,14,4,12,9,10.51115935767,9.75347828520942,0.292645322039781,29
"10170","SP","Macatuba",17214,36723.03,35021,"Jaú",3,"Sudeste",1,"352800",3,18,3,15,7,11,0,0,0,0,0,18,3,15,7,11,15,10.51115935767,9.75347828520942,0.366853522067434,31
"10171","SP","Macatuba",17214,36723.03,35021,"Jaú",3,"Sudeste",1,"352800",4,21,1,20,8,13,1,0,1,0,1,22,1,21,8,14,10,10.51115935767,9.75347828520942,0.406265997260825,30
"10172","SP","Macatuba",17214,36723.03,35021,"Jaú",3,"Sudeste",1,"352800",5,17,4,13,7,10,0,0,0,0,0,17,4,13,7,10,13,10.51115935767,9.75347828520942,0.378027031817826,31
"10173","SP","Macaubal",8147,19121.48,35007,"Nhandeara",3,"Sudeste",0,"352810",2,3,1,2,2,1,1,0,1,0,1,4,1,3,2,2,7,9.85856758946745,9.00540504031064,0.283680226371464,29
"10174","SP","Macaubal",8147,19121.48,35007,"Nhandeara",3,"Sudeste",0,"352810",3,1,0,1,0,1,0,0,0,0,0,1,0,1,0,1,6,9.85856758946745,9.00540504031064,0.341804076625883,31
"10175","SP","Macaubal",8147,19121.48,35007,"Nhandeara",3,"Sudeste",0,"352810",4,2,0,2,1,1,0,0,0,0,0,2,0,2,1,1,5,9.85856758946745,9.00540504031064,0.388149336562908,30
"10176","SP","Macaubal",8147,19121.48,35007,"Nhandeara",3,"Sudeste",0,"352810",5,8,1,7,2,6,0,0,0,0,0,8,1,7,2,6,3,9.85856758946745,9.00540504031064,0.349492796836735,31
"10177","SP","Mairinque",47441,40484.94,35046,"Sorocaba",3,"Sudeste",1,"352840",2,45,10,35,13,32,1,0,1,1,0,46,10,36,14,32,23,10.6086853320887,10.7672421127075,0.327243365075669,29
"10178","SP","Mairinque",47441,40484.94,35046,"Sorocaba",3,"Sudeste",1,"352840",3,44,15,29,14,30,2,1,1,1,1,46,16,30,15,31,34,10.6086853320887,10.7672421127075,0.411118076425202,31
"10179","SP","Mairinque",47441,40484.94,35046,"Sorocaba",3,"Sudeste",1,"352840",4,47,10,37,12,35,1,0,1,0,1,48,10,38,12,36,20,10.6086853320887,10.7672421127075,0.475942683677476,30
"10180","SP","Mairinque",47441,40484.94,35046,"Sorocaba",3,"Sudeste",1,"352840",5,58,10,48,24,34,0,0,0,0,0,58,10,48,24,34,29,10.6086853320887,10.7672421127075,0.445373328127961,31
"10181","SP","Mairiporã",101937,17774.55,35058,"Franco da Rocha",3,"Sudeste",1,"352850",2,70,11,59,28,42,0,0,0,0,0,70,11,59,28,42,51,9.78552293789528,11.5321102543851,0.311002595153748,29
"10182","SP","Mairiporã",101937,17774.55,35058,"Franco da Rocha",3,"Sudeste",1,"352850",3,97,14,83,30,67,0,0,0,0,0,97,14,83,30,67,54,9.78552293789528,11.5321102543851,0.411542465943561,31
"10183","SP","Mairiporã",101937,17774.55,35058,"Franco da Rocha",3,"Sudeste",1,"352850",4,74,7,67,25,49,0,0,0,0,0,74,7,67,25,49,50,9.78552293789528,11.5321102543851,0.483965857717913,30
"10184","SP","Mairiporã",101937,17774.55,35058,"Franco da Rocha",3,"Sudeste",1,"352850",5,85,22,63,22,63,0,0,0,0,0,85,22,63,22,63,59,9.78552293789528,11.5321102543851,0.448513650669858,31
"10185","SP","Manduri",9910,23378.18,35040,"Ourinhos",3,"Sudeste",0,"352860",2,6,0,6,0,6,0,0,0,0,0,6,0,6,0,6,8,10.0595583876847,9.20129962732403,0.307633323506858,29
"10186","SP","Manduri",9910,23378.18,35040,"Ourinhos",3,"Sudeste",0,"352860",3,8,2,6,3,5,0,0,0,0,0,8,2,6,3,5,9,10.0595583876847,9.20129962732403,0.420210950935825,31
"10187","SP","Manduri",9910,23378.18,35040,"Ourinhos",3,"Sudeste",0,"352860",4,9,3,6,7,2,0,0,0,0,0,9,3,6,7,2,4,10.0595583876847,9.20129962732403,0.483247139074367,30
"10188","SP","Manduri",9910,23378.18,35040,"Ourinhos",3,"Sudeste",0,"352860",5,7,3,4,4,3,0,0,0,0,0,7,3,4,4,3,5,10.0595583876847,9.20129962732403,0.454583687546746,31
"10189","SP","Maracaí",14036,29529.19,35039,"Assis",3,"Sudeste",0,"352880",2,11,0,11,5,6,0,0,0,0,0,11,0,11,5,6,6,10.2931345446293,9.5493807367031,0.32903960373978,29
"10190","SP","Maracaí",14036,29529.19,35039,"Assis",3,"Sudeste",0,"352880",3,15,4,11,6,9,0,0,0,0,0,15,4,11,6,9,7,10.2931345446293,9.5493807367031,0.401013939576863,31
"10191","SP","Maracaí",14036,29529.19,35039,"Assis",3,"Sudeste",0,"352880",4,15,4,11,7,8,0,0,0,0,0,15,4,11,7,8,10,10.2931345446293,9.5493807367031,0.428777489078141,30
"10192","SP","Maracaí",14036,29529.19,35039,"Assis",3,"Sudeste",0,"352880",5,12,0,12,4,8,0,0,0,0,0,12,0,12,4,8,11,10.2931345446293,9.5493807367031,0.402780042163695,31
"10193","SP","Marapoama",3064,59882.84,35008,"Novo Horizonte",3,"Sudeste",1,"352885",2,4,1,3,0,4,0,0,0,0,0,4,1,3,0,4,3,11.0001452655986,8.02747653086048,0.314009972853026,29
"10194","SP","Marapoama",3064,59882.84,35008,"Novo Horizonte",3,"Sudeste",1,"352885",3,2,1,1,2,0,0,0,0,0,0,2,1,1,2,0,3,11.0001452655986,8.02747653086048,0.348235852629543,31
"10195","SP","Marapoama",3064,59882.84,35008,"Novo Horizonte",3,"Sudeste",1,"352885",4,2,1,1,0,2,0,0,0,0,0,2,1,1,0,2,1,11.0001452655986,8.02747653086048,0.380386248859923,30
"10196","SP","Marapoama",3064,59882.84,35008,"Novo Horizonte",3,"Sudeste",1,"352885",5,3,2,1,2,1,0,0,0,0,0,3,2,1,2,1,4,11.0001452655986,8.02747653086048,0.374609800731066,31
"10197","SP","Marília",240590,34083.86,35038,"Marília",3,"Sudeste",1,"352900",2,209,15,194,59,150,1,0,1,0,1,210,15,195,59,151,126,10.4365792374403,12.3908495188992,0.287691115658425,29
"10198","SP","Marília",240590,34083.86,35038,"Marília",3,"Sudeste",1,"352900",3,239,15,224,83,156,2,0,2,1,1,241,15,226,84,157,168,10.4365792374403,12.3908495188992,0.382042463281777,31
"10199","SP","Marília",240590,34083.86,35038,"Marília",3,"Sudeste",1,"352900",4,227,22,205,68,159,1,0,1,1,0,228,22,206,69,159,114,10.4365792374403,12.3908495188992,0.440009397266014,30
"10200","SP","Marília",240590,34083.86,35038,"Marília",3,"Sudeste",1,"352900",5,224,20,204,55,169,1,1,0,1,0,225,21,204,56,169,125,10.4365792374403,12.3908495188992,0.398893292326513,31
"10201","SP","Martinópolis",26628,18871.02,35036,"Presidente Prudente",3,"Sudeste",1,"352920",2,19,2,17,9,10,0,0,0,0,0,19,2,17,9,10,22,9.84538269095578,10.1897185727206,0.315147177699999,29
"10202","SP","Martinópolis",26628,18871.02,35036,"Presidente Prudente",3,"Sudeste",1,"352920",3,25,7,18,11,14,1,0,1,0,1,26,7,19,11,15,23,9.84538269095578,10.1897185727206,0.388731716003756,31
"10203","SP","Martinópolis",26628,18871.02,35036,"Presidente Prudente",3,"Sudeste",1,"352920",4,18,0,18,7,11,0,0,0,0,0,18,0,18,7,11,9,9.84538269095578,10.1897185727206,0.421338329331206,30
"10204","SP","Martinópolis",26628,18871.02,35036,"Presidente Prudente",3,"Sudeste",1,"352920",5,28,4,24,12,16,0,0,0,0,0,28,4,24,12,16,10,9.84538269095578,10.1897185727206,0.38725263379086,31
"10205","SP","Matão",83626,50228.39,35024,"Araraquara",3,"Sudeste",1,"352930",2,69,14,55,22,47,0,0,0,0,0,69,14,55,22,47,37,10.8243356836722,11.3341097555055,0.308182772329182,29
"10206","SP","Matão",83626,50228.39,35024,"Araraquara",3,"Sudeste",1,"352930",3,71,9,62,24,47,0,0,0,0,0,71,9,62,24,47,51,10.8243356836722,11.3341097555055,0.391002716796725,31
"10207","SP","Matão",83626,50228.39,35024,"Araraquara",3,"Sudeste",1,"352930",4,64,11,53,21,43,0,0,0,0,0,64,11,53,21,43,41,10.8243356836722,11.3341097555055,0.436167783841994,30
"10208","SP","Matão",83626,50228.39,35024,"Araraquara",3,"Sudeste",1,"352930",5,77,10,67,21,56,1,0,1,1,0,78,10,68,22,56,52,10.8243356836722,11.3341097555055,0.398998615053438,31
"10209","SP","Mauá",477552,32655.23,35061,"São Paulo",3,"Sudeste",1,"352940",2,390,51,339,117,273,2,0,2,1,1,392,51,341,118,274,186,10.3937603056438,13.0764283334973,0.294054706104963,29
"10210","SP","Mauá",477552,32655.23,35061,"São Paulo",3,"Sudeste",1,"352940",3,403,42,361,122,281,2,2,0,0,2,405,44,361,122,283,193,10.3937603056438,13.0764283334973,0.394713663395006,31
"10211","SP","Mauá",477552,32655.23,35061,"São Paulo",3,"Sudeste",1,"352940",4,325,36,289,104,221,1,0,1,0,1,326,36,290,104,222,246,10.3937603056438,13.0764283334973,0.476260976095571,30
"10212","SP","Mauá",477552,32655.23,35061,"São Paulo",3,"Sudeste",1,"352940",5,373,40,333,134,239,3,1,2,3,0,376,41,335,137,239,268,10.3937603056438,13.0764283334973,0.443215309709668,31
"10213","SP","Mendonça",5565,43139.21,35004,"São José do Rio Preto",3,"Sudeste",0,"352950",2,5,2,3,4,1,0,0,0,0,0,5,2,3,4,1,6,10.6721876073044,8.62425226370964,0.302651015592328,29
"10214","SP","Mendonça",5565,43139.21,35004,"São José do Rio Preto",3,"Sudeste",0,"352950",3,7,1,6,2,5,0,0,0,0,0,7,1,6,2,5,5,10.6721876073044,8.62425226370964,0.364236338931041,31
"10215","SP","Mendonça",5565,43139.21,35004,"São José do Rio Preto",3,"Sudeste",0,"352950",4,6,3,3,5,1,0,0,0,0,0,6,3,3,5,1,2,10.6721876073044,8.62425226370964,0.371400342024237,30
"10216","SP","Mendonça",5565,43139.21,35004,"São José do Rio Preto",3,"Sudeste",0,"352950",5,8,2,6,2,6,0,0,0,0,0,8,2,6,2,6,3,10.6721876073044,8.62425226370964,0.339614337048486,31
"10217","SP","Meridiano",3824,62670.64,35002,"Fernandópolis",3,"Sudeste",0,"352960",2,6,1,5,0,6,0,0,0,0,0,6,1,5,0,6,3,11.0456483553893,8.24905227417129,0.318196722648567,29
"10218","SP","Meridiano",3824,62670.64,35002,"Fernandópolis",3,"Sudeste",0,"352960",3,2,0,2,1,1,0,0,0,0,0,2,0,2,1,1,1,11.0456483553893,8.24905227417129,0.383253354634038,31
"10219","SP","Meridiano",3824,62670.64,35002,"Fernandópolis",3,"Sudeste",0,"352960",4,5,1,4,3,2,0,0,0,0,0,5,1,4,3,2,2,11.0456483553893,8.24905227417129,0.443365892201419,30
"10220","SP","Meridiano",3824,62670.64,35002,"Fernandópolis",3,"Sudeste",0,"352960",5,5,0,5,1,4,0,0,0,0,0,5,0,5,1,4,4,11.0456483553893,8.24905227417129,0.383048917914517,31
"10221","SP","Miguelópolis",22355,45954.52,35010,"São Joaquim da Barra",3,"Sudeste",1,"352970",2,26,5,21,9,17,0,0,0,0,0,26,5,21,9,17,7,10.7354074907371,10.0148052886681,0.302297463145181,29
"10222","SP","Miguelópolis",22355,45954.52,35010,"São Joaquim da Barra",3,"Sudeste",1,"352970",3,15,4,11,5,10,0,0,0,0,0,15,4,11,5,10,13,10.7354074907371,10.0148052886681,0.35130629780914,31
"10223","SP","Miguelópolis",22355,45954.52,35010,"São Joaquim da Barra",3,"Sudeste",1,"352970",4,8,2,6,2,6,0,0,0,0,0,8,2,6,2,6,6,10.7354074907371,10.0148052886681,0.405510710719168,30
"10224","SP","Miguelópolis",22355,45954.52,35010,"São Joaquim da Barra",3,"Sudeste",1,"352970",5,26,1,25,10,16,0,0,0,0,0,26,1,25,10,16,18,10.7354074907371,10.0148052886681,0.395609489598539,31
"10225","SP","Mineiros do Tietê",12966,13408.67,35021,"Jaú",3,"Sudeste",1,"352980",2,14,2,12,3,11,0,0,0,0,0,14,2,12,3,11,2,9.50365679164046,9.47008582573494,0.315724580727604,29
"10226","SP","Mineiros do Tietê",12966,13408.67,35021,"Jaú",3,"Sudeste",1,"352980",3,7,1,6,0,7,0,0,0,0,0,7,1,6,0,7,14,9.50365679164046,9.47008582573494,0.371630901252594,31
"10227","SP","Mineiros do Tietê",12966,13408.67,35021,"Jaú",3,"Sudeste",1,"352980",4,2,1,1,0,2,0,0,0,0,0,2,1,1,0,2,7,9.50365679164046,9.47008582573494,0.417012297127927,30
"10228","SP","Mineiros do Tietê",12966,13408.67,35021,"Jaú",3,"Sudeste",1,"352980",5,10,2,8,2,8,0,0,0,0,0,10,2,8,2,8,13,9.50365679164046,9.47008582573494,0.398949583024563,31
"10229","SP","Miracatu",19643,19706.5,35055,"Registro",3,"Sudeste",0,"352990",2,8,3,5,1,7,0,0,0,0,0,8,3,5,1,7,5,9.88870380954338,9.88547631973428,0.2994518739333,29
"10230","SP","Miracatu",19643,19706.5,35055,"Registro",3,"Sudeste",0,"352990",3,15,4,11,6,9,0,0,0,0,0,15,4,11,6,9,8,9.88870380954338,9.88547631973428,0.371656601664382,31
"10231","SP","Miracatu",19643,19706.5,35055,"Registro",3,"Sudeste",0,"352990",4,28,6,22,10,18,1,0,1,1,0,29,6,23,11,18,9,9.88870380954338,9.88547631973428,0.427330924163187,30
"10232","SP","Miracatu",19643,19706.5,35055,"Registro",3,"Sudeste",0,"352990",5,30,10,20,19,11,0,0,0,0,0,30,10,20,19,11,14,9.88870380954338,9.88547631973428,0.432304351121222,31
"10233","SP","Mirandópolis",29706,22230.68,35016,"Andradina",3,"Sudeste",1,"353010",2,11,2,9,3,8,0,0,0,0,0,11,2,9,3,8,17,10.0092285957841,10.2991043245895,0.304330043494702,29
"10234","SP","Mirandópolis",29706,22230.68,35016,"Andradina",3,"Sudeste",1,"353010",3,20,3,17,6,14,0,0,0,0,0,20,3,17,6,14,17,10.0092285957841,10.2991043245895,0.386690542430738,31
"10235","SP","Mirandópolis",29706,22230.68,35016,"Andradina",3,"Sudeste",1,"353010",4,20,3,17,4,16,0,0,0,0,0,20,3,17,4,16,24,10.0092285957841,10.2991043245895,0.432642241575546,30
"10236","SP","Mirandópolis",29706,22230.68,35016,"Andradina",3,"Sudeste",1,"353010",5,29,3,26,6,23,0,0,0,0,0,29,3,26,6,23,19,10.0092285957841,10.2991043245895,0.403449730257271,31
"10237","SP","Mirante do Paranapanema",18338,19027.18,35036,"Presidente Prudente",3,"Sudeste",0,"353020",2,11,0,11,5,6,0,0,0,0,0,11,0,11,5,6,12,9.85362376223636,9.81673068860985,0.321381415853108,29
"10238","SP","Mirante do Paranapanema",18338,19027.18,35036,"Presidente Prudente",3,"Sudeste",0,"353020",3,14,4,10,4,10,0,0,0,0,0,14,4,10,4,10,8,9.85362376223636,9.81673068860985,0.399096665089658,31
"10239","SP","Mirante do Paranapanema",18338,19027.18,35036,"Presidente Prudente",3,"Sudeste",0,"353020",4,10,2,8,5,5,0,0,0,0,0,10,2,8,5,5,12,9.85362376223636,9.81673068860985,0.433386737381602,30
"10240","SP","Mirante do Paranapanema",18338,19027.18,35036,"Presidente Prudente",3,"Sudeste",0,"353020",5,16,0,16,5,11,0,0,0,0,0,16,0,16,5,11,13,9.85362376223636,9.81673068860985,0.438826069034913,31
"10241","SP","Mirassol",60303,30509.55,35004,"São José do Rio Preto",3,"Sudeste",1,"353030",2,48,5,43,20,28,0,0,0,0,0,48,5,43,20,28,28,10.3257950283394,11.0071371327215,0.276660030116058,29
"10242","SP","Mirassol",60303,30509.55,35004,"São José do Rio Preto",3,"Sudeste",1,"353030",3,57,6,51,20,37,0,0,0,0,0,57,6,51,20,37,57,10.3257950283394,11.0071371327215,0.367918866502614,31
"10243","SP","Mirassol",60303,30509.55,35004,"São José do Rio Preto",3,"Sudeste",1,"353030",4,70,8,62,21,49,0,0,0,0,0,70,8,62,21,49,29,10.3257950283394,11.0071371327215,0.411478864681165,30
"10244","SP","Mirassol",60303,30509.55,35004,"São José do Rio Preto",3,"Sudeste",1,"353030",5,78,8,70,32,46,1,0,1,0,1,79,8,71,32,47,41,10.3257950283394,11.0071371327215,0.372633990531316,31
"10245","SP","Mirassolândia",4919,26663.98,35004,"São José do Rio Preto",3,"Sudeste",1,"353040",2,6,0,6,2,4,0,0,0,0,0,6,0,6,2,4,2,10.1910688699123,8.50086053679534,0.314496226060267,29
"10246","SP","Mirassolândia",4919,26663.98,35004,"São José do Rio Preto",3,"Sudeste",1,"353040",3,6,1,5,3,3,0,0,0,0,0,6,1,5,3,3,4,10.1910688699123,8.50086053679534,0.407363104496155,31
"10247","SP","Mirassolândia",4919,26663.98,35004,"São José do Rio Preto",3,"Sudeste",1,"353040",4,3,1,2,1,2,0,0,0,0,0,3,1,2,1,2,4,10.1910688699123,8.50086053679534,0.405603004809736,30
"10248","SP","Mirassolândia",4919,26663.98,35004,"São José do Rio Preto",3,"Sudeste",1,"353040",5,6,1,5,3,3,0,0,0,0,0,6,1,5,3,3,2,10.1910688699123,8.50086053679534,0.417297845194074,31
"10249","SP","Mococa",68980,30828.27,35030,"São João da Boa Vista",3,"Sudeste",1,"353050",2,44,10,34,16,28,0,0,0,0,0,44,10,34,16,28,39,10.3361874051312,11.1415718864908,0.315845033327458,29
"10250","SP","Mococa",68980,30828.27,35030,"São João da Boa Vista",3,"Sudeste",1,"353050",3,58,12,46,25,33,0,0,0,0,0,58,12,46,25,33,71,10.3361874051312,11.1415718864908,0.407520557028463,31
"10251","SP","Mococa",68980,30828.27,35030,"São João da Boa Vista",3,"Sudeste",1,"353050",4,48,6,42,22,26,0,0,0,0,0,48,6,42,22,26,34,10.3361874051312,11.1415718864908,0.462632875383942,30
"10252","SP","Mococa",68980,30828.27,35030,"São João da Boa Vista",3,"Sudeste",1,"353050",5,60,10,50,22,38,2,0,2,0,2,62,10,52,22,40,40,10.3361874051312,11.1415718864908,0.432168265857375,31
"10253","SP","Mogi das Cruzes",450785,34908.31,35062,"Mogi das Cruzes",3,"Sudeste",1,"353060",2,479,49,430,174,305,3,0,3,0,3,482,49,433,174,308,198,10.4604801887296,13.0187457864149,0.301142140385993,29
"10254","SP","Mogi das Cruzes",450785,34908.31,35062,"Mogi das Cruzes",3,"Sudeste",1,"353060",3,461,52,409,142,319,3,2,1,2,1,464,54,410,144,320,260,10.4604801887296,13.0187457864149,0.409924712048596,31
"10255","SP","Mogi das Cruzes",450785,34908.31,35062,"Mogi das Cruzes",3,"Sudeste",1,"353060",4,422,59,363,162,260,5,4,1,2,3,427,63,364,164,263,243,10.4604801887296,13.0187457864149,0.492627717977018,30
"10256","SP","Mogi das Cruzes",450785,34908.31,35062,"Mogi das Cruzes",3,"Sudeste",1,"353060",5,508,72,436,189,319,4,0,4,1,3,512,72,440,190,322,311,10.4604801887296,13.0187457864149,0.457890175272826,31
"10257","SP","Mogi Guaçu",153033,38971.42,35031,"Mogi Mirim",3,"Sudeste",1,"353070",2,124,30,94,38,86,1,1,0,1,0,125,31,94,39,86,83,10.5705838359548,11.9384088633921,0.304056612368955,29
"10258","SP","Mogi Guaçu",153033,38971.42,35031,"Mogi Mirim",3,"Sudeste",1,"353070",3,125,28,97,40,85,0,0,0,0,0,125,28,97,40,85,86,10.5705838359548,11.9384088633921,0.404289051883728,31
"10259","SP","Mogi Guaçu",153033,38971.42,35031,"Mogi Mirim",3,"Sudeste",1,"353070",4,121,18,103,36,85,1,1,0,1,0,122,19,103,37,85,77,10.5705838359548,11.9384088633921,0.459476956888245,30
"10260","SP","Mogi Guaçu",153033,38971.42,35031,"Mogi Mirim",3,"Sudeste",1,"353070",5,159,23,136,42,117,4,1,3,3,1,163,24,139,45,118,115,10.5705838359548,11.9384088633921,0.41816345798565,31
"10261","SP","Mogi Mirim",93650,49631.35,35031,"Mogi Mirim",3,"Sudeste",1,"353080",2,60,10,50,17,43,0,0,0,0,0,60,10,50,17,43,55,10.8123779695011,11.4473197078722,0.314239238693293,29
"10262","SP","Mogi Mirim",93650,49631.35,35031,"Mogi Mirim",3,"Sudeste",1,"353080",3,63,9,54,18,45,1,0,1,1,0,64,9,55,19,45,54,10.8123779695011,11.4473197078722,0.411064500754357,31
"10263","SP","Mogi Mirim",93650,49631.35,35031,"Mogi Mirim",3,"Sudeste",1,"353080",4,75,11,64,19,56,2,0,2,0,2,77,11,66,19,58,53,10.8123779695011,11.4473197078722,0.471715990095886,30
"10264","SP","Mogi Mirim",93650,49631.35,35031,"Mogi Mirim",3,"Sudeste",1,"353080",5,73,12,61,24,49,2,0,2,0,2,75,12,63,24,51,43,10.8123779695011,11.4473197078722,0.429422725601526,31
"10265","SP","Mongaguá",57648,18581.77,35056,"Itanhaém",3,"Sudeste",1,"353110",2,52,13,39,19,33,0,0,0,0,0,52,13,39,19,33,46,9.82993627155496,10.9621108329879,0.342560043292151,29
"10266","SP","Mongaguá",57648,18581.77,35056,"Itanhaém",3,"Sudeste",1,"353110",3,63,14,49,31,32,1,0,1,1,0,64,14,50,32,32,39,9.82993627155496,10.9621108329879,0.450982937654215,31
"10267","SP","Mongaguá",57648,18581.77,35056,"Itanhaém",3,"Sudeste",1,"353110",4,55,8,47,28,27,1,1,0,0,1,56,9,47,28,28,40,9.82993627155496,10.9621108329879,0.511653105020092,30
"10268","SP","Mongaguá",57648,18581.77,35056,"Itanhaém",3,"Sudeste",1,"353110",5,84,17,67,28,56,0,0,0,0,0,84,17,67,28,56,55,9.82993627155496,10.9621108329879,0.475679059788552,31
"10269","SP","Monte Alegre do Sul",8111,22391.71,35033,"Amparo",3,"Sudeste",1,"353120",2,5,2,3,1,4,0,0,0,0,0,5,2,3,1,4,9,10.0164460800575,9.00097644407034,0.300706041942136,29
"10270","SP","Monte Alegre do Sul",8111,22391.71,35033,"Amparo",3,"Sudeste",1,"353120",3,4,0,4,1,3,0,0,0,0,0,4,0,4,1,3,5,10.0164460800575,9.00097644407034,0.405231341492426,31
"10271","SP","Monte Alegre do Sul",8111,22391.71,35033,"Amparo",3,"Sudeste",1,"353120",4,11,2,9,2,9,0,0,0,0,0,11,2,9,2,9,3,10.0164460800575,9.00097644407034,0.427341572308969,30
"10272","SP","Monte Alegre do Sul",8111,22391.71,35033,"Amparo",3,"Sudeste",1,"353120",5,4,0,4,0,4,0,0,0,0,0,4,0,4,0,4,6,10.0164460800575,9.00097644407034,0.428097009717865,31
"10273","SP","Monte Alto",50772,35901.3,35013,"Jaboticabal",3,"Sudeste",1,"353130",2,34,5,29,12,22,0,0,0,0,0,34,5,29,12,22,30,10.4885287855199,10.8351003005081,0.297787699806451,29
"10274","SP","Monte Alto",50772,35901.3,35013,"Jaboticabal",3,"Sudeste",1,"353130",3,38,3,35,12,26,0,0,0,0,0,38,3,35,12,26,26,10.4885287855199,10.8351003005081,0.390463777005709,31
"10275","SP","Monte Alto",50772,35901.3,35013,"Jaboticabal",3,"Sudeste",1,"353130",4,32,6,26,10,22,0,0,0,0,0,32,6,26,10,22,29,10.4885287855199,10.8351003005081,0.444768907380751,30
"10276","SP","Monte Alto",50772,35901.3,35013,"Jaboticabal",3,"Sudeste",1,"353130",5,45,3,42,9,36,0,0,0,0,0,45,3,42,9,36,25,10.4885287855199,10.8351003005081,0.39683917564761,31
"10277","SP","Monte Aprazível",25373,26584.41,35007,"Nhandeara",3,"Sudeste",1,"353140",2,32,10,22,6,26,0,0,0,0,0,32,10,22,6,26,20,10.1880802327262,10.1414408955038,0.288681188127083,29
"10278","SP","Monte Aprazível",25373,26584.41,35007,"Nhandeara",3,"Sudeste",1,"353140",3,20,3,17,8,12,1,0,1,0,1,21,3,18,8,13,11,10.1880802327262,10.1414408955038,0.347509796563721,31
"10279","SP","Monte Aprazível",25373,26584.41,35007,"Nhandeara",3,"Sudeste",1,"353140",4,19,3,16,7,12,0,0,0,0,0,19,3,16,7,12,14,10.1880802327262,10.1414408955038,0.380342492617759,30
"10280","SP","Monte Aprazível",25373,26584.41,35007,"Nhandeara",3,"Sudeste",1,"353140",5,28,7,21,11,17,1,0,1,0,1,29,7,22,11,18,20,10.1880802327262,10.1414408955038,0.366132965706871,31
"10281","SP","Monte Azul Paulista",18968,28033.28,35013,"Jaboticabal",3,"Sudeste",1,"353150",2,14,5,9,4,10,0,0,0,0,0,14,5,9,4,10,7,10.2411476547941,9.85050862774524,0.304519557108366,29
"10282","SP","Monte Azul Paulista",18968,28033.28,35013,"Jaboticabal",3,"Sudeste",1,"353150",3,14,2,12,5,9,0,0,0,0,0,14,2,12,5,9,8,10.2411476547941,9.85050862774524,0.366243126586883,31
"10283","SP","Monte Azul Paulista",18968,28033.28,35013,"Jaboticabal",3,"Sudeste",1,"353150",4,19,5,14,7,12,0,0,0,0,0,19,5,14,7,12,22,10.2411476547941,9.85050862774524,0.412740805747981,30
"10284","SP","Monte Azul Paulista",18968,28033.28,35013,"Jaboticabal",3,"Sudeste",1,"353150",5,14,3,11,3,11,0,0,0,0,0,14,3,11,3,11,8,10.2411476547941,9.85050862774524,0.380483323032471,31
"10285","SP","Monte Mor",60754,59311.32,35032,"Campinas",3,"Sudeste",1,"353180",2,57,12,45,23,34,1,0,1,0,1,58,12,46,23,35,23,10.9905554605285,11.0145882026566,0.296614461726561,29
"10286","SP","Monte Mor",60754,59311.32,35032,"Campinas",3,"Sudeste",1,"353180",3,71,11,60,27,44,1,0,1,0,1,72,11,61,27,45,32,10.9905554605285,11.0145882026566,0.385561301188511,31
"10287","SP","Monte Mor",60754,59311.32,35032,"Campinas",3,"Sudeste",1,"353180",4,72,7,65,22,50,1,0,1,0,1,73,7,66,22,51,32,10.9905554605285,11.0145882026566,0.441264203001878,30
"10288","SP","Monte Mor",60754,59311.32,35032,"Campinas",3,"Sudeste",1,"353180",5,57,11,46,16,41,0,0,0,0,0,57,11,46,16,41,38,10.9905554605285,11.0145882026566,0.413008248009558,31
"10289","SP","Morro Agudo",33288,36037.1,35010,"São Joaquim da Barra",3,"Sudeste",1,"353190",2,27,5,22,9,18,0,0,0,0,0,27,5,22,9,18,15,10.492304242336,10.4129522506628,0.306708508372071,29
"10290","SP","Morro Agudo",33288,36037.1,35010,"São Joaquim da Barra",3,"Sudeste",1,"353190",3,29,3,26,14,15,1,0,1,1,0,30,3,27,15,15,23,10.492304242336,10.4129522506628,0.375705925043742,31
"10291","SP","Morro Agudo",33288,36037.1,35010,"São Joaquim da Barra",3,"Sudeste",1,"353190",4,24,6,18,8,16,0,0,0,0,0,24,6,18,8,16,8,10.492304242336,10.4129522506628,0.412684498330852,30
"10292","SP","Morro Agudo",33288,36037.1,35010,"São Joaquim da Barra",3,"Sudeste",1,"353190",5,34,9,25,21,13,0,0,0,0,0,34,9,25,21,13,17,10.492304242336,10.4129522506628,0.403691494103105,31
"10293","SP","Morungaba",13781,33875.48,35048,"Bragança Paulista",3,"Sudeste",0,"353200",2,9,3,6,3,6,0,0,0,0,0,9,3,6,3,6,7,10.4304467278233,9.53104611087515,0.307968833700906,29
"10294","SP","Morungaba",13781,33875.48,35048,"Bragança Paulista",3,"Sudeste",0,"353200",3,15,3,12,6,9,0,0,0,0,0,15,3,12,6,9,7,10.4304467278233,9.53104611087515,0.378324832868929,31
"10295","SP","Morungaba",13781,33875.48,35048,"Bragança Paulista",3,"Sudeste",0,"353200",4,13,3,10,5,8,0,0,0,0,0,13,3,10,5,8,6,10.4304467278233,9.53104611087515,0.402161675935737,30
"10296","SP","Morungaba",13781,33875.48,35048,"Bragança Paulista",3,"Sudeste",0,"353200",5,16,2,14,6,10,0,0,0,0,0,16,2,14,6,10,5,10.4304467278233,9.53104611087515,0.386234657981152,31
"10297","SP","Narandiba",4904,38665.32,35036,"Presidente Prudente",3,"Sudeste",1,"353220",2,4,0,4,2,2,0,0,0,0,0,4,0,4,2,2,3,10.5626983532277,8.49780647761605,0.314030138002131,29
"10298","SP","Narandiba",4904,38665.32,35036,"Presidente Prudente",3,"Sudeste",1,"353220",3,8,1,7,4,4,0,0,0,0,0,8,1,7,4,4,5,10.5626983532277,8.49780647761605,0.359943159136922,31
"10299","SP","Narandiba",4904,38665.32,35036,"Presidente Prudente",3,"Sudeste",1,"353220",4,6,2,4,1,5,0,0,0,0,0,6,2,4,1,5,3,10.5626983532277,8.49780647761605,0.408167819459384,30
"10300","SP","Narandiba",4904,38665.32,35036,"Presidente Prudente",3,"Sudeste",1,"353220",5,8,1,7,2,6,0,0,0,0,0,8,1,7,2,6,1,10.5626983532277,8.49780647761605,0.382416177129816,31
"10301","SP","Natividade da Serra",6642,10848.03,35053,"Paraibuna/Paraitinga",3,"Sudeste",0,"353230",2,2,1,1,0,2,0,0,0,0,0,2,1,1,0,2,3,9.29173877566308,8.80116840193669,0.326261292610043,29
"10302","SP","Natividade da Serra",6642,10848.03,35053,"Paraibuna/Paraitinga",3,"Sudeste",0,"353230",3,5,3,2,1,4,0,0,0,0,0,5,3,2,1,4,3,9.29173877566308,8.80116840193669,0.429374417157326,31
"10303","SP","Natividade da Serra",6642,10848.03,35053,"Paraibuna/Paraitinga",3,"Sudeste",0,"353230",4,1,0,1,0,1,0,0,0,0,0,1,0,1,0,1,3,9.29173877566308,8.80116840193669,0.453917666981027,30
"10304","SP","Natividade da Serra",6642,10848.03,35053,"Paraibuna/Paraitinga",3,"Sudeste",0,"353230",5,5,1,4,2,3,0,0,0,0,0,5,1,4,2,3,3,9.29173877566308,8.80116840193669,0.437980347343074,31
"10305","SP","Nazaré Paulista",18698,18651.19,35048,"Bragança Paulista",3,"Sudeste",0,"353240",2,19,5,14,7,12,0,0,0,0,0,19,5,14,7,12,10,9.83366523000689,9.83617184525126,0.300304018305695,29
"10306","SP","Nazaré Paulista",18698,18651.19,35048,"Bragança Paulista",3,"Sudeste",0,"353240",3,13,4,9,6,7,0,0,0,0,0,13,4,9,6,7,10,9.83366523000689,9.83617184525126,0.394995161692327,31
"10307","SP","Nazaré Paulista",18698,18651.19,35048,"Bragança Paulista",3,"Sudeste",0,"353240",4,15,1,14,5,10,0,0,0,0,0,15,1,14,5,10,14,9.83366523000689,9.83617184525126,0.449850014295858,30
"10308","SP","Nazaré Paulista",18698,18651.19,35048,"Bragança Paulista",3,"Sudeste",0,"353240",5,21,3,18,8,13,0,0,0,0,0,21,3,18,8,13,17,9.83366523000689,9.83617184525126,0.438947822212604,31
"10309","SP","Neves Paulista",8923,23770.6,35007,"Nhandeara",3,"Sudeste",1,"353250",2,3,1,2,1,2,0,0,0,0,0,3,1,2,1,2,15,10.0762048019372,9.09638749190015,0.287453164300932,29
"10310","SP","Neves Paulista",8923,23770.6,35007,"Nhandeara",3,"Sudeste",1,"353250",3,7,3,4,1,6,1,0,1,0,1,8,3,5,1,7,3,10.0762048019372,9.09638749190015,0.370696300862857,31
"10311","SP","Neves Paulista",8923,23770.6,35007,"Nhandeara",3,"Sudeste",1,"353250",4,2,0,2,0,2,0,0,0,0,0,2,0,2,0,2,7,10.0762048019372,9.09638749190015,0.389681548876353,30
"10312","SP","Neves Paulista",8923,23770.6,35007,"Nhandeara",3,"Sudeste",1,"353250",5,9,2,7,1,8,0,0,0,0,0,9,2,7,1,8,6,10.0762048019372,9.09638749190015,0.363425203056064,31
"10313","SP","Nhandeara",11527,28388.63,35007,"Nhandeara",3,"Sudeste",0,"353260",2,7,2,5,3,4,0,0,0,0,0,7,2,5,3,4,9,10.2537439918743,9.35244738860101,0.294158201031434,29
"10314","SP","Nhandeara",11527,28388.63,35007,"Nhandeara",3,"Sudeste",0,"353260",3,8,0,8,0,8,0,0,0,0,0,8,0,8,0,8,12,10.2537439918743,9.35244738860101,0.371122288594337,31
"10315","SP","Nhandeara",11527,28388.63,35007,"Nhandeara",3,"Sudeste",0,"353260",4,5,1,4,2,3,0,0,0,0,0,5,1,4,2,3,3,10.2537439918743,9.35244738860101,0.428843630486116,30
"10316","SP","Nhandeara",11527,28388.63,35007,"Nhandeara",3,"Sudeste",0,"353260",5,9,3,6,1,8,0,0,0,0,0,9,3,6,1,8,9,10.2537439918743,9.35244738860101,0.398809501182943,31
"10317","SP","Nipoã",5298,18328.81,35007,"Nhandeara",3,"Sudeste",0,"353270",2,4,2,2,3,1,0,0,0,0,0,4,2,2,3,1,3,9.81622941783159,8.57508466983201,0.312424122229702,29
"10318","SP","Nipoã",5298,18328.81,35007,"Nhandeara",3,"Sudeste",0,"353270",3,6,3,3,2,4,0,0,0,0,0,6,3,3,2,4,0,9.81622941783159,8.57508466983201,0.377940129323698,31
"10319","SP","Nipoã",5298,18328.81,35007,"Nhandeara",3,"Sudeste",0,"353270",4,8,3,5,3,5,0,0,0,0,0,8,3,5,3,5,0,9.81622941783159,8.57508466983201,0.408309578834346,30
"10320","SP","Nipoã",5298,18328.81,35007,"Nhandeara",3,"Sudeste",0,"353270",5,6,0,6,0,6,0,0,0,0,0,6,0,6,0,6,4,9.81622941783159,8.57508466983201,0.370312897589053,31
"10321","SP","Nova Aliança",7068,25206.05,35004,"São José do Rio Preto",3,"Sudeste",1,"353280",2,5,2,3,3,2,0,0,0,0,0,5,2,3,3,2,5,10.1348393240502,8.86333283343959,0.327485050852247,29
"10322","SP","Nova Aliança",7068,25206.05,35004,"São José do Rio Preto",3,"Sudeste",1,"353280",3,5,0,5,0,5,0,0,0,0,0,5,0,5,0,5,4,10.1348393240502,8.86333283343959,0.406438830136723,31
"10323","SP","Nova Aliança",7068,25206.05,35004,"São José do Rio Preto",3,"Sudeste",1,"353280",4,3,1,2,2,1,0,0,0,0,0,3,1,2,2,1,4,10.1348393240502,8.86333283343959,0.408542491125963,30
"10324","SP","Nova Aliança",7068,25206.05,35004,"São José do Rio Preto",3,"Sudeste",1,"353280",5,5,1,4,4,1,0,0,0,0,0,5,1,4,4,1,1,10.1348393240502,8.86333283343959,0.378745219371696,31
"10325","SP","Nova Campina",9860,11418.51,35041,"Itapeva",3,"Sudeste",0,"353282",2,11,5,6,4,7,0,0,0,0,0,11,5,6,4,7,2,9.34299100184304,9.19624144759668,0.340300762108148,29
"10326","SP","Nova Campina",9860,11418.51,35041,"Itapeva",3,"Sudeste",0,"353282",3,8,1,7,5,3,0,0,0,0,0,8,1,7,5,3,8,9.34299100184304,9.19624144759668,0.442360271049799,31
"10327","SP","Nova Campina",9860,11418.51,35041,"Itapeva",3,"Sudeste",0,"353282",4,5,1,4,2,3,0,0,0,0,0,5,1,4,2,3,3,9.34299100184304,9.19624144759668,0.49450746969874,30
"10328","SP","Nova Campina",9860,11418.51,35041,"Itapeva",3,"Sudeste",0,"353282",5,11,3,8,6,5,0,0,0,0,0,11,3,8,6,5,5,9.34299100184304,9.19624144759668,0.454715966307111,31
"10329","SP","Nova Europa",11355,25485.01,35024,"Araraquara",3,"Sudeste",0,"353290",2,4,1,3,1,3,0,0,0,0,0,4,1,3,1,3,2,10.1458457151617,9.33741345453966,0.301114254685701,29
"10330","SP","Nova Europa",11355,25485.01,35024,"Araraquara",3,"Sudeste",0,"353290",3,17,5,12,3,14,0,0,0,0,0,17,5,12,3,14,4,10.1458457151617,9.33741345453966,0.37144793013037,31
"10331","SP","Nova Europa",11355,25485.01,35024,"Araraquara",3,"Sudeste",0,"353290",4,10,2,8,2,8,0,0,0,0,0,10,2,8,2,8,5,10.1458457151617,9.33741345453966,0.406323303828068,30
"10332","SP","Nova Europa",11355,25485.01,35024,"Araraquara",3,"Sudeste",0,"353290",5,12,2,10,5,7,0,0,0,0,0,12,2,10,5,7,7,10.1458457151617,9.33741345453966,0.379660162741016,31
"10333","SP","Nova Granada",21689,20378.67,35004,"São José do Rio Preto",3,"Sudeste",1,"353300",2,21,3,18,9,12,0,0,0,0,0,21,3,18,9,12,9,9.9222440445883,9.98456049856261,0.302517463793518,29
"10334","SP","Nova Granada",21689,20378.67,35004,"São José do Rio Preto",3,"Sudeste",1,"353300",3,19,5,14,9,10,1,0,1,1,0,20,5,15,10,10,21,9.9222440445883,9.98456049856261,0.369336430518279,31
"10335","SP","Nova Granada",21689,20378.67,35004,"São José do Rio Preto",3,"Sudeste",1,"353300",4,26,7,19,8,18,0,0,0,0,0,26,7,19,8,18,11,9.9222440445883,9.98456049856261,0.384701553548817,30
"10336","SP","Nova Granada",21689,20378.67,35004,"São José do Rio Preto",3,"Sudeste",1,"353300",5,15,3,12,2,13,0,0,0,0,0,15,3,12,2,13,16,9.9222440445883,9.98456049856261,0.379406809446845,31
"10337","SP","Nova Independência",4053,36380.1,35016,"Andradina",3,"Sudeste",0,"353320",2,3,0,3,1,2,0,0,0,0,0,3,0,3,1,2,3,10.5017772008314,8.30721262662831,0.275557357315077,29
"10338","SP","Nova Independência",4053,36380.1,35016,"Andradina",3,"Sudeste",0,"353320",3,4,0,4,3,1,0,0,0,0,0,4,0,4,3,1,1,10.5017772008314,8.30721262662831,0.380222219081354,31
"10339","SP","Nova Independência",4053,36380.1,35016,"Andradina",3,"Sudeste",0,"353320",4,5,1,4,1,4,0,0,0,0,0,5,1,4,1,4,0,10.5017772008314,8.30721262662831,0.429507107603184,30
"10340","SP","Nova Independência",4053,36380.1,35016,"Andradina",3,"Sudeste",0,"353320",5,9,0,9,2,7,0,0,0,0,0,9,0,9,2,7,2,10.5017772008314,8.30721262662831,0.433069701185939,31
"10341","SP","Novais",5945,10196.95,35005,"Catanduva",3,"Sudeste",1,"353325",2,5,0,5,3,2,0,0,0,0,0,5,0,5,3,2,3,9.22984393494924,8.69030580912488,0.340968513958259,29
"10342","SP","Novais",5945,10196.95,35005,"Catanduva",3,"Sudeste",1,"353325",3,5,2,3,2,3,0,0,0,0,0,5,2,3,2,3,2,9.22984393494924,8.69030580912488,0.413845667687417,31
"10343","SP","Novais",5945,10196.95,35005,"Catanduva",3,"Sudeste",1,"353325",4,6,0,6,2,4,0,0,0,0,0,6,0,6,2,4,2,9.22984393494924,8.69030580912488,0.418599672668243,30
"10344","SP","Novais",5945,10196.95,35005,"Catanduva",3,"Sudeste",1,"353325",5,4,0,4,3,1,0,0,0,0,0,4,0,4,3,1,0,9.22984393494924,8.69030580912488,0.38124714730873,31
"10345","SP","Nova Odessa",60956,59633.81,35032,"Campinas",3,"Sudeste",1,"353340",2,37,3,34,14,23,1,0,1,1,0,38,3,35,15,23,29,10.9959779740891,11.0179075714098,0.291393340490738,29
"10346","SP","Nova Odessa",60956,59633.81,35032,"Campinas",3,"Sudeste",1,"353340",3,45,8,37,21,24,0,0,0,0,0,45,8,37,21,24,34,10.9959779740891,11.0179075714098,0.390269146777711,31
"10347","SP","Nova Odessa",60956,59633.81,35032,"Campinas",3,"Sudeste",1,"353340",4,46,4,42,10,36,0,0,0,0,0,46,4,42,10,36,29,10.9959779740891,11.0179075714098,0.446729252399585,30
"10348","SP","Nova Odessa",60956,59633.81,35032,"Campinas",3,"Sudeste",1,"353340",5,55,1,54,9,46,0,0,0,0,0,55,1,54,9,46,40,10.9959779740891,11.0179075714098,0.400952383265842,31
"10349","SP","Novo Horizonte",41414,26915.6,35008,"Novo Horizonte",3,"Sudeste",1,"353350",2,38,8,30,16,22,1,0,1,0,1,39,8,31,16,23,26,10.2004613231486,10.6313742669,0.293425287308778,29
"10350","SP","Novo Horizonte",41414,26915.6,35008,"Novo Horizonte",3,"Sudeste",1,"353350",3,38,12,26,8,30,0,0,0,0,0,38,12,26,8,30,34,10.2004613231486,10.6313742669,0.358143120884908,31
"10351","SP","Novo Horizonte",41414,26915.6,35008,"Novo Horizonte",3,"Sudeste",1,"353350",4,41,4,37,15,26,0,0,0,0,0,41,4,37,15,26,33,10.2004613231486,10.6313742669,0.393331466429244,30
"10352","SP","Novo Horizonte",41414,26915.6,35008,"Novo Horizonte",3,"Sudeste",1,"353350",5,30,7,23,12,18,0,0,0,0,0,30,7,23,12,18,27,10.2004613231486,10.6313742669,0.383713609684202,31
"10353","SP","Nuporanga",7478,70520.18,35010,"São Joaquim da Barra",3,"Sudeste",0,"353360",2,4,1,3,2,2,0,0,0,0,0,4,1,3,2,2,4,11.1636541889759,8.91972065553706,0.301958880624504,29
"10354","SP","Nuporanga",7478,70520.18,35010,"São Joaquim da Barra",3,"Sudeste",0,"353360",3,7,3,4,2,5,0,0,0,0,0,7,3,4,2,5,3,11.1636541889759,8.91972065553706,0.365015108743451,31
"10355","SP","Nuporanga",7478,70520.18,35010,"São Joaquim da Barra",3,"Sudeste",0,"353360",4,12,1,11,2,10,0,0,0,0,0,12,1,11,2,10,6,11.1636541889759,8.91972065553706,0.384952372095448,30
"10356","SP","Nuporanga",7478,70520.18,35010,"São Joaquim da Barra",3,"Sudeste",0,"353360",5,13,4,9,5,8,0,0,0,0,0,13,4,9,5,8,11,11.1636541889759,8.91972065553706,0.37278767750948,31
"10357","SP","Ocauçu",4291,27040.7,35038,"Marília",3,"Sudeste",0,"353370",2,2,0,2,2,0,0,0,0,0,0,2,0,2,2,0,3,10.2050984173958,8.36427508499152,0.333230290712747,29
"10358","SP","Ocauçu",4291,27040.7,35038,"Marília",3,"Sudeste",0,"353370",3,4,1,3,3,1,0,0,0,0,0,4,1,3,3,1,2,10.2050984173958,8.36427508499152,0.382264771799421,31
"10359","SP","Ocauçu",4291,27040.7,35038,"Marília",3,"Sudeste",0,"353370",4,5,0,5,3,2,0,0,0,0,0,5,0,5,3,2,1,10.2050984173958,8.36427508499152,0.434118824357546,30
"10360","SP","Ocauçu",4291,27040.7,35038,"Marília",3,"Sudeste",0,"353370",5,4,0,4,2,2,0,0,0,0,0,4,0,4,2,2,1,10.2050984173958,8.36427508499152,0.415932368135348,31
"10361","SP","Olímpia",55130,37387.02,35004,"São José do Rio Preto",3,"Sudeste",1,"353390",2,38,2,36,11,27,1,0,1,0,1,39,2,37,11,28,30,10.5290788643402,10.9174493115837,0.289082887495404,29
"10362","SP","Olímpia",55130,37387.02,35004,"São José do Rio Preto",3,"Sudeste",1,"353390",3,58,7,51,17,41,0,0,0,0,0,58,7,51,17,41,40,10.5290788643402,10.9174493115837,0.371293732182384,31
"10363","SP","Olímpia",55130,37387.02,35004,"São José do Rio Preto",3,"Sudeste",1,"353390",4,53,5,48,20,33,0,0,0,0,0,53,5,48,20,33,40,10.5290788643402,10.9174493115837,0.415982169702093,30
"10364","SP","Olímpia",55130,37387.02,35004,"São José do Rio Preto",3,"Sudeste",1,"353390",5,71,10,61,33,38,0,0,0,0,0,71,10,61,33,38,34,10.5290788643402,10.9174493115837,0.383855660312724,31
"10365","SP","Onda Verde",4422,38174.26,35004,"São José do Rio Preto",3,"Sudeste",0,"353400",2,3,1,2,1,2,0,0,0,0,0,3,1,2,1,2,1,10.5499167454851,8.39434736141739,0.295704396419371,29
"10366","SP","Onda Verde",4422,38174.26,35004,"São José do Rio Preto",3,"Sudeste",0,"353400",3,6,2,4,3,3,0,0,0,0,0,6,2,4,3,3,0,10.5499167454851,8.39434736141739,0.357204948074417,31
"10367","SP","Onda Verde",4422,38174.26,35004,"São José do Rio Preto",3,"Sudeste",0,"353400",4,4,0,4,2,2,0,0,0,0,0,4,0,4,2,2,4,10.5499167454851,8.39434736141739,0.418679965315315,30
"10368","SP","Onda Verde",4422,38174.26,35004,"São José do Rio Preto",3,"Sudeste",0,"353400",5,3,0,3,1,2,0,0,0,0,0,3,0,3,1,2,2,10.5499167454851,8.39434736141739,0.382136045765535,31
"10369","SP","Oriente",6542,15344.27,35038,"Marília",3,"Sudeste",1,"353410",2,3,1,2,0,3,0,0,0,0,0,3,1,2,0,3,5,9.63849739342304,8.78599820809833,0.32248439367778,29
"10370","SP","Oriente",6542,15344.27,35038,"Marília",3,"Sudeste",1,"353410",3,11,1,10,2,9,0,0,0,0,0,11,1,10,2,9,6,9.63849739342304,8.78599820809833,0.403919772671481,31
"10371","SP","Oriente",6542,15344.27,35038,"Marília",3,"Sudeste",1,"353410",4,10,0,10,4,6,0,0,0,0,0,10,0,10,4,6,1,9.63849739342304,8.78599820809833,0.454948591557152,30
"10372","SP","Oriente",6542,15344.27,35038,"Marília",3,"Sudeste",1,"353410",5,6,0,6,3,3,0,0,0,0,0,6,0,6,3,3,2,9.63849739342304,8.78599820809833,0.425341195404365,31
"10373","SP","Orindiúva",7194,58280.24,35004,"São José do Rio Preto",3,"Sudeste",0,"353420",2,4,0,4,1,3,0,0,0,0,0,4,0,4,1,3,3,10.9730183783515,8.88100262425557,0.292567898316678,29
"10374","SP","Orindiúva",7194,58280.24,35004,"São José do Rio Preto",3,"Sudeste",0,"353420",3,5,1,4,3,2,0,0,0,0,0,5,1,4,3,2,6,10.9730183783515,8.88100262425557,0.361070116662632,31
"10375","SP","Orindiúva",7194,58280.24,35004,"São José do Rio Preto",3,"Sudeste",0,"353420",4,7,0,7,1,6,0,0,0,0,0,7,0,7,1,6,4,10.9730183783515,8.88100262425557,0.372107804933357,30
"10376","SP","Orindiúva",7194,58280.24,35004,"São José do Rio Preto",3,"Sudeste",0,"353420",5,7,0,7,4,3,0,0,0,0,0,7,0,7,4,3,6,10.9730183783515,8.88100262425557,0.369948087207481,31
"10377","SP","Orlândia",44360,42003.28,35010,"São Joaquim da Barra",3,"Sudeste",1,"353430",2,37,5,32,7,30,0,0,0,0,0,37,5,32,7,30,22,10.6455029894543,10.7000934414643,0.297925019855009,29
"10378","SP","Orlândia",44360,42003.28,35010,"São Joaquim da Barra",3,"Sudeste",1,"353430",3,30,4,26,7,23,0,0,0,0,0,30,4,26,7,23,26,10.6455029894543,10.7000934414643,0.375347072504473,31
"10379","SP","Orlândia",44360,42003.28,35010,"São Joaquim da Barra",3,"Sudeste",1,"353430",4,31,3,28,8,23,1,0,1,1,0,32,3,29,9,23,19,10.6455029894543,10.7000934414643,0.43718905084541,30
"10380","SP","Orlândia",44360,42003.28,35010,"São Joaquim da Barra",3,"Sudeste",1,"353430",5,47,7,40,13,34,0,0,0,0,0,47,7,40,13,34,21,10.6455029894543,10.7000934414643,0.40751031705328,31
"10381","SP","Osasco",699944,109936.21,35057,"Osasco",3,"Sudeste",1,"353440",2,698,73,625,191,507,10,4,6,6,4,708,77,631,197,511,340,11.6076555674713,13.4587556108254,0.277050848981614,29
"10382","SP","Osasco",699944,109936.21,35057,"Osasco",3,"Sudeste",1,"353440",3,662,89,573,191,471,7,0,7,5,2,669,89,580,196,473,397,11.6076555674713,13.4587556108254,0.393772974747105,31
"10383","SP","Osasco",699944,109936.21,35057,"Osasco",3,"Sudeste",1,"353440",4,591,70,521,182,409,9,0,9,2,7,600,70,530,184,416,500,11.6076555674713,13.4587556108254,0.496572994773649,30
"10384","SP","Osasco",699944,109936.21,35057,"Osasco",3,"Sudeste",1,"353440",5,728,102,626,254,474,12,1,11,3,9,740,103,637,257,483,672,11.6076555674713,13.4587556108254,0.46675966528498,31
"10385","SP","Osvaldo Cruz",33000,25930.54,35035,"Adamantina",3,"Sudeste",1,"353460",2,22,2,20,6,16,1,1,0,0,1,23,3,20,6,17,20,10.1631767036147,10.4042628404486,0.301767286077802,29
"10386","SP","Osvaldo Cruz",33000,25930.54,35035,"Adamantina",3,"Sudeste",1,"353460",3,27,3,24,4,23,0,0,0,0,0,27,3,24,4,23,20,10.1631767036147,10.4042628404486,0.375162127905013,31
"10387","SP","Osvaldo Cruz",33000,25930.54,35035,"Adamantina",3,"Sudeste",1,"353460",4,24,5,19,9,15,0,0,0,0,0,24,5,19,9,15,23,10.1631767036147,10.4042628404486,0.406059200962958,30
"10388","SP","Osvaldo Cruz",33000,25930.54,35035,"Adamantina",3,"Sudeste",1,"353460",5,31,7,24,13,18,0,0,0,0,0,31,7,24,13,18,23,10.1631767036147,10.4042628404486,0.386013732715988,31
"10389","SP","Ourinhos",114352,27232.54,35040,"Ourinhos",3,"Sudeste",1,"353470",2,101,6,95,35,66,1,0,1,1,0,102,6,96,36,66,66,10.2121678607887,11.6470366894598,0.306275556696591,29
"10390","SP","Ourinhos",114352,27232.54,35040,"Ourinhos",3,"Sudeste",1,"353470",3,106,13,93,27,79,1,0,1,0,1,107,13,94,27,80,79,10.2121678607887,11.6470366894598,0.387941717436555,31
"10391","SP","Ourinhos",114352,27232.54,35040,"Ourinhos",3,"Sudeste",1,"353470",4,98,15,83,38,60,2,0,2,2,0,100,15,85,40,60,80,10.2121678607887,11.6470366894598,0.458186936210461,30
"10392","SP","Ourinhos",114352,27232.54,35040,"Ourinhos",3,"Sudeste",1,"353470",5,99,13,86,37,62,2,0,2,1,1,101,13,88,38,63,61,10.2121678607887,11.6470366894598,0.417216785627162,31
"10393","SP","Ouroeste",10539,41425.64,35002,"Fernandópolis",3,"Sudeste",0,"353475",2,8,1,7,5,3,0,0,0,0,0,8,1,7,5,3,4,10.6316552917831,9.26283794093394,0.292988208143202,29
"10394","SP","Ouroeste",10539,41425.64,35002,"Fernandópolis",3,"Sudeste",0,"353475",3,9,1,8,1,8,0,0,0,0,0,9,1,8,1,8,5,10.6316552917831,9.26283794093394,0.365649133125097,31
"10395","SP","Ouroeste",10539,41425.64,35002,"Fernandópolis",3,"Sudeste",0,"353475",4,4,2,2,4,0,1,0,1,0,1,5,2,3,4,1,1,10.6316552917831,9.26283794093394,0.422434247611742,30
"10396","SP","Ouroeste",10539,41425.64,35002,"Fernandópolis",3,"Sudeste",0,"353475",5,8,0,8,2,6,0,0,0,0,0,8,0,8,2,6,8,10.6316552917831,9.26283794093394,0.386344043977708,31
"10397","SP","Ouro Verde",8620,13210.54,35034,"Dracena",3,"Sudeste",0,"353480",2,6,2,4,0,6,0,0,0,0,0,6,2,4,0,6,5,9.48877027480352,9.06184036365774,0.313934878684283,29
"10398","SP","Ouro Verde",8620,13210.54,35034,"Dracena",3,"Sudeste",0,"353480",3,3,0,3,2,1,0,0,0,0,0,3,0,3,2,1,13,9.48877027480352,9.06184036365774,0.358252020986284,31
"10399","SP","Ouro Verde",8620,13210.54,35034,"Dracena",3,"Sudeste",0,"353480",4,8,2,6,2,6,0,0,0,0,0,8,2,6,2,6,5,9.48877027480352,9.06184036365774,0.383376929720744,30
"10400","SP","Ouro Verde",8620,13210.54,35034,"Dracena",3,"Sudeste",0,"353480",5,7,2,5,5,2,0,0,0,0,0,7,2,5,5,2,7,9.48877027480352,9.06184036365774,0.362300392900406,31
"10401","SP","Pacaembu",14263,21542.47,35035,"Adamantina",3,"Sudeste",1,"353490",2,11,2,9,4,7,0,0,0,0,0,11,2,9,4,7,7,9.97778161451692,9.56542405052342,0.274734279024527,29
"10402","SP","Pacaembu",14263,21542.47,35035,"Adamantina",3,"Sudeste",1,"353490",3,9,2,7,5,4,0,0,0,0,0,9,2,7,5,4,14,9.97778161451692,9.56542405052342,0.343652797044331,31
"10403","SP","Pacaembu",14263,21542.47,35035,"Adamantina",3,"Sudeste",1,"353490",4,6,0,6,1,5,0,0,0,0,0,6,0,6,1,5,9,9.97778161451692,9.56542405052342,0.385496663600102,30
"10404","SP","Pacaembu",14263,21542.47,35035,"Adamantina",3,"Sudeste",1,"353490",5,12,3,9,3,9,0,0,0,0,0,12,3,9,3,9,8,9.97778161451692,9.56542405052342,0.379818034082732,31
"10405","SP","Palestina",13123,23871.29,35004,"São José do Rio Preto",3,"Sudeste",0,"353500",2,10,0,10,4,6,0,0,0,0,0,10,0,10,4,6,3,10.0804317606041,9.48212169489629,0.283370728075189,29
"10406","SP","Palestina",13123,23871.29,35004,"São José do Rio Preto",3,"Sudeste",0,"353500",3,13,2,11,6,7,0,0,0,0,0,13,2,11,6,7,6,10.0804317606041,9.48212169489629,0.333387883666507,31
"10407","SP","Palestina",13123,23871.29,35004,"São José do Rio Preto",3,"Sudeste",0,"353500",4,7,0,7,3,4,1,0,1,0,1,8,0,8,3,5,5,10.0804317606041,9.48212169489629,0.367606475798554,30
"10408","SP","Palestina",13123,23871.29,35004,"São José do Rio Preto",3,"Sudeste",0,"353500",5,7,1,6,4,3,0,0,0,0,0,7,1,6,4,3,3,10.0804317606041,9.48212169489629,0.33765521178367,31
"10409","SP","Palmares Paulista",13486,9376.19,35005,"Catanduva",3,"Sudeste",1,"353510",2,13,2,11,7,6,0,0,0,0,0,13,2,11,7,6,4,9.14592877611659,9.50940738929453,0.299594233821302,29
"10410","SP","Palmares Paulista",13486,9376.19,35005,"Catanduva",3,"Sudeste",1,"353510",3,9,1,8,4,5,0,0,0,0,0,9,1,8,4,5,5,9.14592877611659,9.50940738929453,0.353270940203261,31
"10411","SP","Palmares Paulista",13486,9376.19,35005,"Catanduva",3,"Sudeste",1,"353510",4,12,3,9,3,9,0,0,0,0,0,12,3,9,3,9,1,9.14592877611659,9.50940738929453,0.361286318621584,30
"10412","SP","Palmares Paulista",13486,9376.19,35005,"Catanduva",3,"Sudeste",1,"353510",5,9,2,7,4,5,0,0,0,0,0,9,2,7,4,5,7,9.14592877611659,9.50940738929453,0.368519221406241,31
"10413","SP","Palmeira d'Oeste",9227,20086.66,35001,"Jales",3,"Sudeste",0,"353520",2,10,0,10,4,6,0,0,0,0,0,10,0,10,4,6,12,9.90781119212101,9.12988924757856,0.261526677512612,29
"10414","SP","Palmeira d'Oeste",9227,20086.66,35001,"Jales",3,"Sudeste",0,"353520",3,6,1,5,2,4,0,0,0,0,0,6,1,5,2,4,10,9.90781119212101,9.12988924757856,0.373250444108933,31
"10415","SP","Palmeira d'Oeste",9227,20086.66,35001,"Jales",3,"Sudeste",0,"353520",4,13,1,12,3,10,0,0,0,0,0,13,1,12,3,10,2,9.90781119212101,9.12988924757856,0.415352717892389,30
"10416","SP","Palmeira d'Oeste",9227,20086.66,35001,"Jales",3,"Sudeste",0,"353520",5,1,0,1,0,1,0,0,0,0,0,1,0,1,0,1,7,9.90781119212101,9.12988924757856,0.4126969572668,31
"10417","SP","Palmital",22272,30936.78,35039,"Assis",3,"Sudeste",1,"353530",2,21,5,16,7,14,0,0,0,0,0,21,5,16,7,14,18,10.339701046313,10.0110855631341,0.289628384603641,29
"10418","SP","Palmital",22272,30936.78,35039,"Assis",3,"Sudeste",1,"353530",3,20,3,17,5,15,0,0,0,0,0,20,3,17,5,15,16,10.339701046313,10.0110855631341,0.37099694067077,31
"10419","SP","Palmital",22272,30936.78,35039,"Assis",3,"Sudeste",1,"353530",4,17,5,12,10,7,0,0,0,0,0,17,5,12,10,7,20,10.339701046313,10.0110855631341,0.446142672499332,30
"10420","SP","Palmital",22272,30936.78,35039,"Assis",3,"Sudeste",1,"353530",5,25,1,24,9,16,0,0,0,0,0,25,1,24,9,16,11,10.339701046313,10.0110855631341,0.412354282026136,31
"10421","SP","Panorama",15862,16827.13,35034,"Dracena",3,"Sudeste",1,"353540",2,12,4,8,7,5,0,0,0,0,0,12,4,8,7,5,4,9.73074774382557,9.67168159064327,0.32137976221535,29
"10422","SP","Panorama",15862,16827.13,35034,"Dracena",3,"Sudeste",1,"353540",3,11,1,10,1,10,0,0,0,0,0,11,1,10,1,10,16,9.73074774382557,9.67168159064327,0.390686570944515,31
"10423","SP","Panorama",15862,16827.13,35034,"Dracena",3,"Sudeste",1,"353540",4,12,0,12,7,5,0,0,0,0,0,12,0,12,7,5,9,9.73074774382557,9.67168159064327,0.40974499057558,30
"10424","SP","Panorama",15862,16827.13,35034,"Dracena",3,"Sudeste",1,"353540",5,18,7,11,7,11,1,0,1,0,1,19,7,12,7,12,9,9.73074774382557,9.67168159064327,0.39707351199978,31
"10425","SP","Paraguaçu Paulista",45945,33792.38,35039,"Assis",3,"Sudeste",1,"353550",2,39,4,35,13,26,0,0,0,0,0,39,4,35,13,26,22,10.4279906122679,10.735200307935,0.290843111096675,29
"10426","SP","Paraguaçu Paulista",45945,33792.38,35039,"Assis",3,"Sudeste",1,"353550",3,41,6,35,11,30,1,0,1,1,0,42,6,36,12,30,26,10.4279906122679,10.735200307935,0.389905075900749,31
"10427","SP","Paraguaçu Paulista",45945,33792.38,35039,"Assis",3,"Sudeste",1,"353550",4,28,2,26,13,15,0,0,0,0,0,28,2,26,13,15,19,10.4279906122679,10.735200307935,0.415736560937149,30
"10428","SP","Paraguaçu Paulista",45945,33792.38,35039,"Assis",3,"Sudeste",1,"353550",5,53,7,46,21,32,0,0,0,0,0,53,7,46,21,32,31,10.4279906122679,10.735200307935,0.396308544341607,31
"10429","SP","Paraibuna",18263,15336.37,35053,"Paraibuna/Paraitinga",3,"Sudeste",0,"353560",2,13,3,10,5,8,0,0,0,0,0,13,3,10,5,8,12,9.63798241067336,9.81263243419204,0.287632377288635,29
"10430","SP","Paraibuna",18263,15336.37,35053,"Paraibuna/Paraitinga",3,"Sudeste",0,"353560",3,18,2,16,7,11,0,0,0,0,0,18,2,16,7,11,6,9.63798241067336,9.81263243419204,0.376743683998322,31
"10431","SP","Paraibuna",18263,15336.37,35053,"Paraibuna/Paraitinga",3,"Sudeste",0,"353560",4,13,5,8,7,6,0,0,0,0,0,13,5,8,7,6,17,9.63798241067336,9.81263243419204,0.43213358150182,30
"10432","SP","Paraibuna",18263,15336.37,35053,"Paraibuna/Paraitinga",3,"Sudeste",0,"353560",5,23,6,17,12,11,0,0,0,0,0,23,6,17,12,11,13,9.63798241067336,9.81263243419204,0.409746851781802,31
"10433","SP","Paraíso",6496,34584.67,35005,"Catanduva",3,"Sudeste",0,"353570",2,4,0,4,0,4,0,0,0,0,0,4,0,4,0,4,6,10.4511657992803,8.77894188184151,0.320502242331156,29
"10434","SP","Paraíso",6496,34584.67,35005,"Catanduva",3,"Sudeste",0,"353570",3,7,3,4,0,7,0,0,0,0,0,7,3,4,0,7,2,10.4511657992803,8.77894188184151,0.374030361252663,31
"10435","SP","Paraíso",6496,34584.67,35005,"Catanduva",3,"Sudeste",0,"353570",4,2,0,2,1,1,0,0,0,0,0,2,0,2,1,1,5,10.4511657992803,8.77894188184151,0.375804249787715,30
"10436","SP","Paraíso",6496,34584.67,35005,"Catanduva",3,"Sudeste",0,"353570",5,7,0,7,5,2,0,0,0,0,0,7,0,7,5,2,6,10.4511657992803,8.77894188184151,0.361410838037437,31
"10437","SP","Paranapanema",20395,31198.29,35022,"Avaré",3,"Sudeste",0,"353580",2,24,7,17,12,12,0,0,0,0,0,24,7,17,12,12,10,10.3481185646033,9.92304505175166,0.307278825035048,29
"10438","SP","Paranapanema",20395,31198.29,35022,"Avaré",3,"Sudeste",0,"353580",3,25,6,19,17,8,0,0,0,0,0,25,6,19,17,8,9,10.3481185646033,9.92304505175166,0.381272262989797,31
"10439","SP","Paranapanema",20395,31198.29,35022,"Avaré",3,"Sudeste",0,"353580",4,30,7,23,16,14,0,0,0,0,0,30,7,23,16,14,10,10.3481185646033,9.92304505175166,0.402108713359352,30
"10440","SP","Paranapanema",20395,31198.29,35022,"Avaré",3,"Sudeste",0,"353580",5,30,5,25,12,18,0,0,0,0,0,30,5,25,12,18,12,10.3481185646033,9.92304505175166,0.387399431428798,31
"10441","SP","Paranapuã",4095,27485.59,35001,"Jales",3,"Sudeste",0,"353590",2,3,1,2,1,2,0,0,0,0,0,3,1,2,1,2,3,10.2214171463187,8.31752199628717,0.355261254080157,29
"10442","SP","Paranapuã",4095,27485.59,35001,"Jales",3,"Sudeste",0,"353590",3,2,0,2,1,1,0,0,0,0,0,2,0,2,1,1,2,10.2214171463187,8.31752199628717,0.381300358988265,31
"10443","SP","Paranapuã",4095,27485.59,35001,"Jales",3,"Sudeste",0,"353590",4,4,1,3,1,3,0,0,0,0,0,4,1,3,1,3,4,10.2214171463187,8.31752199628717,0.3846773528405,30
"10444","SP","Paranapuã",4095,27485.59,35001,"Jales",3,"Sudeste",0,"353590",5,8,3,5,4,4,0,0,0,0,0,8,3,5,4,4,3,10.2214171463187,8.31752199628717,0.349161874173577,31
"10445","SP","Parapuã",10949,32118.91,35035,"Adamantina",3,"Sudeste",0,"353600",2,4,0,4,3,1,0,0,0,0,0,4,0,4,3,1,9,10.377200232242,9.30100340687343,0.283938681321755,29
"10446","SP","Parapuã",10949,32118.91,35035,"Adamantina",3,"Sudeste",0,"353600",3,5,0,5,2,3,0,0,0,0,0,5,0,5,2,3,13,10.377200232242,9.30100340687343,0.343027490571526,31
"10447","SP","Parapuã",10949,32118.91,35035,"Adamantina",3,"Sudeste",0,"353600",4,9,1,8,2,7,0,0,0,0,0,9,1,8,2,7,8,10.377200232242,9.30100340687343,0.360030288195734,30
"10448","SP","Parapuã",10949,32118.91,35035,"Adamantina",3,"Sudeste",0,"353600",5,10,1,9,4,6,0,0,0,0,0,10,1,9,4,6,5,10.377200232242,9.30100340687343,0.366962477669296,31
"10449","SP","Pardinho",6508,47454.61,35023,"Botucatu",3,"Sudeste",0,"353610",2,11,5,6,4,7,0,0,0,0,0,11,5,6,4,7,5,10.7675289542187,8.78078746833893,0.348746131285988,29
"10450","SP","Pardinho",6508,47454.61,35023,"Botucatu",3,"Sudeste",0,"353610",3,6,3,3,2,4,0,0,0,0,0,6,3,3,2,4,0,10.7675289542187,8.78078746833893,0.410414658003915,31
"10451","SP","Pardinho",6508,47454.61,35023,"Botucatu",3,"Sudeste",0,"353610",4,12,5,7,2,10,0,0,0,0,0,12,5,7,2,10,3,10.7675289542187,8.78078746833893,0.482120507664158,30
"10452","SP","Pardinho",6508,47454.61,35023,"Botucatu",3,"Sudeste",0,"353610",5,8,0,8,4,4,0,0,0,0,0,8,0,8,4,4,7,10.7675289542187,8.78078746833893,0.447324899836601,31
"10453","SP","Pariquera-Açu",19723,25926.61,35055,"Registro",3,"Sudeste",0,"353620",2,21,7,14,7,14,0,0,0,0,0,21,7,14,7,14,14,10.1630251333874,9.8895407464035,0.341356049223954,29
"10454","SP","Pariquera-Açu",19723,25926.61,35055,"Registro",3,"Sudeste",0,"353620",3,20,6,14,10,10,0,0,0,0,0,20,6,14,10,10,7,10.1630251333874,9.8895407464035,0.449905886065582,31
"10455","SP","Pariquera-Açu",19723,25926.61,35055,"Registro",3,"Sudeste",0,"353620",4,19,4,15,13,6,0,0,0,0,0,19,4,15,13,6,7,10.1630251333874,9.8895407464035,0.514373418477341,30
"10456","SP","Pariquera-Açu",19723,25926.61,35055,"Registro",3,"Sudeste",0,"353620",5,18,2,16,6,12,0,0,0,0,0,18,2,16,6,12,15,10.1630251333874,9.8895407464035,0.465913393557221,31
"10457","SP","Patrocínio Paulista",14807,60792.11,35012,"Franca",3,"Sudeste",1,"353630",2,9,2,7,5,4,0,0,0,0,0,9,2,7,5,4,8,11.0152152897966,9.60285532090872,0.310407780791302,29
"10458","SP","Patrocínio Paulista",14807,60792.11,35012,"Franca",3,"Sudeste",1,"353630",3,6,0,6,1,5,0,0,0,0,0,6,0,6,1,5,7,11.0152152897966,9.60285532090872,0.405123654650531,31
"10459","SP","Patrocínio Paulista",14807,60792.11,35012,"Franca",3,"Sudeste",1,"353630",4,1,0,1,0,1,1,1,0,1,0,2,1,1,1,1,7,11.0152152897966,9.60285532090872,0.413618210267292,30
"10460","SP","Patrocínio Paulista",14807,60792.11,35012,"Franca",3,"Sudeste",1,"353630",5,6,0,6,2,4,0,0,0,0,0,6,0,6,2,4,11,11.0152152897966,9.60285532090872,0.388922157201073,31
"10461","SP","Paulicéia",7454,20705.29,35034,"Dracena",3,"Sudeste",0,"353640",2,2,0,2,0,2,0,0,0,0,0,2,0,2,0,2,4,9.93814450216026,8.9165060800392,0.324030217009294,29
"10462","SP","Paulicéia",7454,20705.29,35034,"Dracena",3,"Sudeste",0,"353640",3,8,3,5,4,4,1,0,1,1,0,9,3,6,5,4,6,9.93814450216026,8.9165060800392,0.398204733077198,31
"10463","SP","Paulicéia",7454,20705.29,35034,"Dracena",3,"Sudeste",0,"353640",4,11,2,9,7,4,0,0,0,0,0,11,2,9,7,4,4,9.93814450216026,8.9165060800392,0.420790942649297,30
"10464","SP","Paulicéia",7454,20705.29,35034,"Dracena",3,"Sudeste",0,"353640",5,14,7,7,8,6,0,0,0,0,0,14,7,7,8,6,2,9.93814450216026,8.9165060800392,0.381424654181252,31
"10465","SP","Paulínia",112003,306163.17,35032,"Campinas",3,"Sudeste",1,"353650",2,90,12,78,26,64,1,0,1,1,0,91,12,79,27,64,41,12.6318734741092,11.6262809356328,0.29835909385506,29
"10466","SP","Paulínia",112003,306163.17,35032,"Campinas",3,"Sudeste",1,"353650",3,115,18,97,35,80,0,0,0,0,0,115,18,97,35,80,46,12.6318734741092,11.6262809356328,0.399809331206943,31
"10467","SP","Paulínia",112003,306163.17,35032,"Campinas",3,"Sudeste",1,"353650",4,98,18,80,21,77,1,0,1,1,0,99,18,81,22,77,47,12.6318734741092,11.6262809356328,0.467613050815719,30
"10468","SP","Paulínia",112003,306163.17,35032,"Campinas",3,"Sudeste",1,"353650",5,123,16,107,37,86,0,0,0,0,0,123,16,107,37,86,50,12.6318734741092,11.6262809356328,0.429835160555906,31
"10469","SP","Paulo de Faria",8959,30110.56,35004,"São José do Rio Preto",3,"Sudeste",0,"353660",2,5,1,4,3,2,0,0,0,0,0,5,1,4,3,2,9,10.3126312197751,9.10041389259758,0.309562782139373,29
"10470","SP","Paulo de Faria",8959,30110.56,35004,"São José do Rio Preto",3,"Sudeste",0,"353660",3,4,0,4,0,4,1,1,0,1,0,5,1,4,1,4,2,10.3126312197751,9.10041389259758,0.368611744984812,31
"10471","SP","Paulo de Faria",8959,30110.56,35004,"São José do Rio Preto",3,"Sudeste",0,"353660",4,8,1,7,5,3,0,0,0,0,0,8,1,7,5,3,11,10.3126312197751,9.10041389259758,0.362477306967022,30
"10472","SP","Paulo de Faria",8959,30110.56,35004,"São José do Rio Preto",3,"Sudeste",0,"353660",5,6,0,6,1,5,0,0,0,0,0,6,0,6,1,5,2,10.3126312197751,9.10041389259758,0.372690335232674,31
"10473","SP","Pederneiras",47111,47430.98,35021,"Jaú",3,"Sudeste",1,"353670",2,29,5,24,13,16,0,0,0,0,0,29,5,24,13,16,28,10.7670308806864,10.7602617983845,0.308559080584898,29
"10474","SP","Pederneiras",47111,47430.98,35021,"Jaú",3,"Sudeste",1,"353670",3,35,7,28,6,29,0,0,0,0,0,35,7,28,6,29,24,10.7670308806864,10.7602617983845,0.386203971040423,31
"10475","SP","Pederneiras",47111,47430.98,35021,"Jaú",3,"Sudeste",1,"353670",4,45,10,35,12,33,0,0,0,0,0,45,10,35,12,33,25,10.7670308806864,10.7602617983845,0.422087029272054,30
"10476","SP","Pederneiras",47111,47430.98,35021,"Jaú",3,"Sudeste",1,"353670",5,39,4,35,18,21,0,0,0,0,0,39,4,35,18,21,27,10.7670308806864,10.7602617983845,0.402311106846116,31
"10477","SP","Pedregulho",16811,52418.86,35012,"Franca",3,"Sudeste",0,"353700",2,19,5,14,9,10,0,0,0,0,0,19,5,14,9,10,8,10.8670217292163,9.72978871303306,0.320854488014986,29
"10478","SP","Pedregulho",16811,52418.86,35012,"Franca",3,"Sudeste",0,"353700",3,11,3,8,2,9,0,0,0,0,0,11,3,8,2,9,14,10.8670217292163,9.72978871303306,0.396886899686259,31
"10479","SP","Pedregulho",16811,52418.86,35012,"Franca",3,"Sudeste",0,"353700",4,16,5,11,4,12,0,0,0,0,0,16,5,11,4,12,12,10.8670217292163,9.72978871303306,0.414443600599635,30
"10480","SP","Pedregulho",16811,52418.86,35012,"Franca",3,"Sudeste",0,"353700",5,29,7,22,9,20,0,0,0,0,0,29,7,22,9,20,13,10.8670217292163,9.72978871303306,0.400452044186032,31
"10481","SP","Pedreira",48463,26471.59,35032,"Campinas",3,"Sudeste",1,"353710",2,22,5,17,5,17,0,0,0,0,0,22,5,17,5,17,28,10.1838273614186,10.7885558991816,0.314684536499335,29
"10482","SP","Pedreira",48463,26471.59,35032,"Campinas",3,"Sudeste",1,"353710",3,26,2,24,9,17,0,0,0,0,0,26,2,24,9,17,20,10.1838273614186,10.7885558991816,0.396156274291389,31
"10483","SP","Pedreira",48463,26471.59,35032,"Campinas",3,"Sudeste",1,"353710",4,36,5,31,20,16,0,0,0,0,0,36,5,31,20,16,25,10.1838273614186,10.7885558991816,0.442584144361583,30
"10484","SP","Pedreira",48463,26471.59,35032,"Campinas",3,"Sudeste",1,"353710",5,47,7,40,17,30,0,0,0,0,0,47,7,40,17,30,20,10.1838273614186,10.7885558991816,0.416659016232098,31
"10485","SP","Pedro de Toledo",11421,12787.4,35056,"Itanhaém",3,"Sudeste",0,"353720",2,12,3,9,5,7,0,0,0,0,0,12,3,9,5,7,6,9.45621559009245,9.34320904505061,0.345443673904218,29
"10486","SP","Pedro de Toledo",11421,12787.4,35056,"Itanhaém",3,"Sudeste",0,"353720",3,8,3,5,5,3,0,0,0,0,0,8,3,5,5,3,5,9.45621559009245,9.34320904505061,0.443853326551157,31
"10487","SP","Pedro de Toledo",11421,12787.4,35056,"Itanhaém",3,"Sudeste",0,"353720",4,10,4,6,5,5,0,0,0,0,0,10,4,6,5,5,5,9.45621559009245,9.34320904505061,0.491684382725269,30
"10488","SP","Pedro de Toledo",11421,12787.4,35056,"Itanhaém",3,"Sudeste",0,"353720",5,7,1,6,2,5,0,0,0,0,0,7,1,6,2,5,6,9.45621559009245,9.34320904505061,0.477495827419176,31
"10489","SP","Penápolis",63757,26395.81,35018,"Birigui",3,"Sudeste",1,"353730",2,63,8,55,19,44,1,1,0,0,1,64,9,55,19,45,31,10.1809605644171,11.0628342609142,0.292421231752093,29
"10490","SP","Penápolis",63757,26395.81,35018,"Birigui",3,"Sudeste",1,"353730",3,55,5,50,12,43,0,0,0,0,0,55,5,50,12,43,40,10.1809605644171,11.0628342609142,0.377005489153912,31
"10491","SP","Penápolis",63757,26395.81,35018,"Birigui",3,"Sudeste",1,"353730",4,56,11,45,22,34,0,0,0,0,0,56,11,45,22,34,44,10.1809605644171,11.0628342609142,0.429090821480986,30
"10492","SP","Penápolis",63757,26395.81,35018,"Birigui",3,"Sudeste",1,"353730",5,65,20,45,21,44,1,0,1,1,0,66,20,46,22,44,17,10.1809605644171,11.0628342609142,0.385660028166888,31
"10493","SP","Pereira Barreto",25677,29553.41,35016,"Andradina",3,"Sudeste",1,"353740",2,19,3,16,4,15,0,0,0,0,0,19,3,16,4,15,13,10.2939544138076,10.1533509285497,0.308046944655199,29
"10494","SP","Pereira Barreto",25677,29553.41,35016,"Andradina",3,"Sudeste",1,"353740",3,14,5,9,6,8,0,0,0,0,0,14,5,9,6,8,20,10.2939544138076,10.1533509285497,0.395035194067289,31
"10495","SP","Pereira Barreto",25677,29553.41,35016,"Andradina",3,"Sudeste",1,"353740",4,21,8,13,7,14,0,0,0,0,0,21,8,13,7,14,18,10.2939544138076,10.1533509285497,0.442866726374647,30
"10496","SP","Pereira Barreto",25677,29553.41,35016,"Andradina",3,"Sudeste",1,"353740",5,21,5,16,9,12,0,0,0,0,0,21,5,16,9,12,17,10.2939544138076,10.1533509285497,0.437905691557955,31
"10497","SP","Pereiras",8773,23954.99,35043,"Tatuí",3,"Sudeste",0,"353750",2,8,1,7,2,6,0,0,0,0,0,8,1,7,2,6,6,10.0839319318678,9.07943410212838,0.39173767100255,29
"10498","SP","Pereiras",8773,23954.99,35043,"Tatuí",3,"Sudeste",0,"353750",3,9,2,7,1,8,0,0,0,0,0,9,2,7,1,8,7,10.0839319318678,9.07943410212838,0.460156443516489,31
"10499","SP","Pereiras",8773,23954.99,35043,"Tatuí",3,"Sudeste",0,"353750",4,4,0,4,2,2,0,0,0,0,0,4,0,4,2,2,2,10.0839319318678,9.07943410212838,0.501289446584682,30
"10500","SP","Pereiras",8773,23954.99,35043,"Tatuí",3,"Sudeste",0,"353750",5,13,3,10,6,7,0,0,0,0,0,13,3,10,6,7,3,10.0839319318678,9.07943410212838,0.485516526450419,31
"10501","SP","Peruíbe",69001,22538.1,35056,"Itanhaém",3,"Sudeste",1,"353760",2,56,14,42,20,36,1,0,1,0,1,57,14,43,20,37,50,10.0229624894534,11.141876276228,0.325566532785466,29
"10502","SP","Peruíbe",69001,22538.1,35056,"Itanhaém",3,"Sudeste",1,"353760",3,87,24,63,37,50,0,0,0,0,0,87,24,63,37,50,64,10.0229624894534,11.141876276228,0.422486970734542,31
"10503","SP","Peruíbe",69001,22538.1,35056,"Itanhaém",3,"Sudeste",1,"353760",4,53,11,42,21,32,2,1,1,1,1,55,12,43,22,33,57,10.0229624894534,11.141876276228,0.484237639328951,30
"10504","SP","Peruíbe",69001,22538.1,35056,"Itanhaém",3,"Sudeste",1,"353760",5,79,24,55,31,48,1,0,1,0,1,80,24,56,31,49,57,10.0229624894534,11.141876276228,0.455894829907003,31
"10505","SP","Piacatu",6038,15498.37,35018,"Birigui",3,"Sudeste",0,"353770",2,3,0,3,0,3,0,0,0,0,0,3,0,3,0,3,4,9.64849013608718,8.70582811026678,0.302924332399463,29
"10506","SP","Piacatu",6038,15498.37,35018,"Birigui",3,"Sudeste",0,"353770",3,2,0,2,0,2,0,0,0,0,0,2,0,2,0,2,6,9.64849013608718,8.70582811026678,0.392271808746206,31
"10507","SP","Piacatu",6038,15498.37,35018,"Birigui",3,"Sudeste",0,"353770",4,5,0,5,2,3,0,0,0,0,0,5,0,5,2,3,2,9.64849013608718,8.70582811026678,0.449464869667255,30
"10508","SP","Piacatu",6038,15498.37,35018,"Birigui",3,"Sudeste",0,"353770",5,2,1,1,1,1,0,0,0,0,0,2,1,1,1,1,12,9.64849013608718,8.70582811026678,0.387386840288506,31
"10509","SP","Piedade",55542,21916.31,35045,"Piedade",3,"Sudeste",0,"353780",2,44,8,36,19,25,2,2,0,1,1,46,10,36,20,26,35,9.99498638747522,10.9248947702953,0.297775766485791,29
"10510","SP","Piedade",55542,21916.31,35045,"Piedade",3,"Sudeste",0,"353780",3,46,8,38,14,32,1,0,1,0,1,47,8,39,14,33,33,9.99498638747522,10.9248947702953,0.384025377839454,31
"10511","SP","Piedade",55542,21916.31,35045,"Piedade",3,"Sudeste",0,"353780",4,47,16,31,22,25,1,1,0,0,1,48,17,31,22,26,22,9.99498638747522,10.9248947702953,0.434497960864132,30
"10512","SP","Piedade",55542,21916.31,35045,"Piedade",3,"Sudeste",0,"353780",5,44,13,31,17,27,0,0,0,0,0,44,13,31,17,27,48,9.99498638747522,10.9248947702953,0.421532756077656,31
"10513","SP","Pilar do Sul",29402,23370.06,35045,"Piedade",3,"Sudeste",0,"353790",2,28,8,20,8,20,0,0,0,0,0,28,8,20,8,20,12,10.0592109949237,10.2888179782239,0.263752697909835,29
"10514","SP","Pilar do Sul",29402,23370.06,35045,"Piedade",3,"Sudeste",0,"353790",3,25,4,21,12,13,1,0,1,0,1,26,4,22,12,14,16,10.0592109949237,10.2888179782239,0.355041483206304,31
"10515","SP","Pilar do Sul",29402,23370.06,35045,"Piedade",3,"Sudeste",0,"353790",4,49,12,37,21,28,0,0,0,0,0,49,12,37,21,28,14,10.0592109949237,10.2888179782239,0.412177274347075,30
"10516","SP","Pilar do Sul",29402,23370.06,35045,"Piedade",3,"Sudeste",0,"353790",5,40,6,34,18,22,0,0,0,0,0,40,6,34,18,22,12,10.0592109949237,10.2888179782239,0.386502580164213,31
"10517","SP","Pindamonhangaba",170132,51761.18,35050,"São José dos Campos",3,"Sudeste",1,"353800",2,162,13,149,55,107,3,0,3,1,2,165,13,152,56,109,80,10.854395726442,12.0443298853233,0.307638532454268,29
"10518","SP","Pindamonhangaba",170132,51761.18,35050,"São José dos Campos",3,"Sudeste",1,"353800",3,171,16,155,57,114,2,0,2,0,2,173,16,157,57,116,96,10.854395726442,12.0443298853233,0.415665225670436,31
"10519","SP","Pindamonhangaba",170132,51761.18,35050,"São José dos Campos",3,"Sudeste",1,"353800",4,171,15,156,59,112,0,0,0,0,0,171,15,156,59,112,71,10.854395726442,12.0443298853233,0.477911373482884,30
"10520","SP","Pindamonhangaba",170132,51761.18,35050,"São José dos Campos",3,"Sudeste",1,"353800",5,210,34,176,74,136,1,1,0,0,1,211,35,176,74,137,83,10.854395726442,12.0443298853233,0.429883678858862,31
"10521","SP","Pindorama",17216,22081.72,35005,"Catanduva",3,"Sudeste",1,"353810",2,12,0,12,3,9,0,0,0,0,0,12,0,12,3,9,6,10.0025053959078,9.75359446296151,0.308274600019517,29
"10522","SP","Pindorama",17216,22081.72,35005,"Catanduva",3,"Sudeste",1,"353810",3,14,2,12,3,11,0,0,0,0,0,14,2,12,3,11,15,10.0025053959078,9.75359446296151,0.392613697983205,31
"10523","SP","Pindorama",17216,22081.72,35005,"Catanduva",3,"Sudeste",1,"353810",4,8,0,8,3,5,0,0,0,0,0,8,0,8,3,5,10,10.0025053959078,9.75359446296151,0.431198966755714,30
"10524","SP","Pindorama",17216,22081.72,35005,"Catanduva",3,"Sudeste",1,"353810",5,9,2,7,4,5,0,0,0,0,0,9,2,7,4,5,10,10.0025053959078,9.75359446296151,0.382306472155765,31
"10525","SP","Pinhalzinho",15388,17475.49,35033,"Amparo",3,"Sudeste",0,"353820",2,10,1,9,2,8,0,0,0,0,0,10,1,9,2,8,5,9.76855460676612,9.64134326387219,0.300433746400156,29
"10526","SP","Pinhalzinho",15388,17475.49,35033,"Amparo",3,"Sudeste",0,"353820",3,14,2,12,5,9,0,0,0,0,0,14,2,12,5,9,11,9.76855460676612,9.64134326387219,0.386648382616116,31
"10527","SP","Pinhalzinho",15388,17475.49,35033,"Amparo",3,"Sudeste",0,"353820",4,16,3,13,7,9,0,0,0,0,0,16,3,13,7,9,5,9.76855460676612,9.64134326387219,0.428290663553823,30
"10528","SP","Pinhalzinho",15388,17475.49,35033,"Amparo",3,"Sudeste",0,"353820",5,21,3,18,9,12,0,0,0,0,0,21,3,18,9,12,19,9.76855460676612,9.64134326387219,0.406057701764043,31
"10529","SP","Piquete",13575,11973.44,35051,"Guaratinguetá",3,"Sudeste",1,"353850",2,8,1,7,3,5,0,0,0,0,0,8,1,7,3,5,7,9.39044614239431,9.51598514480214,0.337744403514286,29
"10530","SP","Piquete",13575,11973.44,35051,"Guaratinguetá",3,"Sudeste",1,"353850",3,7,1,6,4,3,0,0,0,0,0,7,1,6,4,3,14,9.39044614239431,9.51598514480214,0.446626398226495,31
"10531","SP","Piquete",13575,11973.44,35051,"Guaratinguetá",3,"Sudeste",1,"353850",4,11,1,10,4,7,0,0,0,0,0,11,1,10,4,7,7,9.39044614239431,9.51598514480214,0.523939501183844,30
"10532","SP","Piquete",13575,11973.44,35051,"Guaratinguetá",3,"Sudeste",1,"353850",5,10,0,10,4,6,0,0,0,0,0,10,0,10,4,6,11,9.39044614239431,9.51598514480214,0.475361584394916,31
"10533","SP","Piracaia",27462,17540.72,35048,"Bragança Paulista",3,"Sudeste",0,"353860",2,24,5,19,6,18,0,0,0,0,0,24,5,19,6,18,15,9.77228031411447,10.2205585098817,0.314386319532049,29
"10534","SP","Piracaia",27462,17540.72,35048,"Bragança Paulista",3,"Sudeste",0,"353860",3,20,2,18,8,12,0,0,0,0,0,20,2,18,8,12,10,9.77228031411447,10.2205585098817,0.396653036467035,31
"10535","SP","Piracaia",27462,17540.72,35048,"Bragança Paulista",3,"Sudeste",0,"353860",4,21,6,15,4,17,1,0,1,0,1,22,6,16,4,18,18,9.77228031411447,10.2205585098817,0.447447783611121,30
"10536","SP","Piracaia",27462,17540.72,35048,"Bragança Paulista",3,"Sudeste",0,"353860",5,25,5,20,8,17,0,0,0,0,0,25,5,20,8,17,20,9.77228031411447,10.2205585098817,0.436032286403652,31
"10537","SP","Piracicaba",407252,65896.34,35028,"Piracicaba",3,"Sudeste",1,"353870",2,367,57,310,110,257,4,1,3,0,4,371,58,313,110,261,198,11.0958381802533,12.9171874374406,0.286111776179879,29
"10538","SP","Piracicaba",407252,65896.34,35028,"Piracicaba",3,"Sudeste",1,"353870",3,374,49,325,112,262,6,0,6,3,3,380,49,331,115,265,226,11.0958381802533,12.9171874374406,0.379895737167955,31
"10539","SP","Piracicaba",407252,65896.34,35028,"Piracicaba",3,"Sudeste",1,"353870",4,367,55,312,103,264,3,1,2,1,2,370,56,314,104,266,200,11.0958381802533,12.9171874374406,0.441890951491506,30
"10540","SP","Piracicaba",407252,65896.34,35028,"Piracicaba",3,"Sudeste",1,"353870",5,427,56,371,137,290,3,0,3,0,3,430,56,374,137,293,238,11.0958381802533,12.9171874374406,0.404185051393581,31
"10541","SP","Piraju",29869,24936.58,35040,"Ourinhos",3,"Sudeste",1,"353880",2,31,8,23,8,23,0,0,0,0,0,31,8,23,8,23,21,10.1240910807211,10.3045764322433,0.303490640353092,29
"10542","SP","Piraju",29869,24936.58,35040,"Ourinhos",3,"Sudeste",1,"353880",3,22,7,15,10,12,1,1,0,1,0,23,8,15,11,12,19,10.1240910807211,10.3045764322433,0.391700763954221,31
"10543","SP","Piraju",29869,24936.58,35040,"Ourinhos",3,"Sudeste",1,"353880",4,30,6,24,13,17,0,0,0,0,0,30,6,24,13,17,10,10.1240910807211,10.3045764322433,0.467427586700245,30
"10544","SP","Piraju",29869,24936.58,35040,"Ourinhos",3,"Sudeste",1,"353880",5,30,2,28,9,21,0,0,0,0,0,30,2,28,9,21,29,10.1240910807211,10.3045764322433,0.436755350767166,31
"10545","SP","Pirajuí",25719,18702.35,35020,"Bauru",3,"Sudeste",1,"353890",2,14,1,13,6,8,0,0,0,0,0,14,1,13,6,8,13,9.83640446339626,10.1549852973469,0.317678763245916,29
"10546","SP","Pirajuí",25719,18702.35,35020,"Bauru",3,"Sudeste",1,"353890",3,14,5,9,4,10,0,0,0,0,0,14,5,9,4,10,25,9.83640446339626,10.1549852973469,0.390087022744531,31
"10547","SP","Pirajuí",25719,18702.35,35020,"Bauru",3,"Sudeste",1,"353890",4,17,2,15,6,11,0,0,0,0,0,17,2,15,6,11,18,9.83640446339626,10.1549852973469,0.423228987806511,30
"10548","SP","Pirajuí",25719,18702.35,35020,"Bauru",3,"Sudeste",1,"353890",5,16,1,15,5,11,1,1,0,0,1,17,2,15,5,12,28,9.83640446339626,10.1549852973469,0.399456998863506,31
"10549","SP","Pirangi",11471,29289.51,35013,"Jaboticabal",3,"Sudeste",0,"353900",2,6,1,5,3,3,0,0,0,0,0,6,1,5,3,3,12,10.2849847104227,9.34757739028127,0.302495330365056,29
"10550","SP","Pirangi",11471,29289.51,35013,"Jaboticabal",3,"Sudeste",0,"353900",3,10,1,9,5,5,0,0,0,0,0,10,1,9,5,5,7,10.2849847104227,9.34757739028127,0.367661250685874,31
"10551","SP","Pirangi",11471,29289.51,35013,"Jaboticabal",3,"Sudeste",0,"353900",4,4,2,2,0,4,0,0,0,0,0,4,2,2,0,4,5,10.2849847104227,9.34757739028127,0.368547577508178,30
"10552","SP","Pirangi",11471,29289.51,35013,"Jaboticabal",3,"Sudeste",0,"353900",5,9,3,6,2,7,0,0,0,0,0,9,3,6,2,7,13,10.2849847104227,9.34757739028127,0.378531991314619,31
"10553","SP","Pirapora do Bom Jesus",19178,24587.66,35057,"Osasco",3,"Sudeste",1,"353910",2,21,0,21,13,8,1,0,1,0,1,22,0,22,13,9,4,10.1099999700478,9.86151906771363,0.276031287858932,29
"10554","SP","Pirapora do Bom Jesus",19178,24587.66,35057,"Osasco",3,"Sudeste",1,"353910",3,18,2,16,4,14,0,0,0,0,0,18,2,16,4,14,11,10.1099999700478,9.86151906771363,0.373563838491343,31
"10555","SP","Pirapora do Bom Jesus",19178,24587.66,35057,"Osasco",3,"Sudeste",1,"353910",4,23,5,18,9,14,0,0,0,0,0,23,5,18,9,14,6,10.1099999700478,9.86151906771363,0.441836561647521,30
"10556","SP","Pirapora do Bom Jesus",19178,24587.66,35057,"Osasco",3,"Sudeste",1,"353910",5,22,1,21,12,10,0,0,0,0,0,22,1,21,12,10,11,10.1099999700478,9.86151906771363,0.422815774696959,31
"10557","SP","Pirapozinho",27754,34839.45,35036,"Presidente Prudente",3,"Sudeste",1,"353920",2,16,3,13,3,13,0,0,0,0,0,16,3,13,3,13,9,10.4585056443895,10.231135252931,0.313050055735794,29
"10558","SP","Pirapozinho",27754,34839.45,35036,"Presidente Prudente",3,"Sudeste",1,"353920",3,24,3,21,9,15,0,0,0,0,0,24,3,21,9,15,15,10.4585056443895,10.231135252931,0.379712118242771,31
"10559","SP","Pirapozinho",27754,34839.45,35036,"Presidente Prudente",3,"Sudeste",1,"353920",4,26,5,21,10,16,0,0,0,0,0,26,5,21,10,16,12,10.4585056443895,10.231135252931,0.418850760396724,30
"10560","SP","Pirapozinho",27754,34839.45,35036,"Presidente Prudente",3,"Sudeste",1,"353920",5,20,2,18,10,10,0,0,0,0,0,20,2,18,10,10,22,10.4585056443895,10.231135252931,0.407824208372793,31
"10561","SP","Pirassununga",76877,36765.67,35029,"Pirassununga",3,"Sudeste",1,"353930",2,77,12,65,29,48,0,0,0,0,0,77,12,65,29,48,54,10.5123198083185,11.2499620210306,0.297658322400382,29
"10562","SP","Pirassununga",76877,36765.67,35029,"Pirassununga",3,"Sudeste",1,"353930",3,64,10,54,19,45,2,0,2,2,0,66,10,56,21,45,57,10.5123198083185,11.2499620210306,0.385573368534329,31
"10563","SP","Pirassununga",76877,36765.67,35029,"Pirassununga",3,"Sudeste",1,"353930",4,65,10,55,23,42,0,0,0,0,0,65,10,55,23,42,45,10.5123198083185,11.2499620210306,0.449328298548127,30
"10564","SP","Pirassununga",76877,36765.67,35029,"Pirassununga",3,"Sudeste",1,"353930",5,61,8,53,26,35,0,0,0,0,0,61,8,53,26,35,52,10.5123198083185,11.2499620210306,0.426422034757725,31
"10565","SP","Piratininga",13765,17432.02,35020,"Bauru",3,"Sudeste",1,"353940",2,13,2,11,3,10,0,0,0,0,0,13,2,11,3,10,5,9.76606402393908,9.52988441757671,0.294445529924216,29
"10566","SP","Piratininga",13765,17432.02,35020,"Bauru",3,"Sudeste",1,"353940",3,21,3,18,3,18,0,0,0,0,0,21,3,18,3,18,12,9.76606402393908,9.52988441757671,0.383545617850658,31
"10567","SP","Piratininga",13765,17432.02,35020,"Bauru",3,"Sudeste",1,"353940",4,13,1,12,5,8,0,0,0,0,0,13,1,12,5,8,10,9.76606402393908,9.52988441757671,0.432561722989323,30
"10568","SP","Piratininga",13765,17432.02,35020,"Bauru",3,"Sudeste",1,"353940",5,13,1,12,2,11,0,0,0,0,0,13,1,12,2,11,15,9.76606402393908,9.52988441757671,0.413386302580477,31
"10569","SP","Pitangueiras",40080,27053.73,35013,"Jaboticabal",3,"Sudeste",1,"353950",2,31,12,19,12,19,0,0,0,0,0,31,12,19,12,19,15,10.2055801675594,10.5986327357587,0.312587055237425,29
"10570","SP","Pitangueiras",40080,27053.73,35013,"Jaboticabal",3,"Sudeste",1,"353950",3,31,8,23,15,16,1,0,1,1,0,32,8,24,16,16,19,10.2055801675594,10.5986327357587,0.38561795079785,31
"10571","SP","Pitangueiras",40080,27053.73,35013,"Jaboticabal",3,"Sudeste",1,"353950",4,34,4,30,8,26,0,0,0,0,0,34,4,30,8,26,17,10.2055801675594,10.5986327357587,0.41817345578698,30
"10572","SP","Pitangueiras",40080,27053.73,35013,"Jaboticabal",3,"Sudeste",1,"353950",5,52,11,41,18,34,0,0,0,0,0,52,11,41,18,34,25,10.2055801675594,10.5986327357587,0.386380692696604,31
"10573","SP","Planalto",5304,30164.36,35004,"São José do Rio Preto",3,"Sudeste",0,"353960",2,4,2,2,3,1,0,0,0,0,0,4,2,2,3,1,1,10.314416374008,8.5762165318657,0.343921613991256,29
"10574","SP","Planalto",5304,30164.36,35004,"São José do Rio Preto",3,"Sudeste",0,"353960",3,4,1,3,3,1,0,0,0,0,0,4,1,3,3,1,3,10.314416374008,8.5762165318657,0.365591982767352,31
"10575","SP","Planalto",5304,30164.36,35004,"São José do Rio Preto",3,"Sudeste",0,"353960",4,4,1,3,1,3,0,0,0,0,0,4,1,3,1,3,4,10.314416374008,8.5762165318657,0.407756263379501,30
"10576","SP","Planalto",5304,30164.36,35004,"São José do Rio Preto",3,"Sudeste",0,"353960",5,7,3,4,3,4,0,0,0,0,0,7,3,4,3,4,1,10.314416374008,8.5762165318657,0.38913969676742,31
"10577","SP","Poá",118349,39992.89,35062,"Mogi das Cruzes",3,"Sudeste",1,"353980",2,99,11,88,33,66,1,0,1,0,1,100,11,89,33,67,56,10.5964569672967,11.6813931653923,0.311510841825451,29
"10578","SP","Poá",118349,39992.89,35062,"Mogi das Cruzes",3,"Sudeste",1,"353980",3,107,10,97,37,70,0,0,0,0,0,107,10,97,37,70,68,10.5964569672967,11.6813931653923,0.415489646087483,31
"10579","SP","Poá",118349,39992.89,35062,"Mogi das Cruzes",3,"Sudeste",1,"353980",4,95,11,84,27,68,3,0,3,2,1,98,11,87,29,69,71,10.5964569672967,11.6813931653923,0.49450090910802,30
"10580","SP","Poá",118349,39992.89,35062,"Mogi das Cruzes",3,"Sudeste",1,"353980",5,99,10,89,33,66,3,1,2,1,2,102,11,91,34,68,93,10.5964569672967,11.6813931653923,0.457021671232862,31
"10581","SP","Poloni",6113,21985.92,35007,"Nhandeara",3,"Sudeste",0,"353990",2,7,0,7,1,6,0,0,0,0,0,7,0,7,1,6,4,9.99815752745303,8.71817293002873,0.275067860788448,29
"10582","SP","Poloni",6113,21985.92,35007,"Nhandeara",3,"Sudeste",0,"353990",3,6,2,4,1,5,0,0,0,0,0,6,2,4,1,5,7,9.99815752745303,8.71817293002873,0.345085208196974,31
"10583","SP","Poloni",6113,21985.92,35007,"Nhandeara",3,"Sudeste",0,"353990",4,4,1,3,1,3,0,0,0,0,0,4,1,3,1,3,3,9.99815752745303,8.71817293002873,0.377710828068221,30
"10584","SP","Poloni",6113,21985.92,35007,"Nhandeara",3,"Sudeste",0,"353990",5,9,3,6,3,6,0,0,0,0,0,9,3,6,3,6,5,9.99815752745303,8.71817293002873,0.354738008605587,31
"10585","SP","Pompéia",22172,56951.86,35038,"Marília",3,"Sudeste",1,"354000",2,10,0,10,1,9,0,0,0,0,0,10,0,10,1,9,10,10.9499616285703,10.0065855105397,0.294855229726939,29
"10586","SP","Pompéia",22172,56951.86,35038,"Marília",3,"Sudeste",1,"354000",3,22,1,21,3,19,0,0,0,0,0,22,1,21,3,19,11,10.9499616285703,10.0065855105397,0.387631948219944,31
"10587","SP","Pompéia",22172,56951.86,35038,"Marília",3,"Sudeste",1,"354000",4,15,0,15,4,11,0,0,0,0,0,15,0,15,4,11,18,10.9499616285703,10.0065855105397,0.449792611918987,30
"10588","SP","Pompéia",22172,56951.86,35038,"Marília",3,"Sudeste",1,"354000",5,22,2,20,6,16,0,0,0,0,0,22,2,20,6,16,14,10.9499616285703,10.0065855105397,0.408364813497908,31
"10589","SP","Pontal",50852,23772.76,35014,"Ribeirão Preto",3,"Sudeste",1,"354020",2,34,6,28,14,20,0,0,0,0,0,34,6,28,14,20,19,10.0762956663608,10.83667473207,0.317202011274718,29
"10590","SP","Pontal",50852,23772.76,35014,"Ribeirão Preto",3,"Sudeste",1,"354020",3,28,3,25,11,17,0,0,0,0,0,28,3,25,11,17,23,10.0762956663608,10.83667473207,0.395073298680427,31
"10591","SP","Pontal",50852,23772.76,35014,"Ribeirão Preto",3,"Sudeste",1,"354020",4,40,10,30,19,21,0,0,0,0,0,40,10,30,19,21,14,10.0762956663608,10.83667473207,0.426232856674533,30
"10592","SP","Pontal",50852,23772.76,35014,"Ribeirão Preto",3,"Sudeste",1,"354020",5,51,12,39,20,31,0,0,0,0,0,51,12,39,20,31,17,10.0762956663608,10.83667473207,0.389670925398332,31
"10593","SP","Populina",4152,22982.84,35001,"Jales",3,"Sudeste",0,"354040",2,3,1,2,0,3,0,0,0,0,0,3,1,2,0,3,3,10.0425031294934,8.33134542484572,0.278232694164935,29
"10594","SP","Populina",4152,22982.84,35001,"Jales",3,"Sudeste",0,"354040",3,4,0,4,1,3,0,0,0,0,0,4,0,4,1,3,4,10.0425031294934,8.33134542484572,0.372096983620318,31
"10595","SP","Populina",4152,22982.84,35001,"Jales",3,"Sudeste",0,"354040",4,2,1,1,2,0,0,0,0,0,0,2,1,1,2,0,6,10.0425031294934,8.33134542484572,0.450674227726336,30
"10596","SP","Populina",4152,22982.84,35001,"Jales",3,"Sudeste",0,"354040",5,3,0,3,2,1,0,0,0,0,0,3,0,3,2,1,3,10.0425031294934,8.33134542484572,0.386903448017898,31
"10597","SP","Porangaba",10067,18026.55,35043,"Tatuí",3,"Sudeste",0,"354050",2,6,2,4,2,4,0,0,0,0,0,6,2,4,2,4,6,9.7996009501343,9.21701802672942,0.295306019632048,29
"10598","SP","Porangaba",10067,18026.55,35043,"Tatuí",3,"Sudeste",0,"354050",3,5,1,4,2,3,0,0,0,0,0,5,1,4,2,3,7,9.7996009501343,9.21701802672942,0.394274034659946,31
"10599","SP","Porangaba",10067,18026.55,35043,"Tatuí",3,"Sudeste",0,"354050",4,12,1,11,4,8,0,0,0,0,0,12,1,11,4,8,12,9.7996009501343,9.21701802672942,0.459710131159261,30
"10600","SP","Porangaba",10067,18026.55,35043,"Tatuí",3,"Sudeste",0,"354050",5,8,4,4,2,6,0,0,0,0,0,8,4,4,2,6,4,9.7996009501343,9.21701802672942,0.445568796755351,31
"10601","SP","Porto Feliz",53402,49253.38,35046,"Sorocaba",3,"Sudeste",1,"354060",2,48,6,42,23,25,0,0,0,0,0,48,6,42,23,25,21,10.804733273687,10.8856034774305,0.300856367306695,29
"10602","SP","Porto Feliz",53402,49253.38,35046,"Sorocaba",3,"Sudeste",1,"354060",3,43,7,36,13,30,0,0,0,0,0,43,7,36,13,30,34,10.804733273687,10.8856034774305,0.393934811462027,31
"10603","SP","Porto Feliz",53402,49253.38,35046,"Sorocaba",3,"Sudeste",1,"354060",4,46,10,36,16,30,0,0,0,0,0,46,10,36,16,30,17,10.804733273687,10.8856034774305,0.448729686004833,30
"10604","SP","Porto Feliz",53402,49253.38,35046,"Sorocaba",3,"Sudeste",1,"354060",5,55,10,45,18,37,2,1,1,0,2,57,11,46,18,39,38,10.804733273687,10.8856034774305,0.414410189559499,31
"10605","SP","Porto Ferreira",56504,36767.59,35029,"Pirassununga",3,"Sudeste",1,"354070",2,36,7,29,12,24,0,0,0,0,0,36,7,29,12,24,29,10.5123720295854,10.9420667110888,0.318678278030884,29
"10606","SP","Porto Ferreira",56504,36767.59,35029,"Pirassununga",3,"Sudeste",1,"354070",3,28,9,19,9,19,1,1,0,1,0,29,10,19,10,19,39,10.5123720295854,10.9420667110888,0.407789663265955,31
"10607","SP","Porto Ferreira",56504,36767.59,35029,"Pirassununga",3,"Sudeste",1,"354070",4,44,16,28,23,21,0,0,0,0,0,44,16,28,23,21,26,10.5123720295854,10.9420667110888,0.481980212847382,30
"10608","SP","Porto Ferreira",56504,36767.59,35029,"Pirassununga",3,"Sudeste",1,"354070",5,49,12,37,20,29,1,0,1,1,0,50,12,38,21,29,34,10.5123720295854,10.9420667110888,0.42063006005284,31
"10609","SP","Potim",25130,9005.43,35051,"Guaratinguetá",3,"Sudeste",1,"354075",2,28,8,20,7,21,1,0,1,0,1,29,8,21,7,22,5,9.10558300771931,10.1318176305376,0.332662581494476,29
"10610","SP","Potim",25130,9005.43,35051,"Guaratinguetá",3,"Sudeste",1,"354075",3,30,9,21,16,14,0,0,0,0,0,30,9,21,16,14,12,9.10558300771931,10.1318176305376,0.434286437236584,31
"10611","SP","Potim",25130,9005.43,35051,"Guaratinguetá",3,"Sudeste",1,"354075",4,21,2,19,9,12,0,0,0,0,0,21,2,19,9,12,7,9.10558300771931,10.1318176305376,0.490806121120529,30
"10612","SP","Potim",25130,9005.43,35051,"Guaratinguetá",3,"Sudeste",1,"354075",5,30,5,25,12,18,0,0,0,0,0,30,5,25,12,18,20,9.10558300771931,10.1318176305376,0.444235579021835,31
"10613","SP","Potirendaba",17516,29949.39,35004,"São José do Rio Preto",3,"Sudeste",1,"354080",2,13,2,11,5,8,0,0,0,0,0,13,2,11,5,8,18,10.3072642360574,9.77087002792129,0.276307924420659,29
"10614","SP","Potirendaba",17516,29949.39,35004,"São José do Rio Preto",3,"Sudeste",1,"354080",3,16,6,10,5,11,0,0,0,0,0,16,6,10,5,11,10,10.3072642360574,9.77087002792129,0.343820575695753,31
"10615","SP","Potirendaba",17516,29949.39,35004,"São José do Rio Preto",3,"Sudeste",1,"354080",4,20,5,15,10,10,0,0,0,0,0,20,5,15,10,10,10,10.3072642360574,9.77087002792129,0.381087428396239,30
"10616","SP","Potirendaba",17516,29949.39,35004,"São José do Rio Preto",3,"Sudeste",1,"354080",5,12,2,10,4,8,0,0,0,0,0,12,2,10,4,8,10,10.3072642360574,9.77087002792129,0.349676671601198,31
"10617","SP","Pradópolis",21873,40977.09,35014,"Ribeirão Preto",3,"Sudeste",1,"354090",2,14,2,12,6,8,0,0,0,0,0,14,2,12,6,8,11,10.6207684090226,9.99300827847454,0.291694466139312,29
"10618","SP","Pradópolis",21873,40977.09,35014,"Ribeirão Preto",3,"Sudeste",1,"354090",3,13,3,10,3,10,0,0,0,0,0,13,3,10,3,10,11,10.6207684090226,9.99300827847454,0.357342530918331,31
"10619","SP","Pradópolis",21873,40977.09,35014,"Ribeirão Preto",3,"Sudeste",1,"354090",4,19,3,16,10,9,0,0,0,0,0,19,3,16,10,9,5,10.6207684090226,9.99300827847454,0.409273096636036,30
"10620","SP","Pradópolis",21873,40977.09,35014,"Ribeirão Preto",3,"Sudeste",1,"354090",5,12,0,12,1,11,0,0,0,0,0,12,0,12,1,11,12,10.6207684090226,9.99300827847454,0.375935695867374,31
"10621","SP","Praia Grande",330845,22064.57,35063,"Santos",3,"Sudeste",1,"354100",2,284,35,249,90,194,3,2,1,1,2,287,37,250,91,196,193,10.001728433637,12.7094052667372,0.305856406845393,29
"10622","SP","Praia Grande",330845,22064.57,35063,"Santos",3,"Sudeste",1,"354100",3,364,65,299,113,251,4,1,3,2,2,368,66,302,115,253,221,10.001728433637,12.7094052667372,0.408825059636991,31
"10623","SP","Praia Grande",330845,22064.57,35063,"Santos",3,"Sudeste",1,"354100",4,341,81,260,111,230,1,1,0,0,1,342,82,260,111,231,228,10.001728433637,12.7094052667372,0.474486227687263,30
"10624","SP","Praia Grande",330845,22064.57,35063,"Santos",3,"Sudeste",1,"354100",5,406,94,312,125,281,3,0,3,1,2,409,94,315,126,283,243,10.001728433637,12.7094052667372,0.436128120849335,31
"10625","SP","Pratânia",5317,25213.86,35023,"Botucatu",3,"Sudeste",0,"354105",2,4,2,2,0,4,0,0,0,0,0,4,2,2,0,4,5,10.135149122305,8.57866451350434,0.35074460869429,29
"10626","SP","Pratânia",5317,25213.86,35023,"Botucatu",3,"Sudeste",0,"354105",3,5,3,2,1,4,0,0,0,0,0,5,3,2,1,4,3,10.135149122305,8.57866451350434,0.41877544404143,31
"10627","SP","Pratânia",5317,25213.86,35023,"Botucatu",3,"Sudeste",0,"354105",4,8,3,5,5,3,0,0,0,0,0,8,3,5,5,3,4,10.135149122305,8.57866451350434,0.444394251683477,30
"10628","SP","Pratânia",5317,25213.86,35023,"Botucatu",3,"Sudeste",0,"354105",5,7,1,6,2,5,0,0,0,0,0,7,1,6,2,5,1,10.135149122305,8.57866451350434,0.42316783281486,31
"10629","SP","Presidente Alves",4080,17861.26,35020,"Bauru",3,"Sudeste",0,"354110",2,1,0,1,1,0,0,0,0,0,0,1,0,1,1,0,2,9.79038940065425,8.31385226739821,0.324166923541629,29
"10630","SP","Presidente Alves",4080,17861.26,35020,"Bauru",3,"Sudeste",0,"354110",3,6,0,6,4,2,0,0,0,0,0,6,0,6,4,2,2,9.79038940065425,8.31385226739821,0.379536909435672,31
"10631","SP","Presidente Alves",4080,17861.26,35020,"Bauru",3,"Sudeste",0,"354110",4,4,1,3,2,2,0,0,0,0,0,4,1,3,2,2,5,9.79038940065425,8.31385226739821,0.385773602387647,30
"10632","SP","Presidente Alves",4080,17861.26,35020,"Bauru",3,"Sudeste",0,"354110",5,6,1,5,5,1,0,0,0,0,0,6,1,5,5,1,2,9.79038940065425,8.31385226739821,0.393713006395947,31
"10633","SP","Presidente Bernardes",13023,20494.34,35036,"Presidente Prudente",3,"Sudeste",1,"354120",2,11,1,10,4,7,0,0,0,0,0,11,1,10,4,7,8,9.92790402944357,9.4744723039677,0.291482100569677,29
"10634","SP","Presidente Bernardes",13023,20494.34,35036,"Presidente Prudente",3,"Sudeste",1,"354120",3,13,2,11,2,11,0,0,0,0,0,13,2,11,2,11,14,9.92790402944357,9.4744723039677,0.369875046719126,31
"10635","SP","Presidente Bernardes",13023,20494.34,35036,"Presidente Prudente",3,"Sudeste",1,"354120",4,9,2,7,4,5,0,0,0,0,0,9,2,7,4,5,5,9.92790402944357,9.4744723039677,0.415867244338892,30
"10636","SP","Presidente Bernardes",13023,20494.34,35036,"Presidente Prudente",3,"Sudeste",1,"354120",5,10,1,9,3,7,0,0,0,0,0,10,1,9,3,7,7,9.92790402944357,9.4744723039677,0.419012306141289,31
"10637","SP","Presidente Epitácio",44389,19364.06,35036,"Presidente Prudente",3,"Sudeste",1,"354130",2,37,5,32,16,21,1,0,1,0,1,38,5,33,16,22,31,9.87117404958815,10.700746969978,0.318028370546604,29
"10638","SP","Presidente Epitácio",44389,19364.06,35036,"Presidente Prudente",3,"Sudeste",1,"354130",3,38,4,34,19,19,1,0,1,1,0,39,4,35,20,19,19,9.87117404958815,10.700746969978,0.40378386100245,31
"10639","SP","Presidente Epitácio",44389,19364.06,35036,"Presidente Prudente",3,"Sudeste",1,"354130",4,42,7,35,18,24,2,0,2,2,0,44,7,37,20,24,21,9.87117404958815,10.700746969978,0.436895319574084,30
"10640","SP","Presidente Epitácio",44389,19364.06,35036,"Presidente Prudente",3,"Sudeste",1,"354130",5,36,6,30,13,23,0,0,0,0,0,36,6,30,13,23,29,9.87117404958815,10.700746969978,0.416730670860996,31
"10641","SP","Presidente Prudente",230371,35207.07,35036,"Presidente Prudente",3,"Sudeste",1,"354140",2,214,19,195,61,153,1,0,1,0,1,215,19,196,61,154,133,10.4690021936908,12.3474463318263,0.297654685778944,29
"10642","SP","Presidente Prudente",230371,35207.07,35036,"Presidente Prudente",3,"Sudeste",1,"354140",3,221,25,196,62,159,2,0,2,0,2,223,25,198,62,161,145,10.4690021936908,12.3474463318263,0.390603682747043,31
"10643","SP","Presidente Prudente",230371,35207.07,35036,"Presidente Prudente",3,"Sudeste",1,"354140",4,197,25,172,59,138,0,0,0,0,0,197,25,172,59,138,135,10.4690021936908,12.3474463318263,0.450818427012821,30
"10644","SP","Presidente Prudente",230371,35207.07,35036,"Presidente Prudente",3,"Sudeste",1,"354140",5,227,24,203,72,155,3,1,2,0,3,230,25,205,72,158,160,10.4690021936908,12.3474463318263,0.415889176745421,31
"10645","SP","Presidente Venceslau",39583,18163.42,35036,"Presidente Prudente",3,"Sudeste",1,"354150",2,28,7,21,10,18,0,0,0,0,0,28,7,21,10,18,19,9.80716496041536,10.5861550121407,0.301161055987804,29
"10646","SP","Presidente Venceslau",39583,18163.42,35036,"Presidente Prudente",3,"Sudeste",1,"354150",3,27,3,24,12,15,0,0,0,0,0,27,3,24,12,15,28,9.80716496041536,10.5861550121407,0.389780226036807,31
"10647","SP","Presidente Venceslau",39583,18163.42,35036,"Presidente Prudente",3,"Sudeste",1,"354150",4,29,3,26,9,20,0,0,0,0,0,29,3,26,9,20,25,9.80716496041536,10.5861550121407,0.444071861768488,30
"10648","SP","Presidente Venceslau",39583,18163.42,35036,"Presidente Prudente",3,"Sudeste",1,"354150",5,31,3,28,5,26,0,0,0,0,0,31,3,28,5,26,27,9.80716496041536,10.5861550121407,0.415754404754458,31
"10649","SP","Promissão",40828,40628.23,35019,"Lins",3,"Sudeste",1,"354160",2,22,11,11,7,15,0,0,0,0,0,22,11,11,7,15,13,10.6122184241638,10.6171233995234,0.310149088528564,29
"10650","SP","Promissão",40828,40628.23,35019,"Lins",3,"Sudeste",1,"354160",3,32,4,28,9,23,0,0,0,0,0,32,4,28,9,23,21,10.6122184241638,10.6171233995234,0.380756318600515,31
"10651","SP","Promissão",40828,40628.23,35019,"Lins",3,"Sudeste",1,"354160",4,29,5,24,14,15,0,0,0,0,0,29,5,24,14,15,19,10.6122184241638,10.6171233995234,0.413338856598786,30
"10652","SP","Promissão",40828,40628.23,35019,"Lins",3,"Sudeste",1,"354160",5,34,9,25,15,19,0,0,0,0,0,34,9,25,15,19,25,10.6122184241638,10.6171233995234,0.389089365688032,31
"10653","SP","Quatá",14210,32860.67,35039,"Assis",3,"Sudeste",1,"354170",2,14,3,11,7,7,0,0,0,0,0,14,3,11,7,7,13,10.4000317809147,9.56170122109115,0.285941195613487,29
"10654","SP","Quatá",14210,32860.67,35039,"Assis",3,"Sudeste",1,"354170",3,9,2,7,4,5,0,0,0,0,0,9,2,7,4,5,6,10.4000317809147,9.56170122109115,0.366852106150752,31
"10655","SP","Quatá",14210,32860.67,35039,"Assis",3,"Sudeste",1,"354170",4,8,1,7,6,2,0,0,0,0,0,8,1,7,6,2,3,10.4000317809147,9.56170122109115,0.391488858510931,30
"10656","SP","Quatá",14210,32860.67,35039,"Assis",3,"Sudeste",1,"354170",5,12,1,11,6,6,0,0,0,0,0,12,1,11,6,6,6,10.4000317809147,9.56170122109115,0.389692737029922,31
"10657","SP","Queluz",13606,25423.85,35051,"Guaratinguetá",3,"Sudeste",0,"354190",2,4,0,4,1,3,0,0,0,0,0,4,0,4,1,3,3,10.143442988822,9.51826615090501,0.323605898675588,29
"10658","SP","Queluz",13606,25423.85,35051,"Guaratinguetá",3,"Sudeste",0,"354190",3,11,1,10,6,5,0,0,0,0,0,11,1,10,6,5,8,10.143442988822,9.51826615090501,0.405724019098459,31
"10659","SP","Queluz",13606,25423.85,35051,"Guaratinguetá",3,"Sudeste",0,"354190",4,6,2,4,1,5,0,0,0,0,0,6,2,4,1,5,13,10.143442988822,9.51826615090501,0.466558400926759,30
"10660","SP","Queluz",13606,25423.85,35051,"Guaratinguetá",3,"Sudeste",0,"354190",5,14,4,10,5,9,0,0,0,0,0,14,4,10,5,9,8,10.143442988822,9.51826615090501,0.452462917619087,31
"10661","SP","Quintana",6688,26261.02,35037,"Tupã",3,"Sudeste",0,"354200",2,6,1,5,1,5,0,0,0,0,0,6,1,5,1,5,6,10.1758409894482,8.80807015476454,0.289989687587215,29
"10662","SP","Quintana",6688,26261.02,35037,"Tupã",3,"Sudeste",0,"354200",3,7,3,4,2,5,0,0,0,0,0,7,3,4,2,5,9,10.1758409894482,8.80807015476454,0.363954624879588,31
"10663","SP","Quintana",6688,26261.02,35037,"Tupã",3,"Sudeste",0,"354200",4,6,2,4,0,6,0,0,0,0,0,6,2,4,0,6,4,10.1758409894482,8.80807015476454,0.411971116617044,30
"10664","SP","Quintana",6688,26261.02,35037,"Tupã",3,"Sudeste",0,"354200",5,8,1,7,6,2,0,0,0,0,0,8,1,7,6,2,8,10.1758409894482,8.80807015476454,0.399787531639914,31
"10665","SP","Rafard",9101,35586.08,35028,"Piracicaba",3,"Sudeste",1,"354210",2,2,1,1,0,2,0,0,0,0,0,2,1,1,0,2,3,10.4797098291393,9.11613957657736,0.324512939785896,29
"10666","SP","Rafard",9101,35586.08,35028,"Piracicaba",3,"Sudeste",1,"354210",3,6,0,6,4,2,0,0,0,0,0,6,0,6,4,2,4,10.4797098291393,9.11613957657736,0.413747592471805,31
"10667","SP","Rafard",9101,35586.08,35028,"Piracicaba",3,"Sudeste",1,"354210",4,8,2,6,4,4,0,0,0,0,0,8,2,6,4,4,4,10.4797098291393,9.11613957657736,0.490752828646351,30
"10668","SP","Rafard",9101,35586.08,35028,"Piracicaba",3,"Sudeste",1,"354210",5,5,1,4,5,0,0,0,0,0,0,5,1,4,5,0,2,10.4797098291393,9.11613957657736,0.411291157638477,31
"10669","SP","Rancharia",29726,37222.41,35036,"Presidente Prudente",3,"Sudeste",1,"354220",2,19,4,15,4,15,0,0,0,0,0,19,4,15,4,15,12,10.5246662782344,10.2997773627088,0.286451831810961,29
"10670","SP","Rancharia",29726,37222.41,35036,"Presidente Prudente",3,"Sudeste",1,"354220",3,38,4,34,24,14,0,0,0,0,0,38,4,34,24,14,23,10.5246662782344,10.2997773627088,0.373818376182285,31
"10671","SP","Rancharia",29726,37222.41,35036,"Presidente Prudente",3,"Sudeste",1,"354220",4,33,10,23,14,19,0,0,0,0,0,33,10,23,14,19,20,10.5246662782344,10.2997773627088,0.400622616084834,30
"10672","SP","Rancharia",29726,37222.41,35036,"Presidente Prudente",3,"Sudeste",1,"354220",5,36,2,34,8,28,0,0,0,0,0,36,2,34,8,28,19,10.5246662782344,10.2997773627088,0.391366777643202,31
"10673","SP","Regente Feijó",20394,35313.43,35036,"Presidente Prudente",3,"Sudeste",1,"354240",2,18,7,11,9,9,0,0,0,0,0,18,7,11,9,9,11,10.4720186238252,9.92299601892417,0.290748616804722,29
"10674","SP","Regente Feijó",20394,35313.43,35036,"Presidente Prudente",3,"Sudeste",1,"354240",3,21,4,17,6,15,0,0,0,0,0,21,4,17,6,15,9,10.4720186238252,9.92299601892417,0.378525483295778,31
"10675","SP","Regente Feijó",20394,35313.43,35036,"Presidente Prudente",3,"Sudeste",1,"354240",4,24,1,23,8,16,0,0,0,0,0,24,1,23,8,16,14,10.4720186238252,9.92299601892417,0.421552476315519,30
"10676","SP","Regente Feijó",20394,35313.43,35036,"Presidente Prudente",3,"Sudeste",1,"354240",5,18,6,12,5,13,0,0,0,0,0,18,6,12,5,13,8,10.4720186238252,9.92299601892417,0.39043848889622,31
"10677","SP","Reginópolis",9837,15428.57,35020,"Bauru",3,"Sudeste",0,"354250",2,2,2,0,2,0,0,0,0,0,0,2,2,0,2,0,4,9.64397626445845,9.19390606551276,0.29925332341733,29
"10678","SP","Reginópolis",9837,15428.57,35020,"Bauru",3,"Sudeste",0,"354250",3,1,0,1,1,0,0,0,0,0,0,1,0,1,1,0,7,9.64397626445845,9.19390606551276,0.382597147757347,31
"10679","SP","Reginópolis",9837,15428.57,35020,"Bauru",3,"Sudeste",0,"354250",4,5,1,4,1,4,0,0,0,0,0,5,1,4,1,4,3,9.64397626445845,9.19390606551276,0.385947934692314,30
"10680","SP","Reginópolis",9837,15428.57,35020,"Bauru",3,"Sudeste",0,"354250",5,3,1,2,2,1,0,0,0,0,0,3,1,2,2,1,5,9.64397626445845,9.19390606551276,0.391487338734682,31
"10681","SP","Registro",56393,34962.27,35055,"Registro",3,"Sudeste",1,"354260",2,60,13,47,20,40,1,0,1,0,1,61,13,48,20,41,25,10.4620247590116,10.9401003163083,0.328172360529428,29
"10682","SP","Registro",56393,34962.27,35055,"Registro",3,"Sudeste",1,"354260",3,53,7,46,25,28,1,1,0,0,1,54,8,46,25,29,34,10.4620247590116,10.9401003163083,0.436635113296909,31
"10683","SP","Registro",56393,34962.27,35055,"Registro",3,"Sudeste",1,"354260",4,61,12,49,28,33,0,0,0,0,0,61,12,49,28,33,34,10.4620247590116,10.9401003163083,0.507599578874997,30
"10684","SP","Registro",56393,34962.27,35055,"Registro",3,"Sudeste",1,"354260",5,76,16,60,26,50,1,0,1,1,0,77,16,61,27,50,28,10.4620247590116,10.9401003163083,0.450983687795432,31
"10685","SP","Restinga",7679,22126.48,35012,"Franca",3,"Sudeste",1,"354270",2,9,2,7,6,3,0,0,0,0,0,9,2,7,6,3,3,10.0045303602943,8.94624460933054,0.303558330471293,29
"10686","SP","Restinga",7679,22126.48,35012,"Franca",3,"Sudeste",1,"354270",3,11,2,9,5,6,0,0,0,0,0,11,2,9,5,6,5,10.0045303602943,8.94624460933054,0.393467707352955,31
"10687","SP","Restinga",7679,22126.48,35012,"Franca",3,"Sudeste",1,"354270",4,5,3,2,4,1,0,0,0,0,0,5,3,2,4,1,6,10.0045303602943,8.94624460933054,0.431002911755994,30
"10688","SP","Restinga",7679,22126.48,35012,"Franca",3,"Sudeste",1,"354270",5,6,1,5,3,3,0,0,0,0,0,6,1,5,3,3,1,10.0045303602943,8.94624460933054,0.406059026532667,31
"10689","SP","Ribeirão Bonito",13299,19500.82,35025,"São Carlos",3,"Sudeste",0,"354290",2,9,2,7,4,5,0,0,0,0,0,9,2,7,4,5,9,9.87821179494976,9.49544412341316,0.318047765238028,29
"10690","SP","Ribeirão Bonito",13299,19500.82,35025,"São Carlos",3,"Sudeste",0,"354290",3,14,4,10,5,9,0,0,0,0,0,14,4,10,5,9,8,9.87821179494976,9.49544412341316,0.369718105688298,31
"10691","SP","Ribeirão Bonito",13299,19500.82,35025,"São Carlos",3,"Sudeste",0,"354290",4,14,0,14,4,10,0,0,0,0,0,14,0,14,4,10,9,9.87821179494976,9.49544412341316,0.431667241030188,30
"10692","SP","Ribeirão Bonito",13299,19500.82,35025,"São Carlos",3,"Sudeste",0,"354290",5,10,3,7,5,5,1,0,1,1,0,11,3,8,6,5,5,9.87821179494976,9.49544412341316,0.415112772480027,31
"10693","SP","Ribeirão Branco",16211,17976.03,35044,"Capão Bonito",3,"Sudeste",0,"354300",2,14,2,12,9,5,1,0,1,0,1,15,2,13,9,6,9,9.79679448275563,9.69344530314157,0.351773432615811,29
"10694","SP","Ribeirão Branco",16211,17976.03,35044,"Capão Bonito",3,"Sudeste",0,"354300",3,24,11,13,11,13,0,0,0,0,0,24,11,13,11,13,12,9.79679448275563,9.69344530314157,0.429224459285561,31
"10695","SP","Ribeirão Branco",16211,17976.03,35044,"Capão Bonito",3,"Sudeste",0,"354300",4,26,9,17,13,13,0,0,0,0,0,26,9,17,13,13,8,9.79679448275563,9.69344530314157,0.457354742963455,30
"10696","SP","Ribeirão Branco",16211,17976.03,35044,"Capão Bonito",3,"Sudeste",0,"354300",5,20,6,14,11,9,0,0,0,0,0,20,6,14,11,9,15,9.79679448275563,9.69344530314157,0.474589695342523,31
"10697","SP","Ribeirão Corrente",4752,23548.05,35012,"Franca",3,"Sudeste",1,"354310",2,5,0,5,2,3,0,0,0,0,0,5,0,5,2,3,0,10.0667982934685,8.46632086104248,0.289076290903581,29
"10698","SP","Ribeirão Corrente",4752,23548.05,35012,"Franca",3,"Sudeste",1,"354310",3,5,1,4,4,1,0,0,0,0,0,5,1,4,4,1,2,10.0667982934685,8.46632086104248,0.348078780953308,31
"10699","SP","Ribeirão Corrente",4752,23548.05,35012,"Franca",3,"Sudeste",1,"354310",4,3,1,2,1,2,0,0,0,0,0,3,1,2,1,2,1,10.0667982934685,8.46632086104248,0.388135565584205,30
"10700","SP","Ribeirão Corrente",4752,23548.05,35012,"Franca",3,"Sudeste",1,"354310",5,1,0,1,1,0,0,0,0,0,0,1,0,1,1,0,2,10.0667982934685,8.46632086104248,0.37677088559964,31
"10701","SP","Ribeirão Pires",124159,24818.57,35061,"São Paulo",3,"Sudeste",1,"354330",2,83,4,79,24,59,0,0,0,0,0,83,4,79,24,59,60,10.119347442272,11.7293182812609,0.307108123835298,29
"10702","SP","Ribeirão Pires",124159,24818.57,35061,"São Paulo",3,"Sudeste",1,"354330",3,100,8,92,34,66,3,1,2,0,3,103,9,94,34,69,73,10.119347442272,11.7293182812609,0.414735783828847,31
"10703","SP","Ribeirão Pires",124159,24818.57,35061,"São Paulo",3,"Sudeste",1,"354330",4,81,7,74,27,54,2,0,2,0,2,83,7,76,27,56,64,10.119347442272,11.7293182812609,0.498396084934343,30
"10704","SP","Ribeirão Pires",124159,24818.57,35061,"São Paulo",3,"Sudeste",1,"354330",5,105,12,93,33,72,2,1,1,1,1,107,13,94,34,73,88,10.119347442272,11.7293182812609,0.459770123442718,31
"10705","SP","Ribeirão Preto",711825,49425.29,35014,"Ribeirão Preto",3,"Sudeste",1,"354340",2,585,107,478,174,411,4,0,4,0,4,589,107,482,174,415,373,10.8082175154976,13.4755873736668,0.277984641559494,29
"10706","SP","Ribeirão Preto",711825,49425.29,35014,"Ribeirão Preto",3,"Sudeste",1,"354340",3,611,107,504,171,440,5,0,5,2,3,616,107,509,173,443,418,10.8082175154976,13.4755873736668,0.389957878732647,31
"10707","SP","Ribeirão Preto",711825,49425.29,35014,"Ribeirão Preto",3,"Sudeste",1,"354340",4,646,127,519,205,441,9,3,6,5,4,655,130,525,210,445,331,10.8082175154976,13.4755873736668,0.47459945185271,30
"10708","SP","Ribeirão Preto",711825,49425.29,35014,"Ribeirão Preto",3,"Sudeste",1,"354340",5,624,111,513,181,443,6,2,4,1,5,630,113,517,182,448,404,10.8082175154976,13.4755873736668,0.427583838020795,31
"10709","SP","Rincão",10812,18176.48,35024,"Araraquara",3,"Sudeste",1,"354370",2,10,3,7,1,9,0,0,0,0,0,10,3,7,1,9,7,9.80788372962289,9.28841190739634,0.302790631589536,29
"10710","SP","Rincão",10812,18176.48,35024,"Araraquara",3,"Sudeste",1,"354370",3,6,1,5,2,4,2,1,1,1,1,8,2,6,3,5,7,9.80788372962289,9.28841190739634,0.397611749331151,31
"10711","SP","Rincão",10812,18176.48,35024,"Araraquara",3,"Sudeste",1,"354370",4,8,0,8,3,5,0,0,0,0,0,8,0,8,3,5,5,9.80788372962289,9.28841190739634,0.417514954583775,30
"10712","SP","Rincão",10812,18176.48,35024,"Araraquara",3,"Sudeste",1,"354370",5,18,5,13,8,10,0,0,0,0,0,18,5,13,8,10,3,9.80788372962289,9.28841190739634,0.418057437974703,31
"10713","SP","Rinópolis",9961,25464.98,35035,"Adamantina",3,"Sudeste",0,"354380",2,5,0,5,2,3,0,0,0,0,0,5,0,5,2,3,5,10.1450594539267,9.20643274714516,0.284281660288139,29
"10714","SP","Rinópolis",9961,25464.98,35035,"Adamantina",3,"Sudeste",0,"354380",3,9,2,7,5,4,0,0,0,0,0,9,2,7,5,4,5,10.1450594539267,9.20643274714516,0.351498448736569,31
"10715","SP","Rinópolis",9961,25464.98,35035,"Adamantina",3,"Sudeste",0,"354380",4,9,3,6,3,6,0,0,0,0,0,9,3,6,3,6,5,10.1450594539267,9.20643274714516,0.393479742411318,30
"10716","SP","Rinópolis",9961,25464.98,35035,"Adamantina",3,"Sudeste",0,"354380",5,4,2,2,1,3,1,0,1,1,0,5,2,3,2,3,4,10.1450594539267,9.20643274714516,0.37046140150715,31
"10717","SP","Rio Claro",208008,47851.56,35026,"Rio Claro",3,"Sudeste",1,"354390",2,165,28,137,65,100,1,0,1,0,1,166,28,138,65,101,118,10.7758589982305,12.2453318194823,0.306000177792239,29
"10718","SP","Rio Claro",208008,47851.56,35026,"Rio Claro",3,"Sudeste",1,"354390",3,177,33,144,46,131,1,0,1,0,1,178,33,145,46,132,121,10.7758589982305,12.2453318194823,0.395264351548117,31
"10719","SP","Rio Claro",208008,47851.56,35026,"Rio Claro",3,"Sudeste",1,"354390",4,195,33,162,64,131,0,0,0,0,0,195,33,162,64,131,115,10.7758589982305,12.2453318194823,0.462257671340325,30
"10720","SP","Rio Claro",208008,47851.56,35026,"Rio Claro",3,"Sudeste",1,"354390",5,189,31,158,62,127,1,0,1,0,1,190,31,159,62,128,133,10.7758589982305,12.2453318194823,0.42355196970331,31
"10721","SP","Rio das Pedras",35738,40086.87,35028,"Piracicaba",3,"Sudeste",1,"354400",2,17,2,15,6,11,2,1,1,1,1,19,3,16,7,12,15,10.5988041282558,10.4839698274386,0.293853064251569,29
"10722","SP","Rio das Pedras",35738,40086.87,35028,"Piracicaba",3,"Sudeste",1,"354400",3,21,1,20,9,12,0,0,0,0,0,21,1,20,9,12,20,10.5988041282558,10.4839698274386,0.37289748537427,31
"10723","SP","Rio das Pedras",35738,40086.87,35028,"Piracicaba",3,"Sudeste",1,"354400",4,34,7,27,5,29,1,1,0,0,1,35,8,27,5,30,11,10.5988041282558,10.4839698274386,0.412411625844053,30
"10724","SP","Rio das Pedras",35738,40086.87,35028,"Piracicaba",3,"Sudeste",1,"354400",5,25,4,21,7,18,0,0,0,0,0,25,4,21,7,18,12,10.5988041282558,10.4839698274386,0.376388865074962,31
"10725","SP","Rio Grande da Serra",51436,11282.4,35061,"São Paulo",3,"Sudeste",1,"354410",2,28,1,27,8,20,2,1,1,1,1,30,2,28,9,21,10,9.33099926837803,10.8480935953903,0.307781671154167,29
"10726","SP","Rio Grande da Serra",51436,11282.4,35061,"São Paulo",3,"Sudeste",1,"354410",3,38,5,33,13,25,0,0,0,0,0,38,5,33,13,25,23,9.33099926837803,10.8480935953903,0.40643148922055,31
"10727","SP","Rio Grande da Serra",51436,11282.4,35061,"São Paulo",3,"Sudeste",1,"354410",4,46,6,40,17,29,1,0,1,1,0,47,6,41,18,29,22,9.33099926837803,10.8480935953903,0.475880384150741,30
"10728","SP","Rio Grande da Serra",51436,11282.4,35061,"São Paulo",3,"Sudeste",1,"354410",5,47,4,43,19,28,0,0,0,0,0,47,4,43,19,28,22,9.33099926837803,10.8480935953903,0.439418252289453,31
"10729","SP","Riolândia",12689,20423.64,35003,"Votuporanga",3,"Sudeste",0,"354420",2,16,1,15,7,9,0,0,0,0,0,16,1,15,7,9,6,9.924448332444,9.44849075539691,0.315806448428988,29
"10730","SP","Riolândia",12689,20423.64,35003,"Votuporanga",3,"Sudeste",0,"354420",3,6,2,4,4,2,0,0,0,0,0,6,2,4,4,2,7,9.924448332444,9.44849075539691,0.382948386834648,31
"10731","SP","Riolândia",12689,20423.64,35003,"Votuporanga",3,"Sudeste",0,"354420",4,10,1,9,3,7,0,0,0,0,0,10,1,9,3,7,10,9.924448332444,9.44849075539691,0.389632871681823,30
"10732","SP","Riolândia",12689,20423.64,35003,"Votuporanga",3,"Sudeste",0,"354420",5,12,2,10,8,4,0,0,0,0,0,12,2,10,8,4,6,9.924448332444,9.44849075539691,0.369693487506741,31
"10733","SP","Rosana",16281,70267.57,35036,"Presidente Prudente",3,"Sudeste",1,"354425",2,13,2,11,6,7,0,0,0,0,0,13,2,11,6,7,14,11.1600656626861,9.69775406273151,0.30932392035736,29
"10734","SP","Rosana",16281,70267.57,35036,"Presidente Prudente",3,"Sudeste",1,"354425",3,19,1,18,10,9,0,0,0,0,0,19,1,18,10,9,13,11.1600656626861,9.69775406273151,0.424972554678041,31
"10735","SP","Rosana",16281,70267.57,35036,"Presidente Prudente",3,"Sudeste",1,"354425",4,14,0,14,7,7,1,0,1,0,1,15,0,15,7,8,8,11.1600656626861,9.69775406273151,0.504800080278248,30
"10736","SP","Rosana",16281,70267.57,35036,"Presidente Prudente",3,"Sudeste",1,"354425",5,17,4,13,6,11,0,0,0,0,0,17,4,13,6,11,11,11.1600656626861,9.69775406273151,0.470716071007045,31
"10737","SP","Roseira",10801,27647.35,35051,"Guaratinguetá",3,"Sudeste",1,"354430",2,9,4,5,2,7,0,0,0,0,0,9,4,5,2,7,6,10.2272851614895,9.28739400141847,0.322638769440512,29
"10738","SP","Roseira",10801,27647.35,35051,"Guaratinguetá",3,"Sudeste",1,"354430",3,9,1,8,5,4,0,0,0,0,0,9,1,8,5,4,6,10.2272851614895,9.28739400141847,0.412630297947324,31
"10739","SP","Roseira",10801,27647.35,35051,"Guaratinguetá",3,"Sudeste",1,"354430",4,6,0,6,2,4,0,0,0,0,0,6,0,6,2,4,7,10.2272851614895,9.28739400141847,0.483123888113188,30
"10740","SP","Roseira",10801,27647.35,35051,"Guaratinguetá",3,"Sudeste",1,"354430",5,8,1,7,2,6,0,0,0,0,0,8,1,7,2,6,9,10.2272851614895,9.28739400141847,0.44619870796901,31
"10741","SP","Rubinéia",3170,24965.32,35001,"Jales",3,"Sudeste",1,"354450",2,3,0,3,2,1,0,0,0,0,0,3,0,3,2,1,1,10.1252429407977,8.06148686687133,0.334569493678739,29
"10742","SP","Rubinéia",3170,24965.32,35001,"Jales",3,"Sudeste",1,"354450",3,2,0,2,0,2,0,0,0,0,0,2,0,2,0,2,3,10.1252429407977,8.06148686687133,0.426079668622454,31
"10743","SP","Rubinéia",3170,24965.32,35001,"Jales",3,"Sudeste",1,"354450",4,1,0,1,0,1,0,0,0,0,0,1,0,1,0,1,6,10.1252429407977,8.06148686687133,0.428347995982669,30
"10744","SP","Rubinéia",3170,24965.32,35001,"Jales",3,"Sudeste",1,"354450",5,3,2,1,1,2,0,0,0,0,0,3,2,1,1,2,2,10.1252429407977,8.06148686687133,0.4172344957474,31
"10745","SP","Sabino",5614,21248.16,35019,"Lins",3,"Sudeste",0,"354460",2,1,0,1,1,0,0,0,0,0,0,1,0,1,1,0,6,9.96402558236829,8.63301875692183,0.312834504448474,29
"10746","SP","Sabino",5614,21248.16,35019,"Lins",3,"Sudeste",0,"354460",3,5,0,5,1,4,0,0,0,0,0,5,0,5,1,4,8,9.96402558236829,8.63301875692183,0.39872547869101,31
"10747","SP","Sabino",5614,21248.16,35019,"Lins",3,"Sudeste",0,"354460",4,3,0,3,1,2,0,0,0,0,0,3,0,3,1,2,9,9.96402558236829,8.63301875692183,0.476117295134815,30
"10748","SP","Sabino",5614,21248.16,35019,"Lins",3,"Sudeste",0,"354460",5,7,3,4,1,6,0,0,0,0,0,7,3,4,1,6,5,9.96402558236829,8.63301875692183,0.407568596770016,31
"10749","SP","Sales",6407,22858.39,35008,"Novo Horizonte",3,"Sudeste",0,"354480",2,5,1,4,2,3,0,0,0,0,0,5,1,4,2,3,9,10.0370735061722,8.76514642163902,0.288797563108645,29
"10750","SP","Sales",6407,22858.39,35008,"Novo Horizonte",3,"Sudeste",0,"354480",3,1,0,1,1,0,0,0,0,0,0,1,0,1,1,0,5,10.0370735061722,8.76514642163902,0.342038719811891,31
"10751","SP","Sales",6407,22858.39,35008,"Novo Horizonte",3,"Sudeste",0,"354480",4,6,0,6,2,4,0,0,0,0,0,6,0,6,2,4,3,10.0370735061722,8.76514642163902,0.379575376469172,30
"10752","SP","Sales",6407,22858.39,35008,"Novo Horizonte",3,"Sudeste",0,"354480",5,6,1,5,2,4,1,1,0,1,0,7,2,5,3,4,2,10.0370735061722,8.76514642163902,0.387786615356061,31
"10753","SP","Sales Oliveira",11998,29378.39,35010,"São Joaquim da Barra",3,"Sudeste",0,"354490",2,9,1,8,3,6,0,0,0,0,0,9,1,8,3,6,4,10.2880146490432,9.39249524821304,0.290231804922929,29
"10754","SP","Sales Oliveira",11998,29378.39,35010,"São Joaquim da Barra",3,"Sudeste",0,"354490",3,9,1,8,1,8,0,0,0,0,0,9,1,8,1,8,7,10.2880146490432,9.39249524821304,0.387598582781186,31
"10755","SP","Sales Oliveira",11998,29378.39,35010,"São Joaquim da Barra",3,"Sudeste",0,"354490",4,7,1,6,3,4,0,0,0,0,0,7,1,6,3,4,4,10.2880146490432,9.39249524821304,0.417365327817153,30
"10756","SP","Sales Oliveira",11998,29378.39,35010,"São Joaquim da Barra",3,"Sudeste",0,"354490",5,6,1,5,2,4,0,0,0,0,0,6,1,5,2,4,9,10.2880146490432,9.39249524821304,0.411626741947838,31
"10757","SP","Salesópolis",17252,11899.42,35062,"Mogi das Cruzes",3,"Sudeste",1,"354500",2,20,4,16,8,12,0,0,0,0,0,20,4,16,8,12,9,9.38424493841601,9.75568335776773,0.285252495502768,29
"10758","SP","Salesópolis",17252,11899.42,35062,"Mogi das Cruzes",3,"Sudeste",1,"354500",3,16,7,9,3,13,0,0,0,0,0,16,7,9,3,13,12,9.38424493841601,9.75568335776773,0.384814197600807,31
"10759","SP","Salesópolis",17252,11899.42,35062,"Mogi das Cruzes",3,"Sudeste",1,"354500",4,19,5,14,7,12,0,0,0,0,0,19,5,14,7,12,8,9.38424493841601,9.75568335776773,0.446472927649478,30
"10760","SP","Salesópolis",17252,11899.42,35062,"Mogi das Cruzes",3,"Sudeste",1,"354500",5,20,4,16,7,13,0,0,0,0,0,20,4,16,7,13,12,9.38424493841601,9.75568335776773,0.416153275162744,31
"10761","SP","Salmourão",5337,13614.17,35035,"Adamantina",3,"Sudeste",0,"354510",2,5,1,4,1,4,0,0,0,0,0,5,1,4,1,4,5,9.51886644107552,8.58241897633394,0.33827100990079,29
"10762","SP","Salmourão",5337,13614.17,35035,"Adamantina",3,"Sudeste",0,"354510",3,2,1,1,1,1,0,0,0,0,0,2,1,1,1,1,4,9.51886644107552,8.58241897633394,0.410576957035569,31
"10763","SP","Salmourão",5337,13614.17,35035,"Adamantina",3,"Sudeste",0,"354510",4,7,2,5,2,5,0,0,0,0,0,7,2,5,2,5,1,9.51886644107552,8.58241897633394,0.431583703213956,30
"10764","SP","Salmourão",5337,13614.17,35035,"Adamantina",3,"Sudeste",0,"354510",5,3,1,2,1,2,0,0,0,0,0,3,1,2,1,2,2,9.51886644107552,8.58241897633394,0.410439109246334,31
"10765","SP","Saltinho",8393,30002.45,35028,"Piracicaba",3,"Sudeste",1,"354515",2,15,4,11,4,11,0,0,0,0,0,15,4,11,4,11,4,10.3090343239764,9.03515330408283,0.275041923250633,29
"10766","SP","Saltinho",8393,30002.45,35028,"Piracicaba",3,"Sudeste",1,"354515",3,0,0,0,0,0,0,0,0,0,0,0,0,0,0,0,3,10.3090343239764,9.03515330408283,0.353169142212249,31
"10767","SP","Saltinho",8393,30002.45,35028,"Piracicaba",3,"Sudeste",1,"354515",4,7,0,7,2,5,0,0,0,0,0,7,0,7,2,5,2,10.3090343239764,9.03515330408283,0.395317466649013,30
"10768","SP","Saltinho",8393,30002.45,35028,"Piracicaba",3,"Sudeste",1,"354515",5,4,1,3,0,4,0,0,0,0,0,4,1,3,0,4,7,10.3090343239764,9.03515330408283,0.368638961356283,31
"10769","SP","Salto",119736,62187.92,35046,"Sorocaba",3,"Sudeste",1,"354520",2,136,13,123,37,99,0,0,0,0,0,136,13,123,37,99,66,11.037916047647,11.693044598209,0.292864576694352,29
"10770","SP","Salto",119736,62187.92,35046,"Sorocaba",3,"Sudeste",1,"354520",3,144,23,121,47,97,0,0,0,0,0,144,23,121,47,97,69,11.037916047647,11.693044598209,0.391963641726838,31
"10771","SP","Salto",119736,62187.92,35046,"Sorocaba",3,"Sudeste",1,"354520",4,132,14,118,34,98,0,0,0,0,0,132,14,118,34,98,61,11.037916047647,11.693044598209,0.468302540168882,30
"10772","SP","Salto",119736,62187.92,35046,"Sorocaba",3,"Sudeste",1,"354520",5,138,13,125,50,88,0,0,0,0,0,138,13,125,50,88,71,11.037916047647,11.693044598209,0.427644784344118,31
"10773","SP","Salto de Pirapora",45860,37530.47,35046,"Sorocaba",3,"Sudeste",1,"354530",2,37,0,37,13,24,0,0,0,0,0,37,0,37,13,24,13,10.5329084153653,10.7333485564119,0.307758533547623,29
"10774","SP","Salto de Pirapora",45860,37530.47,35046,"Sorocaba",3,"Sudeste",1,"354530",3,43,8,35,7,36,0,0,0,0,0,43,8,35,7,36,25,10.5329084153653,10.7333485564119,0.406981877619114,31
"10775","SP","Salto de Pirapora",45860,37530.47,35046,"Sorocaba",3,"Sudeste",1,"354530",4,46,4,42,20,26,0,0,0,0,0,46,4,42,20,26,22,10.5329084153653,10.7333485564119,0.450133934879482,30
"10776","SP","Salto de Pirapora",45860,37530.47,35046,"Sorocaba",3,"Sudeste",1,"354530",5,31,5,26,14,17,0,0,0,0,0,31,5,26,14,17,25,10.5329084153653,10.7333485564119,0.419717587280823,31
"10777","SP","Salto Grande",9364,23885.16,35040,"Ourinhos",3,"Sudeste",0,"354540",2,7,4,3,3,4,0,0,0,0,0,7,4,3,3,4,4,10.0810126245665,9.1446278286108,0.289040137418011,29
"10778","SP","Salto Grande",9364,23885.16,35040,"Ourinhos",3,"Sudeste",0,"354540",3,6,2,4,4,2,0,0,0,0,0,6,2,4,4,2,6,10.0810126245665,9.1446278286108,0.407614981830868,31
"10779","SP","Salto Grande",9364,23885.16,35040,"Ourinhos",3,"Sudeste",0,"354540",4,11,3,8,4,7,0,0,0,0,0,11,3,8,4,7,5,10.0810126245665,9.1446278286108,0.459326073504372,30
"10780","SP","Salto Grande",9364,23885.16,35040,"Ourinhos",3,"Sudeste",0,"354540",5,12,2,10,3,9,0,0,0,0,0,12,2,10,3,9,11,10.0810126245665,9.1446278286108,0.463372551880599,31
"10781","SP","Santa Adélia",15561,19941.08,35005,"Catanduva",3,"Sudeste",1,"354560",2,5,1,4,1,4,0,0,0,0,0,5,1,4,1,4,5,9.90053720453656,9.65252306301951,0.28618033980785,29
"10782","SP","Santa Adélia",15561,19941.08,35005,"Catanduva",3,"Sudeste",1,"354560",3,14,3,11,2,12,0,0,0,0,0,14,3,11,2,12,11,9.90053720453656,9.65252306301951,0.370951692756861,31
"10783","SP","Santa Adélia",15561,19941.08,35005,"Catanduva",3,"Sudeste",1,"354560",4,10,0,10,4,6,0,0,0,0,0,10,0,10,4,6,9,9.90053720453656,9.65252306301951,0.389240398241702,30
"10784","SP","Santa Adélia",15561,19941.08,35005,"Catanduva",3,"Sudeste",1,"354560",5,12,1,11,3,9,0,0,0,0,0,12,1,11,3,9,13,9.90053720453656,9.65252306301951,0.363090356206942,31
"10785","SP","Santa Albertina",6022,30542.24,35001,"Jales",3,"Sudeste",0,"354570",2,6,1,5,2,4,0,0,0,0,0,6,1,5,2,4,7,10.3268659225138,8.70317470904168,0.299366211175448,29
"10786","SP","Santa Albertina",6022,30542.24,35001,"Jales",3,"Sudeste",0,"354570",3,2,0,2,2,0,0,0,0,0,0,2,0,2,2,0,5,10.3268659225138,8.70317470904168,0.354052394138777,31
"10787","SP","Santa Albertina",6022,30542.24,35001,"Jales",3,"Sudeste",0,"354570",4,5,0,5,1,4,0,0,0,0,0,5,0,5,1,4,2,10.3268659225138,8.70317470904168,0.375381184815772,30
"10788","SP","Santa Albertina",6022,30542.24,35001,"Jales",3,"Sudeste",0,"354570",5,6,2,4,5,1,0,0,0,0,0,6,2,4,5,1,7,10.3268659225138,8.70317470904168,0.370080298120087,31
"10789","SP","Santa Bárbara d'Oeste",194390,30798.27,35032,"Campinas",3,"Sudeste",1,"354580",2,152,18,134,38,114,1,0,1,0,1,153,18,135,38,115,91,10.335213798553,12.1776217293562,0.289033660985735,29
"10790","SP","Santa Bárbara d'Oeste",194390,30798.27,35032,"Campinas",3,"Sudeste",1,"354580",3,166,15,151,49,117,2,0,2,0,2,168,15,153,49,119,116,10.335213798553,12.1776217293562,0.381954595619227,31
"10791","SP","Santa Bárbara d'Oeste",194390,30798.27,35032,"Campinas",3,"Sudeste",1,"354580",4,149,16,133,46,103,0,0,0,0,0,149,16,133,46,103,90,10.335213798553,12.1776217293562,0.441165256362159,30
"10792","SP","Santa Bárbara d'Oeste",194390,30798.27,35032,"Campinas",3,"Sudeste",1,"354580",5,190,13,177,59,131,2,0,2,2,0,192,13,179,61,131,96,10.335213798553,12.1776217293562,0.396518010752797,31
"10793","SP","Santa Branca",14857,16610.52,35050,"São José dos Campos",3,"Sudeste",1,"354600",2,10,1,9,4,6,0,0,0,0,0,10,1,9,4,6,11,9.71779150855921,9.60622641363735,0.285531877050594,29
"10794","SP","Santa Branca",14857,16610.52,35050,"São José dos Campos",3,"Sudeste",1,"354600",3,6,1,5,2,4,0,0,0,0,0,6,1,5,2,4,12,9.71779150855921,9.60622641363735,0.378215120150025,31
"10795","SP","Santa Branca",14857,16610.52,35050,"São José dos Campos",3,"Sudeste",1,"354600",4,11,4,7,6,5,0,0,0,0,0,11,4,7,6,5,10,9.71779150855921,9.60622641363735,0.441020427295794,30
"10796","SP","Santa Branca",14857,16610.52,35050,"São José dos Campos",3,"Sudeste",1,"354600",5,16,4,12,5,11,0,0,0,0,0,16,4,12,5,11,6,9.71779150855921,9.60622641363735,0.405276568683907,31
"10797","SP","Santa Cruz das Palmeiras",34737,14724.73,35029,"Pirassununga",3,"Sudeste",1,"354630",2,21,5,16,7,14,0,0,0,0,0,21,5,16,7,14,20,9.59728367218869,10.4555606802804,0.31941883571889,29
"10798","SP","Santa Cruz das Palmeiras",34737,14724.73,35029,"Pirassununga",3,"Sudeste",1,"354630",3,32,15,17,11,21,0,0,0,0,0,32,15,17,11,21,30,9.59728367218869,10.4555606802804,0.3970989332649,31
"10799","SP","Santa Cruz das Palmeiras",34737,14724.73,35029,"Pirassununga",3,"Sudeste",1,"354630",4,19,6,13,10,9,1,1,0,1,0,20,7,13,11,9,22,9.59728367218869,10.4555606802804,0.43476793540591,30
"10800","SP","Santa Cruz das Palmeiras",34737,14724.73,35029,"Pirassununga",3,"Sudeste",1,"354630",5,31,7,24,9,22,0,0,0,0,0,31,7,24,9,22,16,9.59728367218869,10.4555606802804,0.391492989813876,31
"10801","SP","Santa Cruz do Rio Pardo",47943,42906.75,35040,"Ourinhos",3,"Sudeste",1,"354640",2,48,9,39,16,32,1,0,1,0,1,49,9,40,16,33,19,10.6667844351964,10.7777680842532,0.290716725645375,29
"10802","SP","Santa Cruz do Rio Pardo",47943,42906.75,35040,"Ourinhos",3,"Sudeste",1,"354640",3,44,12,32,18,26,0,0,0,0,0,44,12,32,18,26,22,10.6667844351964,10.7777680842532,0.374720987194468,31
"10803","SP","Santa Cruz do Rio Pardo",47943,42906.75,35040,"Ourinhos",3,"Sudeste",1,"354640",4,26,4,22,6,20,0,0,0,0,0,26,4,22,6,20,25,10.6667844351964,10.7777680842532,0.423216775258454,30
"10804","SP","Santa Cruz do Rio Pardo",47943,42906.75,35040,"Ourinhos",3,"Sudeste",1,"354640",5,32,5,27,11,21,0,0,0,0,0,32,5,27,11,21,28,10.6667844351964,10.7777680842532,0.388185039840521,31
"10805","SP","Santa Ernestina",5588,16537.75,35013,"Jaboticabal",3,"Sudeste",0,"354650",2,6,0,6,2,4,0,0,0,0,0,6,0,6,2,4,4,9.71340092546692,8.62837672037685,0.32407262414042,29
"10806","SP","Santa Ernestina",5588,16537.75,35013,"Jaboticabal",3,"Sudeste",0,"354650",3,9,2,7,3,6,0,0,0,0,0,9,2,7,3,6,3,9.71340092546692,8.62837672037685,0.393659469928254,31
"10807","SP","Santa Ernestina",5588,16537.75,35013,"Jaboticabal",3,"Sudeste",0,"354650",4,3,2,1,2,1,0,0,0,0,0,3,2,1,2,1,3,9.71340092546692,8.62837672037685,0.40976506050534,30
"10808","SP","Santa Ernestina",5588,16537.75,35013,"Jaboticabal",3,"Sudeste",0,"354650",5,8,0,8,2,6,0,0,0,0,0,8,0,8,2,6,3,9.71340092546692,8.62837672037685,0.365627857771911,31
"10809","SP","Santa Fé do Sul",32563,33819.05,35001,"Jales",3,"Sudeste",1,"354660",2,24,2,22,10,14,0,0,0,0,0,24,2,22,10,14,21,10.4287795321704,10.3909319534642,0.304576788385391,29
"10810","SP","Santa Fé do Sul",32563,33819.05,35001,"Jales",3,"Sudeste",1,"354660",3,25,2,23,10,15,1,0,1,1,0,26,2,24,11,15,26,10.4287795321704,10.3909319534642,0.387757714448227,31
"10811","SP","Santa Fé do Sul",32563,33819.05,35001,"Jales",3,"Sudeste",1,"354660",4,27,4,23,13,14,2,1,1,1,1,29,5,24,14,15,21,10.4287795321704,10.3909319534642,0.424652088143039,30
"10812","SP","Santa Fé do Sul",32563,33819.05,35001,"Jales",3,"Sudeste",1,"354660",5,49,5,44,13,36,0,0,0,0,0,49,5,44,13,36,31,10.4287795321704,10.3909319534642,0.401712361355709,31
"10813","SP","Santa Gertrudes",27381,67000.11,35027,"Limeira",3,"Sudeste",1,"354670",2,19,3,16,5,14,1,0,1,0,1,20,3,17,5,15,6,11.1124495401628,10.217604621185,0.336235715331406,29
"10814","SP","Santa Gertrudes",27381,67000.11,35027,"Limeira",3,"Sudeste",1,"354670",3,32,9,23,12,20,0,0,0,0,0,32,9,23,12,20,13,11.1124495401628,10.217604621185,0.41474048396576,31
"10815","SP","Santa Gertrudes",27381,67000.11,35027,"Limeira",3,"Sudeste",1,"354670",4,29,5,24,10,19,0,0,0,0,0,29,5,24,10,19,9,11.1124495401628,10.217604621185,0.484233845648055,30
"10816","SP","Santa Gertrudes",27381,67000.11,35027,"Limeira",3,"Sudeste",1,"354670",5,26,2,24,10,16,0,0,0,0,0,26,2,24,10,16,15,11.1124495401628,10.217604621185,0.433135846003597,31
"10817","SP","Santa Isabel",57966,27752.63,35059,"Guarulhos",3,"Sudeste",1,"354680",2,42,2,40,19,23,0,0,0,0,0,42,2,40,19,23,29,10.2310858894585,10.9676119107456,0.310833431002786,29
"10818","SP","Santa Isabel",57966,27752.63,35059,"Guarulhos",3,"Sudeste",1,"354680",3,60,4,56,26,34,3,0,3,1,2,63,4,59,27,36,30,10.2310858894585,10.9676119107456,0.402589647772258,31
"10819","SP","Santa Isabel",57966,27752.63,35059,"Guarulhos",3,"Sudeste",1,"354680",4,44,4,40,18,26,0,0,0,0,0,44,4,40,18,26,27,10.2310858894585,10.9676119107456,0.46488850526129,30
"10820","SP","Santa Isabel",57966,27752.63,35059,"Guarulhos",3,"Sudeste",1,"354680",5,54,12,42,20,34,1,1,0,0,1,55,13,42,20,35,50,10.2310858894585,10.9676119107456,0.448755387570023,31
"10821","SP","Santa Lúcia",8854,13080.61,35024,"Araraquara",3,"Sudeste",1,"354690",2,10,0,10,3,7,0,0,0,0,0,10,0,10,3,7,3,9.47888626000939,9.08862461329209,0.347400871316177,29
"10822","SP","Santa Lúcia",8854,13080.61,35024,"Araraquara",3,"Sudeste",1,"354690",3,9,1,8,6,3,0,0,0,0,0,9,1,8,6,3,3,9.47888626000939,9.08862461329209,0.415475212040314,31
"10823","SP","Santa Lúcia",8854,13080.61,35024,"Araraquara",3,"Sudeste",1,"354690",4,6,3,3,4,2,0,0,0,0,0,6,3,3,4,2,6,9.47888626000939,9.08862461329209,0.472385851411137,30
"10824","SP","Santa Lúcia",8854,13080.61,35024,"Araraquara",3,"Sudeste",1,"354690",5,2,0,2,0,2,0,0,0,0,0,2,0,2,0,2,4,9.47888626000939,9.08862461329209,0.419943922262979,31
"10825","SP","Santa Maria da Serra",6236,21876.38,35028,"Piracicaba",3,"Sudeste",0,"354700",2,4,2,2,1,3,0,0,0,0,0,4,2,2,1,3,4,9.99316279495028,8.73809423017767,0.325032263255083,29
"10826","SP","Santa Maria da Serra",6236,21876.38,35028,"Piracicaba",3,"Sudeste",0,"354700",3,6,1,5,2,4,1,0,1,0,1,7,1,6,2,5,4,9.99316279495028,8.73809423017767,0.374658390413594,31
"10827","SP","Santa Maria da Serra",6236,21876.38,35028,"Piracicaba",3,"Sudeste",0,"354700",4,9,5,4,6,3,0,0,0,0,0,9,5,4,6,3,1,9.99316279495028,8.73809423017767,0.419459286808705,30
"10828","SP","Santa Maria da Serra",6236,21876.38,35028,"Piracicaba",3,"Sudeste",0,"354700",5,7,0,7,5,2,0,0,0,0,0,7,0,7,5,2,2,9.99316279495028,8.73809423017767,0.428318071372856,31
"10829","SP","Santana de Parnaíba",142301,67650.64,35057,"Osasco",3,"Sudeste",1,"354730",2,173,20,153,49,124,2,0,2,0,2,175,20,155,49,126,46,11.1221120940124,11.8656998114601,0.27900434149921,29
"10830","SP","Santana de Parnaíba",142301,67650.64,35057,"Osasco",3,"Sudeste",1,"354730",3,155,26,129,40,115,1,0,1,0,1,156,26,130,40,116,57,11.1221120940124,11.8656998114601,0.392444601519311,31
"10831","SP","Santana de Parnaíba",142301,67650.64,35057,"Osasco",3,"Sudeste",1,"354730",4,173,18,155,54,119,0,0,0,0,0,173,18,155,54,119,57,11.1221120940124,11.8656998114601,0.482395590261336,30
"10832","SP","Santana de Parnaíba",142301,67650.64,35057,"Osasco",3,"Sudeste",1,"354730",5,223,24,199,67,156,0,0,0,0,0,223,24,199,67,156,57,11.1221120940124,11.8656998114601,0.457670775767245,31
"10833","SP","Santa Rita do Passa Quatro",27600,24132.89,35014,"Ribeirão Preto",3,"Sudeste",1,"354750",2,20,3,17,7,13,0,0,0,0,0,20,3,17,7,13,21,10.0913309193712,10.2255710517052,0.302614061853539,29
"10834","SP","Santa Rita do Passa Quatro",27600,24132.89,35014,"Ribeirão Preto",3,"Sudeste",1,"354750",3,16,3,13,6,10,0,0,0,0,0,16,3,13,6,10,29,10.0913309193712,10.2255710517052,0.388128806122764,31
"10835","SP","Santa Rita do Passa Quatro",27600,24132.89,35014,"Ribeirão Preto",3,"Sudeste",1,"354750",4,14,6,8,7,7,0,0,0,0,0,14,6,8,7,7,26,10.0913309193712,10.2255710517052,0.43875685739811,30
"10836","SP","Santa Rita do Passa Quatro",27600,24132.89,35014,"Ribeirão Preto",3,"Sudeste",1,"354750",5,20,2,18,11,9,0,0,0,0,0,20,2,18,11,9,22,10.0913309193712,10.2255710517052,0.41281189362135,31
"10837","SP","Santa Rosa de Viterbo",26753,26438.67,35014,"Ribeirão Preto",3,"Sudeste",1,"354760",2,14,4,10,8,6,0,0,0,0,0,14,4,10,8,6,12,10.1825829901285,10.1944018955686,0.311256813464205,29
"10838","SP","Santa Rosa de Viterbo",26753,26438.67,35014,"Ribeirão Preto",3,"Sudeste",1,"354760",3,22,2,20,6,16,1,0,1,0,1,23,2,21,6,17,16,10.1825829901285,10.1944018955686,0.397191458706013,31
"10839","SP","Santa Rosa de Viterbo",26753,26438.67,35014,"Ribeirão Preto",3,"Sudeste",1,"354760",4,18,5,13,6,12,0,0,0,0,0,18,5,13,6,12,17,10.1825829901285,10.1944018955686,0.436368796238874,30
"10840","SP","Santa Rosa de Viterbo",26753,26438.67,35014,"Ribeirão Preto",3,"Sudeste",1,"354760",5,19,4,15,9,10,0,0,0,0,0,19,4,15,9,10,21,10.1825829901285,10.1944018955686,0.406447785036191,31
"10841","SP","Santo Anastácio",20866,19766.77,35036,"Presidente Prudente",3,"Sudeste",1,"354770",2,12,1,11,3,9,0,0,0,0,0,12,1,11,3,9,19,9.89175752396003,9.94587631902792,0.278431413152733,29
"10842","SP","Santo Anastácio",20866,19766.77,35036,"Presidente Prudente",3,"Sudeste",1,"354770",3,14,0,14,4,10,0,0,0,0,0,14,0,14,4,10,17,9.89175752396003,9.94587631902792,0.360815168489694,31
"10843","SP","Santo Anastácio",20866,19766.77,35036,"Presidente Prudente",3,"Sudeste",1,"354770",4,21,5,16,12,9,0,0,0,0,0,21,5,16,12,9,19,9.89175752396003,9.94587631902792,0.408087214407496,30
"10844","SP","Santo Anastácio",20866,19766.77,35036,"Presidente Prudente",3,"Sudeste",1,"354770",5,15,2,13,6,9,0,0,0,0,0,15,2,13,6,9,11,9.89175752396003,9.94587631902792,0.376305544005361,31
"10845","SP","Santo André",721368,40489.21,35061,"São Paulo",3,"Sudeste",1,"354780",2,607,56,551,150,457,6,1,5,3,3,613,57,556,153,460,400,10.6087907978455,13.4889046882753,0.289703265274162,29
"10846","SP","Santo André",721368,40489.21,35061,"São Paulo",3,"Sudeste",1,"354780",3,682,75,607,188,494,6,4,2,2,4,688,79,609,190,498,452,10.6087907978455,13.4889046882753,0.411367168943763,31
"10847","SP","Santo André",721368,40489.21,35061,"São Paulo",3,"Sudeste",1,"354780",4,629,62,567,176,453,2,2,0,2,0,631,64,567,178,453,518,10.6087907978455,13.4889046882753,0.503487320443413,30
"10848","SP","Santo André",721368,40489.21,35061,"São Paulo",3,"Sudeste",1,"354780",5,701,64,637,182,519,7,1,6,4,3,708,65,643,186,522,653,10.6087907978455,13.4889046882753,0.461614136157181,31
"10849","SP","Santo Antônio da Alegria",6977,18953.27,35015,"Batatais",3,"Sudeste",0,"354790",2,6,2,4,4,2,0,0,0,0,0,6,2,4,4,2,5,9.84973175499067,8.85037430393924,0.295024818135756,29
"10850","SP","Santo Antônio da Alegria",6977,18953.27,35015,"Batatais",3,"Sudeste",0,"354790",3,2,0,2,2,0,0,0,0,0,0,2,0,2,2,0,7,9.84973175499067,8.85037430393924,0.377093965217592,31
"10851","SP","Santo Antônio da Alegria",6977,18953.27,35015,"Batatais",3,"Sudeste",0,"354790",4,3,2,1,1,2,0,0,0,0,0,3,2,1,1,2,7,9.84973175499067,8.85037430393924,0.437888305632308,30
"10852","SP","Santo Antônio da Alegria",6977,18953.27,35015,"Batatais",3,"Sudeste",0,"354790",5,5,1,4,2,3,1,0,1,0,1,6,1,5,2,4,4,9.84973175499067,8.85037430393924,0.366273777522701,31
"10853","SP","Santo Antônio de Posse",23529,48880.01,35031,"Mogi Mirim",3,"Sudeste",1,"354800",2,20,6,14,7,13,0,0,0,0,0,20,6,14,7,13,6,10.7971237984281,10.0659889818808,0.291263129390021,29
"10854","SP","Santo Antônio de Posse",23529,48880.01,35031,"Mogi Mirim",3,"Sudeste",1,"354800",3,18,5,13,7,11,0,0,0,0,0,18,5,13,7,11,18,10.7971237984281,10.0659889818808,0.380401206705228,31
"10855","SP","Santo Antônio de Posse",23529,48880.01,35031,"Mogi Mirim",3,"Sudeste",1,"354800",4,19,7,12,9,10,0,0,0,0,0,19,7,12,9,10,15,10.7971237984281,10.0659889818808,0.42688080711189,30
"10856","SP","Santo Antônio de Posse",23529,48880.01,35031,"Mogi Mirim",3,"Sudeste",1,"354800",5,20,3,17,5,15,0,0,0,0,0,20,3,17,5,15,17,10.7971237984281,10.0659889818808,0.400379139075635,31
"10857","SP","Santo Antônio do Aracanguá",8481,24823.67,35017,"Araçatuba",3,"Sudeste",0,"354805",2,4,0,4,1,3,0,0,0,0,0,4,0,4,1,3,3,10.119552912453,9.0455836463617,0.296951674490096,29
"10858","SP","Santo Antônio do Aracanguá",8481,24823.67,35017,"Araçatuba",3,"Sudeste",0,"354805",3,9,0,9,4,5,0,0,0,0,0,9,0,9,4,5,3,10.119552912453,9.0455836463617,0.391070530601392,31
"10859","SP","Santo Antônio do Aracanguá",8481,24823.67,35017,"Araçatuba",3,"Sudeste",0,"354805",4,9,1,8,3,6,0,0,0,0,0,9,1,8,3,6,4,10.119552912453,9.0455836463617,0.412585833862521,30
"10860","SP","Santo Antônio do Aracanguá",8481,24823.67,35017,"Araçatuba",3,"Sudeste",0,"354805",5,9,1,8,4,5,0,0,0,0,0,9,1,8,4,5,4,10.119552912453,9.0455836463617,0.408039655234108,31
"10861","SP","Santo Antônio do Pinhal",6827,16258.73,35049,"Campos do Jordão",3,"Sudeste",0,"354820",2,9,2,7,3,6,0,0,0,0,0,9,2,7,3,6,3,9.69638527427033,8.82864061741828,0.30811095158135,29
"10862","SP","Santo Antônio do Pinhal",6827,16258.73,35049,"Campos do Jordão",3,"Sudeste",0,"354820",3,5,1,4,1,4,0,0,0,0,0,5,1,4,1,4,5,9.69638527427033,8.82864061741828,0.438987392156532,31
"10863","SP","Santo Antônio do Pinhal",6827,16258.73,35049,"Campos do Jordão",3,"Sudeste",0,"354820",4,7,1,6,3,4,0,0,0,0,0,7,1,6,3,4,0,9.69638527427033,8.82864061741828,0.504058798137841,30
"10864","SP","Santo Antônio do Pinhal",6827,16258.73,35049,"Campos do Jordão",3,"Sudeste",0,"354820",5,10,2,8,6,4,0,0,0,0,0,10,2,8,6,4,8,9.69638527427033,8.82864061741828,0.476186736409236,31
"10865","SP","Santópolis do Aguapeí",4817,14856.83,35018,"Birigui",3,"Sudeste",0,"354840",2,4,0,4,1,3,0,0,0,0,0,4,0,4,1,3,2,9.60621497115417,8.47990660663022,0.287142871086043,29
"10866","SP","Santópolis do Aguapeí",4817,14856.83,35018,"Birigui",3,"Sudeste",0,"354840",3,1,1,0,1,0,0,0,0,0,0,1,1,0,1,0,2,9.60621497115417,8.47990660663022,0.350740687028495,31
"10867","SP","Santópolis do Aguapeí",4817,14856.83,35018,"Birigui",3,"Sudeste",0,"354840",4,3,1,2,2,1,0,0,0,0,0,3,1,2,2,1,1,9.60621497115417,8.47990660663022,0.375795999752586,30
"10868","SP","Santópolis do Aguapeí",4817,14856.83,35018,"Birigui",3,"Sudeste",0,"354840",5,8,3,5,1,7,0,0,0,0,0,8,3,5,1,7,4,9.60621497115417,8.47990660663022,0.398098556765338,31
"10869","SP","Santos",433656,51915.03,35063,"Santos",3,"Sudeste",1,"354850",2,303,35,268,89,214,1,0,1,0,1,304,35,269,89,215,317,10.8573636226051,12.9800068720598,0.29955773254991,29
"10870","SP","Santos",433656,51915.03,35063,"Santos",3,"Sudeste",1,"354850",3,316,41,275,96,220,3,0,3,0,3,319,41,278,96,223,341,10.8573636226051,12.9800068720598,0.419121412029366,31
"10871","SP","Santos",433656,51915.03,35063,"Santos",3,"Sudeste",1,"354850",4,295,27,268,76,219,2,0,2,0,2,297,27,270,76,221,417,10.8573636226051,12.9800068720598,0.508875919830376,30
"10872","SP","Santos",433656,51915.03,35063,"Santos",3,"Sudeste",1,"354850",5,325,40,285,90,235,3,1,2,2,1,328,41,287,92,236,504,10.8573636226051,12.9800068720598,0.474716661809136,31
"10873","SP","São Bento do Sapucaí",10893,18725.82,35049,"Campos do Jordão",3,"Sudeste",0,"354860",2,4,1,3,3,1,1,1,0,0,1,5,2,3,3,2,8,9.83765859914889,9.29587566008245,0.344189267197927,29
"10874","SP","São Bento do Sapucaí",10893,18725.82,35049,"Campos do Jordão",3,"Sudeste",0,"354860",3,7,1,6,2,5,0,0,0,0,0,7,1,6,2,5,10,9.83765859914889,9.29587566008245,0.419901805990727,31
"10875","SP","São Bento do Sapucaí",10893,18725.82,35049,"Campos do Jordão",3,"Sudeste",0,"354860",4,13,1,12,3,10,0,0,0,0,0,13,1,12,3,10,5,9.83765859914889,9.29587566008245,0.465048349579499,30
"10876","SP","São Bento do Sapucaí",10893,18725.82,35049,"Campos do Jordão",3,"Sudeste",0,"354860",5,12,4,8,4,8,0,0,0,0,0,12,4,8,4,8,4,9.83765859914889,9.29587566008245,0.443332972723622,31
"10877","SP","São Bernardo do Campo",844483,60689.23,35061,"São Paulo",3,"Sudeste",1,"354870",2,693,71,622,206,487,2,0,2,0,2,695,71,624,206,489,348,11.0135215313215,13.6464798847728,0.2946708037933,29
"10878","SP","São Bernardo do Campo",844483,60689.23,35061,"São Paulo",3,"Sudeste",1,"354870",3,702,68,634,201,501,6,0,6,2,4,708,68,640,203,505,408,11.0135215313215,13.6464798847728,0.410586092892564,31
"10879","SP","São Bernardo do Campo",844483,60689.23,35061,"São Paulo",3,"Sudeste",1,"354870",4,728,72,656,192,536,4,0,4,1,3,732,72,660,193,539,450,11.0135215313215,13.6464798847728,0.501820856332526,30
"10880","SP","São Bernardo do Campo",844483,60689.23,35061,"São Paulo",3,"Sudeste",1,"354870",5,695,75,620,193,502,6,1,5,2,4,701,76,625,195,506,617,11.0135215313215,13.6464798847728,0.466156597550308,31
"10881","SP","São Caetano do Sul",161957,83860.42,35061,"São Paulo",3,"Sudeste",1,"354880",2,138,3,135,24,114,1,0,1,0,1,139,3,136,24,115,111,11.3369090290595,11.9950861468824,0.290516138219719,29
"10882","SP","São Caetano do Sul",161957,83860.42,35061,"São Paulo",3,"Sudeste",1,"354880",3,99,2,97,21,78,0,0,0,0,0,99,2,97,21,78,148,11.3369090290595,11.9950861468824,0.435925857779943,31
"10883","SP","São Caetano do Sul",161957,83860.42,35061,"São Paulo",3,"Sudeste",1,"354880",4,105,5,100,19,86,0,0,0,0,0,105,5,100,19,86,126,11.3369090290595,11.9950861468824,0.562924437260425,30
"10884","SP","São Caetano do Sul",161957,83860.42,35061,"São Paulo",3,"Sudeste",1,"354880",5,110,4,106,17,93,0,0,0,0,0,110,4,106,17,93,163,11.3369090290595,11.9950861468824,0.516923853019607,31
"10885","SP","São Carlos",254484,44796.83,35025,"São Carlos",3,"Sudeste",1,"354890",2,218,19,199,69,149,1,0,1,0,1,219,19,200,69,150,131,10.709892656971,12.4469932446271,0.29097820832043,29
"10886","SP","São Carlos",254484,44796.83,35025,"São Carlos",3,"Sudeste",1,"354890",3,227,33,194,61,166,1,0,1,0,1,228,33,195,61,167,147,10.709892656971,12.4469932446271,0.409131281922475,31
"10887","SP","São Carlos",254484,44796.83,35025,"São Carlos",3,"Sudeste",1,"354890",4,245,32,213,80,165,4,0,4,0,4,249,32,217,80,169,136,10.709892656971,12.4469932446271,0.508344688174247,30
"10888","SP","São Carlos",254484,44796.83,35025,"São Carlos",3,"Sudeste",1,"354890",5,254,16,238,65,189,2,0,2,0,2,256,16,240,65,191,145,10.709892656971,12.4469932446271,0.469107001260507,31
"10889","SP","São João da Boa Vista",91771,34522.54,35030,"São João da Boa Vista",3,"Sudeste",1,"354910",2,85,17,68,30,55,1,1,0,0,1,86,18,68,30,56,67,10.4493677230235,11.4270516225609,0.339901811802224,29
"10890","SP","São João da Boa Vista",91771,34522.54,35030,"São João da Boa Vista",3,"Sudeste",1,"354910",3,67,19,48,20,47,0,0,0,0,0,67,19,48,20,47,51,10.4493677230235,11.4270516225609,0.438173732083041,31
"10891","SP","São João da Boa Vista",91771,34522.54,35030,"São João da Boa Vista",3,"Sudeste",1,"354910",4,57,15,42,16,41,0,0,0,0,0,57,15,42,16,41,66,10.4493677230235,11.4270516225609,0.50077183099606,30
"10892","SP","São João da Boa Vista",91771,34522.54,35030,"São João da Boa Vista",3,"Sudeste",1,"354910",5,90,17,73,25,65,0,0,0,0,0,90,17,73,25,65,73,10.4493677230235,11.4270516225609,0.460967182195044,31
"10893","SP","São Joaquim da Barra",52319,33011.12,35010,"São Joaquim da Barra",3,"Sudeste",1,"354940",2,43,5,38,11,32,0,0,0,0,0,43,5,38,11,32,28,10.404599753384,10.8651148727986,0.303323339387996,29
"10894","SP","São Joaquim da Barra",52319,33011.12,35010,"São Joaquim da Barra",3,"Sudeste",1,"354940",3,38,2,36,15,23,0,0,0,0,0,38,2,36,15,23,25,10.404599753384,10.8651148727986,0.379956657376486,31
"10895","SP","São Joaquim da Barra",52319,33011.12,35010,"São Joaquim da Barra",3,"Sudeste",1,"354940",4,46,12,34,10,36,0,0,0,0,0,46,12,34,10,36,24,10.404599753384,10.8651148727986,0.44055023941714,30
"10896","SP","São Joaquim da Barra",52319,33011.12,35010,"São Joaquim da Barra",3,"Sudeste",1,"354940",5,31,3,28,11,20,0,0,0,0,0,31,3,28,11,20,21,10.404599753384,10.8651148727986,0.409776137264523,31
"10897","SP","São José da Bela Vista",8960,18219.25,35012,"Franca",3,"Sudeste",0,"354950",2,2,0,2,2,0,0,0,0,0,0,2,0,2,2,0,4,9.81023400641017,9.10052550596898,0.330871438296465,29
"10898","SP","São José da Bela Vista",8960,18219.25,35012,"Franca",3,"Sudeste",0,"354950",3,5,0,5,2,3,0,0,0,0,0,5,0,5,2,3,2,9.81023400641017,9.10052550596898,0.419622109402965,31
"10899","SP","São José da Bela Vista",8960,18219.25,35012,"Franca",3,"Sudeste",0,"354950",4,6,0,6,5,1,0,0,0,0,0,6,0,6,5,1,3,9.81023400641017,9.10052550596898,0.394878313405012,30
"10900","SP","São José da Bela Vista",8960,18219.25,35012,"Franca",3,"Sudeste",0,"354950",5,4,0,4,2,2,0,0,0,0,0,4,0,4,2,2,7,9.81023400641017,9.10052550596898,0.421892836638617,31
"10901","SP","São José do Rio Pardo",55124,33227.23,35030,"São João da Boa Vista",3,"Sudeste",1,"354970",2,50,12,38,17,33,0,0,0,0,0,50,12,38,17,33,27,10.4111249994631,10.917340471995,0.308308586437874,29
"10902","SP","São José do Rio Pardo",55124,33227.23,35030,"São João da Boa Vista",3,"Sudeste",1,"354970",3,46,11,35,17,29,0,0,0,0,0,46,11,35,17,29,31,10.4111249994631,10.917340471995,0.396400153323305,31
"10903","SP","São José do Rio Pardo",55124,33227.23,35030,"São João da Boa Vista",3,"Sudeste",1,"354970",4,46,11,35,15,31,0,0,0,0,0,46,11,35,15,31,30,10.4111249994631,10.917340471995,0.435971311618725,30
"10904","SP","São José do Rio Pardo",55124,33227.23,35030,"São João da Boa Vista",3,"Sudeste",1,"354970",5,45,11,34,10,35,0,0,0,0,0,45,11,34,10,35,53,10.4111249994631,10.917340471995,0.408146003926088,31
"10905","SP","São José do Rio Preto",464983,38449.7,35004,"São José do Rio Preto",3,"Sudeste",1,"354980",2,429,46,383,117,312,3,0,3,0,3,432,46,386,117,315,292,10.5571061725626,13.0497561247614,0.282352278404563,29
"10906","SP","São José do Rio Preto",464983,38449.7,35004,"São José do Rio Preto",3,"Sudeste",1,"354980",3,435,57,378,113,322,2,0,2,2,0,437,57,380,115,322,294,10.5571061725626,13.0497561247614,0.380520923212408,31
"10907","SP","São José do Rio Preto",464983,38449.7,35004,"São José do Rio Preto",3,"Sudeste",1,"354980",4,424,70,354,125,299,1,0,1,0,1,425,70,355,125,300,263,10.5571061725626,13.0497561247614,0.436049071181578,30
"10908","SP","São José do Rio Preto",464983,38449.7,35004,"São José do Rio Preto",3,"Sudeste",1,"354980",5,477,66,411,148,329,4,1,3,0,4,481,67,414,148,333,274,10.5571061725626,13.0497561247614,0.393338073311139,31
"10909","SP","São José dos Campos",729737,55603.18,35050,"São José dos Campos",3,"Sudeste",1,"354990",2,620,61,559,172,448,1,0,1,0,1,621,61,560,172,449,328,10.9259956728477,13.5004394742377,0.286115028361378,29
"10910","SP","São José dos Campos",729737,55603.18,35050,"São José dos Campos",3,"Sudeste",1,"354990",3,684,66,618,211,473,2,0,2,1,1,686,66,620,212,474,352,10.9259956728477,13.5004394742377,0.395566270090936,31
"10911","SP","São José dos Campos",729737,55603.18,35050,"São José dos Campos",3,"Sudeste",1,"354990",4,623,65,558,178,445,5,3,2,3,2,628,68,560,181,447,305,10.9259956728477,13.5004394742377,0.463092219432766,30
"10912","SP","São José dos Campos",729737,55603.18,35050,"São José dos Campos",3,"Sudeste",1,"354990",5,739,84,655,231,508,4,0,4,0,4,743,84,659,231,512,357,10.9259956728477,13.5004394742377,0.421268950108257,31
"10913","SP","São Lourenço da Serra",15978,13319.9,35060,"Itapecerica da Serra",3,"Sudeste",1,"354995",2,15,1,14,6,9,0,0,0,0,0,15,1,14,6,9,4,9.49701443655869,9.67896805504199,0.320575534566877,29
"10914","SP","São Lourenço da Serra",15978,13319.9,35060,"Itapecerica da Serra",3,"Sudeste",1,"354995",3,6,1,5,3,3,0,0,0,0,0,6,1,5,3,3,10,9.49701443655869,9.67896805504199,0.392825920930377,31
"10915","SP","São Lourenço da Serra",15978,13319.9,35060,"Itapecerica da Serra",3,"Sudeste",1,"354995",4,12,0,12,5,7,0,0,0,0,0,12,0,12,5,7,7,9.49701443655869,9.67896805504199,0.460998563122766,30
"10916","SP","São Lourenço da Serra",15978,13319.9,35060,"Itapecerica da Serra",3,"Sudeste",1,"354995",5,13,2,11,8,5,0,0,0,0,0,13,2,11,8,5,9,9.49701443655869,9.67896805504199,0.45302604065791,31
"10917","SP","São Luiz do Paraitinga",10690,15394.97,35053,"Paraibuna/Paraitinga",3,"Sudeste",0,"355000",2,9,2,7,4,5,0,0,0,0,0,9,2,7,4,5,4,9.64179611167206,9.27706400401909,0.319963956440851,29
"10918","SP","São Luiz do Paraitinga",10690,15394.97,35053,"Paraibuna/Paraitinga",3,"Sudeste",0,"355000",3,11,2,9,1,10,0,0,0,0,0,11,2,9,1,10,6,9.64179611167206,9.27706400401909,0.407509996691124,31
"10919","SP","São Luiz do Paraitinga",10690,15394.97,35053,"Paraibuna/Paraitinga",3,"Sudeste",0,"355000",4,8,5,3,0,8,0,0,0,0,0,8,5,3,0,8,10,9.64179611167206,9.27706400401909,0.479228602439771,30
"10920","SP","São Luiz do Paraitinga",10690,15394.97,35053,"Paraibuna/Paraitinga",3,"Sudeste",0,"355000",5,8,1,7,3,5,1,0,1,1,0,9,1,8,4,5,7,9.64179611167206,9.27706400401909,0.435988842578056,31
"10921","SP","São Manuel",41123,29556.56,35023,"Botucatu",3,"Sudeste",1,"355010",2,47,7,40,19,28,0,0,0,0,0,47,7,40,19,28,24,10.2940609948125,10.6243228546662,0.305744090310725,29
"10922","SP","São Manuel",41123,29556.56,35023,"Botucatu",3,"Sudeste",1,"355010",3,38,4,34,10,28,0,0,0,0,0,38,4,34,10,28,24,10.2940609948125,10.6243228546662,0.396838995071745,31
"10923","SP","São Manuel",41123,29556.56,35023,"Botucatu",3,"Sudeste",1,"355010",4,35,4,31,15,20,0,0,0,0,0,35,4,31,15,20,16,10.2940609948125,10.6243228546662,0.44015135594736,30
"10924","SP","São Manuel",41123,29556.56,35023,"Botucatu",3,"Sudeste",1,"355010",5,33,8,25,11,22,1,1,0,1,0,34,9,25,12,22,17,10.2940609948125,10.6243228546662,0.400662279972006,31
"10925","SP","São Miguel Arcanjo",33002,20727.11,35045,"Piedade",3,"Sudeste",0,"355020",2,26,7,19,14,12,0,0,0,0,0,26,7,19,14,12,14,9.9391977842302,10.4043234446727,0.29339603977374,29
"10926","SP","São Miguel Arcanjo",33002,20727.11,35045,"Piedade",3,"Sudeste",0,"355020",3,19,7,12,8,11,0,0,0,0,0,19,7,12,8,11,18,9.9391977842302,10.4043234446727,0.381216551210321,31
"10927","SP","São Miguel Arcanjo",33002,20727.11,35045,"Piedade",3,"Sudeste",0,"355020",4,35,5,30,15,20,0,0,0,0,0,35,5,30,15,20,12,9.9391977842302,10.4043234446727,0.444280974357207,30
"10928","SP","São Miguel Arcanjo",33002,20727.11,35045,"Piedade",3,"Sudeste",0,"355020",5,29,10,19,15,14,0,0,0,0,0,29,10,19,15,14,15,9.9391977842302,10.4043234446727,0.41839903123072,31
"10929","SP","São Paulo",12325232,58691.9,35061,"São Paulo",3,"Sudeste",1,"355030",2,11090,1578,9512,3435,7655,80,20,60,21,59,11170,1598,9572,3456,7714,5936,10.9800570065162,16.3271591012453,0.301191277786397,29
"10930","SP","São Paulo",12325232,58691.9,35061,"São Paulo",3,"Sudeste",1,"355030",3,11231,1552,9679,3547,7684,83,13,70,29,54,11314,1565,9749,3576,7738,7120,10.9800570065162,16.3271591012453,0.416045304494542,31
"10931","SP","São Paulo",12325232,58691.9,35061,"São Paulo",3,"Sudeste",1,"355030",4,10896,1509,9387,3511,7385,71,15,56,18,53,10967,1524,9443,3529,7438,8513,10.9800570065162,16.3271591012453,0.508637064547407,30
"10932","SP","São Paulo",12325232,58691.9,35061,"São Paulo",3,"Sudeste",1,"355030",5,11850,1579,10271,3631,8219,94,17,77,27,67,11944,1596,10348,3658,8286,10107,10.9800570065162,16.3271591012453,0.480815588987444,31
"10933","SP","São Pedro",35980,21316.77,35028,"Piracicaba",3,"Sudeste",0,"355040",2,34,7,27,9,25,0,0,0,0,0,34,7,27,9,25,17,9.96724936586427,10.4907185075045,0.286758747604008,29
"10934","SP","São Pedro",35980,21316.77,35028,"Piracicaba",3,"Sudeste",0,"355040",3,26,8,18,8,18,0,0,0,0,0,26,8,18,8,18,20,9.96724936586427,10.4907185075045,0.381745953823775,31
"10935","SP","São Pedro",35980,21316.77,35028,"Piracicaba",3,"Sudeste",0,"355040",4,27,5,22,12,15,0,0,0,0,0,27,5,22,12,15,26,9.96724936586427,10.4907185075045,0.45739191053166,30
"10936","SP","São Pedro",35980,21316.77,35028,"Piracicaba",3,"Sudeste",0,"355040",5,32,7,25,13,19,0,0,0,0,0,32,7,25,13,19,22,9.96724936586427,10.4907185075045,0.429978757935906,31
"10937","SP","São Pedro do Turvo",7696,23834.77,35040,"Ourinhos",3,"Sudeste",0,"355050",2,4,1,3,3,1,1,1,0,0,1,5,2,3,3,2,5,10.0789007179175,8.94845599234554,0.339913715482343,29
"10938","SP","São Pedro do Turvo",7696,23834.77,35040,"Ourinhos",3,"Sudeste",0,"355050",3,6,1,5,1,5,0,0,0,0,0,6,1,5,1,5,4,10.0789007179175,8.94845599234554,0.422152685769155,31
"10939","SP","São Pedro do Turvo",7696,23834.77,35040,"Ourinhos",3,"Sudeste",0,"355050",4,6,0,6,1,5,0,0,0,0,0,6,0,6,1,5,4,10.0789007179175,8.94845599234554,0.43826395014306,30
"10940","SP","São Pedro do Turvo",7696,23834.77,35040,"Ourinhos",3,"Sudeste",0,"355050",5,8,3,5,1,7,0,0,0,0,0,8,3,5,1,7,6,10.0789007179175,8.94845599234554,0.395228418428782,31
"10941","SP","São Roque",92060,33039.26,35046,"Sorocaba",3,"Sudeste",1,"355060",2,66,14,52,25,41,1,0,1,0,1,67,14,53,25,42,40,10.4054518302897,11.4301958173712,0.311020445853792,29
"10942","SP","São Roque",92060,33039.26,35046,"Sorocaba",3,"Sudeste",1,"355060",3,78,16,62,31,47,2,1,1,0,2,80,17,63,31,49,56,10.4054518302897,11.4301958173712,0.415549795878064,31
"10943","SP","São Roque",92060,33039.26,35046,"Sorocaba",3,"Sudeste",1,"355060",4,61,8,53,21,40,0,0,0,0,0,61,8,53,21,40,47,10.4054518302897,11.4301958173712,0.491110468296822,30
"10944","SP","São Roque",92060,33039.26,35046,"Sorocaba",3,"Sudeste",1,"355060",5,90,18,72,25,65,0,0,0,0,0,90,18,72,25,65,41,10.4054518302897,11.4301958173712,0.469112352071131,31
"10945","SP","São Sebastião",90328,43173.65,35054,"Caraguatatuba",3,"Sudeste",1,"355070",2,78,23,55,22,56,1,1,0,0,1,79,24,55,22,57,28,10.6729856344311,11.4112027688604,0.286433219734985,29
"10946","SP","São Sebastião",90328,43173.65,35054,"Caraguatatuba",3,"Sudeste",1,"355070",3,113,17,96,43,70,1,0,1,0,1,114,17,97,43,71,44,10.6729856344311,11.4112027688604,0.410959468834688,31
"10947","SP","São Sebastião",90328,43173.65,35054,"Caraguatatuba",3,"Sudeste",1,"355070",4,93,13,80,34,59,1,0,1,1,0,94,13,81,35,59,27,10.6729856344311,11.4112027688604,0.483811529389056,30
"10948","SP","São Sebastião",90328,43173.65,35054,"Caraguatatuba",3,"Sudeste",1,"355070",5,118,20,98,37,81,1,0,1,0,1,119,20,99,37,82,30,10.6729856344311,11.4112027688604,0.461381715248301,31
"10949","SP","São Sebastião da Grama",12159,23386.39,35030,"São João da Boa Vista",3,"Sudeste",0,"355080",2,7,2,5,4,3,0,0,0,0,0,7,2,5,4,3,10,10.0599095082054,9.40582491529642,0.291842568724611,29
"10950","SP","São Sebastião da Grama",12159,23386.39,35030,"São João da Boa Vista",3,"Sudeste",0,"355080",3,3,1,2,1,2,0,0,0,0,0,3,1,2,1,2,4,10.0599095082054,9.40582491529642,0.341679944582836,31
"10951","SP","São Sebastião da Grama",12159,23386.39,35030,"São João da Boa Vista",3,"Sudeste",0,"355080",4,4,1,3,3,1,0,0,0,0,0,4,1,3,3,1,7,10.0599095082054,9.40582491529642,0.394017227371674,30
"10952","SP","São Sebastião da Grama",12159,23386.39,35030,"São João da Boa Vista",3,"Sudeste",0,"355080",5,5,3,2,1,4,0,0,0,0,0,5,3,2,1,4,12,10.0599095082054,9.40582491529642,0.372320460271862,31
"10953","SP","São Simão",15385,29049.13,35014,"Ribeirão Preto",3,"Sudeste",1,"355090",2,7,0,7,3,4,0,0,0,0,0,7,0,7,3,4,12,10.2767438134667,9.64114828775614,0.313534659801559,29
"10954","SP","São Simão",15385,29049.13,35014,"Ribeirão Preto",3,"Sudeste",1,"355090",3,15,6,9,3,12,0,0,0,0,0,15,6,9,3,12,12,10.2767438134667,9.64114828775614,0.407356841593152,31
"10955","SP","São Simão",15385,29049.13,35014,"Ribeirão Preto",3,"Sudeste",1,"355090",4,6,1,5,1,5,0,0,0,0,0,6,1,5,1,5,10,10.2767438134667,9.64114828775614,0.459477813925284,30
"10956","SP","São Simão",15385,29049.13,35014,"Ribeirão Preto",3,"Sudeste",1,"355090",5,17,8,9,10,7,1,0,1,1,0,18,8,10,11,7,8,10.2767438134667,9.64114828775614,0.417650786671349,31
"10957","SP","São Vicente",368355,15006.76,35063,"Santos",3,"Sudeste",1,"355100",2,295,57,238,112,183,2,1,1,1,1,297,58,239,113,184,223,9.61625604523129,12.8168024260653,0.311729850522487,29
"10958","SP","São Vicente",368355,15006.76,35063,"Santos",3,"Sudeste",1,"355100",3,334,71,263,133,201,3,0,3,1,2,337,71,266,134,203,219,9.61625604523129,12.8168024260653,0.40801276072262,31
"10959","SP","São Vicente",368355,15006.76,35063,"Santos",3,"Sudeste",1,"355100",4,343,69,274,134,209,5,2,3,1,4,348,71,277,135,213,218,9.61625604523129,12.8168024260653,0.465855466704353,30
"10960","SP","São Vicente",368355,15006.76,35063,"Santos",3,"Sudeste",1,"355100",5,343,64,279,138,205,0,0,0,0,0,343,64,279,138,205,351,9.61625604523129,12.8168024260653,0.438182958593173,31
"10961","SP","Sarapuí",10390,14289.18,35046,"Sorocaba",3,"Sudeste",0,"355110",2,6,2,4,5,1,0,0,0,0,0,6,2,4,5,1,5,9.56725788649229,9.24859908409327,0.306448253021599,29
"10962","SP","Sarapuí",10390,14289.18,35046,"Sorocaba",3,"Sudeste",0,"355110",3,6,2,4,1,5,0,0,0,0,0,6,2,4,1,5,7,9.56725788649229,9.24859908409327,0.385662248664502,31
"10963","SP","Sarapuí",10390,14289.18,35046,"Sorocaba",3,"Sudeste",0,"355110",4,10,0,10,2,8,0,0,0,0,0,10,0,10,2,8,5,9.56725788649229,9.24859908409327,0.440054298790885,30
"10964","SP","Sarapuí",10390,14289.18,35046,"Sorocaba",3,"Sudeste",0,"355110",5,9,1,8,4,5,0,0,0,0,0,9,1,8,4,5,8,9.56725788649229,9.24859908409327,0.432242205009502,31
"10965","SP","Sebastianópolis do Sul",3554,71224.85,35007,"Nhandeara",3,"Sudeste",0,"355130",2,3,0,3,1,2,0,0,0,0,0,3,0,3,1,2,2,11.1735970533618,8.1758290087146,0.323071101576511,29
"10966","SP","Sebastianópolis do Sul",3554,71224.85,35007,"Nhandeara",3,"Sudeste",0,"355130",3,1,1,0,1,0,0,0,0,0,0,1,1,0,1,0,2,11.1735970533618,8.1758290087146,0.354966714088593,31
"10967","SP","Sebastianópolis do Sul",3554,71224.85,35007,"Nhandeara",3,"Sudeste",0,"355130",4,2,0,2,0,2,0,0,0,0,0,2,0,2,0,2,2,11.1735970533618,8.1758290087146,0.41951461754263,30
"10968","SP","Sebastianópolis do Sul",3554,71224.85,35007,"Nhandeara",3,"Sudeste",0,"355130",5,3,0,3,0,3,0,0,0,0,0,3,0,3,0,3,1,11.1735970533618,8.1758290087146,0.38484158319451,31
"10969","SP","Serra Azul",14981,10758.97,35014,"Ribeirão Preto",3,"Sudeste",1,"355140",2,5,0,5,1,4,1,0,1,0,1,6,0,6,1,5,7,9.28349510422679,9.61453801051738,0.299408297926226,29
"10970","SP","Serra Azul",14981,10758.97,35014,"Ribeirão Preto",3,"Sudeste",1,"355140",3,6,0,6,1,5,1,0,1,1,0,7,0,7,2,5,7,9.28349510422679,9.61453801051738,0.387979872063807,31
"10971","SP","Serra Azul",14981,10758.97,35014,"Ribeirão Preto",3,"Sudeste",1,"355140",4,12,0,12,3,9,0,0,0,0,0,12,0,12,3,9,12,9.28349510422679,9.61453801051738,0.427274599935089,30
"10972","SP","Serra Azul",14981,10758.97,35014,"Ribeirão Preto",3,"Sudeste",1,"355140",5,7,2,5,5,2,0,0,0,0,0,7,2,5,5,2,3,9.28349510422679,9.61453801051738,0.395186898978481,31
"10973","SP","Serrana",45644,20663.93,35014,"Ribeirão Preto",3,"Sudeste",1,"355150",2,45,14,31,14,31,2,1,1,0,2,47,15,32,14,33,23,9.93614494723606,10.7286274425546,0.284475290622888,29
"10974","SP","Serrana",45644,20663.93,35014,"Ribeirão Preto",3,"Sudeste",1,"355150",3,38,10,28,16,22,1,0,1,0,1,39,10,29,16,23,14,9.93614494723606,10.7286274425546,0.368107963069411,31
"10975","SP","Serrana",45644,20663.93,35014,"Ribeirão Preto",3,"Sudeste",1,"355150",4,47,10,37,17,30,0,0,0,0,0,47,10,37,17,30,26,9.93614494723606,10.7286274425546,0.410749425216922,30
"10976","SP","Serrana",45644,20663.93,35014,"Ribeirão Preto",3,"Sudeste",1,"355150",5,34,10,24,13,21,0,0,0,0,0,34,10,24,13,21,26,9.93614494723606,10.7286274425546,0.378717775515697,31
"10977","SP","Serra Negra",29452,24910.92,35033,"Amparo",3,"Sudeste",0,"355160",2,16,4,12,5,11,0,0,0,0,0,16,4,12,5,11,23,10.1230615405329,10.2905170984886,0.311443043226625,29
"10978","SP","Serra Negra",29452,24910.92,35033,"Amparo",3,"Sudeste",0,"355160",3,25,5,20,7,18,0,0,0,0,0,25,5,20,7,18,23,10.1230615405329,10.2905170984886,0.429291787379901,31
"10979","SP","Serra Negra",29452,24910.92,35033,"Amparo",3,"Sudeste",0,"355160",4,19,1,18,7,12,0,0,0,0,0,19,1,18,7,12,27,10.1230615405329,10.2905170984886,0.49312386872342,30
"10980","SP","Serra Negra",29452,24910.92,35033,"Amparo",3,"Sudeste",0,"355160",5,32,9,23,9,23,1,0,1,0,1,33,9,24,9,24,23,10.1230615405329,10.2905170984886,0.444935185161244,31
"10981","SP","Sertãozinho",127142,44163.83,35014,"Ribeirão Preto",3,"Sudeste",1,"355170",2,106,11,95,29,77,2,0,2,1,1,108,11,97,30,78,73,10.6956614072626,11.7530598510573,0.286006772839156,29
"10982","SP","Sertãozinho",127142,44163.83,35014,"Ribeirão Preto",3,"Sudeste",1,"355170",3,111,25,86,28,83,3,0,3,1,2,114,25,89,29,85,78,10.6956614072626,11.7530598510573,0.370856556120146,31
"10983","SP","Sertãozinho",127142,44163.83,35014,"Ribeirão Preto",3,"Sudeste",1,"355170",4,112,27,85,32,80,0,0,0,0,0,112,27,85,32,80,73,10.6956614072626,11.7530598510573,0.42313221643237,30
"10984","SP","Sertãozinho",127142,44163.83,35014,"Ribeirão Preto",3,"Sudeste",1,"355170",5,128,26,102,38,90,1,0,1,0,1,129,26,103,38,91,70,10.6956614072626,11.7530598510573,0.387633203860999,31
"10985","SP","Sete Barras",12780,28760.76,35055,"Registro",3,"Sudeste",0,"355180",2,24,6,18,10,14,1,1,0,0,1,25,7,18,10,15,7,10.2667672370769,9.45563672793152,0.343702157666078,29
"10986","SP","Sete Barras",12780,28760.76,35055,"Registro",3,"Sudeste",0,"355180",3,18,2,16,11,7,0,0,0,0,0,18,2,16,11,7,9,10.2667672370769,9.45563672793152,0.442705198105624,31
"10987","SP","Sete Barras",12780,28760.76,35055,"Registro",3,"Sudeste",0,"355180",4,11,4,7,8,3,0,0,0,0,0,11,4,7,8,3,10,10.2667672370769,9.45563672793152,0.493957144807588,30
"10988","SP","Sete Barras",12780,28760.76,35055,"Registro",3,"Sudeste",0,"355180",5,20,6,14,11,9,0,0,0,0,0,20,6,14,11,9,15,10.2667672370769,9.45563672793152,0.480478952870716,31
"10989","SP","Severínia",17661,13372.83,35005,"Catanduva",3,"Sudeste",1,"355190",2,21,7,14,8,13,1,0,1,1,0,22,7,15,9,13,11,9.50098031561074,9.77911409769637,0.311013899945833,29
"10990","SP","Severínia",17661,13372.83,35005,"Catanduva",3,"Sudeste",1,"355190",3,7,3,4,3,4,0,0,0,0,0,7,3,4,3,4,10,9.50098031561074,9.77911409769637,0.383836659079819,31
"10991","SP","Severínia",17661,13372.83,35005,"Catanduva",3,"Sudeste",1,"355190",4,17,4,13,3,14,0,0,0,0,0,17,4,13,3,14,12,9.50098031561074,9.77911409769637,0.388095944186167,30
"10992","SP","Severínia",17661,13372.83,35005,"Catanduva",3,"Sudeste",1,"355190",5,18,3,15,7,11,0,0,0,0,0,18,3,15,7,11,10,9.50098031561074,9.77911409769637,0.375297198679902,31
"10993","SP","Socorro",41352,21180.14,35033,"Amparo",3,"Sudeste",0,"355210",2,26,3,23,5,21,0,0,0,0,0,26,3,23,5,21,28,9.960819229143,10.6298760668759,0.318333009263168,29
"10994","SP","Socorro",41352,21180.14,35033,"Amparo",3,"Sudeste",0,"355210",3,40,6,34,16,24,0,0,0,0,0,40,6,34,16,24,23,9.960819229143,10.6298760668759,0.416906968785839,31
"10995","SP","Socorro",41352,21180.14,35033,"Amparo",3,"Sudeste",0,"355210",4,24,5,19,6,18,0,0,0,0,0,24,5,19,6,18,33,9.960819229143,10.6298760668759,0.457009936583601,30
"10996","SP","Socorro",41352,21180.14,35033,"Amparo",3,"Sudeste",0,"355210",5,37,7,30,20,17,1,0,1,0,1,38,7,31,20,18,46,9.960819229143,10.6298760668759,0.414673544317803,31
"10997","SP","Sorocaba",687357,52169.13,35046,"Sorocaba",3,"Sudeste",1,"355220",2,666,70,596,224,442,1,0,1,0,1,667,70,597,224,443,365,10.8622462196267,13.4406090868879,0.286756977154196,29
"10998","SP","Sorocaba",687357,52169.13,35046,"Sorocaba",3,"Sudeste",1,"355220",3,692,67,625,230,462,1,0,1,0,1,693,67,626,230,463,379,10.8622462196267,13.4406090868879,0.398935472617437,31
"10999","SP","Sorocaba",687357,52169.13,35046,"Sorocaba",3,"Sudeste",1,"355220",4,680,63,617,243,437,8,2,6,5,3,688,65,623,248,440,371,10.8622462196267,13.4406090868879,0.470733275391943,30
"11000","SP","Sorocaba",687357,52169.13,35046,"Sorocaba",3,"Sudeste",1,"355220",5,744,72,672,232,512,5,0,5,2,3,749,72,677,234,515,362,10.8622462196267,13.4406090868879,0.426896758922948,31
"11001","SP","Sud Mennucci",7728,21694.14,35016,"Andradina",3,"Sudeste",0,"355230",2,5,1,4,1,4,0,0,0,0,0,5,1,4,1,4,6,9.98479745697659,8.95260537589235,0.305367933165187,29
"11002","SP","Sud Mennucci",7728,21694.14,35016,"Andradina",3,"Sudeste",0,"355230",3,9,3,6,5,4,0,0,0,0,0,9,3,6,5,4,6,9.98479745697659,8.95260537589235,0.401054171733854,31
"11003","SP","Sud Mennucci",7728,21694.14,35016,"Andradina",3,"Sudeste",0,"355230",4,8,0,8,1,7,0,0,0,0,0,8,0,8,1,7,1,9.98479745697659,8.95260537589235,0.425111556419046,30
"11004","SP","Sud Mennucci",7728,21694.14,35016,"Andradina",3,"Sudeste",0,"355230",5,7,0,7,3,4,0,0,0,0,0,7,0,7,3,4,1,9.98479745697659,8.95260537589235,0.397563169582235,31
"11005","SP","Sumaré",286211,51832.02,35032,"Campinas",3,"Sudeste",1,"355240",2,272,33,239,82,190,2,0,2,0,2,274,33,241,82,192,104,10.8557633839917,12.564484580027,0.286927630978106,29
"11006","SP","Sumaré",286211,51832.02,35032,"Campinas",3,"Sudeste",1,"355240",3,297,40,257,91,206,1,0,1,0,1,298,40,258,91,207,153,10.8557633839917,12.564484580027,0.383525976312147,31
"11007","SP","Sumaré",286211,51832.02,35032,"Campinas",3,"Sudeste",1,"355240",4,286,37,249,96,190,2,0,2,1,1,288,37,251,97,191,141,10.8557633839917,12.564484580027,0.439974601483727,30
"11008","SP","Sumaré",286211,51832.02,35032,"Campinas",3,"Sudeste",1,"355240",5,284,34,250,98,186,3,1,2,1,2,287,35,252,99,188,135,10.8557633839917,12.564484580027,0.402660459551055,31
"11009","SP","Suzano",300559,37835.81,35062,"Mogi das Cruzes",3,"Sudeste",1,"355250",2,299,29,270,83,216,4,0,4,0,4,303,29,274,83,220,127,10.541011287648,12.6133993531196,0.309364522237084,29
"11010","SP","Suzano",300559,37835.81,35062,"Mogi das Cruzes",3,"Sudeste",1,"355250",3,314,27,287,110,204,1,0,1,0,1,315,27,288,110,205,149,10.541011287648,12.6133993531196,0.412102443005775,31
"11011","SP","Suzano",300559,37835.81,35062,"Mogi das Cruzes",3,"Sudeste",1,"355250",4,291,17,274,88,203,1,0,1,1,0,292,17,275,89,203,173,10.541011287648,12.6133993531196,0.481663570907372,30
"11012","SP","Suzano",300559,37835.81,35062,"Mogi das Cruzes",3,"Sudeste",1,"355250",5,260,25,235,73,187,4,0,4,0,4,264,25,239,73,191,226,10.541011287648,12.6133993531196,0.451594504293042,31
"11013","SP","Tabapuã",12485,19073.08,35005,"Catanduva",3,"Sudeste",1,"355260",2,8,2,6,3,5,0,0,0,0,0,8,2,6,3,5,4,9.85603319577858,9.43228320271387,0.28540824160501,29
"11014","SP","Tabapuã",12485,19073.08,35005,"Catanduva",3,"Sudeste",1,"355260",3,14,0,14,4,10,0,0,0,0,0,14,0,14,4,10,10,9.85603319577858,9.43228320271387,0.353913692978944,31
"11015","SP","Tabapuã",12485,19073.08,35005,"Catanduva",3,"Sudeste",1,"355260",4,8,1,7,2,6,0,0,0,0,0,8,1,7,2,6,10,9.85603319577858,9.43228320271387,0.367905124360604,30
"11016","SP","Tabapuã",12485,19073.08,35005,"Catanduva",3,"Sudeste",1,"355260",5,5,0,5,2,3,0,0,0,0,0,5,0,5,2,3,7,9.85603319577858,9.43228320271387,0.356769189974147,31
"11017","SP","Tabatinga",16644,15488.05,35024,"Araraquara",3,"Sudeste",1,"355270",2,16,7,9,4,12,0,0,0,0,0,16,7,9,4,12,11,9.64782403781693,9.71980507010283,0.30500946664637,29
"11018","SP","Tabatinga",16644,15488.05,35024,"Araraquara",3,"Sudeste",1,"355270",3,17,3,14,7,10,0,0,0,0,0,17,3,14,7,10,8,9.64782403781693,9.71980507010283,0.387403578221088,31
"11019","SP","Tabatinga",16644,15488.05,35024,"Araraquara",3,"Sudeste",1,"355270",4,20,4,16,9,11,0,0,0,0,0,20,4,16,9,11,9,9.64782403781693,9.71980507010283,0.393841826767471,30
"11020","SP","Tabatinga",16644,15488.05,35024,"Araraquara",3,"Sudeste",1,"355270",5,23,5,18,11,12,1,1,0,0,1,24,6,18,11,13,8,9.64782403781693,9.71980507010283,0.379455863589138,31
"11021","SP","Taboão da Serra",293652,29340.9,35060,"Itapecerica da Serra",3,"Sudeste",1,"355280",2,282,36,246,95,187,2,0,2,0,2,284,36,248,95,189,109,10.2867377260731,12.5901506717567,0.293411359868042,29
"11022","SP","Taboão da Serra",293652,29340.9,35060,"Itapecerica da Serra",3,"Sudeste",1,"355280",3,306,30,276,93,213,11,1,10,5,6,317,31,286,98,219,161,10.2867377260731,12.5901506717567,0.39761361908733,31
"11023","SP","Taboão da Serra",293652,29340.9,35060,"Itapecerica da Serra",3,"Sudeste",1,"355280",4,301,40,261,106,195,3,1,2,1,2,304,41,263,107,197,159,10.2867377260731,12.5901506717567,0.481092960669964,30
"11024","SP","Taboão da Serra",293652,29340.9,35060,"Itapecerica da Serra",3,"Sudeste",1,"355280",5,337,58,279,119,218,3,0,3,2,1,340,58,282,121,219,185,10.2867377260731,12.5901506717567,0.455273861150253,31
"11025","SP","Taciba",6329,25011.83,35036,"Presidente Prudente",3,"Sudeste",1,"355290",2,3,0,3,1,2,0,0,0,0,0,3,0,3,1,2,3,10.1271041919265,8.7528975247753,0.299102025125696,29
"11026","SP","Taciba",6329,25011.83,35036,"Presidente Prudente",3,"Sudeste",1,"355290",3,5,0,5,1,4,0,0,0,0,0,5,0,5,1,4,5,10.1271041919265,8.7528975247753,0.373011063432797,31
"11027","SP","Taciba",6329,25011.83,35036,"Presidente Prudente",3,"Sudeste",1,"355290",4,14,1,13,5,9,0,0,0,0,0,14,1,13,5,9,3,10.1271041919265,8.7528975247753,0.412804323148045,30
"11028","SP","Taciba",6329,25011.83,35036,"Presidente Prudente",3,"Sudeste",1,"355290",5,10,1,9,2,8,0,0,0,0,0,10,1,9,2,8,3,10.1271041919265,8.7528975247753,0.403958457584147,31
"11029","SP","Taguaí",14141,19998.06,35040,"Ourinhos",3,"Sudeste",0,"355300",2,15,1,14,6,9,0,0,0,0,0,15,1,14,6,9,3,9.90339054783132,9.55683365830778,0.388446647185837,29
"11030","SP","Taguaí",14141,19998.06,35040,"Ourinhos",3,"Sudeste",0,"355300",3,13,2,11,5,8,0,0,0,0,0,13,2,11,5,8,8,9.90339054783132,9.55683365830778,0.431893751825604,31
"11031","SP","Taguaí",14141,19998.06,35040,"Ourinhos",3,"Sudeste",0,"355300",4,12,2,10,4,8,0,0,0,0,0,12,2,10,4,8,5,9.90339054783132,9.55683365830778,0.495411400348219,30
"11032","SP","Taguaí",14141,19998.06,35040,"Ourinhos",3,"Sudeste",0,"355300",5,19,6,13,4,15,0,0,0,0,0,19,6,13,4,15,6,9.90339054783132,9.55683365830778,0.472481807801607,31
"11033","SP","Taiaçu",6320,15473.51,35013,"Jaboticabal",3,"Sudeste",0,"355310",2,4,0,4,3,1,0,0,0,0,0,4,0,4,3,1,2,9.6468848085876,8.7514744871409,0.339082014408791,29
"11034","SP","Taiaçu",6320,15473.51,35013,"Jaboticabal",3,"Sudeste",0,"355310",3,6,1,5,2,4,0,0,0,0,0,6,1,5,2,4,3,9.6468848085876,8.7514744871409,0.408674395340335,31
"11035","SP","Taiaçu",6320,15473.51,35013,"Jaboticabal",3,"Sudeste",0,"355310",4,7,0,7,4,3,0,0,0,0,0,7,0,7,4,3,6,9.6468848085876,8.7514744871409,0.409942532168013,30
"11036","SP","Taiaçu",6320,15473.51,35013,"Jaboticabal",3,"Sudeste",0,"355310",5,6,1,5,2,4,0,0,0,0,0,6,1,5,2,4,4,9.6468848085876,8.7514744871409,0.403640193471422,31
"11037","SP","Taiúva",5564,20486.83,35013,"Jaboticabal",3,"Sudeste",0,"355320",2,1,1,0,1,0,0,0,0,0,0,1,1,0,1,0,5,9.92753751964973,8.62407255304333,0.320920987139684,29
"11038","SP","Taiúva",5564,20486.83,35013,"Jaboticabal",3,"Sudeste",0,"355320",3,3,0,3,0,3,0,0,0,0,0,3,0,3,0,3,1,9.92753751964973,8.62407255304333,0.414003059050915,31
"11039","SP","Taiúva",5564,20486.83,35013,"Jaboticabal",3,"Sudeste",0,"355320",4,4,0,4,0,4,0,0,0,0,0,4,0,4,0,4,4,9.92753751964973,8.62407255304333,0.398243971188799,30
"11040","SP","Taiúva",5564,20486.83,35013,"Jaboticabal",3,"Sudeste",0,"355320",5,3,0,3,1,2,0,0,0,0,0,3,0,3,1,2,4,9.92753751964973,8.62407255304333,0.353786935962446,31
"11041","SP","Tambaú",23232,24209.88,35030,"São João da Boa Vista",3,"Sudeste",1,"355330",2,21,3,18,9,12,1,1,0,0,1,22,4,18,9,13,14,10.0945160932903,10.0532859176245,0.311167037283514,29
"11042","SP","Tambaú",23232,24209.88,35030,"São João da Boa Vista",3,"Sudeste",1,"355330",3,22,3,19,6,16,2,0,2,0,2,24,3,21,6,18,20,10.0945160932903,10.0532859176245,0.399572574098213,31
"11043","SP","Tambaú",23232,24209.88,35030,"São João da Boa Vista",3,"Sudeste",1,"355330",4,12,2,10,1,11,0,0,0,0,0,12,2,10,1,11,19,10.0945160932903,10.0532859176245,0.4247907658228,30
"11044","SP","Tambaú",23232,24209.88,35030,"São João da Boa Vista",3,"Sudeste",1,"355330",5,29,6,23,9,20,0,0,0,0,0,29,6,23,9,20,13,10.0945160932903,10.0532859176245,0.445962419741352,31
"11045","SP","Tanabi",26101,35899.14,35004,"São José do Rio Preto",3,"Sudeste",1,"355340",2,24,6,18,11,13,0,0,0,0,0,24,6,18,11,13,22,10.4884686187577,10.1697289067531,0.28948910048155,29
"11046","SP","Tanabi",26101,35899.14,35004,"São José do Rio Preto",3,"Sudeste",1,"355340",3,33,5,28,12,21,0,0,0,0,0,33,5,28,12,21,22,10.4884686187577,10.1697289067531,0.361556209305004,31
"11047","SP","Tanabi",26101,35899.14,35004,"São José do Rio Preto",3,"Sudeste",1,"355340",4,23,5,18,9,14,0,0,0,0,0,23,5,18,9,14,19,10.4884686187577,10.1697289067531,0.390717844871649,30
"11048","SP","Tanabi",26101,35899.14,35004,"São José do Rio Preto",3,"Sudeste",1,"355340",5,27,3,24,9,18,0,0,0,0,0,27,3,24,9,18,19,10.4884686187577,10.1697289067531,0.369551236893152,31
"11049","SP","Tapiraí",7766,18028.56,35045,"Piedade",3,"Sudeste",0,"355350",2,6,2,4,3,3,0,0,0,0,0,6,2,4,3,3,7,9.79971244611931,8.95751051029161,0.303906917294659,29
"11050","SP","Tapiraí",7766,18028.56,35045,"Piedade",3,"Sudeste",0,"355350",3,9,2,7,3,6,0,0,0,0,0,9,2,7,3,6,6,9.79971244611931,8.95751051029161,0.378433520391433,31
"11051","SP","Tapiraí",7766,18028.56,35045,"Piedade",3,"Sudeste",0,"355350",4,10,3,7,4,6,0,0,0,0,0,10,3,7,4,6,2,9.79971244611931,8.95751051029161,0.419054244902488,30
"11052","SP","Tapiraí",7766,18028.56,35045,"Piedade",3,"Sudeste",0,"355350",5,13,5,8,5,8,0,0,0,0,0,13,5,8,5,8,4,9.79971244611931,8.95751051029161,0.429541293366682,31
"11053","SP","Tapiratiba",12950,25093.84,35030,"São João da Boa Vista",3,"Sudeste",1,"355360",2,7,0,7,1,6,0,0,0,0,0,7,0,7,1,6,7,10.1303776766732,9.46885106712768,0.304249637618641,29
"11054","SP","Tapiratiba",12950,25093.84,35030,"São João da Boa Vista",3,"Sudeste",1,"355360",3,8,1,7,3,5,0,0,0,0,0,8,1,7,3,5,7,10.1303776766732,9.46885106712768,0.404839025555551,31
"11055","SP","Tapiratiba",12950,25093.84,35030,"São João da Boa Vista",3,"Sudeste",1,"355360",4,8,1,7,3,5,1,0,1,1,0,9,1,8,4,5,6,10.1303776766732,9.46885106712768,0.455459676453965,30
"11056","SP","Tapiratiba",12950,25093.84,35030,"São João da Boa Vista",3,"Sudeste",1,"355360",5,13,3,10,5,8,0,0,0,0,0,13,3,10,5,8,7,10.1303776766732,9.46885106712768,0.397822636320739,31
"11057","SP","Taquaritinga",57364,27561.71,35013,"Jaboticabal",3,"Sudeste",1,"355370",2,30,3,27,15,15,1,0,1,0,1,31,3,28,15,16,42,10.2241827696469,10.9571722078491,0.29002412297233,29
"11058","SP","Taquaritinga",57364,27561.71,35013,"Jaboticabal",3,"Sudeste",1,"355370",3,49,5,44,26,23,0,0,0,0,0,49,5,44,26,23,35,10.2241827696469,10.9571722078491,0.384166675480254,31
"11059","SP","Taquaritinga",57364,27561.71,35013,"Jaboticabal",3,"Sudeste",1,"355370",4,34,5,29,15,19,0,0,0,0,0,34,5,29,15,19,36,10.2241827696469,10.9571722078491,0.428354935064885,30
"11060","SP","Taquaritinga",57364,27561.71,35013,"Jaboticabal",3,"Sudeste",1,"355370",5,55,8,47,28,27,0,0,0,0,0,55,8,47,28,27,29,10.2241827696469,10.9571722078491,0.388026217107428,31
"11061","SP","Taquarituba",23256,29717.12,35041,"Itapeva",3,"Sudeste",1,"355380",2,18,2,16,7,11,1,1,0,1,0,19,3,16,8,11,8,10.2994785896947,10.0543184422387,0.359236490420633,29
"11062","SP","Taquarituba",23256,29717.12,35041,"Itapeva",3,"Sudeste",1,"355380",3,22,7,15,7,15,0,0,0,0,0,22,7,15,7,15,11,10.2994785896947,10.0543184422387,0.428339387338849,31
"11063","SP","Taquarituba",23256,29717.12,35041,"Itapeva",3,"Sudeste",1,"355380",4,21,5,16,6,15,0,0,0,0,0,21,5,16,6,15,19,10.2994785896947,10.0543184422387,0.478303464844165,30
"11064","SP","Taquarituba",23256,29717.12,35041,"Itapeva",3,"Sudeste",1,"355380",5,27,5,22,11,16,0,0,0,0,0,27,5,22,11,16,18,10.2994785896947,10.0543184422387,0.423670609936399,31
"11065","SP","Tarabai",7540,15509.65,35036,"Presidente Prudente",3,"Sudeste",1,"355390",2,2,2,0,1,1,1,0,1,0,1,3,2,1,1,2,3,9.64921768982957,8.927977461002,0.299547652284468,29
"11066","SP","Tarabai",7540,15509.65,35036,"Presidente Prudente",3,"Sudeste",1,"355390",3,10,1,9,6,4,0,0,0,0,0,10,1,9,6,4,5,9.64921768982957,8.927977461002,0.37355004692636,31
"11067","SP","Tarabai",7540,15509.65,35036,"Presidente Prudente",3,"Sudeste",1,"355390",4,4,0,4,2,2,0,0,0,0,0,4,0,4,2,2,2,9.64921768982957,8.927977461002,0.419432836162359,30
"11068","SP","Tarabai",7540,15509.65,35036,"Presidente Prudente",3,"Sudeste",1,"355390",5,5,0,5,4,1,0,0,0,0,0,5,0,5,4,1,7,9.64921768982957,8.927977461002,0.393070845337018,31
"11069","SP","Tarumã",15183,52291.48,35039,"Assis",3,"Sudeste",1,"355395",2,13,1,12,7,6,0,0,0,0,0,13,1,12,7,6,2,10.8645887304726,9.62793165988219,0.30844402978338,29
"11070","SP","Tarumã",15183,52291.48,35039,"Assis",3,"Sudeste",1,"355395",3,10,4,6,5,5,0,0,0,0,0,10,4,6,5,5,15,10.8645887304726,9.62793165988219,0.398695616197501,31
"11071","SP","Tarumã",15183,52291.48,35039,"Assis",3,"Sudeste",1,"355395",4,15,2,13,6,9,0,0,0,0,0,15,2,13,6,9,6,10.8645887304726,9.62793165988219,0.420680283059341,30
"11072","SP","Tarumã",15183,52291.48,35039,"Assis",3,"Sudeste",1,"355395",5,13,2,11,5,8,0,0,0,0,0,13,2,11,5,8,10,10.8645887304726,9.62793165988219,0.393428059772256,31
"11073","SP","Tatuí",122967,33202.74,35043,"Tatuí",3,"Sudeste",1,"355400",2,100,22,78,37,63,0,0,0,0,0,100,22,78,37,63,64,10.4103876816196,11.7196713056747,0.298662145981757,29
"11074","SP","Tatuí",122967,33202.74,35043,"Tatuí",3,"Sudeste",1,"355400",3,130,22,108,44,86,1,0,1,1,0,131,22,109,45,86,79,10.4103876816196,11.7196713056747,0.39732657481315,31
"11075","SP","Tatuí",122967,33202.74,35043,"Tatuí",3,"Sudeste",1,"355400",4,104,24,80,42,62,3,0,3,0,3,107,24,83,42,65,69,10.4103876816196,11.7196713056747,0.450823525360859,30
"11076","SP","Tatuí",122967,33202.74,35043,"Tatuí",3,"Sudeste",1,"355400",5,140,18,122,48,92,0,0,0,0,0,140,18,122,48,92,86,10.4103876816196,11.7196713056747,0.421263497383181,31
"11077","SP","Taubaté",317915,55369.58,35050,"São José dos Campos",3,"Sudeste",1,"355410",2,256,44,212,84,172,2,0,2,0,2,258,44,214,84,174,165,10.9217856244532,12.669539330435,0.288200900943622,29
"11078","SP","Taubaté",317915,55369.58,35050,"São José dos Campos",3,"Sudeste",1,"355410",3,268,47,221,73,195,2,0,2,0,2,270,47,223,73,197,190,10.9217856244532,12.669539330435,0.4062097691744,31
"11079","SP","Taubaté",317915,55369.58,35050,"São José dos Campos",3,"Sudeste",1,"355410",4,270,52,218,78,192,2,1,1,1,1,272,53,219,79,193,176,10.9217856244532,12.669539330435,0.480317998055635,30
"11080","SP","Taubaté",317915,55369.58,35050,"São José dos Campos",3,"Sudeste",1,"355410",5,310,60,250,84,226,2,0,2,2,0,312,60,252,86,226,180,10.9217856244532,12.669539330435,0.430410999922149,31
"11081","SP","Teodoro Sampaio",23273,19004.83,35036,"Presidente Prudente",3,"Sudeste",1,"355430",2,18,4,14,8,10,0,0,0,0,0,18,4,14,8,10,10,9.85244843636887,10.0550491693447,0.290898878276228,29
"11082","SP","Teodoro Sampaio",23273,19004.83,35036,"Presidente Prudente",3,"Sudeste",1,"355430",3,16,4,12,11,5,0,0,0,0,0,16,4,12,11,5,11,9.85244843636887,10.0550491693447,0.362096570792781,31
"11083","SP","Teodoro Sampaio",23273,19004.83,35036,"Presidente Prudente",3,"Sudeste",1,"355430",4,27,5,22,11,16,0,0,0,0,0,27,5,22,11,16,20,9.85244843636887,10.0550491693447,0.419878415294509,30
"11084","SP","Teodoro Sampaio",23273,19004.83,35036,"Presidente Prudente",3,"Sudeste",1,"355430",5,35,5,30,15,20,0,0,0,0,0,35,5,30,15,20,11,9.85244843636887,10.0550491693447,0.402111378653555,31
"11085","SP","Terra Roxa",9437,15136.01,35013,"Jaboticabal",3,"Sudeste",0,"355440",2,4,0,4,1,3,0,0,0,0,0,4,0,4,1,3,6,9.62483195196797,9.15239341202133,0.322490666102534,29
"11086","SP","Terra Roxa",9437,15136.01,35013,"Jaboticabal",3,"Sudeste",0,"355440",3,5,3,2,2,3,0,0,0,0,0,5,3,2,2,3,8,9.62483195196797,9.15239341202133,0.392785486128666,31
"11087","SP","Terra Roxa",9437,15136.01,35013,"Jaboticabal",3,"Sudeste",0,"355440",4,6,1,5,2,4,0,0,0,0,0,6,1,5,2,4,1,9.62483195196797,9.15239341202133,0.445597867289543,30
"11088","SP","Terra Roxa",9437,15136.01,35013,"Jaboticabal",3,"Sudeste",0,"355440",5,4,0,4,3,1,0,0,0,0,0,4,0,4,3,1,4,9.62483195196797,9.15239341202133,0.381657503269929,31
"11089","SP","Tietê",42517,43859.26,35028,"Piracicaba",3,"Sudeste",1,"355450",2,31,9,22,9,22,0,0,0,0,0,31,9,22,9,22,25,10.6887411499645,10.6576592749338,0.293142172990595,29
"11090","SP","Tietê",42517,43859.26,35028,"Piracicaba",3,"Sudeste",1,"355450",3,38,5,33,13,25,0,0,0,0,0,38,5,33,13,25,36,10.6887411499645,10.6576592749338,0.378720212921057,31
"11091","SP","Tietê",42517,43859.26,35028,"Piracicaba",3,"Sudeste",1,"355450",4,21,4,17,8,13,0,0,0,0,0,21,4,17,8,13,21,10.6887411499645,10.6576592749338,0.433749061609802,30
"11092","SP","Tietê",42517,43859.26,35028,"Piracicaba",3,"Sudeste",1,"355450",5,38,4,34,15,23,0,0,0,0,0,38,4,34,15,23,20,10.6887411499645,10.6576592749338,0.401893085975165,31
"11093","SP","Torrinha",10056,20407.61,35026,"Rio Claro",3,"Sudeste",0,"355470",2,3,1,2,0,3,0,0,0,0,0,3,1,2,0,3,9,9.92366314948617,9.21592475027008,0.305462916872424,29
"11094","SP","Torrinha",10056,20407.61,35026,"Rio Claro",3,"Sudeste",0,"355470",3,8,2,6,2,6,0,0,0,0,0,8,2,6,2,6,3,9.92366314948617,9.21592475027008,0.361777423941161,31
"11095","SP","Torrinha",10056,20407.61,35026,"Rio Claro",3,"Sudeste",0,"355470",4,5,0,5,2,3,0,0,0,0,0,5,0,5,2,3,7,9.92366314948617,9.21592475027008,0.40560294097603,30
"11096","SP","Torrinha",10056,20407.61,35026,"Rio Claro",3,"Sudeste",0,"355470",5,3,0,3,1,2,0,0,0,0,0,3,0,3,1,2,8,9.92366314948617,9.21592475027008,0.396521198736878,31
"11097","SP","Tremembé",47714,16194.84,35050,"São José dos Campos",3,"Sudeste",1,"355480",2,39,10,29,10,29,0,0,0,0,0,39,10,29,10,29,18,9.69244795196416,10.7729801348616,0.297997454329662,29
"11098","SP","Tremembé",47714,16194.84,35050,"São José dos Campos",3,"Sudeste",1,"355480",3,39,7,32,15,24,0,0,0,0,0,39,7,32,15,24,19,9.69244795196416,10.7729801348616,0.417550144588329,31
"11099","SP","Tremembé",47714,16194.84,35050,"São José dos Campos",3,"Sudeste",1,"355480",4,28,9,19,15,13,0,0,0,0,0,28,9,19,15,13,20,9.69244795196416,10.7729801348616,0.48239225079648,30
"11100","SP","Tremembé",47714,16194.84,35050,"São José dos Campos",3,"Sudeste",1,"355480",5,41,8,33,11,30,0,0,0,0,0,41,8,33,11,30,22,9.69244795196416,10.7729801348616,0.430407312234565,31
"11101","SP","Três Fronteiras",5832,18493.07,35001,"Jales",3,"Sudeste",1,"355490",2,3,1,2,1,2,0,0,0,0,0,3,1,2,1,2,1,9.82515134629374,8.67111527368849,0.323401817778242,29
"11102","SP","Três Fronteiras",5832,18493.07,35001,"Jales",3,"Sudeste",1,"355490",3,3,0,3,1,2,0,0,0,0,0,3,0,3,1,2,8,9.82515134629374,8.67111527368849,0.439433548035976,31
"11103","SP","Três Fronteiras",5832,18493.07,35001,"Jales",3,"Sudeste",1,"355490",4,1,1,0,0,1,0,0,0,0,0,1,1,0,0,1,3,9.82515134629374,8.67111527368849,0.443872402825255,30
"11104","SP","Três Fronteiras",5832,18493.07,35001,"Jales",3,"Sudeste",1,"355490",5,7,2,5,3,4,0,0,0,0,0,7,2,5,3,4,1,9.82515134629374,8.67111527368849,0.399489518406588,31
"11105","SP","Tupã",65570,27412.94,35037,"Tupã",3,"Sudeste",1,"355500",2,42,1,41,11,31,1,0,1,1,0,43,1,42,12,31,48,10.2187704436689,11.0908735532577,0.290893607407072,29
"11106","SP","Tupã",65570,27412.94,35037,"Tupã",3,"Sudeste",1,"355500",3,60,5,55,18,42,0,0,0,0,0,60,5,55,18,42,49,10.2187704436689,11.0908735532577,0.362927670519109,31
"11107","SP","Tupã",65570,27412.94,35037,"Tupã",3,"Sudeste",1,"355500",4,47,6,41,12,35,0,0,0,0,0,47,6,41,12,35,31,10.2187704436689,11.0908735532577,0.40543118216844,30
"11108","SP","Tupã",65570,27412.94,35037,"Tupã",3,"Sudeste",1,"355500",5,70,9,61,16,54,0,0,0,0,0,70,9,61,16,54,46,10.2187704436689,11.0908735532577,0.377556059736035,31
"11109","SP","Tupi Paulista",15583,17786.01,35034,"Dracena",3,"Sudeste",1,"355510",2,13,0,13,4,9,1,0,1,1,0,14,0,14,5,9,12,9.78616747219939,9.65393585544561,0.286640070041166,29
"11110","SP","Tupi Paulista",15583,17786.01,35034,"Dracena",3,"Sudeste",1,"355510",3,7,0,7,2,5,0,0,0,0,0,7,0,7,2,5,17,9.78616747219939,9.65393585544561,0.367867868234752,31
"11111","SP","Tupi Paulista",15583,17786.01,35034,"Dracena",3,"Sudeste",1,"355510",4,5,0,5,1,4,0,0,0,0,0,5,0,5,1,4,10,9.78616747219939,9.65393585544561,0.404445518547739,30
"11112","SP","Tupi Paulista",15583,17786.01,35034,"Dracena",3,"Sudeste",1,"355510",5,12,1,11,6,6,0,0,0,0,0,12,1,11,6,6,16,9.78616747219939,9.65393585544561,0.395181801651509,31
"11113","SP","Ubarana",6400,50883.11,35004,"São José do Rio Preto",3,"Sudeste",0,"355535",2,8,3,5,3,5,0,0,0,0,0,8,3,5,3,5,0,10.8372863203598,8.76405326934776,0.283406337749504,29
"11114","SP","Ubarana",6400,50883.11,35004,"São José do Rio Preto",3,"Sudeste",0,"355535",3,5,0,5,2,3,0,0,0,0,0,5,0,5,2,3,3,10.8372863203598,8.76405326934776,0.372540634730482,31
"11115","SP","Ubarana",6400,50883.11,35004,"São José do Rio Preto",3,"Sudeste",0,"355535",4,2,0,2,1,1,0,0,0,0,0,2,0,2,1,1,6,10.8372863203598,8.76405326934776,0.419104154231885,30
"11116","SP","Ubarana",6400,50883.11,35004,"São José do Rio Preto",3,"Sudeste",0,"355535",5,7,3,4,3,4,0,0,0,0,0,7,3,4,3,4,3,10.8372863203598,8.76405326934776,0.388586100159425,31
"11117","SP","Ubatuba",91824,23826.8,35054,"Caraguatatuba",3,"Sudeste",1,"355540",2,90,19,71,30,60,2,0,2,1,1,92,19,73,31,61,50,10.0785662765605,11.4276289803481,0.31115920932391,29
"11118","SP","Ubatuba",91824,23826.8,35054,"Caraguatatuba",3,"Sudeste",1,"355540",3,90,16,74,31,59,1,0,1,0,1,91,16,75,31,60,42,10.0785662765605,11.4276289803481,0.430221207856549,31
"11119","SP","Ubatuba",91824,23826.8,35054,"Caraguatatuba",3,"Sudeste",1,"355540",4,116,20,96,53,63,1,0,1,0,1,117,20,97,53,64,44,10.0785662765605,11.4276289803481,0.486339112617521,30
"11120","SP","Ubatuba",91824,23826.8,35054,"Caraguatatuba",3,"Sudeste",1,"355540",5,101,17,84,36,65,1,1,0,0,1,102,18,84,36,66,42,10.0785662765605,11.4276289803481,0.453258980637091,31
"11121","SP","Ubirajara",4804,19662,35020,"Bauru",3,"Sudeste",0,"355550",2,3,0,3,2,1,0,0,0,0,0,3,0,3,2,1,0,9.88644311792687,8.47720418319987,0.348816150436113,29
"11122","SP","Ubirajara",4804,19662,35020,"Bauru",3,"Sudeste",0,"355550",3,4,1,3,2,2,0,0,0,0,0,4,1,3,2,2,0,9.88644311792687,8.47720418319987,0.397361950267141,31
"11123","SP","Ubirajara",4804,19662,35020,"Bauru",3,"Sudeste",0,"355550",4,4,0,4,1,3,0,0,0,0,0,4,0,4,1,3,4,9.88644311792687,8.47720418319987,0.389133435798763,30
"11124","SP","Ubirajara",4804,19662,35020,"Bauru",3,"Sudeste",0,"355550",5,9,2,7,3,6,0,0,0,0,0,9,2,7,3,6,6,9.88644311792687,8.47720418319987,0.41981962097959,31
"11125","SP","Uchoa",10151,22187.55,35004,"São José do Rio Preto",3,"Sudeste",1,"355560",2,3,1,2,0,3,0,0,0,0,0,3,1,2,0,3,6,10.0072865997364,9.22532750178443,0.284484519891507,29
"11126","SP","Uchoa",10151,22187.55,35004,"São José do Rio Preto",3,"Sudeste",1,"355560",3,6,1,5,1,5,0,0,0,0,0,6,1,5,1,5,14,10.0072865997364,9.22532750178443,0.359870678012571,31
"11127","SP","Uchoa",10151,22187.55,35004,"São José do Rio Preto",3,"Sudeste",1,"355560",4,9,2,7,2,7,0,0,0,0,0,9,2,7,2,7,8,10.0072865997364,9.22532750178443,0.37999135404814,30
"11128","SP","Uchoa",10151,22187.55,35004,"São José do Rio Preto",3,"Sudeste",1,"355560",5,5,2,3,2,3,0,0,0,0,0,5,2,3,2,3,10,10.0072865997364,9.22532750178443,0.36630276901806,31
"11129","SP","Urânia",9120,23635.22,35001,"Jales",3,"Sudeste",0,"355580",2,7,1,6,2,5,0,0,0,0,0,7,1,6,2,5,9,10.0704932514133,9.11822508306838,0.289233691082979,29
"11130","SP","Urânia",9120,23635.22,35001,"Jales",3,"Sudeste",0,"355580",3,9,2,7,2,7,1,0,1,0,1,10,2,8,2,8,5,10.0704932514133,9.11822508306838,0.366343490281625,31
"11131","SP","Urânia",9120,23635.22,35001,"Jales",3,"Sudeste",0,"355580",4,5,0,5,2,3,0,0,0,0,0,5,0,5,2,3,3,10.0704932514133,9.11822508306838,0.385665538316613,30
"11132","SP","Urânia",9120,23635.22,35001,"Jales",3,"Sudeste",0,"355580",5,5,2,3,0,5,0,0,0,0,0,5,2,3,0,5,8,10.0704932514133,9.11822508306838,0.396777776325784,31
"11133","SP","Urupês",13888,28591.76,35008,"Novo Horizonte",3,"Sudeste",1,"355600",2,11,1,10,0,11,0,0,0,0,0,11,1,10,0,11,6,10.2608738434076,9.53878043690013,0.308817146533875,29
"11134","SP","Urupês",13888,28591.76,35008,"Novo Horizonte",3,"Sudeste",1,"355600",3,9,4,5,1,8,0,0,0,0,0,9,4,5,1,8,7,10.2608738434076,9.53878043690013,0.366478911434281,31
"11135","SP","Urupês",13888,28591.76,35008,"Novo Horizonte",3,"Sudeste",1,"355600",4,4,1,3,1,3,0,0,0,0,0,4,1,3,1,3,6,10.2608738434076,9.53878043690013,0.393140018198781,30
"11136","SP","Urupês",13888,28591.76,35008,"Novo Horizonte",3,"Sudeste",1,"355600",5,19,1,18,3,16,0,0,0,0,0,19,1,18,3,16,7,10.2608738434076,9.53878043690013,0.372661450354086,31
"11137","SP","Valentim Gentil",13532,24770.24,35003,"Votuporanga",3,"Sudeste",0,"355610",2,14,2,12,5,9,0,0,0,0,0,14,2,12,5,9,2,10.1173982115766,9.5128125299006,0.301337335003446,29
"11138","SP","Valentim Gentil",13532,24770.24,35003,"Votuporanga",3,"Sudeste",0,"355610",3,10,0,10,3,7,0,0,0,0,0,10,0,10,3,7,10,10.1173982115766,9.5128125299006,0.358862816335796,31
"11139","SP","Valentim Gentil",13532,24770.24,35003,"Votuporanga",3,"Sudeste",0,"355610",4,16,2,14,7,9,0,0,0,0,0,16,2,14,7,9,6,10.1173982115766,9.5128125299006,0.402820403977946,30
"11140","SP","Valentim Gentil",13532,24770.24,35003,"Votuporanga",3,"Sudeste",0,"355610",5,13,1,12,6,7,0,0,0,0,0,13,1,12,6,7,12,10.1173982115766,9.5128125299006,0.368195459009668,31
"11141","SP","Valinhos",131210,48768.26,35032,"Campinas",3,"Sudeste",1,"355620",2,94,17,77,24,70,0,0,0,0,0,94,17,77,24,70,47,10.7948349703969,11.7845543720998,0.285546732791902,29
"11142","SP","Valinhos",131210,48768.26,35032,"Campinas",3,"Sudeste",1,"355620",3,82,13,69,21,61,0,0,0,0,0,82,13,69,21,61,90,10.7948349703969,11.7845543720998,0.391579023254136,31
"11143","SP","Valinhos",131210,48768.26,35032,"Campinas",3,"Sudeste",1,"355620",4,77,11,66,12,65,1,0,1,0,1,78,11,67,12,66,73,10.7948349703969,11.7845543720998,0.466902485668714,30
"11144","SP","Valinhos",131210,48768.26,35032,"Campinas",3,"Sudeste",1,"355620",5,97,6,91,28,69,0,0,0,0,0,97,6,91,28,69,64,10.7948349703969,11.7845543720998,0.426906911083559,31
"11145","SP","Valparaíso",26822,33427,35017,"Araçatuba",3,"Sudeste",1,"355630",2,17,6,11,8,9,2,0,2,0,2,19,6,13,8,11,15,10.4171192356326,10.1969777252709,0.313459684262258,29
"11146","SP","Valparaíso",26822,33427,35017,"Araçatuba",3,"Sudeste",1,"355630",3,29,4,25,9,20,0,0,0,0,0,29,4,25,9,20,10,10.4171192356326,10.1969777252709,0.394036191948271,31
"11147","SP","Valparaíso",26822,33427,35017,"Araçatuba",3,"Sudeste",1,"355630",4,24,11,13,9,15,0,0,0,0,0,24,11,13,9,15,18,10.4171192356326,10.1969777252709,0.419557282547004,30
"11148","SP","Valparaíso",26822,33427,35017,"Araçatuba",3,"Sudeste",1,"355630",5,24,7,17,7,17,0,0,0,0,0,24,7,17,7,17,12,10.4171192356326,10.1969777252709,0.38951083288755,31
"11149","SP","Vargem",10692,12706.02,35048,"Bragança Paulista",3,"Sudeste",0,"355635",2,8,1,7,5,3,0,0,0,0,0,8,1,7,5,3,2,9.44983117588474,9.27725107725881,0.328254175537804,29
"11150","SP","Vargem",10692,12706.02,35048,"Bragança Paulista",3,"Sudeste",0,"355635",3,7,2,5,1,6,0,0,0,0,0,7,2,5,1,6,6,9.44983117588474,9.27725107725881,0.405888213796247,31
"11151","SP","Vargem",10692,12706.02,35048,"Bragança Paulista",3,"Sudeste",0,"355635",4,10,2,8,3,7,0,0,0,0,0,10,2,8,3,7,3,9.44983117588474,9.27725107725881,0.432216122809202,30
"11152","SP","Vargem",10692,12706.02,35048,"Bragança Paulista",3,"Sudeste",0,"355635",5,10,3,7,4,6,0,0,0,0,0,10,3,7,4,6,4,9.44983117588474,9.27725107725881,0.39770178915085,31
"11153","SP","Vargem Grande do Sul",43110,22882.07,35030,"São João da Boa Vista",3,"Sudeste",1,"355640",2,35,13,22,7,28,0,0,0,0,0,35,13,22,7,28,22,10.0381089134294,10.6715102677412,0.357858788987388,29
"11154","SP","Vargem Grande do Sul",43110,22882.07,35030,"São João da Boa Vista",3,"Sudeste",1,"355640",3,28,8,20,10,18,0,0,0,0,0,28,8,20,10,18,20,10.0381089134294,10.6715102677412,0.442501199989389,31
"11155","SP","Vargem Grande do Sul",43110,22882.07,35030,"São João da Boa Vista",3,"Sudeste",1,"355640",4,39,10,29,13,26,0,0,0,0,0,39,10,29,13,26,25,10.0381089134294,10.6715102677412,0.476024031260575,30
"11156","SP","Vargem Grande do Sul",43110,22882.07,35030,"São João da Boa Vista",3,"Sudeste",1,"355640",5,41,20,21,14,27,0,0,0,0,0,41,20,21,14,27,25,10.0381089134294,10.6715102677412,0.438125881957771,31
"11157","SP","Vargem Grande Paulista",53468,40282.68,35060,"Itapecerica da Serra",3,"Sudeste",1,"355645",2,36,3,33,12,24,1,0,1,0,1,37,3,34,12,25,25,10.6036768788794,10.8868386230914,0.305057502976866,29
"11158","SP","Vargem Grande Paulista",53468,40282.68,35060,"Itapecerica da Serra",3,"Sudeste",1,"355645",3,46,8,38,19,27,1,1,0,0,1,47,9,38,19,28,31,10.6036768788794,10.8868386230914,0.40959951527799,31
"11159","SP","Vargem Grande Paulista",53468,40282.68,35060,"Itapecerica da Serra",3,"Sudeste",1,"355645",4,63,6,57,14,49,0,0,0,0,0,63,6,57,14,49,30,10.6036768788794,10.8868386230914,0.474903851538862,30
"11160","SP","Vargem Grande Paulista",53468,40282.68,35060,"Itapecerica da Serra",3,"Sudeste",1,"355645",5,53,8,45,13,40,1,0,1,0,1,54,8,46,13,41,30,10.6036768788794,10.8868386230914,0.447920478326315,31
"11161","SP","Várzea Paulista",123071,23585.08,35047,"Jundiaí",3,"Sudeste",1,"355650",2,96,14,82,33,63,2,0,2,0,2,98,14,84,33,65,38,10.068369587699,11.7205167035904,0.293904662643602,29
"11162","SP","Várzea Paulista",123071,23585.08,35047,"Jundiaí",3,"Sudeste",1,"355650",3,80,14,66,22,58,1,1,0,1,0,81,15,66,23,58,51,10.068369587699,11.7205167035904,0.393856547397571,31
"11163","SP","Várzea Paulista",123071,23585.08,35047,"Jundiaí",3,"Sudeste",1,"355650",4,115,16,99,42,73,1,0,1,0,1,116,16,100,42,74,45,10.068369587699,11.7205167035904,0.452744861056124,30
"11164","SP","Várzea Paulista",123071,23585.08,35047,"Jundiaí",3,"Sudeste",1,"355650",5,97,16,81,32,65,0,0,0,0,0,97,16,81,32,65,72,10.068369587699,11.7205167035904,0.416622741765876,31
"11165","SP","Vera Cruz",10823,13148.65,35038,"Marília",3,"Sudeste",1,"355660",2,4,0,4,0,4,0,0,0,0,0,4,0,4,0,4,12,9.48407437073889,9.28942877829515,0.275507217205859,29
"11166","SP","Vera Cruz",10823,13148.65,35038,"Marília",3,"Sudeste",1,"355660",3,11,0,11,4,7,1,0,1,1,0,12,0,12,5,7,7,9.48407437073889,9.28942877829515,0.356564023613329,31
"11167","SP","Vera Cruz",10823,13148.65,35038,"Marília",3,"Sudeste",1,"355660",4,7,1,6,3,4,0,0,0,0,0,7,1,6,3,4,10,9.48407437073889,9.28942877829515,0.410168476678697,30
"11168","SP","Vera Cruz",10823,13148.65,35038,"Marília",3,"Sudeste",1,"355660",5,3,0,3,0,3,0,0,0,0,0,3,0,3,0,3,13,9.48407437073889,9.28942877829515,0.392253151394563,31
"11169","SP","Vinhedo",80111,119996.43,35032,"Campinas",3,"Sudeste",1,"355670",2,61,8,53,24,37,0,0,0,0,0,61,8,53,24,37,34,11.6952172713216,11.2911684519674,0.28457232794274,29
"11170","SP","Vinhedo",80111,119996.43,35032,"Campinas",3,"Sudeste",1,"355670",3,65,10,55,24,41,1,0,1,0,1,66,10,56,24,42,41,11.6952172713216,11.2911684519674,0.384156553740398,31
"11171","SP","Vinhedo",80111,119996.43,35032,"Campinas",3,"Sudeste",1,"355670",4,70,8,62,21,49,0,0,0,0,0,70,8,62,21,49,46,11.6952172713216,11.2911684519674,0.456911683910387,30
"11172","SP","Vinhedo",80111,119996.43,35032,"Campinas",3,"Sudeste",1,"355670",5,77,12,65,15,62,0,0,0,0,0,77,12,65,15,62,36,11.6952172713216,11.2911684519674,0.421032116055757,31
"11173","SP","Viradouro",19017,18419.26,35013,"Jaboticabal",3,"Sudeste",1,"355680",2,8,2,6,3,5,0,0,0,0,0,8,2,6,3,5,11,9.8211521352781,9.85308859495228,0.297743086684381,29
"11174","SP","Viradouro",19017,18419.26,35013,"Jaboticabal",3,"Sudeste",1,"355680",3,9,4,5,7,2,0,0,0,0,0,9,4,5,7,2,10,9.8211521352781,9.85308859495228,0.382381190627514,31
"11175","SP","Viradouro",19017,18419.26,35013,"Jaboticabal",3,"Sudeste",1,"355680",4,19,3,16,8,11,1,1,0,0,1,20,4,16,8,12,10,9.8211521352781,9.85308859495228,0.412567524144041,30
"11176","SP","Viradouro",19017,18419.26,35013,"Jaboticabal",3,"Sudeste",1,"355680",5,17,4,13,8,9,0,0,0,0,0,17,4,13,8,9,17,9.8211521352781,9.85308859495228,0.387680151901631,31
"11177","SP","Vista Alegre do Alto",8989,40055.36,35013,"Jaboticabal",3,"Sudeste",0,"355690",2,10,3,7,3,7,1,0,1,0,1,11,3,8,3,8,1,10.5980177762508,9.1037568865734,0.296861771138158,29
"11178","SP","Vista Alegre do Alto",8989,40055.36,35013,"Jaboticabal",3,"Sudeste",0,"355690",3,9,1,8,3,6,0,0,0,0,0,9,1,8,3,6,1,10.5980177762508,9.1037568865734,0.385187292448573,31
"11179","SP","Vista Alegre do Alto",8989,40055.36,35013,"Jaboticabal",3,"Sudeste",0,"355690",4,11,2,9,5,6,0,0,0,0,0,11,2,9,5,6,2,10.5980177762508,9.1037568865734,0.396306681309019,30
"11180","SP","Vista Alegre do Alto",8989,40055.36,35013,"Jaboticabal",3,"Sudeste",0,"355690",5,8,2,6,0,8,0,0,0,0,0,8,2,6,0,8,3,10.5980177762508,9.1037568865734,0.360587619560165,31
"11181","SP","Votorantim",123599,25495.29,35046,"Sorocaba",3,"Sudeste",1,"355700",2,120,19,101,42,78,1,0,1,0,1,121,19,102,42,79,57,10.1462490082039,11.7247977333581,0.286394493613702,29
"11182","SP","Votorantim",123599,25495.29,35046,"Sorocaba",3,"Sudeste",1,"355700",3,127,13,114,48,79,1,0,1,0,1,128,13,115,48,80,66,10.1462490082039,11.7247977333581,0.395009142128489,31
"11183","SP","Votorantim",123599,25495.29,35046,"Sorocaba",3,"Sudeste",1,"355700",4,106,11,95,40,66,2,0,2,2,0,108,11,97,42,66,51,10.1462490082039,11.7247977333581,0.459816666517617,30
"11184","SP","Votorantim",123599,25495.29,35046,"Sorocaba",3,"Sudeste",1,"355700",5,168,26,142,58,110,0,0,0,0,0,168,26,142,58,110,75,10.1462490082039,11.7247977333581,0.419578163599933,31
"11185","SP","Votuporanga",95338,31244,35003,"Votuporanga",3,"Sudeste",1,"355710",2,77,10,67,22,55,1,0,1,1,0,78,10,68,23,55,56,10.3495826367302,11.4651837509848,0.294270931136613,29
"11186","SP","Votuporanga",95338,31244,35003,"Votuporanga",3,"Sudeste",1,"355710",3,87,13,74,23,64,0,0,0,0,0,87,13,74,23,64,49,10.3495826367302,11.4651837509848,0.378668685303864,31
"11187","SP","Votuporanga",95338,31244,35003,"Votuporanga",3,"Sudeste",1,"355710",4,99,13,86,20,79,0,0,0,0,0,99,13,86,20,79,68,10.3495826367302,11.4651837509848,0.423089880783013,30
"11188","SP","Votuporanga",95338,31244,35003,"Votuporanga",3,"Sudeste",1,"355710",5,96,8,88,26,70,0,0,0,0,0,96,8,88,26,70,57,10.3495826367302,11.4651837509848,0.392010746351947,31
"11189","SP","Chavantes",12418,16706.08,35040,"Ourinhos",3,"Sudeste",0,"355720",2,15,4,11,5,10,0,0,0,0,0,15,4,11,5,10,7,9.72352800400306,9.42690231192484,0.306794082780267,29
"11190","SP","Chavantes",12418,16706.08,35040,"Ourinhos",3,"Sudeste",0,"355720",3,10,4,6,6,4,0,0,0,0,0,10,4,6,6,4,11,9.72352800400306,9.42690231192484,0.389362694784121,31
"11191","SP","Chavantes",12418,16706.08,35040,"Ourinhos",3,"Sudeste",0,"355720",4,11,4,7,7,4,0,0,0,0,0,11,4,7,7,4,2,9.72352800400306,9.42690231192484,0.435396898439687,30
"11192","SP","Chavantes",12418,16706.08,35040,"Ourinhos",3,"Sudeste",0,"355720",5,14,3,11,4,10,1,1,0,1,0,15,4,11,5,10,10,9.72352800400306,9.42690231192484,0.427870483232614,31
"11193","SP","Estiva Gerbi",11407,29883.47,35031,"Mogi Mirim",3,"Sudeste",1,"355730",2,14,2,12,3,11,0,0,0,0,0,14,2,12,3,11,5,10.3050607636955,9.3419824810279,0.324008268031979,29
"11194","SP","Estiva Gerbi",11407,29883.47,35031,"Mogi Mirim",3,"Sudeste",1,"355730",3,7,1,6,2,5,0,0,0,0,0,7,1,6,2,5,8,10.3050607636955,9.3419824810279,0.416676306572707,31
"11195","SP","Estiva Gerbi",11407,29883.47,35031,"Mogi Mirim",3,"Sudeste",1,"355730",4,12,2,10,5,7,0,0,0,0,0,12,2,10,5,7,4,10.3050607636955,9.3419824810279,0.451924057342697,30
"11196","SP","Estiva Gerbi",11407,29883.47,35031,"Mogi Mirim",3,"Sudeste",1,"355730",5,13,3,10,4,9,0,0,0,0,0,13,3,10,4,9,6,10.3050607636955,9.3419824810279,0.437715104592828,31
"11197","PR","Agudos do Sul",9470,22087.81,41039,"Rio Negro",4,"Sul",0,"410030",2,6,5,1,2,4,0,0,0,0,0,6,5,1,2,4,2,10.0027811516172,9.15588418618012,0.358507082512678,29
"11198","PR","Agudos do Sul",9470,22087.81,41039,"Rio Negro",4,"Sul",0,"410030",3,5,1,4,2,3,0,0,0,0,0,5,1,4,2,3,7,10.0027811516172,9.15588418618012,0.450008941500647,31
"11199","PR","Agudos do Sul",9470,22087.81,41039,"Rio Negro",4,"Sul",0,"410030",4,11,4,7,7,4,0,0,0,0,0,11,4,7,7,4,8,10.0027811516172,9.15588418618012,0.461313048507273,30
"11200","PR","Agudos do Sul",9470,22087.81,41039,"Rio Negro",4,"Sul",0,"410030",5,12,5,7,5,7,0,0,0,0,0,12,5,7,5,7,4,10.0027811516172,9.15588418618012,0.446775273650989,31
"11201","PR","Almirante Tamandaré",120041,13168.04,41037,"Curitiba",4,"Sul",1,"410040",2,93,21,72,43,50,0,0,0,0,0,93,21,72,43,50,66,9.48554796057931,11.6955886300761,0.301351083440464,29
"11202","PR","Almirante Tamandaré",120041,13168.04,41037,"Curitiba",4,"Sul",1,"410040",3,138,48,90,64,74,1,1,0,0,1,139,49,90,64,75,57,9.48554796057931,11.6955886300761,0.395234308691641,31
"11203","PR","Almirante Tamandaré",120041,13168.04,41037,"Curitiba",4,"Sul",1,"410040",4,123,38,85,54,69,1,0,1,0,1,124,38,86,54,70,46,9.48554796057931,11.6955886300761,0.446658606354115,30
"11204","PR","Almirante Tamandaré",120041,13168.04,41037,"Curitiba",4,"Sul",1,"410040",5,110,34,76,48,62,1,0,1,0,1,111,34,77,48,63,68,9.48554796057931,11.6955886300761,0.403349135561536,31
"11205","PR","Altônia",22176,17248.08,41002,"Umuarama",4,"Sul",0,"410050",2,15,6,9,5,10,0,0,0,0,0,15,6,9,5,10,12,9.75545611191689,10.0067659019896,0.322787981551324,29
"11206","PR","Altônia",22176,17248.08,41002,"Umuarama",4,"Sul",0,"410050",3,15,3,12,7,8,0,0,0,0,0,15,3,12,7,8,21,9.75545611191689,10.0067659019896,0.419260025602093,31
"11207","PR","Altônia",22176,17248.08,41002,"Umuarama",4,"Sul",0,"410050",4,23,2,21,6,17,0,0,0,0,0,23,2,21,6,17,20,9.75545611191689,10.0067659019896,0.42290858063482,30
"11208","PR","Altônia",22176,17248.08,41002,"Umuarama",4,"Sul",0,"410050",5,20,3,17,6,14,0,0,0,0,0,20,3,17,6,14,21,9.75545611191689,10.0067659019896,0.398218313952052,31
"11209","PR","Alto Paraná",14859,22430.78,41001,"Paranavaí",4,"Sul",0,"410060",2,16,2,14,4,12,0,0,0,0,0,16,2,14,4,12,14,10.0181894017647,9.60636102125635,0.277151549466953,29
"11210","PR","Alto Paraná",14859,22430.78,41001,"Paranavaí",4,"Sul",0,"410060",3,13,3,10,8,5,0,0,0,0,0,13,3,10,8,5,12,10.0181894017647,9.60636102125635,0.364409718008953,31
"11211","PR","Alto Paraná",14859,22430.78,41001,"Paranavaí",4,"Sul",0,"410060",4,18,4,14,7,11,0,0,0,0,0,18,4,14,7,11,11,10.0181894017647,9.60636102125635,0.396208979655466,30
"11212","PR","Alto Paraná",14859,22430.78,41001,"Paranavaí",4,"Sul",0,"410060",5,26,6,20,9,17,0,0,0,0,0,26,6,20,9,17,17,10.0181894017647,9.60636102125635,0.369687973630503,31
"11213","PR","Alto Piquiri",9778,30900,41002,"Umuarama",4,"Sul",0,"410070",2,10,1,9,1,9,0,0,0,0,0,10,1,9,1,9,11,10.3385114628858,9.18789024313859,0.286096174471421,29
"11214","PR","Alto Piquiri",9778,30900,41002,"Umuarama",4,"Sul",0,"410070",3,12,2,10,4,8,0,0,0,0,0,12,2,10,4,8,13,10.3385114628858,9.18789024313859,0.419119002716691,31
"11215","PR","Alto Piquiri",9778,30900,41002,"Umuarama",4,"Sul",0,"410070",4,9,4,5,3,6,0,0,0,0,0,9,4,5,3,6,8,10.3385114628858,9.18789024313859,0.438200061345414,30
"11216","PR","Alto Piquiri",9778,30900,41002,"Umuarama",4,"Sul",0,"410070",5,18,2,16,9,9,0,0,0,0,0,18,2,16,9,9,9,10.3385114628858,9.18789024313859,0.377416891911774,31
"11217","PR","Alvorada do Sul",11503,23481.5,41007,"Porecatu",4,"Sul",0,"410080",2,7,2,5,3,4,0,0,0,0,0,7,2,5,3,4,7,10.0639681560583,9.35036314989601,0.338050140468497,29
"11218","PR","Alvorada do Sul",11503,23481.5,41007,"Porecatu",4,"Sul",0,"410080",3,14,3,11,4,10,0,0,0,0,0,14,3,11,4,10,16,10.0639681560583,9.35036314989601,0.385191757511901,31
"11219","PR","Alvorada do Sul",11503,23481.5,41007,"Porecatu",4,"Sul",0,"410080",4,10,1,9,4,6,0,0,0,0,0,10,1,9,4,6,9,10.0639681560583,9.35036314989601,0.404245834407576,30
"11220","PR","Alvorada do Sul",11503,23481.5,41007,"Porecatu",4,"Sul",0,"410080",5,5,2,3,0,5,0,0,0,0,0,5,2,3,0,5,8,10.0639681560583,9.35036314989601,0.38355214965395,31
"11221","PR","Ampére",19311,31922.65,41025,"Capanema",4,"Sul",1,"410100",2,18,4,14,8,10,1,0,1,1,0,19,4,15,9,10,8,10.3710710681679,9.86843016072073,0.296846828154162,29
"11222","PR","Ampére",19311,31922.65,41025,"Capanema",4,"Sul",1,"410100",3,19,6,13,5,14,0,0,0,0,0,19,6,13,5,14,16,10.3710710681679,9.86843016072073,0.413878134289367,31
"11223","PR","Ampére",19311,31922.65,41025,"Capanema",4,"Sul",1,"410100",4,22,4,18,6,16,0,0,0,0,0,22,4,18,6,16,11,10.3710710681679,9.86843016072073,0.400587684878207,30
"11224","PR","Ampére",19311,31922.65,41025,"Capanema",4,"Sul",1,"410100",5,20,5,15,9,11,0,0,0,0,0,20,5,15,9,11,9,10.3710710681679,9.86843016072073,0.408562758578863,31
"11225","PR","Andirá",19926,37115.48,41015,"Cornélio Procópio",4,"Sul",1,"410110",2,19,2,17,7,12,0,0,0,0,0,19,2,17,7,12,5,10.5217894122445,9.8997806906048,0.301166488537147,29
"11226","PR","Andirá",19926,37115.48,41015,"Cornélio Procópio",4,"Sul",1,"410110",3,17,2,15,6,11,0,0,0,0,0,17,2,15,6,11,17,10.5217894122445,9.8997806906048,0.371762097965425,31
"11227","PR","Andirá",19926,37115.48,41015,"Cornélio Procópio",4,"Sul",1,"410110",4,18,5,13,6,12,0,0,0,0,0,18,5,13,6,12,17,10.5217894122445,9.8997806906048,0.398397733721917,30
"11228","PR","Andirá",19926,37115.48,41015,"Cornélio Procópio",4,"Sul",1,"410110",5,10,2,8,2,8,0,0,0,0,0,10,2,8,2,8,16,10.5217894122445,9.8997806906048,0.38361129317984,31
"11229","PR","Ângulo",2930,38937.19,41006,"Astorga",4,"Sul",0,"410115",2,2,1,1,0,2,0,0,0,0,0,2,1,1,0,2,4,10.5697051140214,7.98275770201111,0.339466108734391,29
"11230","PR","Ângulo",2930,38937.19,41006,"Astorga",4,"Sul",0,"410115",3,3,1,2,0,3,0,0,0,0,0,3,1,2,0,3,3,10.5697051140214,7.98275770201111,0.430088567550624,31
"11231","PR","Ângulo",2930,38937.19,41006,"Astorga",4,"Sul",0,"410115",4,4,1,3,1,3,0,0,0,0,0,4,1,3,1,3,1,10.5697051140214,7.98275770201111,0.404970323451612,30
"11232","PR","Ângulo",2930,38937.19,41006,"Astorga",4,"Sul",0,"410115",5,4,1,3,2,2,0,0,0,0,0,4,1,3,2,2,3,10.5697051140214,7.98275770201111,0.369793129160427,31
"11233","PR","Antonina",18949,28312.72,41038,"Paranaguá",4,"Sul",0,"410120",2,14,7,7,8,6,0,0,0,0,0,14,7,7,8,6,8,10.2510664526146,9.84950643866961,0.336293394864838,29
"11234","PR","Antonina",18949,28312.72,41038,"Paranaguá",4,"Sul",0,"410120",3,10,6,4,4,6,0,0,0,0,0,10,6,4,4,6,9,10.2510664526146,9.84950643866961,0.423037918080743,31
"11235","PR","Antonina",18949,28312.72,41038,"Paranaguá",4,"Sul",0,"410120",4,19,7,12,9,10,0,0,0,0,0,19,7,12,9,10,11,10.2510664526146,9.84950643866961,0.434563446484604,30
"11236","PR","Antonina",18949,28312.72,41038,"Paranaguá",4,"Sul",0,"410120",5,24,7,17,10,14,1,1,0,1,0,25,8,17,11,14,11,10.2510664526146,9.84950643866961,0.4346051250811,31
"11237","PR","Apucarana",136234,23315.61,41010,"Apucarana",4,"Sul",1,"410140",2,109,18,91,39,70,1,1,0,0,1,110,19,91,39,71,79,10.0568783723143,11.8221292744372,0.313056917669268,29
"11238","PR","Apucarana",136234,23315.61,41010,"Apucarana",4,"Sul",1,"410140",3,139,31,108,50,89,1,0,1,0,1,140,31,109,50,90,81,10.0568783723143,11.8221292744372,0.404742510263593,31
"11239","PR","Apucarana",136234,23315.61,41010,"Apucarana",4,"Sul",1,"410140",4,129,22,107,40,89,0,0,0,0,0,129,22,107,40,89,65,10.0568783723143,11.8221292744372,0.452434190154589,30
"11240","PR","Apucarana",136234,23315.61,41010,"Apucarana",4,"Sul",1,"410140",5,128,32,96,33,95,1,0,1,0,1,129,32,97,33,96,55,10.0568783723143,11.8221292744372,0.397123665724788,31
"11241","PR","Arapongas",124810,35440.69,41010,"Apucarana",4,"Sul",1,"410150",2,121,24,97,44,77,1,0,1,1,0,122,24,98,45,77,37,10.4756158740554,11.7345478599125,0.305043777064526,29
"11242","PR","Arapongas",124810,35440.69,41010,"Apucarana",4,"Sul",1,"410150",3,119,18,101,33,86,2,1,1,1,1,121,19,102,34,87,67,10.4756158740554,11.7345478599125,0.386173564071291,31
"11243","PR","Arapongas",124810,35440.69,41010,"Apucarana",4,"Sul",1,"410150",4,117,31,86,35,82,0,0,0,0,0,117,31,86,35,82,60,10.4756158740554,11.7345478599125,0.430378589049566,30
"11244","PR","Arapongas",124810,35440.69,41010,"Apucarana",4,"Sul",1,"410150",5,116,25,91,34,82,0,0,0,0,0,116,25,91,34,82,74,10.4756158740554,11.7345478599125,0.372898350776806,31
"11245","PR","Arapoti",28300,41056.91,41020,"Jaguariaíva",4,"Sul",1,"410160",2,21,5,16,9,12,1,0,1,1,0,22,5,17,10,12,15,10.6227144320177,10.2506170836313,0.365307707879348,29
"11246","PR","Arapoti",28300,41056.91,41020,"Jaguariaíva",4,"Sul",1,"410160",3,28,7,21,14,14,0,0,0,0,0,28,7,21,14,14,13,10.6227144320177,10.2506170836313,0.442246113265149,31
"11247","PR","Arapoti",28300,41056.91,41020,"Jaguariaíva",4,"Sul",1,"410160",4,28,8,20,18,10,1,0,1,1,0,29,8,21,19,10,8,10.6227144320177,10.2506170836313,0.453861961728616,30
"11248","PR","Arapoti",28300,41056.91,41020,"Jaguariaíva",4,"Sul",1,"410160",5,36,11,25,16,20,0,0,0,0,0,36,11,25,16,20,11,10.6227144320177,10.2506170836313,0.441617177683378,31
"11249","PR","Araruna",14000,32538.31,41005,"Campo Mourão",4,"Sul",0,"410170",2,15,3,12,6,9,0,0,0,0,0,15,3,12,6,9,11,10.3901734433456,9.5468126085974,0.333442283536556,29
"11250","PR","Araruna",14000,32538.31,41005,"Campo Mourão",4,"Sul",0,"410170",3,20,0,20,2,18,0,0,0,0,0,20,0,20,2,18,4,10.3901734433456,9.5468126085974,0.436415863226458,31
"11251","PR","Araruna",14000,32538.31,41005,"Campo Mourão",4,"Sul",0,"410170",4,14,3,11,5,9,0,0,0,0,0,14,3,11,5,9,9,10.3901734433456,9.5468126085974,0.483844512144779,30
"11252","PR","Araruna",14000,32538.31,41005,"Campo Mourão",4,"Sul",0,"410170",5,12,4,8,4,8,0,0,0,0,0,12,4,8,4,8,10,10.3901734433456,9.5468126085974,0.422493451007973,31
"11253","PR","Araucária",146214,116046.97,41037,"Curitiba",4,"Sul",1,"410180",2,156,31,125,55,101,0,0,0,0,0,156,31,125,55,101,59,11.6617503019261,11.8928265809471,0.303482271859039,29
"11254","PR","Araucária",146214,116046.97,41037,"Curitiba",4,"Sul",1,"410180",3,194,36,158,63,131,2,0,2,1,1,196,36,160,64,132,57,11.6617503019261,11.8928265809471,0.396349847805918,31
"11255","PR","Araucária",146214,116046.97,41037,"Curitiba",4,"Sul",1,"410180",4,150,38,112,52,98,1,0,1,0,1,151,38,113,52,99,64,11.6617503019261,11.8928265809471,0.441716610643025,30
"11256","PR","Araucária",146214,116046.97,41037,"Curitiba",4,"Sul",1,"410180",5,185,39,146,59,126,0,0,0,0,0,185,39,146,59,126,57,11.6617503019261,11.8928265809471,0.396783466252975,31
"11257","PR","Assaí",14954,25938.66,41014,"Assaí",4,"Sul",1,"410190",2,8,1,7,2,6,0,0,0,0,0,8,1,7,2,6,16,10.1634897988646,9.61273410155986,0.306164252868947,29
"11258","PR","Assaí",14954,25938.66,41014,"Assaí",4,"Sul",1,"410190",3,9,1,8,5,4,0,0,0,0,0,9,1,8,5,4,16,10.1634897988646,9.61273410155986,0.408519507200135,31
"11259","PR","Assaí",14954,25938.66,41014,"Assaí",4,"Sul",1,"410190",4,13,4,9,6,7,0,0,0,0,0,13,4,9,6,7,6,10.1634897988646,9.61273410155986,0.423616841631544,30
"11260","PR","Assaí",14954,25938.66,41014,"Assaí",4,"Sul",1,"410190",5,15,1,14,7,8,0,0,0,0,0,15,1,14,7,8,13,10.1634897988646,9.61273410155986,0.408856932973235,31
"11261","PR","Assis Chateaubriand",33340,36800.41,41022,"Toledo",4,"Sul",0,"410200",2,30,11,19,10,20,1,0,1,1,0,31,11,20,11,20,30,10.5132642653993,10.4145131563048,0.317628454672402,29
"11262","PR","Assis Chateaubriand",33340,36800.41,41022,"Toledo",4,"Sul",0,"410200",3,34,12,22,16,18,0,0,0,0,0,34,12,22,16,18,33,10.5132642653993,10.4145131563048,0.415212366057369,31
"11263","PR","Assis Chateaubriand",33340,36800.41,41022,"Toledo",4,"Sul",0,"410200",4,37,7,30,12,25,1,1,0,0,1,38,8,30,12,26,28,10.5132642653993,10.4145131563048,0.447936472978732,30
"11264","PR","Assis Chateaubriand",33340,36800.41,41022,"Toledo",4,"Sul",0,"410200",5,29,8,21,9,20,0,0,0,0,0,29,8,21,9,20,26,10.5132642653993,10.4145131563048,0.399595103897035,31
"11265","PR","Astorga",26209,29141.11,41006,"Astorga",4,"Sul",1,"410210",2,23,3,20,8,15,0,0,0,0,0,23,3,20,8,15,16,10.2799051709935,10.173858142213,0.294541707410388,29
"11266","PR","Astorga",26209,29141.11,41006,"Astorga",4,"Sul",1,"410210",3,21,4,17,6,15,0,0,0,0,0,21,4,17,6,15,20,10.2799051709935,10.173858142213,0.375694595996434,31
"11267","PR","Astorga",26209,29141.11,41006,"Astorga",4,"Sul",1,"410210",4,24,4,20,8,16,0,0,0,0,0,24,4,20,8,16,17,10.2799051709935,10.173858142213,0.399204341656427,30
"11268","PR","Astorga",26209,29141.11,41006,"Astorga",4,"Sul",1,"410210",5,28,6,22,9,19,0,0,0,0,0,28,6,22,9,19,17,10.2799051709935,10.173858142213,0.361570530857228,31
"11269","PR","Atalaia",3881,35008.12,41006,"Astorga",4,"Sul",0,"410220",2,2,0,2,0,2,0,0,0,0,0,2,0,2,0,2,1,10.4633353135637,8.26384813136891,0.29386583623794,29
"11270","PR","Atalaia",3881,35008.12,41006,"Astorga",4,"Sul",0,"410220",3,3,0,3,0,3,0,0,0,0,0,3,0,3,0,3,1,10.4633353135637,8.26384813136891,0.357167465112365,31
"11271","PR","Atalaia",3881,35008.12,41006,"Astorga",4,"Sul",0,"410220",4,4,0,4,1,3,0,0,0,0,0,4,0,4,1,3,3,10.4633353135637,8.26384813136891,0.361337209379106,30
"11272","PR","Atalaia",3881,35008.12,41006,"Astorga",4,"Sul",0,"410220",5,0,0,0,0,0,0,0,0,0,0,0,0,0,0,0,2,10.4633353135637,8.26384813136891,0.338882569666036,31
"11273","PR","Balsa Nova",13092,53915.82,41037,"Curitiba",4,"Sul",1,"410230",2,10,4,6,4,6,1,0,1,0,1,11,4,7,4,7,9,10.895179220326,9.47975663562107,0.304395603949841,29
"11274","PR","Balsa Nova",13092,53915.82,41037,"Curitiba",4,"Sul",1,"410230",3,16,6,10,5,11,0,0,0,0,0,16,6,10,5,11,4,10.895179220326,9.47975663562107,0.390113971145717,31
"11275","PR","Balsa Nova",13092,53915.82,41037,"Curitiba",4,"Sul",1,"410230",4,17,3,14,6,11,0,0,0,0,0,17,3,14,6,11,4,10.895179220326,9.47975663562107,0.423780685879187,30
"11276","PR","Balsa Nova",13092,53915.82,41037,"Curitiba",4,"Sul",1,"410230",5,9,4,5,4,5,0,0,0,0,0,9,4,5,4,5,10,10.895179220326,9.47975663562107,0.401221863302034,31
"11277","PR","Bandeirantes",31211,24859.03,41015,"Cornélio Procópio",4,"Sul",1,"410240",2,22,6,16,9,13,0,0,0,0,0,22,6,16,9,13,17,10.1209763457998,10.348525875764,0.309196553841811,29
"11278","PR","Bandeirantes",31211,24859.03,41015,"Cornélio Procópio",4,"Sul",1,"410240",3,33,7,26,10,23,0,0,0,0,0,33,7,26,10,23,23,10.1209763457998,10.348525875764,0.394941742208523,31
"11279","PR","Bandeirantes",31211,24859.03,41015,"Cornélio Procópio",4,"Sul",1,"410240",4,27,4,23,8,19,0,0,0,0,0,27,4,23,8,19,16,10.1209763457998,10.348525875764,0.443908955458138,30
"11280","PR","Bandeirantes",31211,24859.03,41015,"Cornélio Procópio",4,"Sul",1,"410240",5,29,9,20,10,19,0,0,0,0,0,29,9,20,10,19,15,10.1209763457998,10.348525875764,0.395950926048883,31
"11281","PR","Barbosa Ferraz",11426,17993.5,41005,"Campo Mourão",4,"Sul",0,"410250",2,13,3,10,7,6,0,0,0,0,0,13,3,10,7,6,16,9.79776586055087,9.34364673928441,0.31067775295315,29
"11282","PR","Barbosa Ferraz",11426,17993.5,41005,"Campo Mourão",4,"Sul",0,"410250",3,9,5,4,0,9,0,0,0,0,0,9,5,4,0,9,13,9.79776586055087,9.34364673928441,0.379119020923512,31
"11283","PR","Barbosa Ferraz",11426,17993.5,41005,"Campo Mourão",4,"Sul",0,"410250",4,12,1,11,6,6,0,0,0,0,0,12,1,11,6,6,8,9.79776586055087,9.34364673928441,0.410040884882456,30
"11284","PR","Barbosa Ferraz",11426,17993.5,41005,"Campo Mourão",4,"Sul",0,"410250",5,11,2,9,4,7,0,0,0,0,0,11,2,9,4,7,12,9.79776586055087,9.34364673928441,0.365525663294615,31
"11285","PR","Barracão",10312,24067.18,41026,"Francisco Beltrão",4,"Sul",0,"410260",2,5,1,4,2,3,0,0,0,0,0,5,1,4,2,3,4,10.0886043656252,9.24106354461902,0.318592229008003,29
"11286","PR","Barracão",10312,24067.18,41026,"Francisco Beltrão",4,"Sul",0,"410260",3,8,3,5,5,3,0,0,0,0,0,8,3,5,5,3,6,10.0886043656252,9.24106354461902,0.434077905802441,31
"11287","PR","Barracão",10312,24067.18,41026,"Francisco Beltrão",4,"Sul",0,"410260",4,9,2,7,2,7,0,0,0,0,0,9,2,7,2,7,5,10.0886043656252,9.24106354461902,0.443118148862776,30
"11288","PR","Barracão",10312,24067.18,41026,"Francisco Beltrão",4,"Sul",0,"410260",5,10,2,8,6,4,1,0,1,0,1,11,2,9,6,5,2,10.0886043656252,9.24106354461902,0.403592614354682,31
"11289","PR","Bela Vista do Paraíso",15399,29495.52,41007,"Porecatu",4,"Sul",1,"410280",2,13,5,8,5,8,0,0,0,0,0,13,5,8,5,8,11,10.2919936663886,9.64205785122841,0.301430630034196,29
"11290","PR","Bela Vista do Paraíso",15399,29495.52,41007,"Porecatu",4,"Sul",1,"410280",3,7,1,6,1,6,0,0,0,0,0,7,1,6,1,6,8,10.2919936663886,9.64205785122841,0.387885436490651,31
"11291","PR","Bela Vista do Paraíso",15399,29495.52,41007,"Porecatu",4,"Sul",1,"410280",4,21,6,15,6,15,0,0,0,0,0,21,6,15,6,15,8,10.2919936663886,9.64205785122841,0.411919801783294,30
"11292","PR","Bela Vista do Paraíso",15399,29495.52,41007,"Porecatu",4,"Sul",1,"410280",5,21,8,13,9,12,0,0,0,0,0,21,8,13,9,12,9,10.2919936663886,9.64205785122841,0.366088838773385,31
"11293","PR","Bituruna",16400,22965.66,41033,"União da Vitória",4,"Sul",0,"410290",2,17,9,8,7,10,0,0,0,0,0,17,9,8,7,10,3,10.0417553357329,9.70503661381229,0.340492851801913,29
"11294","PR","Bituruna",16400,22965.66,41033,"União da Vitória",4,"Sul",0,"410290",3,26,9,17,10,16,0,0,0,0,0,26,9,17,10,16,9,10.0417553357329,9.70503661381229,0.418658535555429,31
"11295","PR","Bituruna",16400,22965.66,41033,"União da Vitória",4,"Sul",0,"410290",4,19,3,16,13,6,0,0,0,0,0,19,3,16,13,6,13,10.0417553357329,9.70503661381229,0.430197054357429,30
"11296","PR","Bituruna",16400,22965.66,41033,"União da Vitória",4,"Sul",0,"410290",5,23,7,16,13,10,1,1,0,1,0,24,8,16,14,10,11,10.0417553357329,9.70503661381229,0.412813175693198,31
"11297","PR","Boa Vista da Aparecida",7540,18345.91,41023,"Cascavel",4,"Sul",0,"410305",2,12,2,10,7,5,0,0,0,0,0,12,2,10,7,5,7,9.81716194035605,8.927977461002,0.340454001006921,29
"11298","PR","Boa Vista da Aparecida",7540,18345.91,41023,"Cascavel",4,"Sul",0,"410305",3,9,4,5,3,6,0,0,0,0,0,9,4,5,3,6,4,9.81716194035605,8.927977461002,0.408629089229487,31
"11299","PR","Boa Vista da Aparecida",7540,18345.91,41023,"Cascavel",4,"Sul",0,"410305",4,11,3,8,6,5,0,0,0,0,0,11,3,8,6,5,2,9.81716194035605,8.927977461002,0.405695108118752,30
"11300","PR","Boa Vista da Aparecida",7540,18345.91,41023,"Cascavel",4,"Sul",0,"410305",5,13,3,10,5,8,0,0,0,0,0,13,3,10,5,8,6,9.81716194035605,8.927977461002,0.427282124130747,31
"11301","PR","Bocaiúva do Sul",13129,15505.64,41037,"Curitiba",4,"Sul",1,"410310",2,18,11,7,6,12,1,0,1,0,1,19,11,8,6,13,7,9.64895910769009,9.48257880293411,0.295258065746672,29
"11302","PR","Bocaiúva do Sul",13129,15505.64,41037,"Curitiba",4,"Sul",1,"410310",3,22,11,11,13,9,0,0,0,0,0,22,11,11,13,9,7,9.64895910769009,9.48257880293411,0.390910050234,31
"11303","PR","Bocaiúva do Sul",13129,15505.64,41037,"Curitiba",4,"Sul",1,"410310",4,11,7,4,4,7,0,0,0,0,0,11,7,4,4,7,9,9.64895910769009,9.48257880293411,0.418017228443376,30
"11304","PR","Bocaiúva do Sul",13129,15505.64,41037,"Curitiba",4,"Sul",1,"410310",5,16,11,5,6,10,0,0,0,0,0,16,11,5,6,10,7,9.64895910769009,9.48257880293411,0.401223083258436,31
"11305","PR","Bom Sucesso",7068,16424.65,41012,"Faxinal",4,"Sul",0,"410320",2,3,2,1,0,3,0,0,0,0,0,3,2,1,0,3,4,9.70653853414556,8.86333283343959,0.31356961915002,29
"11306","PR","Bom Sucesso",7068,16424.65,41012,"Faxinal",4,"Sul",0,"410320",3,5,1,4,2,3,0,0,0,0,0,5,1,4,2,3,5,9.70653853414556,8.86333283343959,0.358095425848677,31
"11307","PR","Bom Sucesso",7068,16424.65,41012,"Faxinal",4,"Sul",0,"410320",4,3,2,1,3,0,0,0,0,0,0,3,2,1,3,0,5,9.70653853414556,8.86333283343959,0.386955524289516,30
"11308","PR","Bom Sucesso",7068,16424.65,41012,"Faxinal",4,"Sul",0,"410320",5,9,3,6,6,3,0,0,0,0,0,9,3,6,6,3,2,9.70653853414556,8.86333283343959,0.374966194581854,31
"11309","PR","Borrazópolis",6439,31389.44,41012,"Faxinal",4,"Sul",0,"410330",2,4,1,3,1,3,0,0,0,0,0,4,1,3,1,3,1,10.3542268096004,8.77012852753818,0.302882456149769,29
"11310","PR","Borrazópolis",6439,31389.44,41012,"Faxinal",4,"Sul",0,"410330",3,5,1,4,3,2,0,0,0,0,0,5,1,4,3,2,4,10.3542268096004,8.77012852753818,0.368100300269498,31
"11311","PR","Borrazópolis",6439,31389.44,41012,"Faxinal",4,"Sul",0,"410330",4,6,1,5,4,2,0,0,0,0,0,6,1,5,4,2,4,10.3542268096004,8.77012852753818,0.418347920979734,30
"11312","PR","Borrazópolis",6439,31389.44,41012,"Faxinal",4,"Sul",0,"410330",5,5,2,3,1,4,0,0,0,0,0,5,2,3,1,4,7,10.3542268096004,8.77012852753818,0.371522913754092,31
"11313","PR","Cafelândia",18456,77661.71,41023,"Cascavel",4,"Sul",1,"410345",2,22,7,15,10,12,0,0,0,0,0,22,7,15,10,12,11,11.2601176221007,9.82314479985359,0.340616783230048,29
"11314","PR","Cafelândia",18456,77661.71,41023,"Cascavel",4,"Sul",1,"410345",3,26,7,19,6,20,1,0,1,0,1,27,7,20,6,21,6,11.2601176221007,9.82314479985359,0.413121614018482,31
"11315","PR","Cafelândia",18456,77661.71,41023,"Cascavel",4,"Sul",1,"410345",4,25,5,20,11,14,0,0,0,0,0,25,5,20,11,14,9,11.2601176221007,9.82314479985359,0.429415905660434,30
"11316","PR","Cafelândia",18456,77661.71,41023,"Cascavel",4,"Sul",1,"410345",5,28,11,17,9,19,1,1,0,0,1,29,12,17,9,20,4,11.2601176221007,9.82314479985359,0.40752356588799,31
"11317","PR","Califórnia",8606,20864.61,41010,"Apucarana",4,"Sul",0,"410350",2,9,1,8,3,6,0,0,0,0,0,9,1,8,3,6,5,9.94580970126218,9.06021491339854,0.285337591453797,29
"11318","PR","Califórnia",8606,20864.61,41010,"Apucarana",4,"Sul",0,"410350",3,7,2,5,2,5,0,0,0,0,0,7,2,5,2,5,5,9.94580970126218,9.06021491339854,0.339434321254357,31
"11319","PR","Califórnia",8606,20864.61,41010,"Apucarana",4,"Sul",0,"410350",4,13,2,11,3,10,0,0,0,0,0,13,2,11,3,10,6,9.94580970126218,9.06021491339854,0.380020475703387,30
"11320","PR","Califórnia",8606,20864.61,41010,"Apucarana",4,"Sul",0,"410350",5,10,3,7,4,6,0,0,0,0,0,10,3,7,4,6,10,9.94580970126218,9.06021491339854,0.348188999223818,31
"11321","PR","Cambará",25466,28586.57,41016,"Jacarezinho",4,"Sul",1,"410360",2,17,7,10,8,9,0,0,0,0,0,17,7,10,8,9,20,10.260692306101,10.1450995081334,0.317816332375647,29
"11322","PR","Cambará",25466,28586.57,41016,"Jacarezinho",4,"Sul",1,"410360",3,18,6,12,6,12,0,0,0,0,0,18,6,12,6,12,18,10.260692306101,10.1450995081334,0.385027431336034,31
"11323","PR","Cambará",25466,28586.57,41016,"Jacarezinho",4,"Sul",1,"410360",4,21,6,15,6,15,0,0,0,0,0,21,6,15,6,15,24,10.260692306101,10.1450995081334,0.434389435398943,30
"11324","PR","Cambará",25466,28586.57,41016,"Jacarezinho",4,"Sul",1,"410360",5,25,8,17,12,13,0,0,0,0,0,25,8,17,12,13,15,10.260692306101,10.1450995081334,0.407906598026522,31
"11325","PR","Cambé",107341,36311.28,41011,"Londrina",4,"Sul",1,"410370",2,96,18,78,41,55,1,0,1,0,1,97,18,79,41,56,51,10.4998837157837,11.583765961879,0.294247284204839,29
"11326","PR","Cambé",107341,36311.28,41011,"Londrina",4,"Sul",1,"410370",3,100,20,80,39,61,2,1,1,1,1,102,21,81,40,62,68,10.4998837157837,11.583765961879,0.391817955773034,31
"11327","PR","Cambé",107341,36311.28,41011,"Londrina",4,"Sul",1,"410370",4,86,14,72,32,54,1,0,1,0,1,87,14,73,32,55,57,10.4998837157837,11.583765961879,0.442663873181415,30
"11328","PR","Cambé",107341,36311.28,41011,"Londrina",4,"Sul",1,"410370",5,117,29,88,45,72,1,1,0,0,1,118,30,88,45,73,63,10.4998837157837,11.583765961879,0.38014477759892,31
"11329","PR","Cambira",7917,21998.93,41010,"Apucarana",4,"Sul",1,"410380",2,5,2,3,1,4,0,0,0,0,0,5,2,3,1,4,5,9.99874909479403,8.97676762517143,0.314735500652939,29
"11330","PR","Cambira",7917,21998.93,41010,"Apucarana",4,"Sul",1,"410380",3,7,1,6,2,5,0,0,0,0,0,7,1,6,2,5,5,9.99874909479403,8.97676762517143,0.380802648346588,31
"11331","PR","Cambira",7917,21998.93,41010,"Apucarana",4,"Sul",1,"410380",4,7,1,6,3,4,0,0,0,0,0,7,1,6,3,4,5,9.99874909479403,8.97676762517143,0.408250409701988,30
"11332","PR","Cambira",7917,21998.93,41010,"Apucarana",4,"Sul",1,"410380",5,7,2,5,3,4,0,0,0,0,0,7,2,5,3,4,3,9.99874909479403,8.97676762517143,0.403719361053288,31
"11333","PR","Campina da Lagoa",14043,28823.18,41004,"Goioerê",4,"Sul",0,"410390",2,17,4,13,6,11,0,0,0,0,0,17,4,13,6,11,6,10.2689352035081,9.54987932996818,0.305081701647719,29
"11334","PR","Campina da Lagoa",14043,28823.18,41004,"Goioerê",4,"Sul",0,"410390",3,17,2,15,7,10,0,0,0,0,0,17,2,15,7,10,12,10.2689352035081,9.54987932996818,0.37134631291952,31
"11335","PR","Campina da Lagoa",14043,28823.18,41004,"Goioerê",4,"Sul",0,"410390",4,22,2,20,13,9,0,0,0,0,0,22,2,20,13,9,10,10.2689352035081,9.54987932996818,0.414048635205031,30
"11336","PR","Campina da Lagoa",14043,28823.18,41004,"Goioerê",4,"Sul",0,"410390",5,14,0,14,7,7,0,0,0,0,0,14,0,14,7,7,10,10.2689352035081,9.54987932996818,0.375909250189268,31
"11337","PR","Campina Grande do Sul",43685,36518.02,41037,"Curitiba",4,"Sul",1,"410400",2,53,12,41,24,29,0,0,0,0,0,53,12,41,24,29,25,10.5055611163716,10.6847600727322,0.301360725859633,29
"11338","PR","Campina Grande do Sul",43685,36518.02,41037,"Curitiba",4,"Sul",1,"410400",3,60,9,51,27,33,0,0,0,0,0,60,9,51,27,33,20,10.5055611163716,10.6847600727322,0.389463922687543,31
"11339","PR","Campina Grande do Sul",43685,36518.02,41037,"Curitiba",4,"Sul",1,"410400",4,54,17,37,25,29,0,0,0,0,0,54,17,37,25,29,22,10.5055611163716,10.6847600727322,0.439440052823287,30
"11340","PR","Campina Grande do Sul",43685,36518.02,41037,"Curitiba",4,"Sul",1,"410400",5,51,7,44,20,31,1,0,1,0,1,52,7,45,20,32,29,10.5055611163716,10.6847600727322,0.394120975742969,31
"11341","PR","Campo Largo",133865,33304.69,41037,"Curitiba",4,"Sul",1,"410420",2,123,22,101,39,84,0,0,0,0,0,123,22,101,39,84,58,10.4134535068922,11.8045871084148,0.293410541973809,29
"11342","PR","Campo Largo",133865,33304.69,41037,"Curitiba",4,"Sul",1,"410420",3,100,21,79,46,54,0,0,0,0,0,100,21,79,46,54,49,10.4134535068922,11.8045871084148,0.395259306367623,31
"11343","PR","Campo Largo",133865,33304.69,41037,"Curitiba",4,"Sul",1,"410420",4,128,32,96,59,69,0,0,0,0,0,128,32,96,59,69,45,10.4134535068922,11.8045871084148,0.438806998759725,30
"11344","PR","Campo Largo",133865,33304.69,41037,"Curitiba",4,"Sul",1,"410420",5,137,23,114,50,87,0,0,0,0,0,137,23,114,50,87,47,10.4134535068922,11.8045871084148,0.39827381845283,31
"11345","PR","Campo Magro",29740,14644.71,41037,"Curitiba",4,"Sul",1,"410425",2,29,9,20,11,18,1,1,0,1,0,30,10,20,12,18,6,9.59183445708557,10.3002482200141,0.289830791695797,29
"11346","PR","Campo Magro",29740,14644.71,41037,"Curitiba",4,"Sul",1,"410425",3,33,5,28,15,18,0,0,0,0,0,33,5,28,15,18,12,9.59183445708557,10.3002482200141,0.380857327363839,31
"11347","PR","Campo Magro",29740,14644.71,41037,"Curitiba",4,"Sul",1,"410425",4,26,5,21,12,14,0,0,0,0,0,26,5,21,12,14,8,9.59183445708557,10.3002482200141,0.423091898258905,30
"11348","PR","Campo Magro",29740,14644.71,41037,"Curitiba",4,"Sul",1,"410425",5,31,12,19,15,16,0,0,0,0,0,31,12,19,15,16,15,9.59183445708557,10.3002482200141,0.378957414477354,31
"11349","PR","Campo Mourão",95488,41536.16,41005,"Campo Mourão",4,"Sul",1,"410430",2,88,17,71,28,60,2,0,2,0,2,90,17,73,28,62,48,10.6343196521365,11.4667558641234,0.313569661759683,29
"11350","PR","Campo Mourão",95488,41536.16,41005,"Campo Mourão",4,"Sul",1,"410430",3,99,17,82,32,67,1,1,0,0,1,100,18,82,32,68,52,10.6343196521365,11.4667558641234,0.418065789163676,31
"11351","PR","Campo Mourão",95488,41536.16,41005,"Campo Mourão",4,"Sul",1,"410430",4,106,22,84,40,66,1,0,1,0,1,107,22,85,40,67,63,10.6343196521365,11.4667558641234,0.481663510739836,30
"11352","PR","Campo Mourão",95488,41536.16,41005,"Campo Mourão",4,"Sul",1,"410430",5,120,17,103,51,69,1,0,1,0,1,121,17,104,51,70,58,10.6343196521365,11.4667558641234,0.408637387150633,31
"11353","PR","Cândido de Abreu",14809,20862.25,41013,"Ivaiporã",4,"Sul",0,"410440",2,6,1,5,3,3,0,0,0,0,0,6,1,5,3,3,11,9.9456965846748,9.6029903830375,0.332410131390628,29
"11354","PR","Cândido de Abreu",14809,20862.25,41013,"Ivaiporã",4,"Sul",0,"410440",3,13,5,8,6,7,0,0,0,0,0,13,5,8,6,7,5,9.9456965846748,9.6029903830375,0.415519452261051,31
"11355","PR","Cândido de Abreu",14809,20862.25,41013,"Ivaiporã",4,"Sul",0,"410440",4,11,5,6,6,5,0,0,0,0,0,11,5,6,6,5,11,9.9456965846748,9.6029903830375,0.454706817524967,30
"11356","PR","Cândido de Abreu",14809,20862.25,41013,"Ivaiporã",4,"Sul",0,"410440",5,16,5,11,6,10,1,0,1,1,0,17,5,12,7,10,8,9.9456965846748,9.6029903830375,0.422851742025268,31
"11357","PR","Candói",16053,32013.04,41029,"Guarapuava",4,"Sul",0,"410442",2,17,9,8,3,14,1,1,0,0,1,18,10,8,3,15,5,10.3738985987763,9.68365102697941,0.320102928086003,29
"11358","PR","Candói",16053,32013.04,41029,"Guarapuava",4,"Sul",0,"410442",3,12,3,9,4,8,0,0,0,0,0,12,3,9,4,8,3,10.3738985987763,9.68365102697941,0.419296886322925,31
"11359","PR","Candói",16053,32013.04,41029,"Guarapuava",4,"Sul",0,"410442",4,22,8,14,11,11,0,0,0,0,0,22,8,14,11,11,9,10.3738985987763,9.68365102697941,0.400929251211355,30
"11360","PR","Candói",16053,32013.04,41029,"Guarapuava",4,"Sul",0,"410442",5,23,7,16,7,16,0,0,0,0,0,23,7,16,7,16,7,10.3738985987763,9.68365102697941,0.431494402070749,31
"11361","PR","Cantagalo",13329,19378.91,41029,"Guarapuava",4,"Sul",0,"410445",2,12,6,6,8,4,0,0,0,0,0,12,6,6,8,4,3,9.87194064031298,9.49769739160402,0.318773600642107,29
"11362","PR","Cantagalo",13329,19378.91,41029,"Guarapuava",4,"Sul",0,"410445",3,15,7,8,6,9,0,0,0,0,0,15,7,8,6,9,7,9.87194064031298,9.49769739160402,0.382189198922455,31
"11363","PR","Cantagalo",13329,19378.91,41029,"Guarapuava",4,"Sul",0,"410445",4,13,4,9,6,7,0,0,0,0,0,13,4,9,6,7,8,9.87194064031298,9.49769739160402,0.419259925118685,30
"11364","PR","Cantagalo",13329,19378.91,41029,"Guarapuava",4,"Sul",0,"410445",5,18,2,16,7,11,0,0,0,0,0,18,2,16,7,11,9,9.87194064031298,9.49769739160402,0.376181295646591,31
"11365","PR","Capanema",19148,32437.22,41025,"Capanema",4,"Sul",0,"410450",2,16,3,13,3,13,0,0,0,0,0,16,3,13,3,13,14,10.3870618078864,9.8599535505124,0.300820936769349,29
"11366","PR","Capanema",19148,32437.22,41025,"Capanema",4,"Sul",0,"410450",3,21,4,17,8,13,0,0,0,0,0,21,4,17,8,13,9,10.3870618078864,9.8599535505124,0.389973102338145,31
"11367","PR","Capanema",19148,32437.22,41025,"Capanema",4,"Sul",0,"410450",4,20,7,13,6,14,0,0,0,0,0,20,7,13,6,14,13,10.3870618078864,9.8599535505124,0.37342039339416,30
"11368","PR","Capanema",19148,32437.22,41025,"Capanema",4,"Sul",0,"410450",5,10,2,8,3,7,0,0,0,0,0,10,2,8,3,7,12,10.3870618078864,9.8599535505124,0.398956380196987,31
"11369","PR","Capitão Leônidas Marques",15834,74160.76,41023,"Cascavel",4,"Sul",0,"410460",2,10,3,7,5,5,1,0,1,0,1,11,3,8,5,6,6,11.2139904482994,9.66991480573138,0.32735889260499,29
"11370","PR","Capitão Leônidas Marques",15834,74160.76,41023,"Cascavel",4,"Sul",0,"410460",3,21,3,18,11,10,0,0,0,0,0,21,3,18,11,10,9,11.2139904482994,9.66991480573138,0.418342953098221,31
"11371","PR","Capitão Leônidas Marques",15834,74160.76,41023,"Cascavel",4,"Sul",0,"410460",4,17,1,16,6,11,0,0,0,0,0,17,1,16,6,11,8,11.2139904482994,9.66991480573138,0.449850653842234,30
"11372","PR","Capitão Leônidas Marques",15834,74160.76,41023,"Cascavel",4,"Sul",0,"410460",5,12,0,12,5,7,1,1,0,0,1,13,1,12,5,8,10,11.2139904482994,9.66991480573138,0.416913937589924,31
"11373","PR","Carambeí",23825,56774.32,41021,"Ponta Grossa",4,"Sul",1,"410465",2,33,9,24,10,23,0,0,0,0,0,33,9,24,10,23,11,10.9468393897994,10.0784907285224,0.32523733563618,29
"11374","PR","Carambeí",23825,56774.32,41021,"Ponta Grossa",4,"Sul",1,"410465",3,28,5,23,16,12,1,0,1,1,0,29,5,24,17,12,5,10.9468393897994,10.0784907285224,0.403561017847191,31
"11375","PR","Carambeí",23825,56774.32,41021,"Ponta Grossa",4,"Sul",1,"410465",4,33,8,25,16,17,0,0,0,0,0,33,8,25,16,17,7,10.9468393897994,10.0784907285224,0.429700696100918,30
"11376","PR","Carambeí",23825,56774.32,41021,"Ponta Grossa",4,"Sul",1,"410465",5,30,7,23,12,18,0,0,0,0,0,30,7,23,12,18,7,10.9468393897994,10.0784907285224,0.405470008609417,31
"11377","PR","Carlópolis",14356,23990.73,41018,"Wenceslau Braz",4,"Sul",0,"410470",2,15,5,10,2,13,0,0,0,0,0,15,5,10,2,13,13,10.0854227847163,9.5719232522675,0.33274654517556,29
"11378","PR","Carlópolis",14356,23990.73,41018,"Wenceslau Braz",4,"Sul",0,"410470",3,8,3,5,5,3,0,0,0,0,0,8,3,5,5,3,12,10.0854227847163,9.5719232522675,0.386469948142957,31
"11379","PR","Carlópolis",14356,23990.73,41018,"Wenceslau Braz",4,"Sul",0,"410470",4,15,2,13,9,6,0,0,0,0,0,15,2,13,9,6,10,10.0854227847163,9.5719232522675,0.425617681922912,30
"11380","PR","Carlópolis",14356,23990.73,41018,"Wenceslau Braz",4,"Sul",0,"410470",5,15,5,10,11,4,1,0,1,0,1,16,5,11,11,5,9,10.0854227847163,9.5719232522675,0.401792406600382,31
"11381","PR","Cascavel",332333,37733.02,41023,"Cascavel",4,"Sul",1,"410480",2,393,62,331,125,268,5,3,2,2,3,398,65,333,127,271,125,10.5382908521617,12.7138927572663,0.299215036126984,29
"11382","PR","Cascavel",332333,37733.02,41023,"Cascavel",4,"Sul",1,"410480",3,380,73,307,125,255,0,0,0,0,0,380,73,307,125,255,142,10.5382908521617,12.7138927572663,0.405867317751987,31
"11383","PR","Cascavel",332333,37733.02,41023,"Cascavel",4,"Sul",1,"410480",4,376,75,301,126,250,5,2,3,2,3,381,77,304,128,253,161,10.5382908521617,12.7138927572663,0.445661301227484,30
"11384","PR","Cascavel",332333,37733.02,41023,"Cascavel",4,"Sul",1,"410480",5,463,76,387,162,301,6,1,5,2,4,469,77,392,164,305,138,10.5382908521617,12.7138927572663,0.396962414479633,31
"11385","PR","Castro",71809,39629.73,41021,"Ponta Grossa",4,"Sul",1,"410490",2,89,30,59,36,53,2,1,1,1,1,91,31,60,37,54,21,10.5873348731408,11.1817650953703,0.298766536503684,29
"11386","PR","Castro",71809,39629.73,41021,"Ponta Grossa",4,"Sul",1,"410490",3,89,23,66,40,49,0,0,0,0,0,89,23,66,40,49,44,10.5873348731408,11.1817650953703,0.384165434041676,31
"11387","PR","Castro",71809,39629.73,41021,"Ponta Grossa",4,"Sul",1,"410490",4,77,22,55,36,41,0,0,0,0,0,77,22,55,36,41,32,10.5873348731408,11.1817650953703,0.419735051109778,30
"11388","PR","Castro",71809,39629.73,41021,"Ponta Grossa",4,"Sul",1,"410490",5,90,31,59,30,60,1,0,1,0,1,91,31,60,30,61,36,10.5873348731408,11.1817650953703,0.386468719437979,31
"11389","PR","Catanduvas",10167,26803.32,41023,"Cascavel",4,"Sul",0,"410500",2,9,1,8,6,3,0,0,0,0,0,9,1,8,6,3,5,10.1962810394234,9.22690246027516,0.324922010389126,29
"11390","PR","Catanduvas",10167,26803.32,41023,"Cascavel",4,"Sul",0,"410500",3,13,3,10,5,8,0,0,0,0,0,13,3,10,5,8,4,10.1962810394234,9.22690246027516,0.378311077863619,31
"11391","PR","Catanduvas",10167,26803.32,41023,"Cascavel",4,"Sul",0,"410500",4,5,2,3,1,4,0,0,0,0,0,5,2,3,1,4,2,10.1962810394234,9.22690246027516,0.389604124045361,30
"11392","PR","Catanduvas",10167,26803.32,41023,"Cascavel",4,"Sul",0,"410500",5,8,2,6,1,7,0,0,0,0,0,8,2,6,1,7,6,10.1962810394234,9.22690246027516,0.365085318941763,31
"11393","PR","Centenário do Sul",10764,20943.44,41006,"Astorga",4,"Sul",0,"410510",2,8,1,7,2,6,0,0,0,0,0,8,1,7,2,6,16,9.9495807498243,9.2839625118468,0.298683288899144,29
"11394","PR","Centenário do Sul",10764,20943.44,41006,"Astorga",4,"Sul",0,"410510",3,9,5,4,2,7,0,0,0,0,0,9,5,4,2,7,6,9.9495807498243,9.2839625118468,0.388717624565944,31
"11395","PR","Centenário do Sul",10764,20943.44,41006,"Astorga",4,"Sul",0,"410510",4,6,4,2,4,2,0,0,0,0,0,6,4,2,4,2,6,9.9495807498243,9.2839625118468,0.408359943765295,30
"11396","PR","Centenário do Sul",10764,20943.44,41006,"Astorga",4,"Sul",0,"410510",5,11,4,7,3,8,0,0,0,0,0,11,4,7,3,8,8,9.9495807498243,9.2839625118468,0.363544909890553,31
"11397","PR","Céu Azul",11819,54748.1,41024,"Foz do Iguaçu",4,"Sul",0,"410530",2,9,1,8,3,6,0,0,0,0,0,9,1,8,3,6,9,10.9104979438802,9.37746368501224,0.290837652483681,29
"11398","PR","Céu Azul",11819,54748.1,41024,"Foz do Iguaçu",4,"Sul",0,"410530",3,10,1,9,3,7,0,0,0,0,0,10,1,9,3,7,0,10.9104979438802,9.37746368501224,0.420651471330058,31
"11399","PR","Céu Azul",11819,54748.1,41024,"Foz do Iguaçu",4,"Sul",0,"410530",4,11,3,8,2,9,0,0,0,0,0,11,3,8,2,9,2,10.9104979438802,9.37746368501224,0.441793295105773,30
"11400","PR","Céu Azul",11819,54748.1,41024,"Foz do Iguaçu",4,"Sul",0,"410530",5,11,3,8,2,9,0,0,0,0,0,11,3,8,2,9,10,10.9104979438802,9.37746368501224,0.428519071131827,31
"11401","PR","Chopinzinho",19167,34096.42,41027,"Pato Branco",4,"Sul",0,"410540",2,22,5,17,10,12,0,0,0,0,0,22,5,17,10,12,13,10.436947672423,9.86094532927045,0.281509023950129,29
"11402","PR","Chopinzinho",19167,34096.42,41027,"Pato Branco",4,"Sul",0,"410540",3,13,4,9,5,8,0,0,0,0,0,13,4,9,5,8,12,10.436947672423,9.86094532927045,0.355075718457854,31
"11403","PR","Chopinzinho",19167,34096.42,41027,"Pato Branco",4,"Sul",0,"410540",4,21,2,19,6,15,0,0,0,0,0,21,2,19,6,15,14,10.436947672423,9.86094532927045,0.371666042483245,30
"11404","PR","Chopinzinho",19167,34096.42,41027,"Pato Branco",4,"Sul",0,"410540",5,26,7,19,15,11,1,1,0,1,0,27,8,19,16,11,12,10.436947672423,9.86094532927045,0.360116787785778,31
"11405","PR","Cianorte",83816,32662.63,41003,"Cianorte",4,"Sul",1,"410550",2,65,15,50,20,45,1,0,1,1,0,66,15,51,21,45,52,10.3939868899205,11.3363791990328,0.301302106379464,29
"11406","PR","Cianorte",83816,32662.63,41003,"Cianorte",4,"Sul",1,"410550",3,84,15,69,30,54,0,0,0,0,0,84,15,69,30,54,52,10.3939868899205,11.3363791990328,0.408868238221628,31
"11407","PR","Cianorte",83816,32662.63,41003,"Cianorte",4,"Sul",1,"410550",4,81,20,61,27,54,0,0,0,0,0,81,20,61,27,54,37,10.3939868899205,11.3363791990328,0.427959648546199,30
"11408","PR","Cianorte",83816,32662.63,41003,"Cianorte",4,"Sul",1,"410550",5,88,18,70,23,65,0,0,0,0,0,88,18,70,23,65,40,10.3939868899205,11.3363791990328,0.391897644426002,31
"11409","PR","Cidade Gaúcha",12797,33163.57,41003,"Cianorte",4,"Sul",0,"410560",2,8,5,3,4,4,0,0,0,0,0,8,5,3,4,4,6,10.4092072632854,9.4569660474376,0.302664583232137,29
"11410","PR","Cidade Gaúcha",12797,33163.57,41003,"Cianorte",4,"Sul",0,"410560",3,17,4,13,8,9,0,0,0,0,0,17,4,13,8,9,6,10.4092072632854,9.4569660474376,0.393512667620828,31
"11411","PR","Cidade Gaúcha",12797,33163.57,41003,"Cianorte",4,"Sul",0,"410560",4,23,7,16,6,17,0,0,0,0,0,23,7,16,6,17,10,10.4092072632854,9.4569660474376,0.389167197664391,30
"11412","PR","Cidade Gaúcha",12797,33163.57,41003,"Cianorte",4,"Sul",0,"410560",5,15,3,12,5,10,0,0,0,0,0,15,3,12,5,10,12,10.4092072632854,9.4569660474376,0.385733541913859,31
"11413","PR","Clevelândia",16450,27935.92,41030,"Palmas",4,"Sul",1,"410570",2,16,5,11,7,9,0,0,0,0,0,16,5,11,7,9,12,10.2376685949468,9.70808075619352,0.344718401465066,29
"11414","PR","Clevelândia",16450,27935.92,41030,"Palmas",4,"Sul",1,"410570",3,22,7,15,12,10,0,0,0,0,0,22,7,15,12,10,12,10.2376685949468,9.70808075619352,0.402786946369987,31
"11415","PR","Clevelândia",16450,27935.92,41030,"Palmas",4,"Sul",1,"410570",4,22,8,14,6,16,0,0,0,0,0,22,8,14,6,16,7,10.2376685949468,9.70808075619352,0.427729844475259,30
"11416","PR","Clevelândia",16450,27935.92,41030,"Palmas",4,"Sul",1,"410570",5,25,8,17,10,15,0,0,0,0,0,25,8,17,10,15,10,10.2376685949468,9.70808075619352,0.417146878393707,31
"11417","PR","Colombo",246540,21682.44,41037,"Curitiba",4,"Sul",1,"410580",2,241,62,179,97,144,1,0,1,1,0,242,62,180,98,144,86,9.9842579953462,12.4152795311055,0.299683761106538,29
"11418","PR","Colombo",246540,21682.44,41037,"Curitiba",4,"Sul",1,"410580",3,224,73,151,91,133,5,1,4,4,1,229,74,155,95,134,105,9.9842579953462,12.4152795311055,0.394013470062824,31
"11419","PR","Colombo",246540,21682.44,41037,"Curitiba",4,"Sul",1,"410580",4,219,76,143,91,128,2,1,1,1,1,221,77,144,92,129,112,9.9842579953462,12.4152795311055,0.44182090646929,30
"11420","PR","Colombo",246540,21682.44,41037,"Curitiba",4,"Sul",1,"410580",5,262,86,176,111,151,4,2,2,1,3,266,88,178,112,154,89,9.9842579953462,12.4152795311055,0.396169668108594,31
"11421","PR","Colorado",24145,25897.41,41006,"Astorga",4,"Sul",1,"410590",2,15,2,13,3,12,0,0,0,0,0,15,2,13,3,12,16,10.1618982426873,10.0918325983076,0.309675664019021,29
"11422","PR","Colorado",24145,25897.41,41006,"Astorga",4,"Sul",1,"410590",3,26,9,17,13,13,0,0,0,0,0,26,9,17,13,13,15,10.1618982426873,10.0918325983076,0.399607677315098,31
"11423","PR","Colorado",24145,25897.41,41006,"Astorga",4,"Sul",1,"410590",4,22,4,18,5,17,0,0,0,0,0,22,4,18,5,17,11,10.1618982426873,10.0918325983076,0.435491850597896,30
"11424","PR","Colorado",24145,25897.41,41006,"Astorga",4,"Sul",1,"410590",5,24,5,19,7,17,0,0,0,0,0,24,5,19,7,17,21,10.1618982426873,10.0918325983076,0.380496252048634,31
"11425","PR","Congonhinhas",8857,23435.05,41015,"Cornélio Procópio",4,"Sul",0,"410600",2,6,1,5,3,3,0,0,0,0,0,6,1,5,3,3,5,10.0619880439154,9.08896338580958,0.330967138424068,29
"11426","PR","Congonhinhas",8857,23435.05,41015,"Cornélio Procópio",4,"Sul",0,"410600",3,10,4,6,3,7,0,0,0,0,0,10,4,6,3,7,7,10.0619880439154,9.08896338580958,0.406419420440712,31
"11427","PR","Congonhinhas",8857,23435.05,41015,"Cornélio Procópio",4,"Sul",0,"410600",4,7,4,3,3,4,0,0,0,0,0,7,4,3,3,4,7,10.0619880439154,9.08896338580958,0.411880604499125,30
"11428","PR","Congonhinhas",8857,23435.05,41015,"Cornélio Procópio",4,"Sul",0,"410600",5,8,1,7,4,4,0,0,0,0,0,8,1,7,4,4,3,10.0619880439154,9.08896338580958,0.42343608528114,31
"11429","PR","Contenda",18837,21847.83,41037,"Curitiba",4,"Sul",1,"410620",2,20,8,12,8,12,0,0,0,0,0,20,8,12,8,12,6,9.99185688209068,9.84357829978222,0.297701333737386,29
"11430","PR","Contenda",18837,21847.83,41037,"Curitiba",4,"Sul",1,"410620",3,18,6,12,8,10,0,0,0,0,0,18,6,12,8,10,8,9.99185688209068,9.84357829978222,0.394147573680094,31
"11431","PR","Contenda",18837,21847.83,41037,"Curitiba",4,"Sul",1,"410620",4,23,8,15,10,13,0,0,0,0,0,23,8,15,10,13,10,9.99185688209068,9.84357829978222,0.428190006876766,30
"11432","PR","Contenda",18837,21847.83,41037,"Curitiba",4,"Sul",1,"410620",5,18,5,13,3,15,0,0,0,0,0,18,5,13,3,15,13,9.99185688209068,9.84357829978222,0.416806001727393,31
"11433","PR","Corbélia",17117,35813.38,41023,"Cascavel",4,"Sul",0,"410630",2,15,2,13,6,9,0,0,0,0,0,15,2,13,6,9,8,10.486076845581,9.74782740069566,0.28879228028951,29
"11434","PR","Corbélia",17117,35813.38,41023,"Cascavel",4,"Sul",0,"410630",3,17,2,15,9,8,0,0,0,0,0,17,2,15,9,8,19,10.486076845581,9.74782740069566,0.379009979218993,31
"11435","PR","Corbélia",17117,35813.38,41023,"Cascavel",4,"Sul",0,"410630",4,19,4,15,8,11,0,0,0,0,0,19,4,15,8,11,13,10.486076845581,9.74782740069566,0.399591126283338,30
"11436","PR","Corbélia",17117,35813.38,41023,"Cascavel",4,"Sul",0,"410630",5,23,2,21,2,21,0,0,0,0,0,23,2,21,2,21,10,10.486076845581,9.74782740069566,0.361491185827079,31
"11437","PR","Cornélio Procópio",47842,32330.82,41015,"Cornélio Procópio",4,"Sul",1,"410640",2,32,3,29,11,21,1,0,1,0,1,33,3,30,11,22,27,10.3837762338374,10.7756591937707,0.293327817655161,29
"11438","PR","Cornélio Procópio",47842,32330.82,41015,"Cornélio Procópio",4,"Sul",1,"410640",3,43,5,38,14,29,0,0,0,0,0,43,5,38,14,29,33,10.3837762338374,10.7756591937707,0.403833877451634,31
"11439","PR","Cornélio Procópio",47842,32330.82,41015,"Cornélio Procópio",4,"Sul",1,"410640",4,24,4,20,8,16,0,0,0,0,0,24,4,20,8,16,45,10.3837762338374,10.7756591937707,0.447936961405493,30
"11440","PR","Cornélio Procópio",47842,32330.82,41015,"Cornélio Procópio",4,"Sul",1,"410640",5,38,3,35,16,22,0,0,0,0,0,38,3,35,16,22,35,10.3837762338374,10.7756591937707,0.408462388041598,31
"11441","PR","Coronel Vivida",20580,32847.6,41027,"Pato Branco",4,"Sul",0,"410650",2,28,5,23,8,20,0,0,0,0,0,28,5,23,8,20,8,10.3996339618831,9.93207500938804,0.318098950477852,29
"11442","PR","Coronel Vivida",20580,32847.6,41027,"Pato Branco",4,"Sul",0,"410650",3,22,8,14,8,14,0,0,0,0,0,22,8,14,8,14,18,10.3996339618831,9.93207500938804,0.410428077189251,31
"11443","PR","Coronel Vivida",20580,32847.6,41027,"Pato Branco",4,"Sul",0,"410650",4,19,4,15,8,11,0,0,0,0,0,19,4,15,8,11,16,10.3996339618831,9.93207500938804,0.4152747219123,30
"11444","PR","Coronel Vivida",20580,32847.6,41027,"Pato Branco",4,"Sul",0,"410650",5,32,10,22,11,21,0,0,0,0,0,32,10,22,11,21,14,10.3996339618831,9.93207500938804,0.410525287990842,31
"11445","PR","Cruzeiro do Oeste",20947,39631.52,41002,"Umuarama",4,"Sul",1,"410660",2,27,8,19,9,18,0,0,0,0,0,27,8,19,9,18,17,10.5873800402307,9.94975071700577,0.295626895768438,29
"11446","PR","Cruzeiro do Oeste",20947,39631.52,41002,"Umuarama",4,"Sul",1,"410660",3,18,5,13,8,10,1,1,0,0,1,19,6,13,8,11,17,10.5873800402307,9.94975071700577,0.398670170716929,31
"11447","PR","Cruzeiro do Oeste",20947,39631.52,41002,"Umuarama",4,"Sul",1,"410660",4,31,5,26,15,16,1,1,0,1,0,32,6,26,16,16,20,10.5873800402307,9.94975071700577,0.40252002174407,30
"11448","PR","Cruzeiro do Oeste",20947,39631.52,41002,"Umuarama",4,"Sul",1,"410660",5,27,6,21,10,17,0,0,0,0,0,27,6,21,10,17,16,10.5873800402307,9.94975071700577,0.360842563236519,31
"11449","PR","Cruzeiro do Sul",4449,41283.44,41001,"Paranavaí",4,"Sul",1,"410670",2,3,2,1,1,2,0,0,0,0,0,3,2,1,1,2,6,10.6282167300167,8.40043463080604,0.279937117944452,29
"11450","PR","Cruzeiro do Sul",4449,41283.44,41001,"Paranavaí",4,"Sul",1,"410670",3,1,0,1,0,1,0,0,0,0,0,1,0,1,0,1,4,10.6282167300167,8.40043463080604,0.343191049915551,31
"11451","PR","Cruzeiro do Sul",4449,41283.44,41001,"Paranavaí",4,"Sul",1,"410670",4,8,2,6,5,3,0,0,0,0,0,8,2,6,5,3,2,10.6282167300167,8.40043463080604,0.387838414701053,30
"11452","PR","Cruzeiro do Sul",4449,41283.44,41001,"Paranavaí",4,"Sul",1,"410670",5,11,1,10,4,7,0,0,0,0,0,11,1,10,4,7,3,10.6282167300167,8.40043463080604,0.350950173095303,31
"11453","PR","Cruz Machado",18741,19721.21,41033,"União da Vitória",4,"Sul",0,"410680",2,16,5,11,6,10,0,0,0,0,0,16,5,11,6,10,13,9.88944998530061,9.83846891616168,0.31264757371243,29
"11454","PR","Cruz Machado",18741,19721.21,41033,"União da Vitória",4,"Sul",0,"410680",3,14,6,8,7,7,0,0,0,0,0,14,6,8,7,7,8,9.88944998530061,9.83846891616168,0.420311843628732,31
"11455","PR","Cruz Machado",18741,19721.21,41033,"União da Vitória",4,"Sul",0,"410680",4,11,3,8,6,5,0,0,0,0,0,11,3,8,6,5,9,9.88944998530061,9.83846891616168,0.424754850366659,30
"11456","PR","Cruz Machado",18741,19721.21,41033,"União da Vitória",4,"Sul",0,"410680",5,6,2,4,4,2,0,0,0,0,0,6,2,4,4,2,7,9.88944998530061,9.83846891616168,0.408163153067274,31
"11457","PR","Curitiba",1948626,45458.29,41037,"Curitiba",4,"Sul",1,"410690",2,1487,185,1302,413,1074,8,1,7,4,4,1495,186,1309,417,1078,799,10.7245504812129,14.4826350667972,0.298578278950826,29
"11458","PR","Curitiba",1948626,45458.29,41037,"Curitiba",4,"Sul",1,"410690",3,1505,205,1300,423,1082,11,5,6,4,7,1516,210,1306,427,1089,890,10.7245504812129,14.4826350667972,0.412781657333338,31
"11459","PR","Curitiba",1948626,45458.29,41037,"Curitiba",4,"Sul",1,"410690",4,1362,168,1194,359,1003,12,1,11,2,10,1374,169,1205,361,1013,872,10.7245504812129,14.4826350667972,0.480637380201168,30
"11460","PR","Curitiba",1948626,45458.29,41037,"Curitiba",4,"Sul",1,"410690",5,1323,152,1171,353,970,7,1,6,0,7,1330,153,1177,353,977,908,10.7245504812129,14.4826350667972,0.429573437999275,31
"11461","PR","Curiúva",15196,15485.22,41017,"Ibaiti",4,"Sul",0,"410700",2,8,3,5,2,6,0,0,0,0,0,8,3,5,2,6,6,9.64764129960376,9.62878751430752,0.276303766865553,29
"11462","PR","Curiúva",15196,15485.22,41017,"Ibaiti",4,"Sul",0,"410700",3,13,7,6,6,7,0,0,0,0,0,13,7,6,6,7,7,9.64764129960376,9.62878751430752,0.372321753547342,31
"11463","PR","Curiúva",15196,15485.22,41017,"Ibaiti",4,"Sul",0,"410700",4,12,4,8,5,7,0,0,0,0,0,12,4,8,5,7,13,9.64764129960376,9.62878751430752,0.39400376878616,30
"11464","PR","Curiúva",15196,15485.22,41017,"Ibaiti",4,"Sul",0,"410700",5,11,5,6,5,6,1,1,0,0,1,12,6,6,5,7,10,9.64764129960376,9.62878751430752,0.385021903395195,31
"11465","PR","Dois Vizinhos",41038,39449.27,41026,"Francisco Beltrão",4,"Sul",1,"410720",2,41,8,33,13,28,0,0,0,0,0,41,8,33,13,28,21,10.5827708216668,10.6222537457137,0.303278197862472,29
"11466","PR","Dois Vizinhos",41038,39449.27,41026,"Francisco Beltrão",4,"Sul",1,"410720",3,47,8,39,16,31,0,0,0,0,0,47,8,39,16,31,20,10.5827708216668,10.6222537457137,0.418766536208094,31
"11467","PR","Dois Vizinhos",41038,39449.27,41026,"Francisco Beltrão",4,"Sul",1,"410720",4,51,12,39,20,31,0,0,0,0,0,51,12,39,20,31,18,10.5827708216668,10.6222537457137,0.421133299200432,30
"11468","PR","Dois Vizinhos",41038,39449.27,41026,"Francisco Beltrão",4,"Sul",1,"410720",5,71,15,56,27,44,0,0,0,0,0,71,15,56,27,44,14,10.5827708216668,10.6222537457137,0.388620122140902,31
"11469","PR","Douradina",8869,68677.24,41002,"Umuarama",4,"Sul",0,"410725",2,10,0,10,2,8,0,0,0,0,0,10,0,10,2,8,5,11.1371731278323,9.09031732937645,0.25967537355945,29
"11470","PR","Douradina",8869,68677.24,41002,"Umuarama",4,"Sul",0,"410725",3,7,1,6,1,6,0,0,0,0,0,7,1,6,1,6,7,11.1371731278323,9.09031732937645,0.356626477733778,31
"11471","PR","Douradina",8869,68677.24,41002,"Umuarama",4,"Sul",0,"410725",4,11,1,10,1,10,0,0,0,0,0,11,1,10,1,10,3,11.1371731278323,9.09031732937645,0.425455840436737,30
"11472","PR","Douradina",8869,68677.24,41002,"Umuarama",4,"Sul",0,"410725",5,7,0,7,1,6,0,0,0,0,0,7,0,7,1,6,6,11.1371731278323,9.09031732937645,0.427183661562783,31
"11473","PR","Doutor Camargo",5983,25886.51,41008,"Floraí",4,"Sul",0,"410730",2,2,0,2,0,2,0,0,0,0,0,2,0,2,0,2,3,10.1614772625776,8.69667739339003,0.26965583829666,29
"11474","PR","Doutor Camargo",5983,25886.51,41008,"Floraí",4,"Sul",0,"410730",3,0,0,0,0,0,0,0,0,0,0,0,0,0,0,0,7,10.1614772625776,8.69667739339003,0.372454367205539,31
"11475","PR","Doutor Camargo",5983,25886.51,41008,"Floraí",4,"Sul",0,"410730",4,8,1,7,4,4,0,0,0,0,0,8,1,7,4,4,6,10.1614772625776,8.69667739339003,0.400629413979012,30
"11476","PR","Doutor Camargo",5983,25886.51,41008,"Floraí",4,"Sul",0,"410730",5,9,3,6,3,6,0,0,0,0,0,9,3,6,3,6,5,10.1614772625776,8.69667739339003,0.352147580097276,31
"11477","PR","Engenheiro Beltrão",13981,40211.54,41005,"Campo Mourão",4,"Sul",0,"410750",2,16,2,14,7,9,0,0,0,0,0,16,2,14,7,9,11,10.6019092980885,9.54545454398782,0.305731813388012,29
"11478","PR","Engenheiro Beltrão",13981,40211.54,41005,"Campo Mourão",4,"Sul",0,"410750",3,14,1,13,2,12,0,0,0,0,0,14,1,13,2,12,8,10.6019092980885,9.54545454398782,0.388004547597786,31
"11479","PR","Engenheiro Beltrão",13981,40211.54,41005,"Campo Mourão",4,"Sul",0,"410750",4,22,5,17,9,13,0,0,0,0,0,22,5,17,9,13,6,10.6019092980885,9.54545454398782,0.417401126413235,30
"11480","PR","Engenheiro Beltrão",13981,40211.54,41005,"Campo Mourão",4,"Sul",0,"410750",5,8,0,8,4,4,0,0,0,0,0,8,0,8,4,4,12,10.6019092980885,9.54545454398782,0.390933404356539,31
"11481","PR","Faxinal",17316,24752.72,41012,"Faxinal",4,"Sul",1,"410760",2,11,2,9,5,6,0,0,0,0,0,11,2,9,5,6,12,10.1166906609483,9.75938620856187,0.306861821316808,29
"11482","PR","Faxinal",17316,24752.72,41012,"Faxinal",4,"Sul",1,"410760",3,23,6,17,8,15,0,0,0,0,0,23,6,17,8,15,18,10.1166906609483,9.75938620856187,0.384916637923757,31
"11483","PR","Faxinal",17316,24752.72,41012,"Faxinal",4,"Sul",1,"410760",4,26,5,21,9,17,0,0,0,0,0,26,5,21,9,17,10,10.1166906609483,9.75938620856187,0.403153893331421,30
"11484","PR","Faxinal",17316,24752.72,41012,"Faxinal",4,"Sul",1,"410760",5,12,4,8,4,8,0,0,0,0,0,12,4,8,4,8,12,10.1166906609483,9.75938620856187,0.378763693714312,31
"11485","PR","Fazenda Rio Grande",102004,25607.26,41037,"Curitiba",4,"Sul",1,"410765",2,157,27,130,61,96,1,0,1,1,0,158,27,131,62,96,49,10.1506311840125,11.5327673071838,0.305362887765415,29
"11486","PR","Fazenda Rio Grande",102004,25607.26,41037,"Curitiba",4,"Sul",1,"410765",3,176,35,141,77,99,2,1,1,0,2,178,36,142,77,101,34,10.1506311840125,11.5327673071838,0.404634725743768,31
"11487","PR","Fazenda Rio Grande",102004,25607.26,41037,"Curitiba",4,"Sul",1,"410765",4,157,42,115,60,97,3,0,3,2,1,160,42,118,62,98,45,10.1506311840125,11.5327673071838,0.445725690891052,30
"11488","PR","Fazenda Rio Grande",102004,25607.26,41037,"Curitiba",4,"Sul",1,"410765",5,196,37,159,61,135,1,1,0,1,0,197,38,159,62,135,44,10.1506311840125,11.5327673071838,0.400580003318546,31
"11489","PR","Figueira",7696,19071.11,41017,"Ibaiti",4,"Sul",0,"410775",2,5,2,3,2,3,1,0,1,1,0,6,2,4,3,3,7,9.85592990350776,8.94845599234554,0.308679380530348,29
"11490","PR","Figueira",7696,19071.11,41017,"Ibaiti",4,"Sul",0,"410775",3,11,3,8,4,7,0,0,0,0,0,11,3,8,4,7,5,9.85592990350776,8.94845599234554,0.386911826991449,31
"11491","PR","Figueira",7696,19071.11,41017,"Ibaiti",4,"Sul",0,"410775",4,9,1,8,6,3,0,0,0,0,0,9,1,8,6,3,9,9.85592990350776,8.94845599234554,0.424383286367478,30
"11492","PR","Figueira",7696,19071.11,41017,"Ibaiti",4,"Sul",0,"410775",5,9,2,7,5,4,0,0,0,0,0,9,2,7,5,4,8,9.85592990350776,8.94845599234554,0.369706477979082,31
"11493","PR","Floraí",4906,35608.91,41008,"Floraí",4,"Sul",0,"410780",2,4,0,4,1,3,0,0,0,0,0,4,0,4,1,3,3,10.480351166424,8.49821422481843,0.31342947496085,29
"11494","PR","Floraí",4906,35608.91,41008,"Floraí",4,"Sul",0,"410780",3,3,2,1,2,1,0,0,0,0,0,3,2,1,2,1,2,10.480351166424,8.49821422481843,0.375172848389559,31
"11495","PR","Floraí",4906,35608.91,41008,"Floraí",4,"Sul",0,"410780",4,6,0,6,1,5,0,0,0,0,0,6,0,6,1,5,9,10.480351166424,8.49821422481843,0.39646530512233,30
"11496","PR","Floraí",4906,35608.91,41008,"Floraí",4,"Sul",0,"410780",5,2,1,1,0,2,0,0,0,0,0,2,1,1,0,2,6,10.480351166424,8.49821422481843,0.351923749147983,31
"11497","PR","Floresta",6851,30945.99,41008,"Floraí",4,"Sul",1,"410790",2,5,1,4,2,3,0,0,0,0,0,5,1,4,2,3,3,10.339998705906,8.8321499060029,0.281944825721663,29
"11498","PR","Floresta",6851,30945.99,41008,"Floraí",4,"Sul",1,"410790",3,6,1,5,2,4,0,0,0,0,0,6,1,5,2,4,2,10.339998705906,8.8321499060029,0.382372545267716,31
"11499","PR","Floresta",6851,30945.99,41008,"Floraí",4,"Sul",1,"410790",4,8,3,5,4,4,0,0,0,0,0,8,3,5,4,4,3,10.339998705906,8.8321499060029,0.429738133097005,30
"11500","PR","Floresta",6851,30945.99,41008,"Floraí",4,"Sul",1,"410790",5,15,2,13,7,8,1,0,1,0,1,16,2,14,7,9,3,10.339998705906,8.8321499060029,0.381008491268892,31
"11501","PR","Florestópolis",10453,23371.68,41007,"Porecatu",4,"Sul",0,"410800",2,11,2,9,3,8,0,0,0,0,0,11,2,9,3,8,14,10.0592803119838,9.25464429753271,0.29330219325805,29
"11502","PR","Florestópolis",10453,23371.68,41007,"Porecatu",4,"Sul",0,"410800",3,11,4,7,4,7,0,0,0,0,0,11,4,7,4,7,14,10.0592803119838,9.25464429753271,0.374847796890498,31
"11503","PR","Florestópolis",10453,23371.68,41007,"Porecatu",4,"Sul",0,"410800",4,13,1,12,5,8,0,0,0,0,0,13,1,12,5,8,7,10.0592803119838,9.25464429753271,0.364656647275549,30
"11504","PR","Florestópolis",10453,23371.68,41007,"Porecatu",4,"Sul",0,"410800",5,13,3,10,7,6,0,0,0,0,0,13,3,10,7,6,8,10.0592803119838,9.25464429753271,0.347531156164251,31
"11505","PR","Formosa do Oeste",6460,39962.99,41022,"Toledo",4,"Sul",0,"410820",2,8,1,7,1,7,0,0,0,0,0,8,1,7,1,7,5,10.5957090547881,8.77338459677665,0.279977752579701,29
"11506","PR","Formosa do Oeste",6460,39962.99,41022,"Toledo",4,"Sul",0,"410820",3,4,1,3,2,2,0,0,0,0,0,4,1,3,2,2,7,10.5957090547881,8.77338459677665,0.372083693735383,31
"11507","PR","Formosa do Oeste",6460,39962.99,41022,"Toledo",4,"Sul",0,"410820",4,11,2,9,3,8,0,0,0,0,0,11,2,9,3,8,4,10.5957090547881,8.77338459677665,0.417449388759257,30
"11508","PR","Formosa do Oeste",6460,39962.99,41022,"Toledo",4,"Sul",0,"410820",5,7,3,4,3,4,0,0,0,0,0,7,3,4,3,4,4,10.5957090547881,8.77338459677665,0.394109331785159,31
"11509","PR","Foz do Iguaçu",258248,56702.71,41024,"Foz do Iguaçu",4,"Sul",1,"410830",2,291,68,223,90,201,0,0,0,0,0,291,68,223,90,201,118,10.9455772839881,12.4616756425182,0.325615717192713,29
"11510","PR","Foz do Iguaçu",258248,56702.71,41024,"Foz do Iguaçu",4,"Sul",1,"410830",3,314,72,242,109,205,1,1,0,1,0,315,73,242,110,205,142,10.9455772839881,12.4616756425182,0.456832297997792,31
"11511","PR","Foz do Iguaçu",258248,56702.71,41024,"Foz do Iguaçu",4,"Sul",1,"410830",4,344,107,237,128,216,4,4,0,2,2,348,111,237,130,218,141,10.9455772839881,12.4616756425182,0.522792096627884,30
"11512","PR","Foz do Iguaçu",258248,56702.71,41024,"Foz do Iguaçu",4,"Sul",1,"410830",5,361,82,279,125,236,5,2,3,2,3,366,84,282,127,239,109,10.9455772839881,12.4616756425182,0.462617617819584,31
"11513","PR","Francisco Alves",5993,32119.32,41002,"Umuarama",4,"Sul",0,"410832",2,8,2,6,4,4,0,0,0,0,0,8,2,6,4,4,9,10.3772129972264,8.69834740045819,0.3151702756635,29
"11514","PR","Francisco Alves",5993,32119.32,41002,"Umuarama",4,"Sul",0,"410832",3,10,2,8,6,4,0,0,0,0,0,10,2,8,6,4,7,10.3772129972264,8.69834740045819,0.376467860402631,31
"11515","PR","Francisco Alves",5993,32119.32,41002,"Umuarama",4,"Sul",0,"410832",4,12,3,9,5,7,0,0,0,0,0,12,3,9,5,7,4,10.3772129972264,8.69834740045819,0.407247608960692,30
"11516","PR","Francisco Alves",5993,32119.32,41002,"Umuarama",4,"Sul",0,"410832",5,12,4,8,6,6,2,0,2,2,0,14,4,10,8,6,4,10.3772129972264,8.69834740045819,0.421297083332066,31
"11517","PR","Francisco Beltrão",92216,35460.16,41026,"Francisco Beltrão",4,"Sul",1,"410840",2,119,25,94,36,83,0,0,0,0,0,119,25,94,36,83,27,10.4761650917444,11.4318889302808,0.308519563796704,29
"11518","PR","Francisco Beltrão",92216,35460.16,41026,"Francisco Beltrão",4,"Sul",1,"410840",3,92,13,79,31,61,0,0,0,0,0,92,13,79,31,61,45,10.4761650917444,11.4318889302808,0.414002664672253,31
"11519","PR","Francisco Beltrão",92216,35460.16,41026,"Francisco Beltrão",4,"Sul",1,"410840",4,99,19,80,31,68,0,0,0,0,0,99,19,80,31,68,29,10.4761650917444,11.4318889302808,0.448730293363605,30
"11520","PR","Francisco Beltrão",92216,35460.16,41026,"Francisco Beltrão",4,"Sul",1,"410840",5,58,9,49,20,38,0,0,0,0,0,58,9,49,20,38,43,10.4761650917444,11.4318889302808,0.39579899208447,31
"11521","PR","General Carneiro",13685,20913.85,41033,"União da Vitória",4,"Sul",0,"410850",2,15,7,8,8,7,0,0,0,0,0,15,7,8,8,7,7,9.94816689790368,9.52405562147478,0.395077068521346,29
"11522","PR","General Carneiro",13685,20913.85,41033,"União da Vitória",4,"Sul",0,"410850",3,17,8,9,13,4,0,0,0,0,0,17,8,9,13,4,4,9.94816689790368,9.52405562147478,0.445734314273207,31
"11523","PR","General Carneiro",13685,20913.85,41033,"União da Vitória",4,"Sul",0,"410850",4,7,4,3,3,4,0,0,0,0,0,7,4,3,3,4,3,9.94816689790368,9.52405562147478,0.489782114081697,30
"11524","PR","General Carneiro",13685,20913.85,41033,"União da Vitória",4,"Sul",0,"410850",5,2,0,2,0,2,0,0,0,0,0,2,0,2,0,2,10,9.94816689790368,9.52405562147478,0.483316971217113,31
"11525","PR","Goioerê",28808,31176.74,41004,"Goioerê",4,"Sul",1,"410860",2,20,2,18,8,12,0,0,0,0,0,20,2,18,8,12,20,10.3474275829442,10.2684084053287,0.307936549905512,29
"11526","PR","Goioerê",28808,31176.74,41004,"Goioerê",4,"Sul",1,"410860",3,22,1,21,8,14,0,0,0,0,0,22,1,21,8,14,24,10.3474275829442,10.2684084053287,0.397297920851163,31
"11527","PR","Goioerê",28808,31176.74,41004,"Goioerê",4,"Sul",1,"410860",4,26,5,21,12,14,0,0,0,0,0,26,5,21,12,14,19,10.3474275829442,10.2684084053287,0.438253135415858,30
"11528","PR","Goioerê",28808,31176.74,41004,"Goioerê",4,"Sul",1,"410860",5,16,2,14,4,12,0,0,0,0,0,16,2,14,4,12,21,10.3474275829442,10.2684084053287,0.390148884989943,31
"11529","PR","Guaíra",33310,28449.48,41022,"Toledo",4,"Sul",1,"410880",2,38,19,19,15,23,0,0,0,0,0,38,19,19,15,23,20,10.2558851617073,10.4136129311877,0.324683421164496,29
"11530","PR","Guaíra",33310,28449.48,41022,"Toledo",4,"Sul",1,"410880",3,28,11,17,10,18,2,0,2,0,2,30,11,19,10,20,23,10.2558851617073,10.4136129311877,0.415106166964997,31
"11531","PR","Guaíra",33310,28449.48,41022,"Toledo",4,"Sul",1,"410880",4,37,9,28,11,26,0,0,0,0,0,37,9,28,11,26,15,10.2558851617073,10.4136129311877,0.435713520110261,30
"11532","PR","Guaíra",33310,28449.48,41022,"Toledo",4,"Sul",1,"410880",5,42,16,26,19,23,0,0,0,0,0,42,16,26,19,23,19,10.2558851617073,10.4136129311877,0.399854947843632,31
"11533","PR","Guairaçá",6609,34669.25,41001,"Paranavaí",4,"Sul",0,"410890",2,3,2,1,2,1,0,0,0,0,0,3,2,1,2,1,3,10.4536084059097,8.79618763547045,0.300101459809492,29
"11534","PR","Guairaçá",6609,34669.25,41001,"Paranavaí",4,"Sul",0,"410890",3,5,1,4,1,4,0,0,0,0,0,5,1,4,1,4,3,10.4536084059097,8.79618763547045,0.363864406257095,31
"11535","PR","Guairaçá",6609,34669.25,41001,"Paranavaí",4,"Sul",0,"410890",4,10,2,8,5,5,0,0,0,0,0,10,2,8,5,5,3,10.4536084059097,8.79618763547045,0.387980141488376,30
"11536","PR","Guairaçá",6609,34669.25,41001,"Paranavaí",4,"Sul",0,"410890",5,6,1,5,3,3,0,0,0,0,0,6,1,5,3,3,5,10.4536084059097,8.79618763547045,0.373280249887311,31
"11537","PR","Guaraci",5530,19423.76,41006,"Astorga",4,"Sul",0,"410920",2,3,1,2,0,3,0,0,0,0,0,3,1,2,0,3,3,9.87425233793446,8.61794309451638,0.331003643315753,29
"11538","PR","Guaraci",5530,19423.76,41006,"Astorga",4,"Sul",0,"410920",3,6,2,4,3,3,0,0,0,0,0,6,2,4,3,3,6,9.87425233793446,8.61794309451638,0.409807360248792,31
"11539","PR","Guaraci",5530,19423.76,41006,"Astorga",4,"Sul",0,"410920",4,1,1,0,1,0,0,0,0,0,0,1,1,0,1,0,1,9.87425233793446,8.61794309451638,0.428381714089413,30
"11540","PR","Guaraci",5530,19423.76,41006,"Astorga",4,"Sul",0,"410920",5,3,1,2,1,2,0,0,0,0,0,3,1,2,1,2,4,9.87425233793446,8.61794309451638,0.404817585531919,31
"11541","PR","Guaraniaçu",12217,27779.56,41023,"Cascavel",4,"Sul",0,"410930",2,11,3,8,3,8,0,0,0,0,0,11,3,8,3,8,7,10.23205577745,9.41058370340406,0.290168355688583,29
"11542","PR","Guaraniaçu",12217,27779.56,41023,"Cascavel",4,"Sul",0,"410930",3,9,6,3,4,5,0,0,0,0,0,9,6,3,4,5,11,10.23205577745,9.41058370340406,0.381147811169631,31
"11543","PR","Guaraniaçu",12217,27779.56,41023,"Cascavel",4,"Sul",0,"410930",4,9,1,8,3,6,0,0,0,0,0,9,1,8,3,6,5,10.23205577745,9.41058370340406,0.425996514485881,30
"11544","PR","Guaraniaçu",12217,27779.56,41023,"Cascavel",4,"Sul",0,"410930",5,19,4,15,9,10,0,0,0,0,0,19,4,15,9,10,9,10.23205577745,9.41058370340406,0.420023195606813,31
"11545","PR","Guarapuava",182644,33913.76,41029,"Guarapuava",4,"Sul",1,"410940",2,237,65,172,91,146,0,0,0,0,0,237,65,172,91,146,89,10.4315761107186,12.1152941819713,0.317940438842566,29
"11546","PR","Guarapuava",182644,33913.76,41029,"Guarapuava",4,"Sul",1,"410940",3,240,70,170,103,137,1,0,1,0,1,241,70,171,103,138,106,10.4315761107186,12.1152941819713,0.415683918645113,31
"11547","PR","Guarapuava",182644,33913.76,41029,"Guarapuava",4,"Sul",1,"410940",4,244,75,169,119,125,2,0,2,1,1,246,75,171,120,126,110,10.4315761107186,12.1152941819713,0.467541650968155,30
"11548","PR","Guarapuava",182644,33913.76,41029,"Guarapuava",4,"Sul",1,"410940",5,233,65,168,95,138,1,1,0,0,1,234,66,168,95,139,83,10.4315761107186,12.1152941819713,0.428385108729964,31
"11549","PR","Guaratuba",37527,21789.76,41038,"Paranaguá",4,"Sul",0,"410960",2,38,12,26,13,25,1,1,0,0,1,39,13,26,13,26,16,9.9891954136513,10.5328159528829,0.30590107891383,29
"11550","PR","Guaratuba",37527,21789.76,41038,"Paranaguá",4,"Sul",0,"410960",3,40,14,26,18,22,0,0,0,0,0,40,14,26,18,22,18,9.9891954136513,10.5328159528829,0.424019930140334,31
"11551","PR","Guaratuba",37527,21789.76,41038,"Paranaguá",4,"Sul",0,"410960",4,35,16,19,12,23,0,0,0,0,0,35,16,19,12,23,26,9.9891954136513,10.5328159528829,0.471116891415895,30
"11552","PR","Guaratuba",37527,21789.76,41038,"Paranaguá",4,"Sul",0,"410960",5,49,20,29,19,30,0,0,0,0,0,49,20,29,19,30,14,9.9891954136513,10.5328159528829,0.440505683130611,31
"11553","PR","Ibaiti",31644,21791.16,41017,"Ibaiti",4,"Sul",0,"410970",2,31,14,17,14,17,0,0,0,0,0,31,14,17,14,17,20,9.98925966195081,10.3623038361413,0.311998645236739,29
"11554","PR","Ibaiti",31644,21791.16,41017,"Ibaiti",4,"Sul",0,"410970",3,28,10,18,14,14,0,0,0,0,0,28,10,18,14,14,18,9.98925966195081,10.3623038361413,0.38010342433134,31
"11555","PR","Ibaiti",31644,21791.16,41017,"Ibaiti",4,"Sul",0,"410970",4,31,7,24,16,15,0,0,0,0,0,31,7,24,16,15,17,9.98925966195081,10.3623038361413,0.398584642095558,30
"11556","PR","Ibaiti",31644,21791.16,41017,"Ibaiti",4,"Sul",0,"410970",5,39,12,27,11,28,0,0,0,0,0,39,12,27,11,28,29,9.98925966195081,10.3623038361413,0.383681815687125,31
"11557","PR","Ibema",6370,26148.72,41023,"Cascavel",4,"Sul",0,"410975",2,11,3,8,5,6,0,0,0,0,0,11,3,8,5,6,5,10.1715555199203,8.75935474856621,0.366713809165216,29
"11558","PR","Ibema",6370,26148.72,41023,"Cascavel",4,"Sul",0,"410975",3,8,3,5,4,4,0,0,0,0,0,8,3,5,4,4,4,10.1715555199203,8.75935474856621,0.452786340149966,31
"11559","PR","Ibema",6370,26148.72,41023,"Cascavel",4,"Sul",0,"410975",4,3,2,1,1,2,0,0,0,0,0,3,2,1,1,2,4,10.1715555199203,8.75935474856621,0.474010783176641,30
"11560","PR","Ibema",6370,26148.72,41023,"Cascavel",4,"Sul",0,"410975",5,10,2,8,4,6,0,0,0,0,0,10,2,8,4,6,4,10.1715555199203,8.75935474856621,0.374107805624931,31
"11561","PR","Ibiporã",55131,45232.95,41011,"Londrina",4,"Sul",1,"410980",2,55,17,38,23,32,0,0,0,0,0,55,17,38,23,32,24,10.7195810825427,10.9174674503635,0.305407292823722,29
"11562","PR","Ibiporã",55131,45232.95,41011,"Londrina",4,"Sul",1,"410980",3,40,10,30,18,22,0,0,0,0,0,40,10,30,18,22,27,10.7195810825427,10.9174674503635,0.39387763068967,31
"11563","PR","Ibiporã",55131,45232.95,41011,"Londrina",4,"Sul",1,"410980",4,51,14,37,21,30,0,0,0,0,0,51,14,37,21,30,25,10.7195810825427,10.9174674503635,0.437971946041015,30
"11564","PR","Ibiporã",55131,45232.95,41011,"Londrina",4,"Sul",1,"410980",5,52,11,41,17,35,0,0,0,0,0,52,11,41,17,35,35,10.7195810825427,10.9174674503635,0.387780449330772,31
"11565","PR","Icaraíma",7786,29010.5,41002,"Umuarama",4,"Sul",0,"410990",2,6,1,5,1,5,0,0,0,0,0,6,1,5,1,5,5,10.275413112403,8.9600825281704,0.290060332357751,29
"11566","PR","Icaraíma",7786,29010.5,41002,"Umuarama",4,"Sul",0,"410990",3,7,1,6,3,4,0,0,0,0,0,7,1,6,3,4,5,10.275413112403,8.9600825281704,0.374550570350596,31
"11567","PR","Icaraíma",7786,29010.5,41002,"Umuarama",4,"Sul",0,"410990",4,6,1,5,2,4,0,0,0,0,0,6,1,5,2,4,5,10.275413112403,8.9600825281704,0.36730848005937,30
"11568","PR","Icaraíma",7786,29010.5,41002,"Umuarama",4,"Sul",0,"410990",5,9,1,8,6,3,0,0,0,0,0,9,1,8,6,3,5,10.275413112403,8.9600825281704,0.368980842710555,31
"11569","PR","Iguaraçu",4440,33960.38,41006,"Astorga",4,"Sul",1,"411000",2,9,4,5,0,9,0,0,0,0,0,9,4,5,0,9,1,10.4329498299975,8.39840965542627,0.297185861765924,29
"11570","PR","Iguaraçu",4440,33960.38,41006,"Astorga",4,"Sul",1,"411000",3,7,2,5,0,7,0,0,0,0,0,7,2,5,0,7,4,10.4329498299975,8.39840965542627,0.385503062425191,31
"11571","PR","Iguaraçu",4440,33960.38,41006,"Astorga",4,"Sul",1,"411000",4,3,1,2,2,1,0,0,0,0,0,3,1,2,2,1,4,10.4329498299975,8.39840965542627,0.393831549909281,30
"11572","PR","Iguaraçu",4440,33960.38,41006,"Astorga",4,"Sul",1,"411000",5,7,3,4,4,3,0,0,0,0,0,7,3,4,4,3,2,10.4329498299975,8.39840965542627,0.369059196759147,31
"11573","PR","Imbaú",13282,17384.38,41019,"Telêmaco Borba",4,"Sul",0,"411007",2,14,3,11,6,8,0,0,0,0,0,14,3,11,6,8,10,9.76332738087821,9.49416501410066,0.295204820988158,29
"11574","PR","Imbaú",13282,17384.38,41019,"Telêmaco Borba",4,"Sul",0,"411007",3,17,6,11,9,8,0,0,0,0,0,17,6,11,9,8,3,9.76332738087821,9.49416501410066,0.365420569462866,31
"11575","PR","Imbaú",13282,17384.38,41019,"Telêmaco Borba",4,"Sul",0,"411007",4,12,2,10,5,7,1,1,0,0,1,13,3,10,5,8,7,9.76332738087821,9.49416501410066,0.411065433114844,30
"11576","PR","Imbaú",13282,17384.38,41019,"Telêmaco Borba",4,"Sul",0,"411007",5,13,5,8,5,8,1,1,0,1,0,14,6,8,6,8,10,9.76332738087821,9.49416501410066,0.368808257353321,31
"11577","PR","Imbituva",32940,27827.18,41031,"Prudentópolis",4,"Sul",0,"411010",2,23,13,10,14,9,1,1,0,0,1,24,14,10,14,10,20,10.2337685198852,10.4024430037316,0.313299269925932,29
"11578","PR","Imbituva",32940,27827.18,41031,"Prudentópolis",4,"Sul",0,"411010",3,31,10,21,15,16,1,0,1,0,1,32,10,22,15,17,18,10.2337685198852,10.4024430037316,0.396603687406507,31
"11579","PR","Imbituva",32940,27827.18,41031,"Prudentópolis",4,"Sul",0,"411010",4,24,7,17,14,10,0,0,0,0,0,24,7,17,14,10,14,10.2337685198852,10.4024430037316,0.424945217216138,30
"11580","PR","Imbituva",32940,27827.18,41031,"Prudentópolis",4,"Sul",0,"411010",5,53,21,32,24,29,1,0,1,0,1,54,21,33,24,30,20,10.2337685198852,10.4024430037316,0.428702434757292,31
"11581","PR","Indianópolis",4465,115710.65,41003,"Cianorte",4,"Sul",0,"411040",2,3,1,2,2,1,0,0,0,0,0,3,1,2,2,1,2,11.6588479573466,8.4040244933106,0.319301978566806,29
"11582","PR","Indianópolis",4465,115710.65,41003,"Cianorte",4,"Sul",0,"411040",3,1,1,0,1,0,0,0,0,0,0,1,1,0,1,0,6,11.6588479573466,8.4040244933106,0.359919518566546,31
"11583","PR","Indianópolis",4465,115710.65,41003,"Cianorte",4,"Sul",0,"411040",4,7,4,3,3,4,0,0,0,0,0,7,4,3,3,4,1,11.6588479573466,8.4040244933106,0.399259748078789,30
"11584","PR","Indianópolis",4465,115710.65,41003,"Cianorte",4,"Sul",0,"411040",5,5,1,4,2,3,0,0,0,0,0,5,1,4,2,3,3,11.6588479573466,8.4040244933106,0.396680979019475,31
"11585","PR","Ipiranga",15251,33390.21,41031,"Prudentópolis",4,"Sul",0,"411050",2,11,5,6,4,7,0,0,0,0,0,11,5,6,4,7,6,10.4160180222261,9.63240035365618,0.306709743414681,29
"11586","PR","Ipiranga",15251,33390.21,41031,"Prudentópolis",4,"Sul",0,"411050",3,13,4,9,7,6,0,0,0,0,0,13,4,9,7,6,6,10.4160180222261,9.63240035365618,0.429163336928575,31
"11587","PR","Ipiranga",15251,33390.21,41031,"Prudentópolis",4,"Sul",0,"411050",4,13,4,9,4,9,0,0,0,0,0,13,4,9,4,9,10,10.4160180222261,9.63240035365618,0.416205022317182,30
"11588","PR","Ipiranga",15251,33390.21,41031,"Prudentópolis",4,"Sul",0,"411050",5,11,5,6,2,9,0,0,0,0,0,11,5,6,2,9,9,10.4160180222261,9.63240035365618,0.451935608512532,31
"11589","PR","Iporã",13782,26062.01,41002,"Umuarama",4,"Sul",0,"411060",2,14,2,12,6,8,0,0,0,0,0,14,2,12,6,8,9,10.1682339774052,9.53111867191715,0.293072723192676,29
"11590","PR","Iporã",13782,26062.01,41002,"Umuarama",4,"Sul",0,"411060",3,20,5,15,8,12,0,0,0,0,0,20,5,15,8,12,6,10.1682339774052,9.53111867191715,0.387641428206653,31
"11591","PR","Iporã",13782,26062.01,41002,"Umuarama",4,"Sul",0,"411060",4,15,5,10,5,10,0,0,0,0,0,15,5,10,5,10,6,10.1682339774052,9.53111867191715,0.384425207866082,30
"11592","PR","Iporã",13782,26062.01,41002,"Umuarama",4,"Sul",0,"411060",5,23,3,20,11,12,0,0,0,0,0,23,3,20,11,12,12,10.1682339774052,9.53111867191715,0.370919700611337,31
"11593","PR","Irati",61088,30279.24,41032,"Irati",4,"Sul",1,"411070",2,60,20,40,16,44,0,0,0,0,0,60,20,40,16,44,30,10.3182176081611,11.0200707265255,0.327402045764951,29
"11594","PR","Irati",61088,30279.24,41032,"Irati",4,"Sul",1,"411070",3,57,7,50,24,33,0,0,0,0,0,57,7,50,24,33,39,10.3182176081611,11.0200707265255,0.426373392265205,31
"11595","PR","Irati",61088,30279.24,41032,"Irati",4,"Sul",1,"411070",4,45,13,32,19,26,0,0,0,0,0,45,13,32,19,26,35,10.3182176081611,11.0200707265255,0.464662148010204,30
"11596","PR","Irati",61088,30279.24,41032,"Irati",4,"Sul",1,"411070",5,61,8,53,25,36,0,0,0,0,0,61,8,53,25,36,45,10.3182176081611,11.0200707265255,0.429324246614576,31
"11597","PR","Iretama",10098,25114.59,41005,"Campo Mourão",4,"Sul",0,"411080",2,4,2,2,3,1,0,0,0,0,0,4,2,2,3,1,7,10.1312042311455,9.22009266341886,0.308811151804688,29
"11598","PR","Iretama",10098,25114.59,41005,"Campo Mourão",4,"Sul",0,"411080",3,9,1,8,3,6,1,0,1,0,1,10,1,9,3,7,5,10.1312042311455,9.22009266341886,0.421059430283137,31
"11599","PR","Iretama",10098,25114.59,41005,"Campo Mourão",4,"Sul",0,"411080",4,4,1,3,0,4,0,0,0,0,0,4,1,3,0,4,8,10.1312042311455,9.22009266341886,0.475556680084617,30
"11600","PR","Iretama",10098,25114.59,41005,"Campo Mourão",4,"Sul",0,"411080",5,13,4,9,4,9,0,0,0,0,0,13,4,9,4,9,8,10.1312042311455,9.22009266341886,0.431270433829615,31
"11601","PR","Itaipulândia",11385,32812.56,41024,"Foz do Iguaçu",4,"Sul",0,"411095",2,8,3,5,3,5,0,0,0,0,0,8,3,5,3,5,8,10.3985666479037,9.34005197849784,0.333335869802547,29
"11602","PR","Itaipulândia",11385,32812.56,41024,"Foz do Iguaçu",4,"Sul",0,"411095",3,16,3,13,7,9,0,0,0,0,0,16,3,13,7,9,8,10.3985666479037,9.34005197849784,0.404887815641295,31
"11603","PR","Itaipulândia",11385,32812.56,41024,"Foz do Iguaçu",4,"Sul",0,"411095",4,15,5,10,4,11,0,0,0,0,0,15,5,10,4,11,13,10.3985666479037,9.34005197849784,0.417999779890911,30
"11604","PR","Itaipulândia",11385,32812.56,41024,"Foz do Iguaçu",4,"Sul",0,"411095",5,12,2,10,5,7,0,0,0,0,0,12,2,10,5,7,8,10.3985666479037,9.34005197849784,0.389011814169642,31
"11605","PR","Itambé",6109,31056.55,41008,"Floraí",4,"Sul",1,"411110",2,2,0,2,1,1,0,0,0,0,0,2,0,2,1,1,2,10.3435650151953,8.71751837264977,0.318803262930342,29
"11606","PR","Itambé",6109,31056.55,41008,"Floraí",4,"Sul",1,"411110",3,7,0,7,3,4,0,0,0,0,0,7,0,7,3,4,8,10.3435650151953,8.71751837264977,0.415117975392008,31
"11607","PR","Itambé",6109,31056.55,41008,"Floraí",4,"Sul",1,"411110",4,2,1,1,2,0,0,0,0,0,0,2,1,1,2,0,4,10.3435650151953,8.71751837264977,0.440644434758993,30
"11608","PR","Itambé",6109,31056.55,41008,"Floraí",4,"Sul",1,"411110",5,7,1,6,2,5,0,0,0,0,0,7,1,6,2,5,3,10.3435650151953,8.71751837264977,0.377367019682922,31
"11609","PR","Itapejara d'Oeste",12094,52016.54,41027,"Pato Branco",4,"Sul",0,"411120",2,12,2,10,5,7,0,0,0,0,0,12,2,10,5,7,10,10.8593170239109,9.40046474083316,0.323610462688018,29
"11610","PR","Itapejara d'Oeste",12094,52016.54,41027,"Pato Branco",4,"Sul",0,"411120",3,9,0,9,3,6,0,0,0,0,0,9,0,9,3,6,5,10.8593170239109,9.40046474083316,0.395299093856203,31
"11611","PR","Itapejara d'Oeste",12094,52016.54,41027,"Pato Branco",4,"Sul",0,"411120",4,9,1,8,5,4,1,0,1,0,1,10,1,9,5,5,4,10.8593170239109,9.40046474083316,0.394906190562664,30
"11612","PR","Itapejara d'Oeste",12094,52016.54,41027,"Pato Branco",4,"Sul",0,"411120",5,9,1,8,4,5,0,0,0,0,0,9,1,8,4,5,10,10.8593170239109,9.40046474083316,0.401331142462891,31
"11613","PR","Itaperuçu",29070,18017.57,41037,"Curitiba",4,"Sul",1,"411125",2,31,14,17,12,19,1,0,1,1,0,32,14,18,13,19,10,9.79910267190275,10.2774619935529,0.299493218672792,29
"11614","PR","Itaperuçu",29070,18017.57,41037,"Curitiba",4,"Sul",1,"411125",3,39,14,25,13,26,0,0,0,0,0,39,14,25,13,26,16,9.79910267190275,10.2774619935529,0.383754817394014,31
"11615","PR","Itaperuçu",29070,18017.57,41037,"Curitiba",4,"Sul",1,"411125",4,37,14,23,16,21,0,0,0,0,0,37,14,23,16,21,11,9.79910267190275,10.2774619935529,0.397417448007045,30
"11616","PR","Itaperuçu",29070,18017.57,41037,"Curitiba",4,"Sul",1,"411125",5,34,13,21,15,19,0,0,0,0,0,34,13,21,15,19,17,9.79910267190275,10.2774619935529,0.372799329285433,31
"11617","PR","Ivaí",13965,27240.57,41031,"Prudentópolis",4,"Sul",0,"411140",2,10,4,6,5,5,0,0,0,0,0,10,4,6,5,5,7,10.2124626851547,9.54430947837928,0.306166466092038,29
"11618","PR","Ivaí",13965,27240.57,41031,"Prudentópolis",4,"Sul",0,"411140",3,18,6,12,8,10,0,0,0,0,0,18,6,12,8,10,6,10.2124626851547,9.54430947837928,0.382836399544534,31
"11619","PR","Ivaí",13965,27240.57,41031,"Prudentópolis",4,"Sul",0,"411140",4,12,5,7,5,7,0,0,0,0,0,12,5,7,5,7,8,10.2124626851547,9.54430947837928,0.375535739730003,30
"11620","PR","Ivaí",13965,27240.57,41031,"Prudentópolis",4,"Sul",0,"411140",5,16,6,10,5,11,0,0,0,0,0,16,6,10,5,11,5,10.2124626851547,9.54430947837928,0.423796831692504,31
"11621","PR","Ivaiporã",31935,25614.24,41013,"Ivaiporã",4,"Sul",1,"411150",2,18,1,17,2,16,0,0,0,0,0,18,1,17,2,16,32,10.150903725818,10.3714578659957,0.299686540464783,29
"11622","PR","Ivaiporã",31935,25614.24,41013,"Ivaiporã",4,"Sul",1,"411150",3,30,2,28,8,22,0,0,0,0,0,30,2,28,8,22,28,10.150903725818,10.3714578659957,0.382723353287167,31
"11623","PR","Ivaiporã",31935,25614.24,41013,"Ivaiporã",4,"Sul",1,"411150",4,28,4,24,9,19,0,0,0,0,0,28,4,24,9,19,21,10.150903725818,10.3714578659957,0.415222235149158,30
"11624","PR","Ivaiporã",31935,25614.24,41013,"Ivaiporã",4,"Sul",1,"411150",5,27,4,23,11,16,0,0,0,0,0,27,4,23,11,16,37,10.150903725818,10.3714578659957,0.383674664665353,31
"11625","PR","Ivaté",8240,24077.53,41002,"Umuarama",4,"Sul",0,"411155",2,11,3,8,4,7,0,0,0,0,0,11,3,8,4,7,4,10.0890343194108,9.01675562290352,0.296511913245887,29
"11626","PR","Ivaté",8240,24077.53,41002,"Umuarama",4,"Sul",0,"411155",3,8,0,8,2,6,0,0,0,0,0,8,0,8,2,6,3,10.0890343194108,9.01675562290352,0.372348690613578,31
"11627","PR","Ivaté",8240,24077.53,41002,"Umuarama",4,"Sul",0,"411155",4,9,1,8,3,6,0,0,0,0,0,9,1,8,3,6,1,10.0890343194108,9.01675562290352,0.383744206052854,30
"11628","PR","Ivaté",8240,24077.53,41002,"Umuarama",4,"Sul",0,"411155",5,2,0,2,2,0,0,0,0,0,0,2,0,2,2,0,6,10.0890343194108,9.01675562290352,0.356238669904092,31
"11629","PR","Ivatuba",3279,34521.35,41008,"Floraí",4,"Sul",0,"411160",2,3,0,3,1,2,0,0,0,0,0,3,0,3,1,2,2,10.4493332521963,8.09529377684465,0.308627671214855,29
"11630","PR","Ivatuba",3279,34521.35,41008,"Floraí",4,"Sul",0,"411160",3,0,0,0,0,0,0,0,0,0,0,0,0,0,0,0,3,10.4493332521963,8.09529377684465,0.414878352391264,31
"11631","PR","Ivatuba",3279,34521.35,41008,"Floraí",4,"Sul",0,"411160",4,5,0,5,1,4,0,0,0,0,0,5,0,5,1,4,5,10.4493332521963,8.09529377684465,0.505150550648137,30
"11632","PR","Ivatuba",3279,34521.35,41008,"Floraí",4,"Sul",0,"411160",5,0,0,0,0,0,0,0,0,0,0,0,0,0,0,0,3,10.4493332521963,8.09529377684465,0.453288568857809,31
"11633","PR","Jacarezinho",39322,34442.35,41016,"Jacarezinho",4,"Sul",1,"411180",2,36,11,25,17,19,1,0,1,0,1,37,11,26,17,20,26,10.4470421908247,10.5795394376674,0.325894402890991,29
"11634","PR","Jacarezinho",39322,34442.35,41016,"Jacarezinho",4,"Sul",1,"411180",3,51,7,44,20,31,0,0,0,0,0,51,7,44,20,31,22,10.4470421908247,10.5795394376674,0.419021645339989,31
"11635","PR","Jacarezinho",39322,34442.35,41016,"Jacarezinho",4,"Sul",1,"411180",4,47,12,35,14,33,0,0,0,0,0,47,12,35,14,33,22,10.4470421908247,10.5795394376674,0.460222655081267,30
"11636","PR","Jacarezinho",39322,34442.35,41016,"Jacarezinho",4,"Sul",1,"411180",5,61,17,44,27,34,0,0,0,0,0,61,17,44,27,34,27,10.4470421908247,10.5795394376674,0.424474912996244,31
"11637","PR","Jaguapitã",13742,57909.85,41006,"Astorga",4,"Sul",1,"411190",2,12,2,10,7,5,0,0,0,0,0,12,2,10,7,5,9,10.9666427699903,9.52821211559102,0.288667338102038,29
"11638","PR","Jaguapitã",13742,57909.85,41006,"Astorga",4,"Sul",1,"411190",3,10,3,7,6,4,0,0,0,0,0,10,3,7,6,4,11,10.9666427699903,9.52821211559102,0.373740251755755,31
"11639","PR","Jaguapitã",13742,57909.85,41006,"Astorga",4,"Sul",1,"411190",4,7,3,4,0,7,0,0,0,0,0,7,3,4,0,7,8,10.9666427699903,9.52821211559102,0.417962890632782,30
"11640","PR","Jaguapitã",13742,57909.85,41006,"Astorga",4,"Sul",1,"411190",5,21,6,15,15,6,0,0,0,0,0,21,6,15,15,6,15,10.9666427699903,9.52821211559102,0.379853440490136,31
"11641","PR","Jaguariaíva",35027,42684.52,41020,"Jaguariaíva",4,"Sul",1,"411200",2,44,14,30,16,28,0,0,0,0,0,44,14,30,16,28,20,10.6615916042131,10.4638744716449,0.344255898156331,29
"11642","PR","Jaguariaíva",35027,42684.52,41020,"Jaguariaíva",4,"Sul",1,"411200",3,43,12,31,20,23,0,0,0,0,0,43,12,31,20,23,24,10.6615916042131,10.4638744716449,0.43006461489599,31
"11643","PR","Jaguariaíva",35027,42684.52,41020,"Jaguariaíva",4,"Sul",1,"411200",4,47,12,35,19,28,0,0,0,0,0,47,12,35,19,28,17,10.6615916042131,10.4638744716449,0.472191245877336,30
"11644","PR","Jaguariaíva",35027,42684.52,41020,"Jaguariaíva",4,"Sul",1,"411200",5,42,11,31,21,21,2,0,2,1,1,44,11,33,22,22,27,10.6615916042131,10.4638744716449,0.456370730026,31
"11645","PR","Jandaia do Sul",21230,32094.76,41010,"Apucarana",4,"Sul",1,"411210",2,14,1,13,2,12,0,0,0,0,0,14,1,13,2,12,17,10.3764480559176,9.9631705546973,0.266031676185416,29
"11646","PR","Jandaia do Sul",21230,32094.76,41010,"Apucarana",4,"Sul",1,"411210",3,14,2,12,6,8,0,0,0,0,0,14,2,12,6,8,11,10.3764480559176,9.9631705546973,0.356059349183335,31
"11647","PR","Jandaia do Sul",21230,32094.76,41010,"Apucarana",4,"Sul",1,"411210",4,22,5,17,9,13,0,0,0,0,0,22,5,17,9,13,15,10.3764480559176,9.9631705546973,0.382772676597711,30
"11648","PR","Jandaia do Sul",21230,32094.76,41010,"Apucarana",4,"Sul",1,"411210",5,15,2,13,4,11,0,0,0,0,0,15,2,13,4,11,19,10.3764480559176,9.9631705546973,0.349312369634915,31
"11649","PR","Japurá",9500,26887.19,41003,"Cianorte",4,"Sul",0,"411240",2,4,1,3,0,4,0,0,0,0,0,4,1,3,0,4,5,10.1994052439884,9.15904707758863,0.326734094074608,29
"11650","PR","Japurá",9500,26887.19,41003,"Cianorte",4,"Sul",0,"411240",3,10,0,10,2,8,0,0,0,0,0,10,0,10,2,8,7,10.1994052439884,9.15904707758863,0.387241729879502,31
"11651","PR","Japurá",9500,26887.19,41003,"Cianorte",4,"Sul",0,"411240",4,6,1,5,3,3,0,0,0,0,0,6,1,5,3,3,4,10.1994052439884,9.15904707758863,0.429018657765054,30
"11652","PR","Japurá",9500,26887.19,41003,"Cianorte",4,"Sul",0,"411240",5,4,1,3,0,4,0,0,0,0,0,4,1,3,0,4,9,10.1994052439884,9.15904707758863,0.387072396031363,31
"11653","PR","Jardim Alegre",11196,22020.85,41013,"Ivaiporã",4,"Sul",0,"411250",2,11,3,8,3,8,0,0,0,0,0,11,3,8,3,8,10,9.99974501080323,9.32331185063534,0.294908771583838,29
"11654","PR","Jardim Alegre",11196,22020.85,41013,"Ivaiporã",4,"Sul",0,"411250",3,5,2,3,0,5,0,0,0,0,0,5,2,3,0,5,9,9.99974501080323,9.32331185063534,0.379005570254579,31
"11655","PR","Jardim Alegre",11196,22020.85,41013,"Ivaiporã",4,"Sul",0,"411250",4,7,1,6,3,4,1,0,1,0,1,8,1,7,3,5,17,9.99974501080323,9.32331185063534,0.407317411573174,30
"11656","PR","Jardim Alegre",11196,22020.85,41013,"Ivaiporã",4,"Sul",0,"411250",5,14,3,11,4,10,0,0,0,0,0,14,3,11,4,10,8,9.99974501080323,9.32331185063534,0.367929017951074,31
"11657","PR","Jataizinho",12638,15234.12,41014,"Assaí",4,"Sul",1,"411270",2,8,4,4,4,4,0,0,0,0,0,8,4,4,4,4,12,9.63129292801868,9.4444634273334,0.341519468654996,29
"11658","PR","Jataizinho",12638,15234.12,41014,"Assaí",4,"Sul",1,"411270",3,13,1,12,5,8,0,0,0,0,0,13,1,12,5,8,11,9.63129292801868,9.4444634273334,0.400714884567862,31
"11659","PR","Jataizinho",12638,15234.12,41014,"Assaí",4,"Sul",1,"411270",4,20,4,16,10,10,1,0,1,0,1,21,4,17,10,11,9,9.63129292801868,9.4444634273334,0.434696579848577,30
"11660","PR","Jataizinho",12638,15234.12,41014,"Assaí",4,"Sul",1,"411270",5,16,3,13,7,9,0,0,0,0,0,16,3,13,7,9,9,9.63129292801868,9.4444634273334,0.397193378052313,31
"11661","PR","Jesuítas",8330,40574.75,41022,"Toledo",4,"Sul",0,"411275",2,4,2,2,1,3,0,0,0,0,0,4,2,2,1,3,6,10.6109012309344,9.02761873516089,0.348330477657546,29
"11662","PR","Jesuítas",8330,40574.75,41022,"Toledo",4,"Sul",0,"411275",3,7,0,7,2,5,0,0,0,0,0,7,0,7,2,5,7,10.6109012309344,9.02761873516089,0.42918136803432,31
"11663","PR","Jesuítas",8330,40574.75,41022,"Toledo",4,"Sul",0,"411275",4,6,2,4,2,4,0,0,0,0,0,6,2,4,2,4,2,10.6109012309344,9.02761873516089,0.428692602138914,30
"11664","PR","Jesuítas",8330,40574.75,41022,"Toledo",4,"Sul",0,"411275",5,9,2,7,5,4,0,0,0,0,0,9,2,7,5,4,10,10.6109012309344,9.02761873516089,0.399121764250741,31
"11665","PR","Joaquim Távora",12009,49769.88,41018,"Wenceslau Braz",4,"Sul",0,"411280",2,7,1,6,1,6,0,0,0,0,0,7,1,6,1,6,7,10.8151652607587,9.39341164766068,0.339923470540654,29
"11666","PR","Joaquim Távora",12009,49769.88,41018,"Wenceslau Braz",4,"Sul",0,"411280",3,12,6,6,1,11,0,0,0,0,0,12,6,6,1,11,6,10.8151652607587,9.39341164766068,0.425583604887429,31
"11667","PR","Joaquim Távora",12009,49769.88,41018,"Wenceslau Braz",4,"Sul",0,"411280",4,11,5,6,4,7,0,0,0,0,0,11,5,6,4,7,6,10.8151652607587,9.39341164766068,0.451432033078518,30
"11668","PR","Joaquim Távora",12009,49769.88,41018,"Wenceslau Braz",4,"Sul",0,"411280",5,16,3,13,5,11,0,0,0,0,0,16,3,13,5,11,4,10.8151652607587,9.39341164766068,0.440331335708291,31
"11669","PR","Juranda",7292,45869.17,41004,"Goioerê",4,"Sul",0,"411295",2,9,1,8,2,7,0,0,0,0,0,9,1,8,2,7,7,10.7335484928123,8.89453313579855,0.272879436883876,29
"11670","PR","Juranda",7292,45869.17,41004,"Goioerê",4,"Sul",0,"411295",3,6,4,2,3,3,0,0,0,0,0,6,4,2,3,3,5,10.7335484928123,8.89453313579855,0.382219431732815,31
"11671","PR","Juranda",7292,45869.17,41004,"Goioerê",4,"Sul",0,"411295",4,10,2,8,5,5,1,0,1,1,0,11,2,9,6,5,5,10.7335484928123,8.89453313579855,0.471966214860401,30
"11672","PR","Juranda",7292,45869.17,41004,"Goioerê",4,"Sul",0,"411295",5,10,1,9,0,10,0,0,0,0,0,10,1,9,0,10,5,10.7335484928123,8.89453313579855,0.413896337543617,31
"11673","PR","Jussara",7041,32148.38,41003,"Cianorte",4,"Sul",0,"411300",2,3,0,3,0,3,0,0,0,0,0,3,0,3,0,3,4,10.3781173395937,8.85950548451913,0.322074979279949,29
"11674","PR","Jussara",7041,32148.38,41003,"Cianorte",4,"Sul",0,"411300",3,8,1,7,3,5,0,0,0,0,0,8,1,7,3,5,6,10.3781173395937,8.85950548451913,0.402211997167795,31
"11675","PR","Jussara",7041,32148.38,41003,"Cianorte",4,"Sul",0,"411300",4,4,1,3,2,2,0,0,0,0,0,4,1,3,2,2,6,10.3781173395937,8.85950548451913,0.411966330901957,30
"11676","PR","Jussara",7041,32148.38,41003,"Cianorte",4,"Sul",0,"411300",5,7,2,5,3,4,0,0,0,0,0,7,2,5,3,4,5,10.3781173395937,8.85950548451913,0.377141638803492,31
"11677","PR","Lapa",48410,34292.29,41036,"Lapa",4,"Sul",1,"411320",2,32,6,26,11,21,0,0,0,0,0,32,6,26,11,21,24,10.4426758265458,10.7874616829337,0.315189471519797,29
"11678","PR","Lapa",48410,34292.29,41036,"Lapa",4,"Sul",1,"411320",3,24,8,16,10,14,0,0,0,0,0,24,8,16,10,14,25,10.4426758265458,10.7874616829337,0.41379202744845,31
"11679","PR","Lapa",48410,34292.29,41036,"Lapa",4,"Sul",1,"411320",4,22,8,14,5,17,0,0,0,0,0,22,8,14,5,17,21,10.4426758265458,10.7874616829337,0.43894140710365,30
"11680","PR","Lapa",48410,34292.29,41036,"Lapa",4,"Sul",1,"411320",5,38,7,31,13,25,0,0,0,0,0,38,7,31,13,25,28,10.4426758265458,10.7874616829337,0.414449379938697,31
"11681","PR","Laranjeiras do Sul",32139,24175.13,41029,"Guarapuava",4,"Sul",0,"411330",2,37,10,27,10,27,0,0,0,0,0,37,10,27,10,27,22,10.0930796977631,10.3778255249307,0.320972476025742,29
"11682","PR","Laranjeiras do Sul",32139,24175.13,41029,"Guarapuava",4,"Sul",0,"411330",3,41,14,27,14,27,0,0,0,0,0,41,14,27,14,27,25,10.0930796977631,10.3778255249307,0.389446134441301,31
"11683","PR","Laranjeiras do Sul",32139,24175.13,41029,"Guarapuava",4,"Sul",0,"411330",4,28,7,21,14,14,0,0,0,0,0,28,7,21,14,14,20,10.0930796977631,10.3778255249307,0.444253499888199,30
"11684","PR","Laranjeiras do Sul",32139,24175.13,41029,"Guarapuava",4,"Sul",0,"411330",5,35,9,26,15,20,2,0,2,1,1,37,9,28,16,21,16,10.0930796977631,10.3778255249307,0.412791511025674,31
"11685","PR","Loanda",23242,25048.28,41001,"Paranavaí",4,"Sul",1,"411350",2,25,8,17,12,13,0,0,0,0,0,25,8,17,12,13,11,10.128560441481,10.0537162657828,0.292294402172273,29
"11686","PR","Loanda",23242,25048.28,41001,"Paranavaí",4,"Sul",1,"411350",3,20,6,14,7,13,0,0,0,0,0,20,6,14,7,13,19,10.128560441481,10.0537162657828,0.383254977482548,31
"11687","PR","Loanda",23242,25048.28,41001,"Paranavaí",4,"Sul",1,"411350",4,11,1,10,1,10,0,0,0,0,0,11,1,10,1,10,14,10.128560441481,10.0537162657828,0.385892530624303,30
"11688","PR","Loanda",23242,25048.28,41001,"Paranavaí",4,"Sul",1,"411350",5,3,0,3,0,3,0,0,0,0,0,3,0,3,0,3,10,10.128560441481,10.0537162657828,0.354093049141156,31
"11689","PR","Lobato",4819,38826.56,41006,"Astorga",4,"Sul",0,"411360",2,2,0,2,0,2,0,0,0,0,0,2,0,2,0,2,3,10.5668598275059,8.48032171664033,0.285164665626971,29
"11690","PR","Lobato",4819,38826.56,41006,"Astorga",4,"Sul",0,"411360",3,9,2,7,2,7,0,0,0,0,0,9,2,7,2,7,2,10.5668598275059,8.48032171664033,0.38803425087176,31
"11691","PR","Lobato",4819,38826.56,41006,"Astorga",4,"Sul",0,"411360",4,2,1,1,0,2,0,0,0,0,0,2,1,1,0,2,3,10.5668598275059,8.48032171664033,0.388408760158485,30
"11692","PR","Lobato",4819,38826.56,41006,"Astorga",4,"Sul",0,"411360",5,1,0,1,0,1,0,0,0,0,0,1,0,1,0,1,3,10.5668598275059,8.48032171664033,0.345893980954605,31
"11693","PR","Londrina",575377,35383.29,41011,"Londrina",4,"Sul",1,"411370",2,449,65,384,123,326,4,0,4,0,4,453,65,388,123,330,328,10.4739949537805,13.2627807571074,0.288996888874064,29
"11694","PR","Londrina",575377,35383.29,41011,"Londrina",4,"Sul",1,"411370",3,478,76,402,150,328,5,1,4,2,3,483,77,406,152,331,333,10.4739949537805,13.2627807571074,0.402316498242747,31
"11695","PR","Londrina",575377,35383.29,41011,"Londrina",4,"Sul",1,"411370",4,548,89,459,162,386,3,1,2,1,2,551,90,461,163,388,307,10.4739949537805,13.2627807571074,0.467576924224046,30
"11696","PR","Londrina",575377,35383.29,41011,"Londrina",4,"Sul",1,"411370",5,526,95,431,148,378,4,1,3,1,3,530,96,434,149,381,326,10.4739949537805,13.2627807571074,0.398140653600397,31
"11697","PR","Luiziana",7240,45022.98,41005,"Campo Mourão",4,"Sul",0,"411373",2,9,3,6,5,4,0,0,0,0,0,9,3,6,5,4,3,10.7149283050733,8.88737648537976,0.318820526292772,29
"11698","PR","Luiziana",7240,45022.98,41005,"Campo Mourão",4,"Sul",0,"411373",3,3,1,2,0,3,0,0,0,0,0,3,1,2,0,3,3,10.7149283050733,8.88737648537976,0.399723683021989,31
"11699","PR","Luiziana",7240,45022.98,41005,"Campo Mourão",4,"Sul",0,"411373",4,5,2,3,2,3,0,0,0,0,0,5,2,3,2,3,2,10.7149283050733,8.88737648537976,0.435515214462677,30
"11700","PR","Luiziana",7240,45022.98,41005,"Campo Mourão",4,"Sul",0,"411373",5,11,2,9,5,6,0,0,0,0,0,11,2,9,5,6,5,10.7149283050733,8.88737648537976,0.441592394562722,31
"11701","PR","Mallet",13663,52248.32,41032,"Irati",4,"Sul",0,"411390",2,11,2,9,2,9,0,0,0,0,0,11,2,9,2,9,8,10.8637630162001,9.52244672833849,0.3395826928012,29
"11702","PR","Mallet",13663,52248.32,41032,"Irati",4,"Sul",0,"411390",3,6,0,6,4,2,0,0,0,0,0,6,0,6,4,2,4,10.8637630162001,9.52244672833849,0.439884917195988,31
"11703","PR","Mallet",13663,52248.32,41032,"Irati",4,"Sul",0,"411390",4,12,1,11,5,7,0,0,0,0,0,12,1,11,5,7,6,10.8637630162001,9.52244672833849,0.450346647591234,30
"11704","PR","Mallet",13663,52248.32,41032,"Irati",4,"Sul",0,"411390",5,6,2,4,1,5,0,0,0,0,0,6,2,4,1,5,8,10.8637630162001,9.52244672833849,0.437300596737707,31
"11705","PR","Mamborê",13014,41062.6,41005,"Campo Mourão",4,"Sul",0,"411400",2,10,0,10,4,6,0,0,0,0,0,10,0,10,4,6,5,10.622853010536,9.47378098005493,0.349644035032903,29
"11706","PR","Mamborê",13014,41062.6,41005,"Campo Mourão",4,"Sul",0,"411400",3,17,2,15,8,9,0,0,0,0,0,17,2,15,8,9,7,10.622853010536,9.47378098005493,0.399353810757552,31
"11707","PR","Mamborê",13014,41062.6,41005,"Campo Mourão",4,"Sul",0,"411400",4,23,8,15,13,10,0,0,0,0,0,23,8,15,13,10,7,10.622853010536,9.47378098005493,0.411482418356812,30
"11708","PR","Mamborê",13014,41062.6,41005,"Campo Mourão",4,"Sul",0,"411400",5,20,6,14,4,16,0,0,0,0,0,20,6,14,4,16,6,10.622853010536,9.47378098005493,0.370812088317254,31
"11709","PR","Mandaguaçu",23100,24761.97,41006,"Astorga",4,"Sul",1,"411410",2,37,6,31,11,26,1,1,0,0,1,38,7,31,11,27,6,10.1170642874461,10.0475878965099,0.300190941764644,29
"11710","PR","Mandaguaçu",23100,24761.97,41006,"Astorga",4,"Sul",1,"411410",3,37,7,30,13,24,1,0,1,0,1,38,7,31,13,25,18,10.1170642874461,10.0475878965099,0.406485134117013,31
"11711","PR","Mandaguaçu",23100,24761.97,41006,"Astorga",4,"Sul",1,"411410",4,37,6,31,16,21,0,0,0,0,0,37,6,31,16,21,17,10.1170642874461,10.0475878965099,0.443095312777899,30
"11712","PR","Mandaguaçu",23100,24761.97,41006,"Astorga",4,"Sul",1,"411410",5,39,12,27,17,22,0,0,0,0,0,39,12,27,17,22,18,10.1170642874461,10.0475878965099,0.386088478206991,31
"11713","PR","Mandaguari",34515,45662.87,41009,"Maringá",4,"Sul",1,"411420",2,36,2,34,16,20,0,0,0,0,0,36,2,34,16,20,21,10.7290407739998,10.4491492911376,0.300583218521779,29
"11714","PR","Mandaguari",34515,45662.87,41009,"Maringá",4,"Sul",1,"411420",3,36,12,24,13,23,0,0,0,0,0,36,12,24,13,23,21,10.7290407739998,10.4491492911376,0.383670687671485,31
"11715","PR","Mandaguari",34515,45662.87,41009,"Maringá",4,"Sul",1,"411420",4,44,11,33,16,28,0,0,0,0,0,44,11,33,16,28,20,10.7290407739998,10.4491492911376,0.417721766695557,30
"11716","PR","Mandaguari",34515,45662.87,41009,"Maringá",4,"Sul",1,"411420",5,41,6,35,11,30,0,0,0,0,0,41,6,35,11,30,27,10.7290407739998,10.4491492911376,0.371242540729969,31
"11717","PR","Mandirituba",27315,23214.18,41037,"Curitiba",4,"Sul",1,"411430",2,30,11,19,8,22,0,0,0,0,0,30,11,19,8,22,11,10.0525185778401,10.2151912808298,0.305792508489965,29
"11718","PR","Mandirituba",27315,23214.18,41037,"Curitiba",4,"Sul",1,"411430",3,28,9,19,13,15,0,0,0,0,0,28,9,19,13,15,9,10.0525185778401,10.2151912808298,0.40041623660421,31
"11719","PR","Mandirituba",27315,23214.18,41037,"Curitiba",4,"Sul",1,"411430",4,29,5,24,11,18,0,0,0,0,0,29,5,24,11,18,11,10.0525185778401,10.2151912808298,0.428248826683652,30
"11720","PR","Mandirituba",27315,23214.18,41037,"Curitiba",4,"Sul",1,"411430",5,27,7,20,10,17,0,0,0,0,0,27,7,20,10,17,13,10.0525185778401,10.2151912808298,0.410174296857933,31
"11721","PR","Mangueirinha",16642,80180.85,41030,"Palmas",4,"Sul",0,"411440",2,16,7,9,5,11,0,0,0,0,0,16,7,9,5,11,7,11.2920399872877,9.71968489946038,0.306803328891021,29
"11722","PR","Mangueirinha",16642,80180.85,41030,"Palmas",4,"Sul",0,"411440",3,25,2,23,7,18,0,0,0,0,0,25,2,23,7,18,9,11.2920399872877,9.71968489946038,0.378206473134864,31
"11723","PR","Mangueirinha",16642,80180.85,41030,"Palmas",4,"Sul",0,"411440",4,25,4,21,11,14,0,0,0,0,0,25,4,21,11,14,9,11.2920399872877,9.71968489946038,0.399058430691093,30
"11724","PR","Mangueirinha",16642,80180.85,41030,"Palmas",4,"Sul",0,"411440",5,21,8,13,13,8,0,0,0,0,0,21,8,13,13,8,9,11.2920399872877,9.71968489946038,0.391602553517162,31
"11725","PR","Manoel Ribas",13510,28109.94,41013,"Ivaiporã",4,"Sul",0,"411450",2,8,4,4,3,5,0,0,0,0,0,8,4,4,3,5,5,10.2438785294266,9.51118543095424,0.299531643644996,29
"11726","PR","Manoel Ribas",13510,28109.94,41013,"Ivaiporã",4,"Sul",0,"411450",3,18,9,9,4,14,1,1,0,1,0,19,10,9,5,14,12,10.2438785294266,9.51118543095424,0.345291118888583,31
"11727","PR","Manoel Ribas",13510,28109.94,41013,"Ivaiporã",4,"Sul",0,"411450",4,10,5,5,5,5,0,0,0,0,0,10,5,5,5,5,5,10.2438785294266,9.51118543095424,0.408633433719117,30
"11728","PR","Manoel Ribas",13510,28109.94,41013,"Ivaiporã",4,"Sul",0,"411450",5,16,3,13,7,9,0,0,0,0,0,16,3,13,7,9,2,10.2438785294266,9.51118543095424,0.388160581646742,31
"11729","PR","Marechal Cândido Rondon",53495,44732.8,41022,"Toledo",4,"Sul",1,"411460",2,53,13,40,17,36,0,0,0,0,0,53,13,40,17,36,32,10.7084622922768,10.8873434705727,0.329441796111553,29
"11730","PR","Marechal Cândido Rondon",53495,44732.8,41022,"Toledo",4,"Sul",1,"411460",3,58,9,49,18,40,0,0,0,0,0,58,9,49,18,40,42,10.7084622922768,10.8873434705727,0.424538708296565,31
"11731","PR","Marechal Cândido Rondon",53495,44732.8,41022,"Toledo",4,"Sul",1,"411460",4,55,13,42,12,43,0,0,0,0,0,55,13,42,12,43,29,10.7084622922768,10.8873434705727,0.445465164345729,30
"11732","PR","Marechal Cândido Rondon",53495,44732.8,41022,"Toledo",4,"Sul",1,"411460",5,83,17,66,23,60,0,0,0,0,0,83,17,66,23,60,31,10.7084622922768,10.8873434705727,0.411232142214087,31
"11733","PR","Marialva",35804,42116.89,41009,"Maringá",4,"Sul",1,"411480",2,46,8,38,10,36,0,0,0,0,0,46,8,38,10,36,16,10.6482041268647,10.4858148979908,0.289774502328333,29
"11734","PR","Marialva",35804,42116.89,41009,"Maringá",4,"Sul",1,"411480",3,44,9,35,10,34,0,0,0,0,0,44,9,35,10,34,29,10.6482041268647,10.4858148979908,0.393953718952398,31
"11735","PR","Marialva",35804,42116.89,41009,"Maringá",4,"Sul",1,"411480",4,51,10,41,19,32,0,0,0,0,0,51,10,41,19,32,27,10.6482041268647,10.4858148979908,0.422316368477062,30
"11736","PR","Marialva",35804,42116.89,41009,"Maringá",4,"Sul",1,"411480",5,54,12,42,15,39,0,0,0,0,0,54,12,42,15,39,24,10.6482041268647,10.4858148979908,0.371196442834258,31
"11737","PR","Marilândia do Sul",8814,37610.62,41010,"Apucarana",4,"Sul",0,"411490",2,11,2,9,6,5,0,0,0,0,0,11,2,9,6,5,4,10.5350417363059,9.08409664540193,0.337060506653226,29
"11738","PR","Marilândia do Sul",8814,37610.62,41010,"Apucarana",4,"Sul",0,"411490",3,11,1,10,7,4,0,0,0,0,0,11,1,10,7,4,9,10.5350417363059,9.08409664540193,0.398044588974309,31
"11739","PR","Marilândia do Sul",8814,37610.62,41010,"Apucarana",4,"Sul",0,"411490",4,10,2,8,4,6,0,0,0,0,0,10,2,8,4,6,5,10.5350417363059,9.08409664540193,0.442045723629275,30
"11740","PR","Marilândia do Sul",8814,37610.62,41010,"Apucarana",4,"Sul",0,"411490",5,5,1,4,2,3,0,0,0,0,0,5,1,4,2,3,5,10.5350417363059,9.08409664540193,0.404407015508321,31
"11741","PR","Marilena",7084,19342.54,41001,"Paranavaí",4,"Sul",0,"411500",2,4,0,4,1,3,0,0,0,0,0,4,0,4,1,3,5,9.87006209440648,8.86559399890272,0.336169783591738,29
"11742","PR","Marilena",7084,19342.54,41001,"Paranavaí",4,"Sul",0,"411500",3,7,1,6,2,5,0,0,0,0,0,7,1,6,2,5,4,9.87006209440648,8.86559399890272,0.400539977214599,31
"11743","PR","Marilena",7084,19342.54,41001,"Paranavaí",4,"Sul",0,"411500",4,7,2,5,2,5,0,0,0,0,0,7,2,5,2,5,4,9.87006209440648,8.86559399890272,0.437028454161441,30
"11744","PR","Marilena",7084,19342.54,41001,"Paranavaí",4,"Sul",0,"411500",5,5,3,2,1,4,0,0,0,0,0,5,3,2,1,4,2,9.87006209440648,8.86559399890272,0.411934911877761,31
"11745","PR","Mariluz",10336,22238.9,41002,"Umuarama",4,"Sul",0,"411510",2,12,3,9,2,10,0,0,0,0,0,12,3,9,2,10,10,10.0095982867097,9.24338822602238,0.295475224664528,29
"11746","PR","Mariluz",10336,22238.9,41002,"Umuarama",4,"Sul",0,"411510",3,13,3,10,6,7,2,0,2,2,0,15,3,12,8,7,5,10.0095982867097,9.24338822602238,0.359801319865981,31
"11747","PR","Mariluz",10336,22238.9,41002,"Umuarama",4,"Sul",0,"411510",4,11,3,8,3,8,0,0,0,0,0,11,3,8,3,8,7,10.0095982867097,9.24338822602238,0.379826898763198,30
"11748","PR","Mariluz",10336,22238.9,41002,"Umuarama",4,"Sul",0,"411510",5,13,4,9,8,5,0,0,0,0,0,13,4,9,8,5,11,10.0095982867097,9.24338822602238,0.340189925211524,31
"11749","PR","Maringá",430157,44442.52,41009,"Maringá",4,"Sul",1,"411520",2,337,32,305,65,272,4,0,4,0,4,341,32,309,65,276,183,10.7019519478164,12.9719055373101,0.291788053861062,29
"11750","PR","Maringá",430157,44442.52,41009,"Maringá",4,"Sul",1,"411520",3,366,50,316,84,282,1,0,1,0,1,367,50,317,84,283,231,10.7019519478164,12.9719055373101,0.426142476531364,31
"11751","PR","Maringá",430157,44442.52,41009,"Maringá",4,"Sul",1,"411520",4,362,43,319,79,283,2,0,2,0,2,364,43,321,79,285,191,10.7019519478164,12.9719055373101,0.481299240324792,30
"11752","PR","Maringá",430157,44442.52,41009,"Maringá",4,"Sul",1,"411520",5,393,39,354,82,311,5,1,4,4,1,398,40,358,86,312,211,10.7019519478164,12.9719055373101,0.40608890984634,31
"11753","PR","Maripá",5582,62613.28,41022,"Toledo",4,"Sul",0,"411535",2,6,1,5,1,5,0,0,0,0,0,6,1,5,1,5,5,11.0447326751646,8.62730241409627,0.382957481472358,29
"11754","PR","Maripá",5582,62613.28,41022,"Toledo",4,"Sul",0,"411535",3,8,4,4,4,4,0,0,0,0,0,8,4,4,4,4,5,11.0447326751646,8.62730241409627,0.439105560738885,31
"11755","PR","Maripá",5582,62613.28,41022,"Toledo",4,"Sul",0,"411535",4,4,3,1,3,1,0,0,0,0,0,4,3,1,3,1,5,11.0447326751646,8.62730241409627,0.446964208830915,30
"11756","PR","Maripá",5582,62613.28,41022,"Toledo",4,"Sul",0,"411535",5,8,3,5,1,7,1,0,1,0,1,9,3,6,1,8,8,11.0447326751646,8.62730241409627,0.439115761047596,31
"11757","PR","Marmeleiro",14387,31572.28,41026,"Francisco Beltrão",4,"Sul",0,"411540",2,20,2,18,6,14,1,1,0,0,1,21,3,18,6,15,4,10.3600347994067,9.57408030003703,0.317058088459967,29
"11758","PR","Marmeleiro",14387,31572.28,41026,"Francisco Beltrão",4,"Sul",0,"411540",3,15,5,10,3,12,0,0,0,0,0,15,5,10,3,12,5,10.3600347994067,9.57408030003703,0.415895312607173,31
"11759","PR","Marmeleiro",14387,31572.28,41026,"Francisco Beltrão",4,"Sul",0,"411540",4,18,5,13,5,13,0,0,0,0,0,18,5,13,5,13,7,10.3600347994067,9.57408030003703,0.425342992090327,30
"11760","PR","Marmeleiro",14387,31572.28,41026,"Francisco Beltrão",4,"Sul",0,"411540",5,10,1,9,4,6,0,0,0,0,0,10,1,9,4,6,8,10.3600347994067,9.57408030003703,0.391370511435115,31
"11761","PR","Matelândia",18107,51478.22,41024,"Foz do Iguaçu",4,"Sul",0,"411560",2,25,6,19,13,12,0,0,0,0,0,25,6,19,13,12,7,10.8489140845777,9.80405388282064,0.359272642096329,29
"11762","PR","Matelândia",18107,51478.22,41024,"Foz do Iguaçu",4,"Sul",0,"411560",3,20,9,11,12,8,0,0,0,0,0,20,9,11,12,8,8,10.8489140845777,9.80405388282064,0.457905029287268,31
"11763","PR","Matelândia",18107,51478.22,41024,"Foz do Iguaçu",4,"Sul",0,"411560",4,28,6,22,8,20,0,0,0,0,0,28,6,22,8,20,6,10.8489140845777,9.80405388282064,0.469188791823547,30
"11764","PR","Matelândia",18107,51478.22,41024,"Foz do Iguaçu",4,"Sul",0,"411560",5,37,9,28,14,23,0,0,0,0,0,37,9,28,14,23,5,10.8489140845777,9.80405388282064,0.426296933675508,31
"11765","PR","Matinhos",35219,22284.64,41038,"Paranaguá",4,"Sul",1,"411570",2,28,8,20,13,15,0,0,0,0,0,28,8,20,13,15,25,10.0116529308863,10.4693409886886,0.333017664458321,29
"11766","PR","Matinhos",35219,22284.64,41038,"Paranaguá",4,"Sul",1,"411570",3,39,13,26,21,18,1,0,1,0,1,40,13,27,21,19,33,10.0116529308863,10.4693409886886,0.446393815624778,31
"11767","PR","Matinhos",35219,22284.64,41038,"Paranaguá",4,"Sul",1,"411570",4,37,11,26,19,18,0,0,0,0,0,37,11,26,19,18,21,10.0116529308863,10.4693409886886,0.50551187486288,30
"11768","PR","Matinhos",35219,22284.64,41038,"Paranaguá",4,"Sul",1,"411570",5,34,9,25,18,16,0,0,0,0,0,34,9,25,18,16,25,10.0116529308863,10.4693409886886,0.454915115299558,31
"11769","PR","Mauá da Serra",10800,28379.51,41010,"Apucarana",4,"Sul",0,"411575",2,11,1,10,4,7,0,0,0,0,0,11,1,10,4,7,1,10.2534226848849,9.28730141311231,0.323701958240266,29
"11770","PR","Mauá da Serra",10800,28379.51,41010,"Apucarana",4,"Sul",0,"411575",3,12,8,4,3,9,0,0,0,0,0,12,8,4,3,9,3,10.2534226848849,9.28730141311231,0.383882234038143,31
"11771","PR","Mauá da Serra",10800,28379.51,41010,"Apucarana",4,"Sul",0,"411575",4,22,7,15,12,10,0,0,0,0,0,22,7,15,12,10,5,10.2534226848849,9.28730141311231,0.415632339347805,30
"11772","PR","Mauá da Serra",10800,28379.51,41010,"Apucarana",4,"Sul",0,"411575",5,15,5,10,7,8,0,0,0,0,0,15,5,10,7,8,4,10.2534226848849,9.28730141311231,0.382303813768916,31
"11773","PR","Medianeira",46574,42116.01,41024,"Foz do Iguaçu",4,"Sul",1,"411580",2,53,17,36,12,41,0,0,0,0,0,53,17,36,12,41,24,10.6481832324161,10.7487977244932,0.341347769865269,29
"11774","PR","Medianeira",46574,42116.01,41024,"Foz do Iguaçu",4,"Sul",1,"411580",3,78,17,61,25,53,0,0,0,0,0,78,17,61,25,53,31,10.6481832324161,10.7487977244932,0.435105741739217,31
"11775","PR","Medianeira",46574,42116.01,41024,"Foz do Iguaçu",4,"Sul",1,"411580",4,58,17,41,22,36,0,0,0,0,0,58,17,41,22,36,18,10.6481832324161,10.7487977244932,0.468441034982066,30
"11776","PR","Medianeira",46574,42116.01,41024,"Foz do Iguaçu",4,"Sul",1,"411580",5,60,18,42,21,39,1,0,1,1,0,61,18,43,22,39,18,10.6481832324161,10.7487977244932,0.419303610474433,31
"11777","PR","Missal",10704,32446.53,41024,"Foz do Iguaçu",4,"Sul",0,"411605",2,9,2,7,2,7,0,0,0,0,0,9,2,7,2,7,8,10.3873487826702,9.27837278236801,0.320652083877225,29
"11778","PR","Missal",10704,32446.53,41024,"Foz do Iguaçu",4,"Sul",0,"411605",3,9,2,7,2,7,0,0,0,0,0,9,2,7,2,7,5,10.3873487826702,9.27837278236801,0.415696893509577,31
"11779","PR","Missal",10704,32446.53,41024,"Foz do Iguaçu",4,"Sul",0,"411605",4,5,4,1,2,3,0,0,0,0,0,5,4,1,2,3,9,10.3873487826702,9.27837278236801,0.470443819957666,30
"11780","PR","Missal",10704,32446.53,41024,"Foz do Iguaçu",4,"Sul",0,"411605",5,7,1,6,2,5,0,0,0,0,0,7,1,6,2,5,15,10.3873487826702,9.27837278236801,0.440924436879513,31
"11781","PR","Moreira Sales",12042,25425.59,41004,"Goioerê",4,"Sul",0,"411610",2,4,1,3,0,4,0,0,0,0,0,4,1,3,0,4,7,10.1435114261539,9.39615581802439,0.309581787996148,29
"11782","PR","Moreira Sales",12042,25425.59,41004,"Goioerê",4,"Sul",0,"411610",3,14,3,11,6,8,0,0,0,0,0,14,3,11,6,8,6,10.1435114261539,9.39615581802439,0.384964912075841,31
"11783","PR","Moreira Sales",12042,25425.59,41004,"Goioerê",4,"Sul",0,"411610",4,9,2,7,3,6,0,0,0,0,0,9,2,7,3,6,18,10.1435114261539,9.39615581802439,0.394491048711986,30
"11784","PR","Moreira Sales",12042,25425.59,41004,"Goioerê",4,"Sul",0,"411610",5,9,1,8,2,7,0,0,0,0,0,9,1,8,2,7,10,10.1435114261539,9.39615581802439,0.366724346623117,31
"11785","PR","Morretes",16446,20421.98,41038,"Paranaguá",4,"Sul",0,"411620",2,16,5,11,7,9,0,0,0,0,0,16,5,11,7,9,11,9.92436705077899,9.70783756553084,0.335555264716424,29
"11786","PR","Morretes",16446,20421.98,41038,"Paranaguá",4,"Sul",0,"411620",3,20,7,13,8,12,0,0,0,0,0,20,7,13,8,12,10,9.92436705077899,9.70783756553084,0.436948800158803,31
"11787","PR","Morretes",16446,20421.98,41038,"Paranaguá",4,"Sul",0,"411620",4,14,6,8,6,8,0,0,0,0,0,14,6,8,6,8,11,9.92436705077899,9.70783756553084,0.460792228969755,30
"11788","PR","Morretes",16446,20421.98,41038,"Paranaguá",4,"Sul",0,"411620",5,9,3,6,3,6,0,0,0,0,0,9,3,6,3,6,11,9.92436705077899,9.70783756553084,0.438919652595611,31
"11789","PR","Munhoz de Melo",4009,24148.09,41006,"Astorga",4,"Sul",0,"411630",2,4,1,3,2,2,0,0,0,0,0,4,1,3,2,2,3,10.0919605669261,8.29629711264251,0.326233595378239,29
"11790","PR","Munhoz de Melo",4009,24148.09,41006,"Astorga",4,"Sul",0,"411630",3,2,1,1,2,0,0,0,0,0,0,2,1,1,2,0,1,10.0919605669261,8.29629711264251,0.390670295693812,31
"11791","PR","Munhoz de Melo",4009,24148.09,41006,"Astorga",4,"Sul",0,"411630",4,5,1,4,1,4,0,0,0,0,0,5,1,4,1,4,4,10.0919605669261,8.29629711264251,0.405731080160612,30
"11792","PR","Munhoz de Melo",4009,24148.09,41006,"Astorga",4,"Sul",0,"411630",5,0,0,0,0,0,0,0,0,0,0,0,0,0,0,0,1,10.0919605669261,8.29629711264251,0.389710564739289,31
"11793","PR","Nova Aurora",10299,58755.55,41023,"Cascavel",4,"Sul",0,"411670",2,11,4,7,6,5,0,0,0,0,0,11,4,7,6,5,10,10.9811408956297,9.2398020821258,0.287863247466801,29
"11794","PR","Nova Aurora",10299,58755.55,41023,"Cascavel",4,"Sul",0,"411670",3,9,5,4,5,4,0,0,0,0,0,9,5,4,5,4,15,10.9811408956297,9.2398020821258,0.370383928389061,31
"11795","PR","Nova Aurora",10299,58755.55,41023,"Cascavel",4,"Sul",0,"411670",4,10,1,9,2,8,0,0,0,0,0,10,1,9,2,8,7,10.9811408956297,9.2398020821258,0.42388977805769,30
"11796","PR","Nova Aurora",10299,58755.55,41023,"Cascavel",4,"Sul",0,"411670",5,10,1,9,0,10,0,0,0,0,0,10,1,9,0,10,9,10.9811408956297,9.2398020821258,0.402416243626338,31
"11797","PR","Nova Esperança",27984,26155.04,41006,"Astorga",4,"Sul",1,"411690",2,19,4,15,3,16,1,0,1,0,1,20,4,16,3,17,15,10.1717971851478,10.2393881972584,0.297123234913985,29
"11798","PR","Nova Esperança",27984,26155.04,41006,"Astorga",4,"Sul",1,"411690",3,22,7,15,7,15,1,0,1,1,0,23,7,16,8,15,34,10.1717971851478,10.2393881972584,0.392787254710637,31
"11799","PR","Nova Esperança",27984,26155.04,41006,"Astorga",4,"Sul",1,"411690",4,21,5,16,7,14,0,0,0,0,0,21,5,16,7,14,14,10.1717971851478,10.2393881972584,0.400292151889895,30
"11800","PR","Nova Esperança",27984,26155.04,41006,"Astorga",4,"Sul",1,"411690",5,28,10,18,9,19,0,0,0,0,0,28,10,18,9,19,21,10.1717971851478,10.2393881972584,0.370584938253517,31
"11801","PR","Nova Fátima",8136,30298.71,41015,"Cornélio Procópio",4,"Sul",0,"411700",2,4,1,3,0,4,0,0,0,0,0,4,1,3,0,4,5,10.3188604163337,9.0040539377284,0.29550611261252,29
"11802","PR","Nova Fátima",8136,30298.71,41015,"Cornélio Procópio",4,"Sul",0,"411700",3,7,2,5,1,6,0,0,0,0,0,7,2,5,1,6,8,10.3188604163337,9.0040539377284,0.37999802787703,31
"11803","PR","Nova Fátima",8136,30298.71,41015,"Cornélio Procópio",4,"Sul",0,"411700",4,4,1,3,2,2,0,0,0,0,0,4,1,3,2,2,2,10.3188604163337,9.0040539377284,0.407983371954478,30
"11804","PR","Nova Fátima",8136,30298.71,41015,"Cornélio Procópio",4,"Sul",0,"411700",5,9,1,8,4,5,0,0,0,0,0,9,1,8,4,5,6,10.3188604163337,9.0040539377284,0.386948002226063,31
"11805","PR","Nova Londrina",13200,24026.21,41001,"Paranavaí",4,"Sul",1,"411710",2,9,1,8,6,3,0,0,0,0,0,9,1,8,6,3,8,10.0869005967742,9.48797210857446,0.318188727046444,29
"11806","PR","Nova Londrina",13200,24026.21,41001,"Paranavaí",4,"Sul",1,"411710",3,11,2,9,3,8,0,0,0,0,0,11,2,9,3,8,11,10.0869005967742,9.48797210857446,0.382962910248967,31
"11807","PR","Nova Londrina",13200,24026.21,41001,"Paranavaí",4,"Sul",1,"411710",4,6,0,6,2,4,0,0,0,0,0,6,0,6,2,4,5,10.0869005967742,9.48797210857446,0.424947502296709,30
"11808","PR","Nova Londrina",13200,24026.21,41001,"Paranavaí",4,"Sul",1,"411710",5,9,1,8,2,7,1,0,1,0,1,10,1,9,2,8,8,10.0869005967742,9.48797210857446,0.393343945796744,31
"11809","PR","Nova Olímpia",5826,14263.18,41002,"Umuarama",4,"Sul",0,"411720",2,6,1,5,0,6,0,0,0,0,0,6,1,5,0,6,3,9.56543667050969,8.67008593751938,0.2970357907758,29
"11810","PR","Nova Olímpia",5826,14263.18,41002,"Umuarama",4,"Sul",0,"411720",3,4,2,2,2,2,0,0,0,0,0,4,2,2,2,2,6,9.56543667050969,8.67008593751938,0.372154400784011,31
"11811","PR","Nova Olímpia",5826,14263.18,41002,"Umuarama",4,"Sul",0,"411720",4,6,1,5,2,4,1,1,0,0,1,7,2,5,2,5,4,9.56543667050969,8.67008593751938,0.402857921723275,30
"11812","PR","Nova Olímpia",5826,14263.18,41002,"Umuarama",4,"Sul",0,"411720",5,6,2,4,0,6,0,0,0,0,0,6,2,4,0,6,4,9.56543667050969,8.67008593751938,0.37310899089106,31
"11813","PR","Nova Santa Rosa",8266,40035.57,41022,"Toledo",4,"Sul",0,"411722",2,6,2,4,2,4,0,0,0,0,0,6,2,4,2,4,6,10.5975235879475,9.01990599507168,0.303446068752275,29
"11814","PR","Nova Santa Rosa",8266,40035.57,41022,"Toledo",4,"Sul",0,"411722",3,7,2,5,5,2,0,0,0,0,0,7,2,5,5,2,5,10.5975235879475,9.01990599507168,0.370672753748125,31
"11815","PR","Nova Santa Rosa",8266,40035.57,41022,"Toledo",4,"Sul",0,"411722",4,10,1,9,4,6,0,0,0,0,0,10,1,9,4,6,5,10.5975235879475,9.01990599507168,0.389218630875617,30
"11816","PR","Nova Santa Rosa",8266,40035.57,41022,"Toledo",4,"Sul",0,"411722",5,9,1,8,1,8,0,0,0,0,0,9,1,8,1,8,9,10.5975235879475,9.01990599507168,0.403040331579449,31
"11817","PR","Ourizona",3425,31021.49,41008,"Floraí",4,"Sul",1,"411740",2,3,1,2,2,1,0,0,0,0,0,3,1,2,2,1,1,10.3424354691037,8.13885675069633,0.287878348269075,29
"11818","PR","Ourizona",3425,31021.49,41008,"Floraí",4,"Sul",1,"411740",3,3,0,3,0,3,0,0,0,0,0,3,0,3,0,3,8,10.3424354691037,8.13885675069633,0.352745955970178,31
"11819","PR","Ourizona",3425,31021.49,41008,"Floraí",4,"Sul",1,"411740",4,0,0,0,0,0,0,0,0,0,0,0,0,0,0,0,2,10.3424354691037,8.13885675069633,0.404603574297038,30
"11820","PR","Ourizona",3425,31021.49,41008,"Floraí",4,"Sul",1,"411740",5,1,1,0,0,1,0,0,0,0,0,1,1,0,0,1,3,10.3424354691037,8.13885675069633,0.40768388829906,31
"11821","PR","Ouro Verde do Oeste",6016,29575.62,41022,"Toledo",4,"Sul",1,"411745",2,4,2,2,1,3,0,0,0,0,0,4,2,2,1,3,3,10.2947056522786,8.70217786562968,0.3212816642806,29
"11822","PR","Ouro Verde do Oeste",6016,29575.62,41022,"Toledo",4,"Sul",1,"411745",3,7,0,7,1,6,0,0,0,0,0,7,0,7,1,6,6,10.2947056522786,8.70217786562968,0.395679328722693,31
"11823","PR","Ouro Verde do Oeste",6016,29575.62,41022,"Toledo",4,"Sul",1,"411745",4,6,0,6,2,4,0,0,0,0,0,6,0,6,2,4,4,10.2947056522786,8.70217786562968,0.42998863375904,30
"11824","PR","Ouro Verde do Oeste",6016,29575.62,41022,"Toledo",4,"Sul",1,"411745",5,7,3,4,4,3,0,0,0,0,0,7,3,4,4,3,1,10.2947056522786,8.70217786562968,0.402175754450324,31
"11825","PR","Paiçandu",41773,20508.39,41009,"Maringá",4,"Sul",1,"411750",2,40,7,33,14,26,0,0,0,0,0,40,7,33,14,26,19,9.92858934969176,10.6400054767939,0.297956975060627,29
"11826","PR","Paiçandu",41773,20508.39,41009,"Maringá",4,"Sul",1,"411750",3,54,14,40,20,34,1,1,0,0,1,55,15,40,20,35,22,9.92858934969176,10.6400054767939,0.403804243306077,31
"11827","PR","Paiçandu",41773,20508.39,41009,"Maringá",4,"Sul",1,"411750",4,53,15,38,18,35,0,0,0,0,0,53,15,38,18,35,13,9.92858934969176,10.6400054767939,0.428736863838717,30
"11828","PR","Paiçandu",41773,20508.39,41009,"Maringá",4,"Sul",1,"411750",5,56,9,47,20,36,0,0,0,0,0,56,9,47,20,36,28,9.92858934969176,10.6400054767939,0.37677508722882,31
"11829","PR","Palmas",51755,23588.47,41030,"Palmas",4,"Sul",1,"411760",2,51,21,30,27,24,0,0,0,0,0,51,21,30,27,24,28,10.0685133123077,10.8542763248179,0.332659303955927,29
"11830","PR","Palmas",51755,23588.47,41030,"Palmas",4,"Sul",1,"411760",3,86,41,45,43,43,0,0,0,0,0,86,41,45,43,43,30,10.0685133123077,10.8542763248179,0.407641892873118,31
"11831","PR","Palmas",51755,23588.47,41030,"Palmas",4,"Sul",1,"411760",4,75,28,47,44,31,0,0,0,0,0,75,28,47,44,31,30,10.0685133123077,10.8542763248179,0.432300935561012,30
"11832","PR","Palmas",51755,23588.47,41030,"Palmas",4,"Sul",1,"411760",5,59,15,44,30,29,0,0,0,0,0,59,15,44,30,29,25,10.0685133123077,10.8542763248179,0.402308298488173,31
"11833","PR","Palmeira",33994,42390.25,41021,"Ponta Grossa",4,"Sul",0,"411770",2,36,13,23,17,19,0,0,0,0,0,36,13,23,17,19,14,10.6546736619467,10.4339393174373,0.307305936528764,29
"11834","PR","Palmeira",33994,42390.25,41021,"Ponta Grossa",4,"Sul",0,"411770",3,32,8,24,15,17,0,0,0,0,0,32,8,24,15,17,20,10.6546736619467,10.4339393174373,0.389692518861878,31
"11835","PR","Palmeira",33994,42390.25,41021,"Ponta Grossa",4,"Sul",0,"411770",4,48,4,44,15,33,0,0,0,0,0,48,4,44,15,33,15,10.6546736619467,10.4339393174373,0.423965583105333,30
"11836","PR","Palmeira",33994,42390.25,41021,"Ponta Grossa",4,"Sul",0,"411770",5,31,6,25,8,23,0,0,0,0,0,31,6,25,8,23,28,10.6546736619467,10.4339393174373,0.407654387539123,31
"11837","PR","Palmital",12960,18982.46,41028,"Pitanga",4,"Sul",0,"411780",2,11,6,5,8,3,0,0,0,0,0,11,6,5,8,3,6,9.85127067388117,9.46962296990626,0.314350119581209,29
"11838","PR","Palmital",12960,18982.46,41028,"Pitanga",4,"Sul",0,"411780",3,21,6,15,9,12,0,0,0,0,0,21,6,15,9,12,6,9.85127067388117,9.46962296990626,0.391655278151925,31
"11839","PR","Palmital",12960,18982.46,41028,"Pitanga",4,"Sul",0,"411780",4,23,8,15,9,14,0,0,0,0,0,23,8,15,9,14,4,9.85127067388117,9.46962296990626,0.432424462762193,30
"11840","PR","Palmital",12960,18982.46,41028,"Pitanga",4,"Sul",0,"411780",5,10,7,3,5,5,0,0,0,0,0,10,7,3,5,5,11,9.85127067388117,9.46962296990626,0.365069245015409,31
"11841","PR","Palotina",32121,69645.03,41022,"Toledo",4,"Sul",1,"411790",2,40,6,34,16,24,0,0,0,0,0,40,6,34,16,24,12,11.151166619878,10.3772653008264,0.322326914335644,29
"11842","PR","Palotina",32121,69645.03,41022,"Toledo",4,"Sul",1,"411790",3,41,10,31,13,28,0,0,0,0,0,41,10,31,13,28,15,11.151166619878,10.3772653008264,0.406936922637768,31
"11843","PR","Palotina",32121,69645.03,41022,"Toledo",4,"Sul",1,"411790",4,45,12,33,14,31,0,0,0,0,0,45,12,33,14,31,10,11.151166619878,10.3772653008264,0.430243808317079,30
"11844","PR","Palotina",32121,69645.03,41022,"Toledo",4,"Sul",1,"411790",5,35,8,27,16,19,0,0,0,0,0,35,8,27,16,19,19,11.151166619878,10.3772653008264,0.417474685537299,31
"11845","PR","Paraíso do Norte",14023,24179.33,41001,"Paranavaí",4,"Sul",0,"411800",2,20,3,17,5,15,0,0,0,0,0,20,3,17,5,15,7,10.0932534149346,9.54845411772665,0.323240748719066,29
"11846","PR","Paraíso do Norte",14023,24179.33,41001,"Paranavaí",4,"Sul",0,"411800",3,9,1,8,3,6,0,0,0,0,0,9,1,8,3,6,9,10.0932534149346,9.54845411772665,0.407138140351146,31
"11847","PR","Paraíso do Norte",14023,24179.33,41001,"Paranavaí",4,"Sul",0,"411800",4,18,4,14,8,10,0,0,0,0,0,18,4,14,8,10,8,10.0932534149346,9.54845411772665,0.429333542917505,30
"11848","PR","Paraíso do Norte",14023,24179.33,41001,"Paranavaí",4,"Sul",0,"411800",5,18,5,13,5,13,0,0,0,0,0,18,5,13,5,13,15,10.0932534149346,9.54845411772665,0.401331549642991,31
"11849","PR","Paranacity",11580,28209.55,41001,"Paranavaí",4,"Sul",1,"411810",2,10,5,5,6,4,0,0,0,0,0,10,5,5,6,4,7,10.2474158520787,9.35703475112699,0.292738807415048,29
"11850","PR","Paranacity",11580,28209.55,41001,"Paranavaí",4,"Sul",1,"411810",3,10,3,7,5,5,0,0,0,0,0,10,3,7,5,5,11,10.2474158520787,9.35703475112699,0.363676795956281,31
"11851","PR","Paranacity",11580,28209.55,41001,"Paranavaí",4,"Sul",1,"411810",4,20,3,17,8,12,0,0,0,0,0,20,3,17,8,12,4,10.2474158520787,9.35703475112699,0.382934442750359,30
"11852","PR","Paranacity",11580,28209.55,41001,"Paranavaí",4,"Sul",1,"411810",5,8,3,5,4,4,0,0,0,0,0,8,3,5,4,4,4,10.2474158520787,9.35703475112699,0.331920059186913,31
"11853","PR","Paranaguá",156174,63606.54,41038,"Paranaguá",4,"Sul",1,"411820",2,153,46,107,65,88,0,0,0,0,0,153,46,107,65,88,88,11.0604715742302,11.9587260492678,0.321344913853658,29
"11854","PR","Paranaguá",156174,63606.54,41038,"Paranaguá",4,"Sul",1,"411820",3,201,48,153,84,117,3,2,1,3,0,204,50,154,87,117,59,11.0604715742302,11.9587260492678,0.411926707219713,31
"11855","PR","Paranaguá",156174,63606.54,41038,"Paranaguá",4,"Sul",1,"411820",4,179,54,125,55,124,1,1,0,1,0,180,55,125,56,124,85,11.0604715742302,11.9587260492678,0.459805673186127,30
"11856","PR","Paranaguá",156174,63606.54,41038,"Paranaguá",4,"Sul",1,"411820",5,209,67,142,96,113,1,0,1,0,1,210,67,143,96,114,91,11.0604715742302,11.9587260492678,0.422451559397378,31
"11857","PR","Paranavaí",88922,30152.82,41001,"Paranavaí",4,"Sul",1,"411840",2,69,10,59,21,48,1,0,1,1,0,70,10,60,22,48,50,10.3140337301198,11.3955148599529,0.29831137120967,29
"11858","PR","Paranavaí",88922,30152.82,41001,"Paranavaí",4,"Sul",1,"411840",3,97,9,88,26,71,1,1,0,0,1,98,10,88,26,72,54,10.3140337301198,11.3955148599529,0.39149920603173,31
"11859","PR","Paranavaí",88922,30152.82,41001,"Paranavaí",4,"Sul",1,"411840",4,93,13,80,26,67,0,0,0,0,0,93,13,80,26,67,52,10.3140337301198,11.3955148599529,0.426838282298972,30
"11860","PR","Paranavaí",88922,30152.82,41001,"Paranavaí",4,"Sul",1,"411840",5,85,15,70,31,54,0,0,0,0,0,85,15,70,31,54,63,10.3140337301198,11.3955148599529,0.385969273776684,31
"11861","PR","Pato Branco",83843,46842.5,41027,"Pato Branco",4,"Sul",1,"411850",2,110,21,89,36,74,0,0,0,0,0,110,21,89,36,74,44,10.7545461894727,11.3367012813574,0.312321065007414,29
"11862","PR","Pato Branco",83843,46842.5,41027,"Pato Branco",4,"Sul",1,"411850",3,122,28,94,32,90,1,1,0,0,1,123,29,94,32,91,46,10.7545461894727,11.3367012813574,0.435341946267598,31
"11863","PR","Pato Branco",83843,46842.5,41027,"Pato Branco",4,"Sul",1,"411850",4,117,19,98,36,81,1,0,1,0,1,118,19,99,36,82,44,10.7545461894727,11.3367012813574,0.464272298843523,30
"11864","PR","Pato Branco",83843,46842.5,41027,"Pato Branco",4,"Sul",1,"411850",5,123,18,105,40,83,1,0,1,0,1,124,18,106,40,84,52,10.7545461894727,11.3367012813574,0.412470771231327,31
"11865","PR","Peabiru",14007,23403.1,41005,"Campo Mourão",4,"Sul",1,"411880",2,10,2,8,3,7,0,0,0,0,0,10,2,8,3,7,8,10.0606237712038,9.54731248363905,0.314535342710991,29
"11866","PR","Peabiru",14007,23403.1,41005,"Campo Mourão",4,"Sul",1,"411880",3,13,1,12,6,7,1,0,1,1,0,14,1,13,7,7,10,10.0606237712038,9.54731248363905,0.402062170276172,31
"11867","PR","Peabiru",14007,23403.1,41005,"Campo Mourão",4,"Sul",1,"411880",4,11,1,10,6,5,0,0,0,0,0,11,1,10,6,5,9,10.0606237712038,9.54731248363905,0.461460196466672,30
"11868","PR","Peabiru",14007,23403.1,41005,"Campo Mourão",4,"Sul",1,"411880",5,11,2,9,8,3,0,0,0,0,0,11,2,9,8,3,8,10.0606237712038,9.54731248363905,0.397361313493316,31
"11869","PR","Perobal",6160,29981.44,41002,"Umuarama",4,"Sul",0,"411885",2,2,1,1,1,1,0,0,0,0,0,2,1,1,1,1,7,10.3083338025244,8.72583205652757,0.313480276181456,29
"11870","PR","Perobal",6160,29981.44,41002,"Umuarama",4,"Sul",0,"411885",3,12,1,11,3,9,0,0,0,0,0,12,1,11,3,9,4,10.3083338025244,8.72583205652757,0.376300724875102,31
"11871","PR","Perobal",6160,29981.44,41002,"Umuarama",4,"Sul",0,"411885",4,6,4,2,2,4,0,0,0,0,0,6,4,2,2,4,2,10.3083338025244,8.72583205652757,0.402070164572452,30
"11872","PR","Perobal",6160,29981.44,41002,"Umuarama",4,"Sul",0,"411885",5,7,1,6,3,4,0,0,0,0,0,7,1,6,3,4,6,10.3083338025244,8.72583205652757,0.363739827704763,31
"11873","PR","Pérola",11321,30399.07,41002,"Umuarama",4,"Sul",0,"411890",2,9,0,9,3,6,0,0,0,0,0,9,0,9,3,6,4,10.3221672948211,9.33441468707811,0.290172215185378,29
"11874","PR","Pérola",11321,30399.07,41002,"Umuarama",4,"Sul",0,"411890",3,10,1,9,3,7,0,0,0,0,0,10,1,9,3,7,6,10.3221672948211,9.33441468707811,0.406059462123673,31
"11875","PR","Pérola",11321,30399.07,41002,"Umuarama",4,"Sul",0,"411890",4,7,0,7,3,4,0,0,0,0,0,7,0,7,3,4,2,10.3221672948211,9.33441468707811,0.408842728450511,30
"11876","PR","Pérola",11321,30399.07,41002,"Umuarama",4,"Sul",0,"411890",5,5,1,4,0,5,1,0,1,0,1,6,1,5,0,6,7,10.3221672948211,9.33441468707811,0.377483382554237,31
"11877","PR","Piên",12882,63033.25,41039,"Rio Negro",4,"Sul",0,"411910",2,17,6,11,7,10,0,0,0,0,0,17,6,11,7,10,3,11.0514176439257,9.46358626710684,0.32550876559087,29
"11878","PR","Piên",12882,63033.25,41039,"Rio Negro",4,"Sul",0,"411910",3,8,1,7,2,6,0,0,0,0,0,8,1,7,2,6,6,11.0514176439257,9.46358626710684,0.442880493989968,31
"11879","PR","Piên",12882,63033.25,41039,"Rio Negro",4,"Sul",0,"411910",4,15,4,11,4,11,0,0,0,0,0,15,4,11,4,11,4,11.0514176439257,9.46358626710684,0.436511739021472,30
"11880","PR","Piên",12882,63033.25,41039,"Rio Negro",4,"Sul",0,"411910",5,12,2,10,3,9,0,0,0,0,0,12,2,10,3,9,4,11.0514176439257,9.46358626710684,0.435829459567335,31
"11881","PR","Pinhais",133490,44773.58,41037,"Curitiba",4,"Sul",1,"411915",2,119,17,102,36,83,1,0,1,0,1,120,17,103,36,84,59,10.7093735122998,11.8017818476498,0.291774530655762,29
"11882","PR","Pinhais",133490,44773.58,41037,"Curitiba",4,"Sul",1,"411915",3,120,22,98,43,77,0,0,0,0,0,120,22,98,43,77,56,10.7093735122998,11.8017818476498,0.397871809685336,31
"11883","PR","Pinhais",133490,44773.58,41037,"Curitiba",4,"Sul",1,"411915",4,97,18,79,35,62,0,0,0,0,0,97,18,79,35,62,68,10.7093735122998,11.8017818476498,0.45373739398152,30
"11884","PR","Pinhais",133490,44773.58,41037,"Curitiba",4,"Sul",1,"411915",5,109,24,85,36,73,0,0,0,0,0,109,24,85,36,73,53,10.7093735122998,11.8017818476498,0.403046867404296,31
"11885","PR","Pinhão",32559,48650.61,41029,"Guarapuava",4,"Sul",0,"411930",2,47,20,27,27,20,0,0,0,0,0,47,20,27,27,20,19,10.7924196260761,10.3908091071141,0.315625910683515,29
"11886","PR","Pinhão",32559,48650.61,41029,"Guarapuava",4,"Sul",0,"411930",3,41,21,20,19,22,0,0,0,0,0,41,21,20,19,22,15,10.7924196260761,10.3908091071141,0.399748483733558,31
"11887","PR","Pinhão",32559,48650.61,41029,"Guarapuava",4,"Sul",0,"411930",4,44,18,26,26,18,1,1,0,0,1,45,19,26,26,19,15,10.7924196260761,10.3908091071141,0.429709282532954,30
"11888","PR","Pinhão",32559,48650.61,41029,"Guarapuava",4,"Sul",0,"411930",5,45,14,31,17,28,1,1,0,0,1,46,15,31,17,29,11,10.7924196260761,10.3908091071141,0.426465193821509,31
"11889","PR","Piraí do Sul",25617,31574.18,41020,"Jaguariaíva",4,"Sul",0,"411940",2,22,10,12,8,14,0,0,0,0,0,22,10,12,8,14,14,10.3600949769686,10.1510114725757,0.284407187846579,29
"11890","PR","Piraí do Sul",25617,31574.18,41020,"Jaguariaíva",4,"Sul",0,"411940",3,23,3,20,12,11,0,0,0,0,0,23,3,20,12,11,9,10.3600949769686,10.1510114725757,0.380028325512186,31
"11891","PR","Piraí do Sul",25617,31574.18,41020,"Jaguariaíva",4,"Sul",0,"411940",4,26,6,20,14,12,0,0,0,0,0,26,6,20,14,12,17,10.3600949769686,10.1510114725757,0.396225531814525,30
"11892","PR","Piraí do Sul",25617,31574.18,41020,"Jaguariaíva",4,"Sul",0,"411940",5,26,11,15,12,14,0,0,0,0,0,26,11,15,12,14,14,10.3600949769686,10.1510114725757,0.390001311487536,31
"11893","PR","Piraquara",114970,11681.04,41037,"Curitiba",4,"Sul",1,"411950",2,113,33,80,50,63,2,1,1,1,1,115,34,81,51,64,35,9.36572229351419,11.6524265037478,0.310803921367197,29
"11894","PR","Piraquara",114970,11681.04,41037,"Curitiba",4,"Sul",1,"411950",3,129,36,93,60,69,1,0,1,0,1,130,36,94,60,70,53,9.36572229351419,11.6524265037478,0.404336743347274,31
"11895","PR","Piraquara",114970,11681.04,41037,"Curitiba",4,"Sul",1,"411950",4,87,35,52,34,53,0,0,0,0,0,87,35,52,34,53,39,9.36572229351419,11.6524265037478,0.455280036156757,30
"11896","PR","Piraquara",114970,11681.04,41037,"Curitiba",4,"Sul",1,"411950",5,129,35,94,54,75,2,1,1,0,2,131,36,95,54,77,55,9.36572229351419,11.6524265037478,0.412166493158508,31
"11897","PR","Pitanga",29994,29163.59,41028,"Pitanga",4,"Sul",0,"411960",2,31,5,26,12,19,0,0,0,0,0,31,5,26,12,19,19,10.2806762923993,10.3087526406416,0.291860738152473,29
"11898","PR","Pitanga",29994,29163.59,41028,"Pitanga",4,"Sul",0,"411960",3,31,10,21,14,17,0,0,0,0,0,31,10,21,14,17,15,10.2806762923993,10.3087526406416,0.373659442735499,31
"11899","PR","Pitanga",29994,29163.59,41028,"Pitanga",4,"Sul",0,"411960",4,42,9,33,20,22,0,0,0,0,0,42,9,33,20,22,22,10.2806762923993,10.3087526406416,0.392090170557808,30
"11900","PR","Pitanga",29994,29163.59,41028,"Pitanga",4,"Sul",0,"411960",5,29,6,23,13,16,0,0,0,0,0,29,6,23,13,16,15,10.2806762923993,10.3087526406416,0.372450195661178,31
"11901","PR","Planalto",13431,24111.9,41025,"Capanema",4,"Sul",0,"411980",2,11,1,10,4,7,0,0,0,0,0,11,1,10,4,7,7,10.0904607735451,9.50532074690907,0.303435927976857,29
"11902","PR","Planalto",13431,24111.9,41025,"Capanema",4,"Sul",0,"411980",3,16,4,12,2,14,0,0,0,0,0,16,4,12,2,14,10,10.0904607735451,9.50532074690907,0.372361852314953,31
"11903","PR","Planalto",13431,24111.9,41025,"Capanema",4,"Sul",0,"411980",4,11,3,8,4,7,0,0,0,0,0,11,3,8,4,7,10,10.0904607735451,9.50532074690907,0.413878910525288,30
"11904","PR","Planalto",13431,24111.9,41025,"Capanema",4,"Sul",0,"411980",5,7,2,5,1,6,0,0,0,0,0,7,2,5,1,6,5,10.0904607735451,9.50532074690907,0.421453263233201,31
"11905","PR","Ponta Grossa",355336,43253.34,41021,"Ponta Grossa",4,"Sul",1,"411990",2,339,78,261,137,202,3,2,1,1,2,342,80,262,138,204,169,10.6748297348118,12.7808190997021,0.303588602458726,29
"11906","PR","Ponta Grossa",355336,43253.34,41021,"Ponta Grossa",4,"Sul",1,"411990",3,387,105,282,145,242,2,0,2,1,1,389,105,284,146,243,170,10.6748297348118,12.7808190997021,0.404606708613383,31
"11907","PR","Ponta Grossa",355336,43253.34,41021,"Ponta Grossa",4,"Sul",1,"411990",4,413,82,331,162,251,4,2,2,1,3,417,84,333,163,254,170,10.6748297348118,12.7808190997021,0.446697417189234,30
"11908","PR","Ponta Grossa",355336,43253.34,41021,"Ponta Grossa",4,"Sul",1,"411990",5,465,100,365,165,300,7,2,5,4,3,472,102,370,169,303,177,10.6748297348118,12.7808190997021,0.403472318046974,31
"11909","PR","Pontal do Paraná",27915,91044.66,41038,"Paranaguá",4,"Sul",1,"411995",2,21,4,17,11,10,0,0,0,0,0,21,4,17,11,10,15,11.4191054343419,10.2369194577445,0.334738045214757,29
"11910","PR","Pontal do Paraná",27915,91044.66,41038,"Paranaguá",4,"Sul",1,"411995",3,29,7,22,10,19,0,0,0,0,0,29,7,22,10,19,22,11.4191054343419,10.2369194577445,0.434719055224961,31
"11911","PR","Pontal do Paraná",27915,91044.66,41038,"Paranaguá",4,"Sul",1,"411995",4,25,10,15,11,14,0,0,0,0,0,25,10,15,11,14,19,11.4191054343419,10.2369194577445,0.484897622460965,30
"11912","PR","Pontal do Paraná",27915,91044.66,41038,"Paranaguá",4,"Sul",1,"411995",5,21,7,14,11,10,0,0,0,0,0,21,7,14,11,10,14,11.4191054343419,10.2369194577445,0.459187873058106,31
"11913","PR","Porecatu",12748,42639.27,41007,"Porecatu",4,"Sul",1,"412000",2,7,2,5,1,6,0,0,0,0,0,7,2,5,1,6,13,10.6605309386181,9.45312967553723,0.30968090669248,29
"11914","PR","Porecatu",12748,42639.27,41007,"Porecatu",4,"Sul",1,"412000",3,11,0,11,7,4,0,0,0,0,0,11,0,11,7,4,17,10.6605309386181,9.45312967553723,0.371138092896591,31
"11915","PR","Porecatu",12748,42639.27,41007,"Porecatu",4,"Sul",1,"412000",4,4,0,4,2,2,0,0,0,0,0,4,0,4,2,2,11,10.6605309386181,9.45312967553723,0.434760054317405,30
"11916","PR","Porecatu",12748,42639.27,41007,"Porecatu",4,"Sul",1,"412000",5,12,2,10,4,8,0,0,0,0,0,12,2,10,4,8,6,10.6605309386181,9.45312967553723,0.415117884709814,31
"11917","PR","Presidente Castelo Branco",5351,26125.94,41006,"Astorga",4,"Sul",1,"412040",2,3,0,3,3,0,0,0,0,0,0,3,0,3,3,0,3,10.1706839694811,8.5850387383113,0.312074868837809,29
"11918","PR","Presidente Castelo Branco",5351,26125.94,41006,"Astorga",4,"Sul",1,"412040",3,7,1,6,3,4,0,0,0,0,0,7,1,6,3,4,7,10.1706839694811,8.5850387383113,0.417128460710447,31
"11919","PR","Presidente Castelo Branco",5351,26125.94,41006,"Astorga",4,"Sul",1,"412040",4,4,0,4,2,2,0,0,0,0,0,4,0,4,2,2,4,10.1706839694811,8.5850387383113,0.449608160942614,30
"11920","PR","Presidente Castelo Branco",5351,26125.94,41006,"Astorga",4,"Sul",1,"412040",5,4,2,2,2,2,0,0,0,0,0,4,2,2,2,2,3,10.1706839694811,8.5850387383113,0.39750010804582,31
"11921","PR","Primeiro de Maio",11130,26990.66,41007,"Porecatu",4,"Sul",0,"412050",2,5,0,5,1,4,0,0,0,0,0,5,0,5,1,4,4,10.2032461592144,9.31739944426959,0.288744010371289,29
"11922","PR","Primeiro de Maio",11130,26990.66,41007,"Porecatu",4,"Sul",0,"412050",3,5,2,3,2,3,0,0,0,0,0,5,2,3,2,3,8,10.2032461592144,9.31739944426959,0.340769660162933,31
"11923","PR","Primeiro de Maio",11130,26990.66,41007,"Porecatu",4,"Sul",0,"412050",4,8,3,5,2,6,0,0,0,0,0,8,3,5,2,6,11,10.2032461592144,9.31739944426959,0.359098768220196,30
"11924","PR","Primeiro de Maio",11130,26990.66,41007,"Porecatu",4,"Sul",0,"412050",5,7,3,4,1,6,0,0,0,0,0,7,3,4,1,6,7,10.2032461592144,9.31739944426959,0.314157558974798,31
"11925","PR","Prudentópolis",52513,23031.31,41031,"Prudentópolis",4,"Sul",0,"412060",2,39,12,27,14,25,1,0,1,0,1,40,12,28,14,26,40,10.0446098735244,10.8688160369748,0.30338966843712,29
"11926","PR","Prudentópolis",52513,23031.31,41031,"Prudentópolis",4,"Sul",0,"412060",3,47,14,33,18,29,0,0,0,0,0,47,14,33,18,29,32,10.0446098735244,10.8688160369748,0.383536461950746,31
"11927","PR","Prudentópolis",52513,23031.31,41031,"Prudentópolis",4,"Sul",0,"412060",4,43,15,28,16,27,0,0,0,0,0,43,15,28,16,27,16,10.0446098735244,10.8688160369748,0.401832397381172,30
"11928","PR","Prudentópolis",52513,23031.31,41031,"Prudentópolis",4,"Sul",0,"412060",5,46,7,39,18,28,1,1,0,0,1,47,8,39,18,29,27,10.0446098735244,10.8688160369748,0.400923484399391,31
"11929","PR","Quatiguá",7477,23984.75,41018,"Wenceslau Braz",4,"Sul",0,"412070",2,6,2,4,3,3,0,0,0,0,0,6,2,4,3,3,7,10.0851734907007,8.91958692099992,0.286735798382871,29
"11930","PR","Quatiguá",7477,23984.75,41018,"Wenceslau Braz",4,"Sul",0,"412070",3,6,0,6,3,3,0,0,0,0,0,6,0,6,3,3,7,10.0851734907007,8.91958692099992,0.393525212379804,31
"11931","PR","Quatiguá",7477,23984.75,41018,"Wenceslau Braz",4,"Sul",0,"412070",4,8,1,7,2,6,0,0,0,0,0,8,1,7,2,6,7,10.0851734907007,8.91958692099992,0.419413460894651,30
"11932","PR","Quatiguá",7477,23984.75,41018,"Wenceslau Braz",4,"Sul",0,"412070",5,14,3,11,5,9,0,0,0,0,0,14,3,11,5,9,4,10.0851734907007,8.91958692099992,0.37611864878664,31
"11933","PR","Quatro Barras",23911,66795.52,41037,"Curitiba",4,"Sul",1,"412080",2,16,3,13,7,9,0,0,0,0,0,16,3,13,7,9,6,11.1093912914075,10.0820938830826,0.31089066906829,29
"11934","PR","Quatro Barras",23911,66795.52,41037,"Curitiba",4,"Sul",1,"412080",3,28,5,23,8,20,0,0,0,0,0,28,5,23,8,20,10,11.1093912914075,10.0820938830826,0.404870085460741,31
"11935","PR","Quatro Barras",23911,66795.52,41037,"Curitiba",4,"Sul",1,"412080",4,19,4,15,7,12,0,0,0,0,0,19,4,15,7,12,9,11.1093912914075,10.0820938830826,0.468852689547284,30
"11936","PR","Quatro Barras",23911,66795.52,41037,"Curitiba",4,"Sul",1,"412080",5,23,7,16,11,12,0,0,0,0,0,23,7,16,11,12,7,11.1093912914075,10.0820938830826,0.425237140767709,31
"11937","PR","Quedas do Iguaçu",34409,35360.99,41029,"Guarapuava",4,"Sul",0,"412090",2,29,10,19,14,15,0,0,0,0,0,29,10,19,14,15,13,10.4733645140972,10.4460734370499,0.323528679878149,29
"11938","PR","Quedas do Iguaçu",34409,35360.99,41029,"Guarapuava",4,"Sul",0,"412090",3,43,15,28,21,22,2,1,1,0,2,45,16,29,21,24,17,10.4733645140972,10.4460734370499,0.415552656031488,31
"11939","PR","Quedas do Iguaçu",34409,35360.99,41029,"Guarapuava",4,"Sul",0,"412090",4,33,9,24,10,23,0,0,0,0,0,33,9,24,10,23,13,10.4733645140972,10.4460734370499,0.431182688159126,30
"11940","PR","Quedas do Iguaçu",34409,35360.99,41029,"Guarapuava",4,"Sul",0,"412090",5,48,14,34,24,24,0,0,0,0,0,48,14,34,24,24,13,10.4733645140972,10.4460734370499,0.416991767405883,31
"11941","PR","Querência do Norte",12232,19477.22,41001,"Paranavaí",4,"Sul",0,"412100",2,11,7,4,6,5,0,0,0,0,0,11,7,4,6,5,7,9.87700085654014,9.4118107476089,0.276453677328061,29
"11942","PR","Querência do Norte",12232,19477.22,41001,"Paranavaí",4,"Sul",0,"412100",3,10,3,7,7,3,0,0,0,0,0,10,3,7,7,3,5,9.87700085654014,9.4118107476089,0.369624480047911,31
"11943","PR","Querência do Norte",12232,19477.22,41001,"Paranavaí",4,"Sul",0,"412100",4,9,3,6,3,6,0,0,0,0,0,9,3,6,3,6,5,9.87700085654014,9.4118107476089,0.37777001469602,30
"11944","PR","Querência do Norte",12232,19477.22,41001,"Paranavaí",4,"Sul",0,"412100",5,15,8,7,9,6,0,0,0,0,0,15,8,7,9,6,5,9.87700085654014,9.4118107476089,0.384446468254468,31
"11945","PR","Realeza",16950,35674.76,41025,"Capanema",4,"Sul",0,"412140",2,10,2,8,3,7,0,0,0,0,0,10,2,8,3,7,12,10.4821987149223,9.7380231128086,0.296287618946943,29
"11946","PR","Realeza",16950,35674.76,41025,"Capanema",4,"Sul",0,"412140",3,17,1,16,5,12,0,0,0,0,0,17,1,16,5,12,11,10.4821987149223,9.7380231128086,0.3804082061172,31
"11947","PR","Realeza",16950,35674.76,41025,"Capanema",4,"Sul",0,"412140",4,15,1,14,1,14,0,0,0,0,0,15,1,14,1,14,5,10.4821987149223,9.7380231128086,0.418207456776957,30
"11948","PR","Realeza",16950,35674.76,41025,"Capanema",4,"Sul",0,"412140",5,18,4,14,7,11,0,0,0,0,0,18,4,14,7,11,6,10.4821987149223,9.7380231128086,0.414501665469547,31
"11949","PR","Rebouças",14946,25556.97,41032,"Irati",4,"Sul",0,"412150",2,21,2,19,10,11,0,0,0,0,0,21,2,19,10,11,8,10.1486653568636,9.61219898449024,0.337620871857685,29
"11950","PR","Rebouças",14946,25556.97,41032,"Irati",4,"Sul",0,"412150",3,11,2,9,3,8,0,0,0,0,0,11,2,9,3,8,10,10.1486653568636,9.61219898449024,0.411115713662692,31
"11951","PR","Rebouças",14946,25556.97,41032,"Irati",4,"Sul",0,"412150",4,13,1,12,3,10,1,1,0,0,1,14,2,12,3,11,9,10.1486653568636,9.61219898449024,0.438313488018411,30
"11952","PR","Rebouças",14946,25556.97,41032,"Irati",4,"Sul",0,"412150",5,11,1,10,3,8,0,0,0,0,0,11,1,10,3,8,11,10.1486653568636,9.61219898449024,0.43369820931367,31
"11953","PR","Reserva",26825,23196.34,41019,"Telêmaco Borba",4,"Sul",0,"412170",2,29,14,15,14,15,0,0,0,0,0,29,14,15,14,15,20,10.0517497865885,10.1970895674989,0.291455707228046,29
"11954","PR","Reserva",26825,23196.34,41019,"Telêmaco Borba",4,"Sul",0,"412170",3,36,17,19,20,16,0,0,0,0,0,36,17,19,20,16,12,10.0517497865885,10.1970895674989,0.355985154721722,31
"11955","PR","Reserva",26825,23196.34,41019,"Telêmaco Borba",4,"Sul",0,"412170",4,33,15,18,17,16,0,0,0,0,0,33,15,18,17,16,12,10.0517497865885,10.1970895674989,0.392738919531864,30
"11956","PR","Reserva",26825,23196.34,41019,"Telêmaco Borba",4,"Sul",0,"412170",5,25,9,16,12,13,0,0,0,0,0,25,9,16,12,13,9,10.0517497865885,10.1970895674989,0.401445283853182,31
"11957","PR","Ribeirão Claro",10645,43864.02,41016,"Jacarezinho",4,"Sul",0,"412180",2,13,1,12,4,9,0,0,0,0,0,13,1,12,4,9,6,10.6888496730386,9.27284557732758,0.314559273633311,29
"11958","PR","Ribeirão Claro",10645,43864.02,41016,"Jacarezinho",4,"Sul",0,"412180",3,13,4,9,2,11,0,0,0,0,0,13,4,9,2,11,5,10.6888496730386,9.27284557732758,0.401004870913114,31
"11959","PR","Ribeirão Claro",10645,43864.02,41016,"Jacarezinho",4,"Sul",0,"412180",4,12,6,6,7,5,0,0,0,0,0,12,6,6,7,5,11,10.6888496730386,9.27284557732758,0.438199315921423,30
"11960","PR","Ribeirão Claro",10645,43864.02,41016,"Jacarezinho",4,"Sul",0,"412180",5,13,3,10,5,8,0,0,0,0,0,13,3,10,5,8,13,10.6888496730386,9.27284557732758,0.419696963647405,31
"11961","PR","Ribeirão do Pinhal",12948,17801.07,41015,"Cornélio Procópio",4,"Sul",1,"412190",2,12,1,11,4,8,0,0,0,0,0,12,1,11,4,8,10,9.78701384683305,9.46869661504613,0.288409184892399,29
"11962","PR","Ribeirão do Pinhal",12948,17801.07,41015,"Cornélio Procópio",4,"Sul",1,"412190",3,12,2,10,2,10,0,0,0,0,0,12,2,10,2,10,7,9.78701384683305,9.46869661504613,0.355396538035406,31
"11963","PR","Ribeirão do Pinhal",12948,17801.07,41015,"Cornélio Procópio",4,"Sul",1,"412190",4,8,1,7,1,7,0,0,0,0,0,8,1,7,1,7,8,9.78701384683305,9.46869661504613,0.399786251388319,30
"11964","PR","Ribeirão do Pinhal",12948,17801.07,41015,"Cornélio Procópio",4,"Sul",1,"412190",5,14,2,12,5,9,0,0,0,0,0,14,2,12,5,9,5,9.78701384683305,9.46869661504613,0.405019698849975,31
"11965","PR","Rio Azul",15336,40165.19,41032,"Irati",4,"Sul",0,"412200",2,19,9,10,10,9,0,0,0,0,0,19,9,10,10,9,12,10.6007559790835,9.63795828472548,0.335041787294756,29
"11966","PR","Rio Azul",15336,40165.19,41032,"Irati",4,"Sul",0,"412200",3,9,3,6,2,7,0,0,0,0,0,9,3,6,2,7,5,10.6007559790835,9.63795828472548,0.409333383262151,31
"11967","PR","Rio Azul",15336,40165.19,41032,"Irati",4,"Sul",0,"412200",4,7,1,6,4,3,0,0,0,0,0,7,1,6,4,3,8,10.6007559790835,9.63795828472548,0.45285454070721,30
"11968","PR","Rio Azul",15336,40165.19,41032,"Irati",4,"Sul",0,"412200",5,20,10,10,6,14,0,0,0,0,0,20,10,10,6,14,5,10.6007559790835,9.63795828472548,0.456009583450876,31
"11969","PR","Rio Branco do Sul",32517,34623.86,41037,"Curitiba",4,"Sul",1,"412220",2,40,11,29,23,17,0,0,0,0,0,40,11,29,23,17,11,10.4522983187599,10.3895183084839,0.323210774708178,29
"11970","PR","Rio Branco do Sul",32517,34623.86,41037,"Curitiba",4,"Sul",1,"412220",3,34,13,21,14,20,1,0,1,1,0,35,13,22,15,20,15,10.4522983187599,10.3895183084839,0.414860170387751,31
"11971","PR","Rio Branco do Sul",32517,34623.86,41037,"Curitiba",4,"Sul",1,"412220",4,40,18,22,24,16,0,0,0,0,0,40,18,22,24,16,12,10.4522983187599,10.3895183084839,0.45722848268016,30
"11972","PR","Rio Branco do Sul",32517,34623.86,41037,"Curitiba",4,"Sul",1,"412220",5,44,17,27,24,20,1,0,1,1,0,45,17,28,25,20,14,10.4522983187599,10.3895183084839,0.41353390150334,31
"11973","PR","Rio Negro",34411,36241.73,41039,"Rio Negro",4,"Sul",1,"412230",2,36,5,31,11,25,0,0,0,0,0,36,5,31,11,25,10,10.4979664963244,10.4461315596886,0.303428879836944,29
"11974","PR","Rio Negro",34411,36241.73,41039,"Rio Negro",4,"Sul",1,"412230",3,20,4,16,6,14,0,0,0,0,0,20,4,16,6,14,20,10.4979664963244,10.4461315596886,0.411636713189955,31
"11975","PR","Rio Negro",34411,36241.73,41039,"Rio Negro",4,"Sul",1,"412230",4,25,6,19,14,11,0,0,0,0,0,25,6,19,14,11,17,10.4979664963244,10.4461315596886,0.440350631788815,30
"11976","PR","Rio Negro",34411,36241.73,41039,"Rio Negro",4,"Sul",1,"412230",5,24,3,21,8,16,0,0,0,0,0,24,3,21,8,16,21,10.4979664963244,10.4461315596886,0.408981156055846,31
"11977","PR","Rolândia",67383,40410.66,41011,"Londrina",4,"Sul",1,"412240",2,75,23,52,27,48,1,0,1,0,1,76,23,53,27,49,40,10.6068488905301,11.1181480395669,0.318842028834989,29
"11978","PR","Rolândia",67383,40410.66,41011,"Londrina",4,"Sul",1,"412240",3,81,25,56,31,50,1,1,0,0,1,82,26,56,31,51,41,10.6068488905301,11.1181480395669,0.410788826270328,31
"11979","PR","Rolândia",67383,40410.66,41011,"Londrina",4,"Sul",1,"412240",4,49,16,33,14,35,1,0,1,0,1,50,16,34,14,36,46,10.6068488905301,11.1181480395669,0.441577649842525,30
"11980","PR","Rolândia",67383,40410.66,41011,"Londrina",4,"Sul",1,"412240",5,88,25,63,35,53,0,0,0,0,0,88,25,63,35,53,36,10.6068488905301,11.1181480395669,0.392819781189202,31
"11981","PR","Roncador",9645,42915.27,41005,"Campo Mourão",4,"Sul",0,"412250",2,9,2,7,5,4,0,0,0,0,0,9,2,7,5,4,5,10.666982985639,9.17419492533983,0.314151905064247,29
"11982","PR","Roncador",9645,42915.27,41005,"Campo Mourão",4,"Sul",0,"412250",3,17,6,11,4,13,0,0,0,0,0,17,6,11,4,13,5,10.666982985639,9.17419492533983,0.40484936798416,31
"11983","PR","Roncador",9645,42915.27,41005,"Campo Mourão",4,"Sul",0,"412250",4,13,2,11,3,10,0,0,0,0,0,13,2,11,3,10,11,10.666982985639,9.17419492533983,0.433087869425595,30
"11984","PR","Roncador",9645,42915.27,41005,"Campo Mourão",4,"Sul",0,"412250",5,7,1,6,3,4,0,0,0,0,0,7,1,6,3,4,10,10.666982985639,9.17419492533983,0.401380786894145,31
"11985","PR","Rondon",9622,27777.97,41003,"Cianorte",4,"Sul",0,"412260",2,5,4,1,2,3,0,0,0,0,0,5,4,1,2,3,5,10.2319985394842,9.1718074222594,0.28597927668289,29
"11986","PR","Rondon",9622,27777.97,41003,"Cianorte",4,"Sul",0,"412260",3,11,0,11,4,7,0,0,0,0,0,11,0,11,4,7,4,10.2319985394842,9.1718074222594,0.355208713498257,31
"11987","PR","Rondon",9622,27777.97,41003,"Cianorte",4,"Sul",0,"412260",4,15,3,12,9,6,0,0,0,0,0,15,3,12,9,6,5,10.2319985394842,9.1718074222594,0.365851181812048,30
"11988","PR","Rondon",9622,27777.97,41003,"Cianorte",4,"Sul",0,"412260",5,13,3,10,7,6,0,0,0,0,0,13,3,10,7,6,3,10.2319985394842,9.1718074222594,0.381056907243371,31
"11989","PR","Sabáudia",6891,84156.9,41010,"Apucarana",4,"Sul",0,"412270",2,7,3,4,2,5,0,0,0,0,0,7,3,4,2,5,5,11.3404381926924,8.83797149135721,0.319055420716918,29
"11990","PR","Sabáudia",6891,84156.9,41010,"Apucarana",4,"Sul",0,"412270",3,12,2,10,4,8,0,0,0,0,0,12,2,10,4,8,8,11.3404381926924,8.83797149135721,0.387987318486186,31
"11991","PR","Sabáudia",6891,84156.9,41010,"Apucarana",4,"Sul",0,"412270",4,11,4,7,7,4,0,0,0,0,0,11,4,7,7,4,4,11.3404381926924,8.83797149135721,0.443289331893474,30
"11992","PR","Sabáudia",6891,84156.9,41010,"Apucarana",4,"Sul",0,"412270",5,9,0,9,2,7,0,0,0,0,0,9,0,9,2,7,1,11.3404381926924,8.83797149135721,0.370088630452231,31
"11993","PR","Salto do Lontra",14872,25292.01,41026,"Francisco Beltrão",4,"Sul",0,"412300",2,15,4,11,8,7,0,0,0,0,0,15,4,11,8,7,7,10.1382438145604,9.60723552940128,0.304579286798575,29
"11994","PR","Salto do Lontra",14872,25292.01,41026,"Francisco Beltrão",4,"Sul",0,"412300",3,6,0,6,2,4,0,0,0,0,0,6,0,6,2,4,9,10.1382438145604,9.60723552940128,0.389415755486562,31
"11995","PR","Salto do Lontra",14872,25292.01,41026,"Francisco Beltrão",4,"Sul",0,"412300",4,18,8,10,8,10,0,0,0,0,0,18,8,10,8,10,5,10.1382438145604,9.60723552940128,0.381306395343929,30
"11996","PR","Salto do Lontra",14872,25292.01,41026,"Francisco Beltrão",4,"Sul",0,"412300",5,9,1,8,5,4,0,0,0,0,0,9,1,8,5,4,8,10.1382438145604,9.60723552940128,0.385569646761996,31
"11997","PR","Santa Cruz de Monte Castelo",7751,33465.37,41001,"Paranavaí",4,"Sul",0,"412330",2,9,2,7,3,6,0,0,0,0,0,9,2,7,3,6,5,10.4182664518011,8.95557714628151,0.320065792999041,29
"11998","PR","Santa Cruz de Monte Castelo",7751,33465.37,41001,"Paranavaí",4,"Sul",0,"412330",3,3,1,2,1,2,0,0,0,0,0,3,1,2,1,2,9,10.4182664518011,8.95557714628151,0.414811070450971,31
"11999","PR","Santa Cruz de Monte Castelo",7751,33465.37,41001,"Paranavaí",4,"Sul",0,"412330",4,1,1,0,1,0,0,0,0,0,0,1,1,0,1,0,9,10.4182664518011,8.95557714628151,0.436069533549558,30
"12000","PR","Santa Cruz de Monte Castelo",7751,33465.37,41001,"Paranavaí",4,"Sul",0,"412330",5,1,1,0,0,1,0,0,0,0,0,1,1,0,0,1,8,10.4182664518011,8.95557714628151,0.376337915728364,31
"12001","PR","Santa Fé",12186,22753.57,41006,"Astorga",4,"Sul",0,"412340",2,8,3,5,4,4,0,0,0,0,0,8,3,5,4,4,6,10.0324773351449,9.40804303080844,0.280428474712992,29
"12002","PR","Santa Fé",12186,22753.57,41006,"Astorga",4,"Sul",0,"412340",3,6,1,5,2,4,0,0,0,0,0,6,1,5,2,4,7,10.0324773351449,9.40804303080844,0.37330680903592,31
"12003","PR","Santa Fé",12186,22753.57,41006,"Astorga",4,"Sul",0,"412340",4,11,3,8,2,9,0,0,0,0,0,11,3,8,2,9,11,10.0324773351449,9.40804303080844,0.414269597518978,30
"12004","PR","Santa Fé",12186,22753.57,41006,"Astorga",4,"Sul",0,"412340",5,12,2,10,7,5,0,0,0,0,0,12,2,10,7,5,9,10.0324773351449,9.40804303080844,0.369007139100231,31
"12005","PR","Santa Helena",26767,35652.74,41022,"Toledo",4,"Sul",0,"412350",2,28,8,20,11,17,0,0,0,0,0,28,8,20,11,17,14,10.481581281234,10.1949250644893,0.309255211818224,29
"12006","PR","Santa Helena",26767,35652.74,41022,"Toledo",4,"Sul",0,"412350",3,23,6,17,11,12,0,0,0,0,0,23,6,17,11,12,17,10.481581281234,10.1949250644893,0.417665685594082,31
"12007","PR","Santa Helena",26767,35652.74,41022,"Toledo",4,"Sul",0,"412350",4,28,8,20,9,19,2,1,1,1,1,30,9,21,10,20,18,10.481581281234,10.1949250644893,0.435074105129541,30
"12008","PR","Santa Helena",26767,35652.74,41022,"Toledo",4,"Sul",0,"412350",5,30,9,21,6,24,0,0,0,0,0,30,9,21,6,24,18,10.481581281234,10.1949250644893,0.416658741252827,31
"12009","PR","Santa Isabel do Ivaí",8523,22904.05,41001,"Paranavaí",4,"Sul",0,"412370",2,7,1,6,1,6,0,0,0,0,0,7,1,6,1,6,4,10.0390690298004,9.0505236705223,0.313236770237622,29
"12010","PR","Santa Isabel do Ivaí",8523,22904.05,41001,"Paranavaí",4,"Sul",0,"412370",3,8,3,5,2,6,0,0,0,0,0,8,3,5,2,6,10,10.0390690298004,9.0505236705223,0.407183936624126,31
"12011","PR","Santa Isabel do Ivaí",8523,22904.05,41001,"Paranavaí",4,"Sul",0,"412370",4,5,1,4,1,4,0,0,0,0,0,5,1,4,1,4,6,10.0390690298004,9.0505236705223,0.462754082747953,30
"12012","PR","Santa Isabel do Ivaí",8523,22904.05,41001,"Paranavaí",4,"Sul",0,"412370",5,8,3,5,5,3,0,0,0,0,0,8,3,5,5,3,5,10.0390690298004,9.0505236705223,0.425903854676145,31
"12013","PR","Santa Izabel do Oeste",14794,22155.36,41025,"Capanema",4,"Sul",0,"412380",2,14,6,8,4,10,0,0,0,0,0,14,6,8,4,10,3,10.0058347326553,9.60197697214781,0.304152928018704,29
"12014","PR","Santa Izabel do Oeste",14794,22155.36,41025,"Capanema",4,"Sul",0,"412380",3,11,3,8,1,10,0,0,0,0,0,11,3,8,1,10,7,10.0058347326553,9.60197697214781,0.390888331979215,31
"12015","PR","Santa Izabel do Oeste",14794,22155.36,41025,"Capanema",4,"Sul",0,"412380",4,24,5,19,12,12,0,0,0,0,0,24,5,19,12,12,9,10.0058347326553,9.60197697214781,0.41139508445575,30
"12016","PR","Santa Izabel do Oeste",14794,22155.36,41025,"Capanema",4,"Sul",0,"412380",5,14,4,10,7,7,0,0,0,0,0,14,4,10,7,7,4,10.0058347326553,9.60197697214781,0.382878677923137,31
"12017","PR","Santa Mariana",11622,28615.91,41015,"Cornélio Procópio",4,"Sul",0,"412390",2,7,1,6,1,6,0,0,0,0,0,7,1,6,1,6,12,10.2617181358403,9.36065513263505,0.322409077343654,29
"12018","PR","Santa Mariana",11622,28615.91,41015,"Cornélio Procópio",4,"Sul",0,"412390",3,5,0,5,1,4,0,0,0,0,0,5,0,5,1,4,5,10.2617181358403,9.36065513263505,0.39478532982072,31
"12019","PR","Santa Mariana",11622,28615.91,41015,"Cornélio Procópio",4,"Sul",0,"412390",4,11,1,10,6,5,0,0,0,0,0,11,1,10,6,5,11,10.2617181358403,9.36065513263505,0.435532443997323,30
"12020","PR","Santa Mariana",11622,28615.91,41015,"Cornélio Procópio",4,"Sul",0,"412390",5,17,4,13,7,10,0,0,0,0,0,17,4,13,7,10,15,10.2617181358403,9.36065513263505,0.407768130450814,31
"12021","PR","Santa Tereza do Oeste",10096,36647.22,41023,"Cascavel",4,"Sul",1,"412402",2,14,7,7,3,11,0,0,0,0,0,14,7,7,3,11,4,10.5090928517775,9.219894584781,0.300247782520562,29
"12022","PR","Santa Tereza do Oeste",10096,36647.22,41023,"Cascavel",4,"Sul",1,"412402",3,16,6,10,5,11,0,0,0,0,0,16,6,10,5,11,3,10.5090928517775,9.219894584781,0.384761694459611,31
"12023","PR","Santa Tereza do Oeste",10096,36647.22,41023,"Cascavel",4,"Sul",1,"412402",4,15,5,10,6,9,0,0,0,0,0,15,5,10,6,9,5,10.5090928517775,9.219894584781,0.41299736446892,30
"12024","PR","Santa Tereza do Oeste",10096,36647.22,41023,"Cascavel",4,"Sul",1,"412402",5,13,4,9,2,11,0,0,0,0,0,13,4,9,2,11,6,10.5090928517775,9.219894584781,0.379755880708279,31
"12025","PR","Santa Terezinha de Itaipu",23699,22533.87,41024,"Foz do Iguaçu",4,"Sul",1,"412405",2,16,5,11,7,9,0,0,0,0,0,16,5,11,7,9,12,10.0227747896474,10.0731881321402,0.345395491841336,29
"12026","PR","Santa Terezinha de Itaipu",23699,22533.87,41024,"Foz do Iguaçu",4,"Sul",1,"412405",3,16,3,13,5,11,1,0,1,0,1,17,3,14,5,12,14,10.0227747896474,10.0731881321402,0.439196797990295,31
"12027","PR","Santa Terezinha de Itaipu",23699,22533.87,41024,"Foz do Iguaçu",4,"Sul",1,"412405",4,28,10,18,15,13,0,0,0,0,0,28,10,18,15,13,14,10.0227747896474,10.0731881321402,0.492875942583425,30
"12028","PR","Santa Terezinha de Itaipu",23699,22533.87,41024,"Foz do Iguaçu",4,"Sul",1,"412405",5,30,4,26,12,18,0,0,0,0,0,30,4,26,12,18,13,10.0227747896474,10.0731881321402,0.441299653354797,31
"12029","PR","Santo Antônio da Platina",46251,26464,41016,"Jacarezinho",4,"Sul",1,"412410",2,48,10,38,19,29,0,0,0,0,0,48,10,38,19,29,25,10.1835405978234,10.7418383643284,0.313952298660626,29
"12030","PR","Santo Antônio da Platina",46251,26464,41016,"Jacarezinho",4,"Sul",1,"412410",3,46,10,36,15,31,1,1,0,0,1,47,11,36,15,32,34,10.1835405978234,10.7418383643284,0.397039269158454,31
"12031","PR","Santo Antônio da Platina",46251,26464,41016,"Jacarezinho",4,"Sul",1,"412410",4,42,10,32,17,25,1,0,1,1,0,43,10,33,18,25,34,10.1835405978234,10.7418383643284,0.440239317390524,30
"12032","PR","Santo Antônio da Platina",46251,26464,41016,"Jacarezinho",4,"Sul",1,"412410",5,50,12,38,20,30,0,0,0,0,0,50,12,38,20,30,34,10.1835405978234,10.7418383643284,0.399943557067739,31
"12033","PR","Santo Antônio do Sudoeste",20261,25232.69,41026,"Francisco Beltrão",4,"Sul",0,"412440",2,19,4,15,7,12,0,0,0,0,0,19,4,15,7,12,10,10.1358956550559,9.91645313492615,0.340803291125819,29
"12034","PR","Santo Antônio do Sudoeste",20261,25232.69,41026,"Francisco Beltrão",4,"Sul",0,"412440",3,24,12,12,6,18,0,0,0,0,0,24,12,12,6,18,11,10.1358956550559,9.91645313492615,0.414040297697139,31
"12035","PR","Santo Antônio do Sudoeste",20261,25232.69,41026,"Francisco Beltrão",4,"Sul",0,"412440",4,12,5,7,3,9,0,0,0,0,0,12,5,7,3,9,13,10.1358956550559,9.91645313492615,0.43305527764588,30
"12036","PR","Santo Antônio do Sudoeste",20261,25232.69,41026,"Francisco Beltrão",4,"Sul",0,"412440",5,15,9,6,11,4,0,0,0,0,0,15,9,6,11,4,11,10.1358956550559,9.91645313492615,0.40757554561058,31
"12037","PR","Santo Inácio",5416,53762.37,41006,"Astorga",4,"Sul",0,"412450",2,9,2,7,5,4,0,0,0,0,0,9,2,7,5,4,2,10.8923290590468,8.59711281459211,0.337240769501145,29
"12038","PR","Santo Inácio",5416,53762.37,41006,"Astorga",4,"Sul",0,"412450",3,11,1,10,5,6,0,0,0,0,0,11,1,10,5,6,3,10.8923290590468,8.59711281459211,0.398594655549476,31
"12039","PR","Santo Inácio",5416,53762.37,41006,"Astorga",4,"Sul",0,"412450",4,3,1,2,1,2,0,0,0,0,0,3,1,2,1,2,2,10.8923290590468,8.59711281459211,0.380291774175321,30
"12040","PR","Santo Inácio",5416,53762.37,41006,"Astorga",4,"Sul",0,"412450",5,10,2,8,3,7,0,0,0,0,0,10,2,8,3,7,1,10.8923290590468,8.59711281459211,0.387303770322243,31
"12041","PR","São Carlos do Ivaí",6920,45033.98,41001,"Paranavaí",4,"Sul",0,"412460",2,8,3,5,4,4,0,0,0,0,0,8,3,5,4,4,3,10.7151725949106,8.84217104861172,0.329302238007499,29
"12042","PR","São Carlos do Ivaí",6920,45033.98,41001,"Paranavaí",4,"Sul",0,"412460",3,6,2,4,2,4,0,0,0,0,0,6,2,4,2,4,4,10.7151725949106,8.84217104861172,0.410364160282006,31
"12043","PR","São Carlos do Ivaí",6920,45033.98,41001,"Paranavaí",4,"Sul",0,"412460",4,13,5,8,5,8,0,0,0,0,0,13,5,8,5,8,6,10.7151725949106,8.84217104861172,0.410055883840108,30
"12044","PR","São Carlos do Ivaí",6920,45033.98,41001,"Paranavaí",4,"Sul",0,"412460",5,13,3,10,6,7,0,0,0,0,0,13,3,10,6,7,4,10.7151725949106,8.84217104861172,0.35904424430223,31
"12045","PR","São Jerônimo da Serra",11128,20351.17,41014,"Assaí",4,"Sul",0,"412470",2,8,1,7,5,3,0,0,0,0,0,8,1,7,5,3,3,9.92089368307553,9.31721973360328,0.331605645809556,29
"12046","PR","São Jerônimo da Serra",11128,20351.17,41014,"Assaí",4,"Sul",0,"412470",3,10,2,8,7,3,0,0,0,0,0,10,2,8,7,3,2,9.92089368307553,9.31721973360328,0.415540427901616,31
"12047","PR","São Jerônimo da Serra",11128,20351.17,41014,"Assaí",4,"Sul",0,"412470",4,9,3,6,3,6,0,0,0,0,0,9,3,6,3,6,2,9.92089368307553,9.31721973360328,0.426159622701522,30
"12048","PR","São Jerônimo da Serra",11128,20351.17,41014,"Assaí",4,"Sul",0,"412470",5,7,1,6,2,5,0,0,0,0,0,7,1,6,2,5,5,9.92089368307553,9.31721973360328,0.407535008665634,31
"12049","PR","São João",10181,71759.27,41027,"Pato Branco",4,"Sul",0,"412480",2,10,1,9,0,10,0,0,0,0,0,10,1,9,0,10,5,11.1810723238827,9.2282785171072,0.308673597522498,29
"12050","PR","São João",10181,71759.27,41027,"Pato Branco",4,"Sul",0,"412480",3,14,1,13,5,9,0,0,0,0,0,14,1,13,5,9,1,11.1810723238827,9.2282785171072,0.401318048500317,31
"12051","PR","São João",10181,71759.27,41027,"Pato Branco",4,"Sul",0,"412480",4,17,6,11,3,14,0,0,0,0,0,17,6,11,3,14,8,11.1810723238827,9.2282785171072,0.436534081697246,30
"12052","PR","São João",10181,71759.27,41027,"Pato Branco",4,"Sul",0,"412480",5,12,1,11,3,9,0,0,0,0,0,12,1,11,3,9,2,11.1810723238827,9.2282785171072,0.40493709845586,31
"12053","PR","São João do Ivaí",10056,27109.18,41013,"Ivaiporã",4,"Sul",0,"412500",2,7,1,6,4,3,0,0,0,0,0,7,1,6,4,3,10,10.207627694894,9.21592475027008,0.296383288385693,29
"12054","PR","São João do Ivaí",10056,27109.18,41013,"Ivaiporã",4,"Sul",0,"412500",3,5,0,5,3,2,0,0,0,0,0,5,0,5,3,2,10,10.207627694894,9.21592475027008,0.381465969604334,31
"12055","PR","São João do Ivaí",10056,27109.18,41013,"Ivaiporã",4,"Sul",0,"412500",4,11,4,7,6,5,0,0,0,0,0,11,4,7,6,5,12,10.207627694894,9.21592475027008,0.435713845005621,30
"12056","PR","São João do Ivaí",10056,27109.18,41013,"Ivaiporã",4,"Sul",0,"412500",5,7,0,7,2,5,0,0,0,0,0,7,0,7,2,5,5,10.207627694894,9.21592475027008,0.387475091099496,31
"12057","PR","São Jorge do Ivaí",5543,49974.2,41008,"Floraí",4,"Sul",0,"412530",2,4,0,4,0,4,0,0,0,0,0,4,0,4,0,4,0,10.8192621512365,8.6202911494198,0.286402597542619,29
"12058","PR","São Jorge do Ivaí",5543,49974.2,41008,"Floraí",4,"Sul",0,"412530",3,9,1,8,4,5,0,0,0,0,0,9,1,8,4,5,5,10.8192621512365,8.6202911494198,0.349103729568786,31
"12059","PR","São Jorge do Ivaí",5543,49974.2,41008,"Floraí",4,"Sul",0,"412530",4,3,0,3,1,2,0,0,0,0,0,3,0,3,1,2,3,10.8192621512365,8.6202911494198,0.368767167814504,30
"12060","PR","São Jorge do Ivaí",5543,49974.2,41008,"Floraí",4,"Sul",0,"412530",5,5,0,5,1,4,0,0,0,0,0,5,0,5,1,4,4,10.8192621512365,8.6202911494198,0.322935577454731,31
"12061","PR","São Jorge do Patrocínio",5586,20301.66,41002,"Umuarama",4,"Sul",0,"412535",2,5,1,4,1,4,0,0,0,0,0,5,1,4,1,4,3,9.91845793508563,8.62801874650512,0.325279078182541,29
"12062","PR","São Jorge do Patrocínio",5586,20301.66,41002,"Umuarama",4,"Sul",0,"412535",3,10,3,7,5,5,0,0,0,0,0,10,3,7,5,5,4,9.91845793508563,8.62801874650512,0.390544194114232,31
"12063","PR","São Jorge do Patrocínio",5586,20301.66,41002,"Umuarama",4,"Sul",0,"412535",4,6,0,6,1,5,0,0,0,0,0,6,0,6,1,5,2,9.91845793508563,8.62801874650512,0.375295927005312,30
"12064","PR","São Jorge do Patrocínio",5586,20301.66,41002,"Umuarama",4,"Sul",0,"412535",5,5,1,4,3,2,0,0,0,0,0,5,1,4,3,2,6,9.91845793508563,8.62801874650512,0.373855685297065,31
"12065","PR","São José dos Pinhais",329058,75926.83,41037,"Curitiba",4,"Sul",1,"412550",2,319,63,256,117,202,3,1,2,1,2,322,64,258,118,204,126,11.2375253923564,12.7039893060032,0.295588755524244,29
"12066","PR","São José dos Pinhais",329058,75926.83,41037,"Curitiba",4,"Sul",1,"412550",3,331,72,259,106,225,1,0,1,0,1,332,72,260,106,226,147,11.2375253923564,12.7039893060032,0.396968744930851,31
"12067","PR","São José dos Pinhais",329058,75926.83,41037,"Curitiba",4,"Sul",1,"412550",4,328,59,269,120,208,2,0,2,1,1,330,59,271,121,209,124,11.2375253923564,12.7039893060032,0.454339934111432,30
"12068","PR","São José dos Pinhais",329058,75926.83,41037,"Curitiba",4,"Sul",1,"412550",5,339,94,245,123,216,3,1,2,1,2,342,95,247,124,218,151,11.2375253923564,12.7039893060032,0.402510685057686,31
"12069","PR","São Mateus do Sul",46705,27418.27,41034,"São Mateus do Sul",4,"Sul",0,"412560",2,48,11,37,18,30,0,0,0,0,0,48,11,37,18,30,9,10.2189648584928,10.7516065043069,0.306150143332261,29
"12070","PR","São Mateus do Sul",46705,27418.27,41034,"São Mateus do Sul",4,"Sul",0,"412560",3,48,5,43,14,34,0,0,0,0,0,48,5,43,14,34,21,10.2189648584928,10.7516065043069,0.404188906207376,31
"12071","PR","São Mateus do Sul",46705,27418.27,41034,"São Mateus do Sul",4,"Sul",0,"412560",4,46,8,38,20,26,0,0,0,0,0,46,8,38,20,26,21,10.2189648584928,10.7516065043069,0.434330154043022,30
"12072","PR","São Mateus do Sul",46705,27418.27,41034,"São Mateus do Sul",4,"Sul",0,"412560",5,52,18,34,23,29,0,0,0,0,0,52,18,34,23,29,22,10.2189648584928,10.7516065043069,0.434811186550716,31
"12073","PR","São Miguel do Iguaçu",27576,36719.62,41024,"Foz do Iguaçu",4,"Sul",0,"412570",2,27,8,19,14,13,0,0,0,0,0,27,8,19,14,13,18,10.511066496097,10.2247011081967,0.30477521121783,29
"12074","PR","São Miguel do Iguaçu",27576,36719.62,41024,"Foz do Iguaçu",4,"Sul",0,"412570",3,28,9,19,7,21,0,0,0,0,0,28,9,19,7,21,18,10.511066496097,10.2247011081967,0.388946083939915,31
"12075","PR","São Miguel do Iguaçu",27576,36719.62,41024,"Foz do Iguaçu",4,"Sul",0,"412570",4,26,7,19,12,14,0,0,0,0,0,26,7,19,12,14,22,10.511066496097,10.2247011081967,0.413703877204914,30
"12076","PR","São Miguel do Iguaçu",27576,36719.62,41024,"Foz do Iguaçu",4,"Sul",0,"412570",5,26,5,21,6,20,0,0,0,0,0,26,5,21,6,20,11,10.511066496097,10.2247011081967,0.402473678379145,31
"12077","PR","São Pedro do Ivaí",11046,27079.68,41013,"Ivaiporã",4,"Sul",0,"412580",2,10,2,8,1,9,0,0,0,0,0,10,2,8,1,9,8,10.2065389101174,9.30982365046113,0.308584504199503,29
"12078","PR","São Pedro do Ivaí",11046,27079.68,41013,"Ivaiporã",4,"Sul",0,"412580",3,8,2,6,5,3,0,0,0,0,0,8,2,6,5,3,5,10.2065389101174,9.30982365046113,0.378285794521983,31
"12079","PR","São Pedro do Ivaí",11046,27079.68,41013,"Ivaiporã",4,"Sul",0,"412580",4,18,1,17,6,12,0,0,0,0,0,18,1,17,6,12,11,10.2065389101174,9.30982365046113,0.410397593036955,30
"12080","PR","São Pedro do Ivaí",11046,27079.68,41013,"Ivaiporã",4,"Sul",0,"412580",5,12,6,6,3,9,0,0,0,0,0,12,6,6,3,9,8,10.2065389101174,9.30982365046113,0.35843266433089,31
"12081","PR","São Sebastião da Amoreira",8859,22135.84,41014,"Assaí",4,"Sul",0,"412600",2,5,1,4,2,3,0,0,0,0,0,5,1,4,2,3,2,10.0049532933958,9.08918917041203,0.326483078999487,29
"12082","PR","São Sebastião da Amoreira",8859,22135.84,41014,"Assaí",4,"Sul",0,"412600",3,3,0,3,3,0,0,0,0,0,0,3,0,3,3,0,8,10.0049532933958,9.08918917041203,0.404950171121422,31
"12083","PR","São Sebastião da Amoreira",8859,22135.84,41014,"Assaí",4,"Sul",0,"412600",4,7,3,4,4,3,0,0,0,0,0,7,3,4,4,3,5,10.0049532933958,9.08918917041203,0.434866081444936,30
"12084","PR","São Sebastião da Amoreira",8859,22135.84,41014,"Assaí",4,"Sul",0,"412600",5,6,0,6,4,2,0,0,0,0,0,6,0,6,4,2,4,10.0049532933958,9.08918917041203,0.409758923336352,31
"12085","PR","São Tomé",5750,24275.48,41003,"Cianorte",4,"Sul",0,"412610",2,5,0,5,2,3,0,0,0,0,0,5,0,5,2,3,6,10.0972220663935,8.6569551337914,0.250461510552656,29
"12086","PR","São Tomé",5750,24275.48,41003,"Cianorte",4,"Sul",0,"412610",3,3,0,3,1,2,0,0,0,0,0,3,0,3,1,2,3,10.0972220663935,8.6569551337914,0.358377407540644,31
"12087","PR","São Tomé",5750,24275.48,41003,"Cianorte",4,"Sul",0,"412610",4,8,0,8,5,3,0,0,0,0,0,8,0,8,5,3,3,10.0972220663935,8.6569551337914,0.367035382551719,30
"12088","PR","São Tomé",5750,24275.48,41003,"Cianorte",4,"Sul",0,"412610",5,6,0,6,2,4,0,0,0,0,0,6,0,6,2,4,3,10.0972220663935,8.6569551337914,0.370422078517909,31
"12089","PR","Sarandi",97803,16617.93,41009,"Maringá",4,"Sul",1,"412625",2,100,32,68,36,64,0,0,0,0,0,100,32,68,36,64,65,9.71823751191614,11.4907105303991,0.294082947307544,29
"12090","PR","Sarandi",97803,16617.93,41009,"Maringá",4,"Sul",1,"412625",3,121,28,93,43,78,0,0,0,0,0,121,28,93,43,78,52,9.71823751191614,11.4907105303991,0.409065038845037,31
"12091","PR","Sarandi",97803,16617.93,41009,"Maringá",4,"Sul",1,"412625",4,138,37,101,69,69,3,1,2,1,2,141,38,103,70,71,49,9.71823751191614,11.4907105303991,0.444908907624492,30
"12092","PR","Sarandi",97803,16617.93,41009,"Maringá",4,"Sul",1,"412625",5,154,47,107,52,102,0,0,0,0,0,154,47,107,52,102,60,9.71823751191614,11.4907105303991,0.379323934405857,31
"12093","PR","Sengés",19385,23760.98,41020,"Jaguariaíva",4,"Sul",0,"412630",2,20,8,12,9,11,0,0,0,0,0,20,8,12,9,11,8,10.0758000184172,9.87225485010503,0.389956754177602,29
"12094","PR","Sengés",19385,23760.98,41020,"Jaguariaíva",4,"Sul",0,"412630",3,12,2,10,7,5,0,0,0,0,0,12,2,10,7,5,10,10.0758000184172,9.87225485010503,0.453133603293167,31
"12095","PR","Sengés",19385,23760.98,41020,"Jaguariaíva",4,"Sul",0,"412630",4,21,8,13,10,11,0,0,0,0,0,21,8,13,10,11,6,10.0758000184172,9.87225485010503,0.473253166924604,30
"12096","PR","Sengés",19385,23760.98,41020,"Jaguariaíva",4,"Sul",0,"412630",5,21,9,12,11,10,0,0,0,0,0,21,9,12,11,10,12,10.0758000184172,9.87225485010503,0.451295928395921,31
"12097","PR","Sertaneja",5216,53374.1,41015,"Cornélio Procópio",4,"Sul",0,"412640",2,5,2,3,1,4,0,0,0,0,0,5,2,3,1,4,4,10.8850808885621,8.55948610360649,0.323198267769744,29
"12098","PR","Sertaneja",5216,53374.1,41015,"Cornélio Procópio",4,"Sul",0,"412640",3,4,1,3,1,3,0,0,0,0,0,4,1,3,1,3,7,10.8850808885621,8.55948610360649,0.409396766278563,31
"12099","PR","Sertaneja",5216,53374.1,41015,"Cornélio Procópio",4,"Sul",0,"412640",4,5,0,5,4,1,0,0,0,0,0,5,0,5,4,1,1,10.8850808885621,8.55948610360649,0.451457627703932,30
"12100","PR","Sertaneja",5216,53374.1,41015,"Cornélio Procópio",4,"Sul",0,"412640",5,8,0,8,1,7,0,0,0,0,0,8,0,8,1,7,4,10.8850808885621,8.55948610360649,0.398736039251825,31
"12101","PR","Sertanópolis",16413,42088.82,41007,"Porecatu",4,"Sul",1,"412650",2,11,2,9,4,7,0,0,0,0,0,11,2,9,4,7,13,10.6475374262089,9.70582898273194,0.288749549045281,29
"12102","PR","Sertanópolis",16413,42088.82,41007,"Porecatu",4,"Sul",1,"412650",3,12,3,9,4,8,0,0,0,0,0,12,3,9,4,8,17,10.6475374262089,9.70582898273194,0.374632412395138,31
"12103","PR","Sertanópolis",16413,42088.82,41007,"Porecatu",4,"Sul",1,"412650",4,16,3,13,3,13,0,0,0,0,0,16,3,13,3,13,10,10.6475374262089,9.70582898273194,0.384751169521458,30
"12104","PR","Sertanópolis",16413,42088.82,41007,"Porecatu",4,"Sul",1,"412650",5,17,4,13,8,9,0,0,0,0,0,17,4,13,8,9,12,10.6475374262089,9.70582898273194,0.340207321606235,31
"12105","PR","Siqueira Campos",21249,26060.49,41018,"Wenceslau Braz",4,"Sul",0,"412660",2,21,6,15,7,14,0,0,0,0,0,21,6,15,7,14,14,10.1681756532649,9.96406511442173,0.303223179268774,29
"12106","PR","Siqueira Campos",21249,26060.49,41018,"Wenceslau Braz",4,"Sul",0,"412660",3,23,5,18,8,15,0,0,0,0,0,23,5,18,8,15,14,10.1681756532649,9.96406511442173,0.398846969441305,31
"12107","PR","Siqueira Campos",21249,26060.49,41018,"Wenceslau Braz",4,"Sul",0,"412660",4,21,4,17,5,16,0,0,0,0,0,21,4,17,5,16,14,10.1681756532649,9.96406511442173,0.428251603632711,30
"12108","PR","Siqueira Campos",21249,26060.49,41018,"Wenceslau Braz",4,"Sul",0,"412660",5,28,6,22,7,21,0,0,0,0,0,28,6,22,7,21,18,10.1681756532649,9.96406511442173,0.374498551664243,31
"12109","PR","Tamarana",15040,20888.07,41011,"Londrina",4,"Sul",0,"412667",2,14,7,7,8,6,0,0,0,0,0,14,7,7,8,6,9,9.94693346157978,9.61846859750383,0.323286704039811,29
"12110","PR","Tamarana",15040,20888.07,41011,"Londrina",4,"Sul",0,"412667",3,14,9,5,9,5,0,0,0,0,0,14,9,5,9,5,6,9.94693346157978,9.61846859750383,0.390463453080123,31
"12111","PR","Tamarana",15040,20888.07,41011,"Londrina",4,"Sul",0,"412667",4,9,4,5,4,5,0,0,0,0,0,9,4,5,4,5,2,9.94693346157978,9.61846859750383,0.414232639016338,30
"12112","PR","Tamarana",15040,20888.07,41011,"Londrina",4,"Sul",0,"412667",5,17,9,8,7,10,0,0,0,0,0,17,9,8,7,10,5,9.94693346157978,9.61846859750383,0.390278485739876,31
"12113","PR","Tamboara",5158,24630.39,41001,"Paranavaí",4,"Sul",0,"412670",2,5,0,5,0,5,0,0,0,0,0,5,0,5,0,5,2,10.1117363253376,8.54830418644129,0.322042775631844,29
"12114","PR","Tamboara",5158,24630.39,41001,"Paranavaí",4,"Sul",0,"412670",3,6,1,5,1,5,0,0,0,0,0,6,1,5,1,5,1,10.1117363253376,8.54830418644129,0.371327525658725,31
"12115","PR","Tamboara",5158,24630.39,41001,"Paranavaí",4,"Sul",0,"412670",4,3,0,3,2,1,0,0,0,0,0,3,0,3,2,1,2,10.1117363253376,8.54830418644129,0.386182509744548,30
"12116","PR","Tamboara",5158,24630.39,41001,"Paranavaí",4,"Sul",0,"412670",5,9,1,8,4,5,0,0,0,0,0,9,1,8,4,5,2,10.1117363253376,8.54830418644129,0.359530045129082,31
"12117","PR","Tapejara",16345,28146.78,41003,"Cianorte",4,"Sul",1,"412680",2,10,5,5,4,6,0,0,0,0,0,10,5,5,4,6,4,10.2451882398138,9.70167731915831,0.308488191608802,29
"12118","PR","Tapejara",16345,28146.78,41003,"Cianorte",4,"Sul",1,"412680",3,11,4,7,6,5,0,0,0,0,0,11,4,7,6,5,18,10.2451882398138,9.70167731915831,0.380433585529755,31
"12119","PR","Tapejara",16345,28146.78,41003,"Cianorte",4,"Sul",1,"412680",4,13,8,5,6,7,0,0,0,0,0,13,8,5,6,7,13,10.2451882398138,9.70167731915831,0.397615918374203,30
"12120","PR","Tapejara",16345,28146.78,41003,"Cianorte",4,"Sul",1,"412680",5,11,2,9,6,5,0,0,0,0,0,11,2,9,6,5,11,10.2451882398138,9.70167731915831,0.386877086986723,31
"12121","PR","Teixeira Soares",12567,31212.48,41031,"Prudentópolis",4,"Sul",0,"412700",2,9,5,4,6,3,0,0,0,0,0,9,5,4,6,3,3,10.3485732938189,9.43882960961514,0.364288893122411,29
"12122","PR","Teixeira Soares",12567,31212.48,41031,"Prudentópolis",4,"Sul",0,"412700",3,9,0,9,1,8,1,0,1,0,1,10,0,10,1,9,4,10.3485732938189,9.43882960961514,0.429875301125363,31
"12123","PR","Teixeira Soares",12567,31212.48,41031,"Prudentópolis",4,"Sul",0,"412700",4,9,2,7,3,6,0,0,0,0,0,9,2,7,3,6,7,10.3485732938189,9.43882960961514,0.454657347012106,30
"12124","PR","Teixeira Soares",12567,31212.48,41031,"Prudentópolis",4,"Sul",0,"412700",5,8,2,6,3,5,0,0,0,0,0,8,2,6,3,5,6,10.3485732938189,9.43882960961514,0.438784565680551,31
"12125","PR","Telêmaco Borba",79792,43918.78,41019,"Telêmaco Borba",4,"Sul",1,"412710",2,64,13,51,26,38,0,0,0,0,0,64,13,51,26,38,43,10.6900972980198,11.2871785277859,0.319645818631127,29
"12126","PR","Telêmaco Borba",79792,43918.78,41019,"Telêmaco Borba",4,"Sul",1,"412710",3,82,18,64,33,49,0,0,0,0,0,82,18,64,33,49,47,10.6900972980198,11.2871785277859,0.413285007517968,31
"12127","PR","Telêmaco Borba",79792,43918.78,41019,"Telêmaco Borba",4,"Sul",1,"412710",4,92,20,72,30,62,1,0,1,0,1,93,20,73,30,63,32,10.6900972980198,11.2871785277859,0.464194058160792,30
"12128","PR","Telêmaco Borba",79792,43918.78,41019,"Telêmaco Borba",4,"Sul",1,"412710",5,94,22,72,38,56,1,1,0,1,0,95,23,72,39,56,48,10.6900972980198,11.2871785277859,0.409523217562604,31
"12129","PR","Terra Boa",17200,28607.25,41005,"Campo Mourão",4,"Sul",1,"412720",2,13,3,10,7,6,0,0,0,0,0,13,3,10,7,6,11,10.2614154611866,9.75266466280154,0.302541742323836,29
"12130","PR","Terra Boa",17200,28607.25,41005,"Campo Mourão",4,"Sul",1,"412720",3,18,5,13,5,13,0,0,0,0,0,18,5,13,5,13,16,10.2614154611866,9.75266466280154,0.412201496258191,31
"12131","PR","Terra Boa",17200,28607.25,41005,"Campo Mourão",4,"Sul",1,"412720",4,12,3,9,5,7,0,0,0,0,0,12,3,9,5,7,11,10.2614154611866,9.75266466280154,0.424731193234119,30
"12132","PR","Terra Boa",17200,28607.25,41005,"Campo Mourão",4,"Sul",1,"412720",5,21,5,16,8,13,0,0,0,0,0,21,5,16,8,13,13,10.2614154611866,9.75266466280154,0.377526406225317,31
"12133","PR","Terra Rica",16924,20956.04,41001,"Paranavaí",4,"Sul",0,"412730",2,11,2,9,3,8,0,0,0,0,0,11,2,9,3,8,10,9.9501821892875,9.73648801183996,0.305098035660836,29
"12134","PR","Terra Rica",16924,20956.04,41001,"Paranavaí",4,"Sul",0,"412730",3,24,7,17,11,13,0,0,0,0,0,24,7,17,11,13,11,9.9501821892875,9.73648801183996,0.386105908733168,31
"12135","PR","Terra Rica",16924,20956.04,41001,"Paranavaí",4,"Sul",0,"412730",4,12,3,9,3,9,0,0,0,0,0,12,3,9,3,9,9,9.9501821892875,9.73648801183996,0.417717047376497,30
"12136","PR","Terra Rica",16924,20956.04,41001,"Paranavaí",4,"Sul",0,"412730",5,16,5,11,6,10,0,0,0,0,0,16,5,11,6,10,11,9.9501821892875,9.73648801183996,0.405522906168105,31
"12137","PR","Terra Roxa",17522,38866.78,41022,"Toledo",4,"Sul",0,"412740",2,14,3,11,8,6,0,0,0,0,0,14,3,11,8,6,8,10.5678951801781,9.77121251322631,0.311208827254158,29
"12138","PR","Terra Roxa",17522,38866.78,41022,"Toledo",4,"Sul",0,"412740",3,17,4,13,8,9,1,1,0,1,0,18,5,13,9,9,9,10.5678951801781,9.77121251322631,0.420568596661947,31
"12139","PR","Terra Roxa",17522,38866.78,41022,"Toledo",4,"Sul",0,"412740",4,18,8,10,8,10,0,0,0,0,0,18,8,10,8,10,7,10.5678951801781,9.77121251322631,0.44581076361272,30
"12140","PR","Terra Roxa",17522,38866.78,41022,"Toledo",4,"Sul",0,"412740",5,17,7,10,9,8,0,0,0,0,0,17,7,10,9,8,12,10.5678951801781,9.77121251322631,0.4005520577986,31
"12141","PR","Tibagi",20607,43874.69,41019,"Telêmaco Borba",4,"Sul",0,"412750",2,23,8,15,13,10,0,0,0,0,0,23,8,15,13,10,11,10.6890928952161,9.93338610288199,0.319387632829382,29
"12142","PR","Tibagi",20607,43874.69,41019,"Telêmaco Borba",4,"Sul",0,"412750",3,21,8,13,12,9,1,1,0,0,1,22,9,13,12,10,8,10.6890928952161,9.93338610288199,0.421339358228835,31
"12143","PR","Tibagi",20607,43874.69,41019,"Telêmaco Borba",4,"Sul",0,"412750",4,31,17,14,15,16,0,0,0,0,0,31,17,14,15,16,17,10.6890928952161,9.93338610288199,0.445866772492623,30
"12144","PR","Tibagi",20607,43874.69,41019,"Telêmaco Borba",4,"Sul",0,"412750",5,35,11,24,15,20,0,0,0,0,0,35,11,24,15,20,13,10.6890928952161,9.93338610288199,0.442026192129578,31
"12145","PR","Tijucas do Sul",17084,19517.42,41039,"Rio Negro",4,"Sul",0,"412760",2,18,7,11,8,10,0,0,0,0,0,18,7,11,8,10,10,9.87906267910043,9.74589763196136,0.31225774554774,29
"12146","PR","Tijucas do Sul",17084,19517.42,41039,"Rio Negro",4,"Sul",0,"412760",3,18,5,13,7,11,0,0,0,0,0,18,5,13,7,11,7,9.87906267910043,9.74589763196136,0.398300083031785,31
"12147","PR","Tijucas do Sul",17084,19517.42,41039,"Rio Negro",4,"Sul",0,"412760",4,20,9,11,5,15,0,0,0,0,0,20,9,11,5,15,9,9.87906267910043,9.74589763196136,0.409450852680402,30
"12148","PR","Tijucas do Sul",17084,19517.42,41039,"Rio Negro",4,"Sul",0,"412760",5,23,13,10,18,5,0,0,0,0,0,23,13,10,18,5,5,9.87906267910043,9.74589763196136,0.407077305087796,31
"12149","PR","Toledo",142645,44448.08,41022,"Toledo",4,"Sul",1,"412770",2,149,20,129,48,101,0,0,0,0,0,149,20,129,48,101,55,10.7020770454085,11.8681143052037,0.320145375303161,29
"12150","PR","Toledo",142645,44448.08,41022,"Toledo",4,"Sul",1,"412770",3,147,26,121,41,106,4,0,4,3,1,151,26,125,44,107,76,10.7020770454085,11.8681143052037,0.415203149305731,31
"12151","PR","Toledo",142645,44448.08,41022,"Toledo",4,"Sul",1,"412770",4,171,32,139,51,120,0,0,0,0,0,171,32,139,51,120,63,10.7020770454085,11.8681143052037,0.436466616432632,30
"12152","PR","Toledo",142645,44448.08,41022,"Toledo",4,"Sul",1,"412770",5,182,22,160,49,133,1,0,1,0,1,183,22,161,49,134,73,10.7020770454085,11.8681143052037,0.406490088546034,31
"12153","PR","Três Barras do Paraná",12038,26456.58,41023,"Cascavel",4,"Sul",0,"412785",2,4,1,3,1,3,0,0,0,0,0,4,1,3,1,3,3,10.1832601776145,9.39582359210772,0.300545324130755,29
"12154","PR","Três Barras do Paraná",12038,26456.58,41023,"Cascavel",4,"Sul",0,"412785",3,12,2,10,6,6,0,0,0,0,0,12,2,10,6,6,7,10.1832601776145,9.39582359210772,0.363731215002014,31
"12155","PR","Três Barras do Paraná",12038,26456.58,41023,"Cascavel",4,"Sul",0,"412785",4,10,4,6,2,8,0,0,0,0,0,10,4,6,2,8,6,10.1832601776145,9.39582359210772,0.386383161729463,30
"12156","PR","Três Barras do Paraná",12038,26456.58,41023,"Cascavel",4,"Sul",0,"412785",5,12,2,10,5,7,0,0,0,0,0,12,2,10,5,7,2,10.1832601776145,9.39582359210772,0.41970864759136,31
"12157","PR","Tupãssi",8109,42171.14,41022,"Toledo",4,"Sul",0,"412795",2,4,2,2,3,1,0,0,0,0,0,4,2,2,3,1,3,10.6494913798113,9.00072983494456,0.353698937284282,29
"12158","PR","Tupãssi",8109,42171.14,41022,"Toledo",4,"Sul",0,"412795",3,8,0,8,3,5,0,0,0,0,0,8,0,8,3,5,4,10.6494913798113,9.00072983494456,0.42815876550727,31
"12159","PR","Tupãssi",8109,42171.14,41022,"Toledo",4,"Sul",0,"412795",4,7,2,5,1,6,0,0,0,0,0,7,2,5,1,6,5,10.6494913798113,9.00072983494456,0.472556340284331,30
"12160","PR","Tupãssi",8109,42171.14,41022,"Toledo",4,"Sul",0,"412795",5,4,1,3,0,4,0,0,0,0,0,4,1,3,0,4,8,10.6494913798113,9.00072983494456,0.432638486786749,31
"12161","PR","Ubiratã",20909,44835.33,41004,"Goioerê",4,"Sul",1,"412800",2,27,4,23,14,13,0,0,0,0,0,27,4,23,14,13,18,10.7107517236802,9.94793496727142,0.321877403061292,29
"12162","PR","Ubiratã",20909,44835.33,41004,"Goioerê",4,"Sul",1,"412800",3,21,3,18,5,16,0,0,0,0,0,21,3,18,5,16,24,10.7107517236802,9.94793496727142,0.399133180079741,31
"12163","PR","Ubiratã",20909,44835.33,41004,"Goioerê",4,"Sul",1,"412800",4,26,4,22,14,12,1,0,1,0,1,27,4,23,14,13,19,10.7107517236802,9.94793496727142,0.415607705741336,30
"12164","PR","Ubiratã",20909,44835.33,41004,"Goioerê",4,"Sul",1,"412800",5,31,5,26,12,19,1,0,1,0,1,32,5,27,12,20,17,10.7107517236802,9.94793496727142,0.407105994189741,31
"12165","PR","Umuarama",112500,30659.36,41002,"Umuarama",4,"Sul",1,"412810",2,102,9,93,35,67,1,0,1,1,0,103,9,94,36,67,70,10.3306932781049,11.6307085006266,0.298904675091133,29
"12166","PR","Umuarama",112500,30659.36,41002,"Umuarama",4,"Sul",1,"412810",3,123,15,108,41,82,1,0,1,0,1,124,15,109,41,83,78,10.3306932781049,11.6307085006266,0.40976362840618,31
"12167","PR","Umuarama",112500,30659.36,41002,"Umuarama",4,"Sul",1,"412810",4,117,21,96,40,77,1,0,1,1,0,118,21,97,41,77,69,10.3306932781049,11.6307085006266,0.424166060343537,30
"12168","PR","Umuarama",112500,30659.36,41002,"Umuarama",4,"Sul",1,"412810",5,153,16,137,42,111,0,0,0,0,0,153,16,137,42,111,72,10.3306932781049,11.6307085006266,0.378030333021236,31
"12169","PR","União da Vitória",57913,27678.96,41033,"União da Vitória",4,"Sul",1,"412820",2,48,15,33,24,24,1,0,1,1,0,49,15,34,25,24,34,10.2284278367714,10.9666971634023,0.332245587794601,29
"12170","PR","União da Vitória",57913,27678.96,41033,"União da Vitória",4,"Sul",1,"412820",3,53,8,45,22,31,0,0,0,0,0,53,8,45,22,31,25,10.2284278367714,10.9666971634023,0.424526498229796,31
"12171","PR","União da Vitória",57913,27678.96,41033,"União da Vitória",4,"Sul",1,"412820",4,44,8,36,20,24,0,0,0,0,0,44,8,36,20,24,35,10.2284278367714,10.9666971634023,0.461993303559223,30
"12172","PR","União da Vitória",57913,27678.96,41033,"União da Vitória",4,"Sul",1,"412820",5,10,2,8,3,7,2,0,2,2,0,12,2,10,5,7,48,10.2284278367714,10.9666971634023,0.417498798102517,31
"12173","PR","Uraí",11273,25004.27,41014,"Assaí",4,"Sul",0,"412840",2,9,3,6,2,7,0,0,0,0,0,9,3,6,2,7,7,10.1268018892657,9.33016576504453,0.308302265310141,29
"12174","PR","Uraí",11273,25004.27,41014,"Assaí",4,"Sul",0,"412840",3,7,1,6,2,5,0,0,0,0,0,7,1,6,2,5,5,10.1268018892657,9.33016576504453,0.389643013235155,31
"12175","PR","Uraí",11273,25004.27,41014,"Assaí",4,"Sul",0,"412840",4,14,2,12,7,7,0,0,0,0,0,14,2,12,7,7,7,10.1268018892657,9.33016576504453,0.416982393506524,30
"12176","PR","Uraí",11273,25004.27,41014,"Assaí",4,"Sul",0,"412840",5,7,2,5,2,5,0,0,0,0,0,7,2,5,2,5,2,10.1268018892657,9.33016576504453,0.389633544844892,31
"12177","PR","Wenceslau Braz",19386,28652.64,41018,"Wenceslau Braz",4,"Sul",1,"412850",2,27,6,21,11,16,0,0,0,0,0,27,6,21,11,16,17,10.2630008644945,9.87230643505255,0.345444510381054,29
"12178","PR","Wenceslau Braz",19386,28652.64,41018,"Wenceslau Braz",4,"Sul",1,"412850",3,25,7,18,13,12,0,0,0,0,0,25,7,18,13,12,19,10.2630008644945,9.87230643505255,0.42757779541154,31
"12179","PR","Wenceslau Braz",19386,28652.64,41018,"Wenceslau Braz",4,"Sul",1,"412850",4,25,7,18,8,17,0,0,0,0,0,25,7,18,8,17,12,10.2630008644945,9.87230643505255,0.426438474166267,30
"12180","PR","Wenceslau Braz",19386,28652.64,41018,"Wenceslau Braz",4,"Sul",1,"412850",5,23,6,17,8,15,1,1,0,0,1,24,7,17,8,16,13,10.2630008644945,9.87230643505255,0.417806989811589,31
"12181","PR","Vera Cruz do Oeste",8454,29918.57,41024,"Foz do Iguaçu",4,"Sul",0,"412855",2,10,4,6,4,6,0,0,0,0,0,10,4,6,4,6,2,10.3062346368286,9.04239498112674,0.312532165050491,29
"12182","PR","Vera Cruz do Oeste",8454,29918.57,41024,"Foz do Iguaçu",4,"Sul",0,"412855",3,3,0,3,2,1,0,0,0,0,0,3,0,3,2,1,6,10.3062346368286,9.04239498112674,0.389223404025719,31
"12183","PR","Vera Cruz do Oeste",8454,29918.57,41024,"Foz do Iguaçu",4,"Sul",0,"412855",4,5,0,5,3,2,1,0,1,0,1,6,0,6,3,3,7,10.3062346368286,9.04239498112674,0.428913017627176,30
"12184","PR","Vera Cruz do Oeste",8454,29918.57,41024,"Foz do Iguaçu",4,"Sul",0,"412855",5,2,0,2,2,0,0,0,0,0,0,2,0,2,2,0,7,10.3062346368286,9.04239498112674,0.406828914602194,31
"12185","PR","Verê",7174,39915.08,41026,"Francisco Beltrão",4,"Sul",0,"412860",2,11,2,9,7,4,0,0,0,0,0,11,2,9,7,4,3,10.5945094763369,8.87821865809223,0.332058675230444,29
"12186","PR","Verê",7174,39915.08,41026,"Francisco Beltrão",4,"Sul",0,"412860",3,9,2,7,0,9,0,0,0,0,0,9,2,7,0,9,5,10.5945094763369,8.87821865809223,0.427304761717398,31
"12187","PR","Verê",7174,39915.08,41026,"Francisco Beltrão",4,"Sul",0,"412860",4,6,1,5,1,5,0,0,0,0,0,6,1,5,1,5,5,10.5945094763369,8.87821865809223,0.417999622776452,30
"12188","PR","Verê",7174,39915.08,41026,"Francisco Beltrão",4,"Sul",0,"412860",5,1,0,1,0,1,0,0,0,0,0,1,0,1,0,1,4,10.5945094763369,8.87821865809223,0.438358559987668,31
"12189","PR","Vitorino",6859,52876.69,41027,"Pato Branco",4,"Sul",0,"412870",2,11,7,4,5,6,0,0,0,0,0,11,7,4,5,6,2,10.8757178780127,8.83331693749932,0.316291811533317,29
"12190","PR","Vitorino",6859,52876.69,41027,"Pato Branco",4,"Sul",0,"412870",3,14,0,14,4,10,0,0,0,0,0,14,0,14,4,10,3,10.8757178780127,8.83331693749932,0.39871003892546,31
"12191","PR","Vitorino",6859,52876.69,41027,"Pato Branco",4,"Sul",0,"412870",4,10,2,8,3,7,1,1,0,0,1,11,3,8,3,8,5,10.8757178780127,8.83331693749932,0.411169508139709,30
"12192","PR","Vitorino",6859,52876.69,41027,"Pato Branco",4,"Sul",0,"412870",5,7,2,5,2,5,0,0,0,0,0,7,2,5,2,5,5,10.8757178780127,8.83331693749932,0.367632751370039,31
"12193","SC","Abelardo Luz",17960,39108.44,42003,"Xanxerê",4,"Sul",0,"420010",2,26,10,16,8,18,0,0,0,0,0,26,10,16,8,18,13,10.5740935794572,9.79590234185619,0.309728238004473,29
"12194","SC","Abelardo Luz",17960,39108.44,42003,"Xanxerê",4,"Sul",0,"420010",3,28,11,17,8,20,0,0,0,0,0,28,11,17,8,20,7,10.5740935794572,9.79590234185619,0.39985011629695,31
"12195","SC","Abelardo Luz",17960,39108.44,42003,"Xanxerê",4,"Sul",0,"420010",4,28,11,17,11,17,1,0,1,0,1,29,11,18,11,18,12,10.5740935794572,9.79590234185619,0.413686324321178,30
"12196","SC","Abelardo Luz",17960,39108.44,42003,"Xanxerê",4,"Sul",0,"420010",5,30,12,18,8,22,0,0,0,0,0,30,12,18,8,22,6,10.5740935794572,9.79590234185619,0.418349365301694,31
"12197","SC","Agrolândia",11013,23224.16,42014,"Ituporanga",4,"Sul",0,"420020",2,8,3,5,4,4,0,0,0,0,0,8,3,5,4,4,5,10.0529483951055,9.30683167216494,0.337697407883527,29
"12198","SC","Agrolândia",11013,23224.16,42014,"Ituporanga",4,"Sul",0,"420020",3,8,4,4,0,8,0,0,0,0,0,8,4,4,0,8,9,10.0529483951055,9.30683167216494,0.433644734796526,31
"12199","SC","Agrolândia",11013,23224.16,42014,"Ituporanga",4,"Sul",0,"420020",4,7,2,5,3,4,0,0,0,0,0,7,2,5,3,4,7,10.0529483951055,9.30683167216494,0.423015654118349,30
"12200","SC","Agrolândia",11013,23224.16,42014,"Ituporanga",4,"Sul",0,"420020",5,6,3,3,5,1,0,0,0,0,0,6,3,3,5,1,7,10.0529483951055,9.30683167216494,0.408656861079638,31
"12201","SC","Águas Mornas",6559,25790.35,42017,"Tabuleiro",4,"Sul",1,"420060",2,7,1,6,2,5,0,0,0,0,0,7,1,6,2,5,6,10.1577556699349,8.78859343129374,0.321742333113885,29
"12202","SC","Águas Mornas",6559,25790.35,42017,"Tabuleiro",4,"Sul",1,"420060",3,6,4,2,1,5,0,0,0,0,0,6,4,2,1,5,2,10.1577556699349,8.78859343129374,0.435505120827037,31
"12203","SC","Águas Mornas",6559,25790.35,42017,"Tabuleiro",4,"Sul",1,"420060",4,3,2,1,2,1,0,0,0,0,0,3,2,1,2,1,3,10.1577556699349,8.78859343129374,0.469864326895528,30
"12204","SC","Águas Mornas",6559,25790.35,42017,"Tabuleiro",4,"Sul",1,"420060",5,3,1,2,0,3,0,0,0,0,0,3,1,2,0,3,7,10.1577556699349,8.78859343129374,0.42516483708643,31
"12205","SC","Antônio Carlos",8613,78006.01,42016,"Florianópolis",4,"Sul",1,"420120",2,14,1,13,3,11,0,0,0,0,0,14,1,13,3,11,4,11.2645411539855,9.06102796878917,0.30486328649826,29
"12206","SC","Antônio Carlos",8613,78006.01,42016,"Florianópolis",4,"Sul",1,"420120",3,8,1,7,2,6,0,0,0,0,0,8,1,7,2,6,3,11.2645411539855,9.06102796878917,0.420980047724865,31
"12207","SC","Antônio Carlos",8613,78006.01,42016,"Florianópolis",4,"Sul",1,"420120",4,10,1,9,1,9,0,0,0,0,0,10,1,9,1,9,5,11.2645411539855,9.06102796878917,0.443865286089464,30
"12208","SC","Antônio Carlos",8613,78006.01,42016,"Florianópolis",4,"Sul",1,"420120",5,13,3,10,4,9,0,0,0,0,0,13,3,10,4,9,0,11.2645411539855,9.06102796878917,0.387063669090022,31
"12209","SC","Apiúna",10848,39068.46,42012,"Blumenau",4,"Sul",0,"420125",2,9,3,6,5,4,0,0,0,0,0,9,3,6,5,4,8,10.5730707708402,9.29173601018018,0.305972469553553,29
"12210","SC","Apiúna",10848,39068.46,42012,"Blumenau",4,"Sul",0,"420125",3,7,2,5,2,5,0,0,0,0,0,7,2,5,2,5,4,10.5730707708402,9.29173601018018,0.43596621228692,31
"12211","SC","Apiúna",10848,39068.46,42012,"Blumenau",4,"Sul",0,"420125",4,11,3,8,3,8,0,0,0,0,0,11,3,8,3,8,6,10.5730707708402,9.29173601018018,0.456710767223357,30
"12212","SC","Apiúna",10848,39068.46,42012,"Blumenau",4,"Sul",0,"420125",5,12,4,8,2,10,0,0,0,0,0,12,4,8,2,10,2,10.5730707708402,9.29173601018018,0.417191496316825,31
"12213","SC","Araquari",39524,113080.67,42008,"Joinville",4,"Sul",1,"420130",2,49,16,33,13,36,0,0,0,0,0,49,16,33,13,36,15,11.6358567367988,10.5846633613149,0.317451024131622,29
"12214","SC","Araquari",39524,113080.67,42008,"Joinville",4,"Sul",1,"420130",3,63,23,40,19,44,0,0,0,0,0,63,23,40,19,44,13,11.6358567367988,10.5846633613149,0.432603416774627,31
"12215","SC","Araquari",39524,113080.67,42008,"Joinville",4,"Sul",1,"420130",4,39,17,22,18,21,0,0,0,0,0,39,17,22,18,21,21,11.6358567367988,10.5846633613149,0.445672788277415,30
"12216","SC","Araquari",39524,113080.67,42008,"Joinville",4,"Sul",1,"420130",5,60,19,41,24,36,0,0,0,0,0,60,19,41,24,36,15,11.6358567367988,10.5846633613149,0.398566086916299,31
"12217","SC","Araranguá",68867,27132.74,42020,"Araranguá",4,"Sul",1,"420140",2,79,12,67,25,54,0,0,0,0,0,79,12,67,25,54,37,10.2084963957616,11.1399323872589,0.312334262268953,29
"12218","SC","Araranguá",68867,27132.74,42020,"Araranguá",4,"Sul",1,"420140",3,71,19,52,23,48,0,0,0,0,0,71,19,52,23,48,30,10.2084963957616,11.1399323872589,0.448951477068056,31
"12219","SC","Araranguá",68867,27132.74,42020,"Araranguá",4,"Sul",1,"420140",4,71,19,52,32,39,1,0,1,0,1,72,19,53,32,40,29,10.2084963957616,11.1399323872589,0.464835604906589,30
"12220","SC","Araranguá",68867,27132.74,42020,"Araranguá",4,"Sul",1,"420140",5,86,15,71,23,63,2,1,1,0,2,88,16,72,23,65,38,10.2084963957616,11.1399323872589,0.410176016757451,31
"12221","SC","Ascurra",7978,24968.67,42012,"Blumenau",4,"Sul",0,"420170",2,4,1,3,2,2,0,0,0,0,0,4,1,3,2,2,4,10.1253771179385,8.98444303246535,0.281620751869827,29
"12222","SC","Ascurra",7978,24968.67,42012,"Blumenau",4,"Sul",0,"420170",3,6,3,3,4,2,0,0,0,0,0,6,3,3,4,2,3,10.1253771179385,8.98444303246535,0.403989537902443,31
"12223","SC","Ascurra",7978,24968.67,42012,"Blumenau",4,"Sul",0,"420170",4,21,6,15,7,14,0,0,0,0,0,21,6,15,7,14,5,10.1253771179385,8.98444303246535,0.425895324734132,30
"12224","SC","Ascurra",7978,24968.67,42012,"Blumenau",4,"Sul",0,"420170",5,10,6,4,4,6,0,0,0,0,0,10,6,4,4,6,5,10.1253771179385,8.98444303246535,0.385304076391707,31
"12225","SC","Balneário Arroio do Silva",13430,13503,42020,"Araranguá",4,"Sul",0,"420195",2,11,5,6,2,9,0,0,0,0,0,11,5,6,2,9,10,9.51066716196104,9.50524628951728,0.33045786334737,29
"12226","SC","Balneário Arroio do Silva",13430,13503,42020,"Araranguá",4,"Sul",0,"420195",3,16,4,12,5,11,0,0,0,0,0,16,4,12,5,11,17,9.51066716196104,9.50524628951728,0.46912960641793,31
"12227","SC","Balneário Arroio do Silva",13430,13503,42020,"Araranguá",4,"Sul",0,"420195",4,13,1,12,5,8,0,0,0,0,0,13,1,12,5,8,5,9.51066716196104,9.50524628951728,0.498702184763546,30
"12228","SC","Balneário Arroio do Silva",13430,13503,42020,"Araranguá",4,"Sul",0,"420195",5,16,3,13,5,11,0,0,0,0,0,16,3,13,5,11,9,9.51066716196104,9.50524628951728,0.440616968173585,31
"12229","SC","Balneário Camboriú",145796,40002.3,42013,"Itajaí",4,"Sul",1,"420200",2,117,19,98,35,82,1,0,1,0,1,118,19,99,35,83,51,10.596692231443,11.8899636633381,0.296158563978662,29
"12230","SC","Balneário Camboriú",145796,40002.3,42013,"Itajaí",4,"Sul",1,"420200",3,128,29,99,47,81,0,0,0,0,0,128,29,99,47,81,68,10.596692231443,11.8899636633381,0.454455108708366,31
"12231","SC","Balneário Camboriú",145796,40002.3,42013,"Itajaí",4,"Sul",1,"420200",4,136,19,117,34,102,2,0,2,0,2,138,19,119,34,104,57,10.596692231443,11.8899636633381,0.476040369031473,30
"12232","SC","Balneário Camboriú",145796,40002.3,42013,"Itajaí",4,"Sul",1,"420200",5,144,18,126,35,109,1,0,1,0,1,145,18,127,35,110,47,10.596692231443,11.8899636633381,0.411936938838958,31
"12233","SC","Balneário Barra do Sul",11035,17626.61,42008,"Joinville",4,"Sul",0,"420205",2,7,1,6,2,5,0,0,0,0,0,7,1,6,2,5,11,9.77716497102627,9.30882731869084,0.327879940349149,29
"12234","SC","Balneário Barra do Sul",11035,17626.61,42008,"Joinville",4,"Sul",0,"420205",3,12,3,9,5,7,0,0,0,0,0,12,3,9,5,7,9,9.77716497102627,9.30882731869084,0.444827707997611,31
"12235","SC","Balneário Barra do Sul",11035,17626.61,42008,"Joinville",4,"Sul",0,"420205",4,15,5,10,9,6,0,0,0,0,0,15,5,10,9,6,10,9.77716497102627,9.30882731869084,0.468465573607415,30
"12236","SC","Balneário Barra do Sul",11035,17626.61,42008,"Joinville",4,"Sul",0,"420205",5,17,1,16,4,13,0,0,0,0,0,17,1,16,4,13,8,9.77716497102627,9.30882731869084,0.421315767489641,31
"12237","SC","Balneário Gaivota",11260,14239.64,42020,"Araranguá",4,"Sul",0,"420207",2,13,3,10,5,8,0,0,0,0,0,13,3,10,5,8,6,9.56378490374752,9.32901190169368,0.343910960239973,29
"12238","SC","Balneário Gaivota",11260,14239.64,42020,"Araranguá",4,"Sul",0,"420207",3,11,3,8,4,7,0,0,0,0,0,11,3,8,4,7,10,9.56378490374752,9.32901190169368,0.465610025532374,31
"12239","SC","Balneário Gaivota",11260,14239.64,42020,"Araranguá",4,"Sul",0,"420207",4,15,6,9,6,9,0,0,0,0,0,15,6,9,6,9,10,9.56378490374752,9.32901190169368,0.490189553997732,30
"12240","SC","Balneário Gaivota",11260,14239.64,42020,"Araranguá",4,"Sul",0,"420207",5,19,4,15,8,11,0,0,0,0,0,19,4,15,8,11,5,9.56378490374752,9.32901190169368,0.434970449746168,31
"12241","SC","Barra Velha",29860,48950.39,42013,"Itajaí",4,"Sul",1,"420210",2,43,12,31,18,25,0,0,0,0,0,43,12,31,18,25,14,10.7985626152405,10.3042750710932,0.311857465606245,29
"12242","SC","Barra Velha",29860,48950.39,42013,"Itajaí",4,"Sul",1,"420210",3,48,22,26,20,28,1,0,1,0,1,49,22,27,20,29,22,10.7985626152405,10.3042750710932,0.440662075392821,31
"12243","SC","Barra Velha",29860,48950.39,42013,"Itajaí",4,"Sul",1,"420210",4,49,14,35,20,29,0,0,0,0,0,49,14,35,20,29,18,10.7985626152405,10.3042750710932,0.450534550252674,30
"12244","SC","Barra Velha",29860,48950.39,42013,"Itajaí",4,"Sul",1,"420210",5,55,11,44,21,34,0,0,0,0,0,55,11,44,21,34,20,10.7985626152405,10.3042750710932,0.404742978459154,31
"12245","SC","Benedito Novo",11775,26235.82,42012,"Blumenau",4,"Sul",0,"420220",2,4,0,4,2,2,0,0,0,0,0,4,0,4,2,2,6,10.1748809315881,9.37373391888462,0.355342765793285,29
"12246","SC","Benedito Novo",11775,26235.82,42012,"Blumenau",4,"Sul",0,"420220",3,2,1,1,1,1,0,0,0,0,0,2,1,1,1,1,6,10.1748809315881,9.37373391888462,0.437997685588251,31
"12247","SC","Benedito Novo",11775,26235.82,42012,"Blumenau",4,"Sul",0,"420220",4,4,2,2,2,2,0,0,0,0,0,4,2,2,2,2,4,10.1748809315881,9.37373391888462,0.452912756812071,30
"12248","SC","Benedito Novo",11775,26235.82,42012,"Blumenau",4,"Sul",0,"420220",5,2,0,2,0,2,0,0,0,0,0,2,0,2,0,2,6,10.1748809315881,9.37373391888462,0.445750123700401,31
"12249","SC","Biguaçu",69486,27639.57,42016,"Florianópolis",4,"Sul",1,"420230",2,68,17,51,18,50,2,0,2,1,1,70,17,53,19,51,27,10.2270037205971,11.1488805724124,0.30275506348292,29
"12250","SC","Biguaçu",69486,27639.57,42016,"Florianópolis",4,"Sul",1,"420230",3,70,21,49,28,42,0,0,0,0,0,70,21,49,28,42,25,10.2270037205971,11.1488805724124,0.439544523814197,31
"12251","SC","Biguaçu",69486,27639.57,42016,"Florianópolis",4,"Sul",1,"420230",4,76,17,59,29,47,0,0,0,0,0,76,17,59,29,47,21,10.2270037205971,11.1488805724124,0.458122227667513,30
"12252","SC","Biguaçu",69486,27639.57,42016,"Florianópolis",4,"Sul",1,"420230",5,94,23,71,36,58,1,0,1,1,0,95,23,72,37,58,43,10.2270037205971,11.1488805724124,0.404424420685103,31
"12253","SC","Blumenau",361855,48115.48,42012,"Blumenau",4,"Sul",1,"420240",2,332,57,275,92,240,5,1,4,3,2,337,58,279,95,242,114,10.7813592338397,12.7989988580791,0.306474925947697,29
"12254","SC","Blumenau",361855,48115.48,42012,"Blumenau",4,"Sul",1,"420240",3,303,58,245,93,210,2,2,0,1,1,305,60,245,94,211,154,10.7813592338397,12.7989988580791,0.458035025553887,31
"12255","SC","Blumenau",361855,48115.48,42012,"Blumenau",4,"Sul",1,"420240",4,335,60,275,92,243,2,0,2,1,1,337,60,277,93,244,136,10.7813592338397,12.7989988580791,0.479150552563166,30
"12256","SC","Blumenau",361855,48115.48,42012,"Blumenau",4,"Sul",1,"420240",5,385,72,313,124,261,3,1,2,1,2,388,73,315,125,263,146,10.7813592338397,12.7989988580791,0.420638084383457,31
"12257","SC","Bombinhas",20335,34165.56,42013,"Itajaí",4,"Sul",1,"420245",2,20,5,15,8,12,0,0,0,0,0,20,5,15,8,12,5,10.438973398124,9.92009881834132,0.275736346968625,29
"12258","SC","Bombinhas",20335,34165.56,42013,"Itajaí",4,"Sul",1,"420245",3,23,2,21,6,17,0,0,0,0,0,23,2,21,6,17,7,10.438973398124,9.92009881834132,0.427753833162508,31
"12259","SC","Bombinhas",20335,34165.56,42013,"Itajaí",4,"Sul",1,"420245",4,25,3,22,7,18,1,0,1,1,0,26,3,23,8,18,8,10.438973398124,9.92009881834132,0.455336169783553,30
"12260","SC","Bombinhas",20335,34165.56,42013,"Itajaí",4,"Sul",1,"420245",5,19,3,16,5,14,0,0,0,0,0,19,3,16,5,14,6,10.438973398124,9.92009881834132,0.413009487654447,31
"12261","SC","Bom Retiro",10060,27619.92,42010,"Campos de Lages",4,"Sul",0,"420260",2,6,3,3,1,5,0,0,0,0,0,6,3,3,1,5,6,10.2262925305072,9.21632244365373,0.28208165115164,29
"12262","SC","Bom Retiro",10060,27619.92,42010,"Campos de Lages",4,"Sul",0,"420260",3,8,4,4,2,6,0,0,0,0,0,8,4,4,2,6,9,10.2262925305072,9.21632244365373,0.422437871655082,31
"12263","SC","Bom Retiro",10060,27619.92,42010,"Campos de Lages",4,"Sul",0,"420260",4,9,3,6,3,6,0,0,0,0,0,9,3,6,3,6,3,10.2262925305072,9.21632244365373,0.411114118302834,30
"12264","SC","Bom Retiro",10060,27619.92,42010,"Campos de Lages",4,"Sul",0,"420260",5,15,10,5,9,6,0,0,0,0,0,15,10,5,9,6,2,10.2262925305072,9.21632244365373,0.392645744831232,31
"12265","SC","Braço do Norte",33876,35572.21,42018,"Tubarão",4,"Sul",1,"420280",2,50,12,38,14,36,0,0,0,0,0,50,12,38,14,36,10,10.4793199940217,10.4304620780415,0.295502239806597,29
"12266","SC","Braço do Norte",33876,35572.21,42018,"Tubarão",4,"Sul",1,"420280",3,36,13,23,10,26,0,0,0,0,0,36,13,23,10,26,21,10.4793199940217,10.4304620780415,0.40675067488541,31
"12267","SC","Braço do Norte",33876,35572.21,42018,"Tubarão",4,"Sul",1,"420280",4,45,11,34,10,35,0,0,0,0,0,45,11,34,10,35,8,10.4793199940217,10.4304620780415,0.422094977524679,30
"12268","SC","Braço do Norte",33876,35572.21,42018,"Tubarão",4,"Sul",1,"420280",5,60,13,47,24,36,0,0,0,0,0,60,13,47,24,36,10,10.4793199940217,10.4304620780415,0.375121509940944,31
"12269","SC","Brusque",137689,48408.17,42012,"Blumenau",4,"Sul",1,"420290",2,162,27,135,58,104,2,0,2,1,1,164,27,137,59,105,47,10.7874238801122,11.8327527977205,0.310126232533131,29
"12270","SC","Brusque",137689,48408.17,42012,"Blumenau",4,"Sul",1,"420290",3,173,30,143,60,113,0,0,0,0,0,173,30,143,60,113,58,10.7874238801122,11.8327527977205,0.442106796266329,31
"12271","SC","Brusque",137689,48408.17,42012,"Blumenau",4,"Sul",1,"420290",4,114,16,98,36,78,0,0,0,0,0,114,16,98,36,78,39,10.7874238801122,11.8327527977205,0.456164280005466,30
"12272","SC","Brusque",137689,48408.17,42012,"Blumenau",4,"Sul",1,"420290",5,33,2,31,7,26,6,4,2,2,4,39,6,33,9,30,46,10.7874238801122,11.8327527977205,0.39670969403877,31
"12273","SC","Caçador",79313,42367.59,42004,"Joaçaba",4,"Sul",1,"420300",2,77,27,50,31,46,0,0,0,0,0,77,27,50,31,46,55,10.6541389621351,11.2811573286134,0.324089309516997,29
"12274","SC","Caçador",79313,42367.59,42004,"Joaçaba",4,"Sul",1,"420300",3,80,23,57,34,46,0,0,0,0,0,80,23,57,34,46,40,10.6541389621351,11.2811573286134,0.430010538672466,31
"12275","SC","Caçador",79313,42367.59,42004,"Joaçaba",4,"Sul",1,"420300",4,101,35,66,43,58,1,0,1,1,0,102,35,67,44,58,39,10.6541389621351,11.2811573286134,0.443671915633829,30
"12276","SC","Caçador",79313,42367.59,42004,"Joaçaba",4,"Sul",1,"420300",5,91,26,65,45,46,1,1,0,1,0,92,27,65,46,46,49,10.6541389621351,11.2811573286134,0.410004765937358,31
"12277","SC","Camboriú",85105,18570.55,42013,"Itajaí",4,"Sul",1,"420320",2,90,25,65,38,52,1,0,1,1,0,91,25,66,39,52,30,9.82933227157105,11.3516410672421,0.298602123408395,29
"12278","SC","Camboriú",85105,18570.55,42013,"Itajaí",4,"Sul",1,"420320",3,137,30,107,63,74,0,0,0,0,0,137,30,107,63,74,27,9.82933227157105,11.3516410672421,0.44545097243282,31
"12279","SC","Camboriú",85105,18570.55,42013,"Itajaí",4,"Sul",1,"420320",4,131,22,109,46,85,2,0,2,0,2,133,22,111,46,87,37,9.82933227157105,11.3516410672421,0.451235789483059,30
"12280","SC","Camboriú",85105,18570.55,42013,"Itajaí",4,"Sul",1,"420320",5,131,39,92,52,79,1,1,0,1,0,132,40,92,53,79,38,9.82933227157105,11.3516410672421,0.389720343601181,31
"12281","SC","Campo Alegre",11981,41005.32,42007,"São Bento do Sul",4,"Sul",0,"420330",2,8,2,6,0,8,0,0,0,0,0,8,2,6,0,8,7,10.6214570933664,9.3910773406399,0.356146215970391,29
"12282","SC","Campo Alegre",11981,41005.32,42007,"São Bento do Sul",4,"Sul",0,"420330",3,19,3,16,12,7,0,0,0,0,0,19,3,16,12,7,8,10.6214570933664,9.3910773406399,0.442677504988954,31
"12283","SC","Campo Alegre",11981,41005.32,42007,"São Bento do Sul",4,"Sul",0,"420330",4,5,0,5,1,4,0,0,0,0,0,5,0,5,1,4,8,10.6214570933664,9.3910773406399,0.450156838238299,30
"12284","SC","Campo Alegre",11981,41005.32,42007,"São Bento do Sul",4,"Sul",0,"420330",5,15,6,9,6,9,0,0,0,0,0,15,6,9,6,9,8,10.6214570933664,9.3910773406399,0.452830263109738,31
"12285","SC","Campo Erê",8418,34014.9,42002,"Chapecó",4,"Sul",0,"420350",2,11,6,5,6,5,1,1,0,0,1,12,7,5,6,6,8,10.4345539428954,9.03812754933052,0.3466951512186,29
"12286","SC","Campo Erê",8418,34014.9,42002,"Chapecó",4,"Sul",0,"420350",3,9,2,7,5,4,0,0,0,0,0,9,2,7,5,4,5,10.4345539428954,9.03812754933052,0.434994636440331,31
"12287","SC","Campo Erê",8418,34014.9,42002,"Chapecó",4,"Sul",0,"420350",4,11,4,7,6,5,1,1,0,1,0,12,5,7,7,5,5,10.4345539428954,9.03812754933052,0.461209339014693,30
"12288","SC","Campo Erê",8418,34014.9,42002,"Chapecó",4,"Sul",0,"420350",5,13,5,8,6,7,0,0,0,0,0,13,5,8,6,7,6,10.4345539428954,9.03812754933052,0.432346657603132,31
"12289","SC","Campos Novos",36556,54233.53,42009,"Curitibanos",4,"Sul",1,"420360",2,37,11,26,17,20,0,0,0,0,0,37,11,26,17,20,16,10.9010546308385,10.5066006103921,0.323098015314358,29
"12290","SC","Campos Novos",36556,54233.53,42009,"Curitibanos",4,"Sul",1,"420360",3,43,17,26,17,26,1,0,1,1,0,44,17,27,18,26,26,10.9010546308385,10.5066006103921,0.439137710342172,31
"12291","SC","Campos Novos",36556,54233.53,42009,"Curitibanos",4,"Sul",1,"420360",4,32,10,22,18,14,0,0,0,0,0,32,10,22,18,14,19,10.9010546308385,10.5066006103921,0.429426441168093,30
"12292","SC","Campos Novos",36556,54233.53,42009,"Curitibanos",4,"Sul",1,"420360",5,43,11,32,18,25,0,0,0,0,0,43,11,32,18,25,23,10.9010546308385,10.5066006103921,0.411090216172112,31
"12293","SC","Canelinha",12398,15724.49,42015,"Tijucas",4,"Sul",0,"420370",2,9,6,3,1,8,0,0,0,0,0,9,6,3,1,8,3,9.66297464861027,9.42529044826187,0.310896408243875,29
"12294","SC","Canelinha",12398,15724.49,42015,"Tijucas",4,"Sul",0,"420370",3,16,4,12,5,11,0,0,0,0,0,16,4,12,5,11,6,9.66297464861027,9.42529044826187,0.408000171502996,31
"12295","SC","Canelinha",12398,15724.49,42015,"Tijucas",4,"Sul",0,"420370",4,8,3,5,4,4,0,0,0,0,0,8,3,5,4,4,2,9.66297464861027,9.42529044826187,0.40578738031119,30
"12296","SC","Canelinha",12398,15724.49,42015,"Tijucas",4,"Sul",0,"420370",5,16,5,11,9,7,0,0,0,0,0,16,5,11,9,7,7,9.66297464861027,9.42529044826187,0.382493191602571,31
"12297","SC","Canoinhas",54480,31334.28,42006,"Canoinhas",4,"Sul",1,"420380",2,63,6,57,25,38,0,0,0,0,0,63,6,57,25,38,25,10.3524679848936,10.9055889408234,0.297876641290121,29
"12298","SC","Canoinhas",54480,31334.28,42006,"Canoinhas",4,"Sul",1,"420380",3,59,14,45,19,40,2,1,1,2,0,61,15,46,21,40,41,10.3524679848936,10.9055889408234,0.432348882293444,31
"12299","SC","Canoinhas",54480,31334.28,42006,"Canoinhas",4,"Sul",1,"420380",4,44,7,37,20,24,0,0,0,0,0,44,7,37,20,24,28,10.3524679848936,10.9055889408234,0.440211883973258,30
"12300","SC","Canoinhas",54480,31334.28,42006,"Canoinhas",4,"Sul",1,"420380",5,62,12,50,23,39,0,0,0,0,0,62,12,50,23,39,35,10.3524679848936,10.9055889408234,0.396975591668668,31
"12301","SC","Capinzal",23035,36806.58,42004,"Joaçaba",4,"Sul",0,"420390",2,22,1,21,6,16,0,0,0,0,0,22,1,21,6,16,11,10.5134319125213,10.04477007737,0.32315885814543,29
"12302","SC","Capinzal",23035,36806.58,42004,"Joaçaba",4,"Sul",0,"420390",3,32,6,26,10,22,0,0,0,0,0,32,6,26,10,22,13,10.5134319125213,10.04477007737,0.388468200975766,31
"12303","SC","Capinzal",23035,36806.58,42004,"Joaçaba",4,"Sul",0,"420390",4,18,4,14,8,10,0,0,0,0,0,18,4,14,8,10,7,10.5134319125213,10.04477007737,0.391286466785278,30
"12304","SC","Capinzal",23035,36806.58,42004,"Joaçaba",4,"Sul",0,"420390",5,16,2,14,9,7,0,0,0,0,0,16,2,14,9,7,9,10.5134319125213,10.04477007737,0.397580472619107,31
"12305","SC","Capivari de Baixo",25177,31917.87,42018,"Tubarão",4,"Sul",1,"420395",2,29,5,24,7,22,0,0,0,0,0,29,5,24,7,22,11,10.3709213200139,10.133686158324,0.31860693987663,29
"12306","SC","Capivari de Baixo",25177,31917.87,42018,"Tubarão",4,"Sul",1,"420395",3,24,1,23,5,19,1,0,1,1,0,25,1,24,6,19,7,10.3709213200139,10.133686158324,0.465854301060585,31
"12307","SC","Capivari de Baixo",25177,31917.87,42018,"Tubarão",4,"Sul",1,"420395",4,28,5,23,8,20,0,0,0,0,0,28,5,23,8,20,6,10.3709213200139,10.133686158324,0.458332988706177,30
"12308","SC","Capivari de Baixo",25177,31917.87,42018,"Tubarão",4,"Sul",1,"420395",5,33,4,29,10,23,0,0,0,0,0,33,4,29,10,23,21,10.3709213200139,10.133686158324,0.404362067178423,31
"12309","SC","Catanduvas",10984,37883.59,42004,"Joaçaba",4,"Sul",0,"420400",2,16,6,10,6,10,0,0,0,0,0,16,6,10,6,10,6,10.5422733157766,9.30419494744781,0.324453998982627,29
"12310","SC","Catanduvas",10984,37883.59,42004,"Joaçaba",4,"Sul",0,"420400",3,12,4,8,4,8,0,0,0,0,0,12,4,8,4,8,6,10.5422733157766,9.30419494744781,0.444241957371828,31
"12311","SC","Catanduvas",10984,37883.59,42004,"Joaçaba",4,"Sul",0,"420400",4,15,4,11,7,8,0,0,0,0,0,15,4,11,7,8,7,10.5422733157766,9.30419494744781,0.428768548014741,30
"12312","SC","Catanduvas",10984,37883.59,42004,"Joaçaba",4,"Sul",0,"420400",5,12,3,9,3,9,0,0,0,0,0,12,3,9,3,9,3,10.5422733157766,9.30419494744781,0.410968766347797,31
"12313","SC","Chapecó",224013,44321.07,42002,"Chapecó",4,"Sul",1,"420420",2,277,70,207,86,191,8,2,6,4,4,285,72,213,90,195,61,10.699215463729,12.3194593648675,0.316497189366559,29
"12314","SC","Chapecó",224013,44321.07,42002,"Chapecó",4,"Sul",1,"420420",3,331,85,246,106,225,3,1,2,1,2,334,86,248,107,227,96,10.699215463729,12.3194593648675,0.44859468063858,31
"12315","SC","Chapecó",224013,44321.07,42002,"Chapecó",4,"Sul",1,"420420",4,320,78,242,104,216,1,0,1,0,1,321,78,243,104,217,61,10.699215463729,12.3194593648675,0.449235991671407,30
"12316","SC","Chapecó",224013,44321.07,42002,"Chapecó",4,"Sul",1,"420420",5,357,86,271,113,244,2,1,1,2,0,359,87,272,115,244,101,10.699215463729,12.3194593648675,0.427046493797594,31
"12317","SC","Cocal do Sul",16821,39615.6,42019,"Criciúma",4,"Sul",1,"420425",2,13,1,12,4,9,1,0,1,0,1,14,1,13,4,10,6,10.5869782590628,9.73038338479178,0.303238529832759,29
"12318","SC","Cocal do Sul",16821,39615.6,42019,"Criciúma",4,"Sul",1,"420425",3,13,4,9,4,9,0,0,0,0,0,13,4,9,4,9,5,10.5869782590628,9.73038338479178,0.439009096158326,31
"12319","SC","Cocal do Sul",16821,39615.6,42019,"Criciúma",4,"Sul",1,"420425",4,14,2,12,1,13,0,0,0,0,0,14,2,12,1,13,12,10.5869782590628,9.73038338479178,0.475397792994794,30
"12320","SC","Cocal do Sul",16821,39615.6,42019,"Criciúma",4,"Sul",1,"420425",5,15,2,13,3,12,0,0,0,0,0,15,2,13,3,12,10,10.5869782590628,9.73038338479178,0.417305814437349,31
"12321","SC","Concórdia",75167,45197.17,42005,"Concórdia",4,"Sul",1,"420430",2,77,11,66,21,56,0,0,0,0,0,77,11,66,21,56,35,10.7187897532407,11.2274675838367,0.322987529878843,29
"12322","SC","Concórdia",75167,45197.17,42005,"Concórdia",4,"Sul",1,"420430",3,89,11,78,27,62,1,1,0,0,1,90,12,78,27,63,46,10.7187897532407,11.2274675838367,0.431321402530331,31
"12323","SC","Concórdia",75167,45197.17,42005,"Concórdia",4,"Sul",1,"420430",4,91,12,79,30,61,0,0,0,0,0,91,12,79,30,61,40,10.7187897532407,11.2274675838367,0.440918542051246,30
"12324","SC","Concórdia",75167,45197.17,42005,"Concórdia",4,"Sul",1,"420430",5,84,17,67,25,59,0,0,0,0,0,84,17,67,25,59,44,10.7187897532407,11.2274675838367,0.428096066572472,31
"12325","SC","Coronel Freitas",9940,26940.52,42002,"Chapecó",4,"Sul",0,"420440",2,6,2,4,1,5,0,0,0,0,0,6,2,4,1,5,8,10.201386751931,9.20432229965062,0.321888881172895,29
"12326","SC","Coronel Freitas",9940,26940.52,42002,"Chapecó",4,"Sul",0,"420440",3,8,3,5,2,6,0,0,0,0,0,8,3,5,2,6,3,10.201386751931,9.20432229965062,0.423026764571558,31
"12327","SC","Coronel Freitas",9940,26940.52,42002,"Chapecó",4,"Sul",0,"420440",4,5,2,3,3,2,0,0,0,0,0,5,2,3,3,2,7,10.201386751931,9.20432229965062,0.459618245427445,30
"12328","SC","Coronel Freitas",9940,26940.52,42002,"Chapecó",4,"Sul",0,"420440",5,12,0,12,3,9,0,0,0,0,0,12,0,12,3,9,6,10.201386751931,9.20432229965062,0.396953036226829,31
"12329","SC","Corupá",16107,28160.26,42008,"Joinville",4,"Sul",1,"420450",2,10,2,8,2,8,0,0,0,0,0,10,2,8,2,8,5,10.2456670431839,9.68700923909068,0.32871786123375,29
"12330","SC","Corupá",16107,28160.26,42008,"Joinville",4,"Sul",1,"420450",3,17,2,15,7,10,0,0,0,0,0,17,2,15,7,10,4,10.2456670431839,9.68700923909068,0.416948768020084,31
"12331","SC","Corupá",16107,28160.26,42008,"Joinville",4,"Sul",1,"420450",4,12,6,6,2,10,0,0,0,0,0,12,6,6,2,10,8,10.2456670431839,9.68700923909068,0.42610073295165,30
"12332","SC","Corupá",16107,28160.26,42008,"Joinville",4,"Sul",1,"420450",5,14,2,12,2,12,0,0,0,0,0,14,2,12,2,12,7,10.2456670431839,9.68700923909068,0.398376671999857,31
"12333","SC","Correia Pinto",12553,44370.99,42010,"Campos de Lages",4,"Sul",1,"420455",2,21,9,12,11,10,0,0,0,0,0,21,9,12,11,10,12,10.7003411564973,9.43771495981821,0.320250035259529,29
"12334","SC","Correia Pinto",12553,44370.99,42010,"Campos de Lages",4,"Sul",1,"420455",3,13,1,12,5,8,0,0,0,0,0,13,1,12,5,8,6,10.7003411564973,9.43771495981821,0.400506430156816,31
"12335","SC","Correia Pinto",12553,44370.99,42010,"Campos de Lages",4,"Sul",1,"420455",4,17,3,14,11,6,0,0,0,0,0,17,3,14,11,6,5,10.7003411564973,9.43771495981821,0.407848530748361,30
"12336","SC","Correia Pinto",12553,44370.99,42010,"Campos de Lages",4,"Sul",1,"420455",5,22,6,16,15,7,0,0,0,0,0,22,6,16,15,7,8,10.7003411564973,9.43771495981821,0.377013226931162,31
"12337","SC","Criciúma",217311,36073.31,42019,"Criciúma",4,"Sul",1,"420460",2,198,43,155,57,141,2,0,2,0,2,200,43,157,57,143,78,10.4933085356979,12.2890847862242,0.308843355380351,29
"12338","SC","Criciúma",217311,36073.31,42019,"Criciúma",4,"Sul",1,"420460",3,250,50,200,85,165,0,0,0,0,0,250,50,200,85,165,127,10.4933085356979,12.2890847862242,0.448785811613041,31
"12339","SC","Criciúma",217311,36073.31,42019,"Criciúma",4,"Sul",1,"420460",4,224,56,168,74,150,0,0,0,0,0,224,56,168,74,150,82,10.4933085356979,12.2890847862242,0.470006803772589,30
"12340","SC","Criciúma",217311,36073.31,42019,"Criciúma",4,"Sul",1,"420460",5,254,60,194,75,179,1,0,1,1,0,255,60,195,76,179,109,10.4933085356979,12.2890847862242,0.403379036432414,31
"12341","SC","Cunha Porã",11118,48327.51,42002,"Chapecó",4,"Sul",0,"420470",2,15,5,10,3,12,0,0,0,0,0,15,5,10,3,12,5,10.7857562427174,9.31632069551342,0.313788459069061,29
"12342","SC","Cunha Porã",11118,48327.51,42002,"Chapecó",4,"Sul",0,"420470",3,15,4,11,4,11,0,0,0,0,0,15,4,11,4,11,7,10.7857562427174,9.31632069551342,0.383281141987835,31
"12343","SC","Cunha Porã",11118,48327.51,42002,"Chapecó",4,"Sul",0,"420470",4,16,2,14,4,12,0,0,0,0,0,16,2,14,4,12,9,10.7857562427174,9.31632069551342,0.383428530244635,30
"12344","SC","Cunha Porã",11118,48327.51,42002,"Chapecó",4,"Sul",0,"420470",5,18,4,14,4,14,0,0,0,0,0,18,4,14,4,14,7,10.7857562427174,9.31632069551342,0.398922001128636,31
"12345","SC","Curitibanos",39893,35989.53,42009,"Curitibanos",4,"Sul",1,"420480",2,65,14,51,28,37,1,1,0,0,1,66,15,51,28,38,31,10.4909833418047,10.5939561488903,0.317284338643307,29
"12346","SC","Curitibanos",39893,35989.53,42009,"Curitibanos",4,"Sul",1,"420480",3,53,18,35,22,31,1,1,0,0,1,54,19,35,22,32,16,10.4909833418047,10.5939561488903,0.439911978895909,31
"12347","SC","Curitibanos",39893,35989.53,42009,"Curitibanos",4,"Sul",1,"420480",4,47,14,33,21,26,1,0,1,1,0,48,14,34,22,26,23,10.4909833418047,10.5939561488903,0.449732349403661,30
"12348","SC","Curitibanos",39893,35989.53,42009,"Curitibanos",4,"Sul",1,"420480",5,57,12,45,22,35,1,1,0,0,1,58,13,45,22,36,23,10.4909833418047,10.5939561488903,0.413358702278148,31
"12349","SC","Dionísio Cerqueira",15545,25541.91,42001,"São Miguel do Oeste",4,"Sul",0,"420500",2,11,2,9,3,8,0,0,0,0,0,11,2,9,3,8,6,10.1480759114418,9.65149432249285,0.33279054220644,29
"12350","SC","Dionísio Cerqueira",15545,25541.91,42001,"São Miguel do Oeste",4,"Sul",0,"420500",3,15,5,10,4,11,2,0,2,0,2,17,5,12,4,13,15,10.1480759114418,9.65149432249285,0.409407953365874,31
"12351","SC","Dionísio Cerqueira",15545,25541.91,42001,"São Miguel do Oeste",4,"Sul",0,"420500",4,20,7,13,8,12,0,0,0,0,0,20,7,13,8,12,5,10.1480759114418,9.65149432249285,0.391725593235201,30
"12352","SC","Dionísio Cerqueira",15545,25541.91,42001,"São Miguel do Oeste",4,"Sul",0,"420500",5,20,6,14,11,9,1,1,0,0,1,21,7,14,11,10,11,10.1480759114418,9.65149432249285,0.393460067066563,31
"12353","SC","Faxinal dos Guedes",10649,41236.16,42003,"Xanxerê",4,"Sul",0,"420530",2,11,3,8,4,7,0,0,0,0,0,11,3,8,4,7,11,10.6270708203135,9.27322127001538,0.358311372435664,29
"12354","SC","Faxinal dos Guedes",10649,41236.16,42003,"Xanxerê",4,"Sul",0,"420530",3,15,3,12,4,11,0,0,0,0,0,15,3,12,4,11,5,10.6270708203135,9.27322127001538,0.468009474010589,31
"12355","SC","Faxinal dos Guedes",10649,41236.16,42003,"Xanxerê",4,"Sul",0,"420530",4,10,1,9,4,6,1,1,0,1,0,11,2,9,5,6,7,10.6270708203135,9.27322127001538,0.444002834035812,30
"12356","SC","Faxinal dos Guedes",10649,41236.16,42003,"Xanxerê",4,"Sul",0,"420530",5,11,1,10,1,10,0,0,0,0,0,11,1,10,1,10,7,10.6270708203135,9.27322127001538,0.428943607721523,31
"12357","SC","Florianópolis",508826,42719.16,42016,"Florianópolis",4,"Sul",1,"420540",2,414,56,358,83,331,1,0,1,0,1,415,56,359,83,332,202,10.6624028105194,13.1398613903314,0.299797995349823,29
"12358","SC","Florianópolis",508826,42719.16,42016,"Florianópolis",4,"Sul",1,"420540",3,440,82,358,113,327,2,1,1,0,2,442,83,359,113,329,211,10.6624028105194,13.1398613903314,0.464696964001302,31
"12359","SC","Florianópolis",508826,42719.16,42016,"Florianópolis",4,"Sul",1,"420540",4,458,78,380,112,346,5,0,5,2,3,463,78,385,114,349,223,10.6624028105194,13.1398613903314,0.527000377410957,30
"12360","SC","Florianópolis",508826,42719.16,42016,"Florianópolis",4,"Sul",1,"420540",5,478,70,408,125,353,6,0,6,2,4,484,70,414,127,357,190,10.6624028105194,13.1398613903314,0.454074354727731,31
"12361","SC","Forquilhinha",27211,32261.34,42019,"Criciúma",4,"Sul",1,"420545",2,30,6,24,10,20,0,0,0,0,0,30,6,24,10,20,7,10.3816248883243,10.2113765822964,0.308921381089143,29
"12362","SC","Forquilhinha",27211,32261.34,42019,"Criciúma",4,"Sul",1,"420545",3,39,12,27,15,24,1,0,1,0,1,40,12,28,15,25,8,10.3816248883243,10.2113765822964,0.425646661286497,31
"12363","SC","Forquilhinha",27211,32261.34,42019,"Criciúma",4,"Sul",1,"420545",4,34,11,23,10,24,1,0,1,0,1,35,11,24,10,25,4,10.3816248883243,10.2113765822964,0.428294420193188,30
"12364","SC","Forquilhinha",27211,32261.34,42019,"Criciúma",4,"Sul",1,"420545",5,40,9,31,12,28,0,0,0,0,0,40,9,31,12,28,5,10.3816248883243,10.2113765822964,0.390642339713727,31
"12365","SC","Fraiburgo",36584,25498.89,42004,"Joaçaba",4,"Sul",0,"420550",2,4,0,4,1,3,0,0,0,0,0,4,0,4,1,3,17,10.1463902007873,10.5073662653379,0.303554332796168,29
"12366","SC","Fraiburgo",36584,25498.89,42004,"Joaçaba",4,"Sul",0,"420550",3,5,1,4,1,4,0,0,0,0,0,5,1,4,1,4,26,10.1463902007873,10.5073662653379,0.429457254577258,31
"12367","SC","Fraiburgo",36584,25498.89,42004,"Joaçaba",4,"Sul",0,"420550",4,6,2,4,0,6,0,0,0,0,0,6,2,4,0,6,17,10.1463902007873,10.5073662653379,0.447272159631425,30
"12368","SC","Fraiburgo",36584,25498.89,42004,"Joaçaba",4,"Sul",0,"420550",5,2,0,2,1,1,0,0,0,0,0,2,0,2,1,1,11,10.1463902007873,10.5073662653379,0.429821885697396,31
"12369","SC","Garopaba",23579,25916.45,42018,"Tubarão",4,"Sul",1,"420570",2,23,1,22,7,16,0,0,0,0,0,23,1,22,7,16,8,10.1626331812098,10.068111764371,0.299482202001172,29
"12370","SC","Garopaba",23579,25916.45,42018,"Tubarão",4,"Sul",1,"420570",3,27,7,20,7,20,0,0,0,0,0,27,7,20,7,20,9,10.1626331812098,10.068111764371,0.464647340918647,31
"12371","SC","Garopaba",23579,25916.45,42018,"Tubarão",4,"Sul",1,"420570",4,20,2,18,5,15,0,0,0,0,0,20,2,18,5,15,11,10.1626331812098,10.068111764371,0.490430016078557,30
"12372","SC","Garopaba",23579,25916.45,42018,"Tubarão",4,"Sul",1,"420570",5,33,5,28,8,25,0,0,0,0,0,33,5,28,8,25,10,10.1626331812098,10.068111764371,0.413308209670507,31
"12373","SC","Gaspar",70793,43487.46,42012,"Blumenau",4,"Sul",1,"420590",2,58,11,47,20,38,1,1,0,0,1,59,12,47,20,39,29,10.6802278996552,11.1675154047373,0.311056374111823,29
"12374","SC","Gaspar",70793,43487.46,42012,"Blumenau",4,"Sul",1,"420590",3,77,16,61,26,51,1,0,1,0,1,78,16,62,26,52,36,10.6802278996552,11.1675154047373,0.450132838091879,31
"12375","SC","Gaspar",70793,43487.46,42012,"Blumenau",4,"Sul",1,"420590",4,76,14,62,26,50,1,0,1,0,1,77,14,63,26,51,24,10.6802278996552,11.1675154047373,0.455064993492616,30
"12376","SC","Gaspar",70793,43487.46,42012,"Blumenau",4,"Sul",1,"420590",5,81,22,59,25,56,1,1,0,1,0,82,23,59,26,56,30,10.6802278996552,11.1675154047373,0.405789227598456,31
"12377","SC","Governador Celso Ramos",14606,22084.49,42016,"Florianópolis",4,"Sul",1,"420600",2,10,2,8,3,7,0,0,0,0,0,10,2,8,3,7,8,10.0026308311672,9.58918768218006,0.31869809714682,29
"12378","SC","Governador Celso Ramos",14606,22084.49,42016,"Florianópolis",4,"Sul",1,"420600",3,13,4,9,9,4,0,0,0,0,0,13,4,9,9,4,11,10.0026308311672,9.58918768218006,0.456836077766599,31
"12379","SC","Governador Celso Ramos",14606,22084.49,42016,"Florianópolis",4,"Sul",1,"420600",4,13,3,10,6,7,0,0,0,0,0,13,3,10,6,7,7,10.0026308311672,9.58918768218006,0.483867205383007,30
"12380","SC","Governador Celso Ramos",14606,22084.49,42016,"Florianópolis",4,"Sul",1,"420600",5,12,2,10,6,6,1,0,1,1,0,13,2,11,7,6,6,10.0026308311672,9.58918768218006,0.431336516464697,31
"12381","SC","Gravatal",11577,21076.68,42018,"Tubarão",4,"Sul",1,"420620",2,13,6,7,8,5,0,0,0,0,0,13,6,7,8,5,5,9.95592249499545,9.35677565020573,0.319445176000765,29
"12382","SC","Gravatal",11577,21076.68,42018,"Tubarão",4,"Sul",1,"420620",3,10,3,7,3,7,0,0,0,0,0,10,3,7,3,7,8,9.95592249499545,9.35677565020573,0.448109187836684,31
"12383","SC","Gravatal",11577,21076.68,42018,"Tubarão",4,"Sul",1,"420620",4,15,2,13,6,9,0,0,0,0,0,15,2,13,6,9,5,9.95592249499545,9.35677565020573,0.435234292771426,30
"12384","SC","Gravatal",11577,21076.68,42018,"Tubarão",4,"Sul",1,"420620",5,11,2,9,1,10,0,0,0,0,0,11,2,9,1,10,8,9.95592249499545,9.35677565020573,0.372100791764595,31
"12385","SC","Guabiruba",24382,41994.87,42012,"Blumenau",4,"Sul",1,"420630",2,18,3,15,4,14,0,0,0,0,0,18,3,15,4,14,6,10.6453027469483,10.1016004341251,0.327617563778174,29
"12386","SC","Guabiruba",24382,41994.87,42012,"Blumenau",4,"Sul",1,"420630",3,27,3,24,8,19,0,0,0,0,0,27,3,24,8,19,12,10.6453027469483,10.1016004341251,0.454187016757199,31
"12387","SC","Guabiruba",24382,41994.87,42012,"Blumenau",4,"Sul",1,"420630",4,17,3,14,5,12,2,1,1,2,0,19,4,15,7,12,6,10.6453027469483,10.1016004341251,0.456594596361012,30
"12388","SC","Guabiruba",24382,41994.87,42012,"Blumenau",4,"Sul",1,"420630",5,7,1,6,1,6,0,0,0,0,0,7,1,6,1,6,9,10.6453027469483,10.1016004341251,0.407291790934475,31
"12389","SC","Guaramirim",45797,38693.4,42008,"Joinville",4,"Sul",1,"420650",2,40,7,33,8,32,0,0,0,0,0,40,7,33,8,32,19,10.5634243218382,10.7319738657735,0.313313885055917,29
"12390","SC","Guaramirim",45797,38693.4,42008,"Joinville",4,"Sul",1,"420650",3,50,8,42,22,28,0,0,0,0,0,50,8,42,22,28,16,10.5634243218382,10.7319738657735,0.432569767715994,31
"12391","SC","Guaramirim",45797,38693.4,42008,"Joinville",4,"Sul",1,"420650",4,43,9,34,17,26,1,0,1,1,0,44,9,35,18,26,15,10.5634243218382,10.7319738657735,0.445393576427779,30
"12392","SC","Guaramirim",45797,38693.4,42008,"Joinville",4,"Sul",1,"420650",5,63,14,49,22,41,0,0,0,0,0,63,14,49,22,41,14,10.5634243218382,10.7319738657735,0.414939932851516,31
"12393","SC","Herval d'Oeste",22714,21180.37,42004,"Joaçaba",4,"Sul",1,"420670",2,22,5,17,5,17,0,0,0,0,0,22,5,17,5,17,8,9.96083008831348,10.0307367534516,0.302514130065272,29
"12394","SC","Herval d'Oeste",22714,21180.37,42004,"Joaçaba",4,"Sul",1,"420670",3,25,7,18,11,14,0,0,0,0,0,25,7,18,11,14,8,9.96083008831348,10.0307367534516,0.413545823096091,31
"12395","SC","Herval d'Oeste",22714,21180.37,42004,"Joaçaba",4,"Sul",1,"420670",4,23,5,18,11,12,0,0,0,0,0,23,5,18,11,12,11,9.96083008831348,10.0307367534516,0.426527239783269,30
"12396","SC","Herval d'Oeste",22714,21180.37,42004,"Joaçaba",4,"Sul",1,"420670",5,25,6,19,10,15,0,0,0,0,0,25,6,19,10,15,9,9.96083008831348,10.0307367534516,0.412563663158837,31
"12397","SC","Ibirama",19096,23619.6,42011,"Rio do Sul",4,"Sul",0,"420690",2,16,6,10,6,10,0,0,0,0,0,16,6,10,6,10,16,10.0698321548069,9.85723416801867,0.307127735540166,29
"12398","SC","Ibirama",19096,23619.6,42011,"Rio do Sul",4,"Sul",0,"420690",3,26,12,14,10,16,0,0,0,0,0,26,12,14,10,16,4,10.0698321548069,9.85723416801867,0.439204056099375,31
"12399","SC","Ibirama",19096,23619.6,42011,"Rio do Sul",4,"Sul",0,"420690",4,14,6,8,7,7,0,0,0,0,0,14,6,8,7,7,8,10.0698321548069,9.85723416801867,0.434938903390411,30
"12400","SC","Ibirama",19096,23619.6,42011,"Rio do Sul",4,"Sul",0,"420690",5,18,5,13,4,14,0,0,0,0,0,18,5,13,4,14,13,10.0698321548069,9.85723416801867,0.402529795115774,31
"12401","SC","Içara",57247,42042.2,42019,"Criciúma",4,"Sul",1,"420700",2,70,18,52,21,49,0,0,0,0,0,70,18,52,21,49,28,10.6464291547349,10.9551305182967,0.312344485939252,29
"12402","SC","Içara",57247,42042.2,42019,"Criciúma",4,"Sul",1,"420700",3,63,15,48,17,46,0,0,0,0,0,63,15,48,17,46,23,10.6464291547349,10.9551305182967,0.447865646741337,31
"12403","SC","Içara",57247,42042.2,42019,"Criciúma",4,"Sul",1,"420700",4,63,17,46,14,49,0,0,0,0,0,63,17,46,14,49,21,10.6464291547349,10.9551305182967,0.456160693197428,30
"12404","SC","Içara",57247,42042.2,42019,"Criciúma",4,"Sul",1,"420700",5,60,15,45,19,41,0,0,0,0,0,60,15,45,19,41,24,10.6464291547349,10.9551305182967,0.39171673877756,31
"12405","SC","Ilhota",14359,50605.82,42013,"Itajaí",4,"Sul",1,"420710",2,13,5,8,6,7,0,0,0,0,0,13,5,8,6,7,4,10.8318218684241,9.57213220229438,0.330881631810077,29
"12406","SC","Ilhota",14359,50605.82,42013,"Itajaí",4,"Sul",1,"420710",3,17,5,12,7,10,0,0,0,0,0,17,5,12,7,10,6,10.8318218684241,9.57213220229438,0.453655926151963,31
"12407","SC","Ilhota",14359,50605.82,42013,"Itajaí",4,"Sul",1,"420710",4,17,6,11,5,12,0,0,0,0,0,17,6,11,5,12,6,10.8318218684241,9.57213220229438,0.459173077918346,30
"12408","SC","Ilhota",14359,50605.82,42013,"Itajaí",4,"Sul",1,"420710",5,9,3,6,3,6,0,0,0,0,0,9,3,6,3,6,7,10.8318218684241,9.57213220229438,0.413999976670377,31
"12409","SC","Imaruí",9948,19014.64,42018,"Tubarão",4,"Sul",0,"420720",2,9,0,9,1,8,0,0,0,0,0,9,0,9,1,8,4,9.85296448776137,9.2051268049233,0.337954176844877,29
"12410","SC","Imaruí",9948,19014.64,42018,"Tubarão",4,"Sul",0,"420720",3,7,1,6,3,4,0,0,0,0,0,7,1,6,3,4,8,9.85296448776137,9.2051268049233,0.448328947629292,31
"12411","SC","Imaruí",9948,19014.64,42018,"Tubarão",4,"Sul",0,"420720",4,7,2,5,2,5,0,0,0,0,0,7,2,5,2,5,6,9.85296448776137,9.2051268049233,0.457479265805108,30
"12412","SC","Imaruí",9948,19014.64,42018,"Tubarão",4,"Sul",0,"420720",5,4,2,2,2,2,0,0,0,0,0,4,2,2,2,2,3,9.85296448776137,9.2051268049233,0.427396018277215,31
"12413","SC","Imbituba",45286,39926.04,42018,"Tubarão",4,"Sul",1,"420730",2,45,6,39,9,36,1,1,0,1,0,46,7,39,10,36,42,10.5947840215855,10.7207532129325,0.304681058952048,29
"12414","SC","Imbituba",45286,39926.04,42018,"Tubarão",4,"Sul",1,"420730",3,52,10,42,15,37,2,1,1,1,1,54,11,43,16,38,34,10.5947840215855,10.7207532129325,0.454924057292618,31
"12415","SC","Imbituba",45286,39926.04,42018,"Tubarão",4,"Sul",1,"420730",4,30,5,25,9,21,2,0,2,1,1,32,5,27,10,22,21,10.5947840215855,10.7207532129325,0.47853519599187,30
"12416","SC","Imbituba",45286,39926.04,42018,"Tubarão",4,"Sul",1,"420730",5,55,12,43,15,40,0,0,0,0,0,55,12,43,15,40,26,10.5947840215855,10.7207532129325,0.402375344321835,31
"12417","SC","Indaial",70900,38127.84,42012,"Blumenau",4,"Sul",1,"420750",2,63,24,39,20,43,0,0,0,0,0,63,24,39,20,43,36,10.5487000029386,11.1690257125202,0.301248702293928,29
"12418","SC","Indaial",70900,38127.84,42012,"Blumenau",4,"Sul",1,"420750",3,90,19,71,35,55,0,0,0,0,0,90,19,71,35,55,27,10.5487000029386,11.1690257125202,0.43931445092179,31
"12419","SC","Indaial",70900,38127.84,42012,"Blumenau",4,"Sul",1,"420750",4,60,15,45,19,41,0,0,0,0,0,60,15,45,19,41,25,10.5487000029386,11.1690257125202,0.443416862018656,30
"12420","SC","Indaial",70900,38127.84,42012,"Blumenau",4,"Sul",1,"420750",5,73,12,61,27,46,3,0,3,3,0,76,12,64,30,46,27,10.5487000029386,11.1690257125202,0.393689774835832,31
"12421","SC","Irani",10498,23059.27,42005,"Concórdia",4,"Sul",0,"420780",2,10,1,9,3,7,0,0,0,0,0,10,1,9,3,7,6,10.0458231367738,9.25894004181225,0.307873815849689,29
"12422","SC","Irani",10498,23059.27,42005,"Concórdia",4,"Sul",0,"420780",3,11,0,11,5,6,0,0,0,0,0,11,0,11,5,6,6,10.0458231367738,9.25894004181225,0.41894471153789,31
"12423","SC","Irani",10498,23059.27,42005,"Concórdia",4,"Sul",0,"420780",4,10,1,9,2,8,0,0,0,0,0,10,1,9,2,8,7,10.0458231367738,9.25894004181225,0.424407102867152,30
"12424","SC","Irani",10498,23059.27,42005,"Concórdia",4,"Sul",0,"420780",5,6,2,4,1,5,0,0,0,0,0,6,2,4,1,5,8,10.0458231367738,9.25894004181225,0.419745137966969,31
"12425","SC","Itaiópolis",21780,34769.15,42006,"Canoinhas",4,"Sul",0,"420810",2,20,8,12,10,10,0,0,0,0,0,20,8,12,10,10,15,10.4564857783413,9.98874739648695,0.340177555608248,29
"12426","SC","Itaiópolis",21780,34769.15,42006,"Canoinhas",4,"Sul",0,"420810",3,22,7,15,9,13,1,0,1,1,0,23,7,16,10,13,13,10.4564857783413,9.98874739648695,0.435075442265134,31
"12427","SC","Itaiópolis",21780,34769.15,42006,"Canoinhas",4,"Sul",0,"420810",4,26,6,20,12,14,0,0,0,0,0,26,6,20,12,14,15,10.4564857783413,9.98874739648695,0.448303479050266,30
"12428","SC","Itaiópolis",21780,34769.15,42006,"Canoinhas",4,"Sul",0,"420810",5,33,13,20,14,19,0,0,0,0,0,33,13,20,14,19,15,10.4564857783413,9.98874739648695,0.423235816732873,31
"12429","SC","Itajaí",223112,117712,42013,"Itajaí",4,"Sul",1,"420820",2,305,59,246,101,204,3,0,3,1,2,308,59,249,102,206,115,11.675996242172,12.3154291665133,0.304248134492369,29
"12430","SC","Itajaí",223112,117712,42013,"Itajaí",4,"Sul",1,"420820",3,304,52,252,105,199,1,0,1,1,0,305,52,253,106,199,109,11.675996242172,12.3154291665133,0.437974847759868,31
"12431","SC","Itajaí",223112,117712,42013,"Itajaí",4,"Sul",1,"420820",4,249,43,206,79,170,3,2,1,0,3,252,45,207,79,173,105,11.675996242172,12.3154291665133,0.452605702020104,30
"12432","SC","Itajaí",223112,117712,42013,"Itajaí",4,"Sul",1,"420820",5,293,52,241,89,204,0,0,0,0,0,293,52,241,89,204,107,11.675996242172,12.3154291665133,0.398942924971925,31
"12433","SC","Itapema",67338,29597.1,42013,"Itajaí",4,"Sul",1,"420830",2,81,18,63,35,46,1,0,1,0,1,82,18,64,35,47,23,10.2954316625395,11.1174799922443,0.306906645083573,29
"12434","SC","Itapema",67338,29597.1,42013,"Itajaí",4,"Sul",1,"420830",3,92,22,70,34,58,0,0,0,0,0,92,22,70,34,58,28,10.2954316625395,11.1174799922443,0.46905065678078,31
"12435","SC","Itapema",67338,29597.1,42013,"Itajaí",4,"Sul",1,"420830",4,109,26,83,33,76,2,1,1,0,2,111,27,84,33,78,23,10.2954316625395,11.1174799922443,0.456830689456819,30
"12436","SC","Itapema",67338,29597.1,42013,"Itajaí",4,"Sul",1,"420830",5,86,28,58,30,56,1,0,1,0,1,87,28,59,30,57,20,10.2954316625395,11.1174799922443,0.400881146002591,31
"12437","SC","Itapiranga",17007,46220.97,42001,"São Miguel do Oeste",4,"Sul",0,"420840",2,16,4,12,5,11,0,0,0,0,0,16,4,12,5,11,4,10.741188870194,9.74138030299241,0.378426808745674,29
"12438","SC","Itapiranga",17007,46220.97,42001,"São Miguel do Oeste",4,"Sul",0,"420840",3,15,2,13,2,13,0,0,0,0,0,15,2,13,2,13,6,10.741188870194,9.74138030299241,0.458461849999593,31
"12439","SC","Itapiranga",17007,46220.97,42001,"São Miguel do Oeste",4,"Sul",0,"420840",4,13,2,11,5,8,1,0,1,1,0,14,2,12,6,8,5,10.741188870194,9.74138030299241,0.463422117467187,30
"12440","SC","Itapiranga",17007,46220.97,42001,"São Miguel do Oeste",4,"Sul",0,"420840",5,13,3,10,2,11,0,0,0,0,0,13,3,10,2,11,7,10.741188870194,9.74138030299241,0.448343112462071,31
"12441","SC","Itapoá",21177,39735.17,42008,"Joinville",4,"Sul",0,"420845",2,24,2,22,7,17,0,0,0,0,0,24,2,22,7,17,8,10.5899919687092,9.96067096606358,0.334695065756607,29
"12442","SC","Itapoá",21177,39735.17,42008,"Joinville",4,"Sul",0,"420845",3,28,10,18,10,18,0,0,0,0,0,28,10,18,10,18,9,10.5899919687092,9.96067096606358,0.447664388964959,31
"12443","SC","Itapoá",21177,39735.17,42008,"Joinville",4,"Sul",0,"420845",4,38,11,27,10,28,0,0,0,0,0,38,11,27,10,28,7,10.5899919687092,9.96067096606358,0.455366478872738,30
"12444","SC","Itapoá",21177,39735.17,42008,"Joinville",4,"Sul",0,"420845",5,22,7,15,8,14,0,0,0,0,0,22,7,15,8,14,8,10.5899919687092,9.96067096606358,0.422905224170762,31
"12445","SC","Ituporanga",25355,37632.2,42014,"Ituporanga",4,"Sul",0,"420850",2,43,11,32,18,25,0,0,0,0,0,43,11,32,18,25,13,10.53561534587,10.1407312282291,0.298237355543857,29
"12446","SC","Ituporanga",25355,37632.2,42014,"Ituporanga",4,"Sul",0,"420850",3,16,4,12,8,8,0,0,0,0,0,16,4,12,8,8,19,10.53561534587,10.1407312282291,0.39758206828045,31
"12447","SC","Ituporanga",25355,37632.2,42014,"Ituporanga",4,"Sul",0,"420850",4,29,5,24,12,17,0,0,0,0,0,29,5,24,12,17,11,10.53561534587,10.1407312282291,0.407664717084545,30
"12448","SC","Ituporanga",25355,37632.2,42014,"Ituporanga",4,"Sul",0,"420850",5,40,15,25,9,31,0,0,0,0,0,40,15,25,9,31,13,10.53561534587,10.1407312282291,0.378603491075181,31
"12449","SC","Jacinto Machado",10376,31700.91,42020,"Araranguá",4,"Sul",0,"420870",2,10,2,8,6,4,0,0,0,0,0,10,2,8,6,4,6,10.364100666078,9.24725072599628,0.283238173460207,29
"12450","SC","Jacinto Machado",10376,31700.91,42020,"Araranguá",4,"Sul",0,"420870",3,7,1,6,5,2,0,0,0,0,0,7,1,6,5,2,5,10.364100666078,9.24725072599628,0.372844143382308,31
"12451","SC","Jacinto Machado",10376,31700.91,42020,"Araranguá",4,"Sul",0,"420870",4,15,5,10,5,10,0,0,0,0,0,15,5,10,5,10,6,10.364100666078,9.24725072599628,0.375237902987142,30
"12452","SC","Jacinto Machado",10376,31700.91,42020,"Araranguá",4,"Sul",0,"420870",5,9,2,7,2,7,0,0,0,0,0,9,2,7,2,7,8,10.364100666078,9.24725072599628,0.363280227413307,31
"12453","SC","Jaguaruna",20288,23787.1,42018,"Tubarão",4,"Sul",0,"420880",2,23,4,19,5,18,0,0,0,0,0,23,4,19,5,18,12,10.0768986959086,9.91778485723695,0.319325118394708,29
"12454","SC","Jaguaruna",20288,23787.1,42018,"Tubarão",4,"Sul",0,"420880",3,19,9,10,3,16,0,0,0,0,0,19,9,10,3,16,15,10.0768986959086,9.91778485723695,0.432219991311495,31
"12455","SC","Jaguaruna",20288,23787.1,42018,"Tubarão",4,"Sul",0,"420880",4,24,7,17,8,16,0,0,0,0,0,24,7,17,8,16,5,10.0768986959086,9.91778485723695,0.4558193419409,30
"12456","SC","Jaguaruna",20288,23787.1,42018,"Tubarão",4,"Sul",0,"420880",5,29,7,22,12,17,0,0,0,0,0,29,7,22,12,17,14,10.0768986959086,9.91778485723695,0.410171794674605,31
"12457","SC","Jaraguá do Sul",181173,51652.44,42008,"Joinville",4,"Sul",1,"420890",2,162,14,148,41,121,1,0,1,0,1,163,14,149,41,122,72,10.8522927144775,12.1072076548659,0.298094889114829,29
"12458","SC","Jaraguá do Sul",181173,51652.44,42008,"Joinville",4,"Sul",1,"420890",3,182,26,156,56,126,1,0,1,0,1,183,26,157,56,127,60,10.8522927144775,12.1072076548659,0.440580817902965,31
"12459","SC","Jaraguá do Sul",181173,51652.44,42008,"Joinville",4,"Sul",1,"420890",4,198,24,174,52,146,0,0,0,0,0,198,24,174,52,146,61,10.8522927144775,12.1072076548659,0.459068346760061,30
"12460","SC","Jaraguá do Sul",181173,51652.44,42008,"Joinville",4,"Sul",1,"420890",5,193,21,172,56,137,2,0,2,0,2,195,21,174,56,139,69,10.8522927144775,12.1072076548659,0.403086575190507,31
"12461","SC","Joaçaba",30404,64675.09,42004,"Joaçaba",4,"Sul",1,"420900",2,22,4,18,5,17,0,0,0,0,0,22,4,18,5,17,12,11.0771313986265,10.3223294576859,0.309339280575728,29
"12462","SC","Joaçaba",30404,64675.09,42004,"Joaçaba",4,"Sul",1,"420900",3,34,5,29,7,27,0,0,0,0,0,34,5,29,7,27,17,11.0771313986265,10.3223294576859,0.44427696122351,31
"12463","SC","Joaçaba",30404,64675.09,42004,"Joaçaba",4,"Sul",1,"420900",4,31,4,27,10,21,0,0,0,0,0,31,4,27,10,21,11,11.0771313986265,10.3223294576859,0.458239607003389,30
"12464","SC","Joaçaba",30404,64675.09,42004,"Joaçaba",4,"Sul",1,"420900",5,32,6,26,11,21,0,0,0,0,0,32,6,26,11,21,11,11.0771313986265,10.3223294576859,0.410600419151731,31
"12465","SC","Joinville",597658,52792.59,42008,"Joinville",4,"Sul",1,"420910",2,586,103,483,187,399,2,0,2,0,2,588,103,485,187,401,248,10.8741261189366,13.3007739629774,0.300175211021156,29
"12466","SC","Joinville",597658,52792.59,42008,"Joinville",4,"Sul",1,"420910",3,618,101,517,190,428,3,0,3,2,1,621,101,520,192,429,253,10.8741261189366,13.3007739629774,0.438190010211749,31
"12467","SC","Joinville",597658,52792.59,42008,"Joinville",4,"Sul",1,"420910",4,564,99,465,167,397,1,0,1,0,1,565,99,466,167,398,217,10.8741261189366,13.3007739629774,0.462435075956702,30
"12468","SC","Joinville",597658,52792.59,42008,"Joinville",4,"Sul",1,"420910",5,647,115,532,189,458,7,1,6,3,4,654,116,538,192,462,233,10.8741261189366,13.3007739629774,0.404528532242257,31
"12469","SC","Lages",157349,32355.43,42010,"Campos de Lages",4,"Sul",1,"420930",2,171,40,131,56,115,2,0,2,0,2,173,40,133,56,117,87,10.3845371374664,11.9662215472134,0.314610317438418,29
"12470","SC","Lages",157349,32355.43,42010,"Campos de Lages",4,"Sul",1,"420930",3,191,49,142,83,108,1,1,0,0,1,192,50,142,83,109,130,10.3845371374664,11.9662215472134,0.444692319808152,31
"12471","SC","Lages",157349,32355.43,42010,"Campos de Lages",4,"Sul",1,"420930",4,173,46,127,58,115,2,1,1,2,0,175,47,128,60,115,90,10.3845371374664,11.9662215472134,0.463329084001533,30
"12472","SC","Lages",157349,32355.43,42010,"Campos de Lages",4,"Sul",1,"420930",5,192,45,147,63,129,1,0,1,1,0,193,45,148,64,129,99,10.3845371374664,11.9662215472134,0.407413409663334,31
"12473","SC","Laguna",46122,19791.19,42018,"Tubarão",4,"Sul",1,"420940",2,24,6,18,6,18,0,0,0,0,0,24,6,18,6,18,37,9.89299216816828,10.7390453385772,0.309492389217263,29
"12474","SC","Laguna",46122,19791.19,42018,"Tubarão",4,"Sul",1,"420940",3,40,10,30,17,23,1,0,1,0,1,41,10,31,17,24,35,9.89299216816828,10.7390453385772,0.454734788454733,31
"12475","SC","Laguna",46122,19791.19,42018,"Tubarão",4,"Sul",1,"420940",4,27,4,23,8,19,0,0,0,0,0,27,4,23,8,19,30,9.89299216816828,10.7390453385772,0.482325293177514,30
"12476","SC","Laguna",46122,19791.19,42018,"Tubarão",4,"Sul",1,"420940",5,44,6,38,13,31,1,1,0,0,1,45,7,38,13,32,22,9.89299216816828,10.7390453385772,0.432334018958613,31
"12477","SC","Laurentino",7063,38934.69,42011,"Rio do Sul",4,"Sul",0,"420950",2,4,1,3,1,3,0,0,0,0,0,4,1,3,1,3,3,10.5696409059915,8.86262516940892,0.300302131911658,29
"12478","SC","Laurentino",7063,38934.69,42011,"Rio do Sul",4,"Sul",0,"420950",3,6,2,4,0,6,1,0,1,0,1,7,2,5,0,7,5,10.5696409059915,8.86262516940892,0.415536291314716,31
"12479","SC","Laurentino",7063,38934.69,42011,"Rio do Sul",4,"Sul",0,"420950",4,6,1,5,0,6,0,0,0,0,0,6,1,5,0,6,5,10.5696409059915,8.86262516940892,0.396072137344496,30
"12480","SC","Laurentino",7063,38934.69,42011,"Rio do Sul",4,"Sul",0,"420950",5,11,3,8,3,8,0,0,0,0,0,11,3,8,3,8,2,10.5696409059915,8.86262516940892,0.347448668818621,31
"12481","SC","Lebon Régis",12115,20402.4,42004,"Joaçaba",4,"Sul",0,"420970",2,16,9,7,7,9,1,0,1,1,0,17,9,8,8,9,7,9.92340781997126,9.40219963325063,0.352003510462018,29
"12482","SC","Lebon Régis",12115,20402.4,42004,"Joaçaba",4,"Sul",0,"420970",3,11,6,5,6,5,0,0,0,0,0,11,6,5,6,5,8,9.92340781997126,9.40219963325063,0.437456168949614,31
"12483","SC","Lebon Régis",12115,20402.4,42004,"Joaçaba",4,"Sul",0,"420970",4,15,5,10,6,9,1,1,0,1,0,16,6,10,7,9,6,9.92340781997126,9.40219963325063,0.473956654918841,30
"12484","SC","Lebon Régis",12115,20402.4,42004,"Joaçaba",4,"Sul",0,"420970",5,29,15,14,14,15,0,0,0,0,0,29,15,14,14,15,8,9.92340781997126,9.40219963325063,0.450777618007032,31
"12485","SC","Lontras",12315,26977.89,42011,"Rio do Sul",4,"Sul",1,"420990",2,9,3,6,2,7,0,0,0,0,0,9,3,6,2,7,6,10.2027729206249,9.41857331055464,0.282632735186495,29
"12486","SC","Lontras",12315,26977.89,42011,"Rio do Sul",4,"Sul",1,"420990",3,9,3,6,3,6,1,0,1,0,1,10,3,7,3,7,4,10.2027729206249,9.41857331055464,0.413138817652032,31
"12487","SC","Lontras",12315,26977.89,42011,"Rio do Sul",4,"Sul",1,"420990",4,11,2,9,2,9,0,0,0,0,0,11,2,9,2,9,6,10.2027729206249,9.41857331055464,0.399253799563686,30
"12488","SC","Lontras",12315,26977.89,42011,"Rio do Sul",4,"Sul",1,"420990",5,12,3,9,6,6,0,0,0,0,0,12,3,9,6,6,9,10.2027729206249,9.41857331055464,0.362389771490587,31
"12489","SC","Luiz Alves",13107,46083.39,42012,"Blumenau",4,"Sul",0,"421000",2,13,3,10,5,8,0,0,0,0,0,13,3,10,5,8,2,10.7382078603721,9.48090171761955,0.311274574376639,29
"12490","SC","Luiz Alves",13107,46083.39,42012,"Blumenau",4,"Sul",0,"421000",3,13,3,10,8,5,0,0,0,0,0,13,3,10,8,5,3,10.7382078603721,9.48090171761955,0.437355657859505,31
"12491","SC","Luiz Alves",13107,46083.39,42012,"Blumenau",4,"Sul",0,"421000",4,15,4,11,7,8,1,0,1,0,1,16,4,12,7,9,4,10.7382078603721,9.48090171761955,0.45107362616161,30
"12492","SC","Luiz Alves",13107,46083.39,42012,"Blumenau",4,"Sul",0,"421000",5,22,7,15,8,14,0,0,0,0,0,22,7,15,8,14,11,10.7382078603721,9.48090171761955,0.423776127169705,31
"12493","SC","Luzerna",5684,30042.54,42004,"Joaçaba",4,"Sul",1,"421003",2,2,1,1,1,1,0,0,0,0,0,2,1,1,1,1,4,10.3103696562317,8.64541048921699,0.327173303311231,29
"12494","SC","Luzerna",5684,30042.54,42004,"Joaçaba",4,"Sul",1,"421003",3,6,0,6,2,4,0,0,0,0,0,6,0,6,2,4,3,10.3103696562317,8.64541048921699,0.424801974763016,31
"12495","SC","Luzerna",5684,30042.54,42004,"Joaçaba",4,"Sul",1,"421003",4,3,0,3,0,3,0,0,0,0,0,3,0,3,0,3,2,10.3103696562317,8.64541048921699,0.421518242420915,30
"12496","SC","Luzerna",5684,30042.54,42004,"Joaçaba",4,"Sul",1,"421003",5,5,0,5,1,4,0,0,0,0,0,5,0,5,1,4,3,10.3103696562317,8.64541048921699,0.378173624933767,31
"12497","SC","Mafra",56561,34993.36,42006,"Canoinhas",4,"Sul",1,"421010",2,59,16,43,19,40,1,0,1,0,1,60,16,44,19,41,28,10.4629136081878,10.9430749807536,0.309734657239248,29
"12498","SC","Mafra",56561,34993.36,42006,"Canoinhas",4,"Sul",1,"421010",3,51,14,37,18,33,0,0,0,0,0,51,14,37,18,33,25,10.4629136081878,10.9430749807536,0.425010814608554,31
"12499","SC","Mafra",56561,34993.36,42006,"Canoinhas",4,"Sul",1,"421010",4,59,16,43,16,43,0,0,0,0,0,59,16,43,16,43,32,10.4629136081878,10.9430749807536,0.446495721911041,30
"12500","SC","Mafra",56561,34993.36,42006,"Canoinhas",4,"Sul",1,"421010",5,65,13,52,25,40,0,0,0,0,0,65,13,52,25,40,27,10.4629136081878,10.9430749807536,0.409837723089232,31
"12501","SC","Maracajá",7378,27385.36,42020,"Araranguá",4,"Sul",0,"421040",2,10,2,8,6,4,0,0,0,0,0,10,2,8,6,4,1,10.2177638430142,8.90625787815662,0.281079195717309,29
"12502","SC","Maracajá",7378,27385.36,42020,"Araranguá",4,"Sul",0,"421040",3,7,2,5,2,5,0,0,0,0,0,7,2,5,2,5,2,10.2177638430142,8.90625787815662,0.403897779793824,31
"12503","SC","Maracajá",7378,27385.36,42020,"Araranguá",4,"Sul",0,"421040",4,5,0,5,3,2,0,0,0,0,0,5,0,5,3,2,6,10.2177638430142,8.90625787815662,0.415337288718504,30
"12504","SC","Maracajá",7378,27385.36,42020,"Araranguá",4,"Sul",0,"421040",5,9,2,7,5,4,0,0,0,0,0,9,2,7,5,4,2,10.2177638430142,8.90625787815662,0.379164632132154,31
"12505","SC","Maravilha",26116,50727.8,42002,"Chapecó",4,"Sul",1,"421050",2,32,6,26,13,19,0,0,0,0,0,32,6,26,13,19,9,10.8342293627763,10.1703034323065,0.312913714165309,29
"12506","SC","Maravilha",26116,50727.8,42002,"Chapecó",4,"Sul",1,"421050",3,25,1,24,6,19,0,0,0,0,0,25,1,24,6,19,16,10.8342293627763,10.1703034323065,0.417164966028604,31
"12507","SC","Maravilha",26116,50727.8,42002,"Chapecó",4,"Sul",1,"421050",4,31,2,29,11,20,1,1,0,1,0,32,3,29,12,20,12,10.8342293627763,10.1703034323065,0.422145496729461,30
"12508","SC","Maravilha",26116,50727.8,42002,"Chapecó",4,"Sul",1,"421050",5,28,5,23,10,18,0,0,0,0,0,28,5,23,10,18,11,10.8342293627763,10.1703034323065,0.406456935373129,31
"12509","SC","Massaranduba",17125,32809.4,42008,"Joinville",4,"Sul",0,"421060",2,15,5,10,1,14,0,0,0,0,0,15,5,10,1,14,17,10.3984703386803,9.74829466313043,0.332045126935358,29
"12510","SC","Massaranduba",17125,32809.4,42008,"Joinville",4,"Sul",0,"421060",3,12,4,8,7,5,0,0,0,0,0,12,4,8,7,5,16,10.3984703386803,9.74829466313043,0.465947346160775,31
"12511","SC","Massaranduba",17125,32809.4,42008,"Joinville",4,"Sul",0,"421060",4,18,3,15,2,16,0,0,0,0,0,18,3,15,2,16,14,10.3984703386803,9.74829466313043,0.471359879713455,30
"12512","SC","Massaranduba",17125,32809.4,42008,"Joinville",4,"Sul",0,"421060",5,21,7,14,4,17,1,0,1,0,1,22,7,15,4,18,7,10.3984703386803,9.74829466313043,0.42618317022166,31
"12513","SC","Meleiro",7001,34105.74,42020,"Araranguá",4,"Sul",0,"421080",2,7,0,7,2,5,0,0,0,0,0,7,0,7,2,5,4,10.4372209775517,8.8538082749772,0.295981286554088,29
"12514","SC","Meleiro",7001,34105.74,42020,"Araranguá",4,"Sul",0,"421080",3,4,0,4,2,2,0,0,0,0,0,4,0,4,2,2,1,10.4372209775517,8.8538082749772,0.392002216340618,31
"12515","SC","Meleiro",7001,34105.74,42020,"Araranguá",4,"Sul",0,"421080",4,4,1,3,0,4,0,0,0,0,0,4,1,3,0,4,3,10.4372209775517,8.8538082749772,0.414611302531083,30
"12516","SC","Meleiro",7001,34105.74,42020,"Araranguá",4,"Sul",0,"421080",5,6,1,5,1,5,0,0,0,0,0,6,1,5,1,5,4,10.4372209775517,8.8538082749772,0.363161209920224,31
"12517","SC","Monte Carlo",9906,16172.78,42009,"Curitibanos",4,"Sul",0,"421105",2,14,6,8,8,6,0,0,0,0,0,14,6,8,8,6,5,9.69108486110881,9.20089591314818,0.302179147673592,29
"12518","SC","Monte Carlo",9906,16172.78,42009,"Curitibanos",4,"Sul",0,"421105",3,17,9,8,8,9,0,0,0,0,0,17,9,8,8,9,6,9.69108486110881,9.20089591314818,0.402467165359554,31
"12519","SC","Monte Carlo",9906,16172.78,42009,"Curitibanos",4,"Sul",0,"421105",4,15,4,11,8,7,0,0,0,0,0,15,4,11,8,7,8,9.69108486110881,9.20089591314818,0.42096747766255,30
"12520","SC","Monte Carlo",9906,16172.78,42009,"Curitibanos",4,"Sul",0,"421105",5,14,9,5,7,7,0,0,0,0,0,14,9,5,7,7,6,9.69108486110881,9.20089591314818,0.41366022680225,31
"12521","SC","Morro da Fumaça",17947,36437.43,42019,"Criciúma",4,"Sul",1,"421120",2,23,4,19,7,16,0,0,0,0,0,23,4,19,7,16,12,10.5033518219932,9.79517824902928,0.293577121591766,29
"12522","SC","Morro da Fumaça",17947,36437.43,42019,"Criciúma",4,"Sul",1,"421120",3,14,6,8,8,6,0,0,0,0,0,14,6,8,8,6,7,10.5033518219932,9.79517824902928,0.416896064996329,31
"12523","SC","Morro da Fumaça",17947,36437.43,42019,"Criciúma",4,"Sul",1,"421120",4,17,7,10,3,14,0,0,0,0,0,17,7,10,3,14,7,10.5033518219932,9.79517824902928,0.416394127117493,30
"12524","SC","Morro da Fumaça",17947,36437.43,42019,"Criciúma",4,"Sul",1,"421120",5,23,8,15,7,16,0,0,0,0,0,23,8,15,7,16,9,10.5033518219932,9.79517824902928,0.387840669679182,31
"12525","SC","Navegantes",83626,48187.98,42013,"Itajaí",4,"Sul",1,"421130",2,112,44,68,50,62,1,1,0,0,1,113,45,68,50,63,35,10.7828648913456,11.3341097555055,0.326748287421022,29
"12526","SC","Navegantes",83626,48187.98,42013,"Itajaí",4,"Sul",1,"421130",3,94,13,81,31,63,1,1,0,0,1,95,14,81,31,64,32,10.7828648913456,11.3341097555055,0.456898262158439,31
"12527","SC","Navegantes",83626,48187.98,42013,"Itajaí",4,"Sul",1,"421130",4,45,12,33,16,29,4,1,3,1,3,49,13,36,17,32,38,10.7828648913456,11.3341097555055,0.470147495217764,30
"12528","SC","Navegantes",83626,48187.98,42013,"Itajaí",4,"Sul",1,"421130",5,28,1,27,7,21,1,0,1,1,0,29,1,28,8,21,45,10.7828648913456,11.3341097555055,0.433460237173547,31
"12529","SC","Nova Veneza",15342,48411.29,42019,"Criciúma",4,"Sul",1,"421160",2,9,3,6,1,8,0,0,0,0,0,9,3,6,1,8,3,10.7874883299656,9.63834944451924,0.29942661981862,29
"12530","SC","Nova Veneza",15342,48411.29,42019,"Criciúma",4,"Sul",1,"421160",3,12,1,11,1,11,0,0,0,0,0,12,1,11,1,11,5,10.7874883299656,9.63834944451924,0.438313705142217,31
"12531","SC","Nova Veneza",15342,48411.29,42019,"Criciúma",4,"Sul",1,"421160",4,12,3,9,6,6,0,0,0,0,0,12,3,9,6,6,5,10.7874883299656,9.63834944451924,0.445205618942548,30
"12532","SC","Nova Veneza",15342,48411.29,42019,"Criciúma",4,"Sul",1,"421160",5,17,1,16,5,12,0,0,0,0,0,17,1,16,5,12,6,10.7874883299656,9.63834944451924,0.385724810844994,31
"12533","SC","Orleans",23038,39817.94,42018,"Tubarão",4,"Sul",0,"421170",2,18,3,15,9,9,0,0,0,0,0,18,3,15,9,9,5,10.5920728434824,10.0449003054865,0.327077186554101,29
"12534","SC","Orleans",23038,39817.94,42018,"Tubarão",4,"Sul",0,"421170",3,34,6,28,7,27,0,0,0,0,0,34,6,28,7,27,8,10.5920728434824,10.0449003054865,0.420018653085203,31
"12535","SC","Orleans",23038,39817.94,42018,"Tubarão",4,"Sul",0,"421170",4,22,4,18,6,16,0,0,0,0,0,22,4,18,6,16,16,10.5920728434824,10.0449003054865,0.432979251177725,30
"12536","SC","Orleans",23038,39817.94,42018,"Tubarão",4,"Sul",0,"421170",5,25,11,14,8,17,1,0,1,1,0,26,11,15,9,17,9,10.5920728434824,10.0449003054865,0.393904754304575,31
"12537","SC","Otacílio Costa",18975,40840.77,42010,"Campos de Lages",4,"Sul",1,"421175",2,18,4,14,14,4,0,0,0,0,0,18,4,14,14,4,9,10.6174361261655,9.85087760226383,0.325777089397917,29
"12538","SC","Otacílio Costa",18975,40840.77,42010,"Campos de Lages",4,"Sul",1,"421175",3,19,7,12,5,14,1,1,0,1,0,20,8,12,6,14,6,10.6174361261655,9.85087760226383,0.410480315448678,31
"12539","SC","Otacílio Costa",18975,40840.77,42010,"Campos de Lages",4,"Sul",1,"421175",4,17,2,15,7,10,0,0,0,0,0,17,2,15,7,10,6,10.6174361261655,9.85087760226383,0.424432436347694,30
"12540","SC","Otacílio Costa",18975,40840.77,42010,"Campos de Lages",4,"Sul",1,"421175",5,20,7,13,8,12,0,0,0,0,0,20,7,13,8,12,11,10.6174361261655,9.85087760226383,0.39739317400754,31
"12541","SC","Palhoça",175272,32626.34,42016,"Florianópolis",4,"Sul",1,"421190",2,201,35,166,52,149,2,2,0,1,1,203,37,166,53,150,57,10.3928752165785,12.0740943319681,0.294889100649912,29
"12542","SC","Palhoça",175272,32626.34,42016,"Florianópolis",4,"Sul",1,"421190",3,200,35,165,71,129,1,0,1,0,1,201,35,166,71,130,83,10.3928752165785,12.0740943319681,0.439358421476088,31
"12543","SC","Palhoça",175272,32626.34,42016,"Florianópolis",4,"Sul",1,"421190",4,200,41,159,64,136,1,0,1,0,1,201,41,160,64,137,64,10.3928752165785,12.0740943319681,0.458702078699148,30
"12544","SC","Palhoça",175272,32626.34,42016,"Florianópolis",4,"Sul",1,"421190",5,249,59,190,77,172,0,0,0,0,0,249,59,190,77,172,62,10.3928752165785,12.0740943319681,0.397168249356783,31
"12545","SC","Palma Sola",7372,30088.69,42001,"São Miguel do Oeste",4,"Sul",0,"421200",2,10,4,6,3,7,0,0,0,0,0,10,4,6,3,7,4,10.3119046326179,8.90544431878971,0.365763547605245,29
"12546","SC","Palma Sola",7372,30088.69,42001,"São Miguel do Oeste",4,"Sul",0,"421200",3,10,0,10,4,6,0,0,0,0,0,10,0,10,4,6,8,10.3119046326179,8.90544431878971,0.422829194251023,31
"12547","SC","Palma Sola",7372,30088.69,42001,"São Miguel do Oeste",4,"Sul",0,"421200",4,9,1,8,4,5,0,0,0,0,0,9,1,8,4,5,2,10.3119046326179,8.90544431878971,0.449409677497232,30
"12548","SC","Palma Sola",7372,30088.69,42001,"São Miguel do Oeste",4,"Sul",0,"421200",5,8,4,4,5,3,0,0,0,0,0,8,4,4,5,3,1,10.3119046326179,8.90544431878971,0.443892595595113,31
"12549","SC","Palmitos",16157,38378.79,42002,"Chapecó",4,"Sul",0,"421210",2,15,3,12,6,9,0,0,0,0,0,15,3,12,6,9,11,10.5552602422278,9.69010867127683,0.326357950784308,29
"12550","SC","Palmitos",16157,38378.79,42002,"Chapecó",4,"Sul",0,"421210",3,8,4,4,1,7,0,0,0,0,0,8,4,4,1,7,12,10.5552602422278,9.69010867127683,0.404762273411801,31
"12551","SC","Palmitos",16157,38378.79,42002,"Chapecó",4,"Sul",0,"421210",4,8,1,7,2,6,0,0,0,0,0,8,1,7,2,6,8,10.5552602422278,9.69010867127683,0.406283689164762,30
"12552","SC","Palmitos",16157,38378.79,42002,"Chapecó",4,"Sul",0,"421210",5,18,0,18,4,14,0,0,0,0,0,18,0,18,4,14,11,10.5552602422278,9.69010867127683,0.424233471255137,31
"12553","SC","Papanduva",19422,31184.55,42006,"Canoinhas",4,"Sul",0,"421220",2,25,3,22,12,13,0,0,0,0,0,25,3,22,12,13,14,10.3476780588417,9.8741617231543,0.30020839728723,29
"12554","SC","Papanduva",19422,31184.55,42006,"Canoinhas",4,"Sul",0,"421220",3,26,13,13,15,11,0,0,0,0,0,26,13,13,15,11,7,10.3476780588417,9.8741617231543,0.413150342299556,31
"12555","SC","Papanduva",19422,31184.55,42006,"Canoinhas",4,"Sul",0,"421220",4,22,6,16,5,17,0,0,0,0,0,22,6,16,5,17,11,10.3476780588417,9.8741617231543,0.393528047378506,30
"12556","SC","Papanduva",19422,31184.55,42006,"Canoinhas",4,"Sul",0,"421220",5,28,10,18,13,15,0,0,0,0,0,28,10,18,13,15,18,10.3476780588417,9.8741617231543,0.394258498429454,31
"12557","SC","Passo de Torres",9048,19144.41,42020,"Araranguá",4,"Sul",1,"421225",2,5,1,4,1,4,0,0,0,0,0,5,1,4,1,4,3,9.85976604599072,9.11029901779596,0.318953418185178,29
"12558","SC","Passo de Torres",9048,19144.41,42020,"Araranguá",4,"Sul",1,"421225",3,3,1,2,0,3,0,0,0,0,0,3,1,2,0,3,6,9.85976604599072,9.11029901779596,0.468226035175488,31
"12559","SC","Passo de Torres",9048,19144.41,42020,"Araranguá",4,"Sul",1,"421225",4,18,4,14,4,14,0,0,0,0,0,18,4,14,4,14,2,9.85976604599072,9.11029901779596,0.474487124944678,30
"12560","SC","Passo de Torres",9048,19144.41,42020,"Araranguá",4,"Sul",1,"421225",5,9,0,9,2,7,0,0,0,0,0,9,0,9,2,7,3,9.85976604599072,9.11029901779596,0.434888324669564,31
"12561","SC","Paulo Lopes",7569,25654.38,42016,"Florianópolis",4,"Sul",1,"421230",2,9,1,8,3,6,0,0,0,0,0,9,1,8,3,6,2,10.152469596255,8.93181623730917,0.315215186983308,29
"12562","SC","Paulo Lopes",7569,25654.38,42016,"Florianópolis",4,"Sul",1,"421230",3,10,6,4,4,6,0,0,0,0,0,10,6,4,4,6,5,10.152469596255,8.93181623730917,0.46168261974295,31
"12563","SC","Paulo Lopes",7569,25654.38,42016,"Florianópolis",4,"Sul",1,"421230",4,11,2,9,4,7,1,0,1,1,0,12,2,10,5,7,3,10.152469596255,8.93181623730917,0.450681763036731,30
"12564","SC","Paulo Lopes",7569,25654.38,42016,"Florianópolis",4,"Sul",1,"421230",5,9,4,5,2,7,0,0,0,0,0,9,4,5,2,7,2,10.152469596255,8.93181623730917,0.402994948537289,31
"12565","SC","Penha",33284,23419.45,42013,"Itajaí",4,"Sul",1,"421250",2,30,6,24,12,18,3,0,3,0,3,33,6,27,12,21,15,10.0613221526744,10.4128320800203,0.310178986756467,29
"12566","SC","Penha",33284,23419.45,42013,"Itajaí",4,"Sul",1,"421250",3,22,4,18,6,16,0,0,0,0,0,22,4,18,6,16,19,10.0613221526744,10.4128320800203,0.453283456270189,31
"12567","SC","Penha",33284,23419.45,42013,"Itajaí",4,"Sul",1,"421250",4,24,6,18,6,18,0,0,0,0,0,24,6,18,6,18,14,10.0613221526744,10.4128320800203,0.475440353689331,30
"12568","SC","Penha",33284,23419.45,42013,"Itajaí",4,"Sul",1,"421250",5,27,4,23,12,15,0,0,0,0,0,27,4,23,12,15,18,10.0613221526744,10.4128320800203,0.425201068492773,31
"12569","SC","Balneário Piçarras",23772,41741.3,42013,"Itajaí",4,"Sul",1,"421280",2,29,9,20,12,17,0,0,0,0,0,29,9,20,12,17,13,10.6392463253307,10.0762636964866,0.303363192543022,29
"12570","SC","Balneário Piçarras",23772,41741.3,42013,"Itajaí",4,"Sul",1,"421280",3,28,3,25,6,22,0,0,0,0,0,28,3,25,6,22,12,10.6392463253307,10.0762636964866,0.435414119446689,31
"12571","SC","Balneário Piçarras",23772,41741.3,42013,"Itajaí",4,"Sul",1,"421280",4,21,6,15,8,13,1,0,1,1,0,22,6,16,9,13,11,10.6392463253307,10.0762636964866,0.455241298986381,30
"12572","SC","Balneário Piçarras",23772,41741.3,42013,"Itajaí",4,"Sul",1,"421280",5,36,7,29,9,27,1,0,1,0,1,37,7,30,9,28,12,10.6392463253307,10.0762636964866,0.401845461976887,31
"12573","SC","Pinhalzinho",20712,56398.18,42002,"Chapecó",4,"Sul",1,"421290",2,18,3,15,5,13,0,0,0,0,0,18,3,15,5,13,6,10.9401921674619,9.93846852143137,0.301944780930145,29
"12574","SC","Pinhalzinho",20712,56398.18,42002,"Chapecó",4,"Sul",1,"421290",3,28,6,22,10,18,0,0,0,0,0,28,6,22,10,18,2,10.9401921674619,9.93846852143137,0.414490584350589,31
"12575","SC","Pinhalzinho",20712,56398.18,42002,"Chapecó",4,"Sul",1,"421290",4,19,6,13,3,16,2,0,2,0,2,21,6,15,3,18,7,10.9401921674619,9.93846852143137,0.421268986427318,30
"12576","SC","Pinhalzinho",20712,56398.18,42002,"Chapecó",4,"Sul",1,"421290",5,28,7,21,8,20,0,0,0,0,0,28,7,21,8,20,13,10.9401921674619,9.93846852143137,0.397830506432812,31
"12577","SC","Pomerode",34010,61648,42012,"Blumenau",4,"Sul",0,"421320",2,21,7,14,7,14,0,0,0,0,0,21,7,14,7,14,20,11.0291960668659,10.4344098780012,0.308282268002684,29
"12578","SC","Pomerode",34010,61648,42012,"Blumenau",4,"Sul",0,"421320",3,35,5,30,9,26,1,1,0,0,1,36,6,30,9,27,22,11.0291960668659,10.4344098780012,0.439200272548988,31
"12579","SC","Pomerode",34010,61648,42012,"Blumenau",4,"Sul",0,"421320",4,39,10,29,14,25,0,0,0,0,0,39,10,29,14,25,16,11.0291960668659,10.4344098780012,0.467701009093441,30
"12580","SC","Pomerode",34010,61648,42012,"Blumenau",4,"Sul",0,"421320",5,21,1,20,4,17,0,0,0,0,0,21,1,20,4,17,15,11.0291960668659,10.4344098780012,0.409311250927361,31
"12581","SC","Ponte Serrada",11634,19642.03,42003,"Xanxerê",4,"Sul",0,"421340",2,9,3,6,6,3,0,0,0,0,0,9,3,6,6,3,4,9.88542693705593,9.36168712447071,0.330392410328573,29
"12582","SC","Ponte Serrada",11634,19642.03,42003,"Xanxerê",4,"Sul",0,"421340",3,13,4,9,5,8,0,0,0,0,0,13,4,9,5,8,8,9.88542693705593,9.36168712447071,0.420234689557943,31
"12583","SC","Ponte Serrada",11634,19642.03,42003,"Xanxerê",4,"Sul",0,"421340",4,11,6,5,4,7,0,0,0,0,0,11,6,5,4,7,3,9.88542693705593,9.36168712447071,0.393947160197796,30
"12584","SC","Ponte Serrada",11634,19642.03,42003,"Xanxerê",4,"Sul",0,"421340",5,11,2,9,5,6,0,0,0,0,0,11,2,9,5,6,10,9.88542693705593,9.36168712447071,0.410908555775754,31
"12585","SC","Porto Belo",21932,56537.87,42013,"Itajaí",4,"Sul",1,"421350",2,21,3,18,8,13,0,0,0,0,0,21,3,18,8,13,14,10.9426659580937,9.99570203652394,0.31049276348038,29
"12586","SC","Porto Belo",21932,56537.87,42013,"Itajaí",4,"Sul",1,"421350",3,34,6,28,13,21,1,1,0,0,1,35,7,28,13,22,15,10.9426659580937,9.99570203652394,0.467940621233015,31
"12587","SC","Porto Belo",21932,56537.87,42013,"Itajaí",4,"Sul",1,"421350",4,30,5,25,14,16,1,0,1,0,1,31,5,26,14,17,11,10.9426659580937,9.99570203652394,0.466355794278321,30
"12588","SC","Porto Belo",21932,56537.87,42013,"Itajaí",4,"Sul",1,"421350",5,14,1,13,7,7,0,0,0,0,0,14,1,13,7,7,16,10.9426659580937,9.99570203652394,0.410261084048173,31
"12589","SC","Porto União",35543,21427.35,42006,"Canoinhas",4,"Sul",1,"421360",2,21,4,17,7,14,0,0,0,0,0,21,4,17,7,14,19,9.97242342239852,10.4784985100764,0.336694463927924,29
"12590","SC","Porto União",35543,21427.35,42006,"Canoinhas",4,"Sul",1,"421360",3,26,5,21,9,17,1,0,1,0,1,27,5,22,9,18,15,9.97242342239852,10.4784985100764,0.431092987792515,31
"12591","SC","Porto União",35543,21427.35,42006,"Canoinhas",4,"Sul",1,"421360",4,26,8,18,16,10,1,0,1,0,1,27,8,19,16,11,19,9.97242342239852,10.4784985100764,0.456923930364159,30
"12592","SC","Porto União",35543,21427.35,42006,"Canoinhas",4,"Sul",1,"421360",5,19,6,13,12,7,1,0,1,0,1,20,6,14,12,8,18,9.97242342239852,10.4784985100764,0.419728321420878,31
"12593","SC","Pouso Redondo",17712,28157.09,42011,"Rio do Sul",4,"Sul",0,"421370",2,16,8,8,11,5,0,0,0,0,0,16,8,8,11,5,6,10.2455544668641,9.78199765494842,0.292167686241116,29
"12594","SC","Pouso Redondo",17712,28157.09,42011,"Rio do Sul",4,"Sul",0,"421370",3,17,4,13,7,10,0,0,0,0,0,17,4,13,7,10,8,10.2455544668641,9.78199765494842,0.389971139168204,31
"12595","SC","Pouso Redondo",17712,28157.09,42011,"Rio do Sul",4,"Sul",0,"421370",4,17,8,9,5,12,1,0,1,0,1,18,8,10,5,13,9,10.2455544668641,9.78199765494842,0.381684114938097,30
"12596","SC","Pouso Redondo",17712,28157.09,42011,"Rio do Sul",4,"Sul",0,"421370",5,21,7,14,11,10,0,0,0,0,0,21,7,14,11,10,9,10.2455544668641,9.78199765494842,0.351440309906716,31
"12597","SC","Praia Grande",7312,21879.04,42020,"Araranguá",4,"Sul",0,"421380",2,5,1,4,3,2,0,0,0,0,0,5,1,4,3,2,5,9.99328437988779,8.89727211313399,0.323458856761138,29
"12598","SC","Praia Grande",7312,21879.04,42020,"Araranguá",4,"Sul",0,"421380",3,8,3,5,2,6,0,0,0,0,0,8,3,5,2,6,6,9.99328437988779,8.89727211313399,0.460119829664315,31
"12599","SC","Praia Grande",7312,21879.04,42020,"Araranguá",4,"Sul",0,"421380",4,10,3,7,3,7,0,0,0,0,0,10,3,7,3,7,3,9.99328437988779,8.89727211313399,0.432479270633092,30
"12600","SC","Praia Grande",7312,21879.04,42020,"Araranguá",4,"Sul",0,"421380",5,11,2,9,1,10,0,0,0,0,0,11,2,9,1,10,2,9.99328437988779,8.89727211313399,0.425017276092099,31
"12601","SC","Presidente Getúlio",17726,41362.31,42011,"Rio do Sul",4,"Sul",0,"421400",2,24,6,18,9,15,0,0,0,0,0,24,6,18,9,15,4,10.6301253586865,9.78278776729834,0.307897014046389,29
"12602","SC","Presidente Getúlio",17726,41362.31,42011,"Rio do Sul",4,"Sul",0,"421400",3,25,5,20,8,17,0,0,0,0,0,25,5,20,8,17,11,10.6301253586865,9.78278776729834,0.420984992184964,31
"12603","SC","Presidente Getúlio",17726,41362.31,42011,"Rio do Sul",4,"Sul",0,"421400",4,23,8,15,7,16,0,0,0,0,0,23,8,15,7,16,8,10.6301253586865,9.78278776729834,0.416447553938084,30
"12604","SC","Presidente Getúlio",17726,41362.31,42011,"Rio do Sul",4,"Sul",0,"421400",5,20,5,15,6,14,0,0,0,0,0,20,5,15,6,14,9,10.6301253586865,9.78278776729834,0.383254255428535,31
"12605","SC","Quilombo",9829,35457.41,42002,"Chapecó",4,"Sul",0,"421420",2,10,3,7,3,7,0,0,0,0,0,10,3,7,3,7,5,10.4760875369155,9.19309247856663,0.319425130807328,29
"12606","SC","Quilombo",9829,35457.41,42002,"Chapecó",4,"Sul",0,"421420",3,10,2,8,3,7,0,0,0,0,0,10,2,8,3,7,4,10.4760875369155,9.19309247856663,0.372636448967119,31
"12607","SC","Quilombo",9829,35457.41,42002,"Chapecó",4,"Sul",0,"421420",4,13,2,11,5,8,0,0,0,0,0,13,2,11,5,8,3,10.4760875369155,9.19309247856663,0.421338870793797,30
"12608","SC","Quilombo",9829,35457.41,42002,"Chapecó",4,"Sul",0,"421420",5,9,0,9,0,9,0,0,0,0,0,9,0,9,0,9,2,10.4760875369155,9.19309247856663,0.42677810185892,31
"12609","SC","Rio dos Cedros",11808,28748.91,42012,"Blumenau",4,"Sul",0,"421470",2,2,0,2,0,2,0,0,0,0,0,2,0,2,0,2,3,10.2663551324633,9.37653254684025,0.356559298885972,29
"12610","SC","Rio dos Cedros",11808,28748.91,42012,"Blumenau",4,"Sul",0,"421470",3,1,0,1,0,1,0,0,0,0,0,1,0,1,0,1,3,10.2663551324633,9.37653254684025,0.460519577542617,31
"12611","SC","Rio dos Cedros",11808,28748.91,42012,"Blumenau",4,"Sul",0,"421470",4,0,0,0,0,0,0,0,0,0,0,0,0,0,0,0,11,10.2663551324633,9.37653254684025,0.473789385009934,30
"12612","SC","Rio dos Cedros",11808,28748.91,42012,"Blumenau",4,"Sul",0,"421470",5,1,0,1,0,1,0,0,0,0,0,1,0,1,0,1,5,10.2663551324633,9.37653254684025,0.441189955446561,31
"12613","SC","Rio do Sul",72006,38796.66,42011,"Rio do Sul",4,"Sul",1,"421480",2,63,14,49,24,39,0,0,0,0,0,63,14,49,24,39,31,10.5660894394318,11.1845047278595,0.292461015510513,29
"12614","SC","Rio do Sul",72006,38796.66,42011,"Rio do Sul",4,"Sul",1,"421480",3,66,10,56,22,44,0,0,0,0,0,66,10,56,22,44,27,10.5660894394318,11.1845047278595,0.431162372698961,31
"12615","SC","Rio do Sul",72006,38796.66,42011,"Rio do Sul",4,"Sul",1,"421480",4,66,11,55,24,42,2,0,2,0,2,68,11,57,24,44,30,10.5660894394318,11.1845047278595,0.441401251786697,30
"12616","SC","Rio do Sul",72006,38796.66,42011,"Rio do Sul",4,"Sul",1,"421480",5,78,16,62,19,59,0,0,0,0,0,78,16,62,19,59,32,10.5660894394318,11.1845047278595,0.398276124017317,31
"12617","SC","Rio Negrinho",42495,27502.3,42007,"São Bento do Sul",4,"Sul",1,"421500",2,42,16,26,13,29,0,0,0,0,0,42,16,26,13,29,21,10.222024916521,10.6571417009327,0.32217540355336,29
"12618","SC","Rio Negrinho",42495,27502.3,42007,"São Bento do Sul",4,"Sul",1,"421500",3,39,9,30,12,27,0,0,0,0,0,39,9,30,12,27,17,10.222024916521,10.6571417009327,0.432104903214511,31
"12619","SC","Rio Negrinho",42495,27502.3,42007,"São Bento do Sul",4,"Sul",1,"421500",4,55,18,37,20,35,0,0,0,0,0,55,18,37,20,35,21,10.222024916521,10.6571417009327,0.451773861221772,30
"12620","SC","Rio Negrinho",42495,27502.3,42007,"São Bento do Sul",4,"Sul",1,"421500",5,55,10,45,23,32,0,0,0,0,0,55,10,45,23,32,14,10.222024916521,10.6571417009327,0.410327575197281,31
"12621","SC","Rodeio",11600,24814.2,42012,"Blumenau",4,"Sul",0,"421510",2,8,3,5,2,6,0,0,0,0,0,8,3,5,2,6,7,10.1191713489365,9.35876037709446,0.305702691159343,29
"12622","SC","Rodeio",11600,24814.2,42012,"Blumenau",4,"Sul",0,"421510",3,7,0,7,1,6,0,0,0,0,0,7,0,7,1,6,7,10.1191713489365,9.35876037709446,0.429864867199633,31
"12623","SC","Rodeio",11600,24814.2,42012,"Blumenau",4,"Sul",0,"421510",4,10,2,8,4,6,0,0,0,0,0,10,2,8,4,6,3,10.1191713489365,9.35876037709446,0.443999540218217,30
"12624","SC","Rodeio",11600,24814.2,42012,"Blumenau",4,"Sul",0,"421510",5,7,0,7,3,4,0,0,0,0,0,7,0,7,3,4,6,10.1191713489365,9.35876037709446,0.394547830488262,31
"12625","SC","Sangão",12905,25663.39,42018,"Tubarão",4,"Sul",0,"421545",2,12,4,8,5,7,0,0,0,0,0,12,4,8,5,7,8,10.1528207416805,9.46537011215271,0.320324819965644,29
"12626","SC","Sangão",12905,25663.39,42018,"Tubarão",4,"Sul",0,"421545",3,13,7,6,3,10,0,0,0,0,0,13,7,6,3,10,6,10.1528207416805,9.46537011215271,0.414810235938538,31
"12627","SC","Sangão",12905,25663.39,42018,"Tubarão",4,"Sul",0,"421545",4,11,6,5,5,6,0,0,0,0,0,11,6,5,5,6,5,10.1528207416805,9.46537011215271,0.438752364205999,30
"12628","SC","Sangão",12905,25663.39,42018,"Tubarão",4,"Sul",0,"421545",5,21,11,10,7,14,0,0,0,0,0,21,11,10,7,14,5,10.1528207416805,9.46537011215271,0.382958659903068,31
"12629","SC","Santa Cecília",16918,28120.98,42009,"Curitibanos",4,"Sul",1,"421550",2,23,11,12,14,9,0,0,0,0,0,23,11,12,14,9,7,10.2442711959574,9.73613342286396,0.309022677492945,29
"12630","SC","Santa Cecília",16918,28120.98,42009,"Curitibanos",4,"Sul",1,"421550",3,29,9,20,15,14,0,0,0,0,0,29,9,20,15,14,7,10.2442711959574,9.73613342286396,0.398585211160278,31
"12631","SC","Santa Cecília",16918,28120.98,42009,"Curitibanos",4,"Sul",1,"421550",4,21,6,15,11,10,0,0,0,0,0,21,6,15,11,10,11,10.2442711959574,9.73613342286396,0.412021038202589,30
"12632","SC","Santa Cecília",16918,28120.98,42009,"Curitibanos",4,"Sul",1,"421550",5,16,3,13,10,6,0,0,0,0,0,16,3,13,10,6,10,10.2442711959574,9.73613342286396,0.37968842269061,31
"12633","SC","Santa Rosa do Sul",8378,15931.64,42020,"Araranguá",4,"Sul",0,"421565",2,4,0,4,3,1,0,0,0,0,0,4,0,4,3,1,4,9.6760623480131,9.03336450150698,0.321453957046593,29
"12634","SC","Santa Rosa do Sul",8378,15931.64,42020,"Araranguá",4,"Sul",0,"421565",3,11,3,8,2,9,0,0,0,0,0,11,3,8,2,9,6,9.6760623480131,9.03336450150698,0.454124758067727,31
"12635","SC","Santa Rosa do Sul",8378,15931.64,42020,"Araranguá",4,"Sul",0,"421565",4,10,2,8,2,8,0,0,0,0,0,10,2,8,2,8,4,9.6760623480131,9.03336450150698,0.488839012193275,30
"12636","SC","Santa Rosa do Sul",8378,15931.64,42020,"Araranguá",4,"Sul",0,"421565",5,8,2,6,0,8,0,0,0,0,0,8,2,6,0,8,6,9.6760623480131,9.03336450150698,0.434976145200348,31
"12637","SC","Santo Amaro da Imperatriz",23579,37065.02,42016,"Florianópolis",4,"Sul",1,"421570",2,26,5,21,9,17,0,0,0,0,0,26,5,21,9,17,8,10.5204289466833,10.068111764371,0.2909596270899,29
"12638","SC","Santo Amaro da Imperatriz",23579,37065.02,42016,"Florianópolis",4,"Sul",1,"421570",3,22,7,15,8,14,0,0,0,0,0,22,7,15,8,14,13,10.5204289466833,10.068111764371,0.41415293906771,31
"12639","SC","Santo Amaro da Imperatriz",23579,37065.02,42016,"Florianópolis",4,"Sul",1,"421570",4,27,5,22,5,22,0,0,0,0,0,27,5,22,5,22,20,10.5204289466833,10.068111764371,0.426338870016736,30
"12640","SC","Santo Amaro da Imperatriz",23579,37065.02,42016,"Florianópolis",4,"Sul",1,"421570",5,29,6,23,6,23,0,0,0,0,0,29,6,23,6,23,12,10.5204289466833,10.068111764371,0.369758306665912,31
"12641","SC","São Bento do Sul",85421,38266.83,42007,"São Bento do Sul",4,"Sul",1,"421580",2,64,18,46,15,49,2,0,2,1,1,66,18,48,16,50,34,10.5523387424831,11.3553472511872,0.295818602114289,29
"12642","SC","São Bento do Sul",85421,38266.83,42007,"São Bento do Sul",4,"Sul",1,"421580",3,78,13,65,27,51,1,0,1,0,1,79,13,66,27,52,36,10.5523387424831,11.3553472511872,0.427549058973969,31
"12643","SC","São Bento do Sul",85421,38266.83,42007,"São Bento do Sul",4,"Sul",1,"421580",4,88,15,73,36,52,0,0,0,0,0,88,15,73,36,52,47,10.5523387424831,11.3553472511872,0.443972457767852,30
"12644","SC","São Bento do Sul",85421,38266.83,42007,"São Bento do Sul",4,"Sul",1,"421580",5,82,14,68,28,54,1,1,0,1,0,83,15,68,29,54,32,10.5523387424831,11.3553472511872,0.390594756643004,31
"12645","SC","São Carlos",11369,37942.44,42002,"Chapecó",4,"Sul",0,"421600",2,11,2,9,4,7,0,0,0,0,0,11,2,9,4,7,7,10.5438255534928,9.33864563212911,0.308408909235823,29
"12646","SC","São Carlos",11369,37942.44,42002,"Chapecó",4,"Sul",0,"421600",3,15,4,11,2,13,0,0,0,0,0,15,4,11,2,13,4,10.5438255534928,9.33864563212911,0.450210369637302,31
"12647","SC","São Carlos",11369,37942.44,42002,"Chapecó",4,"Sul",0,"421600",4,9,0,9,3,6,0,0,0,0,0,9,0,9,3,6,7,10.5438255534928,9.33864563212911,0.444687139356874,30
"12648","SC","São Carlos",11369,37942.44,42002,"Chapecó",4,"Sul",0,"421600",5,11,3,8,1,10,1,0,1,0,1,12,3,9,1,11,5,10.5438255534928,9.33864563212911,0.436349770887772,31
"12649","SC","São Domingos",9434,34612.07,42003,"Xanxerê",4,"Sul",0,"421610",2,7,2,5,3,4,0,0,0,0,0,7,2,5,3,4,7,10.4519577441446,9.15207546384421,0.320408150013754,29
"12650","SC","São Domingos",9434,34612.07,42003,"Xanxerê",4,"Sul",0,"421610",3,8,0,8,3,5,0,0,0,0,0,8,0,8,3,5,5,10.4519577441446,9.15207546384421,0.410949432102181,31
"12651","SC","São Domingos",9434,34612.07,42003,"Xanxerê",4,"Sul",0,"421610",4,8,0,8,2,6,0,0,0,0,0,8,0,8,2,6,3,10.4519577441446,9.15207546384421,0.435217200363734,30
"12652","SC","São Domingos",9434,34612.07,42003,"Xanxerê",4,"Sul",0,"421610",5,8,3,5,3,5,1,1,0,1,0,9,4,5,4,5,5,10.4519577441446,9.15207546384421,0.415770256714259,31
"12653","SC","São Francisco do Sul",53746,80165.53,42008,"Joinville",4,"Sul",1,"421620",2,41,6,35,12,29,0,0,0,0,0,41,6,35,12,29,33,11.2918489009651,10.8920245246161,0.334664558471948,29
"12654","SC","São Francisco do Sul",53746,80165.53,42008,"Joinville",4,"Sul",1,"421620",3,58,12,46,21,37,1,0,1,0,1,59,12,47,21,38,28,11.2918489009651,10.8920245246161,0.446605451913499,31
"12655","SC","São Francisco do Sul",53746,80165.53,42008,"Joinville",4,"Sul",1,"421620",4,43,5,38,15,28,0,0,0,0,0,43,5,38,15,28,25,11.2918489009651,10.8920245246161,0.459920544987743,30
"12656","SC","São Francisco do Sul",53746,80165.53,42008,"Joinville",4,"Sul",1,"421620",5,53,13,40,23,30,0,0,0,0,0,53,13,40,23,30,23,11.2918489009651,10.8920245246161,0.421663472560617,31
"12657","SC","São João Batista",38583,24798.96,42015,"Tijucas",4,"Sul",1,"421630",2,34,9,25,10,24,1,0,1,0,1,35,9,26,10,25,9,10.1185569957899,10.5605670439342,0.317029493939353,29
"12658","SC","São João Batista",38583,24798.96,42015,"Tijucas",4,"Sul",1,"421630",3,35,9,26,9,26,1,0,1,0,1,36,9,27,9,27,10,10.1185569957899,10.5605670439342,0.431359171814829,31
"12659","SC","São João Batista",38583,24798.96,42015,"Tijucas",4,"Sul",1,"421630",4,33,13,20,13,20,0,0,0,0,0,33,13,20,13,20,17,10.1185569957899,10.5605670439342,0.44007850618871,30
"12660","SC","São João Batista",38583,24798.96,42015,"Tijucas",4,"Sul",1,"421630",5,49,20,29,23,26,1,0,1,1,0,50,20,30,24,26,9,10.1185569957899,10.5605670439342,0.397730921468408,31
"12661","SC","São Joaquim",27139,27919.27,42010,"Campos de Lages",4,"Sul",0,"421650",2,30,8,22,14,16,0,0,0,0,0,30,8,22,14,16,16,10.2370724104027,10.2087270867262,0.337522748204747,29
"12662","SC","São Joaquim",27139,27919.27,42010,"Campos de Lages",4,"Sul",0,"421650",3,44,13,31,18,26,1,1,0,0,1,45,14,31,18,27,17,10.2370724104027,10.2087270867262,0.412052491162251,31
"12663","SC","São Joaquim",27139,27919.27,42010,"Campos de Lages",4,"Sul",0,"421650",4,21,7,14,9,12,0,0,0,0,0,21,7,14,9,12,18,10.2370724104027,10.2087270867262,0.426829897439489,30
"12664","SC","São Joaquim",27139,27919.27,42010,"Campos de Lages",4,"Sul",0,"421650",5,28,13,15,12,16,0,0,0,0,0,28,13,15,12,16,19,10.2370724104027,10.2087270867262,0.430102359788772,31
"12665","SC","São José",250181,43665.31,42016,"Florianópolis",4,"Sul",1,"421660",2,238,39,199,76,162,5,0,5,0,5,243,39,204,76,167,96,10.6843092443302,12.4299399348828,0.290512419339993,29
"12666","SC","São José",250181,43665.31,42016,"Florianópolis",4,"Sul",1,"421660",3,229,43,186,69,160,1,1,0,1,0,230,44,186,70,160,115,10.6843092443302,12.4299399348828,0.442182904868785,31
"12667","SC","São José",250181,43665.31,42016,"Florianópolis",4,"Sul",1,"421660",4,245,51,194,72,173,0,0,0,0,0,245,51,194,72,173,118,10.6843092443302,12.4299399348828,0.47507948068751,30
"12668","SC","São José",250181,43665.31,42016,"Florianópolis",4,"Sul",1,"421660",5,278,47,231,88,190,0,0,0,0,0,278,47,231,88,190,103,10.6843092443302,12.4299399348828,0.405795622414454,31
"12669","SC","São José do Cedro",13820,29589.39,42001,"São Miguel do Oeste",4,"Sul",0,"421670",2,13,5,8,1,12,0,0,0,0,0,13,5,8,1,12,6,10.2951711301091,9.53387209732166,0.317961782630841,29
"12670","SC","São José do Cedro",13820,29589.39,42001,"São Miguel do Oeste",4,"Sul",0,"421670",3,14,2,12,2,12,0,0,0,0,0,14,2,12,2,12,8,10.2951711301091,9.53387209732166,0.434948650626896,31
"12671","SC","São José do Cedro",13820,29589.39,42001,"São Miguel do Oeste",4,"Sul",0,"421670",4,16,2,14,4,12,0,0,0,0,0,16,2,14,4,12,5,10.2951711301091,9.53387209732166,0.423834327557366,30
"12672","SC","São José do Cedro",13820,29589.39,42001,"São Miguel do Oeste",4,"Sul",0,"421670",5,14,1,13,5,9,0,0,0,0,0,14,1,13,5,9,7,10.2951711301091,9.53387209732166,0.416577966263066,31
"12673","SC","São Lourenço do Oeste",24291,40274.72,42002,"Chapecó",4,"Sul",0,"421690",2,8,2,6,1,7,0,0,0,0,0,8,2,6,1,7,5,10.6034792558174,10.0978611903542,0.278032121539128,29
"12674","SC","São Lourenço do Oeste",24291,40274.72,42002,"Chapecó",4,"Sul",0,"421690",3,13,0,13,4,9,0,0,0,0,0,13,0,13,4,9,0,10.6034792558174,10.0978611903542,0.382681141947478,31
"12675","SC","São Lourenço do Oeste",24291,40274.72,42002,"Chapecó",4,"Sul",0,"421690",4,8,0,8,1,7,0,0,0,0,0,8,0,8,1,7,2,10.6034792558174,10.0978611903542,0.403972013509778,30
"12676","SC","São Lourenço do Oeste",24291,40274.72,42002,"Chapecó",4,"Sul",0,"421690",5,13,1,12,1,12,0,0,0,0,0,13,1,12,1,12,3,10.6034792558174,10.0978611903542,0.386523241295905,31
"12677","SC","São Ludgero",13650,48336.52,42018,"Tubarão",4,"Sul",0,"421700",2,10,2,8,1,9,0,0,0,0,0,10,2,8,1,9,3,10.7859426615957,9.52149480061311,0.339201087420144,29
"12678","SC","São Ludgero",13650,48336.52,42018,"Tubarão",4,"Sul",0,"421700",3,25,7,18,7,18,0,0,0,0,0,25,7,18,7,18,5,10.7859426615957,9.52149480061311,0.424621406362547,31
"12679","SC","São Ludgero",13650,48336.52,42018,"Tubarão",4,"Sul",0,"421700",4,12,5,7,4,8,0,0,0,0,0,12,5,7,4,8,4,10.7859426615957,9.52149480061311,0.441939685188825,30
"12680","SC","São Ludgero",13650,48336.52,42018,"Tubarão",4,"Sul",0,"421700",5,11,2,9,3,8,0,0,0,0,0,11,2,9,3,8,1,10.7859426615957,9.52149480061311,0.402137966705793,31
"12681","SC","São Miguel do Oeste",40868,37963.89,42001,"São Miguel do Oeste",4,"Sul",1,"421720",2,43,8,35,6,37,0,0,0,0,0,43,8,35,6,37,20,10.5443907237644,10.6181026397113,0.30510992315794,29
"12682","SC","São Miguel do Oeste",40868,37963.89,42001,"São Miguel do Oeste",4,"Sul",1,"421720",3,49,8,41,12,37,1,0,1,0,1,50,8,42,12,38,17,10.5443907237644,10.6181026397113,0.43019168802602,31
"12683","SC","São Miguel do Oeste",40868,37963.89,42001,"São Miguel do Oeste",4,"Sul",1,"421720",4,46,14,32,12,34,1,1,0,1,0,47,15,32,13,34,22,10.5443907237644,10.6181026397113,0.437212497490036,30
"12684","SC","São Miguel do Oeste",40868,37963.89,42001,"São Miguel do Oeste",4,"Sul",1,"421720",5,46,12,34,15,31,0,0,0,0,0,46,12,34,15,31,23,10.5443907237644,10.6181026397113,0.398749686099422,31
"12685","SC","São Pedro de Alcântara",5935,14164.08,42016,"Florianópolis",4,"Sul",1,"421725",2,2,0,2,1,1,0,0,0,0,0,2,0,2,1,1,2,9.55846446133784,8.68862230704377,0.322855228194517,29
"12686","SC","São Pedro de Alcântara",5935,14164.08,42016,"Florianópolis",4,"Sul",1,"421725",3,2,0,2,0,2,0,0,0,0,0,2,0,2,0,2,2,9.55846446133784,8.68862230704377,0.437691088515625,31
"12687","SC","São Pedro de Alcântara",5935,14164.08,42016,"Florianópolis",4,"Sul",1,"421725",4,4,1,3,0,4,0,0,0,0,0,4,1,3,0,4,5,9.55846446133784,8.68862230704377,0.471586982460413,30
"12688","SC","São Pedro de Alcântara",5935,14164.08,42016,"Florianópolis",4,"Sul",1,"421725",5,1,0,1,0,1,0,0,0,0,0,1,0,1,0,1,4,9.55846446133784,8.68862230704377,0.42139088545807,31
"12689","SC","Schroeder",21991,24106.03,42008,"Joinville",4,"Sul",1,"421740",2,15,4,11,4,11,0,0,0,0,0,15,4,11,4,11,6,10.090217295651,9.99838855773085,0.32263061520997,29
"12690","SC","Schroeder",21991,24106.03,42008,"Joinville",4,"Sul",1,"421740",3,22,6,16,5,17,0,0,0,0,0,22,6,16,5,17,5,10.090217295651,9.99838855773085,0.448092021446535,31
"12691","SC","Schroeder",21991,24106.03,42008,"Joinville",4,"Sul",1,"421740",4,19,1,18,5,14,0,0,0,0,0,19,1,18,5,14,5,10.090217295651,9.99838855773085,0.445759006083347,30
"12692","SC","Schroeder",21991,24106.03,42008,"Joinville",4,"Sul",1,"421740",5,33,7,26,14,19,0,0,0,0,0,33,7,26,14,19,9,10.090217295651,9.99838855773085,0.407367855706025,31
"12693","SC","Seara",17576,45693.62,42005,"Concórdia",4,"Sul",0,"421750",2,17,3,14,8,9,0,0,0,0,0,17,3,14,8,9,7,10.7297139610095,9.77428961406445,0.324410528574639,29
"12694","SC","Seara",17576,45693.62,42005,"Concórdia",4,"Sul",0,"421750",3,23,7,16,7,16,1,0,1,0,1,24,7,17,7,17,12,10.7297139610095,9.77428961406445,0.426255953305955,31
"12695","SC","Seara",17576,45693.62,42005,"Concórdia",4,"Sul",0,"421750",4,15,2,13,4,11,0,0,0,0,0,15,2,13,4,11,4,10.7297139610095,9.77428961406445,0.440235503024483,30
"12696","SC","Seara",17576,45693.62,42005,"Concórdia",4,"Sul",0,"421750",5,4,0,4,1,3,1,1,0,0,1,5,1,4,1,4,8,10.7297139610095,9.77428961406445,0.443679611629852,31
"12697","SC","Siderópolis",14092,33528.51,42019,"Criciúma",4,"Sul",1,"421760",2,7,0,7,1,6,0,0,0,0,0,7,0,7,1,6,5,10.420151400656,9.55336253946113,0.312260006918809,29
"12698","SC","Siderópolis",14092,33528.51,42019,"Criciúma",4,"Sul",1,"421760",3,16,4,12,6,10,0,0,0,0,0,16,4,12,6,10,8,10.420151400656,9.55336253946113,0.436948688516178,31
"12699","SC","Siderópolis",14092,33528.51,42019,"Criciúma",4,"Sul",1,"421760",4,10,2,8,2,8,0,0,0,0,0,10,2,8,2,8,7,10.420151400656,9.55336253946113,0.457920907186089,30
"12700","SC","Siderópolis",14092,33528.51,42019,"Criciúma",4,"Sul",1,"421760",5,24,5,19,15,9,0,0,0,0,0,24,5,19,15,9,8,10.420151400656,9.55336253946113,0.39638180283545,31
"12701","SC","Sombrio",30733,26167.72,42020,"Araranguá",4,"Sul",0,"421770",2,23,9,14,2,21,0,0,0,0,0,23,9,14,2,21,11,10.1722818690693,10.3330922748308,0.296940659648685,29
"12702","SC","Sombrio",30733,26167.72,42020,"Araranguá",4,"Sul",0,"421770",3,32,10,22,9,23,0,0,0,0,0,32,10,22,9,23,12,10.1722818690693,10.3330922748308,0.428161090570708,31
"12703","SC","Sombrio",30733,26167.72,42020,"Araranguá",4,"Sul",0,"421770",4,31,7,24,12,19,0,0,0,0,0,31,7,24,12,19,16,10.1722818690693,10.3330922748308,0.440648980763333,30
"12704","SC","Sombrio",30733,26167.72,42020,"Araranguá",4,"Sul",0,"421770",5,30,10,20,11,19,0,0,0,0,0,30,10,20,11,19,16,10.1722818690693,10.3330922748308,0.392468291258986,31
"12705","SC","Taió",18486,32781.05,42011,"Rio do Sul",4,"Sul",0,"421780",2,3,0,3,0,3,0,0,0,0,0,3,0,3,0,3,12,10.3976058835115,9.82476896782472,0.296061791020128,29
"12706","SC","Taió",18486,32781.05,42011,"Rio do Sul",4,"Sul",0,"421780",3,7,2,5,0,7,0,0,0,0,0,7,2,5,0,7,12,10.3976058835115,9.82476896782472,0.410700174352379,31
"12707","SC","Taió",18486,32781.05,42011,"Rio do Sul",4,"Sul",0,"421780",4,2,1,1,0,2,1,1,0,0,1,3,2,1,0,3,8,10.3976058835115,9.82476896782472,0.400817934431632,30
"12708","SC","Taió",18486,32781.05,42011,"Rio do Sul",4,"Sul",0,"421780",5,2,1,1,0,2,0,0,0,0,0,2,1,1,0,2,7,10.3976058835115,9.82476896782472,0.390014369053785,31
"12709","SC","Tangará",8662,47114.19,42004,"Joaçaba",4,"Sul",0,"421790",2,8,5,3,3,5,0,0,0,0,0,8,5,3,3,5,6,10.760329508516,9.06670092177457,0.350560003817886,29
"12710","SC","Tangará",8662,47114.19,42004,"Joaçaba",4,"Sul",0,"421790",3,10,1,9,2,8,0,0,0,0,0,10,1,9,2,8,5,10.760329508516,9.06670092177457,0.423697119395609,31
"12711","SC","Tangará",8662,47114.19,42004,"Joaçaba",4,"Sul",0,"421790",4,11,5,6,1,10,0,0,0,0,0,11,5,6,1,10,5,10.760329508516,9.06670092177457,0.425591144344122,30
"12712","SC","Tangará",8662,47114.19,42004,"Joaçaba",4,"Sul",0,"421790",5,7,3,4,2,5,0,0,0,0,0,7,3,4,2,5,3,10.760329508516,9.06670092177457,0.404279676051248,31
"12713","SC","Tijucas",39155,40901.83,42015,"Tijucas",4,"Sul",1,"421800",2,46,11,35,17,29,0,0,0,0,0,46,11,35,17,29,14,10.6189300843062,10.575283407185,0.306227936409619,29
"12714","SC","Tijucas",39155,40901.83,42015,"Tijucas",4,"Sul",1,"421800",3,55,17,38,25,30,1,0,1,0,1,56,17,39,25,31,16,10.6189300843062,10.575283407185,0.433427648194983,31
"12715","SC","Tijucas",39155,40901.83,42015,"Tijucas",4,"Sul",1,"421800",4,61,9,52,20,41,0,0,0,0,0,61,9,52,20,41,23,10.6189300843062,10.575283407185,0.435898460768905,30
"12716","SC","Tijucas",39155,40901.83,42015,"Tijucas",4,"Sul",1,"421800",5,46,7,39,18,28,2,1,1,0,2,48,8,40,18,30,21,10.6189300843062,10.575283407185,0.390034428303655,31
"12717","SC","Timbó",44977,42748.35,42012,"Blumenau",4,"Sul",1,"421820",2,12,0,12,1,11,1,0,1,1,0,13,0,13,2,11,16,10.6630858771288,10.7139065269795,0.307349492455853,29
"12718","SC","Timbó",44977,42748.35,42012,"Blumenau",4,"Sul",1,"421820",3,9,1,8,1,8,0,0,0,0,0,9,1,8,1,8,14,10.6630858771288,10.7139065269795,0.438261859477839,31
"12719","SC","Timbó",44977,42748.35,42012,"Blumenau",4,"Sul",1,"421820",4,15,0,15,1,14,1,1,0,0,1,16,1,15,1,15,17,10.6630858771288,10.7139065269795,0.453350093605911,30
"12720","SC","Timbó",44977,42748.35,42012,"Blumenau",4,"Sul",1,"421820",5,6,0,6,1,5,0,0,0,0,0,6,0,6,1,5,21,10.6630858771288,10.7139065269795,0.402384668089553,31
"12721","SC","Três Barras",19366,58050.25,42006,"Canoinhas",4,"Sul",0,"421830",2,21,8,13,12,9,0,0,0,0,0,21,8,13,12,9,8,10.969064293749,9.87127423017148,0.314759212746357,29
"12722","SC","Três Barras",19366,58050.25,42006,"Canoinhas",4,"Sul",0,"421830",3,25,6,19,9,16,0,0,0,0,0,25,6,19,9,16,14,10.969064293749,9.87127423017148,0.433134855365996,31
"12723","SC","Três Barras",19366,58050.25,42006,"Canoinhas",4,"Sul",0,"421830",4,25,4,21,13,12,1,0,1,0,1,26,4,22,13,13,10,10.969064293749,9.87127423017148,0.459812188299995,30
"12724","SC","Três Barras",19366,58050.25,42006,"Canoinhas",4,"Sul",0,"421830",5,25,4,21,13,12,0,0,0,0,0,25,4,21,13,12,10,10.969064293749,9.87127423017148,0.415279943030162,31
"12725","SC","Treze Tílias",7991,79760.98,42004,"Joaçaba",4,"Sul",0,"421850",2,16,2,14,6,10,1,0,1,1,0,17,2,15,7,10,1,11.2867896914208,8.98607118737446,0.286437231341367,29
"12726","SC","Treze Tílias",7991,79760.98,42004,"Joaçaba",4,"Sul",0,"421850",3,15,1,14,10,5,0,0,0,0,0,15,1,14,10,5,5,11.2867896914208,8.98607118737446,0.389555831450698,31
"12727","SC","Treze Tílias",7991,79760.98,42004,"Joaçaba",4,"Sul",0,"421850",4,7,2,5,2,5,0,0,0,0,0,7,2,5,2,5,1,11.2867896914208,8.98607118737446,0.361783346465478,30
"12728","SC","Treze Tílias",7991,79760.98,42004,"Joaçaba",4,"Sul",0,"421850",5,13,6,7,5,8,0,0,0,0,0,13,6,7,5,8,3,11.2867896914208,8.98607118737446,0.343116888285597,31
"12729","SC","Trombudo Central",7434,34907.81,42011,"Rio do Sul",4,"Sul",0,"421860",2,7,3,4,1,6,0,0,0,0,0,7,3,4,1,6,7,10.46046586539,8.9138193508572,0.321339021905706,29
"12730","SC","Trombudo Central",7434,34907.81,42011,"Rio do Sul",4,"Sul",0,"421860",3,7,1,6,3,4,0,0,0,0,0,7,1,6,3,4,2,10.46046586539,8.9138193508572,0.462359347570663,31
"12731","SC","Trombudo Central",7434,34907.81,42011,"Rio do Sul",4,"Sul",0,"421860",4,8,2,6,5,3,0,0,0,0,0,8,2,6,5,3,3,10.46046586539,8.9138193508572,0.47793129925083,30
"12732","SC","Trombudo Central",7434,34907.81,42011,"Rio do Sul",4,"Sul",0,"421860",5,4,2,2,2,2,0,0,0,0,0,4,2,2,2,2,6,10.46046586539,8.9138193508572,0.416648442609982,31
"12733","SC","Tubarão",106422,35655.22,42018,"Tubarão",4,"Sul",1,"421870",2,102,8,94,18,84,0,0,0,0,0,102,8,94,18,84,55,10.481650838686,11.5751676014336,0.305125020706296,29
"12734","SC","Tubarão",106422,35655.22,42018,"Tubarão",4,"Sul",1,"421870",3,88,14,74,31,57,0,0,0,0,0,88,14,74,31,57,56,10.481650838686,11.5751676014336,0.449019269856437,31
"12735","SC","Tubarão",106422,35655.22,42018,"Tubarão",4,"Sul",1,"421870",4,98,16,82,25,73,2,0,2,1,1,100,16,84,26,74,48,10.481650838686,11.5751676014336,0.457731876804747,30
"12736","SC","Tubarão",106422,35655.22,42018,"Tubarão",4,"Sul",1,"421870",5,119,22,97,37,82,0,0,0,0,0,119,22,97,37,82,47,10.481650838686,11.5751676014336,0.396472689966025,31
"12737","SC","Turvo",12990,42026.53,42020,"Araranguá",4,"Sul",0,"421880",2,8,2,6,3,5,0,0,0,0,0,8,2,6,3,5,3,10.6460563645148,9.47193510966465,0.306006406386488,29
"12738","SC","Turvo",12990,42026.53,42020,"Araranguá",4,"Sul",0,"421880",3,8,0,8,2,6,0,0,0,0,0,8,0,8,2,6,7,10.6460563645148,9.47193510966465,0.383523504253473,31
"12739","SC","Turvo",12990,42026.53,42020,"Araranguá",4,"Sul",0,"421880",4,10,3,7,3,7,0,0,0,0,0,10,3,7,3,7,5,10.6460563645148,9.47193510966465,0.400423846169491,30
"12740","SC","Turvo",12990,42026.53,42020,"Araranguá",4,"Sul",0,"421880",5,17,3,14,4,13,1,1,0,0,1,18,4,14,4,14,5,10.6460563645148,9.47193510966465,0.362787715662128,31
"12741","SC","Urussanga",21344,39438.25,42019,"Criciúma",4,"Sul",1,"421900",2,12,5,7,5,7,0,0,0,0,0,12,5,7,5,7,10,10.5824914365354,9.96852594871535,0.302336943661819,29
"12742","SC","Urussanga",21344,39438.25,42019,"Criciúma",4,"Sul",1,"421900",3,15,3,12,2,13,0,0,0,0,0,15,3,12,2,13,14,10.5824914365354,9.96852594871535,0.445353941956979,31
"12743","SC","Urussanga",21344,39438.25,42019,"Criciúma",4,"Sul",1,"421900",4,12,1,11,3,9,1,1,0,0,1,13,2,11,3,10,15,10.5824914365354,9.96852594871535,0.456353035781903,30
"12744","SC","Urussanga",21344,39438.25,42019,"Criciúma",4,"Sul",1,"421900",5,23,3,20,6,17,0,0,0,0,0,23,3,20,6,17,12,10.5824914365354,9.96852594871535,0.400334600228143,31
"12745","SC","Videira",53610,46236.23,42004,"Joaçaba",4,"Sul",1,"421930",2,56,15,41,18,38,1,0,1,1,0,57,15,42,19,38,27,10.7415189688805,10.8894908968216,0.332516200652697,29
"12746","SC","Videira",53610,46236.23,42004,"Joaçaba",4,"Sul",1,"421930",3,70,12,58,29,41,0,0,0,0,0,70,12,58,29,41,16,10.7415189688805,10.8894908968216,0.450565911583619,31
"12747","SC","Videira",53610,46236.23,42004,"Joaçaba",4,"Sul",1,"421930",4,73,17,56,21,52,0,0,0,0,0,73,17,56,21,52,30,10.7415189688805,10.8894908968216,0.458390382827961,30
"12748","SC","Videira",53610,46236.23,42004,"Joaçaba",4,"Sul",1,"421930",5,58,11,47,25,33,0,0,0,0,0,58,11,47,25,33,28,10.7415189688805,10.8894908968216,0.416129103566927,31
"12749","SC","Xanxerê",51642,33864.92,42003,"Xanxerê",4,"Sul",1,"421950",2,54,12,42,22,32,0,0,0,0,0,54,12,42,22,32,29,10.4301349493252,10.8520905738775,0.29327401864719,29
"12750","SC","Xanxerê",51642,33864.92,42003,"Xanxerê",4,"Sul",1,"421950",3,68,8,60,27,41,1,1,0,0,1,69,9,60,27,42,30,10.4301349493252,10.8520905738775,0.391131761730378,31
"12751","SC","Xanxerê",51642,33864.92,42003,"Xanxerê",4,"Sul",1,"421950",4,47,12,35,16,31,1,0,1,0,1,48,12,36,16,32,21,10.4301349493252,10.8520905738775,0.391710631742603,30
"12752","SC","Xanxerê",51642,33864.92,42003,"Xanxerê",4,"Sul",1,"421950",5,74,17,57,17,57,1,0,1,0,1,75,17,58,17,58,21,10.4301349493252,10.8520905738775,0.38643257035346,31
"12753","SC","Xaxim",28983,33345.93,42003,"Xanxerê",4,"Sul",1,"421970",2,42,10,32,16,26,0,0,0,0,0,42,10,32,16,26,13,10.4146910049159,10.2744647301856,0.313458374118227,29
"12754","SC","Xaxim",28983,33345.93,42003,"Xanxerê",4,"Sul",1,"421970",3,40,15,25,13,27,1,1,0,0,1,41,16,25,13,28,7,10.4146910049159,10.2744647301856,0.41557931345553,31
"12755","SC","Xaxim",28983,33345.93,42003,"Xanxerê",4,"Sul",1,"421970",4,55,14,41,13,42,1,1,0,0,1,56,15,41,13,43,14,10.4146910049159,10.2744647301856,0.414110205296449,30
"12756","SC","Xaxim",28983,33345.93,42003,"Xanxerê",4,"Sul",1,"421970",5,40,12,28,13,27,1,1,0,0,1,41,13,28,13,28,18,10.4146910049159,10.2744647301856,0.391170278276827,31
"12757","RS","Agudo",16401,30258.08,43019,"Restinga Seca",4,"Sul",0,"430010",2,17,5,12,3,14,0,0,0,0,0,17,5,12,3,14,9,10.3175185352302,9.70509758756311,0.309891536751052,29
"12758","RS","Agudo",16401,30258.08,43019,"Restinga Seca",4,"Sul",0,"430010",3,19,7,12,6,13,0,0,0,0,0,19,7,12,6,13,9,10.3175185352302,9.70509758756311,0.396291698987214,31
"12759","RS","Agudo",16401,30258.08,43019,"Restinga Seca",4,"Sul",0,"430010",4,10,4,6,3,7,0,0,0,0,0,10,4,6,3,7,8,10.3175185352302,9.70509758756311,0.419312519012276,30
"12760","RS","Agudo",16401,30258.08,43019,"Restinga Seca",4,"Sul",0,"430010",5,12,6,6,5,7,0,0,0,0,0,12,6,6,5,7,13,10.3175185352302,9.70509758756311,0.436274525949162,31
"12761","RS","Alegrete",73028,29467.27,43029,"Campanha Ocidental",4,"Sul",1,"430040",2,82,17,65,32,50,0,0,0,0,0,82,17,65,32,50,49,10.2910354348611,11.1985982082334,0.303822038227476,29
"12762","RS","Alegrete",73028,29467.27,43029,"Campanha Ocidental",4,"Sul",1,"430040",3,54,9,45,19,35,1,1,0,0,1,55,10,45,19,36,50,10.2910354348611,11.1985982082334,0.396728162983867,31
"12763","RS","Alegrete",73028,29467.27,43029,"Campanha Ocidental",4,"Sul",1,"430040",4,60,11,49,25,35,0,0,0,0,0,60,11,49,25,35,49,10.2910354348611,11.1985982082334,0.43364443093103,30
"12764","RS","Alegrete",73028,29467.27,43029,"Campanha Ocidental",4,"Sul",1,"430040",5,91,17,74,33,58,0,0,0,0,0,91,17,74,33,58,44,10.2910354348611,11.1985982082334,0.399432631442534,31
"12765","RS","Alvorada",211352,12914.08,43026,"Porto Alegre",4,"Sul",1,"430060",2,166,56,110,76,90,0,0,0,0,0,166,56,110,76,90,102,9.46607346799454,12.2612802689263,0.316981411158304,29
"12766","RS","Alvorada",211352,12914.08,43026,"Porto Alegre",4,"Sul",1,"430060",3,204,73,131,88,116,4,1,3,2,2,208,74,134,90,118,122,9.46607346799454,12.2612802689263,0.427382680363414,31
"12767","RS","Alvorada",211352,12914.08,43026,"Porto Alegre",4,"Sul",1,"430060",4,208,77,131,79,129,3,2,1,2,1,211,79,132,81,130,110,9.46607346799454,12.2612802689263,0.479082989566432,30
"12768","RS","Alvorada",211352,12914.08,43026,"Porto Alegre",4,"Sul",1,"430060",5,244,87,157,90,154,2,2,0,2,0,246,89,157,92,154,108,9.46607346799454,12.2612802689263,0.424715632927338,31
"12769","RS","Antônio Prado",13045,46929.32,43016,"Caxias do Sul",4,"Sul",0,"430080",2,9,4,5,3,6,0,0,0,0,0,9,4,5,3,6,7,10.756397919018,9.47616019757083,0.272502466795298,29
"12770","RS","Antônio Prado",13045,46929.32,43016,"Caxias do Sul",4,"Sul",0,"430080",3,11,1,10,3,8,0,0,0,0,0,11,1,10,3,8,12,10.756397919018,9.47616019757083,0.342200724134283,31
"12771","RS","Antônio Prado",13045,46929.32,43016,"Caxias do Sul",4,"Sul",0,"430080",4,12,5,7,3,9,0,0,0,0,0,12,5,7,3,9,7,10.756397919018,9.47616019757083,0.371412367205176,30
"12772","RS","Antônio Prado",13045,46929.32,43016,"Caxias do Sul",4,"Sul",0,"430080",5,5,2,3,0,5,0,0,0,0,0,5,2,3,0,5,7,10.756397919018,9.47616019757083,0.36263469475759,31
"12773","RS","Araricá",5771,28896.53,43026,"Porto Alegre",4,"Sul",1,"430087",2,4,1,3,1,3,0,0,0,0,0,4,1,3,1,3,3,10.2714767976875,8.66060065471097,0.298345035202005,29
"12774","RS","Araricá",5771,28896.53,43026,"Porto Alegre",4,"Sul",1,"430087",3,6,1,5,4,2,0,0,0,0,0,6,1,5,4,2,4,10.2714767976875,8.66060065471097,0.409035374440459,31
"12775","RS","Araricá",5771,28896.53,43026,"Porto Alegre",4,"Sul",1,"430087",4,6,2,4,1,5,0,0,0,0,0,6,2,4,1,5,2,10.2714767976875,8.66060065471097,0.431444031034214,30
"12776","RS","Araricá",5771,28896.53,43026,"Porto Alegre",4,"Sul",1,"430087",5,7,1,6,5,2,0,0,0,0,0,7,1,6,5,2,4,10.2714767976875,8.66060065471097,0.383631036555106,31
"12777","RS","Arroio do Meio",20967,59080.01,43021,"Lajeado-Estrela",4,"Sul",1,"430100",2,29,7,22,7,22,0,0,0,0,0,29,7,22,7,22,10,10.9866479059073,9.95070505214524,0.295072510628837,29
"12778","RS","Arroio do Meio",20967,59080.01,43021,"Lajeado-Estrela",4,"Sul",1,"430100",3,28,9,19,12,16,0,0,0,0,0,28,9,19,12,16,11,10.9866479059073,9.95070505214524,0.40760479729473,31
"12779","RS","Arroio do Meio",20967,59080.01,43021,"Lajeado-Estrela",4,"Sul",1,"430100",4,17,3,14,6,11,0,0,0,0,0,17,3,14,6,11,13,10.9866479059073,9.95070505214524,0.441144594801854,30
"12780","RS","Arroio do Meio",20967,59080.01,43021,"Lajeado-Estrela",4,"Sul",1,"430100",5,30,4,26,5,25,0,0,0,0,0,30,4,26,5,25,7,10.9866479059073,9.95070505214524,0.408390332914492,31
"12781","RS","Arroio do Sal",10279,22719.58,43027,"Osório",4,"Sul",0,"430105",2,15,3,12,10,5,0,0,0,0,0,15,3,12,10,5,6,10.0309823867487,9.23785825801292,0.34961264552571,29
"12782","RS","Arroio do Sal",10279,22719.58,43027,"Osório",4,"Sul",0,"430105",3,7,3,4,5,2,0,0,0,0,0,7,3,4,5,2,7,10.0309823867487,9.23785825801292,0.478248219291629,31
"12783","RS","Arroio do Sal",10279,22719.58,43027,"Osório",4,"Sul",0,"430105",4,6,3,3,3,3,0,0,0,0,0,6,3,3,3,3,7,10.0309823867487,9.23785825801292,0.524475970893807,30
"12784","RS","Arroio do Sal",10279,22719.58,43027,"Osório",4,"Sul",0,"430105",5,13,3,10,5,8,0,0,0,0,0,13,3,10,5,8,9,10.0309823867487,9.23785825801292,0.471143008287278,31
"12785","RS","Arroio dos Ratos",14177,18526.84,43025,"São Jerônimo",4,"Sul",1,"430110",2,15,6,9,7,8,0,0,0,0,0,15,6,9,7,8,12,9.82697577046803,9.55937621211763,0.288648569955112,29
"12786","RS","Arroio dos Ratos",14177,18526.84,43025,"São Jerônimo",4,"Sul",1,"430110",3,14,3,11,5,9,0,0,0,0,0,14,3,11,5,9,5,9.82697577046803,9.55937621211763,0.411412747416161,31
"12787","RS","Arroio dos Ratos",14177,18526.84,43025,"São Jerônimo",4,"Sul",1,"430110",4,9,6,3,5,4,1,0,1,0,1,10,6,4,5,5,5,9.82697577046803,9.55937621211763,0.450327226308309,30
"12788","RS","Arroio dos Ratos",14177,18526.84,43025,"São Jerônimo",4,"Sul",1,"430110",5,20,6,14,6,14,0,0,0,0,0,20,6,14,6,14,10,9.82697577046803,9.55937621211763,0.396726543881017,31
"12789","RS","Arroio do Tigre",13413,25173.18,43020,"Santa Cruz do Sul",4,"Sul",0,"430120",2,12,5,7,4,8,0,0,0,0,0,12,5,7,4,8,6,10.133534421031,9.50397966490209,0.305395649057917,29
"12790","RS","Arroio do Tigre",13413,25173.18,43020,"Santa Cruz do Sul",4,"Sul",0,"430120",3,12,5,7,4,8,0,0,0,0,0,12,5,7,4,8,7,10.133534421031,9.50397966490209,0.431094120290601,31
"12791","RS","Arroio do Tigre",13413,25173.18,43020,"Santa Cruz do Sul",4,"Sul",0,"430120",4,9,4,5,3,6,0,0,0,0,0,9,4,5,3,6,12,10.133534421031,9.50397966490209,0.407762395209476,30
"12792","RS","Arroio do Tigre",13413,25173.18,43020,"Santa Cruz do Sul",4,"Sul",0,"430120",5,13,2,11,7,6,0,0,0,0,0,13,2,11,7,6,9,10.133534421031,9.50397966490209,0.402742757978002,31
"12793","RS","Arroio Grande",18238,29608.24,43034,"Jaguarão",4,"Sul",1,"430130",2,14,3,11,4,10,0,0,0,0,0,14,3,11,4,10,12,10.2958079799505,9.81126260849361,0.314855149274549,29
"12794","RS","Arroio Grande",18238,29608.24,43034,"Jaguarão",4,"Sul",1,"430130",3,12,3,9,6,6,0,0,0,0,0,12,3,9,6,6,13,10.2958079799505,9.81126260849361,0.418988556795582,31
"12795","RS","Arroio Grande",18238,29608.24,43034,"Jaguarão",4,"Sul",1,"430130",4,15,9,6,6,9,0,0,0,0,0,15,9,6,6,9,16,10.2958079799505,9.81126260849361,0.45851731783103,30
"12796","RS","Arroio Grande",18238,29608.24,43034,"Jaguarão",4,"Sul",1,"430130",5,15,3,12,6,9,0,0,0,0,0,15,3,12,6,9,9,10.2958079799505,9.81126260849361,0.447692474889181,31
"12797","RS","Arvorezinha",10423,23846.62,43014,"Guaporé",4,"Sul",0,"430140",2,9,3,6,2,7,0,0,0,0,0,9,3,6,2,7,8,10.0793977671958,9.25177018173932,0.319826450653729,29
"12798","RS","Arvorezinha",10423,23846.62,43014,"Guaporé",4,"Sul",0,"430140",3,13,4,9,3,10,0,0,0,0,0,13,4,9,3,10,9,10.0793977671958,9.25177018173932,0.38782513518666,31
"12799","RS","Arvorezinha",10423,23846.62,43014,"Guaporé",4,"Sul",0,"430140",4,11,3,8,3,8,0,0,0,0,0,11,3,8,3,8,7,10.0793977671958,9.25177018173932,0.417061541169827,30
"12800","RS","Arvorezinha",10423,23846.62,43014,"Guaporé",4,"Sul",0,"430140",5,11,7,4,3,8,0,0,0,0,0,11,7,4,3,8,4,10.0793977671958,9.25177018173932,0.378271790556333,31
"12801","RS","Bagé",121335,24620.88,43031,"Campanha Meridional",4,"Sul",1,"430160",2,118,31,87,48,70,3,1,2,0,3,121,32,89,48,73,75,10.1113501423978,11.7063105941202,0.313293921982309,29
"12802","RS","Bagé",121335,24620.88,43031,"Campanha Meridional",4,"Sul",1,"430160",3,120,29,91,45,75,0,0,0,0,0,120,29,91,45,75,88,10.1113501423978,11.7063105941202,0.425463367168832,31
"12803","RS","Bagé",121335,24620.88,43031,"Campanha Meridional",4,"Sul",1,"430160",4,122,37,85,42,80,1,0,1,0,1,123,37,86,42,81,80,10.1113501423978,11.7063105941202,0.468007256343785,30
"12804","RS","Bagé",121335,24620.88,43031,"Campanha Meridional",4,"Sul",1,"430160",5,128,30,98,50,78,0,0,0,0,0,128,30,98,50,78,90,10.1113501423978,11.7063105941202,0.414458482226173,31
"12805","RS","Balneário Pinhal",14363,15745.16,43027,"Osório",4,"Sul",0,"430163",2,6,2,4,3,3,0,0,0,0,0,6,2,4,3,3,6,9.66428829543967,9.57241073443182,0.35003201598012,29
"12806","RS","Balneário Pinhal",14363,15745.16,43027,"Osório",4,"Sul",0,"430163",3,6,2,4,1,5,0,0,0,0,0,6,2,4,1,5,4,9.66428829543967,9.57241073443182,0.472999953518351,31
"12807","RS","Balneário Pinhal",14363,15745.16,43027,"Osório",4,"Sul",0,"430163",4,11,4,7,6,5,0,0,0,0,0,11,4,7,6,5,6,9.66428829543967,9.57241073443182,0.51436103261615,30
"12808","RS","Balneário Pinhal",14363,15745.16,43027,"Osório",4,"Sul",0,"430163",5,12,5,7,9,3,0,0,0,0,0,12,5,7,9,3,8,9.66428829543967,9.57241073443182,0.471808571841753,31
"12809","RS","Barão",6202,34635.32,43023,"Montenegro",4,"Sul",0,"430165",2,2,1,1,1,1,0,0,0,0,0,2,1,1,1,1,2,10.4526292496229,8.73262709966039,0.327385193276756,29
"12810","RS","Barão",6202,34635.32,43023,"Montenegro",4,"Sul",0,"430165",3,4,1,3,0,4,0,0,0,0,0,4,1,3,0,4,4,10.4526292496229,8.73262709966039,0.444866449158969,31
"12811","RS","Barão",6202,34635.32,43023,"Montenegro",4,"Sul",0,"430165",4,1,1,0,1,0,0,0,0,0,0,1,1,0,1,0,5,10.4526292496229,8.73262709966039,0.456363154414721,30
"12812","RS","Barão",6202,34635.32,43023,"Montenegro",4,"Sul",0,"430165",5,4,1,3,1,3,0,0,0,0,0,4,1,3,1,3,4,10.4526292496229,8.73262709966039,0.450257664440099,31
"12813","RS","Barra do Ribeiro",13556,23808.18,43028,"Camaquã",4,"Sul",0,"430190",2,8,2,6,4,4,0,0,0,0,0,8,2,6,4,4,14,10.0777844980881,9.51458453272694,0.297144306350369,29
"12814","RS","Barra do Ribeiro",13556,23808.18,43028,"Camaquã",4,"Sul",0,"430190",3,4,2,2,4,0,0,0,0,0,0,4,2,2,4,0,10,10.0777844980881,9.51458453272694,0.388125542982156,31
"12815","RS","Barra do Ribeiro",13556,23808.18,43028,"Camaquã",4,"Sul",0,"430190",4,11,6,5,4,7,0,0,0,0,0,11,6,5,4,7,11,10.0777844980881,9.51458453272694,0.446353448455285,30
"12816","RS","Barra do Ribeiro",13556,23808.18,43028,"Camaquã",4,"Sul",0,"430190",5,12,6,6,3,9,0,0,0,0,0,12,6,6,3,9,10,10.0777844980881,9.51458453272694,0.411131823123116,31
"12817","RS","Bento Gonçalves",121803,50090.88,43016,"Caxias do Sul",4,"Sul",1,"430210",2,129,30,99,31,98,3,0,3,1,2,132,30,102,32,100,62,10.8215942345743,11.7101602644965,0.294215989695627,29
"12818","RS","Bento Gonçalves",121803,50090.88,43016,"Caxias do Sul",4,"Sul",1,"430210",3,117,24,93,27,90,1,0,1,1,0,118,24,94,28,90,53,10.8215942345743,11.7101602644965,0.429310038353192,31
"12819","RS","Bento Gonçalves",121803,50090.88,43016,"Caxias do Sul",4,"Sul",1,"430210",4,129,25,104,35,94,1,0,1,0,1,130,25,105,35,95,50,10.8215942345743,11.7101602644965,0.444899210821818,30
"12820","RS","Bento Gonçalves",121803,50090.88,43016,"Caxias do Sul",4,"Sul",1,"430210",5,151,31,120,47,104,0,0,0,0,0,151,31,120,47,104,66,10.8215942345743,11.7101602644965,0.39555759148331,31
"12821","RS","Bom Jesus",11309,29455.96,43015,"Vacaria",4,"Sul",0,"430230",2,10,3,7,4,6,0,0,0,0,0,10,3,7,4,6,12,10.2906515455143,9.33335414787133,0.361305145285922,29
"12822","RS","Bom Jesus",11309,29455.96,43015,"Vacaria",4,"Sul",0,"430230",3,12,4,8,4,8,0,0,0,0,0,12,4,8,4,8,8,10.2906515455143,9.33335414787133,0.429698761263927,31
"12823","RS","Bom Jesus",11309,29455.96,43015,"Vacaria",4,"Sul",0,"430230",4,12,9,3,6,6,0,0,0,0,0,12,9,3,6,6,7,10.2906515455143,9.33335414787133,0.447504585728434,30
"12824","RS","Bom Jesus",11309,29455.96,43015,"Vacaria",4,"Sul",0,"430230",5,14,9,5,3,11,0,0,0,0,0,14,9,5,3,11,6,10.2906515455143,9.33335414787133,0.479205320651612,31
"12825","RS","Bom Princípio",14255,47015.72,43023,"Montenegro",4,"Sul",0,"430235",2,7,3,4,2,5,0,0,0,0,0,7,3,4,2,5,12,10.7582372928553,9.56486300134677,0.302572206447784,29
"12826","RS","Bom Princípio",14255,47015.72,43023,"Montenegro",4,"Sul",0,"430235",3,14,1,13,2,12,0,0,0,0,0,14,1,13,2,12,6,10.7582372928553,9.56486300134677,0.395010513889419,31
"12827","RS","Bom Princípio",14255,47015.72,43023,"Montenegro",4,"Sul",0,"430235",4,13,2,11,6,7,0,0,0,0,0,13,2,11,6,7,10,10.7582372928553,9.56486300134677,0.407577484748666,30
"12828","RS","Bom Princípio",14255,47015.72,43023,"Montenegro",4,"Sul",0,"430235",5,9,1,8,1,8,0,0,0,0,0,9,1,8,1,8,4,10.7582372928553,9.56486300134677,0.382936669858814,31
"12829","RS","Bom Retiro do Sul",12390,24714.62,43021,"Lajeado-Estrela",4,"Sul",1,"430240",2,5,0,5,3,2,0,0,0,0,0,5,0,5,3,2,11,10.1151502503447,9.42464497462319,0.28327054485769,29
"12830","RS","Bom Retiro do Sul",12390,24714.62,43021,"Lajeado-Estrela",4,"Sul",1,"430240",3,13,2,11,3,10,0,0,0,0,0,13,2,11,3,10,7,10.1151502503447,9.42464497462319,0.379973456380902,31
"12831","RS","Bom Retiro do Sul",12390,24714.62,43021,"Lajeado-Estrela",4,"Sul",1,"430240",4,5,1,4,2,3,0,0,0,0,0,5,1,4,2,3,7,10.1151502503447,9.42464497462319,0.418175914227098,30
"12832","RS","Bom Retiro do Sul",12390,24714.62,43021,"Lajeado-Estrela",4,"Sul",1,"430240",5,14,7,7,3,11,0,0,0,0,0,14,7,7,3,11,10,10.1151502503447,9.42464497462319,0.40951526587844,31
"12833","RS","Butiá",20952,21264.2,43025,"São Jerônimo",4,"Sul",1,"430270",2,15,6,9,7,8,0,0,0,0,0,15,6,9,7,8,9,9.96478018647689,9.94998938618755,0.313737619251668,29
"12834","RS","Butiá",20952,21264.2,43025,"São Jerônimo",4,"Sul",1,"430270",3,18,6,12,6,12,0,0,0,0,0,18,6,12,6,12,14,9.96478018647689,9.94998938618755,0.38605115259039,31
"12835","RS","Butiá",20952,21264.2,43025,"São Jerônimo",4,"Sul",1,"430270",4,16,6,10,7,9,0,0,0,0,0,16,6,10,7,9,12,9.96478018647689,9.94998938618755,0.424570609272501,30
"12836","RS","Butiá",20952,21264.2,43025,"São Jerônimo",4,"Sul",1,"430270",5,18,7,11,9,9,0,0,0,0,0,18,7,11,9,9,16,9.96478018647689,9.94998938618755,0.398741761129683,31
"12837","RS","Caçapava do Sul",33548,24228.03,43032,"Serras de Sudeste",4,"Sul",0,"430280",2,35,15,20,16,19,0,0,0,0,0,35,15,20,16,19,20,10.0952655063368,10.4207325281043,0.314336662766702,29
"12838","RS","Caçapava do Sul",33548,24228.03,43032,"Serras de Sudeste",4,"Sul",0,"430280",3,18,2,16,4,14,0,0,0,0,0,18,2,16,4,14,27,10.0952655063368,10.4207325281043,0.39533928619031,31
"12839","RS","Caçapava do Sul",33548,24228.03,43032,"Serras de Sudeste",4,"Sul",0,"430280",4,28,5,23,7,21,2,1,1,2,0,30,6,24,9,21,26,10.0952655063368,10.4207325281043,0.42194252701911,30
"12840","RS","Caçapava do Sul",33548,24228.03,43032,"Serras de Sudeste",4,"Sul",0,"430280",5,29,8,21,13,16,0,0,0,0,0,29,8,21,13,16,28,10.0952655063368,10.4207325281043,0.37645904686478,31
"12841","RS","Cacequi",12423,26938.69,43018,"Santa Maria",4,"Sul",0,"430290",2,13,6,7,5,8,0,0,0,0,0,13,6,7,5,8,10,10.2013188222045,9.42730487221368,0.302776304599343,29
"12842","RS","Cacequi",12423,26938.69,43018,"Santa Maria",4,"Sul",0,"430290",3,7,3,4,3,4,0,0,0,0,0,7,3,4,3,4,8,10.2013188222045,9.42730487221368,0.407552745593782,31
"12843","RS","Cacequi",12423,26938.69,43018,"Santa Maria",4,"Sul",0,"430290",4,9,2,7,3,6,0,0,0,0,0,9,2,7,3,6,8,10.2013188222045,9.42730487221368,0.434212435285637,30
"12844","RS","Cacequi",12423,26938.69,43018,"Santa Maria",4,"Sul",0,"430290",5,12,4,8,2,10,0,0,0,0,0,12,4,8,2,10,7,10.2013188222045,9.42730487221368,0.428734017966611,31
"12845","RS","Cachoeira do Sul",81869,28528.77,43022,"Cachoeira do Sul",4,"Sul",1,"430300",2,77,17,60,23,54,0,0,0,0,0,77,17,60,23,54,65,10.258668330765,11.3128756878095,0.313478559830557,29
"12846","RS","Cachoeira do Sul",81869,28528.77,43022,"Cachoeira do Sul",4,"Sul",1,"430300",3,73,16,57,24,49,1,1,0,0,1,74,17,57,24,50,61,10.258668330765,11.3128756878095,0.408800447216963,31
"12847","RS","Cachoeira do Sul",81869,28528.77,43022,"Cachoeira do Sul",4,"Sul",1,"430300",4,81,25,56,25,56,0,0,0,0,0,81,25,56,25,56,59,10.258668330765,11.3128756878095,0.441473672359025,30
"12848","RS","Cachoeira do Sul",81869,28528.77,43022,"Cachoeira do Sul",4,"Sul",1,"430300",5,72,22,50,27,45,1,0,1,0,1,73,22,51,27,46,77,10.258668330765,11.3128756878095,0.420026550155383,31
"12849","RS","Cachoeirinha",131240,40778.59,43026,"Porto Alegre",4,"Sul",1,"430310",2,106,32,74,41,65,0,0,0,0,0,106,32,74,41,65,68,10.6159124677583,11.784782987075,0.300337981538303,29
"12850","RS","Cachoeirinha",131240,40778.59,43026,"Porto Alegre",4,"Sul",1,"430310",3,138,39,99,47,91,2,0,2,1,1,140,39,101,48,92,61,10.6159124677583,11.784782987075,0.412845444089434,31
"12851","RS","Cachoeirinha",131240,40778.59,43026,"Porto Alegre",4,"Sul",1,"430310",4,129,36,93,46,83,1,1,0,0,1,130,37,93,46,84,76,10.6159124677583,11.784782987075,0.469964948529596,30
"12852","RS","Cachoeirinha",131240,40778.59,43026,"Porto Alegre",4,"Sul",1,"430310",5,154,42,112,51,103,0,0,0,0,0,154,42,112,51,103,59,10.6159124677583,11.784782987075,0.408515887509959,31
"12853","RS","Camaquã",66478,30465.98,43028,"Camaquã",4,"Sul",1,"430350",2,60,16,44,24,36,1,0,1,1,0,61,16,45,25,36,41,10.3243659302269,11.1046263448409,0.295860431735786,29
"12854","RS","Camaquã",66478,30465.98,43028,"Camaquã",4,"Sul",1,"430350",3,67,25,42,23,44,0,0,0,0,0,67,25,42,23,44,43,10.3243659302269,11.1046263448409,0.404165706776261,31
"12855","RS","Camaquã",66478,30465.98,43028,"Camaquã",4,"Sul",1,"430350",4,75,27,48,30,45,0,0,0,0,0,75,27,48,30,45,33,10.3243659302269,11.1046263448409,0.432346934250616,30
"12856","RS","Camaquã",66478,30465.98,43028,"Camaquã",4,"Sul",1,"430350",5,56,18,38,22,34,1,1,0,0,1,57,19,38,22,35,44,10.3243659302269,11.1046263448409,0.399402554529342,31
"12857","RS","Campo Bom",69458,47163.5,43026,"Porto Alegre",4,"Sul",1,"430390",2,65,6,59,19,46,0,0,0,0,0,65,6,59,19,46,32,10.7613755673343,11.1484775323333,0.293442214552484,29
"12858","RS","Campo Bom",69458,47163.5,43026,"Porto Alegre",4,"Sul",1,"430390",3,71,10,61,20,51,1,1,0,0,1,72,11,61,20,52,34,10.7613755673343,11.1484775323333,0.410872853789327,31
"12859","RS","Campo Bom",69458,47163.5,43026,"Porto Alegre",4,"Sul",1,"430390",4,67,15,52,24,43,0,0,0,0,0,67,15,52,24,43,24,10.7613755673343,11.1484775323333,0.445584631252781,30
"12860","RS","Campo Bom",69458,47163.5,43026,"Porto Alegre",4,"Sul",1,"430390",5,59,11,48,17,42,0,0,0,0,0,59,11,48,17,42,42,10.7613755673343,11.1484775323333,0.386142699021232,31
"12861","RS","Candelária",31421,26579.24,43020,"Santa Cruz do Sul",4,"Sul",0,"430420",2,16,5,11,2,14,1,0,1,0,1,17,5,12,2,15,23,10.1878857389314,10.355231738165,0.297665567184508,29
"12862","RS","Candelária",31421,26579.24,43020,"Santa Cruz do Sul",4,"Sul",0,"430420",3,22,7,15,10,12,0,0,0,0,0,22,7,15,10,12,16,10.1878857389314,10.355231738165,0.397213001668964,31
"12863","RS","Candelária",31421,26579.24,43020,"Santa Cruz do Sul",4,"Sul",0,"430420",4,29,8,21,11,18,0,0,0,0,0,29,8,21,11,18,9,10.1878857389314,10.355231738165,0.429379593203362,30
"12864","RS","Candelária",31421,26579.24,43020,"Santa Cruz do Sul",4,"Sul",0,"430420",5,22,7,15,8,14,0,0,0,0,0,22,7,15,8,14,27,10.1878857389314,10.355231738165,0.411325432257556,31
"12865","RS","Candiota",9647,66192.85,43032,"Serras de Sudeste",4,"Sul",1,"430435",2,5,1,4,2,3,0,0,0,0,0,5,1,4,2,3,2,11.1003277300497,9.17440226517055,0.330906902457104,29
"12866","RS","Candiota",9647,66192.85,43032,"Serras de Sudeste",4,"Sul",1,"430435",3,13,6,7,5,8,0,0,0,0,0,13,6,7,5,8,9,11.1003277300497,9.17440226517055,0.402069803510248,31
"12867","RS","Candiota",9647,66192.85,43032,"Serras de Sudeste",4,"Sul",1,"430435",4,14,7,7,5,9,0,0,0,0,0,14,7,7,5,9,6,11.1003277300497,9.17440226517055,0.462561600734617,30
"12868","RS","Candiota",9647,66192.85,43032,"Serras de Sudeste",4,"Sul",1,"430435",5,8,5,3,6,2,0,0,0,0,0,8,5,3,6,2,6,11.1003277300497,9.17440226517055,0.432039693557477,31
"12869","RS","Canela",45488,25378.74,43024,"Gramado-Canela",4,"Sul",1,"430440",2,38,9,29,14,24,1,1,0,1,0,39,10,29,15,24,19,10.1416670946459,10.7252038338908,0.299173826845883,29
"12870","RS","Canela",45488,25378.74,43024,"Gramado-Canela",4,"Sul",1,"430440",3,60,16,44,17,43,0,0,0,0,0,60,16,44,17,43,26,10.1416670946459,10.7252038338908,0.411445722457135,31
"12871","RS","Canela",45488,25378.74,43024,"Gramado-Canela",4,"Sul",1,"430440",4,65,25,40,25,40,0,0,0,0,0,65,25,40,25,40,21,10.1416670946459,10.7252038338908,0.456479851096232,30
"12872","RS","Canela",45488,25378.74,43024,"Gramado-Canela",4,"Sul",1,"430440",5,65,20,45,26,39,1,0,1,0,1,66,20,46,26,40,32,10.1416670946459,10.7252038338908,0.424502287729315,31
"12873","RS","Canguçu",56211,19932.46,43033,"Pelotas",4,"Sul",0,"430450",2,38,20,18,8,30,0,0,0,0,0,38,20,18,8,30,29,9.90010483760178,10.9368677462666,0.310640495012781,29
"12874","RS","Canguçu",56211,19932.46,43033,"Pelotas",4,"Sul",0,"430450",3,49,30,19,10,39,1,0,1,0,1,50,30,20,10,40,43,9.90010483760178,10.9368677462666,0.406625544745371,31
"12875","RS","Canguçu",56211,19932.46,43033,"Pelotas",4,"Sul",0,"430450",4,39,18,21,14,25,0,0,0,0,0,39,18,21,14,25,41,9.90010483760178,10.9368677462666,0.442993951148545,30
"12876","RS","Canguçu",56211,19932.46,43033,"Pelotas",4,"Sul",0,"430450",5,43,17,26,16,27,0,0,0,0,0,43,17,26,16,27,42,9.90010483760178,10.9368677462666,0.430343958322878,31
"12877","RS","Canoas",348208,55594.2,43026,"Porto Alegre",4,"Sul",1,"430460",2,305,82,223,108,197,2,0,2,1,1,307,82,225,109,198,198,10.9258341582506,12.7605552813538,0.307013660477948,29
"12878","RS","Canoas",348208,55594.2,43026,"Porto Alegre",4,"Sul",1,"430460",3,352,91,261,108,244,5,1,4,4,1,357,92,265,112,245,195,10.9258341582506,12.7605552813538,0.420742975245245,31
"12879","RS","Canoas",348208,55594.2,43026,"Porto Alegre",4,"Sul",1,"430460",4,391,114,277,130,261,2,1,1,0,2,393,115,278,130,263,182,10.9258341582506,12.7605552813538,0.483884352969822,30
"12880","RS","Canoas",348208,55594.2,43026,"Porto Alegre",4,"Sul",1,"430460",5,363,94,269,116,247,2,1,1,1,1,365,95,270,117,248,215,10.9258341582506,12.7605552813538,0.422235117316632,31
"12881","RS","Capão da Canoa",54051,27586.32,43027,"Osório",4,"Sul",1,"430463",2,60,23,37,21,39,0,0,0,0,0,60,23,37,21,39,31,10.2250752766552,10.8976833242838,0.315404364119694,29
"12882","RS","Capão da Canoa",54051,27586.32,43027,"Osório",4,"Sul",1,"430463",3,84,29,55,35,49,0,0,0,0,0,84,29,55,35,49,31,10.2250752766552,10.8976833242838,0.440903163510129,31
"12883","RS","Capão da Canoa",54051,27586.32,43027,"Osório",4,"Sul",1,"430463",4,67,34,33,31,36,0,0,0,0,0,67,34,33,31,36,33,10.2250752766552,10.8976833242838,0.477708775389348,30
"12884","RS","Capão da Canoa",54051,27586.32,43027,"Osório",4,"Sul",1,"430463",5,70,31,39,26,44,2,1,1,1,1,72,32,40,27,45,27,10.2250752766552,10.8976833242838,0.417833777728388,31
"12885","RS","Capão do Leão",25409,20071.27,43033,"Pelotas",4,"Sul",1,"430466",2,32,14,18,11,21,0,0,0,0,0,32,14,18,11,21,22,9.90704471831354,10.142858720955,0.337357371542372,29
"12886","RS","Capão do Leão",25409,20071.27,43033,"Pelotas",4,"Sul",1,"430466",3,28,14,14,7,21,0,0,0,0,0,28,14,14,7,21,14,9.90704471831354,10.142858720955,0.436028916373739,31
"12887","RS","Capão do Leão",25409,20071.27,43033,"Pelotas",4,"Sul",1,"430466",4,23,7,16,11,12,0,0,0,0,0,23,7,16,11,12,6,9.90704471831354,10.142858720955,0.46611730529957,30
"12888","RS","Capão do Leão",25409,20071.27,43033,"Pelotas",4,"Sul",1,"430466",5,31,12,19,11,20,0,0,0,0,0,31,12,19,11,20,18,9.90704471831354,10.142858720955,0.440443901923155,31
"12889","RS","Capela de Santana",12064,17164.57,43023,"Montenegro",4,"Sul",1,"430468",2,6,0,6,2,4,0,0,0,0,0,6,0,6,2,4,7,9.75060265460219,9.39798109024774,0.328241621885337,29
"12890","RS","Capela de Santana",12064,17164.57,43023,"Montenegro",4,"Sul",1,"430468",3,5,1,4,3,2,0,0,0,0,0,5,1,4,3,2,6,9.75060265460219,9.39798109024774,0.414653998342662,31
"12891","RS","Capela de Santana",12064,17164.57,43023,"Montenegro",4,"Sul",1,"430468",4,14,5,9,6,8,0,0,0,0,0,14,5,9,6,8,6,9.75060265460219,9.39798109024774,0.449981152286557,30
"12892","RS","Capela de Santana",12064,17164.57,43023,"Montenegro",4,"Sul",1,"430468",5,3,1,2,1,2,0,0,0,0,0,3,1,2,1,2,5,9.75060265460219,9.39798109024774,0.403261142534407,31
"12893","RS","Carazinho",62265,48591.24,43009,"Carazinho",4,"Sul",1,"430470",2,56,15,41,15,41,0,0,0,0,0,56,15,41,15,41,44,10.7911985467286,11.0391547491552,0.314470164817543,29
"12894","RS","Carazinho",62265,48591.24,43009,"Carazinho",4,"Sul",1,"430470",3,64,16,48,26,38,0,0,0,0,0,64,16,48,26,38,48,10.7911985467286,11.0391547491552,0.422642690779232,31
"12895","RS","Carazinho",62265,48591.24,43009,"Carazinho",4,"Sul",1,"430470",4,67,13,54,24,43,1,0,1,0,1,68,13,55,24,44,42,10.7911985467286,11.0391547491552,0.456193639482249,30
"12896","RS","Carazinho",62265,48591.24,43009,"Carazinho",4,"Sul",1,"430470",5,72,21,51,26,46,0,0,0,0,0,72,21,51,26,46,50,10.7911985467286,11.0391547491552,0.424505605906819,31
"12897","RS","Carlos Barbosa",30241,85997.12,43016,"Caxias do Sul",4,"Sul",1,"430480",2,20,2,18,2,18,1,1,0,0,1,21,3,18,2,19,14,11.3620690863028,10.3169538985298,0.281160704325832,29
"12898","RS","Carlos Barbosa",30241,85997.12,43016,"Caxias do Sul",4,"Sul",1,"430480",3,27,4,23,4,23,1,0,1,0,1,28,4,24,4,24,10,11.3620690863028,10.3169538985298,0.410014862445702,31
"12899","RS","Carlos Barbosa",30241,85997.12,43016,"Caxias do Sul",4,"Sul",1,"430480",4,21,1,20,2,19,0,0,0,0,0,21,1,20,2,19,4,11.3620690863028,10.3169538985298,0.426674712615645,30
"12900","RS","Carlos Barbosa",30241,85997.12,43016,"Caxias do Sul",4,"Sul",1,"430480",5,23,3,20,4,19,0,0,0,0,0,23,3,20,4,19,13,11.3620690863028,10.3169538985298,0.394266990095104,31
"12901","RS","Caxias do Sul",517451,48959.4,43016,"Caxias do Sul",4,"Sul",1,"430510",2,416,82,334,130,286,1,1,0,0,1,417,83,334,130,287,221,10.7987466622092,13.1566701136483,0.298651898249295,29
"12902","RS","Caxias do Sul",517451,48959.4,43016,"Caxias do Sul",4,"Sul",1,"430510",3,442,98,344,135,307,3,1,2,0,3,445,99,346,135,310,240,10.7987466622092,13.1566701136483,0.424435663957281,31
"12903","RS","Caxias do Sul",517451,48959.4,43016,"Caxias do Sul",4,"Sul",1,"430510",4,385,76,309,118,267,1,0,1,0,1,386,76,310,118,268,231,10.7987466622092,13.1566701136483,0.46536763707565,30
"12904","RS","Caxias do Sul",517451,48959.4,43016,"Caxias do Sul",4,"Sul",1,"430510",5,492,109,383,147,345,2,2,0,0,2,494,111,383,147,347,248,10.7987466622092,13.1566701136483,0.40949682365545,31
"12905","RS","Cerro Largo",14189,52173.65,43006,"Cerro Largo",4,"Sul",0,"430520",2,7,1,6,3,4,0,0,0,0,0,7,1,6,3,4,5,10.8623328571497,9.56022229550731,0.300844859296046,29
"12906","RS","Cerro Largo",14189,52173.65,43006,"Cerro Largo",4,"Sul",0,"430520",3,14,0,14,3,11,0,0,0,0,0,14,0,14,3,11,11,10.8623328571497,9.56022229550731,0.388129656388271,31
"12907","RS","Cerro Largo",14189,52173.65,43006,"Cerro Largo",4,"Sul",0,"430520",4,12,4,8,5,7,0,0,0,0,0,12,4,8,5,7,16,10.8623328571497,9.56022229550731,0.419509221669055,30
"12908","RS","Cerro Largo",14189,52173.65,43006,"Cerro Largo",4,"Sul",0,"430520",5,14,6,8,3,11,0,0,0,0,0,14,6,8,3,11,11,10.8623328571497,9.56022229550731,0.379054020494601,31
"12909","RS","Charqueadas",41258,42460.28,43025,"São Jerônimo",4,"Sul",1,"430535",2,17,3,14,9,8,0,0,0,0,0,17,3,14,9,8,15,10.6563243296773,10.627600312353,0.306310553881634,29
"12910","RS","Charqueadas",41258,42460.28,43025,"São Jerônimo",4,"Sul",1,"430535",3,19,4,15,4,15,0,0,0,0,0,19,4,15,4,15,21,10.6563243296773,10.627600312353,0.417197886622413,31
"12911","RS","Charqueadas",41258,42460.28,43025,"São Jerônimo",4,"Sul",1,"430535",4,20,2,18,9,11,0,0,0,0,0,20,2,18,9,11,26,10.6563243296773,10.627600312353,0.478185007866522,30
"12912","RS","Charqueadas",41258,42460.28,43025,"São Jerônimo",4,"Sul",1,"430535",5,31,6,25,16,15,0,0,0,0,0,31,6,25,16,15,21,10.6563243296773,10.627600312353,0.426784357220521,31
"12913","RS","Cidreira",16583,17575.91,43027,"Osório",4,"Sul",0,"430545",2,17,8,9,6,11,0,0,0,0,0,17,8,9,6,11,6,9.77428449343231,9.7161333532141,0.329307511471925,29
"12914","RS","Cidreira",16583,17575.91,43027,"Osório",4,"Sul",0,"430545",3,13,5,8,3,10,0,0,0,0,0,13,5,8,3,10,6,9.77428449343231,9.7161333532141,0.472086111493735,31
"12915","RS","Cidreira",16583,17575.91,43027,"Osório",4,"Sul",0,"430545",4,17,9,8,7,10,0,0,0,0,0,17,9,8,7,10,12,9.77428449343231,9.7161333532141,0.502457384637935,30
"12916","RS","Cidreira",16583,17575.91,43027,"Osório",4,"Sul",0,"430545",5,13,5,8,5,8,0,0,0,0,0,13,5,8,5,8,15,9.77428449343231,9.7161333532141,0.474521371013567,31
"12917","RS","Constantina",9907,30642.99,43003,"Frederico Westphalen",4,"Sul",0,"430580",2,4,1,3,2,2,0,0,0,0,0,4,1,3,2,2,4,10.3301592039498,9.20099685697303,0.318206452851759,29
"12918","RS","Constantina",9907,30642.99,43003,"Frederico Westphalen",4,"Sul",0,"430580",3,9,3,6,1,8,0,0,0,0,0,9,3,6,1,8,5,10.3301592039498,9.20099685697303,0.38584831092154,31
"12919","RS","Constantina",9907,30642.99,43003,"Frederico Westphalen",4,"Sul",0,"430580",4,6,0,6,3,3,0,0,0,0,0,6,0,6,3,3,7,10.3301592039498,9.20099685697303,0.414910394812032,30
"12920","RS","Constantina",9907,30642.99,43003,"Frederico Westphalen",4,"Sul",0,"430580",5,6,2,4,3,3,0,0,0,0,0,6,2,4,3,3,11,10.3301592039498,9.20099685697303,0.402705642058792,31
"12921","RS","Crissiumal",13357,25509.72,43002,"Três Passos",4,"Sul",0,"430600",2,10,3,7,2,8,0,0,0,0,0,10,3,7,2,8,5,10.1468148349878,9.49979587097711,0.310276469259389,29
"12922","RS","Crissiumal",13357,25509.72,43002,"Três Passos",4,"Sul",0,"430600",3,8,2,6,2,6,0,0,0,0,0,8,2,6,2,6,11,10.1468148349878,9.49979587097711,0.391646594064426,31
"12923","RS","Crissiumal",13357,25509.72,43002,"Três Passos",4,"Sul",0,"430600",4,3,1,2,0,3,0,0,0,0,0,3,1,2,0,3,4,10.1468148349878,9.49979587097711,0.356390577738085,30
"12924","RS","Crissiumal",13357,25509.72,43002,"Três Passos",4,"Sul",0,"430600",5,9,4,5,3,6,0,0,0,0,0,9,4,5,3,6,17,10.1468148349878,9.49979587097711,0.384915266691164,31
"12925","RS","Cruz Alta",59922,65065.59,43011,"Cruz Alta",4,"Sul",1,"430610",2,43,8,35,14,29,0,0,0,0,0,43,8,35,14,29,32,11.083151117025,11.0007989954712,0.312559799294949,29
"12926","RS","Cruz Alta",59922,65065.59,43011,"Cruz Alta",4,"Sul",1,"430610",3,68,19,49,29,39,0,0,0,0,0,68,19,49,29,39,47,11.083151117025,11.0007989954712,0.407545487839948,31
"12927","RS","Cruz Alta",59922,65065.59,43011,"Cruz Alta",4,"Sul",1,"430610",4,67,23,44,23,44,1,0,1,0,1,68,23,45,23,45,40,11.083151117025,11.0007989954712,0.453500672869793,30
"12928","RS","Cruz Alta",59922,65065.59,43011,"Cruz Alta",4,"Sul",1,"430610",5,64,17,47,26,38,1,0,1,1,0,65,17,48,27,38,47,11.083151117025,11.0007989954712,0.414568441982401,31
"12929","RS","Cruzeiro do Sul",12402,29050.27,43021,"Lajeado-Estrela",4,"Sul",1,"430620",2,10,4,6,3,7,0,0,0,0,0,10,4,6,3,7,12,10.276783056557,9.42561302890982,0.321991236599611,29
"12930","RS","Cruzeiro do Sul",12402,29050.27,43021,"Lajeado-Estrela",4,"Sul",1,"430620",3,8,1,7,2,6,0,0,0,0,0,8,1,7,2,6,5,10.276783056557,9.42561302890982,0.414553272658022,31
"12931","RS","Cruzeiro do Sul",12402,29050.27,43021,"Lajeado-Estrela",4,"Sul",1,"430620",4,7,4,3,2,5,0,0,0,0,0,7,4,3,2,5,11,10.276783056557,9.42561302890982,0.434898293285324,30
"12932","RS","Cruzeiro do Sul",12402,29050.27,43021,"Lajeado-Estrela",4,"Sul",1,"430620",5,10,5,5,5,5,0,0,0,0,0,10,5,5,5,5,14,10.276783056557,9.42561302890982,0.454593710273816,31
"12933","RS","Dois Irmãos",33119,62157.03,43024,"Gramado-Canela",4,"Sul",1,"430640",2,28,1,27,8,20,0,0,0,0,0,28,1,27,8,20,5,11.0374192039773,10.4078624148067,0.295379834454106,29
"12934","RS","Dois Irmãos",33119,62157.03,43024,"Gramado-Canela",4,"Sul",1,"430640",3,30,10,20,8,22,0,0,0,0,0,30,10,20,8,22,14,11.0374192039773,10.4078624148067,0.414292047643106,31
"12935","RS","Dois Irmãos",33119,62157.03,43024,"Gramado-Canela",4,"Sul",1,"430640",4,17,2,15,3,14,0,0,0,0,0,17,2,15,3,14,14,11.0374192039773,10.4078624148067,0.455720898541773,30
"12936","RS","Dois Irmãos",33119,62157.03,43024,"Gramado-Canela",4,"Sul",1,"430640",5,31,7,24,9,22,0,0,0,0,0,31,7,24,9,22,22,11.0374192039773,10.4078624148067,0.391103309880932,31
"12937","RS","Dom Feliciano",15487,15501.61,43028,"Camaquã",4,"Sul",0,"430650",2,6,2,4,2,4,0,0,0,0,0,6,2,4,2,4,11,9.64869916848087,9.64775624131618,0.359131004855985,29
"12938","RS","Dom Feliciano",15487,15501.61,43028,"Camaquã",4,"Sul",0,"430650",3,13,6,7,5,8,0,0,0,0,0,13,6,7,5,8,15,9.64869916848087,9.64775624131618,0.459493241311657,31
"12939","RS","Dom Feliciano",15487,15501.61,43028,"Camaquã",4,"Sul",0,"430650",4,14,10,4,7,7,0,0,0,0,0,14,10,4,7,7,14,9.64869916848087,9.64775624131618,0.473528258134812,30
"12940","RS","Dom Feliciano",15487,15501.61,43028,"Camaquã",4,"Sul",0,"430650",5,11,8,3,5,6,0,0,0,0,0,11,8,3,5,6,6,9.64869916848087,9.64775624131618,0.461537382676392,31
"12941","RS","Dom Pedrito",38339,34347.33,43031,"Campanha Meridional",4,"Sul",1,"430660",2,23,10,13,9,14,0,0,0,0,0,23,10,13,9,14,32,10.4442795653718,10.554222933839,0.297801359154984,29
"12942","RS","Dom Pedrito",38339,34347.33,43031,"Campanha Meridional",4,"Sul",1,"430660",3,41,13,28,21,20,0,0,0,0,0,41,13,28,21,20,25,10.4442795653718,10.554222933839,0.373104530559587,31
"12943","RS","Dom Pedrito",38339,34347.33,43031,"Campanha Meridional",4,"Sul",1,"430660",4,27,12,15,12,15,0,0,0,0,0,27,12,15,12,15,22,10.4442795653718,10.554222933839,0.397348196366206,30
"12944","RS","Dom Pedrito",38339,34347.33,43031,"Campanha Meridional",4,"Sul",1,"430660",5,33,10,23,14,19,0,0,0,0,0,33,10,23,14,19,32,10.4442795653718,10.554222933839,0.359464110615452,31
"12945","RS","Eldorado do Sul",41902,39551.13,43026,"Porto Alegre",4,"Sul",1,"430676",2,37,16,21,14,23,1,0,1,1,0,38,16,22,15,23,26,10.5853495442162,10.643088837468,0.306192705641223,29
"12946","RS","Eldorado do Sul",41902,39551.13,43026,"Porto Alegre",4,"Sul",1,"430676",3,41,14,27,15,26,0,0,0,0,0,41,14,27,15,26,14,10.5853495442162,10.643088837468,0.410442895372216,31
"12947","RS","Eldorado do Sul",41902,39551.13,43026,"Porto Alegre",4,"Sul",1,"430676",4,44,20,24,20,24,0,0,0,0,0,44,20,24,20,24,15,10.5853495442162,10.643088837468,0.471943738752795,30
"12948","RS","Eldorado do Sul",41902,39551.13,43026,"Porto Alegre",4,"Sul",1,"430676",5,49,12,37,17,32,0,0,0,0,0,49,12,37,17,32,20,10.5853495442162,10.643088837468,0.420472691867699,31
"12949","RS","Encantado",22880,39380.74,43021,"Lajeado-Estrela",4,"Sul",1,"430680",2,26,7,19,7,19,0,0,0,0,0,26,7,19,7,19,16,10.5810321432812,10.0380184454937,0.297704549130217,29
"12950","RS","Encantado",22880,39380.74,43021,"Lajeado-Estrela",4,"Sul",1,"430680",3,22,4,18,5,17,0,0,0,0,0,22,4,18,5,17,10,10.5810321432812,10.0380184454937,0.390727186803093,31
"12951","RS","Encantado",22880,39380.74,43021,"Lajeado-Estrela",4,"Sul",1,"430680",4,15,4,11,4,11,0,0,0,0,0,15,4,11,4,11,15,10.5810321432812,10.0380184454937,0.435797126753722,30
"12952","RS","Encantado",22880,39380.74,43021,"Lajeado-Estrela",4,"Sul",1,"430680",5,21,6,15,6,15,0,0,0,0,0,21,6,15,6,15,16,10.5810321432812,10.0380184454937,0.402013419996212,31
"12953","RS","Encruzilhada do Sul",25960,20766.94,43032,"Serras de Sudeste",4,"Sul",0,"430690",2,16,7,9,7,9,0,0,0,0,0,16,7,9,7,9,20,9.9411175781396,10.164312170818,0.297220815154325,29
"12954","RS","Encruzilhada do Sul",25960,20766.94,43032,"Serras de Sudeste",4,"Sul",0,"430690",3,19,8,11,8,11,0,0,0,0,0,19,8,11,8,11,20,9.9411175781396,10.164312170818,0.376056079373696,31
"12955","RS","Encruzilhada do Sul",25960,20766.94,43032,"Serras de Sudeste",4,"Sul",0,"430690",4,21,9,12,11,10,0,0,0,0,0,21,9,12,11,10,16,9.9411175781396,10.164312170818,0.433638305233122,30
"12956","RS","Encruzilhada do Sul",25960,20766.94,43032,"Serras de Sudeste",4,"Sul",0,"430690",5,22,10,12,11,11,0,0,0,0,0,22,10,12,11,11,12,9.9411175781396,10.164312170818,0.403910538770089,31
"12957","RS","Entre-Ijuís",8411,47488.62,43007,"Santo Ângelo",4,"Sul",1,"430693",2,3,0,3,1,2,0,0,0,0,0,3,0,3,1,2,7,10.7682453823717,9.03729565196244,0.341145493555987,29
"12958","RS","Entre-Ijuís",8411,47488.62,43007,"Santo Ângelo",4,"Sul",1,"430693",3,15,5,10,5,10,0,0,0,0,0,15,5,10,5,10,9,10.7682453823717,9.03729565196244,0.379230102443299,31
"12959","RS","Entre-Ijuís",8411,47488.62,43007,"Santo Ângelo",4,"Sul",1,"430693",4,4,1,3,0,4,0,0,0,0,0,4,1,3,0,4,5,10.7682453823717,9.03729565196244,0.414626754683247,30
"12960","RS","Entre-Ijuís",8411,47488.62,43007,"Santo Ângelo",4,"Sul",1,"430693",5,5,2,3,2,3,0,0,0,0,0,5,2,3,2,3,6,10.7682453823717,9.03729565196244,0.428610887663029,31
"12961","RS","Erechim",106633,47080.69,43004,"Erechim",4,"Sul",1,"430700",2,82,18,64,17,65,0,0,0,0,0,82,18,64,17,65,41,10.7596182171717,11.5771483112877,0.309153916695888,29
"12962","RS","Erechim",106633,47080.69,43004,"Erechim",4,"Sul",1,"430700",3,101,14,87,25,76,1,1,0,0,1,102,15,87,25,77,56,10.7596182171717,11.5771483112877,0.425107297300708,31
"12963","RS","Erechim",106633,47080.69,43004,"Erechim",4,"Sul",1,"430700",4,104,12,92,25,79,1,1,0,1,0,105,13,92,26,79,57,10.7596182171717,11.5771483112877,0.445072735309003,30
"12964","RS","Erechim",106633,47080.69,43004,"Erechim",4,"Sul",1,"430700",5,94,22,72,25,69,0,0,0,0,0,94,22,72,25,69,51,10.7596182171717,11.5771483112877,0.417678692797701,31
"12965","RS","Espumoso",15591,49684.93,43011,"Cruz Alta",4,"Sul",0,"430750",2,14,4,10,8,6,1,0,1,0,1,15,4,11,8,7,4,10.8134569467886,9.65444910367655,0.32177670173223,29
"12966","RS","Espumoso",15591,49684.93,43011,"Cruz Alta",4,"Sul",0,"430750",3,6,1,5,3,3,0,0,0,0,0,6,1,5,3,3,8,10.8134569467886,9.65444910367655,0.402066263298763,31
"12967","RS","Espumoso",15591,49684.93,43011,"Cruz Alta",4,"Sul",0,"430750",4,14,5,9,6,8,0,0,0,0,0,14,5,9,6,8,12,10.8134569467886,9.65444910367655,0.456117894380863,30
"12968","RS","Espumoso",15591,49684.93,43011,"Cruz Alta",4,"Sul",0,"430750",5,17,4,13,6,11,0,0,0,0,0,17,4,13,6,11,8,10.8134569467886,9.65444910367655,0.421111097983985,31
"12969","RS","Estância Velha",50672,29630.14,43026,"Porto Alegre",4,"Sul",1,"430760",2,39,11,28,10,29,0,0,0,0,0,39,11,28,10,29,19,10.2965473654974,10.8331287687784,0.296468510716294,29
"12970","RS","Estância Velha",50672,29630.14,43026,"Porto Alegre",4,"Sul",1,"430760",3,41,12,29,11,30,0,0,0,0,0,41,12,29,11,30,21,10.2965473654974,10.8331287687784,0.414763758682567,31
"12971","RS","Estância Velha",50672,29630.14,43026,"Porto Alegre",4,"Sul",1,"430760",4,50,8,42,12,38,2,1,1,1,1,52,9,43,13,39,25,10.2965473654974,10.8331287687784,0.452610906507936,30
"12972","RS","Estância Velha",50672,29630.14,43026,"Porto Alegre",4,"Sul",1,"430760",5,39,3,36,9,30,0,0,0,0,0,39,3,36,9,30,18,10.2965473654974,10.8331287687784,0.395707612698609,31
"12973","RS","Esteio",83279,38249.4,43026,"Porto Alegre",4,"Sul",1,"430770",2,75,14,61,26,49,0,0,0,0,0,75,14,61,26,49,46,10.5518831528571,11.3299516955318,0.310711806443193,29
"12974","RS","Esteio",83279,38249.4,43026,"Porto Alegre",4,"Sul",1,"430770",3,81,18,63,31,50,1,1,0,1,0,82,19,63,32,50,40,10.5518831528571,11.3299516955318,0.417697966862489,31
"12975","RS","Esteio",83279,38249.4,43026,"Porto Alegre",4,"Sul",1,"430770",4,80,19,61,21,59,0,0,0,0,0,80,19,61,21,59,49,10.5518831528571,11.3299516955318,0.478305108263317,30
"12976","RS","Esteio",83279,38249.4,43026,"Porto Alegre",4,"Sul",1,"430770",5,64,15,49,23,41,0,0,0,0,0,64,15,49,23,41,45,10.5518831528571,11.3299516955318,0.423565681576915,31
"12977","RS","Estrela",34399,43585.52,43021,"Lajeado-Estrela",4,"Sul",1,"430780",2,21,5,16,9,12,0,0,0,0,0,21,5,16,9,12,16,10.6824802640846,10.4457827731715,0.294115047397909,29
"12978","RS","Estrela",34399,43585.52,43021,"Lajeado-Estrela",4,"Sul",1,"430780",3,33,7,26,7,26,0,0,0,0,0,33,7,26,7,26,21,10.6824802640846,10.4457827731715,0.413787237632724,31
"12979","RS","Estrela",34399,43585.52,43021,"Lajeado-Estrela",4,"Sul",1,"430780",4,38,11,27,14,24,0,0,0,0,0,38,11,27,14,24,17,10.6824802640846,10.4457827731715,0.45027592496204,30
"12980","RS","Estrela",34399,43585.52,43021,"Lajeado-Estrela",4,"Sul",1,"430780",5,34,4,30,8,26,0,0,0,0,0,34,4,30,8,26,17,10.6824802640846,10.4457827731715,0.423563298286175,31
"12981","RS","Farroupilha",73061,47878.78,43016,"Caxias do Sul",4,"Sul",1,"430790",2,67,6,61,15,52,0,0,0,0,0,67,6,61,15,52,29,10.7764276789797,11.1990499876358,0.302712593598022,29
"12982","RS","Farroupilha",73061,47878.78,43016,"Caxias do Sul",4,"Sul",1,"430790",3,66,15,51,15,51,0,0,0,0,0,66,15,51,15,51,41,10.7764276789797,11.1990499876358,0.416335074778718,31
"12983","RS","Farroupilha",73061,47878.78,43016,"Caxias do Sul",4,"Sul",1,"430790",4,72,8,64,19,53,0,0,0,0,0,72,8,64,19,53,36,10.7764276789797,11.1990499876358,0.451062462222742,30
"12984","RS","Farroupilha",73061,47878.78,43016,"Caxias do Sul",4,"Sul",1,"430790",5,60,9,51,20,40,1,1,0,1,0,61,10,51,21,40,42,10.7764276789797,11.1990499876358,0.408276347905302,31
"12985","RS","Feliz",13640,31408.48,43023,"Montenegro",4,"Sul",0,"430810",2,18,3,15,2,16,0,0,0,0,0,18,3,15,2,16,11,10.35483319913,9.52076193139745,0.297524584124305,29
"12986","RS","Feliz",13640,31408.48,43023,"Montenegro",4,"Sul",0,"430810",3,6,2,4,3,3,0,0,0,0,0,6,2,4,3,3,8,10.35483319913,9.52076193139745,0.384462970546296,31
"12987","RS","Feliz",13640,31408.48,43023,"Montenegro",4,"Sul",0,"430810",4,13,3,10,2,11,0,0,0,0,0,13,3,10,2,11,9,10.35483319913,9.52076193139745,0.411357262882141,30
"12988","RS","Feliz",13640,31408.48,43023,"Montenegro",4,"Sul",0,"430810",5,12,3,9,3,9,0,0,0,0,0,12,3,9,3,9,7,10.35483319913,9.52076193139745,0.402321624123051,31
"12989","RS","Flores da Cunha",31063,53356.89,43016,"Caxias do Sul",4,"Sul",0,"430820",2,27,9,18,4,23,0,0,0,0,0,27,9,18,4,23,21,10.8847583955326,10.3437726792889,0.315610144152876,29
"12990","RS","Flores da Cunha",31063,53356.89,43016,"Caxias do Sul",4,"Sul",0,"430820",3,29,6,23,9,20,0,0,0,0,0,29,6,23,9,20,11,10.8847583955326,10.3437726792889,0.435292413113586,31
"12991","RS","Flores da Cunha",31063,53356.89,43016,"Caxias do Sul",4,"Sul",0,"430820",4,26,5,21,7,19,0,0,0,0,0,26,5,21,7,19,12,10.8847583955326,10.3437726792889,0.44781325193375,30
"12992","RS","Flores da Cunha",31063,53356.89,43016,"Caxias do Sul",4,"Sul",0,"430820",5,34,6,28,10,24,0,0,0,0,0,34,6,28,10,24,13,10.8847583955326,10.3437726792889,0.397410310956874,31
"12993","RS","Frederico Westphalen",31498,36706.92,43003,"Frederico Westphalen",4,"Sul",1,"430850",2,31,11,20,11,20,0,0,0,0,0,31,11,20,11,20,18,10.5107205721266,10.3576793307345,0.302128740405374,29
"12994","RS","Frederico Westphalen",31498,36706.92,43003,"Frederico Westphalen",4,"Sul",1,"430850",3,33,14,19,6,27,1,0,1,0,1,34,14,20,6,28,23,10.5107205721266,10.3576793307345,0.406221618888422,31
"12995","RS","Frederico Westphalen",31498,36706.92,43003,"Frederico Westphalen",4,"Sul",1,"430850",4,26,6,20,7,19,1,0,1,1,0,27,6,21,8,19,16,10.5107205721266,10.3576793307345,0.428933477937989,30
"12996","RS","Frederico Westphalen",31498,36706.92,43003,"Frederico Westphalen",4,"Sul",1,"430850",5,41,8,33,12,29,0,0,0,0,0,41,8,33,12,29,13,10.5107205721266,10.3576793307345,0.425723632371476,31
"12997","RS","Garibaldi",35440,59883.3,43016,"Caxias do Sul",4,"Sul",1,"430860",2,33,3,30,3,30,1,0,1,0,1,34,3,31,3,31,15,11.0001529472355,10.475596404719,0.291192177649093,29
"12998","RS","Garibaldi",35440,59883.3,43016,"Caxias do Sul",4,"Sul",1,"430860",3,33,8,25,12,21,0,0,0,0,0,33,8,25,12,21,15,11.0001529472355,10.475596404719,0.417491165330191,31
"12999","RS","Garibaldi",35440,59883.3,43016,"Caxias do Sul",4,"Sul",1,"430860",4,23,7,16,7,16,0,0,0,0,0,23,7,16,7,16,13,11.0001529472355,10.475596404719,0.429304737377003,30
"13000","RS","Garibaldi",35440,59883.3,43016,"Caxias do Sul",4,"Sul",1,"430860",5,30,3,27,5,25,0,0,0,0,0,30,3,27,5,25,24,11.0001529472355,10.475596404719,0.388731401267996,31
"13001","RS","Getúlio Vargas",16184,34152.09,43004,"Erechim",4,"Sul",1,"430890",2,19,5,14,3,16,0,0,0,0,0,19,5,14,3,16,13,10.4385790637119,9.69177837884758,0.331736492832252,29
"13002","RS","Getúlio Vargas",16184,34152.09,43004,"Erechim",4,"Sul",1,"430890",3,12,3,9,4,8,0,0,0,0,0,12,3,9,4,8,5,10.4385790637119,9.69177837884758,0.432805664627091,31
"13003","RS","Getúlio Vargas",16184,34152.09,43004,"Erechim",4,"Sul",1,"430890",4,14,4,10,3,11,0,0,0,0,0,14,4,10,3,11,8,10.4385790637119,9.69177837884758,0.458649996875549,30
"13004","RS","Getúlio Vargas",16184,34152.09,43004,"Erechim",4,"Sul",1,"430890",5,10,2,8,3,7,0,0,0,0,0,10,2,8,3,7,12,10.4385790637119,9.69177837884758,0.431779834685487,31
"13005","RS","Giruá",15863,48599.82,43007,"Santo Ângelo",4,"Sul",0,"430900",2,17,5,12,2,15,0,0,0,0,0,17,5,12,2,15,9,10.791375106178,9.67174463240845,0.323411919204743,29
"13006","RS","Giruá",15863,48599.82,43007,"Santo Ângelo",4,"Sul",0,"430900",3,16,2,14,7,9,0,0,0,0,0,16,2,14,7,9,14,10.791375106178,9.67174463240845,0.41974951593225,31
"13007","RS","Giruá",15863,48599.82,43007,"Santo Ângelo",4,"Sul",0,"430900",4,11,0,11,3,8,1,0,1,0,1,12,0,12,3,9,13,10.791375106178,9.67174463240845,0.419161073527982,30
"13008","RS","Giruá",15863,48599.82,43007,"Santo Ângelo",4,"Sul",0,"430900",5,9,4,5,1,8,0,0,0,0,0,9,4,5,1,8,17,10.791375106178,9.67174463240845,0.420659933193947,31
"13009","RS","Glorinha",8204,41243.59,43026,"Porto Alegre",4,"Sul",1,"430905",2,2,0,2,0,2,0,0,0,0,0,2,0,2,0,2,3,10.6272509857485,9.01237711919227,0.305435308095374,29
"13010","RS","Glorinha",8204,41243.59,43026,"Porto Alegre",4,"Sul",1,"430905",3,4,1,3,1,3,0,0,0,0,0,4,1,3,1,3,7,10.6272509857485,9.01237711919227,0.390321710058278,31
"13011","RS","Glorinha",8204,41243.59,43026,"Porto Alegre",4,"Sul",1,"430905",4,10,2,8,2,8,0,0,0,0,0,10,2,8,2,8,5,10.6272509857485,9.01237711919227,0.4434118111856,30
"13012","RS","Glorinha",8204,41243.59,43026,"Porto Alegre",4,"Sul",1,"430905",5,8,2,6,1,7,0,0,0,0,0,8,2,6,1,7,3,10.6272509857485,9.01237711919227,0.404516470762111,31
"13013","RS","Gramado",36555,54901.17,43024,"Gramado-Canela",4,"Sul",1,"430910",2,37,8,29,12,25,1,0,1,0,1,38,8,30,12,26,25,10.9132899387459,10.5065732547274,0.29440126478112,29
"13014","RS","Gramado",36555,54901.17,43024,"Gramado-Canela",4,"Sul",1,"430910",3,42,7,35,16,26,0,0,0,0,0,42,7,35,16,26,19,10.9132899387459,10.5065732547274,0.428067202501508,31
"13015","RS","Gramado",36555,54901.17,43024,"Gramado-Canela",4,"Sul",1,"430910",4,42,6,36,12,30,0,0,0,0,0,42,6,36,12,30,15,10.9132899387459,10.5065732547274,0.473886140876333,30
"13016","RS","Gramado",36555,54901.17,43024,"Gramado-Canela",4,"Sul",1,"430910",5,46,7,39,11,35,1,0,1,0,1,47,7,40,11,36,15,10.9132899387459,10.5065732547274,0.412652106448471,31
"13017","RS","Gravataí",283620,42820.82,43026,"Porto Alegre",4,"Sul",1,"430920",2,229,71,158,82,147,0,0,0,0,0,229,71,158,82,147,140,10.6647797118903,12.5553905930153,0.300164857801845,29
"13018","RS","Gravataí",283620,42820.82,43026,"Porto Alegre",4,"Sul",1,"430920",3,234,57,177,83,151,3,1,2,1,2,237,58,179,84,153,157,10.6647797118903,12.5553905930153,0.406244589734755,31
"13019","RS","Gravataí",283620,42820.82,43026,"Porto Alegre",4,"Sul",1,"430920",4,248,68,180,85,163,4,0,4,4,0,252,68,184,89,163,144,10.6647797118903,12.5553905930153,0.467830791411859,30
"13020","RS","Gravataí",283620,42820.82,43026,"Porto Alegre",4,"Sul",1,"430920",5,265,67,198,73,192,1,1,0,0,1,266,68,198,73,193,142,10.6647797118903,12.5553905930153,0.409978214541147,31
"13021","RS","Guaíba",98239,68641.09,43026,"Porto Alegre",4,"Sul",1,"430930",2,75,15,60,25,50,3,0,3,1,2,78,15,63,26,52,54,11.1366466139891,11.4951585641761,0.314197059356955,29
"13022","RS","Guaíba",98239,68641.09,43026,"Porto Alegre",4,"Sul",1,"430930",3,82,25,57,36,46,0,0,0,0,0,82,25,57,36,46,70,11.1366466139891,11.4951585641761,0.418170543854753,31
"13023","RS","Guaíba",98239,68641.09,43026,"Porto Alegre",4,"Sul",1,"430930",4,68,17,51,25,43,0,0,0,0,0,68,17,51,25,43,46,11.1366466139891,11.4951585641761,0.47580335544973,30
"13024","RS","Guaíba",98239,68641.09,43026,"Porto Alegre",4,"Sul",1,"430930",5,91,25,66,27,64,0,0,0,0,0,91,25,66,27,64,47,11.1366466139891,11.4951585641761,0.426624654858489,31
"13025","RS","Guaporé",25968,34001.53,43014,"Guaporé",4,"Sul",1,"430940",2,24,5,19,3,21,0,0,0,0,0,24,5,19,3,21,6,10.4341608025858,10.1646202897544,0.311049766233473,29
"13026","RS","Guaporé",25968,34001.53,43014,"Guaporé",4,"Sul",1,"430940",3,27,4,23,6,21,0,0,0,0,0,27,4,23,6,21,22,10.4341608025858,10.1646202897544,0.430728994627083,31
"13027","RS","Guaporé",25968,34001.53,43014,"Guaporé",4,"Sul",1,"430940",4,27,3,24,8,19,0,0,0,0,0,27,3,24,8,19,10,10.4341608025858,10.1646202897544,0.417206691352206,30
"13028","RS","Guaporé",25968,34001.53,43014,"Guaporé",4,"Sul",1,"430940",5,26,4,22,7,19,0,0,0,0,0,26,4,22,7,19,18,10.4341608025858,10.1646202897544,0.382816574199442,31
"13029","RS","Horizontina",19389,84405.81,43002,"Três Passos",4,"Sul",1,"430960",2,16,1,15,1,15,0,0,0,0,0,16,1,15,1,15,10,11.3433915170773,9.87246117393101,0.296030686038324,29
"13030","RS","Horizontina",19389,84405.81,43002,"Três Passos",4,"Sul",1,"430960",3,14,5,9,6,8,0,0,0,0,0,14,5,9,6,8,12,11.3433915170773,9.87246117393101,0.378354448163403,31
"13031","RS","Horizontina",19389,84405.81,43002,"Três Passos",4,"Sul",1,"430960",4,16,2,14,2,14,0,0,0,0,0,16,2,14,2,14,10,11.3433915170773,9.87246117393101,0.436130795026479,30
"13032","RS","Horizontina",19389,84405.81,43002,"Três Passos",4,"Sul",1,"430960",5,22,1,21,7,15,0,0,0,0,0,22,1,21,7,15,9,11.3433915170773,9.87246117393101,0.418021683302569,31
"13033","RS","Ibirubá",20413,52551.35,43011,"Cruz Alta",4,"Sul",0,"431000",2,24,1,23,9,15,0,0,0,0,0,24,1,23,9,15,14,10.8695460657943,9.92392723177358,0.322805313047071,29
"13034","RS","Ibirubá",20413,52551.35,43011,"Cruz Alta",4,"Sul",0,"431000",3,21,2,19,5,16,0,0,0,0,0,21,2,19,5,16,17,10.8695460657943,9.92392723177358,0.411678165293481,31
"13035","RS","Ibirubá",20413,52551.35,43011,"Cruz Alta",4,"Sul",0,"431000",4,20,4,16,5,15,0,0,0,0,0,20,4,16,5,15,10,10.8695460657943,9.92392723177358,0.409642554645821,30
"13036","RS","Ibirubá",20413,52551.35,43011,"Cruz Alta",4,"Sul",0,"431000",5,19,2,17,0,19,0,0,0,0,0,19,2,17,0,19,5,10.8695460657943,9.92392723177358,0.42181025935477,31
"13037","RS","Igrejinha",37340,49798.73,43024,"Gramado-Canela",4,"Sul",1,"431010",2,40,12,28,10,30,0,0,0,0,0,40,12,28,10,30,20,10.8157447606795,10.5278204170957,0.304577147283887,29
"13038","RS","Igrejinha",37340,49798.73,43024,"Gramado-Canela",4,"Sul",1,"431010",3,42,13,29,15,27,0,0,0,0,0,42,13,29,15,27,12,10.8157447606795,10.5278204170957,0.407629675867576,31
"13039","RS","Igrejinha",37340,49798.73,43024,"Gramado-Canela",4,"Sul",1,"431010",4,48,17,31,19,29,0,0,0,0,0,48,17,31,19,29,18,10.8157447606795,10.5278204170957,0.434641025345846,30
"13040","RS","Igrejinha",37340,49798.73,43024,"Gramado-Canela",4,"Sul",1,"431010",5,40,19,21,16,24,0,0,0,0,0,40,19,21,16,24,21,10.8157447606795,10.5278204170957,0.395809629302053,31
"13041","RS","Ijuí",83764,42446.9,43008,"Ijuí",4,"Sul",1,"431020",2,90,15,75,30,60,2,1,1,1,1,92,16,76,31,61,48,10.6560091619822,11.335758599896,0.299198648989805,29
"13042","RS","Ijuí",83764,42446.9,43008,"Ijuí",4,"Sul",1,"431020",3,72,10,62,23,49,0,0,0,0,0,72,10,62,23,49,60,10.6560091619822,11.335758599896,0.400988331769774,31
"13043","RS","Ijuí",83764,42446.9,43008,"Ijuí",4,"Sul",1,"431020",4,84,17,67,30,54,1,0,1,0,1,85,17,68,30,55,57,10.6560091619822,11.335758599896,0.432821714439733,30
"13044","RS","Ijuí",83764,42446.9,43008,"Ijuí",4,"Sul",1,"431020",5,102,16,86,32,70,1,1,0,0,1,103,17,86,32,71,44,10.6560091619822,11.335758599896,0.403169506083747,31
"13045","RS","Imbé",23271,20405.2,43027,"Osório",4,"Sul",1,"431033",2,24,10,14,5,19,0,0,0,0,0,24,10,14,5,19,19,9.92354504931111,10.054963229159,0.319222188155632,29
"13046","RS","Imbé",23271,20405.2,43027,"Osório",4,"Sul",1,"431033",3,24,11,13,12,12,0,0,0,0,0,24,11,13,12,12,21,9.92354504931111,10.054963229159,0.437504421860413,31
"13047","RS","Imbé",23271,20405.2,43027,"Osório",4,"Sul",1,"431033",4,15,10,5,7,8,0,0,0,0,0,15,10,5,7,8,6,9.92354504931111,10.054963229159,0.480796717447393,30
"13048","RS","Imbé",23271,20405.2,43027,"Osório",4,"Sul",1,"431033",5,19,7,12,5,14,0,0,0,0,0,19,7,12,5,14,18,9.92354504931111,10.054963229159,0.436050719064422,31
"13049","RS","Itaqui",37489,36770.02,43029,"Campanha Ocidental",4,"Sul",1,"431060",2,43,16,27,21,22,2,0,2,2,0,45,16,29,23,22,27,10.5124381182168,10.5318028355945,0.265571405422681,29
"13050","RS","Itaqui",37489,36770.02,43029,"Campanha Ocidental",4,"Sul",1,"431060",3,30,7,23,13,17,0,0,0,0,0,30,7,23,13,17,19,10.5124381182168,10.5318028355945,0.359130465953432,31
"13051","RS","Itaqui",37489,36770.02,43029,"Campanha Ocidental",4,"Sul",1,"431060",4,33,10,23,19,14,0,0,0,0,0,33,10,23,19,14,21,10.5124381182168,10.5318028355945,0.386856534325532,30
"13052","RS","Itaqui",37489,36770.02,43029,"Campanha Ocidental",4,"Sul",1,"431060",5,32,10,22,10,22,1,0,1,1,0,33,10,23,11,22,22,10.5124381182168,10.5318028355945,0.371727361097972,31
"13053","RS","Ivoti",24690,42392.5,43024,"Gramado-Canela",4,"Sul",1,"431080",2,13,1,12,3,10,0,0,0,0,0,13,1,12,3,10,7,10.6547267387813,10.1141535823392,0.291675439911329,29
"13054","RS","Ivoti",24690,42392.5,43024,"Gramado-Canela",4,"Sul",1,"431080",3,22,5,17,6,16,0,0,0,0,0,22,5,17,6,16,10,10.6547267387813,10.1141535823392,0.420260552145063,31
"13055","RS","Ivoti",24690,42392.5,43024,"Gramado-Canela",4,"Sul",1,"431080",4,12,3,9,4,8,0,0,0,0,0,12,3,9,4,8,12,10.6547267387813,10.1141535823392,0.475475477817428,30
"13056","RS","Ivoti",24690,42392.5,43024,"Gramado-Canela",4,"Sul",1,"431080",5,17,2,15,5,12,0,0,0,0,0,17,2,15,5,12,10,10.6547267387813,10.1141535823392,0.421782141400441,31
"13057","RS","Jaguarão",26500,24959.82,43034,"Jaguarão",4,"Sul",1,"431100",2,19,5,14,9,10,0,0,0,0,0,19,5,14,9,10,16,10.1250226109189,10.1849000119743,0.320699419516307,29
"13058","RS","Jaguarão",26500,24959.82,43034,"Jaguarão",4,"Sul",1,"431100",3,25,9,16,9,16,0,0,0,0,0,25,9,16,9,16,23,10.1250226109189,10.1849000119743,0.427109011211052,31
"13059","RS","Jaguarão",26500,24959.82,43034,"Jaguarão",4,"Sul",1,"431100",4,21,3,18,8,13,1,0,1,0,1,22,3,19,8,14,18,10.1250226109189,10.1849000119743,0.470598830829527,30
"13060","RS","Jaguarão",26500,24959.82,43034,"Jaguarão",4,"Sul",1,"431100",5,24,7,17,9,15,0,0,0,0,0,24,7,17,9,15,21,10.1250226109189,10.1849000119743,0.436259455154611,31
"13061","RS","Jaguari",10765,23282.63,43018,"Santa Maria",4,"Sul",0,"431110",2,3,0,3,0,3,0,0,0,0,0,3,0,3,0,3,8,10.0554628679731,9.28405540979846,0.267730320156653,29
"13062","RS","Jaguari",10765,23282.63,43018,"Santa Maria",4,"Sul",0,"431110",3,10,3,7,2,8,0,0,0,0,0,10,3,7,2,8,12,10.0554628679731,9.28405540979846,0.377695214184314,31
"13063","RS","Jaguari",10765,23282.63,43018,"Santa Maria",4,"Sul",0,"431110",4,4,0,4,0,4,0,0,0,0,0,4,0,4,0,4,9,10.0554628679731,9.28405540979846,0.424143107983656,30
"13064","RS","Jaguari",10765,23282.63,43018,"Santa Maria",4,"Sul",0,"431110",5,4,2,2,1,3,0,0,0,0,0,4,2,2,1,3,6,10.0554628679731,9.28405540979846,0.419205228712196,31
"13065","RS","Júlio de Castilhos",19224,67506.41,43017,"Santiago",4,"Sul",1,"431120",2,15,3,12,7,8,0,0,0,0,0,15,3,12,7,8,11,11.1199778353149,9.8639147774163,0.313150311421656,29
"13066","RS","Júlio de Castilhos",19224,67506.41,43017,"Santiago",4,"Sul",1,"431120",3,13,3,10,5,8,0,0,0,0,0,13,3,10,5,8,12,11.1199778353149,9.8639147774163,0.395878452758302,31
"13067","RS","Júlio de Castilhos",19224,67506.41,43017,"Santiago",4,"Sul",1,"431120",4,12,6,6,5,7,0,0,0,0,0,12,6,6,5,7,14,11.1199778353149,9.8639147774163,0.422248160786812,30
"13068","RS","Júlio de Castilhos",19224,67506.41,43017,"Santiago",4,"Sul",1,"431120",5,14,5,9,1,13,0,0,0,0,0,14,5,9,1,13,13,11.1199778353149,9.8639147774163,0.391943428088746,31
"13069","RS","Lagoa Vermelha",27778,41824.19,43015,"Vacaria",4,"Sul",1,"431130",2,33,17,16,15,18,0,0,0,0,0,33,17,16,15,18,29,10.6412301592598,10.2319996194762,0.306233615952755,29
"13070","RS","Lagoa Vermelha",27778,41824.19,43015,"Vacaria",4,"Sul",1,"431130",3,32,5,27,15,17,0,0,0,0,0,32,5,27,15,17,23,10.6412301592598,10.2319996194762,0.392822279279054,31
"13071","RS","Lagoa Vermelha",27778,41824.19,43015,"Vacaria",4,"Sul",1,"431130",4,41,8,33,19,22,0,0,0,0,0,41,8,33,19,22,22,10.6412301592598,10.2319996194762,0.417511206021882,30
"13072","RS","Lagoa Vermelha",27778,41824.19,43015,"Vacaria",4,"Sul",1,"431130",5,25,4,21,14,11,0,0,0,0,0,25,4,21,14,11,22,10.6412301592598,10.2319996194762,0.391197222937799,31
"13073","RS","Lajeado",85033,51129.4,43021,"Lajeado-Estrela",4,"Sul",1,"431140",2,90,24,66,26,64,3,0,3,1,2,93,24,69,27,66,45,10.8421149532115,11.3507946954227,0.286133873532307,29
"13074","RS","Lajeado",85033,51129.4,43021,"Lajeado-Estrela",4,"Sul",1,"431140",3,85,23,62,23,62,0,0,0,0,0,85,23,62,23,62,36,10.8421149532115,11.3507946954227,0.403864541709107,31
"13075","RS","Lajeado",85033,51129.4,43021,"Lajeado-Estrela",4,"Sul",1,"431140",4,94,20,74,20,74,1,1,0,0,1,95,21,74,20,75,43,10.8421149532115,11.3507946954227,0.448985278558279,30
"13076","RS","Lajeado",85033,51129.4,43021,"Lajeado-Estrela",4,"Sul",1,"431140",5,105,24,81,22,83,0,0,0,0,0,105,24,81,22,83,48,10.8421149532115,11.3507946954227,0.415418352076155,31
"13077","RS","Lindolfo Collor",6125,49614.84,43024,"Gramado-Canela",4,"Sul",1,"431162",2,3,0,3,0,3,0,0,0,0,0,3,0,3,0,3,2,10.8120452615119,8.72013403541293,0.294407210780186,29
"13078","RS","Lindolfo Collor",6125,49614.84,43024,"Gramado-Canela",4,"Sul",1,"431162",3,4,1,3,1,3,0,0,0,0,0,4,1,3,1,3,1,10.8120452615119,8.72013403541293,0.410983063627105,31
"13079","RS","Lindolfo Collor",6125,49614.84,43024,"Gramado-Canela",4,"Sul",1,"431162",4,3,1,2,1,2,0,0,0,0,0,3,1,2,1,2,2,10.8120452615119,8.72013403541293,0.447947530737204,30
"13080","RS","Lindolfo Collor",6125,49614.84,43024,"Gramado-Canela",4,"Sul",1,"431162",5,8,0,8,3,5,0,0,0,0,0,8,0,8,3,5,1,10.8120452615119,8.72013403541293,0.401775369555548,31
"13081","RS","Marau",44858,47227.43,43010,"Passo Fundo",4,"Sul",1,"431180",2,44,6,38,12,32,0,0,0,0,0,44,6,38,12,32,17,10.7627301468426,10.7112572239328,0.336221210582946,29
"13082","RS","Marau",44858,47227.43,43010,"Passo Fundo",4,"Sul",1,"431180",3,42,9,33,14,28,0,0,0,0,0,42,9,33,14,28,25,10.7627301468426,10.7112572239328,0.419961193794488,31
"13083","RS","Marau",44858,47227.43,43010,"Passo Fundo",4,"Sul",1,"431180",4,41,2,39,13,28,0,0,0,0,0,41,2,39,13,28,14,10.7627301468426,10.7112572239328,0.466869404228257,30
"13084","RS","Marau",44858,47227.43,43010,"Passo Fundo",4,"Sul",1,"431180",5,46,12,34,15,31,1,1,0,1,0,47,13,34,16,31,32,10.7627301468426,10.7112572239328,0.423023271519925,31
"13085","RS","Minas do Leão",8103,21970.07,43025,"São Jerônimo",4,"Sul",0,"431225",2,6,4,2,5,1,0,0,0,0,0,6,4,2,5,1,5,9.99743635153653,8.99998964246073,0.337963299328079,29
"13086","RS","Minas do Leão",8103,21970.07,43025,"São Jerônimo",4,"Sul",0,"431225",3,7,3,4,2,5,0,0,0,0,0,7,3,4,2,5,4,9.99743635153653,8.99998964246073,0.418494856297364,31
"13087","RS","Minas do Leão",8103,21970.07,43025,"São Jerônimo",4,"Sul",0,"431225",4,4,3,1,3,1,0,0,0,0,0,4,3,1,3,1,3,9.99743635153653,8.99998964246073,0.439630878598554,30
"13088","RS","Minas do Leão",8103,21970.07,43025,"São Jerônimo",4,"Sul",0,"431225",5,12,6,6,5,7,0,0,0,0,0,12,6,6,5,7,2,9.99743635153653,8.99998964246073,0.409963891236547,31
"13089","RS","Montenegro",65721,57568.88,43023,"Montenegro",4,"Sul",1,"431240",2,55,14,41,19,36,0,0,0,0,0,55,14,41,19,36,33,10.9607374229036,11.0931737881036,0.307501852159972,29
"13090","RS","Montenegro",65721,57568.88,43023,"Montenegro",4,"Sul",1,"431240",3,57,16,41,21,36,0,0,0,0,0,57,16,41,21,36,30,10.9607374229036,11.0931737881036,0.408440132909028,31
"13091","RS","Montenegro",65721,57568.88,43023,"Montenegro",4,"Sul",1,"431240",4,74,13,61,21,53,0,0,0,0,0,74,13,61,21,53,28,10.9607374229036,11.0931737881036,0.465774298979193,30
"13092","RS","Montenegro",65721,57568.88,43023,"Montenegro",4,"Sul",1,"431240",5,78,31,47,27,51,0,0,0,0,0,78,31,47,27,51,41,10.9607374229036,11.0931737881036,0.412758110193615,31
"13093","RS","Morro Reuter",6513,28815.4,43024,"Gramado-Canela",4,"Sul",1,"431247",2,6,1,5,2,4,0,0,0,0,0,6,1,5,2,4,2,10.2686652454333,8.7815554585464,0.303575843321056,29
"13094","RS","Morro Reuter",6513,28815.4,43024,"Gramado-Canela",4,"Sul",1,"431247",3,7,0,7,1,6,0,0,0,0,0,7,0,7,1,6,5,10.2686652454333,8.7815554585464,0.401997181446826,31
"13095","RS","Morro Reuter",6513,28815.4,43024,"Gramado-Canela",4,"Sul",1,"431247",4,5,0,5,0,5,0,0,0,0,0,5,0,5,0,5,2,10.2686652454333,8.7815554585464,0.44630089451688,30
"13096","RS","Morro Reuter",6513,28815.4,43024,"Gramado-Canela",4,"Sul",1,"431247",5,8,3,5,3,5,0,0,0,0,0,8,3,5,3,5,1,10.2686652454333,8.7815554585464,0.389934198822429,31
"13097","RS","Mostardas",12847,28099.77,43027,"Osório",4,"Sul",0,"431250",2,9,3,6,4,5,0,0,0,0,0,9,3,6,4,5,7,10.243516670235,9.46086560003161,0.330848704026869,29
"13098","RS","Mostardas",12847,28099.77,43027,"Osório",4,"Sul",0,"431250",3,9,3,6,4,5,0,0,0,0,0,9,3,6,4,5,7,10.243516670235,9.46086560003161,0.419488518938461,31
"13099","RS","Mostardas",12847,28099.77,43027,"Osório",4,"Sul",0,"431250",4,17,7,10,12,5,1,1,0,0,1,18,8,10,12,6,10,10.243516670235,9.46086560003161,0.458347340894786,30
"13100","RS","Mostardas",12847,28099.77,43027,"Osório",4,"Sul",0,"431250",5,13,5,8,7,6,0,0,0,0,0,13,5,8,7,6,9,10.243516670235,9.46086560003161,0.462308906547907,31
"13101","RS","Não-Me-Toque",17758,72952.08,43012,"Não-Me-Toque",4,"Sul",1,"431265",2,13,1,12,5,8,0,0,0,0,0,13,1,12,5,8,8,11.1975580662244,9.78459139759227,0.32610134583353,29
"13102","RS","Não-Me-Toque",17758,72952.08,43012,"Não-Me-Toque",4,"Sul",1,"431265",3,17,7,10,6,11,0,0,0,0,0,17,7,10,6,11,23,11.1975580662244,9.78459139759227,0.438352348899392,31
"13103","RS","Não-Me-Toque",17758,72952.08,43012,"Não-Me-Toque",4,"Sul",1,"431265",4,13,2,11,2,11,0,0,0,0,0,13,2,11,2,11,14,11.1975580662244,9.78459139759227,0.454612019799325,30
"13104","RS","Não-Me-Toque",17758,72952.08,43012,"Não-Me-Toque",4,"Sul",1,"431265",5,20,3,17,5,15,0,0,0,0,0,20,3,17,5,15,9,11.1975580662244,9.78459139759227,0.394991008065354,31
"13105","RS","Nonoai",11633,36362.42,43003,"Frederico Westphalen",4,"Sul",0,"431270",2,16,3,13,5,11,0,0,0,0,0,16,3,13,5,11,12,10.5012911027323,9.36160116581677,0.295231282860981,29
"13106","RS","Nonoai",11633,36362.42,43003,"Frederico Westphalen",4,"Sul",0,"431270",3,18,9,9,10,8,0,0,0,0,0,18,9,9,10,8,8,10.5012911027323,9.36160116581677,0.354300334064171,31
"13107","RS","Nonoai",11633,36362.42,43003,"Frederico Westphalen",4,"Sul",0,"431270",4,15,6,9,4,11,0,0,0,0,0,15,6,9,4,11,10,10.5012911027323,9.36160116581677,0.387737402408774,30
"13108","RS","Nonoai",11633,36362.42,43003,"Frederico Westphalen",4,"Sul",0,"431270",5,26,5,21,13,13,0,0,0,0,0,26,5,21,13,13,10,10.5012911027323,9.36160116581677,0.399337216863439,31
"13109","RS","Nova Araçá",4826,44993.4,43014,"Guaporé",4,"Sul",0,"431280",2,4,0,4,2,2,0,0,0,0,0,4,0,4,2,2,1,10.7142710913292,8.48177324618498,0.353387524146437,29
"13110","RS","Nova Araçá",4826,44993.4,43014,"Guaporé",4,"Sul",0,"431280",3,8,1,7,6,2,0,0,0,0,0,8,1,7,6,2,1,10.7142710913292,8.48177324618498,0.424493240809328,31
"13111","RS","Nova Araçá",4826,44993.4,43014,"Guaporé",4,"Sul",0,"431280",4,9,0,9,3,6,1,0,1,1,0,10,0,10,4,6,1,10.7142710913292,8.48177324618498,0.434738757404542,30
"13112","RS","Nova Araçá",4826,44993.4,43014,"Guaporé",4,"Sul",0,"431280",5,3,1,2,0,3,1,0,1,0,1,4,1,3,0,4,6,10.7142710913292,8.48177324618498,0.457618128329562,31
"13113","RS","Nova Bassano",10005,52022.36,43014,"Guaporé",4,"Sul",0,"431290",2,7,3,4,2,5,0,0,0,0,0,7,3,4,2,5,3,10.8594289051401,9.21084024701783,0.264344048774674,29
"13114","RS","Nova Bassano",10005,52022.36,43014,"Guaporé",4,"Sul",0,"431290",3,12,2,10,3,9,0,0,0,0,0,12,2,10,3,9,3,10.8594289051401,9.21084024701783,0.352314046148165,31
"13115","RS","Nova Bassano",10005,52022.36,43014,"Guaporé",4,"Sul",0,"431290",4,2,0,2,0,2,0,0,0,0,0,2,0,2,0,2,5,10.8594289051401,9.21084024701783,0.350429113029812,30
"13116","RS","Nova Bassano",10005,52022.36,43014,"Guaporé",4,"Sul",0,"431290",5,8,3,5,3,5,0,0,0,0,0,8,3,5,3,5,4,10.8594289051401,9.21084024701783,0.402199036338114,31
"13117","RS","Nova Hartz",21875,29692.26,43026,"Porto Alegre",4,"Sul",1,"431306",2,13,2,11,7,6,0,0,0,0,0,13,2,11,7,6,9,10.2986416847665,9.99309971122582,0.290312863308369,29
"13118","RS","Nova Hartz",21875,29692.26,43026,"Porto Alegre",4,"Sul",1,"431306",3,7,2,5,6,1,0,0,0,0,0,7,2,5,6,1,10,10.2986416847665,9.99309971122582,0.373004842800417,31
"13119","RS","Nova Hartz",21875,29692.26,43026,"Porto Alegre",4,"Sul",1,"431306",4,15,7,8,5,10,0,0,0,0,0,15,7,8,5,10,11,10.2986416847665,9.99309971122582,0.40877161320293,30
"13120","RS","Nova Hartz",21875,29692.26,43026,"Porto Alegre",4,"Sul",1,"431306",5,25,5,20,8,17,0,0,0,0,0,25,5,20,8,17,9,10.2986416847665,9.99309971122582,0.346240307032219,31
"13121","RS","Nova Petrópolis",21536,37459.32,43024,"Gramado-Canela",4,"Sul",0,"431320",2,22,2,20,6,16,0,0,0,0,0,22,2,20,6,16,8,10.5310108231371,9.97748123244445,0.329617944076301,29
"13122","RS","Nova Petrópolis",21536,37459.32,43024,"Gramado-Canela",4,"Sul",0,"431320",3,21,4,17,4,17,0,0,0,0,0,21,4,17,4,17,13,10.5310108231371,9.97748123244445,0.435725751880964,31
"13123","RS","Nova Petrópolis",21536,37459.32,43024,"Gramado-Canela",4,"Sul",0,"431320",4,17,3,14,2,15,0,0,0,0,0,17,3,14,2,15,13,10.5310108231371,9.97748123244445,0.485249643238873,30
"13124","RS","Nova Petrópolis",21536,37459.32,43024,"Gramado-Canela",4,"Sul",0,"431320",5,17,3,14,5,12,0,0,0,0,0,17,3,14,5,12,17,10.5310108231371,9.97748123244445,0.435867675338069,31
"13125","RS","Nova Prata",27648,59362.18,43014,"Guaporé",4,"Sul",1,"431330",2,22,3,19,6,16,1,0,1,0,1,23,3,20,6,17,13,10.9914126022343,10.2273086716038,0.293703776416704,29
"13126","RS","Nova Prata",27648,59362.18,43014,"Guaporé",4,"Sul",1,"431330",3,22,6,16,5,17,0,0,0,0,0,22,6,16,5,17,11,10.9914126022343,10.2273086716038,0.397399238945142,31
"13127","RS","Nova Prata",27648,59362.18,43014,"Guaporé",4,"Sul",1,"431330",4,24,4,20,6,18,0,0,0,0,0,24,4,20,6,18,15,10.9914126022343,10.2273086716038,0.423796669737177,30
"13128","RS","Nova Prata",27648,59362.18,43014,"Guaporé",4,"Sul",1,"431330",5,34,6,28,10,24,0,0,0,0,0,34,6,28,10,24,11,10.9914126022343,10.2273086716038,0.383106696755811,31
"13129","RS","Nova Santa Rita",29905,58018.11,43026,"Porto Alegre",4,"Sul",1,"431337",2,28,8,20,13,15,1,1,0,1,0,29,9,20,14,15,14,10.9685104821707,10.3057809694787,0.308540918876448,29
"13130","RS","Nova Santa Rita",29905,58018.11,43026,"Porto Alegre",4,"Sul",1,"431337",3,33,5,28,11,22,0,0,0,0,0,33,5,28,11,22,8,10.9685104821707,10.3057809694787,0.415022415494063,31
"13131","RS","Nova Santa Rita",29905,58018.11,43026,"Porto Alegre",4,"Sul",1,"431337",4,40,16,24,12,28,0,0,0,0,0,40,16,24,12,28,11,10.9685104821707,10.3057809694787,0.465252797784536,30
"13132","RS","Nova Santa Rita",29905,58018.11,43026,"Porto Alegre",4,"Sul",1,"431337",5,23,10,13,10,13,0,0,0,0,0,23,10,13,10,13,15,10.9685104821707,10.3057809694787,0.420600238490404,31
"13133","RS","Novo Hamburgo",247032,38159.33,43026,"Porto Alegre",4,"Sul",1,"431340",2,192,56,136,60,132,1,0,1,0,1,193,56,137,60,133,134,10.5495255677561,12.4172731618745,0.29499886497722,29
"13134","RS","Novo Hamburgo",247032,38159.33,43026,"Porto Alegre",4,"Sul",1,"431340",3,210,82,128,67,143,0,0,0,0,0,210,82,128,67,143,160,10.5495255677561,12.4172731618745,0.412813166162342,31
"13135","RS","Novo Hamburgo",247032,38159.33,43026,"Porto Alegre",4,"Sul",1,"431340",4,237,65,172,82,155,1,1,0,1,0,238,66,172,83,155,123,10.5495255677561,12.4172731618745,0.463300843090789,30
"13136","RS","Novo Hamburgo",247032,38159.33,43026,"Porto Alegre",4,"Sul",1,"431340",5,261,71,190,83,178,3,2,1,2,1,264,73,191,85,179,148,10.5495255677561,12.4172731618745,0.406996076705208,31
"13137","RS","Osório",46414,34323.48,43027,"Osório",4,"Sul",1,"431350",2,37,9,28,8,29,1,0,1,0,1,38,9,29,8,30,23,10.4435849470628,10.7453564168427,0.304775076890932,29
"13138","RS","Osório",46414,34323.48,43027,"Osório",4,"Sul",1,"431350",3,55,19,36,20,35,0,0,0,0,0,55,19,36,20,35,33,10.4435849470628,10.7453564168427,0.420389531547402,31
"13139","RS","Osório",46414,34323.48,43027,"Osório",4,"Sul",1,"431350",4,38,16,22,17,21,2,0,2,2,0,40,16,24,19,21,29,10.4435849470628,10.7453564168427,0.471805454686456,30
"13140","RS","Osório",46414,34323.48,43027,"Osório",4,"Sul",1,"431350",5,48,10,38,20,28,0,0,0,0,0,48,10,38,20,28,32,10.4435849470628,10.7453564168427,0.414327624153671,31
"13141","RS","Palmares do Sul",11330,41484.76,43027,"Osório",4,"Sul",0,"431365",2,11,6,5,2,9,0,0,0,0,0,11,6,5,2,9,13,10.6330814098581,9.33520935402205,0.364132222536772,29
"13142","RS","Palmares do Sul",11330,41484.76,43027,"Osório",4,"Sul",0,"431365",3,12,3,9,3,9,2,0,2,0,2,14,3,11,3,11,7,10.6330814098581,9.33520935402205,0.463551999384471,31
"13143","RS","Palmares do Sul",11330,41484.76,43027,"Osório",4,"Sul",0,"431365",4,4,1,3,2,2,0,0,0,0,0,4,1,3,2,2,12,10.6330814098581,9.33520935402205,0.487880522166017,30
"13144","RS","Palmares do Sul",11330,41484.76,43027,"Osório",4,"Sul",0,"431365",5,11,1,10,4,7,0,0,0,0,0,11,1,10,4,7,4,10.6330814098581,9.33520935402205,0.458443932941187,31
"13145","RS","Palmeira das Missões",33131,43616.98,43009,"Carazinho",4,"Sul",1,"431370",2,31,5,26,10,21,0,0,0,0,0,31,5,26,10,21,13,10.6832018030626,10.4082246789616,0.304031326856675,29
"13146","RS","Palmeira das Missões",33131,43616.98,43009,"Carazinho",4,"Sul",1,"431370",3,30,8,22,12,18,0,0,0,0,0,30,8,22,12,18,19,10.6832018030626,10.4082246789616,0.397895491511324,31
"13147","RS","Palmeira das Missões",33131,43616.98,43009,"Carazinho",4,"Sul",1,"431370",4,48,12,36,13,35,0,0,0,0,0,48,12,36,13,35,12,10.6832018030626,10.4082246789616,0.438980043151381,30
"13148","RS","Palmeira das Missões",33131,43616.98,43009,"Carazinho",4,"Sul",1,"431370",5,57,9,48,24,33,0,0,0,0,0,57,9,48,24,33,20,10.6832018030626,10.4082246789616,0.409414051855951,31
"13149","RS","Panambi",44128,49260.55,43008,"Ijuí",4,"Sul",1,"431390",2,46,4,42,17,29,1,1,0,1,0,47,5,42,18,29,20,10.8048788368578,10.694849780593,0.320622055837341,29
"13150","RS","Panambi",44128,49260.55,43008,"Ijuí",4,"Sul",1,"431390",3,41,4,37,7,34,0,0,0,0,0,41,4,37,7,34,22,10.8048788368578,10.694849780593,0.419713056689962,31
"13151","RS","Panambi",44128,49260.55,43008,"Ijuí",4,"Sul",1,"431390",4,45,8,37,18,27,0,0,0,0,0,45,8,37,18,27,21,10.8048788368578,10.694849780593,0.464016134456868,30
"13152","RS","Panambi",44128,49260.55,43008,"Ijuí",4,"Sul",1,"431390",5,55,9,46,12,43,0,0,0,0,0,55,9,46,12,43,22,10.8048788368578,10.694849780593,0.434914880504325,31
"13153","RS","Pantano Grande",9083,37352.14,43022,"Cachoeira do Sul",4,"Sul",0,"431395",2,9,1,8,3,6,0,0,0,0,0,9,1,8,3,6,6,10.5281454847697,9.11415981350221,0.301523409764567,29
"13154","RS","Pantano Grande",9083,37352.14,43022,"Cachoeira do Sul",4,"Sul",0,"431395",3,11,4,7,1,10,0,0,0,0,0,11,4,7,1,10,6,10.5281454847697,9.11415981350221,0.381722740983622,31
"13155","RS","Pantano Grande",9083,37352.14,43022,"Cachoeira do Sul",4,"Sul",0,"431395",4,7,4,3,2,5,1,1,0,0,1,8,5,3,2,6,9,10.5281454847697,9.11415981350221,0.424926662183659,30
"13156","RS","Pantano Grande",9083,37352.14,43022,"Cachoeira do Sul",4,"Sul",0,"431395",5,9,5,4,4,5,0,0,0,0,0,9,5,4,4,5,8,10.5281454847697,9.11415981350221,0.421860980471435,31
"13157","RS","Parobé",58858,21283.76,43026,"Porto Alegre",4,"Sul",1,"431405",2,44,16,28,19,25,1,0,1,0,1,45,16,29,19,26,25,9.96569961957676,10.9828830422771,0.301999713356435,29
"13158","RS","Parobé",58858,21283.76,43026,"Porto Alegre",4,"Sul",1,"431405",3,62,20,42,19,43,1,0,1,1,0,63,20,43,20,43,29,9.96569961957676,10.9828830422771,0.4210911145534,31
"13159","RS","Parobé",58858,21283.76,43026,"Porto Alegre",4,"Sul",1,"431405",4,56,19,37,19,37,0,0,0,0,0,56,19,37,19,37,21,9.96569961957676,10.9828830422771,0.443623876484272,30
"13160","RS","Parobé",58858,21283.76,43026,"Porto Alegre",4,"Sul",1,"431405",5,80,34,46,39,41,2,1,1,0,2,82,35,47,39,43,27,9.96569961957676,10.9828830422771,0.392879851699571,31
"13161","RS","Passo Fundo",204722,45327.11,43010,"Passo Fundo",4,"Sul",1,"431410",2,222,52,170,82,140,0,0,0,0,0,222,52,170,82,140,107,10.7216605872146,12.2294082402271,0.323824643451199,29
"13162","RS","Passo Fundo",204722,45327.11,43010,"Passo Fundo",4,"Sul",1,"431410",3,224,64,160,69,155,1,0,1,1,0,225,64,161,70,155,105,10.7216605872146,12.2294082402271,0.437485426729481,31
"13163","RS","Passo Fundo",204722,45327.11,43010,"Passo Fundo",4,"Sul",1,"431410",4,221,52,169,84,137,0,0,0,0,0,221,52,169,84,137,127,10.7216605872146,12.2294082402271,0.488614073669822,30
"13164","RS","Passo Fundo",204722,45327.11,43010,"Passo Fundo",4,"Sul",1,"431410",5,259,58,201,85,174,1,0,1,0,1,260,58,202,85,175,135,10.7216605872146,12.2294082402271,0.451733151262046,31
"13165","RS","Pedro Osório",7706,19281.18,43033,"Pelotas",4,"Sul",0,"431420",2,5,0,5,3,2,0,0,0,0,0,5,0,5,3,2,9,9.86688476961119,8.9497545251861,0.3185792421557,29
"13166","RS","Pedro Osório",7706,19281.18,43033,"Pelotas",4,"Sul",0,"431420",3,3,2,1,1,2,0,0,0,0,0,3,2,1,1,2,10,9.86688476961119,8.9497545251861,0.429137787670294,31
"13167","RS","Pedro Osório",7706,19281.18,43033,"Pelotas",4,"Sul",0,"431420",4,7,7,0,3,4,0,0,0,0,0,7,7,0,3,4,6,9.86688476961119,8.9497545251861,0.45173832435567,30
"13168","RS","Pedro Osório",7706,19281.18,43033,"Pelotas",4,"Sul",0,"431420",5,6,2,4,0,6,0,0,0,0,0,6,2,4,0,6,6,9.86688476961119,8.9497545251861,0.420692997888084,31
"13169","RS","Pelotas",343132,25884.35,43033,"Pelotas",4,"Sul",1,"431440",2,248,60,188,74,174,0,0,0,0,0,248,60,188,74,174,190,10.1613938179525,12.7458704917664,0.318117177832451,29
"13170","RS","Pelotas",343132,25884.35,43033,"Pelotas",4,"Sul",1,"431440",3,262,82,180,81,181,1,1,0,0,1,263,83,180,81,182,218,10.1613938179525,12.7458704917664,0.445532905355264,31
"13171","RS","Pelotas",343132,25884.35,43033,"Pelotas",4,"Sul",1,"431440",4,295,93,202,90,205,1,1,0,0,1,296,94,202,90,206,217,10.1613938179525,12.7458704917664,0.525722450289313,30
"13172","RS","Pelotas",343132,25884.35,43033,"Pelotas",4,"Sul",1,"431440",5,327,105,222,123,204,2,0,2,1,1,329,105,224,124,205,246,10.1613938179525,12.7458704917664,0.467357416869864,31
"13173","RS","Picada Café",5738,60482.63,43024,"Gramado-Canela",4,"Sul",1,"431442",2,3,0,3,1,2,0,0,0,0,0,3,0,3,1,2,3,11.0101114953577,8.65486599654131,0.322622435649598,29
"13174","RS","Picada Café",5738,60482.63,43024,"Gramado-Canela",4,"Sul",1,"431442",3,2,0,2,0,2,0,0,0,0,0,2,0,2,0,2,0,11.0101114953577,8.65486599654131,0.422307429546178,31
"13175","RS","Picada Café",5738,60482.63,43024,"Gramado-Canela",4,"Sul",1,"431442",4,4,1,3,3,1,0,0,0,0,0,4,1,3,3,1,0,11.0101114953577,8.65486599654131,0.478341614728998,30
"13176","RS","Picada Café",5738,60482.63,43024,"Gramado-Canela",4,"Sul",1,"431442",5,3,0,3,1,2,0,0,0,0,0,3,0,3,1,2,1,11.0101114953577,8.65486599654131,0.412105426689725,31
"13177","RS","Pinheiro Machado",12195,23263.4,43032,"Serras de Sudeste",4,"Sul",0,"431450",2,6,0,6,1,5,0,0,0,0,0,6,0,6,1,5,8,10.0546365890791,9.40878131065002,0.281032084531889,29
"13178","RS","Pinheiro Machado",12195,23263.4,43032,"Serras de Sudeste",4,"Sul",0,"431450",3,3,2,1,0,3,0,0,0,0,0,3,2,1,0,3,6,10.0546365890791,9.40878131065002,0.367861315233614,31
"13179","RS","Pinheiro Machado",12195,23263.4,43032,"Serras de Sudeste",4,"Sul",0,"431450",4,2,1,1,1,1,0,0,0,0,0,2,1,1,1,1,18,10.0546365890791,9.40878131065002,0.415078423284666,30
"13180","RS","Pinheiro Machado",12195,23263.4,43032,"Serras de Sudeste",4,"Sul",0,"431450",5,9,4,5,2,7,0,0,0,0,0,9,4,5,2,7,10,10.0546365890791,9.40878131065002,0.387779911722665,31
"13181","RS","Piratini",20704,20169.21,43032,"Serras de Sudeste",4,"Sul",0,"431460",2,15,5,10,4,11,0,0,0,0,0,15,5,10,4,11,7,9.91191246310139,9.93808219730063,0.332218000765529,29
"13182","RS","Piratini",20704,20169.21,43032,"Serras de Sudeste",4,"Sul",0,"431460",3,11,4,7,4,7,0,0,0,0,0,11,4,7,4,7,22,9.91191246310139,9.93808219730063,0.427464471585003,31
"13183","RS","Piratini",20704,20169.21,43032,"Serras de Sudeste",4,"Sul",0,"431460",4,15,3,12,7,8,0,0,0,0,0,15,3,12,7,8,6,9.91191246310139,9.93808219730063,0.453183180465034,30
"13184","RS","Piratini",20704,20169.21,43032,"Serras de Sudeste",4,"Sul",0,"431460",5,5,0,5,2,3,0,0,0,0,0,5,0,5,2,3,16,9.91191246310139,9.93808219730063,0.449256974613037,31
"13185","RS","Portão",37561,33064.14,43023,"Montenegro",4,"Sul",1,"431480",2,18,4,14,4,14,0,0,0,0,0,18,4,14,4,14,17,10.406204590395,10.5337215570359,0.306169162369422,29
"13186","RS","Portão",37561,33064.14,43023,"Montenegro",4,"Sul",1,"431480",3,23,10,13,10,13,1,0,1,0,1,24,10,14,10,14,19,10.406204590395,10.5337215570359,0.398805992599498,31
"13187","RS","Portão",37561,33064.14,43023,"Montenegro",4,"Sul",1,"431480",4,26,9,17,5,21,0,0,0,0,0,26,9,17,5,21,15,10.406204590395,10.5337215570359,0.440288609632628,30
"13188","RS","Portão",37561,33064.14,43023,"Montenegro",4,"Sul",1,"431480",5,43,20,23,13,30,0,0,0,0,0,43,20,23,13,30,18,10.406204590395,10.5337215570359,0.386625943444658,31
"13189","RS","Porto Alegre",1488252,52149.66,43026,"Porto Alegre",4,"Sul",1,"431490",2,1185,310,875,360,825,15,3,12,6,9,1200,313,887,366,834,881,10.8618729407528,14.213112834875,0.298992698438217,29
"13190","RS","Porto Alegre",1488252,52149.66,43026,"Porto Alegre",4,"Sul",1,"431490",3,1164,319,845,390,774,11,2,9,4,7,1175,321,854,394,781,918,10.8618729407528,14.213112834875,0.431539790786817,31
"13191","RS","Porto Alegre",1488252,52149.66,43026,"Porto Alegre",4,"Sul",1,"431490",4,1157,321,836,382,775,6,2,4,1,5,1163,323,840,383,780,836,10.8618729407528,14.213112834875,0.527416996746071,30
"13192","RS","Porto Alegre",1488252,52149.66,43026,"Porto Alegre",4,"Sul",1,"431490",5,1296,333,963,433,863,15,4,11,6,9,1311,337,974,439,872,956,10.8618729407528,14.213112834875,0.465631467116199,31
"13193","RS","Porto Xavier",10194,17084.16,43006,"Cerro Largo",4,"Sul",0,"431510",2,7,3,4,3,4,0,0,0,0,0,7,3,4,3,4,3,9.74590699740568,9.22955459089999,0.33554074413229,29
"13194","RS","Porto Xavier",10194,17084.16,43006,"Cerro Largo",4,"Sul",0,"431510",3,10,4,6,4,6,0,0,0,0,0,10,4,6,4,6,14,9.74590699740568,9.22955459089999,0.398509786940437,31
"13195","RS","Porto Xavier",10194,17084.16,43006,"Cerro Largo",4,"Sul",0,"431510",4,8,0,8,3,5,0,0,0,0,0,8,0,8,3,5,7,9.74590699740568,9.22955459089999,0.385477149965855,30
"13196","RS","Porto Xavier",10194,17084.16,43006,"Cerro Largo",4,"Sul",0,"431510",5,9,1,8,3,6,0,0,0,0,0,9,1,8,3,6,6,9.74590699740568,9.22955459089999,0.393133410350346,31
"13197","RS","Quaraí",22607,19655.67,43029,"Campanha Ocidental",4,"Sul",1,"431530",2,30,5,25,12,18,0,0,0,0,0,30,5,25,12,18,13,9.88612112529329,10.0260148718158,0.331694684277433,29
"13198","RS","Quaraí",22607,19655.67,43029,"Campanha Ocidental",4,"Sul",1,"431530",3,16,4,12,5,11,0,0,0,0,0,16,4,12,5,11,17,9.88612112529329,10.0260148718158,0.416280013006758,31
"13199","RS","Quaraí",22607,19655.67,43029,"Campanha Ocidental",4,"Sul",1,"431530",4,16,2,14,7,9,0,0,0,0,0,16,2,14,7,9,14,9.88612112529329,10.0260148718158,0.468556294961605,30
"13200","RS","Quaraí",22607,19655.67,43029,"Campanha Ocidental",4,"Sul",1,"431530",5,25,9,16,13,12,0,0,0,0,0,25,9,16,13,12,17,9.88612112529329,10.0260148718158,0.443300581147508,31
"13201","RS","Restinga Sêca",15744,29261.26,43019,"Restinga Seca",4,"Sul",0,"431550",2,6,4,2,3,3,0,0,0,0,0,6,4,2,3,3,7,10.2840197358479,9.66421461929203,0.294057800752005,29
"13202","RS","Restinga Sêca",15744,29261.26,43019,"Restinga Seca",4,"Sul",0,"431550",3,10,4,6,2,8,0,0,0,0,0,10,4,6,2,8,17,10.2840197358479,9.66421461929203,0.385668630908154,31
"13203","RS","Restinga Sêca",15744,29261.26,43019,"Restinga Seca",4,"Sul",0,"431550",4,10,2,8,2,8,0,0,0,0,0,10,2,8,2,8,9,10.2840197358479,9.66421461929203,0.402729358503631,30
"13204","RS","Restinga Sêca",15744,29261.26,43019,"Restinga Seca",4,"Sul",0,"431550",5,12,3,9,7,5,0,0,0,0,0,12,3,9,7,5,12,10.2840197358479,9.66421461929203,0.415739251214593,31
"13205","RS","Rio Grande",211965,51681.23,43035,"Litoral Lagunar",4,"Sul",1,"431560",2,180,58,122,61,119,2,2,0,2,0,182,60,122,63,119,159,10.8528499384829,12.264176445685,0.332206579902743,29
"13206","RS","Rio Grande",211965,51681.23,43035,"Litoral Lagunar",4,"Sul",1,"431560",3,162,50,112,57,105,3,2,1,1,2,165,52,113,58,107,132,10.8528499384829,12.264176445685,0.454983196129717,31
"13207","RS","Rio Grande",211965,51681.23,43035,"Litoral Lagunar",4,"Sul",1,"431560",4,200,68,132,85,115,2,1,1,0,2,202,69,133,85,117,124,10.8528499384829,12.264176445685,0.535038797125791,30
"13208","RS","Rio Grande",211965,51681.23,43035,"Litoral Lagunar",4,"Sul",1,"431560",5,222,75,147,88,134,0,0,0,0,0,222,75,147,88,134,144,10.8528499384829,12.264176445685,0.486412356482191,31
"13209","RS","Rio Pardo",38265,24379.36,43022,"Cachoeira do Sul",4,"Sul",0,"431570",2,27,9,18,10,17,0,0,0,0,0,27,9,18,10,17,31,10.1014921516653,10.552290919244,0.312960389709223,29
"13210","RS","Rio Pardo",38265,24379.36,43022,"Cachoeira do Sul",4,"Sul",0,"431570",3,33,10,23,13,20,1,1,0,1,0,34,11,23,14,20,25,10.1014921516653,10.552290919244,0.410604880072495,31
"13211","RS","Rio Pardo",38265,24379.36,43022,"Cachoeira do Sul",4,"Sul",0,"431570",4,34,9,25,16,18,0,0,0,0,0,34,9,25,16,18,20,10.1014921516653,10.552290919244,0.425917915799663,30
"13212","RS","Rio Pardo",38265,24379.36,43022,"Cachoeira do Sul",4,"Sul",0,"431570",5,31,7,24,13,18,0,0,0,0,0,31,7,24,13,18,31,10.1014921516653,10.552290919244,0.397094181476682,31
"13213","RS","Roca Sales",11471,40933.3,43021,"Lajeado-Estrela",4,"Sul",0,"431580",2,8,3,5,3,5,0,0,0,0,0,8,3,5,3,5,9,10.6196991916945,9.34757739028127,0.333240929276894,29
"13214","RS","Roca Sales",11471,40933.3,43021,"Lajeado-Estrela",4,"Sul",0,"431580",3,10,4,6,1,9,1,0,1,0,1,11,4,7,1,10,9,10.6196991916945,9.34757739028127,0.448602813508815,31
"13215","RS","Roca Sales",11471,40933.3,43021,"Lajeado-Estrela",4,"Sul",0,"431580",4,14,1,13,4,10,0,0,0,0,0,14,1,13,4,10,2,10.6196991916945,9.34757739028127,0.4875540741354,30
"13216","RS","Roca Sales",11471,40933.3,43021,"Lajeado-Estrela",4,"Sul",0,"431580",5,7,0,7,0,7,0,0,0,0,0,7,0,7,0,7,11,10.6196991916945,9.34757739028127,0.423991019828671,31
"13217","RS","Rolante",21453,29148.17,43024,"Gramado-Canela",4,"Sul",0,"431600",2,17,9,8,5,12,0,0,0,0,0,17,9,8,5,12,7,10.2801474110773,9.97361977471651,0.31182267371894,29
"13218","RS","Rolante",21453,29148.17,43024,"Gramado-Canela",4,"Sul",0,"431600",3,23,11,12,5,18,1,0,1,0,1,24,11,13,5,19,12,10.2801474110773,9.97361977471651,0.408802925670102,31
"13219","RS","Rolante",21453,29148.17,43024,"Gramado-Canela",4,"Sul",0,"431600",4,27,13,14,11,16,0,0,0,0,0,27,13,14,11,16,7,10.2801474110773,9.97361977471651,0.422538905019648,30
"13220","RS","Rolante",21453,29148.17,43024,"Gramado-Canela",4,"Sul",0,"431600",5,23,4,19,10,13,0,0,0,0,0,23,4,19,10,13,11,10.2801474110773,9.97361977471651,0.394226170667906,31
"13221","RS","Rosário do Sul",39314,22909.03,43030,"Campanha Central",4,"Sul",1,"431640",2,28,9,19,12,16,0,0,0,0,0,28,9,19,12,16,20,10.0392864349615,10.5793359685177,0.315955115813623,29
"13222","RS","Rosário do Sul",39314,22909.03,43030,"Campanha Central",4,"Sul",1,"431640",3,22,6,16,4,18,0,0,0,0,0,22,6,16,4,18,28,10.0392864349615,10.5793359685177,0.401724437957252,31
"13223","RS","Rosário do Sul",39314,22909.03,43030,"Campanha Central",4,"Sul",1,"431640",4,42,16,26,17,25,0,0,0,0,0,42,16,26,17,25,25,10.0392864349615,10.5793359685177,0.415206526846655,30
"13224","RS","Rosário do Sul",39314,22909.03,43030,"Campanha Central",4,"Sul",1,"431640",5,36,12,24,15,21,0,0,0,0,0,36,12,24,15,21,24,10.0392864349615,10.5793359685177,0.383002868626885,31
"13225","RS","Salto do Jacuí",12481,64808,43011,"Cruz Alta",4,"Sul",0,"431645",2,4,2,2,2,2,0,0,0,0,0,4,2,2,2,2,4,11.0791843315103,9.43196276691845,0.303886306486244,29
"13226","RS","Salto do Jacuí",12481,64808,43011,"Cruz Alta",4,"Sul",0,"431645",3,7,4,3,2,5,0,0,0,0,0,7,4,3,2,5,9,11.0791843315103,9.43196276691845,0.401876960583278,31
"13227","RS","Salto do Jacuí",12481,64808,43011,"Cruz Alta",4,"Sul",0,"431645",4,9,2,7,2,7,0,0,0,0,0,9,2,7,2,7,10,11.0791843315103,9.43196276691845,0.42657981357233,30
"13228","RS","Salto do Jacuí",12481,64808,43011,"Cruz Alta",4,"Sul",0,"431645",5,6,1,5,3,3,0,0,0,0,0,6,1,5,3,3,6,11.0791843315103,9.43196276691845,0.419107248616728,31
"13229","RS","Salvador do Sul",7889,36513.05,43023,"Montenegro",4,"Sul",0,"431650",2,2,1,1,0,2,0,0,0,0,0,2,1,1,0,2,2,10.505425009917,8.97322466309509,0.333795100677053,29
"13230","RS","Salvador do Sul",7889,36513.05,43023,"Montenegro",4,"Sul",0,"431650",3,9,2,7,3,6,0,0,0,0,0,9,2,7,3,6,2,10.505425009917,8.97322466309509,0.439173281791512,31
"13231","RS","Salvador do Sul",7889,36513.05,43023,"Montenegro",4,"Sul",0,"431650",4,12,1,11,6,6,0,0,0,0,0,12,1,11,6,6,5,10.505425009917,8.97322466309509,0.446861099859821,30
"13232","RS","Salvador do Sul",7889,36513.05,43023,"Montenegro",4,"Sul",0,"431650",5,6,0,6,3,3,0,0,0,0,0,6,0,6,3,3,5,10.505425009917,8.97322466309509,0.426258373523521,31
"13233","RS","Sananduva",16328,36886.58,43005,"Sananduva",4,"Sul",0,"431660",2,11,0,11,5,6,0,0,0,0,0,11,0,11,5,6,9,10.5156030782421,9.70063670448968,0.289191792024016,29
"13234","RS","Sananduva",16328,36886.58,43005,"Sananduva",4,"Sul",0,"431660",3,7,3,4,3,4,0,0,0,0,0,7,3,4,3,4,9,10.5156030782421,9.70063670448968,0.369500453320663,31
"13235","RS","Sananduva",16328,36886.58,43005,"Sananduva",4,"Sul",0,"431660",4,17,6,11,8,9,0,0,0,0,0,17,6,11,8,9,5,10.5156030782421,9.70063670448968,0.403670159615407,30
"13236","RS","Sananduva",16328,36886.58,43005,"Sananduva",4,"Sul",0,"431660",5,18,2,16,2,16,0,0,0,0,0,18,2,16,2,16,11,10.5156030782421,9.70063670448968,0.365930929753275,31
"13237","RS","Santa Bárbara do Sul",7909,97177.43,43011,"Cruz Alta",4,"Sul",0,"431670",2,10,2,8,2,8,0,0,0,0,0,10,2,8,2,8,5,11.4842937618395,8.97575663051942,0.289566032923545,29
"13238","RS","Santa Bárbara do Sul",7909,97177.43,43011,"Cruz Alta",4,"Sul",0,"431670",3,4,0,4,3,1,0,0,0,0,0,4,0,4,3,1,6,11.4842937618395,8.97575663051942,0.386030136932443,31
"13239","RS","Santa Bárbara do Sul",7909,97177.43,43011,"Cruz Alta",4,"Sul",0,"431670",4,12,2,10,3,9,0,0,0,0,0,12,2,10,3,9,6,11.4842937618395,8.97575663051942,0.368763745839981,30
"13240","RS","Santa Bárbara do Sul",7909,97177.43,43011,"Cruz Alta",4,"Sul",0,"431670",5,11,4,7,2,9,0,0,0,0,0,11,4,7,2,9,4,11.4842937618395,8.97575663051942,0.392149817204091,31
"13241","RS","Santa Clara do Sul",6681,40944.1,43021,"Lajeado-Estrela",4,"Sul",1,"431675",2,4,1,3,1,3,0,0,0,0,0,4,1,3,1,3,3,10.6199630007569,8.80702295592548,0.294563630337434,29
"13242","RS","Santa Clara do Sul",6681,40944.1,43021,"Lajeado-Estrela",4,"Sul",1,"431675",3,5,2,3,3,2,0,0,0,0,0,5,2,3,3,2,2,10.6199630007569,8.80702295592548,0.395363687446071,31
"13243","RS","Santa Clara do Sul",6681,40944.1,43021,"Lajeado-Estrela",4,"Sul",1,"431675",4,3,1,2,1,2,0,0,0,0,0,3,1,2,1,2,2,10.6199630007569,8.80702295592548,0.41513671405922,30
"13244","RS","Santa Clara do Sul",6681,40944.1,43021,"Lajeado-Estrela",4,"Sul",1,"431675",5,4,0,4,1,3,0,0,0,0,0,4,0,4,1,3,3,10.6199630007569,8.80702295592548,0.397744790707546,31
"13245","RS","Santa Cruz do Sul",131365,73286.09,43020,"Santa Cruz do Sul",4,"Sul",1,"431680",2,113,24,89,34,79,3,0,3,0,3,116,24,92,34,82,74,11.2021261017901,11.7857349872993,0.307635834851168,29
"13246","RS","Santa Cruz do Sul",131365,73286.09,43020,"Santa Cruz do Sul",4,"Sul",1,"431680",3,130,27,103,33,97,1,1,0,0,1,131,28,103,33,98,74,11.2021261017901,11.7857349872993,0.413006909493493,31
"13247","RS","Santa Cruz do Sul",131365,73286.09,43020,"Santa Cruz do Sul",4,"Sul",1,"431680",4,111,27,84,31,80,1,0,1,0,1,112,27,85,31,81,63,11.2021261017901,11.7857349872993,0.465528723385778,30
"13248","RS","Santa Cruz do Sul",131365,73286.09,43020,"Santa Cruz do Sul",4,"Sul",1,"431680",5,125,28,97,29,96,0,0,0,0,0,125,28,97,29,96,90,11.2021261017901,11.7857349872993,0.419872663840435,31
"13249","RS","Santa Maria",283677,27785.51,43018,"Santa Maria",4,"Sul",1,"431690",2,230,49,181,64,166,3,2,1,2,1,233,51,182,66,167,144,10.2322699407732,12.555591545956,0.320523134586051,29
"13250","RS","Santa Maria",283677,27785.51,43018,"Santa Maria",4,"Sul",1,"431690",3,285,52,233,98,187,0,0,0,0,0,285,52,233,98,187,166,10.2322699407732,12.555591545956,0.441122198248589,31
"13251","RS","Santa Maria",283677,27785.51,43018,"Santa Maria",4,"Sul",1,"431690",4,244,55,189,83,161,0,0,0,0,0,244,55,189,83,161,161,10.2322699407732,12.555591545956,0.491527411797554,30
"13252","RS","Santa Maria",283677,27785.51,43018,"Santa Maria",4,"Sul",1,"431690",5,270,72,198,91,179,3,2,1,1,2,273,74,199,92,181,194,10.2322699407732,12.555591545956,0.440041260909263,31
"13253","RS","Sant'Ana do Livramento",76321,33840.09,43030,"Campanha Central",4,"Sul",1,"431710",2,86,18,68,28,58,0,0,0,0,0,86,18,68,28,58,51,10.4294014732911,11.2427034087617,0.314922206012836,29
"13254","RS","Sant'Ana do Livramento",76321,33840.09,43030,"Campanha Central",4,"Sul",1,"431710",3,74,24,50,27,47,3,2,1,1,2,77,26,51,28,49,59,10.4294014732911,11.2427034087617,0.427312436792744,31
"13255","RS","Sant'Ana do Livramento",76321,33840.09,43030,"Campanha Central",4,"Sul",1,"431710",4,79,26,53,29,50,0,0,0,0,0,79,26,53,29,50,61,10.4294014732911,11.2427034087617,0.454363622529459,30
"13256","RS","Sant'Ana do Livramento",76321,33840.09,43030,"Campanha Central",4,"Sul",1,"431710",5,113,32,81,37,76,6,3,3,4,2,119,35,84,41,78,64,10.4294014732911,11.2427034087617,0.402901469416328,31
"13257","RS","Santa Rosa",73575,41100.58,43001,"Santa Rosa",4,"Sul",1,"431720",2,77,14,63,23,54,0,0,0,0,0,77,14,63,23,54,46,10.6237775123069,11.2060605731017,0.304961132175967,29
"13258","RS","Santa Rosa",73575,41100.58,43001,"Santa Rosa",4,"Sul",1,"431720",3,70,10,60,19,51,0,0,0,0,0,70,10,60,19,51,33,10.6237775123069,11.2060605731017,0.373691214810269,31
"13259","RS","Santa Rosa",73575,41100.58,43001,"Santa Rosa",4,"Sul",1,"431720",4,79,5,74,23,56,0,0,0,0,0,79,5,74,23,56,37,10.6237775123069,11.2060605731017,0.415016945798443,30
"13260","RS","Santa Rosa",73575,41100.58,43001,"Santa Rosa",4,"Sul",1,"431720",5,101,10,91,36,65,1,0,1,0,1,102,10,92,36,66,39,10.6237775123069,11.2060605731017,0.392270707406934,31
"13261","RS","Santa Vitória do Palmar",29483,44990.62,43035,"Litoral Lagunar",4,"Sul",1,"431730",2,25,6,19,9,16,0,0,0,0,0,25,6,19,9,16,24,10.7142093025804,10.2915691050334,0.311980100508624,29
"13262","RS","Santa Vitória do Palmar",29483,44990.62,43035,"Litoral Lagunar",4,"Sul",1,"431730",3,28,9,19,11,17,0,0,0,0,0,28,9,19,11,17,30,10.7142093025804,10.2915691050334,0.405743819733726,31
"13263","RS","Santa Vitória do Palmar",29483,44990.62,43035,"Litoral Lagunar",4,"Sul",1,"431730",4,28,10,18,12,16,0,0,0,0,0,28,10,18,12,16,30,10.7142093025804,10.2915691050334,0.431049301527059,30
"13264","RS","Santa Vitória do Palmar",29483,44990.62,43035,"Litoral Lagunar",4,"Sul",1,"431730",5,31,7,24,10,21,0,0,0,0,0,31,7,24,10,21,27,10.7142093025804,10.2915691050334,0.397852827334866,31
"13265","RS","Santiago",49360,29150.81,43017,"Santiago",4,"Sul",1,"431740",2,42,4,38,13,29,1,0,1,0,1,43,4,39,13,30,24,10.2802379786996,10.8068956585793,0.291757604115452,29
"13266","RS","Santiago",49360,29150.81,43017,"Santiago",4,"Sul",1,"431740",3,41,4,37,13,28,0,0,0,0,0,41,4,37,13,28,22,10.2802379786996,10.8068956585793,0.40031916716313,31
"13267","RS","Santiago",49360,29150.81,43017,"Santiago",4,"Sul",1,"431740",4,38,9,29,16,22,1,1,0,0,1,39,10,29,16,23,31,10.2802379786996,10.8068956585793,0.421942260180679,30
"13268","RS","Santiago",49360,29150.81,43017,"Santiago",4,"Sul",1,"431740",5,43,7,36,10,33,0,0,0,0,0,43,7,36,10,33,39,10.2802379786996,10.8068956585793,0.382651141409574,31
"13269","RS","Santo Ângelo",77568,34128.89,43007,"Santo Ângelo",4,"Sul",1,"431750",2,78,20,58,34,44,0,0,0,0,0,78,20,58,34,44,53,10.4378995186646,11.2589102499889,0.310451019855469,29
"13270","RS","Santo Ângelo",77568,34128.89,43007,"Santo Ângelo",4,"Sul",1,"431750",3,92,23,69,34,58,0,0,0,0,0,92,23,69,34,58,59,10.4378995186646,11.2589102499889,0.403599222473893,31
"13271","RS","Santo Ângelo",77568,34128.89,43007,"Santo Ângelo",4,"Sul",1,"431750",4,81,23,58,29,52,0,0,0,0,0,81,23,58,29,52,43,10.4378995186646,11.2589102499889,0.441097859857432,30
"13272","RS","Santo Ângelo",77568,34128.89,43007,"Santo Ângelo",4,"Sul",1,"431750",5,77,22,55,19,58,1,1,0,0,1,78,23,55,19,59,47,10.4378995186646,11.2589102499889,0.428199902228568,31
"13273","RS","Santo Antônio da Patrulha",43171,29889.94,43027,"Osório",4,"Sul",0,"431760",2,27,5,22,10,17,0,0,0,0,0,27,5,22,10,17,30,10.3052772479156,10.6729242525157,0.275423184717832,29
"13274","RS","Santo Antônio da Patrulha",43171,29889.94,43027,"Osório",4,"Sul",0,"431760",3,39,12,27,17,22,0,0,0,0,0,39,12,27,17,22,30,10.3052772479156,10.6729242525157,0.384097737521028,31
"13275","RS","Santo Antônio da Patrulha",43171,29889.94,43027,"Osório",4,"Sul",0,"431760",4,38,10,28,17,21,0,0,0,0,0,38,10,28,17,21,22,10.3052772479156,10.6729242525157,0.422079879722013,30
"13276","RS","Santo Antônio da Patrulha",43171,29889.94,43027,"Osório",4,"Sul",0,"431760",5,39,9,30,11,28,0,0,0,0,0,39,9,30,11,28,26,10.3052772479156,10.6729242525157,0.381755449885889,31
"13277","RS","Santo Augusto",13848,39859.94,43008,"Ijuí",4,"Sul",1,"431780",2,10,3,7,5,5,0,0,0,0,0,10,3,7,5,5,8,10.5931270884972,9.53589609685605,0.314523064481441,29
"13278","RS","Santo Augusto",13848,39859.94,43008,"Ijuí",4,"Sul",1,"431780",3,14,4,10,2,12,0,0,0,0,0,14,4,10,2,12,5,10.5931270884972,9.53589609685605,0.404740425459932,31
"13279","RS","Santo Augusto",13848,39859.94,43008,"Ijuí",4,"Sul",1,"431780",4,14,1,13,6,8,0,0,0,0,0,14,1,13,6,8,7,10.5931270884972,9.53589609685605,0.419307228489227,30
"13280","RS","Santo Augusto",13848,39859.94,43008,"Ijuí",4,"Sul",1,"431780",5,14,4,10,4,10,0,0,0,0,0,14,4,10,4,10,11,10.5931270884972,9.53589609685605,0.402434341709608,31
"13281","RS","Santo Cristo",14216,39854.23,43001,"Santa Rosa",4,"Sul",0,"431790",2,16,1,15,4,12,0,0,0,0,0,16,1,15,4,12,10,10.5929838266403,9.56212336983449,0.306532256989508,29
"13282","RS","Santo Cristo",14216,39854.23,43001,"Santa Rosa",4,"Sul",0,"431790",3,7,0,7,2,5,0,0,0,0,0,7,0,7,2,5,10,10.5929838266403,9.56212336983449,0.373688752986616,31
"13283","RS","Santo Cristo",14216,39854.23,43001,"Santa Rosa",4,"Sul",0,"431790",4,14,2,12,2,12,0,0,0,0,0,14,2,12,2,12,10,10.5929838266403,9.56212336983449,0.391462877954802,30
"13284","RS","Santo Cristo",14216,39854.23,43001,"Santa Rosa",4,"Sul",0,"431790",5,15,2,13,2,13,0,0,0,0,0,15,2,13,2,13,10,10.5929838266403,9.56212336983449,0.412087831925827,31
"13285","RS","São Borja",60019,31467.27,43029,"Campanha Ocidental",4,"Sul",1,"431800",2,45,4,41,13,32,0,0,0,0,0,45,4,41,13,32,37,10.3567032370105,11.0024164577426,0.326767458768403,29
"13286","RS","São Borja",60019,31467.27,43029,"Campanha Ocidental",4,"Sul",1,"431800",3,56,6,50,21,35,0,0,0,0,0,56,6,50,21,35,39,10.3567032370105,11.0024164577426,0.415613923001151,31
"13287","RS","São Borja",60019,31467.27,43029,"Campanha Ocidental",4,"Sul",1,"431800",4,56,15,41,21,35,1,1,0,1,0,57,16,41,22,35,40,10.3567032370105,11.0024164577426,0.433038044024722,30
"13288","RS","São Borja",60019,31467.27,43029,"Campanha Ocidental",4,"Sul",1,"431800",5,66,15,51,20,46,0,0,0,0,0,66,15,51,20,46,34,10.3567032370105,11.0024164577426,0.422909146247568,31
"13289","RS","São Francisco de Assis",18205,26750.31,43029,"Campanha Ocidental",4,"Sul",0,"431810",2,9,1,8,2,7,0,0,0,0,0,9,1,8,2,7,12,10.194301341042,9.80945156060953,0.279898213853493,29
"13290","RS","São Francisco de Assis",18205,26750.31,43029,"Campanha Ocidental",4,"Sul",0,"431810",3,15,6,9,4,11,0,0,0,0,0,15,6,9,4,11,15,10.194301341042,9.80945156060953,0.370538969777734,31
"13291","RS","São Francisco de Assis",18205,26750.31,43029,"Campanha Ocidental",4,"Sul",0,"431810",4,12,2,10,6,6,0,0,0,0,0,12,2,10,6,6,13,10.194301341042,9.80945156060953,0.389676333776528,30
"13292","RS","São Francisco de Assis",18205,26750.31,43029,"Campanha Ocidental",4,"Sul",0,"431810",5,13,1,12,7,6,0,0,0,0,0,13,1,12,7,6,11,10.194301341042,9.80945156060953,0.35110317037699,31
"13293","RS","São Francisco de Paula",21801,28411.7,43015,"Vacaria",4,"Sul",0,"431820",2,25,11,14,10,15,0,0,0,0,0,25,11,14,10,15,7,10.2545563111432,9.98971111928475,0.327114233788638,29
"13294","RS","São Francisco de Paula",21801,28411.7,43015,"Vacaria",4,"Sul",0,"431820",3,24,15,9,11,13,0,0,0,0,0,24,15,9,11,13,10,10.2545563111432,9.98971111928475,0.419662793583668,31
"13295","RS","São Francisco de Paula",21801,28411.7,43015,"Vacaria",4,"Sul",0,"431820",4,23,13,10,16,7,0,0,0,0,0,23,13,10,16,7,12,10.2545563111432,9.98971111928475,0.425020052289615,30
"13296","RS","São Francisco de Paula",21801,28411.7,43015,"Vacaria",4,"Sul",0,"431820",5,18,5,13,8,10,0,0,0,0,0,18,5,13,8,10,17,10.2545563111432,9.98971111928475,0.414987879427749,31
"13297","RS","São Gabriel",62147,29673.16,43030,"Campanha Central",4,"Sul",1,"431830",2,54,14,40,25,29,0,0,0,0,0,54,14,40,25,29,35,10.2979982125007,11.0372578254601,0.307584359858339,29
"13298","RS","São Gabriel",62147,29673.16,43030,"Campanha Central",4,"Sul",1,"431830",3,48,16,32,13,35,1,0,1,1,0,49,16,33,14,35,45,10.2979982125007,11.0372578254601,0.389262389168832,31
"13299","RS","São Gabriel",62147,29673.16,43030,"Campanha Central",4,"Sul",1,"431830",4,64,18,46,23,41,1,0,1,1,0,65,18,47,24,41,40,10.2979982125007,11.0372578254601,0.420055417870971,30
"13300","RS","São Gabriel",62147,29673.16,43030,"Campanha Central",4,"Sul",1,"431830",5,62,21,41,23,39,1,0,1,1,0,63,21,42,24,39,58,10.2979982125007,11.0372578254601,0.403969388664102,31
"13301","RS","São Jerônimo",24412,24175.77,43025,"São Jerônimo",4,"Sul",1,"431840",2,27,10,17,13,14,0,0,0,0,0,27,10,17,13,14,14,10.0931061709001,10.1028300936644,0.29820835426686,29
"13302","RS","São Jerônimo",24412,24175.77,43025,"São Jerônimo",4,"Sul",1,"431840",3,25,11,14,7,18,0,0,0,0,0,25,11,14,7,18,14,10.0931061709001,10.1028300936644,0.423401306838139,31
"13303","RS","São Jerônimo",24412,24175.77,43025,"São Jerônimo",4,"Sul",1,"431840",4,17,6,11,6,11,0,0,0,0,0,17,6,11,6,11,11,10.0931061709001,10.1028300936644,0.463612157574651,30
"13304","RS","São Jerônimo",24412,24175.77,43025,"São Jerônimo",4,"Sul",1,"431840",5,19,4,15,9,10,0,0,0,0,0,19,4,15,9,10,9,10.0931061709001,10.1028300936644,0.423149563316786,31
"13305","RS","São José do Norte",27721,29672.28,43035,"Litoral Lagunar",4,"Sul",0,"431850",2,20,6,14,7,13,0,0,0,0,0,20,6,14,7,13,24,10.2979685556307,10.2299455276892,0.335722779238078,29
"13306","RS","São José do Norte",27721,29672.28,43035,"Litoral Lagunar",4,"Sul",0,"431850",3,21,8,13,8,13,0,0,0,0,0,21,8,13,8,13,21,10.2979685556307,10.2299455276892,0.421103542981572,31
"13307","RS","São José do Norte",27721,29672.28,43035,"Litoral Lagunar",4,"Sul",0,"431850",4,22,9,13,10,12,0,0,0,0,0,22,9,13,10,12,14,10.2979685556307,10.2299455276892,0.438837291215234,30
"13308","RS","São José do Norte",27721,29672.28,43035,"Litoral Lagunar",4,"Sul",0,"431850",5,32,16,16,17,15,0,0,0,0,0,32,16,16,17,15,17,10.2979685556307,10.2299455276892,0.437924185313838,31
"13309","RS","São Leopoldo",238648,38317.82,43026,"Porto Alegre",4,"Sul",1,"431870",2,192,61,131,51,141,1,1,0,0,1,193,62,131,51,142,106,10.5536703411137,12.3827449419254,0.312370204721516,29
"13310","RS","São Leopoldo",238648,38317.82,43026,"Porto Alegre",4,"Sul",1,"431870",3,212,74,138,78,134,1,0,1,1,0,213,74,139,79,134,135,10.5536703411137,12.3827449419254,0.427418117718821,31
"13311","RS","São Leopoldo",238648,38317.82,43026,"Porto Alegre",4,"Sul",1,"431870",4,219,76,143,92,127,1,1,0,0,1,220,77,143,92,128,100,10.5536703411137,12.3827449419254,0.485049812039438,30
"13312","RS","São Leopoldo",238648,38317.82,43026,"Porto Alegre",4,"Sul",1,"431870",5,223,91,132,77,146,0,0,0,0,0,223,91,132,77,146,119,10.5536703411137,12.3827449419254,0.422383679562277,31
"13313","RS","São Lourenço do Sul",43540,24393.81,43033,"Pelotas",4,"Sul",0,"431880",2,34,16,18,10,24,0,0,0,0,0,34,16,18,10,24,28,10.1020846905723,10.6814353347885,0.299537110280988,29
"13314","RS","São Lourenço do Sul",43540,24393.81,43033,"Pelotas",4,"Sul",0,"431880",3,37,15,22,11,26,0,0,0,0,0,37,15,22,11,26,28,10.1020846905723,10.6814353347885,0.423284797430788,31
"13315","RS","São Lourenço do Sul",43540,24393.81,43033,"Pelotas",4,"Sul",0,"431880",4,30,10,20,7,23,0,0,0,0,0,30,10,20,7,23,33,10.1020846905723,10.6814353347885,0.454242835033924,30
"13316","RS","São Lourenço do Sul",43540,24393.81,43033,"Pelotas",4,"Sul",0,"431880",5,37,14,23,7,30,0,0,0,0,0,37,14,23,7,30,47,10.1020846905723,10.6814353347885,0.437583190543849,31
"13317","RS","São Luiz Gonzaga",33293,39604.23,43007,"Santo Ângelo",4,"Sul",1,"431890",2,39,13,26,14,25,0,0,0,0,0,39,13,26,14,25,15,10.5866912097197,10.4131024436611,0.300245771032207,29
"13318","RS","São Luiz Gonzaga",33293,39604.23,43007,"Santo Ângelo",4,"Sul",1,"431890",3,31,8,23,11,20,0,0,0,0,0,31,8,23,11,20,21,10.5866912097197,10.4131024436611,0.364263324112009,31
"13319","RS","São Luiz Gonzaga",33293,39604.23,43007,"Santo Ângelo",4,"Sul",1,"431890",4,37,15,22,12,25,0,0,0,0,0,37,15,22,12,25,31,10.5866912097197,10.4131024436611,0.383810458521539,30
"13320","RS","São Luiz Gonzaga",33293,39604.23,43007,"Santo Ângelo",4,"Sul",1,"431890",5,27,10,17,13,14,0,0,0,0,0,27,10,17,13,14,17,10.5866912097197,10.4131024436611,0.383201395372567,31
"13321","RS","São Marcos",21658,39582.39,43016,"Caxias do Sul",4,"Sul",1,"431900",2,11,0,11,2,9,1,0,1,0,1,12,0,12,2,10,13,10.5861396013659,9.98313018018832,0.306599839292445,29
"13322","RS","São Marcos",21658,39582.39,43016,"Caxias do Sul",4,"Sul",1,"431900",3,18,4,14,6,12,0,0,0,0,0,18,4,14,6,12,14,10.5861396013659,9.98313018018832,0.413798295518243,31
"13323","RS","São Marcos",21658,39582.39,43016,"Caxias do Sul",4,"Sul",1,"431900",4,21,4,17,7,14,0,0,0,0,0,21,4,17,7,14,9,10.5861396013659,9.98313018018832,0.430497964949231,30
"13324","RS","São Marcos",21658,39582.39,43016,"Caxias do Sul",4,"Sul",1,"431900",5,16,3,13,3,13,0,0,0,0,0,16,3,13,3,13,13,10.5861396013659,9.98313018018832,0.397173913165891,31
"13325","RS","São Pedro do Sul",16148,24488.08,43018,"Santa Maria",4,"Sul",0,"431940",2,15,5,10,5,10,0,0,0,0,0,15,5,10,5,10,10,10.1059417475262,9.68955148197283,0.29715059401254,29
"13326","RS","São Pedro do Sul",16148,24488.08,43018,"Santa Maria",4,"Sul",0,"431940",3,19,5,14,4,15,0,0,0,0,0,19,5,14,4,15,17,10.1059417475262,9.68955148197283,0.382373807073206,31
"13327","RS","São Pedro do Sul",16148,24488.08,43018,"Santa Maria",4,"Sul",0,"431940",4,11,2,9,5,6,0,0,0,0,0,11,2,9,5,6,14,10.1059417475262,9.68955148197283,0.401816855496099,30
"13328","RS","São Pedro do Sul",16148,24488.08,43018,"Santa Maria",4,"Sul",0,"431940",5,11,3,8,3,8,0,0,0,0,0,11,3,8,3,8,14,10.1059417475262,9.68955148197283,0.375089169978168,31
"13329","RS","São Sebastião do Caí",25959,27553.28,43023,"Montenegro",4,"Sul",1,"431950",2,16,7,9,7,9,0,0,0,0,0,16,7,9,7,9,21,10.2238768637558,10.1642736492748,0.323653964999324,29
"13330","RS","São Sebastião do Caí",25959,27553.28,43023,"Montenegro",4,"Sul",1,"431950",3,21,7,14,7,14,0,0,0,0,0,21,7,14,7,14,15,10.2238768637558,10.1642736492748,0.421233240449426,31
"13331","RS","São Sebastião do Caí",25959,27553.28,43023,"Montenegro",4,"Sul",1,"431950",4,25,14,11,10,15,0,0,0,0,0,25,14,11,10,15,16,10.2238768637558,10.1642736492748,0.45633855629128,30
"13332","RS","São Sebastião do Caí",25959,27553.28,43023,"Montenegro",4,"Sul",1,"431950",5,17,9,8,8,9,0,0,0,0,0,17,9,8,8,9,18,10.2238768637558,10.1642736492748,0.411360657197889,31
"13333","RS","São Sepé",23555,33987.83,43018,"Santa Maria",4,"Sul",0,"431960",2,22,4,18,9,13,0,0,0,0,0,22,4,18,9,13,15,10.4337577983456,10.0670933911341,0.270538218634168,29
"13334","RS","São Sepé",23555,33987.83,43018,"Santa Maria",4,"Sul",0,"431960",3,15,9,6,5,10,0,0,0,0,0,15,9,6,5,10,17,10.4337577983456,10.0670933911341,0.369096987721338,31
"13335","RS","São Sepé",23555,33987.83,43018,"Santa Maria",4,"Sul",0,"431960",4,20,6,14,4,16,0,0,0,0,0,20,6,14,4,16,15,10.4337577983456,10.0670933911341,0.392115858065153,30
"13336","RS","São Sepé",23555,33987.83,43018,"Santa Maria",4,"Sul",0,"431960",5,19,7,12,5,14,0,0,0,0,0,19,7,12,5,14,22,10.4337577983456,10.0670933911341,0.375026254943341,31
"13337","RS","São Vicente do Sul",8732,31529.04,43018,"Santa Maria",4,"Sul",0,"431980",2,6,1,5,1,5,0,0,0,0,0,6,1,5,1,5,5,10.3586643048824,9.07474971766984,0.317302311524565,29
"13338","RS","São Vicente do Sul",8732,31529.04,43018,"Santa Maria",4,"Sul",0,"431980",3,7,1,6,1,6,0,0,0,0,0,7,1,6,1,6,3,10.3586643048824,9.07474971766984,0.433186798614791,31
"13339","RS","São Vicente do Sul",8732,31529.04,43018,"Santa Maria",4,"Sul",0,"431980",4,8,0,8,2,6,0,0,0,0,0,8,0,8,2,6,2,10.3586643048824,9.07474971766984,0.467451118439729,30
"13340","RS","São Vicente do Sul",8732,31529.04,43018,"Santa Maria",4,"Sul",0,"431980",5,6,1,5,4,2,0,0,0,0,0,6,1,5,4,2,4,10.3586643048824,9.07474971766984,0.40555678369232,31
"13341","RS","Sapiranga",80037,40789.31,43026,"Porto Alegre",4,"Sul",1,"431990",2,82,17,65,33,49,0,0,0,0,0,82,17,65,33,49,52,10.6161753162578,11.2902443067359,0.294056760936026,29
"13342","RS","Sapiranga",80037,40789.31,43026,"Porto Alegre",4,"Sul",1,"431990",3,93,28,65,30,63,2,1,1,1,1,95,29,66,31,64,29,10.6161753162578,11.2902443067359,0.405406904858322,31
"13343","RS","Sapiranga",80037,40789.31,43026,"Porto Alegre",4,"Sul",1,"431990",4,83,18,65,34,49,0,0,0,0,0,83,18,65,34,49,33,10.6161753162578,11.2902443067359,0.432162734730818,30
"13344","RS","Sapiranga",80037,40789.31,43026,"Porto Alegre",4,"Sul",1,"431990",5,99,27,72,34,65,0,0,0,0,0,99,27,72,34,65,43,10.6161753162578,11.2902443067359,0.380542135673755,31
"13345","RS","Sapucaia do Sul",141808,24171.89,43026,"Porto Alegre",4,"Sul",1,"432000",2,114,33,81,44,70,0,0,0,0,0,114,33,81,44,70,68,10.0929456667513,11.8622293089782,0.305127746207678,29
"13346","RS","Sapucaia do Sul",141808,24171.89,43026,"Porto Alegre",4,"Sul",1,"432000",3,125,41,84,40,85,1,1,0,1,0,126,42,84,41,85,83,10.0929456667513,11.8622293089782,0.411778389681297,31
"13347","RS","Sapucaia do Sul",141808,24171.89,43026,"Porto Alegre",4,"Sul",1,"432000",4,133,49,84,42,91,3,1,2,1,2,136,50,86,43,93,66,10.0929456667513,11.8622293089782,0.474345264668529,30
"13348","RS","Sapucaia do Sul",141808,24171.89,43026,"Porto Alegre",4,"Sul",1,"432000",5,148,41,107,64,84,2,2,0,2,0,150,43,107,66,84,78,10.0929456667513,11.8622293089782,0.414734895996071,31
"13349","RS","Sarandi",24763,37996.58,43009,"Carazinho",4,"Sul",1,"432010",2,17,3,14,6,11,0,0,0,0,0,17,3,14,6,11,11,10.5452514346583,10.1171058826253,0.308403613696946,29
"13350","RS","Sarandi",24763,37996.58,43009,"Carazinho",4,"Sul",1,"432010",3,22,5,17,5,17,0,0,0,0,0,22,5,17,5,17,14,10.5452514346583,10.1171058826253,0.413991441480088,31
"13351","RS","Sarandi",24763,37996.58,43009,"Carazinho",4,"Sul",1,"432010",4,27,8,19,7,20,1,0,1,0,1,28,8,20,7,21,8,10.5452514346583,10.1171058826253,0.428877714495027,30
"13352","RS","Sarandi",24763,37996.58,43009,"Carazinho",4,"Sul",1,"432010",5,24,2,22,6,18,0,0,0,0,0,24,2,22,6,18,13,10.5452514346583,10.1171058826253,0.386244648779198,31
"13353","RS","Seberi",10713,33163.84,43003,"Frederico Westphalen",4,"Sul",0,"432020",2,18,10,8,6,12,0,0,0,0,0,18,10,8,6,12,10,10.409215404716,9.27921323626256,0.268588091159257,29
"13354","RS","Seberi",10713,33163.84,43003,"Frederico Westphalen",4,"Sul",0,"432020",3,19,6,13,5,14,0,0,0,0,0,19,6,13,5,14,5,10.409215404716,9.27921323626256,0.379109783387985,31
"13355","RS","Seberi",10713,33163.84,43003,"Frederico Westphalen",4,"Sul",0,"432020",4,11,7,4,5,6,0,0,0,0,0,11,7,4,5,6,11,10.409215404716,9.27921323626256,0.397539482442368,30
"13356","RS","Seberi",10713,33163.84,43003,"Frederico Westphalen",4,"Sul",0,"432020",5,15,2,13,9,6,0,0,0,0,0,15,2,13,9,6,9,10.409215404716,9.27921323626256,0.373597096741885,31
"13357","RS","Serafina Corrêa",17795,38580.62,43014,"Guaporé",4,"Sul",1,"432040",2,14,0,14,6,8,0,0,0,0,0,14,0,14,6,8,8,10.5605053568334,9.78667279794429,0.305771471994916,29
"13358","RS","Serafina Corrêa",17795,38580.62,43014,"Guaporé",4,"Sul",1,"432040",3,18,6,12,6,12,0,0,0,0,0,18,6,12,6,12,9,10.5605053568334,9.78667279794429,0.398228236204734,31
"13359","RS","Serafina Corrêa",17795,38580.62,43014,"Guaporé",4,"Sul",1,"432040",4,16,2,14,5,11,0,0,0,0,0,16,2,14,5,11,6,10.5605053568334,9.78667279794429,0.403382451023067,30
"13360","RS","Serafina Corrêa",17795,38580.62,43014,"Guaporé",4,"Sul",1,"432040",5,14,6,8,8,6,0,0,0,0,0,14,6,8,8,6,10,10.5605053568334,9.78667279794429,0.38120228689011,31
"13361","RS","Sobradinho",15005,24319.95,43020,"Santa Cruz do Sul",4,"Sul",1,"432070",2,17,2,15,7,10,0,0,0,0,0,17,2,15,7,10,8,10.0990522801569,9.61613875787447,0.269858005163706,29
"13362","RS","Sobradinho",15005,24319.95,43020,"Santa Cruz do Sul",4,"Sul",1,"432070",3,10,4,6,6,4,0,0,0,0,0,10,4,6,6,4,12,10.0990522801569,9.61613875787447,0.369251785459162,31
"13363","RS","Sobradinho",15005,24319.95,43020,"Santa Cruz do Sul",4,"Sul",1,"432070",4,16,9,7,3,13,1,0,1,0,1,17,9,8,3,14,10,10.0990522801569,9.61613875787447,0.401743724867934,30
"13364","RS","Sobradinho",15005,24319.95,43020,"Santa Cruz do Sul",4,"Sul",1,"432070",5,17,6,11,7,10,1,0,1,0,1,18,6,12,7,11,11,10.0990522801569,9.61613875787447,0.369115537792505,31
"13365","RS","Soledade",31035,31513.04,43013,"Soledade",4,"Sul",1,"432080",2,19,4,15,3,16,0,0,0,0,0,19,4,15,3,16,23,10.3581567074065,10.3428708788478,0.315252215950204,29
"13366","RS","Soledade",31035,31513.04,43013,"Soledade",4,"Sul",1,"432080",3,25,11,14,12,13,0,0,0,0,0,25,11,14,12,13,21,10.3581567074065,10.3428708788478,0.418909850348012,31
"13367","RS","Soledade",31035,31513.04,43013,"Soledade",4,"Sul",1,"432080",4,34,6,28,15,19,0,0,0,0,0,34,6,28,15,19,18,10.3581567074065,10.3428708788478,0.445067395528355,30
"13368","RS","Soledade",31035,31513.04,43013,"Soledade",4,"Sul",1,"432080",5,34,13,21,10,24,1,0,1,1,0,35,13,22,11,24,19,10.3581567074065,10.3428708788478,0.407883101259415,31
"13369","RS","Tapejara",24552,47621.01,43010,"Passo Fundo",4,"Sul",1,"432090",2,24,6,18,5,19,0,0,0,0,0,24,6,18,5,19,9,10.7710293293917,10.1085485962996,0.329682006519459,29
"13370","RS","Tapejara",24552,47621.01,43010,"Passo Fundo",4,"Sul",1,"432090",3,17,4,13,6,11,0,0,0,0,0,17,4,13,6,11,9,10.7710293293917,10.1085485962996,0.41224651482282,31
"13371","RS","Tapejara",24552,47621.01,43010,"Passo Fundo",4,"Sul",1,"432090",4,26,5,21,5,21,0,0,0,0,0,26,5,21,5,21,8,10.7710293293917,10.1085485962996,0.439084819002509,30
"13372","RS","Tapejara",24552,47621.01,43010,"Passo Fundo",4,"Sul",1,"432090",5,26,4,22,10,16,0,0,0,0,0,26,4,22,10,16,10,10.7710293293917,10.1085485962996,0.408665134985103,31
"13373","RS","Tapera",10577,42813.31,43012,"Não-Me-Toque",4,"Sul",0,"432100",2,9,2,7,3,6,0,0,0,0,0,9,2,7,3,6,6,10.6646043145336,9.26643711132805,0.339338202566122,29
"13374","RS","Tapera",10577,42813.31,43012,"Não-Me-Toque",4,"Sul",0,"432100",3,7,2,5,1,6,0,0,0,0,0,7,2,5,1,6,9,10.6646043145336,9.26643711132805,0.438767139125914,31
"13375","RS","Tapera",10577,42813.31,43012,"Não-Me-Toque",4,"Sul",0,"432100",4,9,2,7,3,6,0,0,0,0,0,9,2,7,3,6,7,10.6646043145336,9.26643711132805,0.496033592046025,30
"13376","RS","Tapera",10577,42813.31,43012,"Não-Me-Toque",4,"Sul",0,"432100",5,10,2,8,3,7,0,0,0,0,0,10,2,8,3,7,7,10.6646043145336,9.26643711132805,0.436118892828137,31
"13377","RS","Tapes",17332,20628.25,43028,"Camaquã",4,"Sul",1,"432110",2,11,2,9,5,6,0,0,0,0,0,11,2,9,5,6,11,9.9344167745467,9.7603097828598,0.29487364957132,29
"13378","RS","Tapes",17332,20628.25,43028,"Camaquã",4,"Sul",1,"432110",3,10,1,9,5,5,0,0,0,0,0,10,1,9,5,5,17,9.9344167745467,9.7603097828598,0.361285365898943,31
"13379","RS","Tapes",17332,20628.25,43028,"Camaquã",4,"Sul",1,"432110",4,15,4,11,5,10,0,0,0,0,0,15,4,11,5,10,12,9.9344167745467,9.7603097828598,0.396862851418637,30
"13380","RS","Tapes",17332,20628.25,43028,"Camaquã",4,"Sul",1,"432110",5,19,4,15,9,10,0,0,0,0,0,19,4,15,9,10,11,9.9344167745467,9.7603097828598,0.359098487402166,31
"13381","RS","Taquara",57584,22810.98,43024,"Gramado-Canela",4,"Sul",1,"432120",2,48,21,27,16,32,1,1,0,1,0,49,22,27,17,32,29,10.034997277968,10.9610000303188,0.312772168208832,29
"13382","RS","Taquara",57584,22810.98,43024,"Gramado-Canela",4,"Sul",1,"432120",3,57,18,39,16,41,0,0,0,0,0,57,18,39,16,41,33,10.034997277968,10.9610000303188,0.427804953923864,31
"13383","RS","Taquara",57584,22810.98,43024,"Gramado-Canela",4,"Sul",1,"432120",4,42,16,26,13,29,0,0,0,0,0,42,16,26,13,29,22,10.034997277968,10.9610000303188,0.461749127884406,30
"13384","RS","Taquara",57584,22810.98,43024,"Gramado-Canela",4,"Sul",1,"432120",5,56,20,36,21,35,1,1,0,1,0,57,21,36,22,35,30,10.034997277968,10.9610000303188,0.410102804070139,31
"13385","RS","Taquari",26885,27940.73,43021,"Lajeado-Estrela",4,"Sul",1,"432130",2,17,5,12,6,11,0,0,0,0,0,17,5,12,6,11,16,10.2378407598855,10.1993237892438,0.272903480931253,29
"13386","RS","Taquari",26885,27940.73,43021,"Lajeado-Estrela",4,"Sul",1,"432130",3,25,5,20,10,15,0,0,0,0,0,25,5,20,10,15,22,10.2378407598855,10.1993237892438,0.369096504285242,31
"13387","RS","Taquari",26885,27940.73,43021,"Lajeado-Estrela",4,"Sul",1,"432130",4,17,4,13,3,14,0,0,0,0,0,17,4,13,3,14,25,10.2378407598855,10.1993237892438,0.409264678980237,30
"13388","RS","Taquari",26885,27940.73,43021,"Lajeado-Estrela",4,"Sul",1,"432130",5,23,4,19,8,15,0,0,0,0,0,23,4,19,8,15,24,10.2378407598855,10.1993237892438,0.39139224207479,31
"13389","RS","Tenente Portela",13434,31143.69,43002,"Três Passos",4,"Sul",0,"432140",2,18,5,13,8,10,0,0,0,0,0,18,5,13,8,10,4,10.3463669354776,9.50554408582681,0.317170979221166,29
"13390","RS","Tenente Portela",13434,31143.69,43002,"Três Passos",4,"Sul",0,"432140",3,26,8,18,13,13,0,0,0,0,0,26,8,18,13,13,7,10.3463669354776,9.50554408582681,0.382758997473838,31
"13391","RS","Tenente Portela",13434,31143.69,43002,"Três Passos",4,"Sul",0,"432140",4,22,9,13,9,13,0,0,0,0,0,22,9,13,9,13,10,10.3463669354776,9.50554408582681,0.398673091802758,30
"13392","RS","Tenente Portela",13434,31143.69,43002,"Três Passos",4,"Sul",0,"432140",5,25,6,19,8,17,0,0,0,0,0,25,6,19,8,17,10,10.3463669354776,9.50554408582681,0.397427410059838,31
"13393","RS","Terra de Areia",11315,20216.48,43027,"Osório",4,"Sul",1,"432143",2,9,5,4,4,5,0,0,0,0,0,9,5,4,4,5,7,9.91425339235561,9.33388455806764,0.337518429310788,29
"13394","RS","Terra de Areia",11315,20216.48,43027,"Osório",4,"Sul",1,"432143",3,7,2,5,3,4,1,0,1,0,1,8,2,6,3,5,2,9.91425339235561,9.33388455806764,0.432389997653618,31
"13395","RS","Terra de Areia",11315,20216.48,43027,"Osório",4,"Sul",1,"432143",4,10,7,3,6,4,0,0,0,0,0,10,7,3,6,4,4,9.91425339235561,9.33388455806764,0.439915905943573,30
"13396","RS","Terra de Areia",11315,20216.48,43027,"Osório",4,"Sul",1,"432143",5,11,2,9,4,7,0,0,0,0,0,11,2,9,4,7,3,9.91425339235561,9.33388455806764,0.411161455800164,31
"13397","RS","Teutônia",33766,43670.5,43021,"Lajeado-Estrela",4,"Sul",0,"432145",2,44,8,36,16,28,0,0,0,0,0,44,8,36,16,28,17,10.6844280959217,10.4272096580371,0.30830304825353,29
"13398","RS","Teutônia",33766,43670.5,43021,"Lajeado-Estrela",4,"Sul",0,"432145",3,36,7,29,10,26,0,0,0,0,0,36,7,29,10,26,18,10.6844280959217,10.4272096580371,0.404055056489631,31
"13399","RS","Teutônia",33766,43670.5,43021,"Lajeado-Estrela",4,"Sul",0,"432145",4,39,4,35,11,28,0,0,0,0,0,39,4,35,11,28,14,10.6844280959217,10.4272096580371,0.453013363383089,30
"13400","RS","Teutônia",33766,43670.5,43021,"Lajeado-Estrela",4,"Sul",0,"432145",5,40,7,33,9,31,0,0,0,0,0,40,7,33,9,31,14,10.6844280959217,10.4272096580371,0.398364023300687,31
"13401","RS","Torres",39064,29651.15,43027,"Osório",4,"Sul",1,"432150",2,31,8,23,12,19,0,0,0,0,0,31,8,23,12,19,25,10.2972561895085,10.5729566057415,0.303797703199795,29
"13402","RS","Torres",39064,29651.15,43027,"Osório",4,"Sul",1,"432150",3,47,12,35,19,28,0,0,0,0,0,47,12,35,19,28,20,10.2972561895085,10.5729566057415,0.469249085694253,31
"13403","RS","Torres",39064,29651.15,43027,"Osório",4,"Sul",1,"432150",4,41,18,23,16,25,0,0,0,0,0,41,18,23,16,25,20,10.2972561895085,10.5729566057415,0.500698805076761,30
"13404","RS","Torres",39064,29651.15,43027,"Osório",4,"Sul",1,"432150",5,47,15,32,15,32,0,0,0,0,0,47,15,32,15,32,34,10.2972561895085,10.5729566057415,0.437741506702233,31
"13405","RS","Tramandaí",52632,20251.61,43027,"Osório",4,"Sul",1,"432160",2,56,29,27,22,34,1,0,1,0,1,57,29,28,22,35,22,9.91598957554708,10.8710795787658,0.321333664061031,29
"13406","RS","Tramandaí",52632,20251.61,43027,"Osório",4,"Sul",1,"432160",3,70,30,40,33,37,0,0,0,0,0,70,30,40,33,37,36,9.91598957554708,10.8710795787658,0.440860511221343,31
"13407","RS","Tramandaí",52632,20251.61,43027,"Osório",4,"Sul",1,"432160",4,60,20,40,24,36,0,0,0,0,0,60,20,40,24,36,30,9.91598957554708,10.8710795787658,0.473812433770587,30
"13408","RS","Tramandaí",52632,20251.61,43027,"Osório",4,"Sul",1,"432160",5,67,19,48,29,38,0,0,0,0,0,67,19,48,29,38,46,9.91598957554708,10.8710795787658,0.434778996867952,31
"13409","RS","Três Cachoeiras",11115,23133.56,43027,"Osório",4,"Sul",0,"432166",2,11,1,10,4,7,0,0,0,0,0,11,1,10,4,7,3,10.0490396560497,9.3160508263983,0.341594530772895,29
"13410","RS","Três Cachoeiras",11115,23133.56,43027,"Osório",4,"Sul",0,"432166",3,12,3,9,6,6,0,0,0,0,0,12,3,9,6,6,11,10.0490396560497,9.3160508263983,0.438529814349682,31
"13411","RS","Três Cachoeiras",11115,23133.56,43027,"Osório",4,"Sul",0,"432166",4,12,2,10,5,7,0,0,0,0,0,12,2,10,5,7,3,10.0490396560497,9.3160508263983,0.450076986839472,30
"13412","RS","Três Cachoeiras",11115,23133.56,43027,"Osório",4,"Sul",0,"432166",5,9,4,5,3,6,0,0,0,0,0,9,4,5,3,6,4,10.0490396560497,9.3160508263983,0.402815839346101,31
"13413","RS","Três Coroas",28581,33865.84,43024,"Gramado-Canela",4,"Sul",1,"432170",2,18,8,10,8,10,0,0,0,0,0,18,8,10,8,10,16,10.4301621157117,10.2604974403749,0.313091279389304,29
"13414","RS","Três Coroas",28581,33865.84,43024,"Gramado-Canela",4,"Sul",1,"432170",3,23,9,14,11,12,0,0,0,0,0,23,9,14,11,12,12,10.4301621157117,10.2604974403749,0.420916449184895,31
"13415","RS","Três Coroas",28581,33865.84,43024,"Gramado-Canela",4,"Sul",1,"432170",4,20,10,10,6,14,0,0,0,0,0,20,10,10,6,14,8,10.4301621157117,10.2604974403749,0.453849406296361,30
"13416","RS","Três Coroas",28581,33865.84,43024,"Gramado-Canela",4,"Sul",1,"432170",5,16,5,11,8,8,1,1,0,0,1,17,6,11,8,9,17,10.4301621157117,10.2604974403749,0.411357286119446,31
"13417","RS","Três de Maio",23876,45387.3,43001,"Santa Rosa",4,"Sul",1,"432180",2,20,4,16,4,16,0,0,0,0,0,20,4,16,4,16,18,10.7229876092133,10.0806290492885,0.33497042402045,29
"13418","RS","Três de Maio",23876,45387.3,43001,"Santa Rosa",4,"Sul",1,"432180",3,20,2,18,6,14,1,0,1,1,0,21,2,19,7,14,13,10.7229876092133,10.0806290492885,0.414016814353332,31
"13419","RS","Três de Maio",23876,45387.3,43001,"Santa Rosa",4,"Sul",1,"432180",4,33,12,21,11,22,0,0,0,0,0,33,12,21,11,22,24,10.7229876092133,10.0806290492885,0.414388136167775,30
"13420","RS","Três de Maio",23876,45387.3,43001,"Santa Rosa",4,"Sul",1,"432180",5,27,4,23,6,21,0,0,0,0,0,27,4,23,6,21,12,10.7229876092133,10.0806290492885,0.398547634944345,31
"13421","RS","Três Passos",23852,34502.66,43002,"Três Passos",4,"Sul",0,"432190",2,20,4,16,9,11,0,0,0,0,0,20,4,16,9,11,17,10.4487917014966,10.079623350243,0.303979342764294,29
"13422","RS","Três Passos",23852,34502.66,43002,"Três Passos",4,"Sul",0,"432190",3,28,8,20,7,21,0,0,0,0,0,28,8,20,7,21,22,10.4487917014966,10.079623350243,0.399912975528626,31
"13423","RS","Três Passos",23852,34502.66,43002,"Três Passos",4,"Sul",0,"432190",4,24,5,19,7,17,0,0,0,0,0,24,5,19,7,17,19,10.4487917014966,10.079623350243,0.434428528884714,30
"13424","RS","Três Passos",23852,34502.66,43002,"Três Passos",4,"Sul",0,"432190",5,27,4,23,14,13,0,0,0,0,0,27,4,23,14,13,20,10.4487917014966,10.079623350243,0.413288679618194,31
"13425","RS","Triunfo",29856,304208.49,43025,"São Jerônimo",4,"Sul",1,"432200",2,17,5,12,5,12,0,0,0,0,0,17,5,12,5,12,16,12.6254685676881,10.3041411036471,0.320106177423207,29
"13426","RS","Triunfo",29856,304208.49,43025,"São Jerônimo",4,"Sul",1,"432200",3,23,3,20,8,15,0,0,0,0,0,23,3,20,8,15,17,12.6254685676881,10.3041411036471,0.422238595299545,31
"13427","RS","Triunfo",29856,304208.49,43025,"São Jerônimo",4,"Sul",1,"432200",4,28,8,20,13,15,0,0,0,0,0,28,8,20,13,15,23,12.6254685676881,10.3041411036471,0.467476494068525,30
"13428","RS","Triunfo",29856,304208.49,43025,"São Jerônimo",4,"Sul",1,"432200",5,35,7,28,15,20,0,0,0,0,0,35,7,28,15,20,16,12.6254685676881,10.3041411036471,0.427555042799866,31
"13429","RS","Tupanciretã",24068,53810.85,43017,"Santiago",4,"Sul",1,"432220",2,14,5,9,4,10,0,0,0,0,0,14,5,9,4,10,13,10.8932303986791,10.0886384363402,0.296328930647779,29
"13430","RS","Tupanciretã",24068,53810.85,43017,"Santiago",4,"Sul",1,"432220",3,27,11,16,8,19,0,0,0,0,0,27,11,16,8,19,15,10.8932303986791,10.0886384363402,0.381766319520073,31
"13431","RS","Tupanciretã",24068,53810.85,43017,"Santiago",4,"Sul",1,"432220",4,14,6,8,6,8,1,0,1,1,0,15,6,9,7,8,16,10.8932303986791,10.0886384363402,0.412085945679389,30
"13432","RS","Tupanciretã",24068,53810.85,43017,"Santiago",4,"Sul",1,"432220",5,22,7,15,5,17,0,0,0,0,0,22,7,15,5,17,21,10.8932303986791,10.0886384363402,0.402753306752884,31
"13433","RS","Uruguaiana",126866,21808.17,43029,"Campanha Ocidental",4,"Sul",1,"432240",2,104,33,71,47,57,0,0,0,0,0,104,33,71,47,57,73,9.99003994921041,11.7508866903015,0.309592360958841,29
"13434","RS","Uruguaiana",126866,21808.17,43029,"Campanha Ocidental",4,"Sul",1,"432240",3,123,36,87,53,70,2,1,1,1,1,125,37,88,54,71,77,9.99003994921041,11.7508866903015,0.398884746057591,31
"13435","RS","Uruguaiana",126866,21808.17,43029,"Campanha Ocidental",4,"Sul",1,"432240",4,143,42,101,57,86,3,1,2,0,3,146,43,103,57,89,69,9.99003994921041,11.7508866903015,0.443766756799487,30
"13436","RS","Uruguaiana",126866,21808.17,43029,"Campanha Ocidental",4,"Sul",1,"432240",5,163,45,118,64,99,4,2,2,2,2,167,47,120,66,101,93,9.99003994921041,11.7508866903015,0.427080147197175,31
"13437","RS","Vacaria",66575,34272.82,43015,"Vacaria",4,"Sul",1,"432250",2,68,26,42,24,44,0,0,0,0,0,68,26,42,24,44,36,10.4421078991984,11.1060844106821,0.346221161820376,29
"13438","RS","Vacaria",66575,34272.82,43015,"Vacaria",4,"Sul",1,"432250",3,79,29,50,32,47,1,1,0,1,0,80,30,50,33,47,43,10.4421078991984,11.1060844106821,0.417182436890961,31
"13439","RS","Vacaria",66575,34272.82,43015,"Vacaria",4,"Sul",1,"432250",4,94,31,63,39,55,2,1,1,1,1,96,32,64,40,56,41,10.4421078991984,11.1060844106821,0.436458206630161,30
"13440","RS","Vacaria",66575,34272.82,43015,"Vacaria",4,"Sul",1,"432250",5,85,29,56,30,55,0,0,0,0,0,85,29,56,30,55,45,10.4421078991984,11.1060844106821,0.417491641310822,31
"13441","RS","Vale Real",5981,22086.84,43023,"Montenegro",4,"Sul",1,"432254",2,9,2,7,2,7,0,0,0,0,0,9,2,7,2,7,1,10.002737235027,8.69634305704456,0.301522309841579,29
"13442","RS","Vale Real",5981,22086.84,43023,"Montenegro",4,"Sul",1,"432254",3,8,3,5,2,6,0,0,0,0,0,8,3,5,2,6,3,10.002737235027,8.69634305704456,0.384549325358631,31
"13443","RS","Vale Real",5981,22086.84,43023,"Montenegro",4,"Sul",1,"432254",4,10,4,6,0,10,0,0,0,0,0,10,4,6,0,10,2,10.002737235027,8.69634305704456,0.450266028157913,30
"13444","RS","Vale Real",5981,22086.84,43023,"Montenegro",4,"Sul",1,"432254",5,3,0,3,0,3,0,0,0,0,0,3,0,3,0,3,3,10.002737235027,8.69634305704456,0.41973757772269,31
"13445","RS","Venâncio Aires",71973,49352.93,43020,"Santa Cruz do Sul",4,"Sul",1,"432260",2,60,12,48,11,49,1,0,1,1,0,61,12,49,12,49,35,10.806752414933,11.1840463276681,0.28965917713323,29
"13446","RS","Venâncio Aires",71973,49352.93,43020,"Santa Cruz do Sul",4,"Sul",1,"432260",3,64,18,46,19,45,1,0,1,0,1,65,18,47,19,46,41,10.806752414933,11.1840463276681,0.384894117461321,31
"13447","RS","Venâncio Aires",71973,49352.93,43020,"Santa Cruz do Sul",4,"Sul",1,"432260",4,54,15,39,18,36,0,0,0,0,0,54,15,39,18,36,45,10.806752414933,11.1840463276681,0.420065117448688,30
"13448","RS","Venâncio Aires",71973,49352.93,43020,"Santa Cruz do Sul",4,"Sul",1,"432260",5,49,16,33,13,36,1,1,0,1,0,50,17,33,14,36,56,10.806752414933,11.1840463276681,0.406886843235011,31
"13449","RS","Vera Cruz",27099,24467.49,43020,"Santa Cruz do Sul",4,"Sul",1,"432270",2,21,4,17,6,15,0,0,0,0,0,21,4,17,6,15,15,10.1051005765945,10.207252105818,0.319155476156709,29
"13450","RS","Vera Cruz",27099,24467.49,43020,"Santa Cruz do Sul",4,"Sul",1,"432270",3,20,7,13,5,15,1,0,1,0,1,21,7,14,5,16,25,10.1051005765945,10.207252105818,0.413140790826936,31
"13451","RS","Vera Cruz",27099,24467.49,43020,"Santa Cruz do Sul",4,"Sul",1,"432270",4,20,5,15,8,12,0,0,0,0,0,20,5,15,8,12,13,10.1051005765945,10.207252105818,0.443453319532604,30
"13452","RS","Vera Cruz",27099,24467.49,43020,"Santa Cruz do Sul",4,"Sul",1,"432270",5,28,10,18,4,24,0,0,0,0,0,28,10,18,4,24,15,10.1051005765945,10.207252105818,0.409851559360987,31
"13453","RS","Veranópolis",26533,59746.82,43016,"Caxias do Sul",4,"Sul",1,"432280",2,18,2,16,7,11,0,0,0,0,0,18,2,16,7,11,7,10.9978712466201,10.1861445202714,0.308861385688837,29
"13454","RS","Veranópolis",26533,59746.82,43016,"Caxias do Sul",4,"Sul",1,"432280",3,19,2,17,4,15,0,0,0,0,0,19,2,17,4,15,8,10.9978712466201,10.1861445202714,0.386595473687977,31
"13455","RS","Veranópolis",26533,59746.82,43016,"Caxias do Sul",4,"Sul",1,"432280",4,24,4,20,4,20,0,0,0,0,0,24,4,20,4,20,14,10.9978712466201,10.1861445202714,0.406578424870483,30
"13456","RS","Veranópolis",26533,59746.82,43016,"Caxias do Sul",4,"Sul",1,"432280",5,17,1,16,7,10,0,0,0,0,0,17,1,16,7,10,17,10.9978712466201,10.1861445202714,0.387114822131845,31
"13457","RS","Viamão",256302,14732.35,43026,"Porto Alegre",4,"Sul",1,"432300",2,197,75,122,73,124,0,0,0,0,0,197,75,122,73,124,150,9.59780103508888,12.4541117156772,0.320887630588789,29
"13458","RS","Viamão",256302,14732.35,43026,"Porto Alegre",4,"Sul",1,"432300",3,220,67,153,81,139,0,0,0,0,0,220,67,153,81,139,142,9.59780103508888,12.4541117156772,0.429044276490884,31
"13459","RS","Viamão",256302,14732.35,43026,"Porto Alegre",4,"Sul",1,"432300",4,203,59,144,86,117,1,1,0,0,1,204,60,144,86,118,142,9.59780103508888,12.4541117156772,0.485766522986216,30
"13460","RS","Viamão",256302,14732.35,43026,"Porto Alegre",4,"Sul",1,"432300",5,192,67,125,68,124,0,0,0,0,0,192,67,125,68,124,158,9.59780103508888,12.4541117156772,0.433079358485372,31
"13461","RS","Xangri-lá",16775,31202.93,43027,"Osório",4,"Sul",1,"432380",2,19,7,12,6,13,0,0,0,0,0,19,7,12,6,13,5,10.3482672796447,9.72764496183988,0.322668101977633,29
"13462","RS","Xangri-lá",16775,31202.93,43027,"Osório",4,"Sul",1,"432380",3,19,8,11,10,9,0,0,0,0,0,19,8,11,10,9,5,10.3482672796447,9.72764496183988,0.452291218667001,31
"13463","RS","Xangri-lá",16775,31202.93,43027,"Osório",4,"Sul",1,"432380",4,19,10,9,8,11,0,0,0,0,0,19,10,9,8,11,4,10.3482672796447,9.72764496183988,0.489753535039368,30
"13464","RS","Xangri-lá",16775,31202.93,43027,"Osório",4,"Sul",1,"432380",5,26,8,18,6,20,0,0,0,0,0,26,8,18,6,20,8,10.3482672796447,9.72764496183988,0.445741654753061,31
"13465","MS","Água Clara",15776,87307.89,50007,"Três Lagoas",5,"Centro-oeste",0,"500020",2,13,3,10,6,7,0,0,0,0,0,13,3,10,6,7,1,11.3771961157507,9.66624507684242,0.301490443928672,29
"13466","MS","Água Clara",15776,87307.89,50007,"Três Lagoas",5,"Centro-oeste",0,"500020",3,6,2,4,2,4,0,0,0,0,0,6,2,4,2,4,9,11.3771961157507,9.66624507684242,0.341111052710979,31
"13467","MS","Água Clara",15776,87307.89,50007,"Três Lagoas",5,"Centro-oeste",0,"500020",4,14,3,11,5,9,0,0,0,0,0,14,3,11,5,9,4,11.3771961157507,9.66624507684242,0.368070616735926,30
"13468","MS","Água Clara",15776,87307.89,50007,"Três Lagoas",5,"Centro-oeste",0,"500020",5,9,2,7,3,6,0,0,0,0,0,9,2,7,3,6,5,11.3771961157507,9.66624507684242,0.410552023741865,31
"13469","MS","Amambai",39826,26332.85,50010,"Dourados",5,"Centro-oeste",0,"500060",2,42,25,17,21,21,0,0,0,0,0,42,25,17,21,21,21,10.1785724881822,10.5922752443186,0.30323709384856,29
"13470","MS","Amambai",39826,26332.85,50010,"Dourados",5,"Centro-oeste",0,"500060",3,35,17,18,17,18,0,0,0,0,0,35,17,18,17,18,29,10.1785724881822,10.5922752443186,0.379492246651935,31
"13471","MS","Amambai",39826,26332.85,50010,"Dourados",5,"Centro-oeste",0,"500060",4,46,14,32,22,24,0,0,0,0,0,46,14,32,22,24,23,10.1785724881822,10.5922752443186,0.408241391515049,30
"13472","MS","Amambai",39826,26332.85,50010,"Dourados",5,"Centro-oeste",0,"500060",5,52,19,33,25,27,2,1,1,0,2,54,20,34,25,29,29,10.1785724881822,10.5922752443186,0.403982315616856,31
"13473","MS","Anastácio",25237,18115.62,50002,"Aquidauana",5,"Centro-oeste",1,"500070",2,20,9,11,11,9,0,0,0,0,0,20,9,11,11,9,8,9.80452982852323,10.1360664506368,0.298682469345679,29
"13474","MS","Anastácio",25237,18115.62,50002,"Aquidauana",5,"Centro-oeste",1,"500070",3,26,11,15,14,12,1,0,1,0,1,27,11,16,14,13,25,9.80452982852323,10.1360664506368,0.361075675903648,31
"13475","MS","Anastácio",25237,18115.62,50002,"Aquidauana",5,"Centro-oeste",1,"500070",4,36,11,25,19,17,1,1,0,0,1,37,12,25,19,18,14,9.80452982852323,10.1360664506368,0.376803924450927,30
"13476","MS","Anastácio",25237,18115.62,50002,"Aquidauana",5,"Centro-oeste",1,"500070",5,41,16,25,22,19,0,0,0,0,0,41,16,25,22,19,17,9.80452982852323,10.1360664506368,0.374314546163913,31
"13477","MS","Angélica",10932,77746.34,50011,"Iguatemi",5,"Centro-oeste",0,"500085",2,3,0,3,1,2,0,0,0,0,0,3,0,3,1,2,5,11.2612067549785,9.29944954704796,0.299337024769154,29
"13478","MS","Angélica",10932,77746.34,50011,"Iguatemi",5,"Centro-oeste",0,"500085",3,5,2,3,4,1,0,0,0,0,0,5,2,3,4,1,7,11.2612067549785,9.29944954704796,0.370665572290455,31
"13479","MS","Angélica",10932,77746.34,50011,"Iguatemi",5,"Centro-oeste",0,"500085",4,13,5,8,7,6,0,0,0,0,0,13,5,8,7,6,5,11.2612067549785,9.29944954704796,0.401961694569722,30
"13480","MS","Angélica",10932,77746.34,50011,"Iguatemi",5,"Centro-oeste",0,"500085",5,17,4,13,6,11,0,0,0,0,0,17,4,13,6,11,6,11.2612067549785,9.29944954704796,0.376466196631585,31
"13481","MS","Aparecida do Taboado",26069,48734.29,50006,"Paranaíba",5,"Centro-oeste",1,"500100",2,28,8,20,12,16,0,0,0,0,0,28,8,20,12,16,9,10.79413816808,10.1685021479256,0.316822436408885,29
"13482","MS","Aparecida do Taboado",26069,48734.29,50006,"Paranaíba",5,"Centro-oeste",1,"500100",3,24,7,17,8,16,1,1,0,0,1,25,8,17,8,17,16,10.79413816808,10.1685021479256,0.399808641766491,31
"13483","MS","Aparecida do Taboado",26069,48734.29,50006,"Paranaíba",5,"Centro-oeste",1,"500100",4,25,8,17,12,13,0,0,0,0,0,25,8,17,12,13,19,10.79413816808,10.1685021479256,0.409832988666442,30
"13484","MS","Aparecida do Taboado",26069,48734.29,50006,"Paranaíba",5,"Centro-oeste",1,"500100",5,38,14,24,11,27,0,0,0,0,0,38,14,24,11,27,19,10.79413816808,10.1685021479256,0.380930915048362,31
"13485","MS","Aquidauana",48029,19389.54,50002,"Aquidauana",5,"Centro-oeste",1,"500110",2,40,12,28,14,26,1,0,1,0,1,41,12,29,14,27,22,9.87248902438644,10.7795602741215,0.315347253800333,29
"13486","MS","Aquidauana",48029,19389.54,50002,"Aquidauana",5,"Centro-oeste",1,"500110",3,54,19,35,31,23,1,1,0,0,1,55,20,35,31,24,39,9.87248902438644,10.7795602741215,0.389280946025734,31
"13487","MS","Aquidauana",48029,19389.54,50002,"Aquidauana",5,"Centro-oeste",1,"500110",4,57,19,38,30,27,0,0,0,0,0,57,19,38,30,27,28,9.87248902438644,10.7795602741215,0.422763625730027,30
"13488","MS","Aquidauana",48029,19389.54,50002,"Aquidauana",5,"Centro-oeste",1,"500110",5,66,24,42,39,27,0,0,0,0,0,66,24,42,39,27,32,9.87248902438644,10.7795602741215,0.414339246374204,31
"13489","MS","Bandeirantes",7266,60751.54,50004,"Campo Grande",5,"Centro-oeste",0,"500150",2,6,1,5,5,1,0,0,0,0,0,6,1,5,5,1,6,11.0145477106757,8.89096121278115,0.272827219483279,29
"13490","MS","Bandeirantes",7266,60751.54,50004,"Campo Grande",5,"Centro-oeste",0,"500150",3,5,0,5,1,4,1,0,1,1,0,6,0,6,2,4,4,11.0145477106757,8.89096121278115,0.348175985613845,31
"13491","MS","Bandeirantes",7266,60751.54,50004,"Campo Grande",5,"Centro-oeste",0,"500150",4,7,2,5,4,3,0,0,0,0,0,7,2,5,4,3,3,11.0145477106757,8.89096121278115,0.369140529139434,30
"13492","MS","Bandeirantes",7266,60751.54,50004,"Campo Grande",5,"Centro-oeste",0,"500150",5,6,4,2,5,1,0,0,0,0,0,6,4,2,5,1,7,11.0145477106757,8.89096121278115,0.399703889753858,31
"13493","MS","Bataguassu",23325,34552.55,50008,"Nova Andradina",5,"Centro-oeste",1,"500190",2,29,14,15,13,16,0,0,0,0,0,29,14,15,13,16,9,10.4502366325504,10.0572810257155,0.300772738092419,29
"13494","MS","Bataguassu",23325,34552.55,50008,"Nova Andradina",5,"Centro-oeste",1,"500190",3,52,28,24,18,34,0,0,0,0,0,52,28,24,18,34,6,10.4502366325504,10.0572810257155,0.364758563280723,31
"13495","MS","Bataguassu",23325,34552.55,50008,"Nova Andradina",5,"Centro-oeste",1,"500190",4,39,17,22,20,19,0,0,0,0,0,39,17,22,20,19,10,10.4502366325504,10.0572810257155,0.403076626609283,30
"13496","MS","Bataguassu",23325,34552.55,50008,"Nova Andradina",5,"Centro-oeste",1,"500190",5,46,27,19,24,22,0,0,0,0,0,46,27,19,24,22,7,10.4502366325504,10.0572810257155,0.384143712707568,31
"13497","MS","Batayporã",11349,34578.9,50008,"Nova Andradina",5,"Centro-oeste",0,"500200",2,16,5,11,4,12,0,0,0,0,0,16,5,11,4,12,5,10.4509989484364,9.33688491330114,0.290538314144903,29
"13498","MS","Batayporã",11349,34578.9,50008,"Nova Andradina",5,"Centro-oeste",0,"500200",3,10,1,9,6,4,0,0,0,0,0,10,1,9,6,4,6,10.4509989484364,9.33688491330114,0.366138546028044,31
"13499","MS","Batayporã",11349,34578.9,50008,"Nova Andradina",5,"Centro-oeste",0,"500200",4,14,2,12,5,9,0,0,0,0,0,14,2,12,5,9,6,10.4509989484364,9.33688491330114,0.422212962365544,30
"13500","MS","Batayporã",11349,34578.9,50008,"Nova Andradina",5,"Centro-oeste",0,"500200",5,4,1,3,3,1,0,0,0,0,0,4,1,3,3,1,4,10.4509989484364,9.33688491330114,0.403264270145991,31
"13501","MS","Bela Vista",24735,22514.75,50009,"Bodoquena",5,"Centro-oeste",0,"500210",2,41,16,25,19,22,0,0,0,0,0,41,16,25,19,22,15,10.0219259289654,10.1159745236618,0.326027615275774,29
"13502","MS","Bela Vista",24735,22514.75,50009,"Bodoquena",5,"Centro-oeste",0,"500210",3,16,7,9,6,10,1,0,1,0,1,17,7,10,6,11,13,10.0219259289654,10.1159745236618,0.398379799792445,31
"13503","MS","Bela Vista",24735,22514.75,50009,"Bodoquena",5,"Centro-oeste",0,"500210",4,28,12,16,14,14,3,3,0,0,3,31,15,16,14,17,5,10.0219259289654,10.1159745236618,0.422241872412973,30
"13504","MS","Bela Vista",24735,22514.75,50009,"Bodoquena",5,"Centro-oeste",0,"500210",5,42,16,26,26,16,0,0,0,0,0,42,16,26,26,16,18,10.0219259289654,10.1159745236618,0.422107997967911,31
"13505","MS","Bodoquena",7838,27070.07,50009,"Bodoquena",5,"Centro-oeste",0,"500215",2,8,2,6,1,7,0,0,0,0,0,8,2,6,1,7,6,10.2061839684934,8.96673897875958,0.310578466077588,29
"13506","MS","Bodoquena",7838,27070.07,50009,"Bodoquena",5,"Centro-oeste",0,"500215",3,4,2,2,4,0,0,0,0,0,0,4,2,2,4,0,7,10.2061839684934,8.96673897875958,0.365818688386277,31
"13507","MS","Bodoquena",7838,27070.07,50009,"Bodoquena",5,"Centro-oeste",0,"500215",4,11,3,8,4,7,0,0,0,0,0,11,3,8,4,7,2,10.2061839684934,8.96673897875958,0.411766988420618,30
"13508","MS","Bodoquena",7838,27070.07,50009,"Bodoquena",5,"Centro-oeste",0,"500215",5,15,7,8,6,9,0,0,0,0,0,15,7,8,6,9,7,10.2061839684934,8.96673897875958,0.400900613674428,31
"13509","MS","Bonito",22190,34572.89,50009,"Bodoquena",5,"Centro-oeste",1,"500220",2,25,12,13,12,13,0,0,0,0,0,25,12,13,12,13,3,10.4508251279173,10.0073970159266,0.292551932751513,29
"13510","MS","Bonito",22190,34572.89,50009,"Bodoquena",5,"Centro-oeste",1,"500220",3,17,5,12,4,13,1,0,1,0,1,18,5,13,4,14,6,10.4508251279173,10.0073970159266,0.397867125258405,31
"13511","MS","Bonito",22190,34572.89,50009,"Bodoquena",5,"Centro-oeste",1,"500220",4,20,10,10,7,13,1,0,1,1,0,21,10,11,8,13,9,10.4508251279173,10.0073970159266,0.461256793846119,30
"13512","MS","Bonito",22190,34572.89,50009,"Bodoquena",5,"Centro-oeste",1,"500220",5,34,17,17,18,16,1,1,0,1,0,35,18,17,19,16,13,10.4508251279173,10.0073970159266,0.466797379491917,31
"13513","MS","Brasilândia",11853,48100.61,50007,"Três Lagoas",5,"Centro-oeste",0,"500230",2,13,2,11,12,1,0,0,0,0,0,13,2,11,12,1,4,10.7810501379261,9.3803362790795,0.321120984383673,29
"13514","MS","Brasilândia",11853,48100.61,50007,"Três Lagoas",5,"Centro-oeste",0,"500230",3,16,5,11,7,9,0,0,0,0,0,16,5,11,7,9,2,10.7810501379261,9.3803362790795,0.368179395726634,31
"13515","MS","Brasilândia",11853,48100.61,50007,"Três Lagoas",5,"Centro-oeste",0,"500230",4,12,4,8,5,7,0,0,0,0,0,12,4,8,5,7,7,10.7810501379261,9.3803362790795,0.390113547600527,30
"13516","MS","Brasilândia",11853,48100.61,50007,"Três Lagoas",5,"Centro-oeste",0,"500230",5,7,4,3,3,4,0,0,0,0,0,7,4,3,3,4,9,10.7810501379261,9.3803362790795,0.418075070332621,31
"13517","MS","Caarapó",30593,46883.31,50010,"Dourados",5,"Centro-oeste",0,"500240",2,38,12,26,18,20,0,0,0,0,0,38,12,26,18,20,22,10.7554170275605,10.3285265036014,0.324491187348639,29
"13518","MS","Caarapó",30593,46883.31,50010,"Dourados",5,"Centro-oeste",0,"500240",3,42,11,31,18,24,0,0,0,0,0,42,11,31,18,24,18,10.7554170275605,10.3285265036014,0.380509912260958,31
"13519","MS","Caarapó",30593,46883.31,50010,"Dourados",5,"Centro-oeste",0,"500240",4,48,23,25,23,25,1,0,1,0,1,49,23,26,23,26,12,10.7554170275605,10.3285265036014,0.419577105995373,30
"13520","MS","Caarapó",30593,46883.31,50010,"Dourados",5,"Centro-oeste",0,"500240",5,47,15,32,22,25,1,0,1,0,1,48,15,33,22,26,16,10.7554170275605,10.3285265036014,0.388600312657345,31
"13521","MS","Camapuã",13693,31710.66,50003,"Alto Taquari",5,"Centro-oeste",0,"500260",2,10,5,5,5,5,0,0,0,0,0,10,5,5,5,5,9,10.3644081809393,9.52464003233223,0.294305826748146,29
"13522","MS","Camapuã",13693,31710.66,50003,"Alto Taquari",5,"Centro-oeste",0,"500260",3,15,4,11,5,10,0,0,0,0,0,15,4,11,5,10,6,10.3644081809393,9.52464003233223,0.381815783510905,31
"13523","MS","Camapuã",13693,31710.66,50003,"Alto Taquari",5,"Centro-oeste",0,"500260",4,16,4,12,7,9,0,0,0,0,0,16,4,12,7,9,10,10.3644081809393,9.52464003233223,0.381345806263361,30
"13524","MS","Camapuã",13693,31710.66,50003,"Alto Taquari",5,"Centro-oeste",0,"500260",5,14,4,10,10,4,0,0,0,0,0,14,4,10,10,4,6,10.3644081809393,9.52464003233223,0.408206802482762,31
"13525","MS","Campo Grande",906092,32942.46,50004,"Campo Grande",5,"Centro-oeste",1,"500270",2,874,164,710,299,575,11,2,9,2,9,885,166,719,301,584,408,10.4025176821817,13.7168961251236,0.298354963663902,29
"13526","MS","Campo Grande",906092,32942.46,50004,"Campo Grande",5,"Centro-oeste",1,"500270",3,877,160,717,322,555,10,1,9,3,7,887,161,726,325,562,489,10.4025176821817,13.7168961251236,0.403482519486339,31
"13527","MS","Campo Grande",906092,32942.46,50004,"Campo Grande",5,"Centro-oeste",1,"500270",4,1021,218,803,386,635,16,5,11,7,9,1037,223,814,393,644,394,10.4025176821817,13.7168961251236,0.435463775949233,30
"13528","MS","Campo Grande",906092,32942.46,50004,"Campo Grande",5,"Centro-oeste",1,"500270",5,1230,254,976,446,784,5,0,5,5,0,1235,254,981,451,784,446,10.4025176821817,13.7168961251236,0.396861998076503,31
"13529","MS","Cassilândia",22002,26007.38,50005,"Cassilândia",5,"Centro-oeste",1,"500290",2,16,4,12,9,7,0,0,0,0,0,16,4,12,9,7,11,10.1661356228808,9.99888863729938,0.318750662569774,29
"13530","MS","Cassilândia",22002,26007.38,50005,"Cassilândia",5,"Centro-oeste",1,"500290",3,15,2,13,9,6,0,0,0,0,0,15,2,13,9,6,23,10.1661356228808,9.99888863729938,0.387627861925591,31
"13531","MS","Cassilândia",22002,26007.38,50005,"Cassilândia",5,"Centro-oeste",1,"500290",4,23,7,16,16,7,0,0,0,0,0,23,7,16,16,7,11,10.1661356228808,9.99888863729938,0.422561717393774,30
"13532","MS","Cassilândia",22002,26007.38,50005,"Cassilândia",5,"Centro-oeste",1,"500290",5,20,6,14,5,15,0,0,0,0,0,20,6,14,5,15,11,10.1661356228808,9.99888863729938,0.405057655122076,31
"13533","MS","Chapadão do Sul",25865,72390.23,50005,"Cassilândia",5,"Centro-oeste",1,"500295",2,34,9,25,13,21,0,0,0,0,0,34,9,25,13,21,5,11.1898266245166,10.1606459824376,0.307464109436992,29
"13534","MS","Chapadão do Sul",25865,72390.23,50005,"Cassilândia",5,"Centro-oeste",1,"500295",3,46,15,31,17,29,0,0,0,0,0,46,15,31,17,29,10,11.1898266245166,10.1606459824376,0.373740202342351,31
"13535","MS","Chapadão do Sul",25865,72390.23,50005,"Cassilândia",5,"Centro-oeste",1,"500295",4,51,12,39,21,30,0,0,0,0,0,51,12,39,21,30,5,11.1898266245166,10.1606459824376,0.40138650561826,30
"13536","MS","Chapadão do Sul",25865,72390.23,50005,"Cassilândia",5,"Centro-oeste",1,"500295",5,38,7,31,17,21,0,0,0,0,0,38,7,31,17,21,12,11.1898266245166,10.1606459824376,0.370351025090015,31
"13537","MS","Corumbá",112058,27582.68,50001,"Baixo Pantanal",5,"Centro-oeste",1,"500320",2,123,47,76,52,71,1,0,1,0,1,124,47,77,52,72,82,10.2249433184901,11.6267718733784,0.304218394156282,29
"13538","MS","Corumbá",112058,27582.68,50001,"Baixo Pantanal",5,"Centro-oeste",1,"500320",3,131,41,90,46,85,2,1,1,1,1,133,42,91,47,86,76,10.2249433184901,11.6267718733784,0.383633622168307,31
"13539","MS","Corumbá",112058,27582.68,50001,"Baixo Pantanal",5,"Centro-oeste",1,"500320",4,143,53,90,59,84,2,2,0,1,1,145,55,90,60,85,57,10.2249433184901,11.6267718733784,0.42984908852799,30
"13540","MS","Corumbá",112058,27582.68,50001,"Baixo Pantanal",5,"Centro-oeste",1,"500320",5,167,50,117,74,93,4,2,2,3,1,171,52,119,77,94,39,10.2249433184901,11.6267718733784,0.420412038385867,31
"13541","MS","Costa Rica",21142,88940.58,50005,"Cassilândia",5,"Centro-oeste",1,"500325",2,30,4,26,10,20,0,0,0,0,0,30,4,26,10,20,5,11.3957237852937,9.95901686232861,0.300262864534349,29
"13542","MS","Costa Rica",21142,88940.58,50005,"Cassilândia",5,"Centro-oeste",1,"500325",3,33,6,27,17,16,0,0,0,0,0,33,6,27,17,16,7,11.3957237852937,9.95901686232861,0.360190952205916,31
"13543","MS","Costa Rica",21142,88940.58,50005,"Cassilândia",5,"Centro-oeste",1,"500325",4,33,9,24,16,17,0,0,0,0,0,33,9,24,16,17,12,11.3957237852937,9.95901686232861,0.37189365365955,30
"13544","MS","Costa Rica",21142,88940.58,50005,"Cassilândia",5,"Centro-oeste",1,"500325",5,41,10,31,22,19,0,0,0,0,0,41,10,31,22,19,12,11.3957237852937,9.95901686232861,0.373681523510185,31
"13545","MS","Coxim",33459,26823.76,50003,"Alto Taquari",5,"Centro-oeste",1,"500330",2,36,9,27,18,18,0,0,0,0,0,36,9,27,18,18,19,10.1970433408946,10.4180760876626,0.303341613606306,29
"13546","MS","Coxim",33459,26823.76,50003,"Alto Taquari",5,"Centro-oeste",1,"500330",3,17,7,10,8,9,1,1,0,0,1,18,8,10,8,10,20,10.1970433408946,10.4180760876626,0.379154650647206,31
"13547","MS","Coxim",33459,26823.76,50003,"Alto Taquari",5,"Centro-oeste",1,"500330",4,39,11,28,16,23,0,0,0,0,0,39,11,28,16,23,21,10.1970433408946,10.4180760876626,0.400221049973599,30
"13548","MS","Coxim",33459,26823.76,50003,"Alto Taquari",5,"Centro-oeste",1,"500330",5,59,12,47,28,31,1,1,0,1,0,60,13,47,29,31,21,10.1970433408946,10.4180760876626,0.381483498023353,31
"13549","MS","Deodápolis",12984,22939.19,50011,"Iguatemi",5,"Centro-oeste",0,"500345",2,8,4,4,4,4,0,0,0,0,0,8,4,4,4,4,14,10.0406020805569,9.47147310919443,0.335489726640765,29
"13550","MS","Deodápolis",12984,22939.19,50011,"Iguatemi",5,"Centro-oeste",0,"500345",3,11,4,7,3,8,0,0,0,0,0,11,4,7,3,8,2,10.0406020805569,9.47147310919443,0.402367125992635,31
"13551","MS","Deodápolis",12984,22939.19,50011,"Iguatemi",5,"Centro-oeste",0,"500345",4,12,0,12,5,7,1,0,1,1,0,13,0,13,6,7,10,10.0406020805569,9.47147310919443,0.413101334322975,30
"13552","MS","Deodápolis",12984,22939.19,50011,"Iguatemi",5,"Centro-oeste",0,"500345",5,9,2,7,2,7,0,0,0,0,0,9,2,7,2,7,11,10.0406020805569,9.47147310919443,0.395557221893019,31
"13553","MS","Dois Irmãos do Buriti",11467,18355.49,50002,"Aquidauana",5,"Centro-oeste",0,"500348",2,8,1,7,3,5,0,0,0,0,0,8,1,7,3,5,3,9.81768399129785,9.3472286240383,0.308996587867516,29
"13554","MS","Dois Irmãos do Buriti",11467,18355.49,50002,"Aquidauana",5,"Centro-oeste",0,"500348",3,17,5,12,8,9,0,0,0,0,0,17,5,12,8,9,4,9.81768399129785,9.3472286240383,0.34480823243682,31
"13555","MS","Dois Irmãos do Buriti",11467,18355.49,50002,"Aquidauana",5,"Centro-oeste",0,"500348",4,12,3,9,6,6,0,0,0,0,0,12,3,9,6,6,8,9.81768399129785,9.3472286240383,0.379248196423033,30
"13556","MS","Dois Irmãos do Buriti",11467,18355.49,50002,"Aquidauana",5,"Centro-oeste",0,"500348",5,16,4,12,2,14,0,0,0,0,0,16,4,12,2,14,5,9.81768399129785,9.3472286240383,0.441075818087207,31
"13557","MS","Dourados",225495,38468.4,50010,"Dourados",5,"Centro-oeste",1,"500370",2,253,85,168,88,165,3,1,2,1,2,256,86,170,89,167,111,10.5575924040314,12.32605326473,0.320785385529009,29
"13558","MS","Dourados",225495,38468.4,50010,"Dourados",5,"Centro-oeste",1,"500370",3,290,91,199,105,185,3,1,2,3,0,293,92,201,108,185,125,10.5575924040314,12.32605326473,0.410954793641621,31
"13559","MS","Dourados",225495,38468.4,50010,"Dourados",5,"Centro-oeste",1,"500370",4,307,91,216,115,192,4,2,2,1,3,311,93,218,116,195,104,10.5575924040314,12.32605326473,0.450607185013974,30
"13560","MS","Dourados",225495,38468.4,50010,"Dourados",5,"Centro-oeste",1,"500370",5,347,95,252,135,212,3,0,3,1,2,350,95,255,136,214,113,10.5575924040314,12.32605326473,0.42247772854292,31
"13561","MS","Eldorado",12400,30032.67,50011,"Iguatemi",5,"Centro-oeste",0,"500375",2,11,3,8,5,6,0,0,0,0,0,11,3,8,5,6,4,10.3100410681139,9.42545175159313,0.35867472697487,29
"13562","MS","Eldorado",12400,30032.67,50011,"Iguatemi",5,"Centro-oeste",0,"500375",3,11,3,8,6,5,0,0,0,0,0,11,3,8,6,5,8,10.3100410681139,9.42545175159313,0.436928591065362,31
"13563","MS","Eldorado",12400,30032.67,50011,"Iguatemi",5,"Centro-oeste",0,"500375",4,12,3,9,4,8,0,0,0,0,0,12,3,9,4,8,5,10.3100410681139,9.42545175159313,0.411786694765892,30
"13564","MS","Eldorado",12400,30032.67,50011,"Iguatemi",5,"Centro-oeste",0,"500375",5,24,10,14,12,12,0,0,0,0,0,24,10,14,12,12,6,10.3100410681139,9.42545175159313,0.40676381186462,31
"13565","MS","Fátima do Sul",19170,25942.35,50010,"Dourados",5,"Centro-oeste",1,"500380",2,15,3,12,5,10,1,0,1,0,1,16,3,13,5,11,14,10.1636320474448,9.86110183603969,0.324697035453289,29
"13566","MS","Fátima do Sul",19170,25942.35,50010,"Dourados",5,"Centro-oeste",1,"500380",3,34,6,28,16,18,1,0,1,0,1,35,6,29,16,19,17,10.1636320474448,9.86110183603969,0.405081202768358,31
"13567","MS","Fátima do Sul",19170,25942.35,50010,"Dourados",5,"Centro-oeste",1,"500380",4,35,11,24,10,25,0,0,0,0,0,35,11,24,10,25,15,10.1636320474448,9.86110183603969,0.418199528466515,30
"13568","MS","Fátima do Sul",19170,25942.35,50010,"Dourados",5,"Centro-oeste",1,"500380",5,21,3,18,6,15,1,0,1,1,0,22,3,19,7,15,16,10.1636320474448,9.86110183603969,0.443109866053217,31
"13569","MS","Glória de Dourados",9950,18664.75,50011,"Iguatemi",5,"Centro-oeste",0,"500400",2,6,0,6,3,3,0,0,0,0,0,6,0,6,3,3,4,9.83439199720594,9.20532783015264,0.317409989970291,29
"13570","MS","Glória de Dourados",9950,18664.75,50011,"Iguatemi",5,"Centro-oeste",0,"500400",3,8,1,7,3,5,0,0,0,0,0,8,1,7,3,5,9,9.83439199720594,9.20532783015264,0.369858392870399,31
"13571","MS","Glória de Dourados",9950,18664.75,50011,"Iguatemi",5,"Centro-oeste",0,"500400",4,12,3,9,6,6,0,0,0,0,0,12,3,9,6,6,7,9.83439199720594,9.20532783015264,0.392251139858983,30
"13572","MS","Glória de Dourados",9950,18664.75,50011,"Iguatemi",5,"Centro-oeste",0,"500400",5,10,2,8,0,10,0,0,0,0,0,10,2,8,0,10,5,9.83439199720594,9.20532783015264,0.418646077402563,31
"13573","MS","Guia Lopes da Laguna",9824,25855.38,50009,"Bodoquena",5,"Centro-oeste",1,"500410",2,6,0,6,4,2,0,0,0,0,0,6,0,6,4,2,9,10.1602739820729,9.19258365038692,0.336990848769701,29
"13574","MS","Guia Lopes da Laguna",9824,25855.38,50009,"Bodoquena",5,"Centro-oeste",1,"500410",3,7,2,5,3,4,0,0,0,0,0,7,2,5,3,4,8,10.1602739820729,9.19258365038692,0.382840802846599,31
"13575","MS","Guia Lopes da Laguna",9824,25855.38,50009,"Bodoquena",5,"Centro-oeste",1,"500410",4,9,3,6,4,5,0,0,0,0,0,9,3,6,4,5,5,10.1602739820729,9.19258365038692,0.422162525877936,30
"13576","MS","Guia Lopes da Laguna",9824,25855.38,50009,"Bodoquena",5,"Centro-oeste",1,"500410",5,16,3,13,8,8,1,0,1,0,1,17,3,14,8,9,4,10.1602739820729,9.19258365038692,0.490181621468439,31
"13577","MS","Iguatemi",16176,25250.4,50011,"Iguatemi",5,"Centro-oeste",0,"500430",2,12,5,7,5,7,1,1,0,0,1,13,6,7,5,8,2,10.1365972761622,9.69128394126025,0.332821594270476,29
"13578","MS","Iguatemi",16176,25250.4,50011,"Iguatemi",5,"Centro-oeste",0,"500430",3,15,4,11,7,8,0,0,0,0,0,15,4,11,7,8,16,10.1365972761622,9.69128394126025,0.402018449431941,31
"13579","MS","Iguatemi",16176,25250.4,50011,"Iguatemi",5,"Centro-oeste",0,"500430",4,13,3,10,6,7,0,0,0,0,0,13,3,10,6,7,8,10.1365972761622,9.69128394126025,0.418245853858522,30
"13580","MS","Iguatemi",16176,25250.4,50011,"Iguatemi",5,"Centro-oeste",0,"500430",5,18,5,13,7,11,0,0,0,0,0,18,5,13,7,11,3,10.1365972761622,9.69128394126025,0.429942939795316,31
"13581","MS","Inocência",7588,44367.67,50006,"Paranaíba",5,"Centro-oeste",0,"500440",2,6,1,5,2,4,0,0,0,0,0,6,1,5,2,4,5,10.7002663300349,8.93432333105491,0.345855180506199,29
"13582","MS","Inocência",7588,44367.67,50006,"Paranaíba",5,"Centro-oeste",0,"500440",3,9,4,5,5,4,0,0,0,0,0,9,4,5,5,4,5,10.7002663300349,8.93432333105491,0.383933743539368,31
"13583","MS","Inocência",7588,44367.67,50006,"Paranaíba",5,"Centro-oeste",0,"500440",4,9,3,6,5,4,0,0,0,0,0,9,3,6,5,4,4,10.7002663300349,8.93432333105491,0.440788784477367,30
"13584","MS","Inocência",7588,44367.67,50006,"Paranaíba",5,"Centro-oeste",0,"500440",5,18,8,10,11,7,0,0,0,0,0,18,8,10,11,7,4,10.7002663300349,8.93432333105491,0.409553177229342,31
"13585","MS","Itaporã",25162,34391.15,50010,"Dourados",5,"Centro-oeste",0,"500450",2,22,6,16,9,13,0,0,0,0,0,22,6,16,9,13,5,10.4455545428207,10.1330901989111,0.332946217257065,29
"13586","MS","Itaporã",25162,34391.15,50010,"Dourados",5,"Centro-oeste",0,"500450",3,19,4,15,7,12,0,0,0,0,0,19,4,15,7,12,14,10.4455545428207,10.1330901989111,0.40550646789807,31
"13587","MS","Itaporã",25162,34391.15,50010,"Dourados",5,"Centro-oeste",0,"500450",4,23,6,17,9,14,0,0,0,0,0,23,6,17,9,14,6,10.4455545428207,10.1330901989111,0.407434797133249,30
"13588","MS","Itaporã",25162,34391.15,50010,"Dourados",5,"Centro-oeste",0,"500450",5,23,4,19,8,15,0,0,0,0,0,23,4,19,8,15,15,10.4455545428207,10.1330901989111,0.419135554880185,31
"13589","MS","Itaquiraí",21376,35789.39,50011,"Iguatemi",5,"Centro-oeste",0,"500460",2,16,7,9,4,12,1,0,1,1,0,17,7,10,5,12,7,10.4854067597478,9.97002407633637,0.313173409344511,29
"13590","MS","Itaquiraí",21376,35789.39,50011,"Iguatemi",5,"Centro-oeste",0,"500460",3,20,6,14,10,10,0,0,0,0,0,20,6,14,10,10,8,10.4854067597478,9.97002407633637,0.38562717437115,31
"13591","MS","Itaquiraí",21376,35789.39,50011,"Iguatemi",5,"Centro-oeste",0,"500460",4,21,6,15,11,10,0,0,0,0,0,21,6,15,11,10,11,10.4854067597478,9.97002407633637,0.386177973692553,30
"13592","MS","Itaquiraí",21376,35789.39,50011,"Iguatemi",5,"Centro-oeste",0,"500460",5,13,4,9,5,8,0,0,0,0,0,13,4,9,5,8,14,10.4854067597478,9.97002407633637,0.400541624962483,31
"13593","MS","Ivinhema",23232,53921.09,50011,"Iguatemi",5,"Centro-oeste",0,"500470",2,19,6,13,8,11,0,0,0,0,0,19,6,13,8,11,13,10.8952769605154,10.0532859176245,0.299239698698876,29
"13594","MS","Ivinhema",23232,53921.09,50011,"Iguatemi",5,"Centro-oeste",0,"500470",3,32,9,23,13,19,1,0,1,0,1,33,9,24,13,20,9,10.8952769605154,10.0532859176245,0.368692305191769,31
"13595","MS","Ivinhema",23232,53921.09,50011,"Iguatemi",5,"Centro-oeste",0,"500470",4,46,9,37,20,26,0,0,0,0,0,46,9,37,20,26,10,10.8952769605154,10.0532859176245,0.396942683464753,30
"13596","MS","Ivinhema",23232,53921.09,50011,"Iguatemi",5,"Centro-oeste",0,"500470",5,40,12,28,14,26,0,0,0,0,0,40,12,28,14,26,13,10.8952769605154,10.0532859176245,0.379664655756989,31
"13597","MS","Jaraguari",7265,66831.89,50004,"Campo Grande",5,"Centro-oeste",0,"500490",2,5,0,5,1,4,0,0,0,0,0,5,0,5,1,4,6,11.1099356408175,8.89082357600438,0.298370459061768,29
"13598","MS","Jaraguari",7265,66831.89,50004,"Campo Grande",5,"Centro-oeste",0,"500490",3,5,2,3,4,1,0,0,0,0,0,5,2,3,4,1,1,11.1099356408175,8.89082357600438,0.367050358098339,31
"13599","MS","Jaraguari",7265,66831.89,50004,"Campo Grande",5,"Centro-oeste",0,"500490",4,6,4,2,4,2,0,0,0,0,0,6,4,2,4,2,6,11.1099356408175,8.89082357600438,0.433196844535516,30
"13600","MS","Jaraguari",7265,66831.89,50004,"Campo Grande",5,"Centro-oeste",0,"500490",5,2,0,2,0,2,0,0,0,0,0,2,0,2,0,2,2,11.1099356408175,8.89082357600438,0.462130306836733,31
"13601","MS","Jardim",26238,23321.37,50009,"Bodoquena",5,"Centro-oeste",1,"500500",2,30,7,23,15,15,0,0,0,0,0,30,7,23,15,15,15,10.0571253865948,10.174964020641,0.291907291433479,29
"13602","MS","Jardim",26238,23321.37,50009,"Bodoquena",5,"Centro-oeste",1,"500500",3,23,7,16,11,12,0,0,0,0,0,23,7,16,11,12,21,10.0571253865948,10.174964020641,0.353654362169601,31
"13603","MS","Jardim",26238,23321.37,50009,"Bodoquena",5,"Centro-oeste",1,"500500",4,22,5,17,7,15,0,0,0,0,0,22,5,17,7,15,11,10.0571253865948,10.174964020641,0.379104072590118,30
"13604","MS","Jardim",26238,23321.37,50009,"Bodoquena",5,"Centro-oeste",1,"500500",5,38,14,24,16,22,0,0,0,0,0,38,14,24,16,22,19,10.0571253865948,10.174964020641,0.40220405179263,31
"13605","MS","Ladário",23689,14116.4,50001,"Baixo Pantanal",5,"Centro-oeste",1,"500520",2,18,3,15,5,13,0,0,0,0,0,18,3,15,5,13,11,9.55509252103296,10.0727660843581,0.308662837161471,29
"13606","MS","Ladário",23689,14116.4,50001,"Baixo Pantanal",5,"Centro-oeste",1,"500520",3,32,17,15,15,17,0,0,0,0,0,32,17,15,15,17,15,9.55509252103296,10.0727660843581,0.382302545514931,31
"13607","MS","Ladário",23689,14116.4,50001,"Baixo Pantanal",5,"Centro-oeste",1,"500520",4,35,11,24,13,22,0,0,0,0,0,35,11,24,13,22,9,9.55509252103296,10.0727660843581,0.444207117189775,30
"13608","MS","Ladário",23689,14116.4,50001,"Baixo Pantanal",5,"Centro-oeste",1,"500520",5,34,18,16,17,17,0,0,0,0,0,34,18,16,17,17,12,9.55509252103296,10.0727660843581,0.435675520216268,31
"13609","MS","Maracaju",48022,63625,50010,"Dourados",5,"Centro-oeste",1,"500540",2,53,12,41,16,37,0,0,0,0,0,53,12,41,16,37,12,11.0607617538528,10.7794145182207,0.312018417552216,29
"13610","MS","Maracaju",48022,63625,50010,"Dourados",5,"Centro-oeste",1,"500540",3,52,12,40,18,34,2,1,1,0,2,54,13,41,18,36,16,11.0607617538528,10.7794145182207,0.38881114551282,31
"13611","MS","Maracaju",48022,63625,50010,"Dourados",5,"Centro-oeste",1,"500540",4,60,15,45,24,36,0,0,0,0,0,60,15,45,24,36,14,11.0607617538528,10.7794145182207,0.4009297692723,30
"13612","MS","Maracaju",48022,63625,50010,"Dourados",5,"Centro-oeste",1,"500540",5,53,17,36,22,31,0,0,0,0,0,53,17,36,22,31,21,11.0607617538528,10.7794145182207,0.391753383031058,31
"13613","MS","Miranda",28220,18019.95,50002,"Aquidauana",5,"Centro-oeste",0,"500560",2,24,12,12,14,10,0,0,0,0,0,24,12,12,14,10,13,9.7992347564637,10.2477862254068,0.297484159823332,29
"13614","MS","Miranda",28220,18019.95,50002,"Aquidauana",5,"Centro-oeste",0,"500560",3,31,10,21,9,22,0,0,0,0,0,31,10,21,9,22,10,9.7992347564637,10.2477862254068,0.36220951368504,31
"13615","MS","Miranda",28220,18019.95,50002,"Aquidauana",5,"Centro-oeste",0,"500560",4,38,18,20,18,20,1,1,0,0,1,39,19,20,18,21,7,9.7992347564637,10.2477862254068,0.404393289771932,30
"13616","MS","Miranda",28220,18019.95,50002,"Aquidauana",5,"Centro-oeste",0,"500560",5,43,20,23,24,19,1,1,0,0,1,44,21,23,24,20,15,9.7992347564637,10.2477862254068,0.403023926888154,31
"13617","MS","Mundo Novo",18473,28415.19,50011,"Iguatemi",5,"Centro-oeste",1,"500568",2,14,6,8,5,9,0,0,0,0,0,14,6,8,5,9,10,10.2546791403181,9.82406548555864,0.331080691599488,29
"13618","MS","Mundo Novo",18473,28415.19,50011,"Iguatemi",5,"Centro-oeste",1,"500568",3,15,9,6,6,9,0,0,0,0,0,15,9,6,6,9,8,10.2546791403181,9.82406548555864,0.405735836824816,31
"13619","MS","Mundo Novo",18473,28415.19,50011,"Iguatemi",5,"Centro-oeste",1,"500568",4,24,9,15,8,16,0,0,0,0,0,24,9,15,8,16,12,10.2546791403181,9.82406548555864,0.444537653562021,30
"13620","MS","Mundo Novo",18473,28415.19,50011,"Iguatemi",5,"Centro-oeste",1,"500568",5,14,7,7,7,7,0,0,0,0,0,14,7,7,7,7,17,10.2546791403181,9.82406548555864,0.422094481602054,31
"13621","MS","Naviraí",55689,34043.66,50011,"Iguatemi",5,"Centro-oeste",1,"500570",2,25,11,14,6,19,0,0,0,0,0,25,11,14,6,19,14,10.4353990974714,10.9275379198773,0.318460545527541,29
"13622","MS","Naviraí",55689,34043.66,50011,"Iguatemi",5,"Centro-oeste",1,"500570",3,47,18,29,11,36,1,1,0,1,0,48,19,29,12,36,29,10.4353990974714,10.9275379198773,0.388493347113015,31
"13623","MS","Naviraí",55689,34043.66,50011,"Iguatemi",5,"Centro-oeste",1,"500570",4,81,31,50,37,44,1,0,1,0,1,82,31,51,37,45,27,10.4353990974714,10.9275379198773,0.42126445794293,30
"13624","MS","Naviraí",55689,34043.66,50011,"Iguatemi",5,"Centro-oeste",1,"500570",5,74,20,54,32,42,0,0,0,0,0,74,20,54,32,42,26,10.4353990974714,10.9275379198773,0.398042834113517,31
"13625","MS","Nioaque",13862,19873.37,50009,"Bodoquena",5,"Centro-oeste",0,"500580",2,16,4,12,6,10,0,0,0,0,0,16,4,12,6,10,7,9.8971359235807,9.53690656247793,0.32686481810057,29
"13626","MS","Nioaque",13862,19873.37,50009,"Bodoquena",5,"Centro-oeste",0,"500580",3,7,2,5,3,4,0,0,0,0,0,7,2,5,3,4,9,9.8971359235807,9.53690656247793,0.376954025610255,31
"13627","MS","Nioaque",13862,19873.37,50009,"Bodoquena",5,"Centro-oeste",0,"500580",4,13,2,11,8,5,0,0,0,0,0,13,2,11,8,5,4,9.8971359235807,9.53690656247793,0.409399236369879,30
"13628","MS","Nioaque",13862,19873.37,50009,"Bodoquena",5,"Centro-oeste",0,"500580",5,14,7,7,4,10,2,1,1,1,1,16,8,8,5,11,2,9.8971359235807,9.53690656247793,0.444697049391272,31
"13629","MS","Nova Alvorada do Sul",22430,70084.08,50010,"Dourados",5,"Centro-oeste",0,"500600",2,13,4,9,2,11,0,0,0,0,0,13,4,9,2,11,4,11.1574509430937,10.0181546275143,0.322865248736054,29
"13630","MS","Nova Alvorada do Sul",22430,70084.08,50010,"Dourados",5,"Centro-oeste",0,"500600",3,30,14,16,17,13,1,0,1,0,1,31,14,17,17,14,9,11.1574509430937,10.0181546275143,0.372368643747203,31
"13631","MS","Nova Alvorada do Sul",22430,70084.08,50010,"Dourados",5,"Centro-oeste",0,"500600",4,26,9,17,15,11,0,0,0,0,0,26,9,17,15,11,7,11.1574509430937,10.0181546275143,0.390426542596531,30
"13632","MS","Nova Alvorada do Sul",22430,70084.08,50010,"Dourados",5,"Centro-oeste",0,"500600",5,37,13,24,12,25,0,0,0,0,0,37,13,24,12,25,7,11.1574509430937,10.0181546275143,0.384330509691381,31
"13633","MS","Nova Andradina",55224,39155.93,50008,"Nova Andradina",5,"Centro-oeste",1,"500620",2,45,14,31,10,35,0,0,0,0,0,45,14,31,10,35,28,10.5753071586588,10.9191529203833,0.312444336600741,29
"13634","MS","Nova Andradina",55224,39155.93,50008,"Nova Andradina",5,"Centro-oeste",1,"500620",3,61,13,48,29,32,0,0,0,0,0,61,13,48,29,32,17,10.5753071586588,10.9191529203833,0.384989572934277,31
"13635","MS","Nova Andradina",55224,39155.93,50008,"Nova Andradina",5,"Centro-oeste",1,"500620",4,62,16,46,23,39,1,0,1,0,1,63,16,47,23,40,22,10.5753071586588,10.9191529203833,0.428079853341788,30
"13636","MS","Nova Andradina",55224,39155.93,50008,"Nova Andradina",5,"Centro-oeste",1,"500620",5,55,11,44,17,38,0,0,0,0,0,55,11,44,17,38,20,10.5753071586588,10.9191529203833,0.402249629106589,31
"13637","MS","Paranaíba",42276,31363.89,50006,"Paranaíba",5,"Centro-oeste",1,"500630",2,31,4,27,8,23,0,0,0,0,0,31,4,27,8,23,28,10.3534125101389,10.6519748281292,0.308579593840083,29
"13638","MS","Paranaíba",42276,31363.89,50006,"Paranaíba",5,"Centro-oeste",1,"500630",3,34,6,28,9,25,0,0,0,0,0,34,6,28,9,25,37,10.3534125101389,10.6519748281292,0.385090052119834,31
"13639","MS","Paranaíba",42276,31363.89,50006,"Paranaíba",5,"Centro-oeste",1,"500630",4,50,10,40,23,27,1,1,0,1,0,51,11,40,24,27,36,10.3534125101389,10.6519748281292,0.429718019837361,30
"13640","MS","Paranaíba",42276,31363.89,50006,"Paranaíba",5,"Centro-oeste",1,"500630",5,40,18,22,22,18,0,0,0,0,0,40,18,22,22,18,23,10.3534125101389,10.6519748281292,0.402545774414742,31
"13641","MS","Ponta Porã",93937,33619.11,50010,"Dourados",5,"Centro-oeste",1,"500660",2,70,16,54,29,41,0,0,0,0,0,70,16,54,29,41,49,10.4228499342743,11.4503796237932,0.332806793184104,29
"13642","MS","Ponta Porã",93937,33619.11,50010,"Dourados",5,"Centro-oeste",1,"500660",3,87,30,57,42,45,4,2,2,3,1,91,32,59,45,46,58,10.4228499342743,11.4503796237932,0.447156760238129,31
"13643","MS","Ponta Porã",93937,33619.11,50010,"Dourados",5,"Centro-oeste",1,"500660",4,117,33,84,48,69,0,0,0,0,0,117,33,84,48,69,46,10.4228499342743,11.4503796237932,0.468150129415069,30
"13644","MS","Ponta Porã",93937,33619.11,50010,"Dourados",5,"Centro-oeste",1,"500660",5,135,54,81,66,69,4,3,1,1,3,139,57,82,67,72,50,10.4228499342743,11.4503796237932,0.437090636396412,31
"13645","MS","Porto Murtinho",17298,20154.55,50001,"Baixo Pantanal",5,"Centro-oeste",0,"500690",2,12,5,7,6,6,0,0,0,0,0,12,5,7,6,6,10,9.911185348336,9.75834616686646,0.300346486706495,29
"13646","MS","Porto Murtinho",17298,20154.55,50001,"Baixo Pantanal",5,"Centro-oeste",0,"500690",3,15,6,9,7,8,0,0,0,0,0,15,6,9,7,8,10,9.911185348336,9.75834616686646,0.380835967876903,31
"13647","MS","Porto Murtinho",17298,20154.55,50001,"Baixo Pantanal",5,"Centro-oeste",0,"500690",4,21,10,11,7,14,0,0,0,0,0,21,10,11,7,14,4,9.911185348336,9.75834616686646,0.364427293477365,30
"13648","MS","Porto Murtinho",17298,20154.55,50001,"Baixo Pantanal",5,"Centro-oeste",0,"500690",5,21,10,11,11,10,0,0,0,0,0,21,10,11,11,10,1,9.911185348336,9.75834616686646,0.405219848527101,31
"13649","MS","Ribas do Rio Pardo",24966,35805.33,50007,"Três Lagoas",5,"Centro-oeste",0,"500710",2,21,7,14,13,8,0,0,0,0,0,21,7,14,13,8,4,10.4858520439884,10.125270178211,0.311602147578162,29
"13650","MS","Ribas do Rio Pardo",24966,35805.33,50007,"Três Lagoas",5,"Centro-oeste",0,"500710",3,28,11,17,9,19,0,0,0,0,0,28,11,17,9,19,4,10.4858520439884,10.125270178211,0.38081357637497,31
"13651","MS","Ribas do Rio Pardo",24966,35805.33,50007,"Três Lagoas",5,"Centro-oeste",0,"500710",4,40,15,25,22,18,0,0,0,0,0,40,15,25,22,18,9,10.4858520439884,10.125270178211,0.4131654555567,30
"13652","MS","Ribas do Rio Pardo",24966,35805.33,50007,"Três Lagoas",5,"Centro-oeste",0,"500710",5,30,9,21,14,16,0,0,0,0,0,30,9,21,14,16,19,10.4858520439884,10.125270178211,0.436930422792902,31
"13653","MS","Rio Brilhante",38186,62329.23,50010,"Dourados",5,"Centro-oeste",0,"500720",2,32,6,26,6,26,0,0,0,0,0,32,6,26,6,26,16,11.0401857761248,10.5502242352734,0.325402521953117,29
"13654","MS","Rio Brilhante",38186,62329.23,50010,"Dourados",5,"Centro-oeste",0,"500720",3,42,18,24,20,22,0,0,0,0,0,42,18,24,20,22,15,11.0401857761248,10.5502242352734,0.383317985011926,31
"13655","MS","Rio Brilhante",38186,62329.23,50010,"Dourados",5,"Centro-oeste",0,"500720",4,55,22,33,28,27,1,0,1,1,0,56,22,34,29,27,11,11.0401857761248,10.5502242352734,0.401406522752011,30
"13656","MS","Rio Brilhante",38186,62329.23,50010,"Dourados",5,"Centro-oeste",0,"500720",5,60,29,31,25,35,0,0,0,0,0,60,29,31,25,35,14,11.0401857761248,10.5502242352734,0.41821487921178,31
"13657","MS","Rio Verde de Mato Grosso",19973,23783.19,50003,"Alto Taquari",5,"Centro-oeste",1,"500740",2,20,11,9,10,10,0,0,0,0,0,20,11,9,10,10,10,10.0767343075894,9.90213664046517,0.267314769932799,29
"13658","MS","Rio Verde de Mato Grosso",19973,23783.19,50003,"Alto Taquari",5,"Centro-oeste",1,"500740",3,26,8,18,10,16,2,2,0,2,0,28,10,18,12,16,10,10.0767343075894,9.90213664046517,0.332168080277562,31
"13659","MS","Rio Verde de Mato Grosso",19973,23783.19,50003,"Alto Taquari",5,"Centro-oeste",1,"500740",4,24,6,18,13,11,0,0,0,0,0,24,6,18,13,11,11,10.0767343075894,9.90213664046517,0.355774989924117,30
"13660","MS","Rio Verde de Mato Grosso",19973,23783.19,50003,"Alto Taquari",5,"Centro-oeste",1,"500740",5,30,10,20,16,14,1,1,0,0,1,31,11,20,16,15,15,10.0767343075894,9.90213664046517,0.3614090915212,31
"13661","MS","Rochedo",5079,32574.38,50004,"Campo Grande",5,"Centro-oeste",0,"500750",2,6,4,2,1,5,0,0,0,0,0,6,4,2,1,5,3,10.3912813688111,8.53286967080125,0.306585319839614,29
"13662","MS","Rochedo",5079,32574.38,50004,"Campo Grande",5,"Centro-oeste",0,"500750",3,3,1,2,2,1,0,0,0,0,0,3,1,2,2,1,2,10.3912813688111,8.53286967080125,0.38770756624213,31
"13663","MS","Rochedo",5079,32574.38,50004,"Campo Grande",5,"Centro-oeste",0,"500750",4,5,1,4,1,4,0,0,0,0,0,5,1,4,1,4,3,10.3912813688111,8.53286967080125,0.438059352247885,30
"13664","MS","Rochedo",5079,32574.38,50004,"Campo Grande",5,"Centro-oeste",0,"500750",5,7,2,5,2,5,0,0,0,0,0,7,2,5,2,5,2,10.3912813688111,8.53286967080125,0.412714400558666,31
"13665","MS","São Gabriel do Oeste",27221,64330.57,50003,"Alto Taquari",5,"Centro-oeste",1,"500769",2,31,11,20,14,17,0,0,0,0,0,31,11,20,14,17,6,11.0717902249285,10.2117440132235,0.304642624041786,29
"13666","MS","São Gabriel do Oeste",27221,64330.57,50003,"Alto Taquari",5,"Centro-oeste",1,"500769",3,32,10,22,13,19,0,0,0,0,0,32,10,22,13,19,12,11.0717902249285,10.2117440132235,0.368397771819662,31
"13667","MS","São Gabriel do Oeste",27221,64330.57,50003,"Alto Taquari",5,"Centro-oeste",1,"500769",4,43,13,30,23,20,0,0,0,0,0,43,13,30,23,20,8,11.0717902249285,10.2117440132235,0.383742986935444,30
"13668","MS","São Gabriel do Oeste",27221,64330.57,50003,"Alto Taquari",5,"Centro-oeste",1,"500769",5,44,12,32,20,24,0,0,0,0,0,44,12,32,20,24,8,11.0717902249285,10.2117440132235,0.380589317263997,31
"13669","MS","Sidrolândia",59245,38621.63,50004,"Campo Grande",5,"Centro-oeste",1,"500790",2,40,6,34,14,26,0,0,0,0,0,40,6,34,14,26,13,10.5615677612027,10.9894366672508,0.32554994724794,29
"13670","MS","Sidrolândia",59245,38621.63,50004,"Campo Grande",5,"Centro-oeste",1,"500790",3,51,16,35,21,30,1,1,0,0,1,52,17,35,21,31,20,10.5615677612027,10.9894366672508,0.391066766727465,31
"13671","MS","Sidrolândia",59245,38621.63,50004,"Campo Grande",5,"Centro-oeste",1,"500790",4,55,17,38,21,34,1,0,1,0,1,56,17,39,21,35,21,10.5615677612027,10.9894366672508,0.406322030295646,30
"13672","MS","Sidrolândia",59245,38621.63,50004,"Campo Grande",5,"Centro-oeste",1,"500790",5,76,18,58,39,37,1,1,0,0,1,77,19,58,39,38,23,10.5615677612027,10.9894366672508,0.421575684785287,31
"13673","MS","Sonora",19721,37941.82,50003,"Alto Taquari",5,"Centro-oeste",1,"500793",2,15,5,10,8,7,0,0,0,0,0,15,5,10,8,7,8,10.5438092128182,9.88943933681007,0.318509474919347,29
"13674","MS","Sonora",19721,37941.82,50003,"Alto Taquari",5,"Centro-oeste",1,"500793",3,24,6,18,12,12,0,0,0,0,0,24,6,18,12,12,8,10.5438092128182,9.88943933681007,0.364482237092692,31
"13675","MS","Sonora",19721,37941.82,50003,"Alto Taquari",5,"Centro-oeste",1,"500793",4,13,6,7,8,5,0,0,0,0,0,13,6,7,8,5,6,10.5438092128182,9.88943933681007,0.393348331817542,30
"13676","MS","Sonora",19721,37941.82,50003,"Alto Taquari",5,"Centro-oeste",1,"500793",5,20,6,14,8,12,1,1,0,0,1,21,7,14,8,13,4,10.5438092128182,9.88943933681007,0.383528534082047,31
"13677","MS","Terenos",22269,24177.1,50004,"Campo Grande",5,"Centro-oeste",0,"500800",2,8,3,5,2,6,0,0,0,0,0,8,3,5,2,6,9,10.0931611831465,10.0109508557857,0.289024370991245,29
"13678","MS","Terenos",22269,24177.1,50004,"Campo Grande",5,"Centro-oeste",0,"500800",3,11,3,8,3,8,0,0,0,0,0,11,3,8,3,8,8,10.0931611831465,10.0109508557857,0.366312785243174,31
"13679","MS","Terenos",22269,24177.1,50004,"Campo Grande",5,"Centro-oeste",0,"500800",4,19,3,16,9,10,0,0,0,0,0,19,3,16,9,10,4,10.0931611831465,10.0109508557857,0.401609041898907,30
"13680","MS","Terenos",22269,24177.1,50004,"Campo Grande",5,"Centro-oeste",0,"500800",5,24,9,15,11,13,0,0,0,0,0,24,9,15,11,13,11,10.0931611831465,10.0109508557857,0.420905563732369,31
"13681","MS","Três Lagoas",123281,96639.64,50007,"Três Lagoas",5,"Centro-oeste",1,"500830",2,126,29,97,55,71,0,0,0,0,0,126,29,97,55,71,55,11.4787442879961,11.7222215815769,0.323457188548093,29
"13682","MS","Três Lagoas",123281,96639.64,50007,"Três Lagoas",5,"Centro-oeste",1,"500830",3,149,38,111,63,86,1,1,0,0,1,150,39,111,63,87,64,11.4787442879961,11.7222215815769,0.402163827948467,31
"13683","MS","Três Lagoas",123281,96639.64,50007,"Três Lagoas",5,"Centro-oeste",1,"500830",4,143,33,110,52,91,0,0,0,0,0,143,33,110,52,91,69,11.4787442879961,11.7222215815769,0.45452051292524,30
"13684","MS","Três Lagoas",123281,96639.64,50007,"Três Lagoas",5,"Centro-oeste",1,"500830",5,176,56,120,56,120,1,0,1,0,1,177,56,121,56,121,59,11.4787442879961,11.7222215815769,0.428120925686343,31
"13685","MT","Acorizal",5334,14351.88,51016,"Rosário Oeste",5,"Centro-oeste",0,"510010",2,4,0,4,1,3,0,0,0,0,0,4,0,4,1,3,1,9.57163622305961,8.58185670474196,0.303485792069957,29
"13686","MT","Acorizal",5334,14351.88,51016,"Rosário Oeste",5,"Centro-oeste",0,"510010",3,6,1,5,3,3,0,0,0,0,0,6,1,5,3,3,2,9.57163622305961,8.58185670474196,0.375800847390246,31
"13687","MT","Acorizal",5334,14351.88,51016,"Rosário Oeste",5,"Centro-oeste",0,"510010",4,3,0,3,3,0,0,0,0,0,0,3,0,3,3,0,3,9.57163622305961,8.58185670474196,0.374005494992828,30
"13688","MT","Acorizal",5334,14351.88,51016,"Rosário Oeste",5,"Centro-oeste",0,"510010",5,3,0,3,1,2,0,0,0,0,0,3,0,3,1,2,4,9.57163622305961,8.58185670474196,0.375054126275832,31
"13689","MT","Água Boa",26204,43513.27,51010,"Canarana",5,"Centro-oeste",1,"510020",2,24,4,20,11,13,0,0,0,0,0,24,4,20,11,13,9,10.6808212280275,10.1736673498518,0.307900787320179,29
"13690","MT","Água Boa",26204,43513.27,51010,"Canarana",5,"Centro-oeste",1,"510020",3,30,6,24,15,15,0,0,0,0,0,30,6,24,15,15,11,10.6808212280275,10.1736673498518,0.367066938649756,31
"13691","MT","Água Boa",26204,43513.27,51010,"Canarana",5,"Centro-oeste",1,"510020",4,38,7,31,18,20,0,0,0,0,0,38,7,31,18,20,9,10.6808212280275,10.1736673498518,0.391845934207996,30
"13692","MT","Água Boa",26204,43513.27,51010,"Canarana",5,"Centro-oeste",1,"510020",5,32,2,30,14,18,0,0,0,0,0,32,2,30,14,18,13,10.6808212280275,10.1736673498518,0.386851266707791,31
"13693","MT","Alta Floresta",51959,28252.43,51002,"Alta Floresta",5,"Centro-oeste",1,"510025",2,74,15,59,36,38,0,0,0,0,0,74,15,59,36,38,22,10.2489347505744,10.8582102250258,0.336448755556016,29
"13694","MT","Alta Floresta",51959,28252.43,51002,"Alta Floresta",5,"Centro-oeste",1,"510025",3,62,10,52,20,42,0,0,0,0,0,62,10,52,20,42,28,10.2489347505744,10.8582102250258,0.421574953910824,31
"13695","MT","Alta Floresta",51959,28252.43,51002,"Alta Floresta",5,"Centro-oeste",1,"510025",4,76,13,63,38,38,0,0,0,0,0,76,13,63,38,38,26,10.2489347505744,10.8582102250258,0.439151356824906,30
"13696","MT","Alta Floresta",51959,28252.43,51002,"Alta Floresta",5,"Centro-oeste",1,"510025",5,62,12,50,28,34,0,0,0,0,0,62,12,50,28,34,24,10.2489347505744,10.8582102250258,0.428940752102408,31
"13697","MT","Alto Araguaia",19385,48128.57,51022,"Alto Araguaia",5,"Centro-oeste",1,"510030",2,10,1,9,6,4,0,0,0,0,0,10,1,9,6,4,9,10.7816312506569,9.87225485010503,0.265643001660523,29
"13698","MT","Alto Araguaia",19385,48128.57,51022,"Alto Araguaia",5,"Centro-oeste",1,"510030",3,19,4,15,5,14,0,0,0,0,0,19,4,15,5,14,13,10.7816312506569,9.87225485010503,0.319781798562783,31
"13699","MT","Alto Araguaia",19385,48128.57,51022,"Alto Araguaia",5,"Centro-oeste",1,"510030",4,20,1,19,9,11,0,0,0,0,0,20,1,19,9,11,12,10.7816312506569,9.87225485010503,0.361577082428261,30
"13700","MT","Alto Araguaia",19385,48128.57,51022,"Alto Araguaia",5,"Centro-oeste",1,"510030",5,16,3,13,6,10,0,0,0,0,0,16,3,13,6,10,7,10.7816312506569,9.87225485010503,0.372027204978899,31
"13701","MT","Alto Garças",12151,44549.55,51022,"Alto Araguaia",5,"Centro-oeste",0,"510040",2,8,2,6,5,3,0,0,0,0,0,8,2,6,5,3,6,10.7043573318378,9.40516674990861,0.285965398157782,29
"13702","MT","Alto Garças",12151,44549.55,51022,"Alto Araguaia",5,"Centro-oeste",0,"510040",3,9,1,8,3,6,1,0,1,1,0,10,1,9,4,6,6,10.7043573318378,9.40516674990861,0.374069280623316,31
"13703","MT","Alto Garças",12151,44549.55,51022,"Alto Araguaia",5,"Centro-oeste",0,"510040",4,11,4,7,5,6,0,0,0,0,0,11,4,7,5,6,5,10.7043573318378,9.40516674990861,0.34399934581558,30
"13704","MT","Alto Garças",12151,44549.55,51022,"Alto Araguaia",5,"Centro-oeste",0,"510040",5,13,4,9,10,3,0,0,0,0,0,13,4,9,10,3,3,10.7043573318378,9.40516674990861,0.344172802399006,31
"13705","MT","Alto Taquari",11133,84436,51022,"Alto Araguaia",5,"Centro-oeste",0,"510060",2,11,3,8,6,5,0,0,0,0,0,11,3,8,6,5,1,11.343749129926,9.31766894972871,0.275746017478474,29
"13706","MT","Alto Taquari",11133,84436,51022,"Alto Araguaia",5,"Centro-oeste",0,"510060",3,15,6,9,9,6,0,0,0,0,0,15,6,9,9,6,2,11.343749129926,9.31766894972871,0.369261378269831,31
"13707","MT","Alto Taquari",11133,84436,51022,"Alto Araguaia",5,"Centro-oeste",0,"510060",4,8,1,7,4,4,0,0,0,0,0,8,1,7,4,4,5,11.343749129926,9.31766894972871,0.375917062800153,30
"13708","MT","Alto Taquari",11133,84436,51022,"Alto Araguaia",5,"Centro-oeste",0,"510060",5,9,0,9,5,4,0,0,0,0,0,9,0,9,5,4,5,11.343749129926,9.31766894972871,0.318318270375453,31
"13709","MT","Araputanga",16951,27012.05,51014,"Jauru",5,"Centro-oeste",1,"510125",2,14,2,12,6,8,0,0,0,0,0,14,2,12,6,8,8,10.2040383417222,9.73808210811849,0.277772961215852,29
"13710","MT","Araputanga",16951,27012.05,51014,"Jauru",5,"Centro-oeste",1,"510125",3,14,1,13,4,10,0,0,0,0,0,14,1,13,4,10,8,10.2040383417222,9.73808210811849,0.354056699200709,31
"13711","MT","Araputanga",16951,27012.05,51014,"Jauru",5,"Centro-oeste",1,"510125",4,22,6,16,11,11,0,0,0,0,0,22,6,16,11,11,5,10.2040383417222,9.73808210811849,0.364698977977735,30
"13712","MT","Araputanga",16951,27012.05,51014,"Jauru",5,"Centro-oeste",1,"510125",5,25,5,20,11,14,0,0,0,0,0,25,5,20,11,14,10,10.2040383417222,9.73808210811849,0.358415508521491,31
"13713","MT","Arenápolis",9502,17218.89,51015,"Alto Paraguai",5,"Centro-oeste",1,"510130",2,6,1,5,4,2,0,0,0,0,0,6,1,5,4,2,6,9.75376231597378,9.15925758174687,0.27548925623888,29
"13714","MT","Arenápolis",9502,17218.89,51015,"Alto Paraguai",5,"Centro-oeste",1,"510130",3,10,3,7,5,5,0,0,0,0,0,10,3,7,5,5,13,9.75376231597378,9.15925758174687,0.331930046823214,31
"13715","MT","Arenápolis",9502,17218.89,51015,"Alto Paraguai",5,"Centro-oeste",1,"510130",4,13,1,12,7,6,0,0,0,0,0,13,1,12,7,6,9,9.75376231597378,9.15925758174687,0.355536266810237,30
"13716","MT","Arenápolis",9502,17218.89,51015,"Alto Paraguai",5,"Centro-oeste",1,"510130",5,19,1,18,8,11,0,0,0,0,0,19,1,18,8,11,3,9.75376231597378,9.15925758174687,0.378775850500023,31
"13717","MT","Aripuanã",22714,37215.51,51001,"Aripuanã",5,"Centro-oeste",0,"510140",2,4,1,3,1,3,0,0,0,0,0,4,1,3,1,3,12,10.5244808888517,10.0307367534516,0.326926285269514,29
"13718","MT","Aripuanã",22714,37215.51,51001,"Aripuanã",5,"Centro-oeste",0,"510140",3,4,1,3,1,3,0,0,0,0,0,4,1,3,1,3,7,10.5244808888517,10.0307367534516,0.394366887994603,31
"13719","MT","Aripuanã",22714,37215.51,51001,"Aripuanã",5,"Centro-oeste",0,"510140",4,3,0,3,1,2,0,0,0,0,0,3,0,3,1,2,8,10.5244808888517,10.0307367534516,0.394974028206305,30
"13720","MT","Aripuanã",22714,37215.51,51001,"Aripuanã",5,"Centro-oeste",0,"510140",5,8,3,5,3,5,0,0,0,0,0,8,3,5,3,5,12,10.5244808888517,10.0307367534516,0.386112768558021,31
"13721","MT","Barra do Bugres",35307,38012.13,51013,"Tangará da Serra",5,"Centro-oeste",1,"510170",2,35,8,27,12,23,0,0,0,0,0,35,8,27,12,23,19,10.545660598298,10.4718365235458,0.341778810411807,29
"13722","MT","Barra do Bugres",35307,38012.13,51013,"Tangará da Serra",5,"Centro-oeste",1,"510170",3,31,9,22,18,13,1,0,1,1,0,32,9,23,19,13,18,10.545660598298,10.4718365235458,0.415284949846694,31
"13723","MT","Barra do Bugres",35307,38012.13,51013,"Tangará da Serra",5,"Centro-oeste",1,"510170",4,47,12,35,25,22,0,0,0,0,0,47,12,35,25,22,21,10.545660598298,10.4718365235458,0.459631305716156,30
"13724","MT","Barra do Bugres",35307,38012.13,51013,"Tangará da Serra",5,"Centro-oeste",1,"510170",5,36,7,29,23,13,0,0,0,0,0,36,7,29,23,13,11,10.545660598298,10.4718365235458,0.421569288161728,31
"13725","MT","Barra do Garças",61135,31280.1,51011,"Médio Araguaia",5,"Centro-oeste",1,"510180",2,88,20,68,34,54,0,0,0,0,0,88,20,68,34,54,29,10.3507373915851,11.0208398125783,0.297126680169232,29
"13726","MT","Barra do Garças",61135,31280.1,51011,"Médio Araguaia",5,"Centro-oeste",1,"510180",3,100,25,75,34,66,0,0,0,0,0,100,25,75,34,66,38,10.3507373915851,11.0208398125783,0.386368151403839,31
"13727","MT","Barra do Garças",61135,31280.1,51011,"Médio Araguaia",5,"Centro-oeste",1,"510180",4,62,14,48,23,39,0,0,0,0,0,62,14,48,23,39,31,10.3507373915851,11.0208398125783,0.422296960923832,30
"13728","MT","Barra do Garças",61135,31280.1,51011,"Médio Araguaia",5,"Centro-oeste",1,"510180",5,93,21,72,41,52,1,0,1,0,1,94,21,73,41,53,38,10.3507373915851,11.0208398125783,0.426636000478229,31
"13729","MT","Brasnorte",20140,50175.57,51001,"Aripuanã",5,"Centro-oeste",0,"510190",2,17,1,16,11,6,1,1,0,1,0,18,2,16,12,6,4,10.8232835338392,9.91046316627255,0.328285451206619,29
"13730","MT","Brasnorte",20140,50175.57,51001,"Aripuanã",5,"Centro-oeste",0,"510190",3,28,10,18,12,16,0,0,0,0,0,28,10,18,12,16,5,10.8232835338392,9.91046316627255,0.37196035624736,31
"13731","MT","Brasnorte",20140,50175.57,51001,"Aripuanã",5,"Centro-oeste",0,"510190",4,27,7,20,14,13,0,0,0,0,0,27,7,20,14,13,7,10.8232835338392,9.91046316627255,0.381948869481195,30
"13732","MT","Brasnorte",20140,50175.57,51001,"Aripuanã",5,"Centro-oeste",0,"510190",5,18,5,13,11,7,0,0,0,0,0,18,5,13,11,7,7,10.8232835338392,9.91046316627255,0.4306722533617,31
"13733","MT","Cáceres",94861,20193.53,51018,"Alto Pantanal",5,"Centro-oeste",1,"510250",2,141,31,110,71,70,1,0,1,1,0,142,31,111,72,70,50,9.91311753505354,11.4601679412272,0.302439638007472,29
"13734","MT","Cáceres",94861,20193.53,51018,"Alto Pantanal",5,"Centro-oeste",1,"510250",3,93,20,73,41,52,2,1,1,1,1,95,21,74,42,53,77,9.91311753505354,11.4601679412272,0.376778540811169,31
"13735","MT","Cáceres",94861,20193.53,51018,"Alto Pantanal",5,"Centro-oeste",1,"510250",4,101,17,84,45,56,1,0,1,1,0,102,17,85,46,56,54,9.91311753505354,11.4601679412272,0.430734824956709,30
"13736","MT","Cáceres",94861,20193.53,51018,"Alto Pantanal",5,"Centro-oeste",1,"510250",5,135,29,106,57,78,2,1,1,1,1,137,30,107,58,79,46,9.91311753505354,11.4601679412272,0.409057152806894,31
"13737","MT","Campo Novo do Parecis",36143,104853.39,51004,"Parecis",5,"Centro-oeste",1,"510263",2,56,14,42,21,35,0,0,0,0,0,56,14,42,21,35,16,11.5603183677101,10.4952385712157,0.341509138993182,29
"13738","MT","Campo Novo do Parecis",36143,104853.39,51004,"Parecis",5,"Centro-oeste",1,"510263",3,71,28,43,36,35,0,0,0,0,0,71,28,43,36,35,16,11.5603183677101,10.4952385712157,0.397875669396782,31
"13739","MT","Campo Novo do Parecis",36143,104853.39,51004,"Parecis",5,"Centro-oeste",1,"510263",4,68,25,43,33,35,0,0,0,0,0,68,25,43,33,35,10,11.5603183677101,10.4952385712157,0.402492688538059,30
"13740","MT","Campo Novo do Parecis",36143,104853.39,51004,"Parecis",5,"Centro-oeste",1,"510263",5,66,20,46,17,49,0,0,0,0,0,66,20,46,17,49,8,11.5603183677101,10.4952385712157,0.391453230496636,31
"13741","MT","Campo Verde",45740,56886.59,51019,"Primavera do Leste",5,"Centro-oeste",0,"510267",2,68,11,57,34,34,0,0,0,0,0,68,11,57,34,34,16,10.9488149157127,10.7307284675768,0.311102901969102,29
"13742","MT","Campo Verde",45740,56886.59,51019,"Primavera do Leste",5,"Centro-oeste",0,"510267",3,67,15,52,27,40,0,0,0,0,0,67,15,52,27,40,21,10.9488149157127,10.7307284675768,0.394188493466211,31
"13743","MT","Campo Verde",45740,56886.59,51019,"Primavera do Leste",5,"Centro-oeste",0,"510267",4,57,8,49,28,29,1,0,1,0,1,58,8,50,28,30,16,10.9488149157127,10.7307284675768,0.411299846079702,30
"13744","MT","Campo Verde",45740,56886.59,51019,"Primavera do Leste",5,"Centro-oeste",0,"510267",5,59,11,48,30,29,0,0,0,0,0,59,11,48,30,29,11,10.9488149157127,10.7307284675768,0.398346038700057,31
"13745","MT","Campos de Júlio",7070,206666.65,51004,"Parecis",5,"Centro-oeste",0,"510268",2,5,1,4,2,3,1,0,1,0,1,6,1,5,2,4,0,12.238862387708,8.86361575889062,0.332400611042918,29
"13746","MT","Campos de Júlio",7070,206666.65,51004,"Parecis",5,"Centro-oeste",0,"510268",3,11,2,9,7,4,0,0,0,0,0,11,2,9,7,4,1,12.238862387708,8.86361575889062,0.396302599391157,31
"13747","MT","Campos de Júlio",7070,206666.65,51004,"Parecis",5,"Centro-oeste",0,"510268",4,10,4,6,6,4,0,0,0,0,0,10,4,6,6,4,4,12.238862387708,8.86361575889062,0.414708392330213,30
"13748","MT","Campos de Júlio",7070,206666.65,51004,"Parecis",5,"Centro-oeste",0,"510268",5,13,6,7,4,9,0,0,0,0,0,13,6,7,4,9,4,12.238862387708,8.86361575889062,0.453569681204289,31
"13749","MT","Canarana",21842,59701.35,51010,"Canarana",5,"Centro-oeste",0,"510270",2,43,18,25,20,23,0,0,0,0,0,43,18,25,20,23,8,10.9971099121903,9.99159000075767,0.30078177407607,29
"13750","MT","Canarana",21842,59701.35,51010,"Canarana",5,"Centro-oeste",0,"510270",3,40,13,27,21,19,1,1,0,1,0,41,14,27,22,19,12,10.9971099121903,9.99159000075767,0.38311271658304,31
"13751","MT","Canarana",21842,59701.35,51010,"Canarana",5,"Centro-oeste",0,"510270",4,34,11,23,17,17,0,0,0,0,0,34,11,23,17,17,6,10.9971099121903,9.99159000075767,0.389762180701135,30
"13752","MT","Canarana",21842,59701.35,51010,"Canarana",5,"Centro-oeste",0,"510270",5,34,16,18,21,13,0,0,0,0,0,34,16,18,21,13,5,10.9971099121903,9.99159000075767,0.371436884407189,31
"13753","MT","Chapada dos Guimarães",19453,37922.51,51017,"Cuiabá",5,"Centro-oeste",0,"510300",2,30,3,27,14,16,0,0,0,0,0,30,3,27,14,16,7,10.5433001461615,9.87575657879782,0.298837634948818,29
"13754","MT","Chapada dos Guimarães",19453,37922.51,51017,"Cuiabá",5,"Centro-oeste",0,"510300",3,21,4,17,7,14,0,0,0,0,0,21,4,17,7,14,9,10.5433001461615,9.87575657879782,0.398124420600452,31
"13755","MT","Chapada dos Guimarães",19453,37922.51,51017,"Cuiabá",5,"Centro-oeste",0,"510300",4,21,3,18,8,13,2,1,1,0,2,23,4,19,8,15,10,10.5433001461615,9.87575657879782,0.454221382839282,30
"13756","MT","Chapada dos Guimarães",19453,37922.51,51017,"Cuiabá",5,"Centro-oeste",0,"510300",5,17,2,15,8,9,0,0,0,0,0,17,2,15,8,9,11,10.5433001461615,9.87575657879782,0.450319544239033,31
"13757","MT","Colíder",33649,26507.28,51003,"Colíder",5,"Centro-oeste",1,"510320",2,30,3,27,10,20,1,0,1,0,1,31,3,28,10,21,19,10.1851746912276,10.4237386169493,0.316118335888728,29
"13758","MT","Colíder",33649,26507.28,51003,"Colíder",5,"Centro-oeste",1,"510320",3,49,9,40,18,31,0,0,0,0,0,49,9,40,18,31,14,10.1851746912276,10.4237386169493,0.375501386664082,31
"13759","MT","Colíder",33649,26507.28,51003,"Colíder",5,"Centro-oeste",1,"510320",4,35,4,31,13,22,1,1,0,1,0,36,5,31,14,22,20,10.1851746912276,10.4237386169493,0.403280730153433,30
"13760","MT","Colíder",33649,26507.28,51003,"Colíder",5,"Centro-oeste",1,"510320",5,33,3,30,11,22,0,0,0,0,0,33,3,30,11,22,14,10.1851746912276,10.4237386169493,0.386844525292568,31
"13761","MT","Colniza",39861,14625.68,51001,"Aripuanã",5,"Centro-oeste",0,"510325",2,32,12,20,19,13,2,2,0,1,1,34,14,20,20,14,9,9.59053416674566,10.5931536812594,0.366141523587696,29
"13762","MT","Colniza",39861,14625.68,51001,"Aripuanã",5,"Centro-oeste",0,"510325",3,43,11,32,28,15,0,0,0,0,0,43,11,32,28,15,14,9.59053416674566,10.5931536812594,0.441680232144794,31
"13763","MT","Colniza",39861,14625.68,51001,"Aripuanã",5,"Centro-oeste",0,"510325",4,33,13,20,13,20,0,0,0,0,0,33,13,20,13,20,7,9.59053416674566,10.5931536812594,0.473320420573694,30
"13764","MT","Colniza",39861,14625.68,51001,"Aripuanã",5,"Centro-oeste",0,"510325",5,45,12,33,22,23,0,0,0,0,0,45,12,33,22,23,11,9.59053416674566,10.5931536812594,0.458397503576519,31
"13765","MT","Comodoro",21008,33952.48,51004,"Parecis",5,"Centro-oeste",0,"510330",2,24,10,14,12,12,0,0,0,0,0,24,10,14,12,12,6,10.4327171789198,9.95265859654258,0.292774830522946,29
"13766","MT","Comodoro",21008,33952.48,51004,"Parecis",5,"Centro-oeste",0,"510330",3,21,12,9,14,7,0,0,0,0,0,21,12,9,14,7,9,10.4327171789198,9.95265859654258,0.349586851345534,31
"13767","MT","Comodoro",21008,33952.48,51004,"Parecis",5,"Centro-oeste",0,"510330",4,26,14,12,11,15,0,0,0,0,0,26,14,12,11,15,4,10.4327171789198,9.95265859654258,0.377984615010064,30
"13768","MT","Comodoro",21008,33952.48,51004,"Parecis",5,"Centro-oeste",0,"510330",5,31,14,17,19,12,0,0,0,0,0,31,14,17,19,12,7,10.4327171789198,9.95265859654258,0.38803107527839,31
"13769","MT","Confresa",31510,27815.74,51009,"Norte Araguaia",5,"Centro-oeste",0,"510335",2,50,14,36,26,24,0,0,0,0,0,50,14,36,26,24,10,10.2333573265057,10.3580602347513,0.317303690343284,29
"13770","MT","Confresa",31510,27815.74,51009,"Norte Araguaia",5,"Centro-oeste",0,"510335",3,52,10,42,24,28,0,0,0,0,0,52,10,42,24,28,13,10.2333573265057,10.3580602347513,0.386232410266198,31
"13771","MT","Confresa",31510,27815.74,51009,"Norte Araguaia",5,"Centro-oeste",0,"510335",4,46,8,38,25,21,0,0,0,0,0,46,8,38,25,21,14,10.2333573265057,10.3580602347513,0.386670103578666,30
"13772","MT","Confresa",31510,27815.74,51009,"Norte Araguaia",5,"Centro-oeste",0,"510335",5,53,11,42,28,25,0,0,0,0,0,53,11,42,28,25,17,10.2333573265057,10.3580602347513,0.385464498696222,31
"13773","MT","Cuiabá",618124,39043.32,51017,"Cuiabá",5,"Centro-oeste",1,"510340",2,714,71,643,232,482,11,3,8,3,8,725,74,651,235,490,306,10.5724270778949,13.3344443635621,0.2953380370616,29
"13774","MT","Cuiabá",618124,39043.32,51017,"Cuiabá",5,"Centro-oeste",1,"510340",3,714,70,644,245,469,7,2,5,3,4,721,72,649,248,473,311,10.5724270778949,13.3344443635621,0.396990353834146,31
"13775","MT","Cuiabá",618124,39043.32,51017,"Cuiabá",5,"Centro-oeste",1,"510340",4,718,77,641,257,461,8,3,5,2,6,726,80,646,259,467,261,10.5724270778949,13.3344443635621,0.445601172314737,30
"13776","MT","Cuiabá",618124,39043.32,51017,"Cuiabá",5,"Centro-oeste",1,"510340",5,736,42,694,267,469,9,0,9,5,4,745,42,703,272,473,304,10.5724270778949,13.3344443635621,0.402039240584011,31
"13777","MT","Diamantino",22178,104683.45,51004,"Parecis",5,"Centro-oeste",0,"510350",2,34,7,27,19,15,0,0,0,0,0,34,7,27,19,15,4,11.558696313686,10.0068560855132,0.304629831781993,29
"13778","MT","Diamantino",22178,104683.45,51004,"Parecis",5,"Centro-oeste",0,"510350",3,35,5,30,14,21,0,0,0,0,0,35,5,30,14,21,11,11.558696313686,10.0068560855132,0.355943655714136,31
"13779","MT","Diamantino",22178,104683.45,51004,"Parecis",5,"Centro-oeste",0,"510350",4,32,7,25,14,18,0,0,0,0,0,32,7,25,14,18,12,11.558696313686,10.0068560855132,0.402438614948567,30
"13780","MT","Diamantino",22178,104683.45,51004,"Parecis",5,"Centro-oeste",0,"510350",5,26,5,21,12,14,0,0,0,0,0,26,5,21,12,14,7,11.558696313686,10.0068560855132,0.395077833081029,31
"13781","MT","Feliz Natal",14522,31425.24,51007,"Sinop",5,"Centro-oeste",0,"510370",2,11,3,8,6,5,1,1,0,0,1,12,4,8,6,6,2,10.3553666706608,9.58342001994019,0.314054509702791,29
"13782","MT","Feliz Natal",14522,31425.24,51007,"Sinop",5,"Centro-oeste",0,"510370",3,19,4,15,9,10,0,0,0,0,0,19,4,15,9,10,3,10.3553666706608,9.58342001994019,0.37019714476579,31
"13783","MT","Feliz Natal",14522,31425.24,51007,"Sinop",5,"Centro-oeste",0,"510370",4,15,7,8,9,6,1,0,1,1,0,16,7,9,10,6,5,10.3553666706608,9.58342001994019,0.383265841159131,30
"13784","MT","Feliz Natal",14522,31425.24,51007,"Sinop",5,"Centro-oeste",0,"510370",5,20,8,12,10,10,0,0,0,0,0,20,8,12,10,10,1,10.3553666706608,9.58342001994019,0.381371692100184,31
"13785","MT","Guarantã do Norte",36130,25002.98,51003,"Colíder",5,"Centro-oeste",0,"510410",2,32,6,26,16,16,0,0,0,0,0,32,6,26,16,16,8,10.1267502967466,10.4948788241417,0.353460694071502,29
"13786","MT","Guarantã do Norte",36130,25002.98,51003,"Colíder",5,"Centro-oeste",0,"510410",3,49,12,37,20,29,0,0,0,0,0,49,12,37,20,29,14,10.1267502967466,10.4948788241417,0.399757530543141,31
"13787","MT","Guarantã do Norte",36130,25002.98,51003,"Colíder",5,"Centro-oeste",0,"510410",4,34,5,29,17,17,1,1,0,1,0,35,6,29,18,17,15,10.1267502967466,10.4948788241417,0.413876943988511,30
"13788","MT","Guarantã do Norte",36130,25002.98,51003,"Colíder",5,"Centro-oeste",0,"510410",5,42,11,31,19,23,0,0,0,0,0,42,11,31,19,23,11,10.1267502967466,10.4948788241417,0.403414209389316,31
"13789","MT","Itiquira",13552,89125.31,51021,"Rondonópolis",5,"Centro-oeste",0,"510460",2,13,3,10,4,9,0,0,0,0,0,13,3,10,4,9,5,11.3977986359714,9.51428941689184,0.329862135404122,29
"13790","MT","Itiquira",13552,89125.31,51021,"Rondonópolis",5,"Centro-oeste",0,"510460",3,12,5,7,4,8,0,0,0,0,0,12,5,7,4,8,7,11.3977986359714,9.51428941689184,0.43861884250816,31
"13791","MT","Itiquira",13552,89125.31,51021,"Rondonópolis",5,"Centro-oeste",0,"510460",4,13,2,11,5,8,1,0,1,0,1,14,2,12,5,9,4,11.3977986359714,9.51428941689184,0.437761475586342,30
"13792","MT","Itiquira",13552,89125.31,51021,"Rondonópolis",5,"Centro-oeste",0,"510460",5,9,4,5,4,5,0,0,0,0,0,9,4,5,4,5,6,11.3977986359714,9.51428941689184,0.41922249897081,31
"13793","MT","Jaciara",27807,33430.18,51021,"Rondonópolis",5,"Centro-oeste",1,"510480",2,28,4,24,11,17,0,0,0,0,0,28,4,24,11,17,15,10.4172143637849,10.2330430665439,0.316261198655038,29
"13794","MT","Jaciara",27807,33430.18,51021,"Rondonópolis",5,"Centro-oeste",1,"510480",3,35,3,32,19,16,1,1,0,0,1,36,4,32,19,17,17,10.4172143637849,10.2330430665439,0.397634020810069,31
"13795","MT","Jaciara",27807,33430.18,51021,"Rondonópolis",5,"Centro-oeste",1,"510480",4,22,6,16,10,12,0,0,0,0,0,22,6,16,10,12,7,10.4172143637849,10.2330430665439,0.424714038839286,30
"13796","MT","Jaciara",27807,33430.18,51021,"Rondonópolis",5,"Centro-oeste",1,"510480",5,38,6,32,17,21,0,0,0,0,0,38,6,32,17,21,4,10.4172143637849,10.2330430665439,0.393759326948337,31
"13797","MT","Juara",35121,21348.2,51005,"Arinos",5,"Centro-oeste",0,"510510",2,50,14,36,25,25,0,0,0,0,0,50,14,36,25,25,22,9.96872270596907,10.4665545211478,0.311863864680776,29
"13798","MT","Juara",35121,21348.2,51005,"Arinos",5,"Centro-oeste",0,"510510",3,47,13,34,18,29,0,0,0,0,0,47,13,34,18,29,15,9.96872270596907,10.4665545211478,0.370304443713477,31
"13799","MT","Juara",35121,21348.2,51005,"Arinos",5,"Centro-oeste",0,"510510",4,49,12,37,27,22,2,1,1,0,2,51,13,38,27,24,11,9.96872270596907,10.4665545211478,0.378372057832367,30
"13800","MT","Juara",35121,21348.2,51005,"Arinos",5,"Centro-oeste",0,"510510",5,61,14,47,34,27,0,0,0,0,0,61,14,47,34,27,17,9.96872270596907,10.4665545211478,0.379473143002145,31
"13801","MT","Juína",41101,25195.72,51001,"Aripuanã",5,"Centro-oeste",1,"510515",2,51,10,41,20,31,1,0,1,1,0,52,10,42,21,31,19,10.134429417805,10.6237877310886,0.343525645926163,29
"13802","MT","Juína",41101,25195.72,51001,"Aripuanã",5,"Centro-oeste",1,"510515",3,57,13,44,24,33,0,0,0,0,0,57,13,44,24,33,16,10.134429417805,10.6237877310886,0.419282001612443,31
"13803","MT","Juína",41101,25195.72,51001,"Aripuanã",5,"Centro-oeste",1,"510515",4,54,12,42,27,27,0,0,0,0,0,54,12,42,27,27,16,10.134429417805,10.6237877310886,0.427856692984264,30
"13804","MT","Juína",41101,25195.72,51001,"Aripuanã",5,"Centro-oeste",1,"510515",5,57,6,51,27,30,0,0,0,0,0,57,6,51,27,30,23,10.134429417805,10.6237877310886,0.405653995750527,31
"13805","MT","Lucas do Rio Verde",67620,72058.74,51006,"Alto Teles Pires",5,"Centro-oeste",1,"510525",2,92,9,83,28,64,1,1,0,1,0,93,10,83,29,64,21,11.1852368987204,11.1216590762619,0.327696984341273,29
"13806","MT","Lucas do Rio Verde",67620,72058.74,51006,"Alto Teles Pires",5,"Centro-oeste",1,"510525",3,93,25,68,39,54,0,0,0,0,0,93,25,68,39,54,31,11.1852368987204,11.1216590762619,0.406257621329207,31
"13807","MT","Lucas do Rio Verde",67620,72058.74,51006,"Alto Teles Pires",5,"Centro-oeste",1,"510525",4,108,24,84,45,63,0,0,0,0,0,108,24,84,45,63,21,11.1852368987204,11.1216590762619,0.423690951674189,30
"13808","MT","Lucas do Rio Verde",67620,72058.74,51006,"Alto Teles Pires",5,"Centro-oeste",1,"510525",5,125,21,104,50,75,0,0,0,0,0,125,21,104,50,75,19,11.1852368987204,11.1216590762619,0.405771177189552,31
"13809","MT","Matupá",16793,46169.08,51003,"Colíder",5,"Centro-oeste",0,"510560",2,20,4,16,12,8,0,0,0,0,0,20,4,16,12,8,6,10.7400655889434,9.72871741189501,0.333223291051209,29
"13810","MT","Matupá",16793,46169.08,51003,"Colíder",5,"Centro-oeste",0,"510560",3,21,3,18,7,14,0,0,0,0,0,21,3,18,7,14,7,10.7400655889434,9.72871741189501,0.401389412348762,31
"13811","MT","Matupá",16793,46169.08,51003,"Colíder",5,"Centro-oeste",0,"510560",4,15,2,13,9,6,0,0,0,0,0,15,2,13,9,6,10,10.7400655889434,9.72871741189501,0.39982456523104,30
"13812","MT","Matupá",16793,46169.08,51003,"Colíder",5,"Centro-oeste",0,"510560",5,30,4,26,14,16,0,0,0,0,0,30,4,26,14,16,6,10.7400655889434,9.72871741189501,0.398842821206122,31
"13813","MT","Mirassol d'Oeste",27941,27955.36,51014,"Jauru",5,"Centro-oeste",1,"510562",2,36,3,33,10,26,1,0,1,1,0,37,3,34,11,26,18,10.2383642312172,10.2378504231511,0.295365487343867,29
"13814","MT","Mirassol d'Oeste",27941,27955.36,51014,"Jauru",5,"Centro-oeste",1,"510562",3,30,5,25,14,16,0,0,0,0,0,30,5,25,14,16,15,10.2383642312172,10.2378504231511,0.359665093180892,31
"13815","MT","Mirassol d'Oeste",27941,27955.36,51014,"Jauru",5,"Centro-oeste",1,"510562",4,24,3,21,11,13,0,0,0,0,0,24,3,21,11,13,14,10.2383642312172,10.2378504231511,0.412479447752958,30
"13816","MT","Mirassol d'Oeste",27941,27955.36,51014,"Jauru",5,"Centro-oeste",1,"510562",5,25,7,18,10,15,0,0,0,0,0,25,7,18,10,15,11,10.2383642312172,10.2378504231511,0.385009425064656,31
"13817","MT","Nobres",15334,43679.82,51006,"Alto Teles Pires",5,"Centro-oeste",0,"510590",2,18,2,16,7,11,0,0,0,0,0,18,2,16,7,11,16,10.6846414895312,9.63782786411884,0.294104342483062,29
"13818","MT","Nobres",15334,43679.82,51006,"Alto Teles Pires",5,"Centro-oeste",0,"510590",3,22,3,19,8,14,0,0,0,0,0,22,3,19,8,14,8,10.6846414895312,9.63782786411884,0.32974013677867,31
"13819","MT","Nobres",15334,43679.82,51006,"Alto Teles Pires",5,"Centro-oeste",0,"510590",4,22,5,17,8,14,1,0,1,1,0,23,5,18,9,14,10,10.6846414895312,9.63782786411884,0.372059318413074,30
"13820","MT","Nobres",15334,43679.82,51006,"Alto Teles Pires",5,"Centro-oeste",0,"510590",5,15,5,10,7,8,0,0,0,0,0,15,5,10,7,8,9,10.6846414895312,9.63782786411884,0.380827762581402,31
"13821","MT","Nova Mutum",46813,75174.99,51006,"Alto Teles Pires",5,"Centro-oeste",1,"510622",2,72,12,60,28,44,0,0,0,0,0,72,12,60,28,44,11,11.2275738748338,10.7539162211104,0.320786015672355,29
"13822","MT","Nova Mutum",46813,75174.99,51006,"Alto Teles Pires",5,"Centro-oeste",1,"510622",3,48,9,39,15,33,0,0,0,0,0,48,9,39,15,33,13,11.2275738748338,10.7539162211104,0.388349583276823,31
"13823","MT","Nova Mutum",46813,75174.99,51006,"Alto Teles Pires",5,"Centro-oeste",1,"510622",4,63,12,51,22,41,2,0,2,1,1,65,12,53,23,42,8,11.2275738748338,10.7539162211104,0.408176717928516,30
"13824","MT","Nova Mutum",46813,75174.99,51006,"Alto Teles Pires",5,"Centro-oeste",1,"510622",5,83,15,68,37,46,2,1,1,0,2,85,16,69,37,48,12,11.2275738748338,10.7539162211104,0.40192442452331,31
"13825","MT","Nova Olímpia",20563,35897.86,51013,"Tangará da Serra",5,"Centro-oeste",1,"510623",2,18,2,16,6,12,0,0,0,0,0,18,2,16,6,12,6,10.4884329626718,9.93124862332152,0.329687739171948,29
"13826","MT","Nova Olímpia",20563,35897.86,51013,"Tangará da Serra",5,"Centro-oeste",1,"510623",3,26,5,21,13,13,0,0,0,0,0,26,5,21,13,13,6,10.4884329626718,9.93124862332152,0.415307240359869,31
"13827","MT","Nova Olímpia",20563,35897.86,51013,"Tangará da Serra",5,"Centro-oeste",1,"510623",4,31,10,21,16,15,0,0,0,0,0,31,10,21,16,15,8,10.4884329626718,9.93124862332152,0.449508555232857,30
"13828","MT","Nova Olímpia",20563,35897.86,51013,"Tangará da Serra",5,"Centro-oeste",1,"510623",5,24,5,19,12,12,0,0,0,0,0,24,5,19,12,12,14,10.4884329626718,9.93124862332152,0.409679986069286,31
"13829","MT","Nova Ubiratã",12298,92588.46,51006,"Alto Teles Pires",5,"Centro-oeste",0,"510624",2,8,5,3,3,5,0,0,0,0,0,8,5,3,3,5,1,11.4359197908381,9.41719192651341,0.344315497184827,29
"13830","MT","Nova Ubiratã",12298,92588.46,51006,"Alto Teles Pires",5,"Centro-oeste",0,"510624",3,16,4,12,5,11,0,0,0,0,0,16,4,12,5,11,6,11.4359197908381,9.41719192651341,0.406742294127372,31
"13831","MT","Nova Ubiratã",12298,92588.46,51006,"Alto Teles Pires",5,"Centro-oeste",0,"510624",4,11,2,9,2,9,1,0,1,0,1,12,2,10,2,10,4,11.4359197908381,9.41719192651341,0.431286091732135,30
"13832","MT","Nova Ubiratã",12298,92588.46,51006,"Alto Teles Pires",5,"Centro-oeste",0,"510624",5,10,2,8,7,3,0,0,0,0,0,10,2,8,7,3,4,11.4359197908381,9.41719192651341,0.468658575644252,31
"13833","MT","Nova Xavantina",20944,30536.76,51010,"Canarana",5,"Centro-oeste",1,"510625",2,21,5,16,12,9,0,0,0,0,0,21,5,16,12,9,9,10.3266864827714,9.94960748814968,0.333799569513424,29
"13834","MT","Nova Xavantina",20944,30536.76,51010,"Canarana",5,"Centro-oeste",1,"510625",3,35,7,28,15,20,0,0,0,0,0,35,7,28,15,20,10,10.3266864827714,9.94960748814968,0.399394000176573,31
"13835","MT","Nova Xavantina",20944,30536.76,51010,"Canarana",5,"Centro-oeste",1,"510625",4,17,4,13,9,8,0,0,0,0,0,17,4,13,9,8,11,10.3266864827714,9.94960748814968,0.43193649513683,30
"13836","MT","Nova Xavantina",20944,30536.76,51010,"Canarana",5,"Centro-oeste",1,"510625",5,31,4,27,11,20,0,0,0,0,0,31,4,27,11,20,9,10.3266864827714,9.94960748814968,0.414011442895945,31
"13837","MT","Paranatinga",22861,29944.83,51008,"Paranatinga",5,"Centro-oeste",0,"510630",2,29,13,16,12,17,0,0,0,0,0,29,13,16,12,17,7,10.3071119676078,10.037187680924,0.333827423046545,29
"13838","MT","Paranatinga",22861,29944.83,51008,"Paranatinga",5,"Centro-oeste",0,"510630",3,25,10,15,16,9,0,0,0,0,0,25,10,15,16,9,13,10.3071119676078,10.037187680924,0.405252090509027,31
"13839","MT","Paranatinga",22861,29944.83,51008,"Paranatinga",5,"Centro-oeste",0,"510630",4,28,11,17,13,15,2,0,2,0,2,30,11,19,13,17,11,10.3071119676078,10.037187680924,0.421423918447524,30
"13840","MT","Paranatinga",22861,29944.83,51008,"Paranatinga",5,"Centro-oeste",0,"510630",5,22,11,11,11,11,0,0,0,0,0,22,11,11,11,11,16,10.3071119676078,10.037187680924,0.425382359200429,31
"13841","MT","Pedra Preta",17446,42994.76,51021,"Rondonópolis",5,"Centro-oeste",0,"510637",2,22,5,17,12,10,0,0,0,0,0,22,5,17,12,10,7,10.668833526785,9.76686567499316,0.292825856183939,29
"13842","MT","Pedra Preta",17446,42994.76,51021,"Rondonópolis",5,"Centro-oeste",0,"510637",3,27,4,23,14,13,0,0,0,0,0,27,4,23,14,13,12,10.668833526785,9.76686567499316,0.382471629909703,31
"13843","MT","Pedra Preta",17446,42994.76,51021,"Rondonópolis",5,"Centro-oeste",0,"510637",4,22,5,17,6,16,0,0,0,0,0,22,5,17,6,16,11,10.668833526785,9.76686567499316,0.414488997331768,30
"13844","MT","Pedra Preta",17446,42994.76,51021,"Rondonópolis",5,"Centro-oeste",0,"510637",5,21,3,18,7,14,0,0,0,0,0,21,3,18,7,14,14,10.668833526785,9.76686567499316,0.386032546736694,31
"13845","MT","Peixoto de Azevedo",35338,15680.52,51003,"Colíder",5,"Centro-oeste",0,"510642",2,47,16,31,26,21,0,0,0,0,0,47,16,31,26,21,10,9.66017445661982,10.4727141511766,0.321662472228234,29
"13846","MT","Peixoto de Azevedo",35338,15680.52,51003,"Colíder",5,"Centro-oeste",0,"510642",3,52,21,31,27,25,2,1,1,1,1,54,22,32,28,26,22,9.66017445661982,10.4727141511766,0.381310778519871,31
"13847","MT","Peixoto de Azevedo",35338,15680.52,51003,"Colíder",5,"Centro-oeste",0,"510642",4,49,21,28,28,21,1,0,1,0,1,50,21,29,28,22,14,9.66017445661982,10.4727141511766,0.404322458012435,30
"13848","MT","Peixoto de Azevedo",35338,15680.52,51003,"Colíder",5,"Centro-oeste",0,"510642",5,53,27,26,28,25,0,0,0,0,0,53,27,26,28,25,11,9.66017445661982,10.4727141511766,0.393783108654558,31
"13849","MT","Poconé",33315,16474.2,51018,"Alto Pantanal",5,"Centro-oeste",0,"510650",2,42,3,39,22,20,1,0,1,0,1,43,3,40,22,21,19,9.70955079976986,10.4137630249966,0.256138826478633,29
"13850","MT","Poconé",33315,16474.2,51018,"Alto Pantanal",5,"Centro-oeste",0,"510650",3,33,9,24,16,17,1,0,1,0,1,34,9,25,16,18,17,9.70955079976986,10.4137630249966,0.312192862107736,31
"13851","MT","Poconé",33315,16474.2,51018,"Alto Pantanal",5,"Centro-oeste",0,"510650",4,31,11,20,11,20,0,0,0,0,0,31,11,20,11,20,9,9.70955079976986,10.4137630249966,0.330883455581437,30
"13852","MT","Poconé",33315,16474.2,51018,"Alto Pantanal",5,"Centro-oeste",0,"510650",5,48,9,39,24,24,0,0,0,0,0,48,9,39,24,24,19,9.70955079976986,10.4137630249966,0.334237299544391,31
"13853","MT","Pontal do Araguaia",6843,13144.45,51020,"Tesouro",5,"Centro-oeste",1,"510665",2,7,3,4,2,5,0,0,0,0,0,7,3,4,2,5,4,9.48375489528444,8.8309815109525,0.311717500666511,29
"13854","MT","Pontal do Araguaia",6843,13144.45,51020,"Tesouro",5,"Centro-oeste",1,"510665",3,8,2,6,3,5,0,0,0,0,0,8,2,6,3,5,3,9.48375489528444,8.8309815109525,0.379713490275523,31
"13855","MT","Pontal do Araguaia",6843,13144.45,51020,"Tesouro",5,"Centro-oeste",1,"510665",4,2,0,2,2,0,0,0,0,0,0,2,0,2,2,0,1,9.48375489528444,8.8309815109525,0.400178347581444,30
"13856","MT","Pontal do Araguaia",6843,13144.45,51020,"Tesouro",5,"Centro-oeste",1,"510665",5,8,2,6,3,5,0,0,0,0,0,8,2,6,3,5,3,9.48375489528444,8.8309815109525,0.379111605452232,31
"13857","MT","Pontes e Lacerda",45774,29595.1,51012,"Alto Guaporé",5,"Centro-oeste",1,"510675",2,63,18,45,33,30,1,0,1,0,1,64,18,46,33,31,13,10.2953640860683,10.7314715233183,0.336419059335512,29
"13858","MT","Pontes e Lacerda",45774,29595.1,51012,"Alto Guaporé",5,"Centro-oeste",1,"510675",3,55,12,43,21,34,1,0,1,0,1,56,12,44,21,35,23,10.2953640860683,10.7314715233183,0.3975133368104,31
"13859","MT","Pontes e Lacerda",45774,29595.1,51012,"Alto Guaporé",5,"Centro-oeste",1,"510675",4,69,15,54,32,37,3,1,2,1,2,72,16,56,33,39,24,10.2953640860683,10.7314715233183,0.424969412513819,30
"13860","MT","Pontes e Lacerda",45774,29595.1,51012,"Alto Guaporé",5,"Centro-oeste",1,"510675",5,74,19,55,41,33,0,0,0,0,0,74,19,55,41,33,15,10.2953640860683,10.7314715233183,0.418792099820916,31
"13861","MT","Porto Alegre do Norte",12685,18762.1,51009,"Norte Araguaia",5,"Centro-oeste",0,"510677",2,21,3,18,9,12,0,0,0,0,0,21,3,18,9,12,1,9.83959415659388,9.44817547203338,0.346743475482274,29
"13862","MT","Porto Alegre do Norte",12685,18762.1,51009,"Norte Araguaia",5,"Centro-oeste",0,"510677",3,7,2,5,5,2,0,0,0,0,0,7,2,5,5,2,2,9.83959415659388,9.44817547203338,0.379117376431758,31
"13863","MT","Porto Alegre do Norte",12685,18762.1,51009,"Norte Araguaia",5,"Centro-oeste",0,"510677",4,12,3,9,3,9,0,0,0,0,0,12,3,9,3,9,2,9.83959415659388,9.44817547203338,0.396204473358975,30
"13864","MT","Porto Alegre do Norte",12685,18762.1,51009,"Norte Araguaia",5,"Centro-oeste",0,"510677",5,12,3,9,9,3,0,0,0,0,0,12,3,9,9,3,2,9.83959415659388,9.44817547203338,0.400171847164981,31
"13865","MT","Poxoréu",15916,31601.74,51020,"Tesouro",5,"Centro-oeste",0,"510700",2,17,5,12,8,9,0,0,0,0,0,17,5,12,8,9,7,10.3609674613502,9.67508017154682,0.375373323895805,29
"13866","MT","Poxoréu",15916,31601.74,51020,"Tesouro",5,"Centro-oeste",0,"510700",3,20,8,12,7,13,0,0,0,0,0,20,8,12,7,13,16,10.3609674613502,9.67508017154682,0.411342978942792,31
"13867","MT","Poxoréu",15916,31601.74,51020,"Tesouro",5,"Centro-oeste",0,"510700",4,18,4,14,8,10,0,0,0,0,0,18,4,14,8,10,8,10.3609674613502,9.67508017154682,0.413135859106923,30
"13868","MT","Poxoréu",15916,31601.74,51020,"Tesouro",5,"Centro-oeste",0,"510700",5,20,4,16,8,12,0,0,0,0,0,20,4,16,8,12,10,10.3609674613502,9.67508017154682,0.463808555521869,31
"13869","MT","Primavera do Leste",63092,64817.96,51019,"Primavera do Leste",5,"Centro-oeste",1,"510704",2,121,23,98,45,76,0,0,0,0,0,121,23,98,45,76,29,11.0793380044323,11.0523492576074,0.312259349782509,29
"13870","MT","Primavera do Leste",63092,64817.96,51019,"Primavera do Leste",5,"Centro-oeste",1,"510704",3,103,18,85,44,59,0,0,0,0,0,103,18,85,44,59,27,11.0793380044323,11.0523492576074,0.378511702661342,31
"13871","MT","Primavera do Leste",63092,64817.96,51019,"Primavera do Leste",5,"Centro-oeste",1,"510704",4,95,12,83,35,60,0,0,0,0,0,95,12,83,35,60,22,11.0793380044323,11.0523492576074,0.406499633370178,30
"13872","MT","Primavera do Leste",63092,64817.96,51019,"Primavera do Leste",5,"Centro-oeste",1,"510704",5,117,23,94,46,71,0,0,0,0,0,117,23,94,46,71,23,11.0793380044323,11.0523492576074,0.390653868773903,31
"13873","MT","Querência",17937,97089.7,51010,"Canarana",5,"Centro-oeste",0,"510706",2,26,9,17,10,16,0,0,0,0,0,26,9,17,10,16,3,11.4833905724428,9.79462089754901,0.325461167790424,29
"13874","MT","Querência",17937,97089.7,51010,"Canarana",5,"Centro-oeste",0,"510706",3,29,8,21,13,16,0,0,0,0,0,29,8,21,13,16,8,11.4833905724428,9.79462089754901,0.390612542068256,31
"13875","MT","Querência",17937,97089.7,51010,"Canarana",5,"Centro-oeste",0,"510706",4,45,9,36,17,28,0,0,0,0,0,45,9,36,17,28,8,11.4833905724428,9.79462089754901,0.422738195316549,30
"13876","MT","Querência",17937,97089.7,51010,"Canarana",5,"Centro-oeste",0,"510706",5,47,16,31,18,29,0,0,0,0,0,47,16,31,18,29,7,11.4833905724428,9.79462089754901,0.421707328298782,31
"13877","MT","São José dos Quatro Marcos",18846,20023.47,51014,"Jauru",5,"Centro-oeste",0,"510710",2,18,1,17,8,10,0,0,0,0,0,18,1,17,8,10,13,9.90466036452321,9.8440559687667,0.303613916479674,29
"13878","MT","São José dos Quatro Marcos",18846,20023.47,51014,"Jauru",5,"Centro-oeste",0,"510710",3,18,1,17,5,13,0,0,0,0,0,18,1,17,5,13,14,9.90466036452321,9.8440559687667,0.374919545440669,31
"13879","MT","São José dos Quatro Marcos",18846,20023.47,51014,"Jauru",5,"Centro-oeste",0,"510710",4,8,0,8,3,5,0,0,0,0,0,8,0,8,3,5,10,9.90466036452321,9.8440559687667,0.434556496610905,30
"13880","MT","São José dos Quatro Marcos",18846,20023.47,51014,"Jauru",5,"Centro-oeste",0,"510710",5,21,4,17,12,9,0,0,0,0,0,21,4,17,12,9,6,9.90466036452321,9.8440559687667,0.403223946387444,31
"13881","MT","Ribeirão Cascalheira",10329,35068.07,51009,"Norte Araguaia",5,"Centro-oeste",0,"510718",2,8,2,6,4,4,0,0,0,0,0,8,2,6,4,4,1,10.4650463088283,9.24271075200663,0.31023860460697,29
"13882","MT","Ribeirão Cascalheira",10329,35068.07,51009,"Norte Araguaia",5,"Centro-oeste",0,"510718",3,13,7,6,10,3,0,0,0,0,0,13,7,6,10,3,5,10.4650463088283,9.24271075200663,0.357684789461613,31
"13883","MT","Ribeirão Cascalheira",10329,35068.07,51009,"Norte Araguaia",5,"Centro-oeste",0,"510718",4,12,3,9,5,7,0,0,0,0,0,12,3,9,5,7,8,10.4650463088283,9.24271075200663,0.372119917928011,30
"13884","MT","Ribeirão Cascalheira",10329,35068.07,51009,"Norte Araguaia",5,"Centro-oeste",0,"510718",5,19,6,13,12,7,0,0,0,0,0,19,6,13,12,7,4,10.4650463088283,9.24271075200663,0.414327996456152,31
"13885","MT","São José do Rio Claro",21011,41671.17,51005,"Arinos",5,"Centro-oeste",1,"510730",2,27,3,24,17,10,0,0,0,0,0,27,3,24,17,10,5,10.6375648017761,9.95280138908905,0.334608498104366,29
"13886","MT","São José do Rio Claro",21011,41671.17,51005,"Arinos",5,"Centro-oeste",1,"510730",3,11,4,7,7,4,1,1,0,0,1,12,5,7,7,5,7,10.6375648017761,9.95280138908905,0.407755622266458,31
"13887","MT","São José do Rio Claro",21011,41671.17,51005,"Arinos",5,"Centro-oeste",1,"510730",4,28,7,21,18,10,0,0,0,0,0,28,7,21,18,10,4,10.6375648017761,9.95280138908905,0.389845537040023,30
"13888","MT","São José do Rio Claro",21011,41671.17,51005,"Arinos",5,"Centro-oeste",1,"510730",5,31,4,27,10,21,0,0,0,0,0,31,4,27,10,21,9,10.6375648017761,9.95280138908905,0.40668690749563,31
"13889","MT","Rondonópolis",236042,49041.7,51021,"Rondonópolis",5,"Centro-oeste",1,"510760",2,269,49,220,101,168,6,2,4,1,5,275,51,224,102,173,114,10.8004262355884,12.3717650342754,0.320916922908293,29
"13890","MT","Rondonópolis",236042,49041.7,51021,"Rondonópolis",5,"Centro-oeste",1,"510760",3,309,64,245,119,190,5,0,5,1,4,314,64,250,120,194,130,10.8004262355884,12.3717650342754,0.412073583907485,31
"13891","MT","Rondonópolis",236042,49041.7,51021,"Rondonópolis",5,"Centro-oeste",1,"510760",4,302,62,240,121,181,0,0,0,0,0,302,62,240,121,181,91,10.8004262355884,12.3717650342754,0.423357583029691,30
"13892","MT","Rondonópolis",236042,49041.7,51021,"Rondonópolis",5,"Centro-oeste",1,"510760",5,340,54,286,119,221,3,1,2,2,1,343,55,288,121,222,107,10.8004262355884,12.3717650342754,0.39463511363734,31
"13893","MT","Rosário Oeste",17054,18303.21,51016,"Rosário Oeste",5,"Centro-oeste",0,"510770",2,12,1,11,7,5,0,0,0,0,0,12,1,11,7,5,6,9.81483173328307,9.74414005930199,0.329343330248161,29
"13894","MT","Rosário Oeste",17054,18303.21,51016,"Rosário Oeste",5,"Centro-oeste",0,"510770",3,16,1,15,8,8,0,0,0,0,0,16,1,15,8,8,8,9.81483173328307,9.74414005930199,0.388011546193957,31
"13895","MT","Rosário Oeste",17054,18303.21,51016,"Rosário Oeste",5,"Centro-oeste",0,"510770",4,20,4,16,9,11,0,0,0,0,0,20,4,16,9,11,3,9.81483173328307,9.74414005930199,0.415770409588607,30
"13896","MT","Rosário Oeste",17054,18303.21,51016,"Rosário Oeste",5,"Centro-oeste",0,"510770",5,15,2,13,8,7,1,1,0,1,0,16,3,13,9,7,8,9.81483173328307,9.74414005930199,0.441621338487885,31
"13897","MT","Santo Antônio do Leverger",16999,30132.88,51017,"Cuiabá",5,"Centro-oeste",0,"510780",2,16,4,12,5,11,1,1,0,0,1,17,5,12,5,12,10,10.3133722133512,9.74090979777877,0.298779278742273,29
"13898","MT","Santo Antônio do Leverger",16999,30132.88,51017,"Cuiabá",5,"Centro-oeste",0,"510780",3,13,2,11,6,7,0,0,0,0,0,13,2,11,6,7,12,10.3133722133512,9.74090979777877,0.392688680290222,31
"13899","MT","Santo Antônio do Leverger",16999,30132.88,51017,"Cuiabá",5,"Centro-oeste",0,"510780",4,12,2,10,4,8,0,0,0,0,0,12,2,10,4,8,5,10.3133722133512,9.74090979777877,0.427451229288456,30
"13900","MT","Santo Antônio do Leverger",16999,30132.88,51017,"Cuiabá",5,"Centro-oeste",0,"510780",5,19,5,14,8,11,0,0,0,0,0,19,5,14,8,11,5,10.3133722133512,9.74090979777877,0.444380318057698,31
"13901","MT","São Félix do Araguaia",11843,57651.97,51009,"Norte Araguaia",5,"Centro-oeste",0,"510785",2,11,2,9,6,5,0,0,0,0,0,11,2,9,6,5,3,10.9621796968393,9.37949225472149,0.342418509425452,29
"13902","MT","São Félix do Araguaia",11843,57651.97,51009,"Norte Araguaia",5,"Centro-oeste",0,"510785",3,16,4,12,11,5,0,0,0,0,0,16,4,12,11,5,2,10.9621796968393,9.37949225472149,0.394239528808983,31
"13903","MT","São Félix do Araguaia",11843,57651.97,51009,"Norte Araguaia",5,"Centro-oeste",0,"510785",4,7,3,4,4,3,0,0,0,0,0,7,3,4,4,3,6,10.9621796968393,9.37949225472149,0.426169556385437,30
"13904","MT","São Félix do Araguaia",11843,57651.97,51009,"Norte Araguaia",5,"Centro-oeste",0,"510785",5,10,3,7,5,5,0,0,0,0,0,10,3,7,5,5,1,10.9621796968393,9.37949225472149,0.496430876202533,31
"13905","MT","Sapezal",26688,116763.71,51004,"Parecis",5,"Centro-oeste",1,"510787",2,40,12,28,17,23,1,0,1,0,1,41,12,29,17,24,4,11.6679075990436,10.1919693051585,0.308145356884967,29
"13906","MT","Sapezal",26688,116763.71,51004,"Parecis",5,"Centro-oeste",1,"510787",3,27,7,20,14,13,0,0,0,0,0,27,7,20,14,13,6,11.6679075990436,10.1919693051585,0.39150137245388,31
"13907","MT","Sapezal",26688,116763.71,51004,"Parecis",5,"Centro-oeste",1,"510787",4,19,4,15,10,9,1,0,1,0,1,20,4,16,10,10,6,11.6679075990436,10.1919693051585,0.407921533259525,30
"13908","MT","Sapezal",26688,116763.71,51004,"Parecis",5,"Centro-oeste",1,"510787",5,37,12,25,20,17,0,0,0,0,0,37,12,25,20,17,5,11.6679075990436,10.1919693051585,0.399966502760518,31
"13909","MT","Sinop",146005,45050.74,51007,"Sinop",5,"Centro-oeste",1,"510790",2,245,43,202,102,143,1,1,0,0,1,246,44,202,102,144,46,10.7155446890947,11.8913961466794,0.320153248085405,29
"13910","MT","Sinop",146005,45050.74,51007,"Sinop",5,"Centro-oeste",1,"510790",3,249,32,217,102,147,1,0,1,0,1,250,32,218,102,148,64,10.7155446890947,11.8913961466794,0.401732219328067,31
"13911","MT","Sinop",146005,45050.74,51007,"Sinop",5,"Centro-oeste",1,"510790",4,235,43,192,94,141,1,0,1,0,1,236,43,193,94,142,74,10.7155446890947,11.8913961466794,0.430127696591965,30
"13912","MT","Sinop",146005,45050.74,51007,"Sinop",5,"Centro-oeste",1,"510790",5,297,40,257,134,163,0,0,0,0,0,297,40,257,134,163,70,10.7155446890947,11.8913961466794,0.394472539487203,31
"13913","MT","Sorriso",92769,68895.07,51006,"Alto Teles Pires",5,"Centro-oeste",1,"510792",2,154,32,122,65,89,1,1,0,1,0,155,33,122,66,89,27,11.1403399014664,11.4378678112424,0.299183874931314,29
"13914","MT","Sorriso",92769,68895.07,51006,"Alto Teles Pires",5,"Centro-oeste",1,"510792",3,161,49,112,68,93,1,0,1,0,1,162,49,113,68,94,34,11.1403399014664,11.4378678112424,0.374979292187265,31
"13915","MT","Sorriso",92769,68895.07,51006,"Alto Teles Pires",5,"Centro-oeste",1,"510792",4,153,36,117,65,88,4,1,3,2,2,157,37,120,67,90,36,11.1403399014664,11.4378678112424,0.396215812757116,30
"13916","MT","Sorriso",92769,68895.07,51006,"Alto Teles Pires",5,"Centro-oeste",1,"510792",5,184,35,149,68,116,2,1,1,1,1,186,36,150,69,117,30,11.1403399014664,11.4378678112424,0.404028227527554,31
"13917","MT","Tangará da Serra",105711,31823.37,51013,"Tangará da Serra",5,"Centro-oeste",1,"510795",2,141,14,127,54,87,0,0,0,0,0,141,14,127,54,87,46,10.3679562045177,11.5684642345609,0.327052507300803,29
"13918","MT","Tangará da Serra",105711,31823.37,51013,"Tangará da Serra",5,"Centro-oeste",1,"510795",3,125,20,105,55,70,2,1,1,0,2,127,21,106,55,72,56,10.3679562045177,11.5684642345609,0.402300575969471,31
"13919","MT","Tangará da Serra",105711,31823.37,51013,"Tangará da Serra",5,"Centro-oeste",1,"510795",4,122,15,107,42,80,0,0,0,0,0,122,15,107,42,80,44,10.3679562045177,11.5684642345609,0.442497527223587,30
"13920","MT","Tangará da Serra",105711,31823.37,51013,"Tangará da Serra",5,"Centro-oeste",1,"510795",5,142,23,119,53,89,2,1,1,0,2,144,24,120,53,91,35,10.3679562045177,11.5684642345609,0.420225739820747,31
"13921","MT","Tapurah",14046,67010.9,51006,"Alto Teles Pires",5,"Centro-oeste",0,"510800",2,16,5,11,9,7,0,0,0,0,0,16,5,11,9,7,2,11.1126105717082,9.55009293671897,0.356555189973624,29
"13922","MT","Tapurah",14046,67010.9,51006,"Alto Teles Pires",5,"Centro-oeste",0,"510800",3,15,2,13,6,9,1,1,0,0,1,16,3,13,6,10,2,11.1126105717082,9.55009293671897,0.406983095635024,31
"13923","MT","Tapurah",14046,67010.9,51006,"Alto Teles Pires",5,"Centro-oeste",0,"510800",4,16,3,13,6,10,0,0,0,0,0,16,3,13,6,10,8,11.1126105717082,9.55009293671897,0.429805700051671,30
"13924","MT","Tapurah",14046,67010.9,51006,"Alto Teles Pires",5,"Centro-oeste",0,"510800",5,10,3,7,6,4,0,0,0,0,0,10,3,7,6,4,4,11.1126105717082,9.55009293671897,0.417122759310057,31
"13925","MT","Várzea Grande",287526,28311.9,51017,"Cuiabá",5,"Centro-oeste",1,"510840",2,350,55,295,150,200,2,1,1,0,2,352,56,296,150,202,127,10.2510374899479,12.5690685699132,0.290519919917332,29
"13926","MT","Várzea Grande",287526,28311.9,51017,"Cuiabá",5,"Centro-oeste",1,"510840",3,342,45,297,157,185,5,0,5,1,4,347,45,302,158,189,151,10.2510374899479,12.5690685699132,0.381165150976322,31
"13927","MT","Várzea Grande",287526,28311.9,51017,"Cuiabá",5,"Centro-oeste",1,"510840",4,386,48,338,174,212,6,2,4,1,5,392,50,342,175,217,126,10.2510374899479,12.5690685699132,0.416843885092645,30
"13928","MT","Várzea Grande",287526,28311.9,51017,"Cuiabá",5,"Centro-oeste",1,"510840",5,323,41,282,124,199,2,0,2,0,2,325,41,284,124,201,130,10.2510374899479,12.5690685699132,0.378079500171763,31
"13929","MT","Vila Rica",26496,19897.29,51009,"Norte Araguaia",5,"Centro-oeste",0,"510860",2,25,6,19,16,9,0,0,0,0,0,25,6,19,16,9,7,9.8983388205346,10.184749057185,0.33058697658187,29
"13930","MT","Vila Rica",26496,19897.29,51009,"Norte Araguaia",5,"Centro-oeste",0,"510860",3,27,6,21,14,13,0,0,0,0,0,27,6,21,14,13,4,9.8983388205346,10.184749057185,0.400770537269871,31
"13931","MT","Vila Rica",26496,19897.29,51009,"Norte Araguaia",5,"Centro-oeste",0,"510860",4,25,5,20,7,18,0,0,0,0,0,25,5,20,7,18,6,9.8983388205346,10.184749057185,0.384069251700061,30
"13932","MT","Vila Rica",26496,19897.29,51009,"Norte Araguaia",5,"Centro-oeste",0,"510860",5,20,7,13,7,13,0,0,0,0,0,20,7,13,7,13,10,9.8983388205346,10.184749057185,0.386516238346776,31
"13933","GO","Abadia de Goiás",8958,26505.89,52010,"Goiânia",5,"Centro-oeste",1,"520005",2,13,2,11,6,7,0,0,0,0,0,13,2,11,6,7,8,10.1851222514282,9.10030226676725,0.300471957362297,29
"13934","GO","Abadia de Goiás",8958,26505.89,52010,"Goiânia",5,"Centro-oeste",1,"520005",3,20,7,13,9,11,0,0,0,0,0,20,7,13,9,11,6,10.1851222514282,9.10030226676725,0.371665002368743,31
"13935","GO","Abadia de Goiás",8958,26505.89,52010,"Goiânia",5,"Centro-oeste",1,"520005",4,17,1,16,8,9,0,0,0,0,0,17,1,16,8,9,5,10.1851222514282,9.10030226676725,0.401782587580831,30
"13936","GO","Abadia de Goiás",8958,26505.89,52010,"Goiânia",5,"Centro-oeste",1,"520005",5,11,2,9,5,6,0,0,0,0,0,11,2,9,5,6,6,10.1851222514282,9.10030226676725,0.363728187754741,31
"13937","GO","Abadiânia",20461,16132.95,52012,"Entorno de Brasília",5,"Centro-oeste",0,"520010",2,13,3,10,4,9,0,0,0,0,0,13,3,10,4,9,8,9.68861904342375,9.92627591416656,0.316303535485691,29
"13938","GO","Abadiânia",20461,16132.95,52012,"Entorno de Brasília",5,"Centro-oeste",0,"520010",3,12,1,11,5,7,0,0,0,0,0,12,1,11,5,7,9,9.68861904342375,9.92627591416656,0.386849006779945,31
"13939","GO","Abadiânia",20461,16132.95,52012,"Entorno de Brasília",5,"Centro-oeste",0,"520010",4,12,3,9,7,5,1,0,1,0,1,13,3,10,7,6,6,9.68861904342375,9.92627591416656,0.422321449741029,30
"13940","GO","Abadiânia",20461,16132.95,52012,"Entorno de Brasília",5,"Centro-oeste",0,"520010",5,21,5,16,8,13,1,1,0,0,1,22,6,16,8,14,8,9.68861904342375,9.92627591416656,0.39345787687266,31
"13941","GO","Acreúna",22546,30271.32,52014,"Vale do Rio dos Bois",5,"Centro-oeste",1,"520013",2,19,4,15,7,12,0,0,0,0,0,19,4,15,7,12,6,10.3179560085972,10.0233129456045,0.289238497528312,29
"13942","GO","Acreúna",22546,30271.32,52014,"Vale do Rio dos Bois",5,"Centro-oeste",1,"520013",3,22,3,19,9,13,0,0,0,0,0,22,3,19,9,13,15,10.3179560085972,10.0233129456045,0.35596832928503,31
"13943","GO","Acreúna",22546,30271.32,52014,"Vale do Rio dos Bois",5,"Centro-oeste",1,"520013",4,19,3,16,8,11,1,0,1,0,1,20,3,17,8,12,13,10.3179560085972,10.0233129456045,0.375963646818588,30
"13944","GO","Acreúna",22546,30271.32,52014,"Vale do Rio dos Bois",5,"Centro-oeste",1,"520013",5,22,6,16,9,13,0,0,0,0,0,22,6,16,9,13,13,10.3179560085972,10.0233129456045,0.364031173249646,31
"13945","GO","Água Fria de Goiás",5793,45025.66,52012,"Entorno de Brasília",5,"Centro-oeste",0,"520017",2,4,0,4,1,3,0,0,0,0,0,4,0,4,1,3,0,10.7149878284598,8.66440557109662,0.288052201101418,29
"13946","GO","Água Fria de Goiás",5793,45025.66,52012,"Entorno de Brasília",5,"Centro-oeste",0,"520017",3,4,0,4,2,2,0,0,0,0,0,4,0,4,2,2,4,10.7149878284598,8.66440557109662,0.363134157478749,31
"13947","GO","Água Fria de Goiás",5793,45025.66,52012,"Entorno de Brasília",5,"Centro-oeste",0,"520017",4,2,1,1,1,1,0,0,0,0,0,2,1,1,1,1,6,10.7149878284598,8.66440557109662,0.367388239255932,30
"13948","GO","Água Fria de Goiás",5793,45025.66,52012,"Entorno de Brasília",5,"Centro-oeste",0,"520017",5,6,5,1,1,5,0,0,0,0,0,6,5,1,1,5,2,10.7149878284598,8.66440557109662,0.408649990664988,31
"13949","GO","Águas Lindas de Goiás",217698,9100.34,52012,"Entorno de Brasília",5,"Centro-oeste",1,"520025",2,212,60,152,79,133,4,0,4,2,2,216,60,156,81,135,63,9.11606705444434,12.2908640602259,0.299096885321428,29
"13950","GO","Águas Lindas de Goiás",217698,9100.34,52012,"Entorno de Brasília",5,"Centro-oeste",1,"520025",3,238,69,169,111,127,0,0,0,0,0,238,69,169,111,127,58,9.11606705444434,12.2908640602259,0.394706915672016,31
"13951","GO","Águas Lindas de Goiás",217698,9100.34,52012,"Entorno de Brasília",5,"Centro-oeste",1,"520025",4,194,57,137,91,103,3,1,2,1,2,197,58,139,92,105,61,9.11606705444434,12.2908640602259,0.427508986784086,30
"13952","GO","Águas Lindas de Goiás",217698,9100.34,52012,"Entorno de Brasília",5,"Centro-oeste",1,"520025",5,211,71,140,99,112,3,2,1,1,2,214,73,141,100,114,69,9.11606705444434,12.2908640602259,0.391754856348805,31
"13953","GO","Alexânia",28010,29731.85,52012,"Entorno de Brasília",5,"Centro-oeste",0,"520030",2,23,4,19,9,14,0,0,0,0,0,23,4,19,9,14,19,10.2999741407632,10.2403168682542,0.291284531762514,29
"13954","GO","Alexânia",28010,29731.85,52012,"Entorno de Brasília",5,"Centro-oeste",0,"520030",3,26,8,18,12,14,0,0,0,0,0,26,8,18,12,14,16,10.2999741407632,10.2403168682542,0.378651125235696,31
"13955","GO","Alexânia",28010,29731.85,52012,"Entorno de Brasília",5,"Centro-oeste",0,"520030",4,33,7,26,16,17,1,0,1,1,0,34,7,27,17,17,13,10.2999741407632,10.2403168682542,0.398261238575514,30
"13956","GO","Alexânia",28010,29731.85,52012,"Entorno de Brasília",5,"Centro-oeste",0,"520030",5,31,12,19,14,17,1,0,1,1,0,32,12,20,15,17,21,10.2999741407632,10.2403168682542,0.3631911359031,31
"13957","GO","Alto Horizonte",6605,146833.35,52004,"Porangatu",5,"Centro-oeste",0,"520055",2,6,1,5,2,4,0,0,0,0,0,6,1,5,2,4,6,11.8970535491976,8.79558221695643,0.285674316849146,29
"13958","GO","Alto Horizonte",6605,146833.35,52004,"Porangatu",5,"Centro-oeste",0,"520055",3,9,3,6,6,3,0,0,0,0,0,9,3,6,6,3,4,11.8970535491976,8.79558221695643,0.364765473871583,31
"13959","GO","Alto Horizonte",6605,146833.35,52004,"Porangatu",5,"Centro-oeste",0,"520055",4,10,1,9,3,7,0,0,0,0,0,10,1,9,3,7,2,11.8970535491976,8.79558221695643,0.378168713376317,30
"13960","GO","Alto Horizonte",6605,146833.35,52004,"Porangatu",5,"Centro-oeste",0,"520055",5,5,1,4,2,3,0,0,0,0,0,5,1,4,2,3,3,11.8970535491976,8.79558221695643,0.34975703020912,31
"13961","GO","Alto Paraíso de Goiás",7688,22173.34,52005,"Chapada dos Veadeiros",5,"Centro-oeste",0,"520060",2,13,7,6,4,9,0,0,0,0,0,13,7,6,4,9,5,10.0066459453002,8.94741595065013,0.256230524750399,29
"13962","GO","Alto Paraíso de Goiás",7688,22173.34,52005,"Chapada dos Veadeiros",5,"Centro-oeste",0,"520060",3,8,2,6,3,5,0,0,0,0,0,8,2,6,3,5,5,10.0066459453002,8.94741595065013,0.369516915599996,31
"13963","GO","Alto Paraíso de Goiás",7688,22173.34,52005,"Chapada dos Veadeiros",5,"Centro-oeste",0,"520060",4,7,1,6,2,5,0,0,0,0,0,7,1,6,2,5,1,10.0066459453002,8.94741595065013,0.414459902679556,30
"13964","GO","Alto Paraíso de Goiás",7688,22173.34,52005,"Chapada dos Veadeiros",5,"Centro-oeste",0,"520060",5,14,6,8,5,9,0,0,0,0,0,14,6,8,5,9,2,10.0066459453002,8.94741595065013,0.408804300291777,31
"13965","GO","Alvorada do Norte",8705,14929.92,52011,"Vão do Paranã",5,"Centro-oeste",1,"520080",2,16,4,12,7,9,0,0,0,0,0,16,4,12,7,9,3,9.61112253217997,9.07165285220229,0.274147126464657,29
"13966","GO","Alvorada do Norte",8705,14929.92,52011,"Vão do Paranã",5,"Centro-oeste",1,"520080",3,12,4,8,5,7,0,0,0,0,0,12,4,8,5,7,4,9.61112253217997,9.07165285220229,0.338182022763843,31
"13967","GO","Alvorada do Norte",8705,14929.92,52011,"Vão do Paranã",5,"Centro-oeste",1,"520080",4,6,2,4,1,5,0,0,0,0,0,6,2,4,1,5,3,9.61112253217997,9.07165285220229,0.394600769936849,30
"13968","GO","Alvorada do Norte",8705,14929.92,52011,"Vão do Paranã",5,"Centro-oeste",1,"520080",5,15,3,12,7,8,0,0,0,0,0,15,3,12,7,8,5,9.61112253217997,9.07165285220229,0.352529284400281,31
"13969","GO","Americano do Brasil",6164,11153.21,52009,"Anicuns",5,"Centro-oeste",0,"520085",2,14,4,10,8,6,0,0,0,0,0,14,4,10,8,6,7,9.31948262783189,8.72648119644001,0.335961609886042,29
"13970","GO","Americano do Brasil",6164,11153.21,52009,"Anicuns",5,"Centro-oeste",0,"520085",3,8,3,5,5,3,0,0,0,0,0,8,3,5,5,3,2,9.31948262783189,8.72648119644001,0.402545168671006,31
"13971","GO","Americano do Brasil",6164,11153.21,52009,"Anicuns",5,"Centro-oeste",0,"520085",4,2,1,1,2,0,0,0,0,0,0,2,1,1,2,0,2,9.31948262783189,8.72648119644001,0.439667996987643,30
"13972","GO","Americano do Brasil",6164,11153.21,52009,"Anicuns",5,"Centro-oeste",0,"520085",5,6,1,5,3,3,0,0,0,0,0,6,1,5,3,3,3,9.31948262783189,8.72648119644001,0.411043102647073,31
"13973","GO","Anápolis",391772,37277.1,52007,"Anápolis",5,"Centro-oeste",1,"520110",2,412,48,364,151,261,6,2,4,2,4,418,50,368,153,265,189,10.5261344760742,12.8784353169056,0.296101683886818,29
"13974","GO","Anápolis",391772,37277.1,52007,"Anápolis",5,"Centro-oeste",1,"520110",3,361,63,298,119,242,1,0,1,0,1,362,63,299,119,243,230,10.5261344760742,12.8784353169056,0.390219889572788,31
"13975","GO","Anápolis",391772,37277.1,52007,"Anápolis",5,"Centro-oeste",1,"520110",4,443,61,382,158,285,8,5,3,6,2,451,66,385,164,287,169,10.5261344760742,12.8784353169056,0.425021668472244,30
"13976","GO","Anápolis",391772,37277.1,52007,"Anápolis",5,"Centro-oeste",1,"520110",5,502,66,436,189,313,1,0,1,0,1,503,66,437,189,314,204,10.5261344760742,12.8784353169056,0.374928152278274,31
"13977","GO","Anicuns",21981,17820.94,52009,"Anicuns",5,"Centro-oeste",0,"520130",2,9,2,7,7,2,0,0,0,0,0,9,2,7,7,2,16,9.788129449353,9.99793372282807,0.291286890257889,29
"13978","GO","Anicuns",21981,17820.94,52009,"Anicuns",5,"Centro-oeste",0,"520130",3,8,2,6,2,6,0,0,0,0,0,8,2,6,2,6,6,9.788129449353,9.99793372282807,0.374485420748635,31
"13979","GO","Anicuns",21981,17820.94,52009,"Anicuns",5,"Centro-oeste",0,"520130",4,14,2,12,5,9,0,0,0,0,0,14,2,12,5,9,5,9.788129449353,9.99793372282807,0.390782920642618,30
"13980","GO","Anicuns",21981,17820.94,52009,"Anicuns",5,"Centro-oeste",0,"520130",5,14,1,13,3,11,0,0,0,0,0,14,1,13,3,11,8,9.788129449353,9.99793372282807,0.356240761279865,31
"13981","GO","Aparecida de Goiânia",590146,23439.72,52010,"Goiânia",5,"Centro-oeste",1,"520140",2,539,103,436,197,342,4,1,3,1,3,543,104,439,198,345,230,10.0621872982271,13.2881252428964,0.284661671567633,29
"13982","GO","Aparecida de Goiânia",590146,23439.72,52010,"Goiânia",5,"Centro-oeste",1,"520140",3,540,103,437,217,323,3,3,0,0,3,543,106,437,217,326,229,10.0621872982271,13.2881252428964,0.387252897695556,31
"13983","GO","Aparecida de Goiânia",590146,23439.72,52010,"Goiânia",5,"Centro-oeste",1,"520140",4,530,103,427,211,319,7,1,6,2,5,537,104,433,213,324,222,10.0621872982271,13.2881252428964,0.428897200506932,30
"13984","GO","Aparecida de Goiânia",590146,23439.72,52010,"Goiânia",5,"Centro-oeste",1,"520140",5,622,120,502,217,405,5,1,4,1,4,627,121,506,218,409,220,10.0621872982271,13.2881252428964,0.378387751460422,31
"13985","GO","Araçu",3486,15008.13,52007,"Anápolis",5,"Centro-oeste",0,"520160",2,3,0,3,0,3,1,0,1,1,0,4,0,4,1,3,1,9.6163473332554,8.15651022607997,0.284769324760993,29
"13986","GO","Araçu",3486,15008.13,52007,"Anápolis",5,"Centro-oeste",0,"520160",3,3,0,3,1,2,0,0,0,0,0,3,0,3,1,2,4,9.6163473332554,8.15651022607997,0.359678450785249,31
"13987","GO","Araçu",3486,15008.13,52007,"Anápolis",5,"Centro-oeste",0,"520160",4,0,0,0,0,0,0,0,0,0,0,0,0,0,0,0,5,9.6163473332554,8.15651022607997,0.379887422839465,30
"13988","GO","Araçu",3486,15008.13,52007,"Anápolis",5,"Centro-oeste",0,"520160",5,0,0,0,0,0,0,0,0,0,0,0,0,0,0,0,3,9.6163473332554,8.15651022607997,0.357922854778389,31
"13989","GO","Aragarças",20273,12266.97,52003,"Aragarças",5,"Centro-oeste",1,"520170",2,17,1,16,8,9,0,0,0,0,0,17,1,16,8,9,6,9.41466556344404,9.91704523046819,0.291196683894512,29
"13990","GO","Aragarças",20273,12266.97,52003,"Aragarças",5,"Centro-oeste",1,"520170",3,17,4,13,5,12,0,0,0,0,0,17,4,13,5,12,4,9.41466556344404,9.91704523046819,0.39604659342465,31
"13991","GO","Aragarças",20273,12266.97,52003,"Aragarças",5,"Centro-oeste",1,"520170",4,10,3,7,4,6,0,0,0,0,0,10,3,7,4,6,8,9.41466556344404,9.91704523046819,0.419407761428823,30
"13992","GO","Aragarças",20273,12266.97,52003,"Aragarças",5,"Centro-oeste",1,"520170",5,17,3,14,11,6,0,0,0,0,0,17,3,14,11,6,12,9.41466556344404,9.91704523046819,0.406425729926239,31
"13993","GO","Aragoiânia",10496,10709.31,52010,"Goiânia",5,"Centro-oeste",1,"520180",2,12,3,9,4,8,1,0,1,0,1,13,3,10,4,9,6,9.27886873559606,9.25874951118387,0.299586577356873,29
"13994","GO","Aragoiânia",10496,10709.31,52010,"Goiânia",5,"Centro-oeste",1,"520180",3,12,4,8,6,6,0,0,0,0,0,12,4,8,6,6,4,9.27886873559606,9.25874951118387,0.388008084415237,31
"13995","GO","Aragoiânia",10496,10709.31,52010,"Goiânia",5,"Centro-oeste",1,"520180",4,11,4,7,8,3,0,0,0,0,0,11,4,7,8,3,4,9.27886873559606,9.25874951118387,0.398992633947349,30
"13996","GO","Aragoiânia",10496,10709.31,52010,"Goiânia",5,"Centro-oeste",1,"520180",5,14,6,8,9,5,0,0,0,0,0,14,6,8,9,5,7,9.27886873559606,9.25874951118387,0.373624165546828,31
"13997","GO","Araguapaz",7783,15545.86,52002,"Rio Vermelho",5,"Centro-oeste",0,"520215",2,4,1,3,2,2,0,0,0,0,0,4,1,3,2,2,2,9.65154964421765,8.95969714695939,0.29285825629729,29
"13998","GO","Araguapaz",7783,15545.86,52002,"Rio Vermelho",5,"Centro-oeste",0,"520215",3,7,2,5,4,3,1,0,1,1,0,8,2,6,5,3,9,9.65154964421765,8.95969714695939,0.40521722308493,31
"13999","GO","Araguapaz",7783,15545.86,52002,"Rio Vermelho",5,"Centro-oeste",0,"520215",4,1,0,1,0,1,0,0,0,0,0,1,0,1,0,1,5,9.65154964421765,8.95969714695939,0.397338573585393,30
"14000","GO","Araguapaz",7783,15545.86,52002,"Rio Vermelho",5,"Centro-oeste",0,"520215",5,3,1,2,2,1,0,0,0,0,0,3,1,2,2,1,7,9.65154964421765,8.95969714695939,0.401167550074766,31
"14001","GO","Aruanã",10110,22990.62,52002,"Rio Vermelho",5,"Centro-oeste",0,"520250",2,7,3,4,5,2,0,0,0,0,0,7,3,4,5,2,8,10.0428415856407,9.22128031201452,0.282819418925087,29
"14002","GO","Aruanã",10110,22990.62,52002,"Rio Vermelho",5,"Centro-oeste",0,"520250",3,7,0,7,4,3,0,0,0,0,0,7,0,7,4,3,6,10.0428415856407,9.22128031201452,0.375922534896099,31
"14003","GO","Aruanã",10110,22990.62,52002,"Rio Vermelho",5,"Centro-oeste",0,"520250",4,8,3,5,3,5,0,0,0,0,0,8,3,5,3,5,6,10.0428415856407,9.22128031201452,0.408936266264596,30
"14004","GO","Aruanã",10110,22990.62,52002,"Rio Vermelho",5,"Centro-oeste",0,"520250",5,6,4,2,0,6,0,0,0,0,0,6,4,2,0,6,8,10.0428415856407,9.22128031201452,0.373172878508746,31
"14005","GO","Barro Alto",11408,84166.32,52006,"Ceres",5,"Centro-oeste",0,"520320",2,10,0,10,2,8,2,0,2,0,2,12,0,12,2,10,3,11.3405501202091,9.34207014265408,0.312744520465915,29
"14006","GO","Barro Alto",11408,84166.32,52006,"Ceres",5,"Centro-oeste",0,"520320",3,8,1,7,5,3,0,0,0,0,0,8,1,7,5,3,4,11.3405501202091,9.34207014265408,0.377806573603145,31
"14007","GO","Barro Alto",11408,84166.32,52006,"Ceres",5,"Centro-oeste",0,"520320",4,11,3,8,3,8,0,0,0,0,0,11,3,8,3,8,3,11.3405501202091,9.34207014265408,0.400476892961715,30
"14008","GO","Barro Alto",11408,84166.32,52006,"Ceres",5,"Centro-oeste",0,"520320",5,15,4,11,7,8,0,0,0,0,0,15,4,11,7,8,2,11.3405501202091,9.34207014265408,0.393313183299983,31
"14009","GO","Bela Vista de Goiás",30492,32975.87,52010,"Goiânia",5,"Centro-oeste",0,"520330",2,28,7,21,8,20,1,0,1,0,1,29,7,22,8,21,14,10.4035313608614,10.3252196331082,0.291669481250958,29
"14010","GO","Bela Vista de Goiás",30492,32975.87,52010,"Goiânia",5,"Centro-oeste",0,"520330",3,33,4,29,8,25,0,0,0,0,0,33,4,29,8,25,23,10.4035313608614,10.3252196331082,0.369899621238516,31
"14011","GO","Bela Vista de Goiás",30492,32975.87,52010,"Goiânia",5,"Centro-oeste",0,"520330",4,33,12,21,14,19,0,0,0,0,0,33,12,21,14,19,13,10.4035313608614,10.3252196331082,0.398815006056451,30
"14012","GO","Bela Vista de Goiás",30492,32975.87,52010,"Goiânia",5,"Centro-oeste",0,"520330",5,33,8,25,12,21,0,0,0,0,0,33,8,25,12,21,20,10.4035313608614,10.3252196331082,0.377297119527248,31
"14013","GO","Bom Jesus de Goiás",25648,30150.18,52015,"Meia Ponte",5,"Centro-oeste",1,"520350",2,14,4,10,8,6,0,0,0,0,0,14,4,10,8,6,11,10.3139461722868,10.1522208748493,0.326797523181809,29
"14014","GO","Bom Jesus de Goiás",25648,30150.18,52015,"Meia Ponte",5,"Centro-oeste",1,"520350",3,19,6,13,9,10,0,0,0,0,0,19,6,13,9,10,10,10.3139461722868,10.1522208748493,0.390380170916598,31
"14015","GO","Bom Jesus de Goiás",25648,30150.18,52015,"Meia Ponte",5,"Centro-oeste",1,"520350",4,23,6,17,11,12,0,0,0,0,0,23,6,17,11,12,13,10.3139461722868,10.1522208748493,0.401023328207095,30
"14016","GO","Bom Jesus de Goiás",25648,30150.18,52015,"Meia Ponte",5,"Centro-oeste",1,"520350",5,16,4,12,10,6,0,0,0,0,0,16,4,12,10,6,18,10.3139461722868,10.1522208748493,0.386285669060035,31
"14017","GO","Bonfinópolis",9919,9177.64,52010,"Goiânia",5,"Centro-oeste",1,"520355",2,3,1,2,1,2,0,0,0,0,0,3,1,2,1,2,4,9.12452536995363,9.20220738874599,0.290337355226521,29
"14018","GO","Bonfinópolis",9919,9177.64,52010,"Goiânia",5,"Centro-oeste",1,"520355",3,10,3,7,6,4,0,0,0,0,0,10,3,7,6,4,8,9.12452536995363,9.20220738874599,0.376968056036271,31
"14019","GO","Bonfinópolis",9919,9177.64,52010,"Goiânia",5,"Centro-oeste",1,"520355",4,9,2,7,6,3,0,0,0,0,0,9,2,7,6,3,9,9.12452536995363,9.20220738874599,0.395665059645766,30
"14020","GO","Bonfinópolis",9919,9177.64,52010,"Goiânia",5,"Centro-oeste",1,"520355",5,8,1,7,4,4,0,0,0,0,0,8,1,7,4,4,5,9.12452536995363,9.20220738874599,0.374438284457845,31
"14021","GO","Brazabrantes",3746,29765.08,52007,"Anápolis",5,"Centro-oeste",1,"520360",2,6,1,5,0,6,0,0,0,0,0,6,1,5,0,6,1,10.3010911733044,8.22844388300403,0.30302665541024,29
"14022","GO","Brazabrantes",3746,29765.08,52007,"Anápolis",5,"Centro-oeste",1,"520360",3,0,0,0,0,0,0,0,0,0,0,0,0,0,0,0,1,10.3010911733044,8.22844388300403,0.392278067233154,31
"14023","GO","Brazabrantes",3746,29765.08,52007,"Anápolis",5,"Centro-oeste",1,"520360",4,2,1,1,0,2,0,0,0,0,0,2,1,1,0,2,4,10.3010911733044,8.22844388300403,0.418956646413684,30
"14024","GO","Brazabrantes",3746,29765.08,52007,"Anápolis",5,"Centro-oeste",1,"520360",5,3,0,3,1,2,0,0,0,0,0,3,0,3,1,2,4,10.3010911733044,8.22844388300403,0.399464743213616,31
"14025","GO","Britânia",5797,19623.88,52002,"Rio Vermelho",5,"Centro-oeste",0,"520380",2,8,1,7,5,3,0,0,0,0,0,8,1,7,5,3,3,9.88450247095836,8.66509582133973,0.262839042012378,29
"14026","GO","Britânia",5797,19623.88,52002,"Rio Vermelho",5,"Centro-oeste",0,"520380",3,8,0,8,4,4,0,0,0,0,0,8,0,8,4,4,6,9.88450247095836,8.66509582133973,0.349349586873113,31
"14027","GO","Britânia",5797,19623.88,52002,"Rio Vermelho",5,"Centro-oeste",0,"520380",4,7,1,6,5,2,0,0,0,0,0,7,1,6,5,2,2,9.88450247095836,8.66509582133973,0.356275145602541,30
"14028","GO","Britânia",5797,19623.88,52002,"Rio Vermelho",5,"Centro-oeste",0,"520380",5,7,1,6,2,5,0,0,0,0,0,7,1,6,2,5,4,9.88450247095836,8.66509582133973,0.401731798966184,31
"14029","GO","Buriti Alegre",9484,32990.66,52015,"Meia Ponte",5,"Centro-oeste",0,"520390",2,7,1,6,6,1,0,0,0,0,0,7,1,6,6,1,13,10.403979770085,9.1573614471853,0.265867033884706,29
"14030","GO","Buriti Alegre",9484,32990.66,52015,"Meia Ponte",5,"Centro-oeste",0,"520390",3,11,6,5,9,2,1,1,0,0,1,12,7,5,9,3,6,10.403979770085,9.1573614471853,0.339398717592661,31
"14031","GO","Buriti Alegre",9484,32990.66,52015,"Meia Ponte",5,"Centro-oeste",0,"520390",4,10,3,7,4,6,0,0,0,0,0,10,3,7,4,6,8,10.403979770085,9.1573614471853,0.379374755126159,30
"14032","GO","Buriti Alegre",9484,32990.66,52015,"Meia Ponte",5,"Centro-oeste",0,"520390",5,10,1,9,6,4,1,0,1,0,1,11,1,10,6,5,14,10.403979770085,9.1573614471853,0.390161629253757,31
"14033","GO","Cabeceiras",8046,27593.6,52012,"Entorno de Brasília",5,"Centro-oeste",0,"520400",2,9,2,7,3,6,0,0,0,0,0,9,2,7,3,6,2,10.225339140758,8.99293035250973,0.329997225700375,29
"14034","GO","Cabeceiras",8046,27593.6,52012,"Entorno de Brasília",5,"Centro-oeste",0,"520400",3,7,2,5,3,4,0,0,0,0,0,7,2,5,3,4,5,10.225339140758,8.99293035250973,0.383478243403663,31
"14035","GO","Cabeceiras",8046,27593.6,52012,"Entorno de Brasília",5,"Centro-oeste",0,"520400",4,7,1,6,5,2,0,0,0,0,0,7,1,6,5,2,5,10.225339140758,8.99293035250973,0.390985781545814,30
"14036","GO","Cabeceiras",8046,27593.6,52012,"Entorno de Brasília",5,"Centro-oeste",0,"520400",5,5,3,2,2,3,0,0,0,0,0,5,3,2,2,3,3,10.225339140758,8.99293035250973,0.363683780487805,31
"14037","GO","Cachoeira Alta",12666,19218.58,52018,"Quirinópolis",5,"Centro-oeste",0,"520410",2,12,5,7,5,7,0,0,0,0,0,12,5,7,5,7,4,9.86363279842135,9.44667651707638,0.315249669675071,29
"14038","GO","Cachoeira Alta",12666,19218.58,52018,"Quirinópolis",5,"Centro-oeste",0,"520410",3,7,4,3,6,1,0,0,0,0,0,7,4,3,6,1,3,9.86363279842135,9.44667651707638,0.379215142709288,31
"14039","GO","Cachoeira Alta",12666,19218.58,52018,"Quirinópolis",5,"Centro-oeste",0,"520410",4,9,3,6,4,5,0,0,0,0,0,9,3,6,4,5,3,9.86363279842135,9.44667651707638,0.390592459376596,30
"14040","GO","Cachoeira Alta",12666,19218.58,52018,"Quirinópolis",5,"Centro-oeste",0,"520410",5,5,1,4,3,2,0,0,0,0,0,5,1,4,3,2,7,9.86363279842135,9.44667651707638,0.377187864618667,31
"14041","GO","Cachoeira Dourada",8031,110271.88,52015,"Meia Ponte",5,"Centro-oeste",0,"520425",2,5,1,4,3,2,0,0,0,0,0,5,1,4,3,2,3,11.6107042316688,8.99106433218846,0.319193259925855,29
"14042","GO","Cachoeira Dourada",8031,110271.88,52015,"Meia Ponte",5,"Centro-oeste",0,"520425",3,3,1,2,2,1,0,0,0,0,0,3,1,2,2,1,8,11.6107042316688,8.99106433218846,0.408003120291933,31
"14043","GO","Cachoeira Dourada",8031,110271.88,52015,"Meia Ponte",5,"Centro-oeste",0,"520425",4,5,1,4,3,2,0,0,0,0,0,5,1,4,3,2,3,11.6107042316688,8.99106433218846,0.421903182145191,30
"14044","GO","Cachoeira Dourada",8031,110271.88,52015,"Meia Ponte",5,"Centro-oeste",0,"520425",5,11,0,11,4,7,0,0,0,0,0,11,0,11,4,7,4,11.6107042316688,8.99106433218846,0.380413690730568,31
"14045","GO","Caçu",16270,57726.8,52018,"Quirinópolis",5,"Centro-oeste",1,"520430",2,11,1,10,3,8,0,0,0,0,0,11,1,10,3,8,7,10.9634768160666,9.69707820021308,0.301077815125698,29
"14046","GO","Caçu",16270,57726.8,52018,"Quirinópolis",5,"Centro-oeste",1,"520430",3,13,3,10,5,8,0,0,0,0,0,13,3,10,5,8,11,10.9634768160666,9.69707820021308,0.40758931532739,31
"14047","GO","Caçu",16270,57726.8,52018,"Quirinópolis",5,"Centro-oeste",1,"520430",4,12,4,8,6,6,1,0,1,0,1,13,4,9,6,7,3,10.9634768160666,9.69707820021308,0.437568326202922,30
"14048","GO","Caçu",16270,57726.8,52018,"Quirinópolis",5,"Centro-oeste",1,"520430",5,13,5,8,10,3,0,0,0,0,0,13,5,8,10,3,8,10.9634768160666,9.69707820021308,0.397362775782744,31
"14049","GO","Caiapônia",19107,35926.99,52013,"Sudoeste de Goiás",5,"Centro-oeste",0,"520440",2,10,0,10,7,3,0,0,0,0,0,10,0,10,7,3,9,10.4892441025933,9.85781003903948,0.288365579023995,29
"14050","GO","Caiapônia",19107,35926.99,52013,"Sudoeste de Goiás",5,"Centro-oeste",0,"520440",3,16,3,13,7,9,0,0,0,0,0,16,3,13,7,9,7,10.4892441025933,9.85781003903948,0.356053369726067,31
"14051","GO","Caiapônia",19107,35926.99,52013,"Sudoeste de Goiás",5,"Centro-oeste",0,"520440",4,11,1,10,2,9,0,0,0,0,0,11,1,10,2,9,7,10.4892441025933,9.85781003903948,0.346037816966745,30
"14052","GO","Caiapônia",19107,35926.99,52013,"Sudoeste de Goiás",5,"Centro-oeste",0,"520440",5,16,2,14,8,8,0,0,0,0,0,16,2,14,8,8,9,10.4892441025933,9.85781003903948,0.379514105786145,31
"14053","GO","Caldas Novas",93196,28676.21,52015,"Meia Ponte",5,"Centro-oeste",1,"520450",2,78,10,68,32,46,1,1,0,0,1,79,11,68,32,47,35,10.263823138143,11.4424600812977,0.293788061984972,29
"14054","GO","Caldas Novas",93196,28676.21,52015,"Meia Ponte",5,"Centro-oeste",1,"520450",3,91,23,68,38,53,0,0,0,0,0,91,23,68,38,53,35,10.263823138143,11.4424600812977,0.414794387714924,31
"14055","GO","Caldas Novas",93196,28676.21,52015,"Meia Ponte",5,"Centro-oeste",1,"520450",4,99,26,73,41,58,0,0,0,0,0,99,26,73,41,58,45,10.263823138143,11.4424600812977,0.466742183485752,30
"14056","GO","Caldas Novas",93196,28676.21,52015,"Meia Ponte",5,"Centro-oeste",1,"520450",5,107,29,78,37,70,0,0,0,0,0,107,29,78,37,70,37,10.263823138143,11.4424600812977,0.4190164488968,31
"14057","GO","Caldazinha",3848,13477.44,52010,"Goiânia",5,"Centro-oeste",1,"520455",2,7,0,7,3,4,0,0,0,0,0,7,0,7,3,4,1,9.5087724554517,8.2553088117856,0.273998398835127,29
"14058","GO","Caldazinha",3848,13477.44,52010,"Goiânia",5,"Centro-oeste",1,"520455",3,1,0,1,0,1,0,0,0,0,0,1,0,1,0,1,3,9.5087724554517,8.2553088117856,0.349829106368925,31
"14059","GO","Caldazinha",3848,13477.44,52010,"Goiânia",5,"Centro-oeste",1,"520455",4,2,0,2,1,1,0,0,0,0,0,2,0,2,1,1,2,9.5087724554517,8.2553088117856,0.347601212477092,30
"14060","GO","Caldazinha",3848,13477.44,52010,"Goiânia",5,"Centro-oeste",1,"520455",5,1,0,1,0,1,0,0,0,0,0,1,0,1,0,1,1,9.5087724554517,8.2553088117856,0.37339714760707,31
"14061","GO","Campestre de Goiás",3649,16034.83,52014,"Vale do Rio dos Bois",5,"Centro-oeste",0,"520460",2,7,1,6,3,4,0,0,0,0,0,7,1,6,3,4,4,9.68251851026251,8.20220843643645,0.328427352479053,29
"14062","GO","Campestre de Goiás",3649,16034.83,52014,"Vale do Rio dos Bois",5,"Centro-oeste",0,"520460",3,5,3,2,4,1,0,0,0,0,0,5,3,2,4,1,1,9.68251851026251,8.20220843643645,0.440245517606394,31
"14063","GO","Campestre de Goiás",3649,16034.83,52014,"Vale do Rio dos Bois",5,"Centro-oeste",0,"520460",4,3,1,2,1,2,0,0,0,0,0,3,1,2,1,2,0,9.68251851026251,8.20220843643645,0.480195224678661,30
"14064","GO","Campestre de Goiás",3649,16034.83,52014,"Vale do Rio dos Bois",5,"Centro-oeste",0,"520460",5,4,0,4,0,4,0,0,0,0,0,4,0,4,0,4,2,9.68251851026251,8.20220843643645,0.448609251863807,31
"14065","GO","Campinorte",12764,18132.18,52004,"Porangatu",5,"Centro-oeste",0,"520470",2,6,1,5,4,2,0,0,0,0,0,6,1,5,4,2,8,9.80544353921199,9.45438398739813,0.31773004282953,29
"14066","GO","Campinorte",12764,18132.18,52004,"Porangatu",5,"Centro-oeste",0,"520470",3,10,1,9,4,6,0,0,0,0,0,10,1,9,4,6,5,9.80544353921199,9.45438398739813,0.390536093128189,31
"14067","GO","Campinorte",12764,18132.18,52004,"Porangatu",5,"Centro-oeste",0,"520470",4,8,2,6,6,2,0,0,0,0,0,8,2,6,6,2,7,9.80544353921199,9.45438398739813,0.388846796988291,30
"14068","GO","Campinorte",12764,18132.18,52004,"Porangatu",5,"Centro-oeste",0,"520470",5,10,1,9,5,5,0,0,0,0,0,10,1,9,5,5,5,9.80544353921199,9.45438398739813,0.391007196431901,31
"14069","GO","Campo Alegre de Goiás",7738,55469.1,52017,"Catalão",5,"Centro-oeste",0,"520480",2,6,0,6,3,3,0,0,0,0,0,6,0,6,3,3,5,10.9235813879312,8.95389853526046,0.278142908702046,29
"14070","GO","Campo Alegre de Goiás",7738,55469.1,52017,"Catalão",5,"Centro-oeste",0,"520480",3,6,0,6,3,3,0,0,0,0,0,6,0,6,3,3,2,10.9235813879312,8.95389853526046,0.371165158188341,31
"14071","GO","Campo Alegre de Goiás",7738,55469.1,52017,"Catalão",5,"Centro-oeste",0,"520480",4,6,2,4,2,4,0,0,0,0,0,6,2,4,2,4,2,10.9235813879312,8.95389853526046,0.421430797090094,30
"14072","GO","Campo Alegre de Goiás",7738,55469.1,52017,"Catalão",5,"Centro-oeste",0,"520480",5,4,0,4,2,2,0,0,0,0,0,4,0,4,2,2,7,10.9235813879312,8.95389853526046,0.416641643186576,31
"14073","GO","Campo Limpo de Goiás",7940,13282.6,52007,"Anápolis",5,"Centro-oeste",0,"520485",2,9,2,7,4,5,0,0,0,0,0,9,2,7,4,5,5,9.49421018699994,8.97966855424118,0.294466589272726,29
"14074","GO","Campo Limpo de Goiás",7940,13282.6,52007,"Anápolis",5,"Centro-oeste",0,"520485",3,7,0,7,5,2,0,0,0,0,0,7,0,7,5,2,1,9.49421018699994,8.97966855424118,0.37967152725093,31
"14075","GO","Campo Limpo de Goiás",7940,13282.6,52007,"Anápolis",5,"Centro-oeste",0,"520485",4,8,2,6,3,5,0,0,0,0,0,8,2,6,3,5,6,9.49421018699994,8.97966855424118,0.359102747404462,30
"14076","GO","Campo Limpo de Goiás",7940,13282.6,52007,"Anápolis",5,"Centro-oeste",0,"520485",5,9,3,6,6,3,0,0,0,0,0,9,3,6,6,3,3,9.49421018699994,8.97966855424118,0.345156126573389,31
"14077","GO","Campos Belos",20007,13597.96,52005,"Chapada dos Veadeiros",5,"Centro-oeste",1,"520490",2,22,4,18,7,15,0,0,0,0,0,22,4,18,7,15,13,9.51767506047302,9.90383749130042,0.295805190946394,29
"14078","GO","Campos Belos",20007,13597.96,52005,"Chapada dos Veadeiros",5,"Centro-oeste",1,"520490",3,21,2,19,10,11,0,0,0,0,0,21,2,19,10,11,6,9.51767506047302,9.90383749130042,0.372240086080832,31
"14079","GO","Campos Belos",20007,13597.96,52005,"Chapada dos Veadeiros",5,"Centro-oeste",1,"520490",4,23,3,20,7,16,0,0,0,0,0,23,3,20,7,16,9,9.51767506047302,9.90383749130042,0.392060222026421,30
"14080","GO","Campos Belos",20007,13597.96,52005,"Chapada dos Veadeiros",5,"Centro-oeste",1,"520490",5,19,7,12,8,11,0,0,0,0,0,19,7,12,8,11,8,9.51767506047302,9.90383749130042,0.398127710626388,31
"14081","GO","Carmo do Rio Verde",10186,25024.84,52006,"Ceres",5,"Centro-oeste",0,"520500",2,8,0,8,1,7,0,0,0,0,0,8,0,8,1,7,5,10.1276242105566,9.22876950744455,0.32288746467476,29
"14082","GO","Carmo do Rio Verde",10186,25024.84,52006,"Ceres",5,"Centro-oeste",0,"520500",3,5,1,4,3,2,0,0,0,0,0,5,1,4,3,2,3,10.1276242105566,9.22876950744455,0.428563947418882,31
"14083","GO","Carmo do Rio Verde",10186,25024.84,52006,"Ceres",5,"Centro-oeste",0,"520500",4,5,1,4,4,1,0,0,0,0,0,5,1,4,4,1,2,10.1276242105566,9.22876950744455,0.443860161722274,30
"14084","GO","Carmo do Rio Verde",10186,25024.84,52006,"Ceres",5,"Centro-oeste",0,"520500",5,8,1,7,5,3,0,0,0,0,0,8,1,7,5,3,3,10.1276242105566,9.22876950744455,0.392569454819778,31
"14085","GO","Catalão",110983,57291.37,52017,"Catalão",5,"Centro-oeste",1,"520510",2,116,14,102,41,75,1,0,1,0,1,117,14,103,41,76,48,10.9559052805396,11.6171323154122,0.292132782304026,29
"14086","GO","Catalão",110983,57291.37,52017,"Catalão",5,"Centro-oeste",1,"520510",3,112,16,96,44,68,1,0,1,0,1,113,16,97,44,69,49,10.9559052805396,11.6171323154122,0.383973468338637,31
"14087","GO","Catalão",110983,57291.37,52017,"Catalão",5,"Centro-oeste",1,"520510",4,113,21,92,42,71,0,0,0,0,0,113,21,92,42,71,35,10.9559052805396,11.6171323154122,0.421907613850284,30
"14088","GO","Catalão",110983,57291.37,52017,"Catalão",5,"Centro-oeste",1,"520510",5,107,20,87,36,71,0,0,0,0,0,107,20,87,36,71,48,10.9559052805396,11.6171323154122,0.380980684788909,31
"14089","GO","Caturaí",5101,13552.58,52007,"Anápolis",5,"Centro-oeste",0,"520520",2,5,1,4,5,0,0,0,0,0,0,5,1,4,5,0,1,9.514332214087,8.53719187792293,0.290670530871803,29
"14090","GO","Caturaí",5101,13552.58,52007,"Anápolis",5,"Centro-oeste",0,"520520",3,2,2,0,0,2,0,0,0,0,0,2,2,0,0,2,5,9.514332214087,8.53719187792293,0.366147320517134,31
"14091","GO","Caturaí",5101,13552.58,52007,"Anápolis",5,"Centro-oeste",0,"520520",4,7,1,6,2,5,0,0,0,0,0,7,1,6,2,5,4,9.514332214087,8.53719187792293,0.383160649139802,30
"14092","GO","Caturaí",5101,13552.58,52007,"Anápolis",5,"Centro-oeste",0,"520520",5,5,1,4,4,1,0,0,0,0,0,5,1,4,4,1,1,9.514332214087,8.53719187792293,0.365004484516291,31
"14093","GO","Cavalcante",9725,26121.71,52005,"Chapada dos Veadeiros",5,"Centro-oeste",0,"520530",2,14,7,7,9,5,0,0,0,0,0,14,7,7,9,5,4,10.1705220483225,9.18245516848665,0.292638092566046,29
"14094","GO","Cavalcante",9725,26121.71,52005,"Chapada dos Veadeiros",5,"Centro-oeste",0,"520530",3,19,6,13,7,12,0,0,0,0,0,19,6,13,7,12,2,10.1705220483225,9.18245516848665,0.377596493954645,31
"14095","GO","Cavalcante",9725,26121.71,52005,"Chapada dos Veadeiros",5,"Centro-oeste",0,"520530",4,11,3,8,5,6,0,0,0,0,0,11,3,8,5,6,8,10.1705220483225,9.18245516848665,0.400136369429669,30
"14096","GO","Cavalcante",9725,26121.71,52005,"Chapada dos Veadeiros",5,"Centro-oeste",0,"520530",5,7,3,4,4,3,0,0,0,0,0,7,3,4,4,3,7,10.1705220483225,9.18245516848665,0.383483152507739,31
"14097","GO","Ceres",22306,24893.6,52006,"Ceres",5,"Centro-oeste",1,"520540",2,16,0,16,4,12,0,0,0,0,0,16,0,16,4,12,16,10.122366021303,10.0126109795545,0.313150148146767,29
"14098","GO","Ceres",22306,24893.6,52006,"Ceres",5,"Centro-oeste",1,"520540",3,18,2,16,5,13,1,0,1,1,0,19,2,17,6,13,11,10.122366021303,10.0126109795545,0.414551444237173,31
"14099","GO","Ceres",22306,24893.6,52006,"Ceres",5,"Centro-oeste",1,"520540",4,15,2,13,9,6,0,0,0,0,0,15,2,13,9,6,19,10.122366021303,10.0126109795545,0.437990485088377,30
"14100","GO","Ceres",22306,24893.6,52006,"Ceres",5,"Centro-oeste",1,"520540",5,29,4,25,4,25,0,0,0,0,0,29,4,25,4,25,13,10.122366021303,10.0126109795545,0.381297770447035,31
"14101","GO","Cezarina",8703,33748.23,52014,"Vale do Rio dos Bois",5,"Centro-oeste",0,"520545",2,5,1,4,2,3,0,0,0,0,0,5,1,4,2,3,7,10.426683250481,9.07142307278951,0.298574297220473,29
"14102","GO","Cezarina",8703,33748.23,52014,"Vale do Rio dos Bois",5,"Centro-oeste",0,"520545",3,5,2,3,1,4,0,0,0,0,0,5,2,3,1,4,2,10.426683250481,9.07142307278951,0.354777153952617,31
"14103","GO","Cezarina",8703,33748.23,52014,"Vale do Rio dos Bois",5,"Centro-oeste",0,"520545",4,8,2,6,6,2,0,0,0,0,0,8,2,6,6,2,4,10.426683250481,9.07142307278951,0.415276280332551,30
"14104","GO","Cezarina",8703,33748.23,52014,"Vale do Rio dos Bois",5,"Centro-oeste",0,"520545",5,12,1,11,7,5,0,0,0,0,0,12,1,11,7,5,9,10.426683250481,9.07142307278951,0.377012937336255,31
"14105","GO","Chapadão do Céu",10486,112383.68,52013,"Sudoeste de Goiás",5,"Centro-oeste",0,"520547",2,22,8,14,8,14,0,0,0,0,0,22,8,14,8,14,2,11.6296740101703,9.25779631313248,0.2693381514035,29
"14106","GO","Chapadão do Céu",10486,112383.68,52013,"Sudoeste de Goiás",5,"Centro-oeste",0,"520547",3,24,1,23,10,14,0,0,0,0,0,24,1,23,10,14,5,11.6296740101703,9.25779631313248,0.348665970227771,31
"14107","GO","Chapadão do Céu",10486,112383.68,52013,"Sudoeste de Goiás",5,"Centro-oeste",0,"520547",4,19,7,12,5,14,0,0,0,0,0,19,7,12,5,14,4,11.6296740101703,9.25779631313248,0.372990511320148,30
"14108","GO","Chapadão do Céu",10486,112383.68,52013,"Sudoeste de Goiás",5,"Centro-oeste",0,"520547",5,16,2,14,6,10,0,0,0,0,0,16,2,14,6,10,6,11.6296740101703,9.25779631313248,0.354245950481937,31
"14109","GO","Cidade Ocidental",72890,11394.02,52012,"Entorno de Brasília",5,"Centro-oeste",1,"520549",2,91,21,70,33,58,4,1,3,1,3,95,22,73,34,61,24,9.34084393534861,11.1967067343763,0.298448290084108,29
"14110","GO","Cidade Ocidental",72890,11394.02,52012,"Entorno de Brasília",5,"Centro-oeste",1,"520549",3,100,22,78,38,62,1,0,1,1,0,101,22,79,39,62,25,9.34084393534861,11.1967067343763,0.404816700557138,31
"14111","GO","Cidade Ocidental",72890,11394.02,52012,"Entorno de Brasília",5,"Centro-oeste",1,"520549",4,85,22,63,33,52,1,0,1,0,1,86,22,64,33,53,19,9.34084393534861,11.1967067343763,0.451003727748078,30
"14112","GO","Cidade Ocidental",72890,11394.02,52012,"Entorno de Brasília",5,"Centro-oeste",1,"520549",5,94,28,66,34,60,1,0,1,1,0,95,28,67,35,60,31,9.34084393534861,11.1967067343763,0.405507855914964,31
"14113","GO","Cocalzinho de Goiás",20504,16327.17,52012,"Entorno de Brasília",5,"Centro-oeste",0,"520551",2,17,4,13,7,10,1,0,1,0,1,18,4,14,7,11,11,9.70058587027261,9.92837526804391,0.309526660011488,29
"14114","GO","Cocalzinho de Goiás",20504,16327.17,52012,"Entorno de Brasília",5,"Centro-oeste",0,"520551",3,16,3,13,7,9,0,0,0,0,0,16,3,13,7,9,9,9.70058587027261,9.92837526804391,0.390655162277053,31
"14115","GO","Cocalzinho de Goiás",20504,16327.17,52012,"Entorno de Brasília",5,"Centro-oeste",0,"520551",4,16,6,10,8,8,0,0,0,0,0,16,6,10,8,8,6,9.70058587027261,9.92837526804391,0.398082099717874,30
"14116","GO","Cocalzinho de Goiás",20504,16327.17,52012,"Entorno de Brasília",5,"Centro-oeste",0,"520551",5,27,7,20,10,17,1,1,0,0,1,28,8,20,10,18,7,9.70058587027261,9.92837526804391,0.379102611731079,31
"14117","GO","Corumbá de Goiás",11169,15791.45,52012,"Entorno de Brasília",5,"Centro-oeste",0,"520580",2,6,2,4,2,4,0,0,0,0,0,6,2,4,2,4,7,9.66722393330587,9.32089736254083,0.290980139023013,29
"14118","GO","Corumbá de Goiás",11169,15791.45,52012,"Entorno de Brasília",5,"Centro-oeste",0,"520580",3,6,0,6,4,2,0,0,0,0,0,6,0,6,4,2,3,9.66722393330587,9.32089736254083,0.388434216926577,31
"14119","GO","Corumbá de Goiás",11169,15791.45,52012,"Entorno de Brasília",5,"Centro-oeste",0,"520580",4,8,3,5,1,7,0,0,0,0,0,8,3,5,1,7,9,9.66722393330587,9.32089736254083,0.423507581567877,30
"14120","GO","Corumbá de Goiás",11169,15791.45,52012,"Entorno de Brasília",5,"Centro-oeste",0,"520580",5,8,3,5,5,3,0,0,0,0,0,8,3,5,5,3,11,9.66722393330587,9.32089736254083,0.422589799879258,31
"14121","GO","Corumbaíba",9869,61514.71,52017,"Catalão",5,"Centro-oeste",0,"520590",2,8,0,8,1,7,0,0,0,0,0,8,0,8,1,7,6,11.0270316121858,9.19715381017201,0.32509359714806,29
"14122","GO","Corumbaíba",9869,61514.71,52017,"Catalão",5,"Centro-oeste",0,"520590",3,5,0,5,4,1,0,0,0,0,0,5,0,5,4,1,7,11.0270316121858,9.19715381017201,0.39016771160005,31
"14123","GO","Corumbaíba",9869,61514.71,52017,"Catalão",5,"Centro-oeste",0,"520590",4,6,2,4,3,3,0,0,0,0,0,6,2,4,3,3,3,11.0270316121858,9.19715381017201,0.404607984827314,30
"14124","GO","Corumbaíba",9869,61514.71,52017,"Catalão",5,"Centro-oeste",0,"520590",5,9,2,7,4,5,0,0,0,0,0,9,2,7,4,5,8,11.0270316121858,9.19715381017201,0.414564107703722,31
"14125","GO","Cristalina",60210,40300.93,52012,"Entorno de Brasília",5,"Centro-oeste",1,"520620",2,87,27,60,35,52,1,1,0,1,0,88,28,60,36,52,19,10.6041298245916,11.0055937304585,0.311582124304214,29
"14126","GO","Cristalina",60210,40300.93,52012,"Entorno de Brasília",5,"Centro-oeste",1,"520620",3,74,14,60,27,47,1,0,1,1,0,75,14,61,28,47,23,10.6041298245916,11.0055937304585,0.390421799683562,31
"14127","GO","Cristalina",60210,40300.93,52012,"Entorno de Brasília",5,"Centro-oeste",1,"520620",4,66,14,52,35,31,0,0,0,0,0,66,14,52,35,31,25,10.6041298245916,11.0055937304585,0.409397933594234,30
"14128","GO","Cristalina",60210,40300.93,52012,"Entorno de Brasília",5,"Centro-oeste",1,"520620",5,70,27,43,31,39,0,0,0,0,0,70,27,43,31,39,25,10.6041298245916,11.0055937304585,0.404753780251075,31
"14129","GO","Crixás",17044,30961.64,52001,"São Miguel do Araguaia",5,"Centro-oeste",0,"520640",2,17,1,16,5,12,0,0,0,0,0,17,1,16,5,12,6,10.3405042978769,9.7435535146198,0.351994102014361,29
"14130","GO","Crixás",17044,30961.64,52001,"São Miguel do Araguaia",5,"Centro-oeste",0,"520640",3,22,3,19,15,7,0,0,0,0,0,22,3,19,15,7,3,10.3405042978769,9.7435535146198,0.427431898188973,31
"14131","GO","Crixás",17044,30961.64,52001,"São Miguel do Araguaia",5,"Centro-oeste",0,"520640",4,10,0,10,2,8,0,0,0,0,0,10,0,10,2,8,6,10.3405042978769,9.7435535146198,0.44879534031604,30
"14132","GO","Crixás",17044,30961.64,52001,"São Miguel do Araguaia",5,"Centro-oeste",0,"520640",5,20,2,18,9,11,0,0,0,0,0,20,2,18,9,11,11,10.3405042978769,9.7435535146198,0.433201532685825,31
"14133","GO","Cromínia",3472,20076.04,52015,"Meia Ponte",5,"Centro-oeste",0,"520650",2,4,0,4,1,3,0,0,0,0,0,4,0,4,1,3,1,9.90728234320161,8.15248607578024,0.285475582386656,29
"14134","GO","Cromínia",3472,20076.04,52015,"Meia Ponte",5,"Centro-oeste",0,"520650",3,4,1,3,1,3,0,0,0,0,0,4,1,3,1,3,5,9.90728234320161,8.15248607578024,0.361874126430503,31
"14135","GO","Cromínia",3472,20076.04,52015,"Meia Ponte",5,"Centro-oeste",0,"520650",4,0,0,0,0,0,0,0,0,0,0,0,0,0,0,0,1,9.90728234320161,8.15248607578024,0.416602922537652,30
"14136","GO","Cromínia",3472,20076.04,52015,"Meia Ponte",5,"Centro-oeste",0,"520650",5,5,1,4,2,3,1,1,0,1,0,6,2,4,3,3,3,9.90728234320161,8.15248607578024,0.391700943656751,31
"14137","GO","Edéia",12467,68132.84,52014,"Vale do Rio dos Bois",5,"Centro-oeste",0,"520740",2,7,1,6,2,5,0,0,0,0,0,7,1,6,2,5,2,11.1292146079129,9.43084043234498,0.285932465756664,29
"14138","GO","Edéia",12467,68132.84,52014,"Vale do Rio dos Bois",5,"Centro-oeste",0,"520740",3,10,2,8,4,6,0,0,0,0,0,10,2,8,4,6,11,11.1292146079129,9.43084043234498,0.354887744504441,31
"14139","GO","Edéia",12467,68132.84,52014,"Vale do Rio dos Bois",5,"Centro-oeste",0,"520740",4,6,1,5,2,4,0,0,0,0,0,6,1,5,2,4,4,11.1292146079129,9.43084043234498,0.404330180557928,30
"14140","GO","Edéia",12467,68132.84,52014,"Vale do Rio dos Bois",5,"Centro-oeste",0,"520740",5,6,1,5,2,4,0,0,0,0,0,6,1,5,2,4,7,11.1292146079129,9.43084043234498,0.389371312172063,31
"14141","GO","Firminópolis",13449,13368.84,52009,"Anicuns",5,"Centro-oeste",0,"520780",2,7,4,3,4,3,0,0,0,0,0,7,4,3,4,3,6,9.50068190492587,9.50666003282355,0.333454277089538,29
"14142","GO","Firminópolis",13449,13368.84,52009,"Anicuns",5,"Centro-oeste",0,"520780",3,6,1,5,1,5,0,0,0,0,0,6,1,5,1,5,4,9.50068190492587,9.50666003282355,0.416353262739261,31
"14143","GO","Firminópolis",13449,13368.84,52009,"Anicuns",5,"Centro-oeste",0,"520780",4,9,3,6,2,7,0,0,0,0,0,9,3,6,2,7,7,9.50068190492587,9.50666003282355,0.43281216826105,30
"14144","GO","Firminópolis",13449,13368.84,52009,"Anicuns",5,"Centro-oeste",0,"520780",5,11,2,9,5,6,0,0,0,0,0,11,2,9,5,6,5,9.50068190492587,9.50666003282355,0.414110471669975,31
"14145","GO","Formosa",123684,19525.95,52012,"Entorno de Brasília",5,"Centro-oeste",1,"520800",2,112,27,85,44,68,2,1,1,1,1,114,28,86,45,69,42,9.87949962909403,11.7254852048248,0.281580321347927,29
"14146","GO","Formosa",123684,19525.95,52012,"Entorno de Brasília",5,"Centro-oeste",1,"520800",3,108,24,84,59,49,1,0,1,1,0,109,24,85,60,49,60,9.87949962909403,11.7254852048248,0.383415269997071,31
"14147","GO","Formosa",123684,19525.95,52012,"Entorno de Brasília",5,"Centro-oeste",1,"520800",4,135,27,108,57,78,3,2,1,1,2,138,29,109,58,80,46,9.87949962909403,11.7254852048248,0.41430177428897,30
"14148","GO","Formosa",123684,19525.95,52012,"Entorno de Brasília",5,"Centro-oeste",1,"520800",5,141,24,117,58,83,2,1,1,1,1,143,25,118,59,84,53,9.87949962909403,11.7254852048248,0.370551996664614,31
"14149","GO","Goianápolis",11224,18676.56,52010,"Goiânia",5,"Centro-oeste",0,"520840",2,9,1,8,6,3,1,0,1,1,0,10,1,9,7,3,5,9.83502454064878,9.3258096217823,0.298282513428383,29
"14150","GO","Goianápolis",11224,18676.56,52010,"Goiânia",5,"Centro-oeste",0,"520840",3,15,8,7,6,9,0,0,0,0,0,15,8,7,6,9,6,9.83502454064878,9.3258096217823,0.345494250270474,31
"14151","GO","Goianápolis",11224,18676.56,52010,"Goiânia",5,"Centro-oeste",0,"520840",4,14,4,10,5,9,1,0,1,0,1,15,4,11,5,10,13,9.83502454064878,9.3258096217823,0.365496822782791,30
"14152","GO","Goianápolis",11224,18676.56,52010,"Goiânia",5,"Centro-oeste",0,"520840",5,13,3,10,4,9,0,0,0,0,0,13,3,10,4,9,10,9.83502454064878,9.3258096217823,0.335094071482776,31
"14153","GO","Goianésia",71075,20108.61,52006,"Ceres",5,"Centro-oeste",1,"520860",2,79,8,71,29,50,0,0,0,0,0,79,8,71,29,50,35,9.90890336053694,11.1714909365192,0.294691119102279,29
"14154","GO","Goianésia",71075,20108.61,52006,"Ceres",5,"Centro-oeste",1,"520860",3,61,8,53,27,34,1,0,1,0,1,62,8,54,27,35,39,9.90890336053694,11.1714909365192,0.382647934242249,31
"14155","GO","Goianésia",71075,20108.61,52006,"Ceres",5,"Centro-oeste",1,"520860",4,60,9,51,18,42,1,0,1,0,1,61,9,52,18,43,34,9.90890336053694,11.1714909365192,0.419449286697147,30
"14156","GO","Goianésia",71075,20108.61,52006,"Ceres",5,"Centro-oeste",1,"520860",5,83,16,67,28,55,0,0,0,0,0,83,16,67,28,55,44,9.90890336053694,11.1714909365192,0.37087296149595,31
"14157","GO","Goiânia",1536097,33004.01,52010,"Goiânia",5,"Centro-oeste",1,"520870",2,1301,160,1141,378,923,7,3,4,2,5,1308,163,1145,380,928,699,10.4043843482178,14.2447553417375,0.281947864699222,29
"14158","GO","Goiânia",1536097,33004.01,52010,"Goiânia",5,"Centro-oeste",1,"520870",3,1400,188,1212,466,934,14,1,13,5,9,1414,189,1225,471,943,739,10.4043843482178,14.2447553417375,0.395218600302106,31
"14159","GO","Goiânia",1536097,33004.01,52010,"Goiânia",5,"Centro-oeste",1,"520870",4,1348,166,1182,424,924,7,0,7,3,4,1355,166,1189,427,928,692,10.4043843482178,14.2447553417375,0.445249549547573,30
"14160","GO","Goiânia",1536097,33004.01,52010,"Goiânia",5,"Centro-oeste",1,"520870",5,1464,187,1277,428,1036,15,6,9,8,7,1479,193,1286,436,1043,780,10.4043843482178,14.2447553417375,0.391462294067263,31
"14161","GO","Goianira",45296,21705.28,52010,"Goiânia",5,"Centro-oeste",1,"520880",2,77,18,59,38,39,0,0,0,0,0,77,18,59,38,39,16,9.98531082790388,10.7209740073517,0.284677186334581,29
"14162","GO","Goianira",45296,21705.28,52010,"Goiânia",5,"Centro-oeste",1,"520880",3,76,22,54,34,42,0,0,0,0,0,76,22,54,34,42,26,9.98531082790388,10.7209740073517,0.377913179479926,31
"14163","GO","Goianira",45296,21705.28,52010,"Goiânia",5,"Centro-oeste",1,"520880",4,59,16,43,29,30,0,0,0,0,0,59,16,43,29,30,32,9.98531082790388,10.7209740073517,0.406341531434944,30
"14164","GO","Goianira",45296,21705.28,52010,"Goiânia",5,"Centro-oeste",1,"520880",5,86,21,65,28,58,0,0,0,0,0,86,21,65,28,58,24,9.98531082790388,10.7209740073517,0.360200480520717,31
"14165","GO","Goiás",22381,20136.77,52002,"Rio Vermelho",5,"Centro-oeste",0,"520890",2,23,7,16,11,12,0,0,0,0,0,23,7,16,11,12,12,9.91030277605224,10.0159676636201,0.276677708639221,29
"14166","GO","Goiás",22381,20136.77,52002,"Rio Vermelho",5,"Centro-oeste",0,"520890",3,19,2,17,7,12,0,0,0,0,0,19,2,17,7,12,10,9.91030277605224,10.0159676636201,0.381921355316577,31
"14167","GO","Goiás",22381,20136.77,52002,"Rio Vermelho",5,"Centro-oeste",0,"520890",4,11,1,10,5,6,0,0,0,0,0,11,1,10,5,6,16,9.91030277605224,10.0159676636201,0.428151100599549,30
"14168","GO","Goiás",22381,20136.77,52002,"Rio Vermelho",5,"Centro-oeste",0,"520890",5,20,4,16,7,13,0,0,0,0,0,20,4,16,7,13,16,9.91030277605224,10.0159676636201,0.402049894858492,31
"14169","GO","Goiatuba",34202,45434.73,52015,"Meia Ponte",5,"Centro-oeste",1,"520910",2,28,7,21,11,17,2,2,0,0,2,30,9,21,11,19,29,10.7240320695565,10.440039400873,0.329924083051901,29
"14170","GO","Goiatuba",34202,45434.73,52015,"Meia Ponte",5,"Centro-oeste",1,"520910",3,33,8,25,15,18,0,0,0,0,0,33,8,25,15,18,26,10.7240320695565,10.440039400873,0.387936832743334,31
"14171","GO","Goiatuba",34202,45434.73,52015,"Meia Ponte",5,"Centro-oeste",1,"520910",4,33,5,28,15,18,0,0,0,0,0,33,5,28,15,18,23,10.7240320695565,10.440039400873,0.397078096274355,30
"14172","GO","Goiatuba",34202,45434.73,52015,"Meia Ponte",5,"Centro-oeste",1,"520910",5,45,11,34,18,27,1,1,0,1,0,46,12,34,19,27,31,10.7240320695565,10.440039400873,0.371695181830658,31
"14173","GO","Guapó",14207,14365.9,52010,"Goiânia",5,"Centro-oeste",1,"520920",2,15,1,14,9,6,0,0,0,0,0,15,1,14,9,6,3,9.57261262173066,9.56149007987208,0.292927690029231,29
"14174","GO","Guapó",14207,14365.9,52010,"Goiânia",5,"Centro-oeste",1,"520920",3,16,4,12,5,11,0,0,0,0,0,16,4,12,5,11,9,9.57261262173066,9.56149007987208,0.374527578883032,31
"14175","GO","Guapó",14207,14365.9,52010,"Goiânia",5,"Centro-oeste",1,"520920",4,11,1,10,5,6,0,0,0,0,0,11,1,10,5,6,11,9.57261262173066,9.56149007987208,0.390036003258708,30
"14176","GO","Guapó",14207,14365.9,52010,"Goiânia",5,"Centro-oeste",1,"520920",5,13,3,10,5,8,0,0,0,0,0,13,3,10,5,8,9,9.57261262173066,9.56149007987208,0.346729872765524,31
"14177","GO","Heitoraí",3733,15197.1,52007,"Anápolis",5,"Centro-oeste",0,"520960",2,4,1,3,2,2,0,0,0,0,0,4,1,3,2,2,2,9.62885989915806,8.22496747891458,0.314582441660551,29
"14178","GO","Heitoraí",3733,15197.1,52007,"Anápolis",5,"Centro-oeste",0,"520960",3,5,0,5,2,3,0,0,0,0,0,5,0,5,2,3,4,9.62885989915806,8.22496747891458,0.398315920211756,31
"14179","GO","Heitoraí",3733,15197.1,52007,"Anápolis",5,"Centro-oeste",0,"520960",4,4,1,3,1,3,0,0,0,0,0,4,1,3,1,3,2,9.62885989915806,8.22496747891458,0.421909813436926,30
"14180","GO","Heitoraí",3733,15197.1,52007,"Anápolis",5,"Centro-oeste",0,"520960",5,0,0,0,0,0,0,0,0,0,0,0,0,0,0,0,5,9.62885989915806,8.22496747891458,0.404144445084975,31
"14181","GO","Hidrolândia",22124,53846.74,52010,"Goiânia",5,"Centro-oeste",1,"520970",2,17,6,11,5,12,0,0,0,0,0,17,6,11,5,12,9,10.893897142219,10.0044182711146,0.290542777431867,29
"14182","GO","Hidrolândia",22124,53846.74,52010,"Goiânia",5,"Centro-oeste",1,"520970",3,24,6,18,15,9,2,1,1,0,2,26,7,19,15,11,18,10.893897142219,10.0044182711146,0.374228045405657,31
"14183","GO","Hidrolândia",22124,53846.74,52010,"Goiânia",5,"Centro-oeste",1,"520970",4,20,4,16,13,7,0,0,0,0,0,20,4,16,13,7,11,10.893897142219,10.0044182711146,0.419198739574529,30
"14184","GO","Hidrolândia",22124,53846.74,52010,"Goiânia",5,"Centro-oeste",1,"520970",5,30,13,17,16,14,1,1,0,1,0,31,14,17,17,14,12,10.893897142219,10.0044182711146,0.387418036889705,31
"14185","GO","Indiara",15787,20639.49,52014,"Vale do Rio dos Bois",5,"Centro-oeste",1,"520995",2,15,3,12,7,8,0,0,0,0,0,15,3,12,7,8,7,9.93496150998789,9.66694209553173,0.287892521243425,29
"14186","GO","Indiara",15787,20639.49,52014,"Vale do Rio dos Bois",5,"Centro-oeste",1,"520995",3,13,2,11,7,6,0,0,0,0,0,13,2,11,7,6,7,9.93496150998789,9.66694209553173,0.374776859987595,31
"14187","GO","Indiara",15787,20639.49,52014,"Vale do Rio dos Bois",5,"Centro-oeste",1,"520995",4,12,0,12,5,7,1,0,1,1,0,13,0,13,6,7,5,9.93496150998789,9.66694209553173,0.39491825446893,30
"14188","GO","Indiara",15787,20639.49,52014,"Vale do Rio dos Bois",5,"Centro-oeste",1,"520995",5,19,6,13,10,9,0,0,0,0,0,19,6,13,10,9,6,9.93496150998789,9.66694209553173,0.37966114805571,31
"14189","GO","Inhumas",53259,21656.9,52007,"Anápolis",5,"Centro-oeste",1,"521000",2,57,10,47,19,38,0,0,0,0,0,57,10,47,19,38,28,9.9830793893519,10.8829220833749,0.287869625644197,29
"14190","GO","Inhumas",53259,21656.9,52007,"Anápolis",5,"Centro-oeste",1,"521000",3,46,8,38,15,31,0,0,0,0,0,46,8,38,15,31,37,9.9830793893519,10.8829220833749,0.374215148405427,31
"14191","GO","Inhumas",53259,21656.9,52007,"Anápolis",5,"Centro-oeste",1,"521000",4,48,9,39,19,29,0,0,0,0,0,48,9,39,19,29,35,9.9830793893519,10.8829220833749,0.405080356084407,30
"14192","GO","Inhumas",53259,21656.9,52007,"Anápolis",5,"Centro-oeste",1,"521000",5,57,7,50,23,34,1,0,1,1,0,58,7,51,24,34,27,9.9830793893519,10.8829220833749,0.364217110895405,31
"14193","GO","Ipameri",27174,55480.72,52017,"Catalão",5,"Centro-oeste",1,"521010",2,29,7,22,10,19,0,0,0,0,0,29,7,22,10,19,20,10.9237908519942,10.2100159127843,0.311021541233889,29
"14194","GO","Ipameri",27174,55480.72,52017,"Catalão",5,"Centro-oeste",1,"521010",3,22,5,17,8,14,1,0,1,1,0,23,5,18,9,14,15,10.9237908519942,10.2100159127843,0.392890369044244,31
"14195","GO","Ipameri",27174,55480.72,52017,"Catalão",5,"Centro-oeste",1,"521010",4,22,8,14,13,9,0,0,0,0,0,22,8,14,13,9,17,10.9237908519942,10.2100159127843,0.427330933373871,30
"14196","GO","Ipameri",27174,55480.72,52017,"Catalão",5,"Centro-oeste",1,"521010",5,25,10,15,10,15,0,0,0,0,0,25,10,15,10,15,16,10.9237908519942,10.2100159127843,0.405035435586285,31
"14197","GO","Iporá",31499,20853.76,52008,"Iporá",5,"Centro-oeste",1,"521020",2,35,4,31,15,20,2,1,1,0,2,37,5,32,15,22,16,9.94528954669983,10.3577110782781,0.290609454615225,29
"14198","GO","Iporá",31499,20853.76,52008,"Iporá",5,"Centro-oeste",1,"521020",3,22,2,20,5,17,0,0,0,0,0,22,2,20,5,17,18,9.94528954669983,10.3577110782781,0.359666276634159,31
"14199","GO","Iporá",31499,20853.76,52008,"Iporá",5,"Centro-oeste",1,"521020",4,32,2,30,9,23,0,0,0,0,0,32,2,30,9,23,22,9.94528954669983,10.3577110782781,0.372155780914389,30
"14200","GO","Iporá",31499,20853.76,52008,"Iporá",5,"Centro-oeste",1,"521020",5,31,2,29,13,18,0,0,0,0,0,31,2,29,13,18,28,9.94528954669983,10.3577110782781,0.350277871575546,31
"14201","GO","Itaberaí",43622,30570.6,52007,"Anápolis",5,"Centro-oeste",1,"521040",2,39,5,34,16,23,0,0,0,0,0,39,5,34,16,23,15,10.3277940417776,10.6833168892318,0.306311034996555,29
"14202","GO","Itaberaí",43622,30570.6,52007,"Anápolis",5,"Centro-oeste",1,"521040",3,40,9,31,17,23,0,0,0,0,0,40,9,31,17,23,22,10.3277940417776,10.6833168892318,0.373851012149288,31
"14203","GO","Itaberaí",43622,30570.6,52007,"Anápolis",5,"Centro-oeste",1,"521040",4,61,20,41,31,30,1,1,0,0,1,62,21,41,31,31,22,10.3277940417776,10.6833168892318,0.396036780977163,30
"14204","GO","Itaberaí",43622,30570.6,52007,"Anápolis",5,"Centro-oeste",1,"521040",5,38,8,30,16,22,0,0,0,0,0,38,8,30,16,22,34,10.3277940417776,10.6833168892318,0.365415008480549,31
"14205","GO","Itaguari",4685,15083.78,52007,"Anápolis",5,"Centro-oeste",0,"521056",2,5,0,5,2,3,0,0,0,0,0,5,0,5,2,3,3,9.62137527328117,8.45212119467252,0.323974267896302,29
"14206","GO","Itaguari",4685,15083.78,52007,"Anápolis",5,"Centro-oeste",0,"521056",3,4,2,2,4,0,0,0,0,0,0,4,2,2,4,0,5,9.62137527328117,8.45212119467252,0.40269753698789,31
"14207","GO","Itaguari",4685,15083.78,52007,"Anápolis",5,"Centro-oeste",0,"521056",4,3,0,3,2,1,0,0,0,0,0,3,0,3,2,1,1,9.62137527328117,8.45212119467252,0.406759012092421,30
"14208","GO","Itaguari",4685,15083.78,52007,"Anápolis",5,"Centro-oeste",0,"521056",5,2,0,2,0,2,0,0,0,0,0,2,0,2,0,2,3,9.62137527328117,8.45212119467252,0.364098659924136,31
"14209","GO","Itaguaru",5206,14623.89,52007,"Anápolis",5,"Centro-oeste",0,"521060",2,4,0,4,1,3,0,0,0,0,0,4,0,4,1,3,6,9.5904117717838,8.55756708555451,0.299180272146607,29
"14210","GO","Itaguaru",5206,14623.89,52007,"Anápolis",5,"Centro-oeste",0,"521060",3,4,1,3,2,2,0,0,0,0,0,4,1,3,2,2,7,9.5904117717838,8.55756708555451,0.373487134205773,31
"14211","GO","Itaguaru",5206,14623.89,52007,"Anápolis",5,"Centro-oeste",0,"521060",4,3,0,3,2,1,0,0,0,0,0,3,0,3,2,1,7,9.5904117717838,8.55756708555451,0.36261132057937,30
"14212","GO","Itaguaru",5206,14623.89,52007,"Anápolis",5,"Centro-oeste",0,"521060",5,5,0,5,2,3,0,0,0,0,0,5,0,5,2,3,5,9.5904117717838,8.55756708555451,0.34974720317242,31
"14213","GO","Itapaci",23421,15211.06,52006,"Ceres",5,"Centro-oeste",1,"521090",2,22,3,19,12,10,0,0,0,0,0,22,3,19,12,10,13,9.6297780738178,10.0613883347884,0.325080980555076,29
"14214","GO","Itapaci",23421,15211.06,52006,"Ceres",5,"Centro-oeste",1,"521090",3,21,4,17,11,10,0,0,0,0,0,21,4,17,11,10,11,9.6297780738178,10.0613883347884,0.407092355761238,31
"14215","GO","Itapaci",23421,15211.06,52006,"Ceres",5,"Centro-oeste",1,"521090",4,17,1,16,5,12,0,0,0,0,0,17,1,16,5,12,11,9.6297780738178,10.0613883347884,0.43075883823862,30
"14216","GO","Itapaci",23421,15211.06,52006,"Ceres",5,"Centro-oeste",1,"521090",5,21,1,20,11,10,2,0,2,2,0,23,1,22,13,10,12,9.6297780738178,10.0613883347884,0.404025780961303,31
"14217","GO","Itapirapuã",4685,26910.36,52002,"Rio Vermelho",5,"Centro-oeste",0,"521100",2,4,2,2,2,2,0,0,0,0,0,4,2,2,2,2,3,10.2002666215579,8.45212119467252,0.300912911086935,29
"14218","GO","Itapirapuã",4685,26910.36,52002,"Rio Vermelho",5,"Centro-oeste",0,"521100",3,6,1,5,2,4,0,0,0,0,0,6,1,5,2,4,6,10.2002666215579,8.45212119467252,0.389129725947993,31
"14219","GO","Itapirapuã",4685,26910.36,52002,"Rio Vermelho",5,"Centro-oeste",0,"521100",4,11,4,7,7,4,0,0,0,0,0,11,4,7,7,4,2,10.2002666215579,8.45212119467252,0.410210100143122,30
"14220","GO","Itapirapuã",4685,26910.36,52002,"Rio Vermelho",5,"Centro-oeste",0,"521100",5,4,1,3,1,3,0,0,0,0,0,4,1,3,1,3,4,10.2002666215579,8.45212119467252,0.374584600663827,31
"14221","GO","Itapuranga",25681,16338.81,52006,"Ceres",5,"Centro-oeste",1,"521120",2,19,2,17,14,5,0,0,0,0,0,19,2,17,14,5,19,9.70129853834457,10.1535066978557,0.300765184686648,29
"14222","GO","Itapuranga",25681,16338.81,52006,"Ceres",5,"Centro-oeste",1,"521120",3,20,0,20,7,13,0,0,0,0,0,20,0,20,7,13,22,9.70129853834457,10.1535066978557,0.386047989350528,31
"14223","GO","Itapuranga",25681,16338.81,52006,"Ceres",5,"Centro-oeste",1,"521120",4,27,5,22,16,11,0,0,0,0,0,27,5,22,16,11,21,9.70129853834457,10.1535066978557,0.408647075884855,30
"14224","GO","Itapuranga",25681,16338.81,52006,"Ceres",5,"Centro-oeste",1,"521120",5,24,5,19,9,15,0,0,0,0,0,24,5,19,9,15,12,9.70129853834457,10.1535066978557,0.368773319207565,31
"14225","GO","Itauçu",8960,15977.75,52007,"Anápolis",5,"Centro-oeste",0,"521140",2,6,1,5,1,5,0,0,0,0,0,6,1,5,1,5,7,9.67895240840562,9.10052550596898,0.289944598757834,29
"14226","GO","Itauçu",8960,15977.75,52007,"Anápolis",5,"Centro-oeste",0,"521140",3,7,3,4,1,6,0,0,0,0,0,7,3,4,1,6,13,9.67895240840562,9.10052550596898,0.354933245367782,31
"14227","GO","Itauçu",8960,15977.75,52007,"Anápolis",5,"Centro-oeste",0,"521140",4,7,2,5,2,5,0,0,0,0,0,7,2,5,2,5,3,9.67895240840562,9.10052550596898,0.360117445875911,30
"14228","GO","Itauçu",8960,15977.75,52007,"Anápolis",5,"Centro-oeste",0,"521140",5,9,0,9,2,7,0,0,0,0,0,9,0,9,2,7,5,9.67895240840562,9.10052550596898,0.340595604067959,31
"14229","GO","Itumbiara",105809,40399.72,52015,"Meia Ponte",5,"Centro-oeste",1,"521150",2,93,17,76,33,60,0,0,0,0,0,93,17,76,33,60,61,10.6065781332322,11.569390860951,0.302189343462864,29
"14230","GO","Itumbiara",105809,40399.72,52015,"Meia Ponte",5,"Centro-oeste",1,"521150",3,105,20,85,36,69,1,0,1,1,0,106,20,86,37,69,64,10.6065781332322,11.569390860951,0.390401447374129,31
"14231","GO","Itumbiara",105809,40399.72,52015,"Meia Ponte",5,"Centro-oeste",1,"521150",4,103,18,85,42,61,1,0,1,0,1,104,18,86,42,62,56,10.6065781332322,11.569390860951,0.429272274267523,30
"14232","GO","Itumbiara",105809,40399.72,52015,"Meia Ponte",5,"Centro-oeste",1,"521150",5,116,24,92,45,71,0,0,0,0,0,116,24,92,45,71,69,10.6065781332322,11.569390860951,0.385807153740537,31
"14233","GO","Jandaia",6025,40353.89,52014,"Vale do Rio dos Bois",5,"Centro-oeste",0,"521170",2,6,2,4,1,5,0,0,0,0,0,6,2,4,1,5,4,10.6054430754949,8.70367275835886,0.28937231968809,29
"14234","GO","Jandaia",6025,40353.89,52014,"Vale do Rio dos Bois",5,"Centro-oeste",0,"521170",3,4,2,2,2,2,0,0,0,0,0,4,2,2,2,2,6,10.6054430754949,8.70367275835886,0.386905336976687,31
"14235","GO","Jandaia",6025,40353.89,52014,"Vale do Rio dos Bois",5,"Centro-oeste",0,"521170",4,5,0,5,1,4,0,0,0,0,0,5,0,5,1,4,3,10.6054430754949,8.70367275835886,0.409300522560146,30
"14236","GO","Jandaia",6025,40353.89,52014,"Vale do Rio dos Bois",5,"Centro-oeste",0,"521170",5,6,1,5,2,4,0,0,0,0,0,6,1,5,2,4,7,10.6054430754949,8.70367275835886,0.387468286878123,31
"14237","GO","Jaraguá",51338,14196.3,52007,"Anápolis",5,"Centro-oeste",1,"521180",2,42,11,31,18,24,0,0,0,0,0,42,11,31,18,24,26,9.56073664625653,10.8461864976866,0.319878630137096,29
"14238","GO","Jaraguá",51338,14196.3,52007,"Anápolis",5,"Centro-oeste",1,"521180",3,37,10,27,10,27,0,0,0,0,0,37,10,27,10,27,22,9.56073664625653,10.8461864976866,0.411820959032692,31
"14239","GO","Jaraguá",51338,14196.3,52007,"Anápolis",5,"Centro-oeste",1,"521180",4,37,7,30,12,25,0,0,0,0,0,37,7,30,12,25,30,9.56073664625653,10.8461864976866,0.431004923256946,30
"14240","GO","Jaraguá",51338,14196.3,52007,"Anápolis",5,"Centro-oeste",1,"521180",5,49,10,39,16,33,0,0,0,0,0,49,10,39,16,33,32,9.56073664625653,10.8461864976866,0.403087365802403,31
"14241","GO","Jataí",102065,46149.26,52013,"Sudoeste de Goiás",5,"Centro-oeste",1,"521190",2,125,30,95,55,70,0,0,0,0,0,125,30,95,55,70,55,10.7396362051329,11.5333651442077,0.293024148669804,29
"14242","GO","Jataí",102065,46149.26,52013,"Sudoeste de Goiás",5,"Centro-oeste",1,"521190",3,100,26,74,46,54,1,0,1,1,0,101,26,75,47,54,47,10.7396362051329,11.5333651442077,0.391341251389478,31
"14243","GO","Jataí",102065,46149.26,52013,"Sudoeste de Goiás",5,"Centro-oeste",1,"521190",4,133,31,102,58,75,0,0,0,0,0,133,31,102,58,75,34,10.7396362051329,11.5333651442077,0.419422608462695,30
"14244","GO","Jataí",102065,46149.26,52013,"Sudoeste de Goiás",5,"Centro-oeste",1,"521190",5,134,26,108,45,89,0,0,0,0,0,134,26,108,45,89,46,10.7396362051329,11.5333651442077,0.387702604191881,31
"14245","GO","Joviânia",7402,28514.59,52015,"Meia Ponte",5,"Centro-oeste",0,"521210",2,6,3,3,1,5,0,0,0,0,0,6,3,3,1,5,3,10.2581711650899,8.9095055129461,0.337274569113819,29
"14246","GO","Joviânia",7402,28514.59,52015,"Meia Ponte",5,"Centro-oeste",0,"521210",3,8,1,7,4,4,0,0,0,0,0,8,1,7,4,4,3,10.2581711650899,8.9095055129461,0.383263019057763,31
"14247","GO","Joviânia",7402,28514.59,52015,"Meia Ponte",5,"Centro-oeste",0,"521210",4,5,1,4,4,1,0,0,0,0,0,5,1,4,4,1,5,10.2581711650899,8.9095055129461,0.411981442860239,30
"14248","GO","Joviânia",7402,28514.59,52015,"Meia Ponte",5,"Centro-oeste",0,"521210",5,8,2,6,4,4,0,0,0,0,0,8,2,6,4,4,6,10.2581711650899,8.9095055129461,0.38935923214529,31
"14249","GO","Jussara",18371,23958.8,52002,"Rio Vermelho",5,"Centro-oeste",0,"521220",2,23,3,20,10,13,0,0,0,0,0,23,3,20,10,13,10,10.0840909675027,9.81852861330894,0.277380377056454,29
"14250","GO","Jussara",18371,23958.8,52002,"Rio Vermelho",5,"Centro-oeste",0,"521220",3,23,2,21,9,14,0,0,0,0,0,23,2,21,9,14,17,10.0840909675027,9.81852861330894,0.370687121590052,31
"14251","GO","Jussara",18371,23958.8,52002,"Rio Vermelho",5,"Centro-oeste",0,"521220",4,18,2,16,9,9,1,1,0,0,1,19,3,16,9,10,12,10.0840909675027,9.81852861330894,0.404315283582857,30
"14252","GO","Jussara",18371,23958.8,52002,"Rio Vermelho",5,"Centro-oeste",0,"521220",5,16,1,15,8,8,0,0,0,0,0,16,1,15,8,8,13,10.0840909675027,9.81852861330894,0.362292921697537,31
"14253","GO","Leopoldo de Bulhões",7651,29507.17,52010,"Goiânia",5,"Centro-oeste",0,"521230",2,10,2,8,5,5,0,0,0,0,0,10,2,8,5,5,4,10.2923885636433,8.94259163723185,0.31964823201504,29
"14254","GO","Leopoldo de Bulhões",7651,29507.17,52010,"Goiânia",5,"Centro-oeste",0,"521230",3,4,3,1,1,3,0,0,0,0,0,4,3,1,1,3,7,10.2923885636433,8.94259163723185,0.412808717851685,31
"14255","GO","Leopoldo de Bulhões",7651,29507.17,52010,"Goiânia",5,"Centro-oeste",0,"521230",4,10,2,8,4,6,0,0,0,0,0,10,2,8,4,6,4,10.2923885636433,8.94259163723185,0.431952957597983,30
"14256","GO","Leopoldo de Bulhões",7651,29507.17,52010,"Goiânia",5,"Centro-oeste",0,"521230",5,9,1,8,3,6,0,0,0,0,0,9,1,8,3,6,2,10.2923885636433,8.94259163723185,0.415334276573769,31
"14257","GO","Luziânia",211508,17452.11,52012,"Entorno de Brasília",5,"Centro-oeste",1,"521250",2,227,73,154,94,133,0,0,0,0,0,227,73,154,94,133,75,9.76721583722616,12.2620181018122,0.29215495635451,29
"14258","GO","Luziânia",211508,17452.11,52012,"Entorno de Brasília",5,"Centro-oeste",1,"521250",3,232,52,180,86,146,0,0,0,0,0,232,52,180,86,146,85,9.76721583722616,12.2620181018122,0.386492914194562,31
"14259","GO","Luziânia",211508,17452.11,52012,"Entorno de Brasília",5,"Centro-oeste",1,"521250",4,248,65,183,101,147,3,1,2,1,2,251,66,185,102,149,93,9.76721583722616,12.2620181018122,0.416605703737987,30
"14260","GO","Luziânia",211508,17452.11,52012,"Entorno de Brasília",5,"Centro-oeste",1,"521250",5,256,66,190,116,140,2,0,2,1,1,258,66,192,117,141,99,9.76721583722616,12.2620181018122,0.377610995958838,31
"14261","GO","Mambaí",9081,9382.12,52011,"Vão do Paranã",5,"Centro-oeste",0,"521270",2,4,3,1,2,2,0,0,0,0,0,4,3,1,2,2,1,9.1465610292564,9.11393959768983,0.279365053065217,29
"14262","GO","Mambaí",9081,9382.12,52011,"Vão do Paranã",5,"Centro-oeste",0,"521270",3,11,5,6,7,4,0,0,0,0,0,11,5,6,7,4,2,9.1465610292564,9.11393959768983,0.354477763127399,31
"14263","GO","Mambaí",9081,9382.12,52011,"Vão do Paranã",5,"Centro-oeste",0,"521270",4,6,1,5,3,3,0,0,0,0,0,6,1,5,3,3,11,9.1465610292564,9.11393959768983,0.376122660140342,30
"14264","GO","Mambaí",9081,9382.12,52011,"Vão do Paranã",5,"Centro-oeste",0,"521270",5,12,1,11,7,5,0,0,0,0,0,12,1,11,7,5,5,9.1465610292564,9.11393959768983,0.334233699187428,31
"14265","GO","Mara Rosa",9363,19955.63,52004,"Porangatu",5,"Centro-oeste",0,"521280",2,8,0,8,5,3,0,0,0,0,0,8,0,8,5,3,6,9.90126658801931,9.14452103093889,0.334726828610927,29
"14266","GO","Mara Rosa",9363,19955.63,52004,"Porangatu",5,"Centro-oeste",0,"521280",3,8,1,7,3,5,0,0,0,0,0,8,1,7,3,5,7,9.90126658801931,9.14452103093889,0.40212842269751,31
"14267","GO","Mara Rosa",9363,19955.63,52004,"Porangatu",5,"Centro-oeste",0,"521280",4,11,2,9,4,7,0,0,0,0,0,11,2,9,4,7,3,9.90126658801931,9.14452103093889,0.412650590470026,30
"14268","GO","Mara Rosa",9363,19955.63,52004,"Porangatu",5,"Centro-oeste",0,"521280",5,13,4,9,5,8,0,0,0,0,0,13,4,9,5,8,7,9.90126658801931,9.14452103093889,0.391912435139167,31
"14269","GO","Maurilândia",14327,16349.84,52013,"Sudoeste de Goiás",5,"Centro-oeste",1,"521300",2,10,1,9,3,7,0,0,0,0,0,10,1,9,3,7,3,9.7019733903448,9.56990114789337,0.297972058039394,29
"14270","GO","Maurilândia",14327,16349.84,52013,"Sudoeste de Goiás",5,"Centro-oeste",1,"521300",3,6,2,4,1,5,0,0,0,0,0,6,2,4,1,5,3,9.7019733903448,9.56990114789337,0.373797459014986,31
"14271","GO","Maurilândia",14327,16349.84,52013,"Sudoeste de Goiás",5,"Centro-oeste",1,"521300",4,9,2,7,7,2,0,0,0,0,0,9,2,7,7,2,7,9.7019733903448,9.56990114789337,0.35017540191239,30
"14272","GO","Maurilândia",14327,16349.84,52013,"Sudoeste de Goiás",5,"Centro-oeste",1,"521300",5,10,2,8,4,6,1,1,0,0,1,11,3,8,4,7,5,9.7019733903448,9.56990114789337,0.315672816998364,31
"14273","GO","Minaçu",28793,35257.88,52004,"Porangatu",5,"Centro-oeste",1,"521308",2,20,4,16,10,10,2,2,0,1,1,22,6,16,11,11,13,10.470444329357,10.2678875810257,0.310404787016508,29
"14274","GO","Minaçu",28793,35257.88,52004,"Porangatu",5,"Centro-oeste",1,"521308",3,19,1,18,5,14,0,0,0,0,0,19,1,18,5,14,19,10.470444329357,10.2678875810257,0.410038554595503,31
"14275","GO","Minaçu",28793,35257.88,52004,"Porangatu",5,"Centro-oeste",1,"521308",4,46,10,36,26,20,0,0,0,0,0,46,10,36,26,20,15,10.470444329357,10.2678875810257,0.439929249833834,30
"14276","GO","Minaçu",28793,35257.88,52004,"Porangatu",5,"Centro-oeste",1,"521308",5,39,6,33,19,20,0,0,0,0,0,39,6,33,19,20,11,10.470444329357,10.2678875810257,0.4090325828137,31
"14277","GO","Mineiros",68154,39247.79,52013,"Sudoeste de Goiás",5,"Centro-oeste",1,"521310",2,91,22,69,33,58,0,0,0,0,0,91,22,69,33,58,33,10.5776504158928,11.1295251294595,0.291259172429222,29
"14278","GO","Mineiros",68154,39247.79,52013,"Sudoeste de Goiás",5,"Centro-oeste",1,"521310",3,82,20,62,38,44,1,1,0,0,1,83,21,62,38,45,36,10.5776504158928,11.1295251294595,0.370585513162126,31
"14279","GO","Mineiros",68154,39247.79,52013,"Sudoeste de Goiás",5,"Centro-oeste",1,"521310",4,78,16,62,30,48,1,0,1,0,1,79,16,63,30,49,24,10.5776504158928,11.1295251294595,0.399127255660484,30
"14280","GO","Mineiros",68154,39247.79,52013,"Sudoeste de Goiás",5,"Centro-oeste",1,"521310",5,78,14,64,41,37,1,0,1,0,1,79,14,65,41,38,34,10.5776504158928,11.1295251294595,0.37249235064434,31
"14281","GO","Montes Claros de Goiás",8047,36430.77,52003,"Aragarças",5,"Centro-oeste",0,"521370",2,8,2,6,5,3,0,0,0,0,0,8,2,6,5,3,5,10.5031690262053,8.99305463014613,0.312148813217177,29
"14282","GO","Montes Claros de Goiás",8047,36430.77,52003,"Aragarças",5,"Centro-oeste",0,"521370",3,2,2,0,1,1,0,0,0,0,0,2,2,0,1,1,8,10.5031690262053,8.99305463014613,0.352223598043044,31
"14283","GO","Montes Claros de Goiás",8047,36430.77,52003,"Aragarças",5,"Centro-oeste",0,"521370",4,5,0,5,2,3,0,0,0,0,0,5,0,5,2,3,2,10.5031690262053,8.99305463014613,0.380815335266802,30
"14284","GO","Montes Claros de Goiás",8047,36430.77,52003,"Aragarças",5,"Centro-oeste",0,"521370",5,3,0,3,1,2,0,0,0,0,0,3,0,3,1,2,3,10.5031690262053,8.99305463014613,0.422219475317108,31
"14285","GO","Montividiu",13672,59493.64,52013,"Sudoeste de Goiás",5,"Centro-oeste",0,"521375",2,5,1,4,4,1,0,0,0,0,0,5,1,4,4,1,4,10.9936246950642,9.52310522479543,0.326355976371868,29
"14286","GO","Montividiu",13672,59493.64,52013,"Sudoeste de Goiás",5,"Centro-oeste",0,"521375",3,15,4,11,5,10,0,0,0,0,0,15,4,11,5,10,8,10.9936246950642,9.52310522479543,0.394311558685981,31
"14287","GO","Montividiu",13672,59493.64,52013,"Sudoeste de Goiás",5,"Centro-oeste",0,"521375",4,18,3,15,5,13,0,0,0,0,0,18,3,15,5,13,8,10.9936246950642,9.52310522479543,0.390338920954355,30
"14288","GO","Montividiu",13672,59493.64,52013,"Sudoeste de Goiás",5,"Centro-oeste",0,"521375",5,14,1,13,6,8,0,0,0,0,0,14,1,13,6,8,7,10.9936246950642,9.52310522479543,0.376229909689049,31
"14289","GO","Morrinhos",46548,29977.58,52015,"Meia Ponte",5,"Centro-oeste",1,"521380",2,44,14,30,18,26,1,1,0,0,1,45,15,30,18,27,30,10.3082050479182,10.748239317228,0.305130958336358,29
"14290","GO","Morrinhos",46548,29977.58,52015,"Meia Ponte",5,"Centro-oeste",1,"521380",3,59,14,45,23,36,2,1,1,1,1,61,15,46,24,37,35,10.3082050479182,10.748239317228,0.391724548778571,31
"14291","GO","Morrinhos",46548,29977.58,52015,"Meia Ponte",5,"Centro-oeste",1,"521380",4,52,18,34,17,35,0,0,0,0,0,52,18,34,17,35,27,10.3082050479182,10.748239317228,0.414720894121999,30
"14292","GO","Morrinhos",46548,29977.58,52015,"Meia Ponte",5,"Centro-oeste",1,"521380",5,44,14,30,14,30,0,0,0,0,0,44,14,30,14,30,39,10.3082050479182,10.748239317228,0.38733232761695,31
"14293","GO","Mozarlândia",15870,34244.05,52001,"São Miguel do Araguaia",5,"Centro-oeste",1,"521400",2,15,2,13,2,13,0,0,0,0,0,15,2,13,2,13,7,10.4412681059711,9.67218581352046,0.340853797873186,29
"14294","GO","Mozarlândia",15870,34244.05,52001,"São Miguel do Araguaia",5,"Centro-oeste",1,"521400",3,16,8,8,7,9,0,0,0,0,0,16,8,8,7,9,6,10.4412681059711,9.67218581352046,0.425874134769811,31
"14295","GO","Mozarlândia",15870,34244.05,52001,"São Miguel do Araguaia",5,"Centro-oeste",1,"521400",4,16,2,14,7,9,0,0,0,0,0,16,2,14,7,9,12,10.4412681059711,9.67218581352046,0.437851033429146,30
"14296","GO","Mozarlândia",15870,34244.05,52001,"São Miguel do Araguaia",5,"Centro-oeste",1,"521400",5,21,6,15,13,8,0,0,0,0,0,21,6,15,13,8,5,10.4412681059711,9.67218581352046,0.410009178312011,31
"14297","GO","Nazário",9260,19632.43,52009,"Anicuns",5,"Centro-oeste",0,"521440",2,9,1,8,5,4,0,0,0,0,0,9,1,8,5,4,7,9.88493806972631,9.13345932764022,0.285015545356072,29
"14298","GO","Nazário",9260,19632.43,52009,"Anicuns",5,"Centro-oeste",0,"521440",3,7,1,6,1,6,0,0,0,0,0,7,1,6,1,6,4,9.88493806972631,9.13345932764022,0.386194548507608,31
"14299","GO","Nazário",9260,19632.43,52009,"Anicuns",5,"Centro-oeste",0,"521440",4,3,1,2,1,2,2,0,2,1,1,5,1,4,2,3,1,9.88493806972631,9.13345932764022,0.407306331577343,30
"14300","GO","Nazário",9260,19632.43,52009,"Anicuns",5,"Centro-oeste",0,"521440",5,5,0,5,1,4,0,0,0,0,0,5,0,5,1,4,7,9.88493806972631,9.13345932764022,0.371020672887145,31
"14301","GO","Nerópolis",30395,24914.11,52010,"Goiânia",5,"Centro-oeste",1,"521450",2,28,5,23,15,13,0,0,0,0,0,28,5,23,15,13,13,10.1231895886245,10.3220334001828,0.285515808464597,29
"14302","GO","Nerópolis",30395,24914.11,52010,"Goiânia",5,"Centro-oeste",1,"521450",3,39,3,36,13,26,0,0,0,0,0,39,3,36,13,26,18,10.1231895886245,10.3220334001828,0.36554120149543,31
"14303","GO","Nerópolis",30395,24914.11,52010,"Goiânia",5,"Centro-oeste",1,"521450",4,39,10,29,13,26,0,0,0,0,0,39,10,29,13,26,21,10.1231895886245,10.3220334001828,0.389339051106278,30
"14304","GO","Nerópolis",30395,24914.11,52010,"Goiânia",5,"Centro-oeste",1,"521450",5,37,9,28,16,21,1,0,1,0,1,38,9,29,16,22,17,10.1231895886245,10.3220334001828,0.354182278812985,31
"14305","GO","Niquelândia",46730,24041.58,52004,"Porangatu",5,"Centro-oeste",1,"521460",2,29,6,23,14,15,0,0,0,0,0,29,6,23,14,15,22,10.0875401102831,10.7521416356945,0.297054641645495,29
"14306","GO","Niquelândia",46730,24041.58,52004,"Porangatu",5,"Centro-oeste",1,"521460",3,29,8,21,14,15,2,0,2,1,1,31,8,23,15,16,19,10.0875401102831,10.7521416356945,0.384896167808133,31
"14307","GO","Niquelândia",46730,24041.58,52004,"Porangatu",5,"Centro-oeste",1,"521460",4,28,8,20,12,16,1,0,1,0,1,29,8,21,12,17,21,10.0875401102831,10.7521416356945,0.418872231560842,30
"14308","GO","Niquelândia",46730,24041.58,52004,"Porangatu",5,"Centro-oeste",1,"521460",5,37,7,30,15,22,0,0,0,0,0,37,7,30,15,22,25,10.0875401102831,10.7521416356945,0.396287056323276,31
"14309","GO","Nova Crixás",12945,27855.73,52001,"São Miguel do Araguaia",5,"Centro-oeste",0,"521483",2,12,2,10,3,9,0,0,0,0,0,12,2,10,3,9,4,10.2347939692557,9.46846489218564,0.310421033144132,29
"14310","GO","Nova Crixás",12945,27855.73,52001,"São Miguel do Araguaia",5,"Centro-oeste",0,"521483",3,9,2,7,5,4,0,0,0,0,0,9,2,7,5,4,4,10.2347939692557,9.46846489218564,0.39867118349351,31
"14311","GO","Nova Crixás",12945,27855.73,52001,"São Miguel do Araguaia",5,"Centro-oeste",0,"521483",4,13,3,10,8,5,0,0,0,0,0,13,3,10,8,5,6,10.2347939692557,9.46846489218564,0.408107696865056,30
"14312","GO","Nova Crixás",12945,27855.73,52001,"São Miguel do Araguaia",5,"Centro-oeste",0,"521483",5,19,2,17,13,6,0,0,0,0,0,19,2,17,13,6,4,10.2347939692557,9.46846489218564,0.388511590148088,31
"14313","GO","Nova Glória",8112,14322.96,52006,"Ceres",5,"Centro-oeste",0,"521486",2,4,0,4,2,2,0,0,0,0,0,4,0,4,2,2,5,9.56961912306494,9.00109972583097,0.34740427440197,29
"14314","GO","Nova Glória",8112,14322.96,52006,"Ceres",5,"Centro-oeste",0,"521486",3,2,0,2,2,0,0,0,0,0,0,2,0,2,2,0,6,9.56961912306494,9.00109972583097,0.374383259671614,31
"14315","GO","Nova Glória",8112,14322.96,52006,"Ceres",5,"Centro-oeste",0,"521486",4,7,3,4,2,5,0,0,0,0,0,7,3,4,2,5,4,9.56961912306494,9.00109972583097,0.425394453152668,30
"14316","GO","Nova Glória",8112,14322.96,52006,"Ceres",5,"Centro-oeste",0,"521486",5,6,2,4,2,4,1,1,0,0,1,7,3,4,2,5,2,9.56961912306494,9.00109972583097,0.425115773804874,31
"14317","GO","Nova Veneza",10018,18864.15,52007,"Anápolis",5,"Centro-oeste",1,"521500",2,5,0,5,2,3,0,0,0,0,0,5,0,5,2,3,6,9.84501857439948,9.21213875391756,0.310609400866433,29
"14318","GO","Nova Veneza",10018,18864.15,52007,"Anápolis",5,"Centro-oeste",1,"521500",3,9,1,8,3,6,0,0,0,0,0,9,1,8,3,6,5,9.84501857439948,9.21213875391756,0.379568189754624,31
"14319","GO","Nova Veneza",10018,18864.15,52007,"Anápolis",5,"Centro-oeste",1,"521500",4,4,1,3,2,2,0,0,0,0,0,4,1,3,2,2,7,9.84501857439948,9.21213875391756,0.377946233841881,30
"14320","GO","Nova Veneza",10018,18864.15,52007,"Anápolis",5,"Centro-oeste",1,"521500",5,9,1,8,6,3,0,0,0,0,0,9,1,8,6,3,4,9.84501857439948,9.21213875391756,0.356931426774878,31
"14321","GO","Novo Gama",117703,8403.19,52012,"Entorno de Brasília",5,"Centro-oeste",1,"521523",2,85,22,63,35,50,1,0,1,0,1,86,22,64,35,51,35,9.03636667464487,11.6759197814537,0.305398009659051,29
"14322","GO","Novo Gama",117703,8403.19,52012,"Entorno de Brasília",5,"Centro-oeste",1,"521523",3,112,38,74,45,67,1,0,1,0,1,113,38,75,45,68,46,9.03636667464487,11.6759197814537,0.395098722079358,31
"14323","GO","Novo Gama",117703,8403.19,52012,"Entorno de Brasília",5,"Centro-oeste",1,"521523",4,116,40,76,50,66,0,0,0,0,0,116,40,76,50,66,37,9.03636667464487,11.6759197814537,0.434396610222866,30
"14324","GO","Novo Gama",117703,8403.19,52012,"Entorno de Brasília",5,"Centro-oeste",1,"521523",5,119,34,85,49,70,2,1,1,1,1,121,35,86,50,71,49,9.03636667464487,11.6759197814537,0.399913957267706,31
"14325","GO","Orizona",15725,33460.7,52016,"Pires do Rio",5,"Centro-oeste",0,"521530",2,11,4,7,2,9,0,0,0,0,0,11,4,7,2,9,11,10.4181268948241,9.66300708156864,0.285867588020592,29
"14326","GO","Orizona",15725,33460.7,52016,"Pires do Rio",5,"Centro-oeste",0,"521530",3,13,4,9,6,7,0,0,0,0,0,13,4,9,6,7,9,10.4181268948241,9.66300708156864,0.374322470177672,31
"14327","GO","Orizona",15725,33460.7,52016,"Pires do Rio",5,"Centro-oeste",0,"521530",4,23,4,19,9,14,0,0,0,0,0,23,4,19,9,14,7,10.4181268948241,9.66300708156864,0.40491926192922,30
"14328","GO","Orizona",15725,33460.7,52016,"Pires do Rio",5,"Centro-oeste",0,"521530",5,18,3,15,5,13,0,0,0,0,0,18,3,15,5,13,9,10.4181268948241,9.66300708156864,0.388898788185013,31
"14329","GO","Ouvidor",6782,116335.53,52017,"Catalão",5,"Centro-oeste",1,"521550",2,4,0,4,1,3,0,0,0,0,0,4,0,4,1,3,3,11.6642337948597,8.82202732268558,0.279998888753257,29
"14330","GO","Ouvidor",6782,116335.53,52017,"Catalão",5,"Centro-oeste",1,"521550",3,8,0,8,2,6,0,0,0,0,0,8,0,8,2,6,1,11.6642337948597,8.82202732268558,0.352204588832179,31
"14331","GO","Ouvidor",6782,116335.53,52017,"Catalão",5,"Centro-oeste",1,"521550",4,7,2,5,3,4,0,0,0,0,0,7,2,5,3,4,0,11.6642337948597,8.82202732268558,0.416831579823096,30
"14332","GO","Ouvidor",6782,116335.53,52017,"Catalão",5,"Centro-oeste",1,"521550",5,5,2,3,2,3,0,0,0,0,0,5,2,3,2,3,2,11.6642337948597,8.82202732268558,0.39501390857285,31
"14333","GO","Padre Bernardo",34430,15252.08,52012,"Entorno de Brasília",5,"Centro-oeste",1,"521560",2,37,9,28,14,23,0,0,0,0,0,37,9,28,14,23,18,9.63247116617744,10.4466835563326,0.301536292200451,29
"14334","GO","Padre Bernardo",34430,15252.08,52012,"Entorno de Brasília",5,"Centro-oeste",1,"521560",3,26,12,14,10,16,1,0,1,1,0,27,12,15,11,16,26,9.63247116617744,10.4466835563326,0.387994658245997,31
"14335","GO","Padre Bernardo",34430,15252.08,52012,"Entorno de Brasília",5,"Centro-oeste",1,"521560",4,31,8,23,18,13,0,0,0,0,0,31,8,23,18,13,14,9.63247116617744,10.4466835563326,0.415530920825943,30
"14336","GO","Padre Bernardo",34430,15252.08,52012,"Entorno de Brasília",5,"Centro-oeste",1,"521560",5,31,9,22,14,17,0,0,0,0,0,31,9,22,14,17,13,9.63247116617744,10.4466835563326,0.395031333276537,31
"14337","GO","Palmeiras de Goiás",29392,35536.88,52014,"Vale do Rio dos Bois",5,"Centro-oeste",1,"521570",2,22,4,18,9,13,0,0,0,0,0,22,4,18,9,13,9,10.4783263094476,10.2884778074549,0.292261338285847,29
"14338","GO","Palmeiras de Goiás",29392,35536.88,52014,"Vale do Rio dos Bois",5,"Centro-oeste",1,"521570",3,24,5,19,11,13,0,0,0,0,0,24,5,19,11,13,10,10.4783263094476,10.2884778074549,0.363030841284733,31
"14339","GO","Palmeiras de Goiás",29392,35536.88,52014,"Vale do Rio dos Bois",5,"Centro-oeste",1,"521570",4,29,7,22,8,21,0,0,0,0,0,29,7,22,8,21,10,10.4783263094476,10.2884778074549,0.39220209586353,30
"14340","GO","Palmeiras de Goiás",29392,35536.88,52014,"Vale do Rio dos Bois",5,"Centro-oeste",1,"521570",5,39,5,34,17,22,0,0,0,0,0,39,5,34,17,22,17,10.4783263094476,10.2884778074549,0.372223546808709,31
"14341","GO","Paranaiguara",10140,18570.25,52018,"Quirinópolis",5,"Centro-oeste",0,"521630",2,5,1,4,2,3,0,0,0,0,0,5,1,4,2,3,11,9.82931611683018,9.22424327714517,0.301577106262992,29
"14342","GO","Paranaiguara",10140,18570.25,52018,"Quirinópolis",5,"Centro-oeste",0,"521630",3,6,0,6,4,2,0,0,0,0,0,6,0,6,4,2,7,9.82931611683018,9.22424327714517,0.352067887138151,31
"14343","GO","Paranaiguara",10140,18570.25,52018,"Quirinópolis",5,"Centro-oeste",0,"521630",4,9,2,7,2,7,0,0,0,0,0,9,2,7,2,7,7,9.82931611683018,9.22424327714517,0.376907048779489,30
"14344","GO","Paranaiguara",10140,18570.25,52018,"Quirinópolis",5,"Centro-oeste",0,"521630",5,7,1,6,2,5,1,1,0,1,0,8,2,6,3,5,7,9.82931611683018,9.22424327714517,0.404696745082239,31
"14345","GO","Paraúna",10980,81938.77,52014,"Vale do Rio dos Bois",5,"Centro-oeste",0,"521640",2,9,2,7,3,6,0,0,0,0,0,9,2,7,3,6,10,11.3137275400045,9.30383071506352,0.307818418277889,29
"14346","GO","Paraúna",10980,81938.77,52014,"Vale do Rio dos Bois",5,"Centro-oeste",0,"521640",3,13,4,9,4,9,0,0,0,0,0,13,4,9,4,9,5,11.3137275400045,9.30383071506352,0.392077473851771,31
"14347","GO","Paraúna",10980,81938.77,52014,"Vale do Rio dos Bois",5,"Centro-oeste",0,"521640",4,17,5,12,10,7,0,0,0,0,0,17,5,12,10,7,15,11.3137275400045,9.30383071506352,0.4033891616709,30
"14348","GO","Paraúna",10980,81938.77,52014,"Vale do Rio dos Bois",5,"Centro-oeste",0,"521640",5,12,2,10,10,2,0,0,0,0,0,12,2,10,10,2,8,11.3137275400045,9.30383071506352,0.394005401965174,31
"14349","GO","Petrolina de Goiás",10261,14365.85,52007,"Anápolis",5,"Centro-oeste",0,"521680",2,4,0,4,1,3,0,0,0,0,0,4,0,4,1,3,4,9.57260914126045,9.23610557986221,0.300663028059945,29
"14350","GO","Petrolina de Goiás",10261,14365.85,52007,"Anápolis",5,"Centro-oeste",0,"521680",3,5,2,3,1,4,0,0,0,0,0,5,2,3,1,4,3,9.57260914126045,9.23610557986221,0.357943217328792,31
"14351","GO","Petrolina de Goiás",10261,14365.85,52007,"Anápolis",5,"Centro-oeste",0,"521680",4,7,0,7,4,3,0,0,0,0,0,7,0,7,4,3,6,9.57260914126045,9.23610557986221,0.386196445188713,30
"14352","GO","Petrolina de Goiás",10261,14365.85,52007,"Anápolis",5,"Centro-oeste",0,"521680",5,6,1,5,1,5,0,0,0,0,0,6,1,5,1,5,4,9.57260914126045,9.23610557986221,0.371740053296262,31
"14353","GO","Piracanjuba",24548,32399.79,52015,"Meia Ponte",5,"Centro-oeste",0,"521710",2,22,8,14,9,13,0,0,0,0,0,22,8,14,9,13,18,10.3859072202779,10.108385663509,0.293812733304444,29
"14354","GO","Piracanjuba",24548,32399.79,52015,"Meia Ponte",5,"Centro-oeste",0,"521710",3,13,4,9,6,7,0,0,0,0,0,13,4,9,6,7,17,10.3859072202779,10.108385663509,0.365351135500179,31
"14355","GO","Piracanjuba",24548,32399.79,52015,"Meia Ponte",5,"Centro-oeste",0,"521710",4,19,3,16,8,11,0,0,0,0,0,19,3,16,8,11,18,10.3859072202779,10.108385663509,0.417629384183972,30
"14356","GO","Piracanjuba",24548,32399.79,52015,"Meia Ponte",5,"Centro-oeste",0,"521710",5,22,4,18,12,10,0,0,0,0,0,22,4,18,12,10,23,10.3859072202779,10.108385663509,0.395739464088731,31
"14357","GO","Piranhas",10272,36038.71,52003,"Aragarças",5,"Centro-oeste",0,"521720",2,11,2,9,4,7,0,0,0,0,0,11,2,9,4,7,5,10.492348917519,9.23717702592974,0.305824391733389,29
"14358","GO","Piranhas",10272,36038.71,52003,"Aragarças",5,"Centro-oeste",0,"521720",3,5,1,4,1,4,0,0,0,0,0,5,1,4,1,4,8,10.492348917519,9.23717702592974,0.393832411611009,31
"14359","GO","Piranhas",10272,36038.71,52003,"Aragarças",5,"Centro-oeste",0,"521720",4,12,2,10,6,6,0,0,0,0,0,12,2,10,6,6,6,10.492348917519,9.23717702592974,0.408065883285571,30
"14360","GO","Piranhas",10272,36038.71,52003,"Aragarças",5,"Centro-oeste",0,"521720",5,12,4,8,6,6,0,0,0,0,0,12,4,8,6,6,7,10.492348917519,9.23717702592974,0.38108405815934,31
"14361","GO","Pirenópolis",25064,18116.35,52012,"Entorno de Brasília",5,"Centro-oeste",0,"521730",2,20,4,16,5,15,0,0,0,0,0,20,4,16,5,15,19,9.80457012442765,10.129187832632,0.272669534368508,29
"14362","GO","Pirenópolis",25064,18116.35,52012,"Entorno de Brasília",5,"Centro-oeste",0,"521730",3,12,2,10,4,8,0,0,0,0,0,12,2,10,4,8,13,9.80457012442765,10.129187832632,0.36310773394804,31
"14363","GO","Pirenópolis",25064,18116.35,52012,"Entorno de Brasília",5,"Centro-oeste",0,"521730",4,18,3,15,6,12,1,0,1,1,0,19,3,16,7,12,13,9.80457012442765,10.129187832632,0.422750062096731,30
"14364","GO","Pirenópolis",25064,18116.35,52012,"Entorno de Brasília",5,"Centro-oeste",0,"521730",5,25,2,23,9,16,0,0,0,0,0,25,2,23,9,16,14,9.80457012442765,10.129187832632,0.397174874768193,31
"14365","GO","Pires do Rio",31686,28705.53,52016,"Pires do Rio",5,"Centro-oeste",1,"521740",2,13,3,10,3,10,0,0,0,0,0,13,3,10,3,10,20,10.2648450661136,10.363630221935,0.297648900437936,29
"14366","GO","Pires do Rio",31686,28705.53,52016,"Pires do Rio",5,"Centro-oeste",1,"521740",3,18,3,15,7,11,0,0,0,0,0,18,3,15,7,11,15,10.2648450661136,10.363630221935,0.389527818425316,31
"14367","GO","Pires do Rio",31686,28705.53,52016,"Pires do Rio",5,"Centro-oeste",1,"521740",4,23,3,20,10,13,0,0,0,0,0,23,3,20,10,13,17,10.2648450661136,10.363630221935,0.41034720125431,30
"14368","GO","Pires do Rio",31686,28705.53,52016,"Pires do Rio",5,"Centro-oeste",1,"521740",5,25,2,23,11,14,1,1,0,1,0,26,3,23,12,14,18,10.2648450661136,10.363630221935,0.379451234013377,31
"14369","GO","Planaltina",90640,12177.22,52012,"Entorno de Brasília",5,"Centro-oeste",1,"521760",2,107,41,66,45,62,1,1,0,1,0,108,42,66,46,62,35,9.40732227219114,11.4146508957019,0.29793079021118,29
"14370","GO","Planaltina",90640,12177.22,52012,"Entorno de Brasília",5,"Centro-oeste",1,"521760",3,107,39,68,40,67,1,1,0,1,0,108,40,68,41,67,41,9.40732227219114,11.4146508957019,0.402395318225451,31
"14371","GO","Planaltina",90640,12177.22,52012,"Entorno de Brasília",5,"Centro-oeste",1,"521760",4,115,24,91,49,66,0,0,0,0,0,115,24,91,49,66,28,9.40732227219114,11.4146508957019,0.43508238229534,30
"14372","GO","Planaltina",90640,12177.22,52012,"Entorno de Brasília",5,"Centro-oeste",1,"521760",5,103,34,69,46,57,2,1,1,0,2,105,35,70,46,59,40,9.40732227219114,11.4146508957019,0.400614506798185,31
"14373","GO","Pontalina",17860,27501.37,52015,"Meia Ponte",5,"Centro-oeste",1,"521770",2,15,3,12,10,5,0,0,0,0,0,15,3,12,10,5,9,10.2219911005956,9.79031885443049,0.284102100814412,29
"14374","GO","Pontalina",17860,27501.37,52015,"Meia Ponte",5,"Centro-oeste",1,"521770",3,17,4,13,6,11,0,0,0,0,0,17,4,13,6,11,7,10.2219911005956,9.79031885443049,0.371493613400432,31
"14375","GO","Pontalina",17860,27501.37,52015,"Meia Ponte",5,"Centro-oeste",1,"521770",4,10,3,7,6,4,0,0,0,0,0,10,3,7,6,4,11,10.2219911005956,9.79031885443049,0.38712047531689,30
"14376","GO","Pontalina",17860,27501.37,52015,"Meia Ponte",5,"Centro-oeste",1,"521770",5,19,4,15,11,8,0,0,0,0,0,19,4,15,11,8,12,10.2219911005956,9.79031885443049,0.364495601261146,31
"14377","GO","Porangatu",45633,20811.53,52004,"Porangatu",5,"Centro-oeste",1,"521800",2,45,9,36,20,25,2,0,2,2,0,47,9,38,22,25,18,9.94326243903007,10.7283864179799,0.279173336444743,29
"14378","GO","Porangatu",45633,20811.53,52004,"Porangatu",5,"Centro-oeste",1,"521800",3,27,7,20,12,15,1,0,1,0,1,28,7,21,12,16,20,9.94326243903007,10.7283864179799,0.351058351577453,31
"14379","GO","Porangatu",45633,20811.53,52004,"Porangatu",5,"Centro-oeste",1,"521800",4,49,10,39,26,23,0,0,0,0,0,49,10,39,26,23,22,9.94326243903007,10.7283864179799,0.386795276190434,30
"14380","GO","Porangatu",45633,20811.53,52004,"Porangatu",5,"Centro-oeste",1,"521800",5,37,2,35,14,23,0,0,0,0,0,37,2,35,14,23,28,9.94326243903007,10.7283864179799,0.383856552183578,31
"14381","GO","Posse",37414,13964.56,52011,"Vão do Paranã",5,"Centro-oeste",0,"521830",2,49,9,40,21,28,1,0,1,1,0,50,9,41,22,28,6,9.54427797054313,10.5298002449089,0.282139870587165,29
"14382","GO","Posse",37414,13964.56,52011,"Vão do Paranã",5,"Centro-oeste",0,"521830",3,46,14,32,19,27,0,0,0,0,0,46,14,32,19,27,18,9.54427797054313,10.5298002449089,0.35106588617424,31
"14383","GO","Posse",37414,13964.56,52011,"Vão do Paranã",5,"Centro-oeste",0,"521830",4,45,7,38,21,24,0,0,0,0,0,45,7,38,21,24,18,9.54427797054313,10.5298002449089,0.391744614864281,30
"14384","GO","Posse",37414,13964.56,52011,"Vão do Paranã",5,"Centro-oeste",0,"521830",5,41,6,35,15,26,1,0,1,1,0,42,6,36,16,26,15,9.54427797054313,10.5298002449089,0.366676691786825,31
"14385","GO","Quirinópolis",50701,34104.01,52018,"Quirinópolis",5,"Centro-oeste",1,"521850",2,40,3,37,19,21,0,0,0,0,0,40,3,37,19,21,23,10.4371702516657,10.8337009132506,0.299390652030151,29
"14386","GO","Quirinópolis",50701,34104.01,52018,"Quirinópolis",5,"Centro-oeste",1,"521850",3,39,3,36,14,25,0,0,0,0,0,39,3,36,14,25,26,10.4371702516657,10.8337009132506,0.378349880645817,31
"14387","GO","Quirinópolis",50701,34104.01,52018,"Quirinópolis",5,"Centro-oeste",1,"521850",4,54,12,42,26,28,0,0,0,0,0,54,12,42,26,28,25,10.4371702516657,10.8337009132506,0.390319072764989,30
"14388","GO","Quirinópolis",50701,34104.01,52018,"Quirinópolis",5,"Centro-oeste",1,"521850",5,67,11,56,23,44,0,0,0,0,0,67,11,56,23,44,30,10.4371702516657,10.8337009132506,0.387121222728343,31
"14389","GO","Rialma",10940,20226.15,52006,"Ceres",5,"Centro-oeste",1,"521860",2,8,1,7,3,5,0,0,0,0,0,8,1,7,3,5,6,9.91473160063159,9.30018107597597,0.299170618378817,29
"14390","GO","Rialma",10940,20226.15,52006,"Ceres",5,"Centro-oeste",1,"521860",3,12,1,11,5,7,0,0,0,0,0,12,1,11,5,7,7,9.91473160063159,9.30018107597597,0.380308441017774,31
"14391","GO","Rialma",10940,20226.15,52006,"Ceres",5,"Centro-oeste",1,"521860",4,14,2,12,5,9,1,1,0,0,1,15,3,12,5,10,6,9.91473160063159,9.30018107597597,0.428214589661936,30
"14392","GO","Rialma",10940,20226.15,52006,"Ceres",5,"Centro-oeste",1,"521860",5,10,1,9,6,4,0,0,0,0,0,10,1,9,6,4,3,9.91473160063159,9.30018107597597,0.385758579864996,31
"14393","GO","Rio Quente",4612,74660.28,52015,"Meia Ponte",5,"Centro-oeste",0,"521878",2,7,1,6,6,1,0,0,0,0,0,7,1,6,6,1,0,11.2207035027964,8.43641688138895,0.292011322261426,29
"14394","GO","Rio Quente",4612,74660.28,52015,"Meia Ponte",5,"Centro-oeste",0,"521878",3,2,1,1,0,2,0,0,0,0,0,2,1,1,0,2,2,11.2207035027964,8.43641688138895,0.385477533726083,31
"14395","GO","Rio Quente",4612,74660.28,52015,"Meia Ponte",5,"Centro-oeste",0,"521878",4,3,0,3,1,2,0,0,0,0,0,3,0,3,1,2,2,11.2207035027964,8.43641688138895,0.46794089991252,30
"14396","GO","Rio Quente",4612,74660.28,52015,"Meia Ponte",5,"Centro-oeste",0,"521878",5,4,1,3,0,4,0,0,0,0,0,4,1,3,0,4,1,11.2207035027964,8.43641688138895,0.407935788470287,31
"14397","GO","Rio Verde",241518,41815.21,52013,"Sudoeste de Goiás",5,"Centro-oeste",1,"521880",2,260,45,215,101,159,1,0,1,0,1,261,45,216,101,160,85,10.6410154279243,12.3946992834587,0.296085782360848,29
"14398","GO","Rio Verde",241518,41815.21,52013,"Sudoeste de Goiás",5,"Centro-oeste",1,"521880",3,260,42,218,102,158,3,0,3,1,2,263,42,221,103,160,95,10.6410154279243,12.3946992834587,0.375405529772887,31
"14399","GO","Rio Verde",241518,41815.21,52013,"Sudoeste de Goiás",5,"Centro-oeste",1,"521880",4,274,44,230,115,159,0,0,0,0,0,274,44,230,115,159,72,10.6410154279243,12.3946992834587,0.413349761899771,30
"14400","GO","Rio Verde",241518,41815.21,52013,"Sudoeste de Goiás",5,"Centro-oeste",1,"521880",5,281,58,223,101,180,1,0,1,0,1,282,58,224,101,181,98,10.6410154279243,12.3946992834587,0.382915717243726,31
"14401","GO","Rubiataba",19947,21818.48,52006,"Ceres",5,"Centro-oeste",1,"521890",2,14,0,14,5,9,0,0,0,0,0,14,0,14,5,9,10,9.99051259609904,9.90083403507056,0.310224972388527,29
"14402","GO","Rubiataba",19947,21818.48,52006,"Ceres",5,"Centro-oeste",1,"521890",3,22,2,20,8,14,1,0,1,1,0,23,2,21,9,14,11,9.99051259609904,9.90083403507056,0.40428730057315,31
"14403","GO","Rubiataba",19947,21818.48,52006,"Ceres",5,"Centro-oeste",1,"521890",4,8,2,6,5,3,0,0,0,0,0,8,2,6,5,3,10,9.99051259609904,9.90083403507056,0.434469661548737,30
"14404","GO","Rubiataba",19947,21818.48,52006,"Ceres",5,"Centro-oeste",1,"521890",5,21,4,17,7,14,0,0,0,0,0,21,4,17,7,14,9,9.99051259609904,9.90083403507056,0.412598882451699,31
"14405","GO","Sanclerlândia",7632,17778.85,52009,"Anicuns",5,"Centro-oeste",0,"521900",2,8,1,7,2,6,0,0,0,0,0,8,1,7,2,6,5,9.78576482756102,8.94010521312812,0.279730887920811,29
"14406","GO","Sanclerlândia",7632,17778.85,52009,"Anicuns",5,"Centro-oeste",0,"521900",3,5,1,4,3,2,0,0,0,0,0,5,1,4,3,2,3,9.78576482756102,8.94010521312812,0.365130857902923,31
"14407","GO","Sanclerlândia",7632,17778.85,52009,"Anicuns",5,"Centro-oeste",0,"521900",4,6,0,6,3,3,0,0,0,0,0,6,0,6,3,3,4,9.78576482756102,8.94010521312812,0.403899540264801,30
"14408","GO","Sanclerlândia",7632,17778.85,52009,"Anicuns",5,"Centro-oeste",0,"521900",5,2,1,1,1,1,1,1,0,0,1,3,2,1,1,2,3,9.78576482756102,8.94010521312812,0.367339369690846,31
"14409","GO","Santa Bárbara de Goiás",6634,14457.28,52009,"Anicuns",5,"Centro-oeste",0,"521910",2,5,0,5,2,3,0,0,0,0,0,5,0,5,2,3,3,9.5789533729012,8.799963219507,0.289706351429613,29
"14410","GO","Santa Bárbara de Goiás",6634,14457.28,52009,"Anicuns",5,"Centro-oeste",0,"521910",3,6,1,5,1,5,0,0,0,0,0,6,1,5,1,5,2,9.5789533729012,8.799963219507,0.391258241178811,31
"14411","GO","Santa Bárbara de Goiás",6634,14457.28,52009,"Anicuns",5,"Centro-oeste",0,"521910",4,8,2,6,3,5,0,0,0,0,0,8,2,6,3,5,2,9.5789533729012,8.799963219507,0.404685862791021,30
"14412","GO","Santa Bárbara de Goiás",6634,14457.28,52009,"Anicuns",5,"Centro-oeste",0,"521910",5,7,2,5,1,6,0,0,0,0,0,7,2,5,1,6,2,9.5789533729012,8.799963219507,0.337613947227178,31
"14413","GO","Santa Fé de Goiás",5523,54502.53,52002,"Rio Vermelho",5,"Centro-oeste",0,"521925",2,7,2,5,2,5,0,0,0,0,0,7,2,5,2,5,5,10.9060024015922,8.61667646990119,0.369979260147254,29
"14414","GO","Santa Fé de Goiás",5523,54502.53,52002,"Rio Vermelho",5,"Centro-oeste",0,"521925",3,3,1,2,1,2,0,0,0,0,0,3,1,2,1,2,4,10.9060024015922,8.61667646990119,0.456710021979369,31
"14415","GO","Santa Fé de Goiás",5523,54502.53,52002,"Rio Vermelho",5,"Centro-oeste",0,"521925",4,8,3,5,5,3,0,0,0,0,0,8,3,5,5,3,4,10.9060024015922,8.61667646990119,0.508901956445847,30
"14416","GO","Santa Fé de Goiás",5523,54502.53,52002,"Rio Vermelho",5,"Centro-oeste",0,"521925",5,5,3,2,2,3,0,0,0,0,0,5,3,2,2,3,2,10.9060024015922,8.61667646990119,0.483880065445041,31
"14417","GO","Santa Helena de Goiás",38808,28545.12,52013,"Sudoeste de Goiás",5,"Centro-oeste",1,"521930",2,28,7,21,15,13,0,0,0,0,0,28,7,21,15,13,24,10.2592412722781,10.5663816899251,0.289988532839767,29
"14418","GO","Santa Helena de Goiás",38808,28545.12,52013,"Sudoeste de Goiás",5,"Centro-oeste",1,"521930",3,30,8,22,12,18,0,0,0,0,0,30,8,22,12,18,24,10.2592412722781,10.5663816899251,0.371480558240913,31
"14419","GO","Santa Helena de Goiás",38808,28545.12,52013,"Sudoeste de Goiás",5,"Centro-oeste",1,"521930",4,30,8,22,13,17,2,0,2,0,2,32,8,24,13,19,16,10.2592412722781,10.5663816899251,0.386210911970061,30
"14420","GO","Santa Helena de Goiás",38808,28545.12,52013,"Sudoeste de Goiás",5,"Centro-oeste",1,"521930",5,43,11,32,17,26,0,0,0,0,0,43,11,32,17,26,15,10.2592412722781,10.5663816899251,0.359017151973189,31
"14421","GO","Santa Rita do Araguaia",8935,14721.54,52013,"Sudoeste de Goiás",5,"Centro-oeste",1,"521940",2,5,0,5,2,3,0,0,0,0,0,5,0,5,2,3,3,9.59706700637584,9.09773142759353,0.31832609829028,29
"14422","GO","Santa Rita do Araguaia",8935,14721.54,52013,"Sudoeste de Goiás",5,"Centro-oeste",1,"521940",3,5,1,4,4,1,0,0,0,0,0,5,1,4,4,1,2,9.59706700637584,9.09773142759353,0.389585643216911,31
"14423","GO","Santa Rita do Araguaia",8935,14721.54,52013,"Sudoeste de Goiás",5,"Centro-oeste",1,"521940",4,1,0,1,0,1,0,0,0,0,0,1,0,1,0,1,4,9.59706700637584,9.09773142759353,0.428771936612599,30
"14424","GO","Santa Rita do Araguaia",8935,14721.54,52013,"Sudoeste de Goiás",5,"Centro-oeste",1,"521940",5,9,1,8,5,4,0,0,0,0,0,9,1,8,5,4,3,9.59706700637584,9.09773142759353,0.427022282396796,31
"14425","GO","Santa Terezinha de Goiás",8562,14529.38,52004,"Porangatu",5,"Centro-oeste",0,"521970",2,8,1,7,4,4,0,0,0,0,0,8,1,7,4,4,10,9.58392808531669,9.05508908670489,0.356215646859185,29
"14426","GO","Santa Terezinha de Goiás",8562,14529.38,52004,"Porangatu",5,"Centro-oeste",0,"521970",3,4,0,4,3,1,0,0,0,0,0,4,0,4,3,1,8,9.58392808531669,9.05508908670489,0.403212852270636,31
"14427","GO","Santa Terezinha de Goiás",8562,14529.38,52004,"Porangatu",5,"Centro-oeste",0,"521970",4,4,0,4,3,1,0,0,0,0,0,4,0,4,3,1,6,9.58392808531669,9.05508908670489,0.420143173772569,30
"14428","GO","Santa Terezinha de Goiás",8562,14529.38,52004,"Porangatu",5,"Centro-oeste",0,"521970",5,8,1,7,6,2,0,0,0,0,0,8,1,7,6,2,3,9.58392808531669,9.05508908670489,0.405733835150326,31
"14429","GO","Santo Antônio de Goiás",6440,21479.83,52010,"Goiânia",5,"Centro-oeste",1,"521973",2,6,0,6,2,4,0,0,0,0,0,6,0,6,2,4,2,9.97486963425256,8.7702838190984,0.291764190946722,29
"14430","GO","Santo Antônio de Goiás",6440,21479.83,52010,"Goiânia",5,"Centro-oeste",1,"521973",3,6,0,6,3,3,0,0,0,0,0,6,0,6,3,3,4,9.97486963425256,8.7702838190984,0.379428335144645,31
"14431","GO","Santo Antônio de Goiás",6440,21479.83,52010,"Goiânia",5,"Centro-oeste",1,"521973",4,3,0,3,0,3,0,0,0,0,0,3,0,3,0,3,0,9.97486963425256,8.7702838190984,0.420623250769731,30
"14432","GO","Santo Antônio de Goiás",6440,21479.83,52010,"Goiânia",5,"Centro-oeste",1,"521973",5,6,0,6,2,4,0,0,0,0,0,6,0,6,2,4,2,9.97486963425256,8.7702838190984,0.404335434410342,31
"14433","GO","Santo Antônio do Descoberto",75829,9129.07,52012,"Entorno de Brasília",5,"Centro-oeste",1,"521975",2,87,22,65,43,44,0,0,0,0,0,87,22,65,43,44,19,9.1192191064073,11.2362360842152,0.30343144224912,29
"14434","GO","Santo Antônio do Descoberto",75829,9129.07,52012,"Entorno de Brasília",5,"Centro-oeste",1,"521975",3,84,28,56,32,52,0,0,0,0,0,84,28,56,32,52,22,9.1192191064073,11.2362360842152,0.396632835997823,31
"14435","GO","Santo Antônio do Descoberto",75829,9129.07,52012,"Entorno de Brasília",5,"Centro-oeste",1,"521975",4,68,13,55,28,40,3,0,3,0,3,71,13,58,28,43,19,9.1192191064073,11.2362360842152,0.429199344815759,30
"14436","GO","Santo Antônio do Descoberto",75829,9129.07,52012,"Entorno de Brasília",5,"Centro-oeste",1,"521975",5,71,17,54,30,41,2,0,2,0,2,73,17,56,30,43,26,9.1192191064073,11.2362360842152,0.399486137014112,31
"14437","GO","São Francisco de Goiás",6267,16380.33,52007,"Anápolis",5,"Centro-oeste",0,"521990",2,4,2,2,1,3,0,0,0,0,0,4,2,2,1,3,2,9.70383650372427,8.74305305022468,0.302729325247847,29
"14438","GO","São Francisco de Goiás",6267,16380.33,52007,"Anápolis",5,"Centro-oeste",0,"521990",3,6,1,5,2,4,0,0,0,0,0,6,1,5,2,4,4,9.70383650372427,8.74305305022468,0.363072247080693,31
"14439","GO","São Francisco de Goiás",6267,16380.33,52007,"Anápolis",5,"Centro-oeste",0,"521990",4,6,2,4,4,2,0,0,0,0,0,6,2,4,4,2,3,9.70383650372427,8.74305305022468,0.395405678936403,30
"14440","GO","São Francisco de Goiás",6267,16380.33,52007,"Anápolis",5,"Centro-oeste",0,"521990",5,4,0,4,0,4,0,0,0,0,0,4,0,4,0,4,0,9.70383650372427,8.74305305022468,0.406329033084089,31
"14441","GO","São João d'Aliança",14085,21887.06,52005,"Chapada dos Veadeiros",5,"Centro-oeste",0,"522000",2,14,4,10,9,5,1,0,1,0,1,15,4,11,9,6,5,9.99365087359364,9.55286568031047,0.298295618946867,29
"14442","GO","São João d'Aliança",14085,21887.06,52005,"Chapada dos Veadeiros",5,"Centro-oeste",0,"522000",3,10,3,7,6,4,0,0,0,0,0,10,3,7,6,4,5,9.99365087359364,9.55286568031047,0.375485175940451,31
"14443","GO","São João d'Aliança",14085,21887.06,52005,"Chapada dos Veadeiros",5,"Centro-oeste",0,"522000",4,8,0,8,4,4,0,0,0,0,0,8,0,8,4,4,3,9.99365087359364,9.55286568031047,0.391563573593391,30
"14444","GO","São João d'Aliança",14085,21887.06,52005,"Chapada dos Veadeiros",5,"Centro-oeste",0,"522000",5,23,9,14,13,10,0,0,0,0,0,23,9,14,13,10,5,9.99365087359364,9.55286568031047,0.410014826238812,31
"14445","GO","São Luís de Montes Belos",34157,25255.7,52009,"Anicuns",5,"Centro-oeste",1,"522010",2,24,2,22,11,13,0,0,0,0,0,24,2,22,11,13,22,10.1368071518017,10.4387228220319,0.297807082543628,29
"14446","GO","São Luís de Montes Belos",34157,25255.7,52009,"Anicuns",5,"Centro-oeste",1,"522010",3,21,2,19,9,12,0,0,0,0,0,21,2,19,9,12,18,10.1368071518017,10.4387228220319,0.390874250233295,31
"14447","GO","São Luís de Montes Belos",34157,25255.7,52009,"Anicuns",5,"Centro-oeste",1,"522010",4,37,3,34,11,26,0,0,0,0,0,37,3,34,11,26,25,10.1368071518017,10.4387228220319,0.413709200749529,30
"14448","GO","São Luís de Montes Belos",34157,25255.7,52009,"Anicuns",5,"Centro-oeste",1,"522010",5,36,3,33,11,25,1,1,0,1,0,37,4,33,12,25,26,10.1368071518017,10.4387228220319,0.36578766424339,31
"14449","GO","São Miguel do Araguaia",21920,21981.46,52001,"São Miguel do Araguaia",5,"Centro-oeste",0,"522020",2,24,5,19,7,17,0,0,0,0,0,24,5,19,7,17,18,9.99795464977347,9.99515474106195,0.298860957809256,29
"14450","GO","São Miguel do Araguaia",21920,21981.46,52001,"São Miguel do Araguaia",5,"Centro-oeste",0,"522020",3,30,7,23,12,18,0,0,0,0,0,30,7,23,12,18,16,9.99795464977347,9.99515474106195,0.357037384990608,31
"14451","GO","São Miguel do Araguaia",21920,21981.46,52001,"São Miguel do Araguaia",5,"Centro-oeste",0,"522020",4,18,4,14,9,9,0,0,0,0,0,18,4,14,9,9,10,9.99795464977347,9.99515474106195,0.366706986951045,30
"14452","GO","São Miguel do Araguaia",21920,21981.46,52001,"São Miguel do Araguaia",5,"Centro-oeste",0,"522020",5,23,5,18,11,12,0,0,0,0,0,23,5,18,11,12,16,9.99795464977347,9.99515474106195,0.360468964052813,31
"14453","GO","São Simão",20985,38132.31,52018,"Quirinópolis",5,"Centro-oeste",1,"522040",2,18,4,14,7,11,0,0,0,0,0,18,4,14,7,11,17,10.5488172332353,9.95156317576769,0.297755495635091,29
"14454","GO","São Simão",20985,38132.31,52018,"Quirinópolis",5,"Centro-oeste",1,"522040",3,9,3,6,4,5,1,0,1,0,1,10,3,7,4,6,11,10.5488172332353,9.95156317576769,0.389859433446069,31
"14455","GO","São Simão",20985,38132.31,52018,"Quirinópolis",5,"Centro-oeste",1,"522040",4,15,4,11,8,7,1,0,1,1,0,16,4,12,9,7,6,10.5488172332353,9.95156317576769,0.39611549855448,30
"14456","GO","São Simão",20985,38132.31,52018,"Quirinópolis",5,"Centro-oeste",1,"522040",5,17,2,15,8,9,0,0,0,0,0,17,2,15,8,9,11,10.5488172332353,9.95156317576769,0.394537120190681,31
"14457","GO","Senador Canedo",118451,33324.44,52010,"Goiânia",5,"Centro-oeste",1,"522045",2,153,39,114,70,83,1,1,0,1,0,154,40,114,71,83,37,10.4140463407047,11.682254651932,0.288276482992688,29
"14458","GO","Senador Canedo",118451,33324.44,52010,"Goiânia",5,"Centro-oeste",1,"522045",3,156,39,117,64,92,2,0,2,1,1,158,39,119,65,93,45,10.4140463407047,11.682254651932,0.383028325851185,31
"14459","GO","Senador Canedo",118451,33324.44,52010,"Goiânia",5,"Centro-oeste",1,"522045",4,170,30,140,70,100,3,2,1,2,1,173,32,141,72,101,50,10.4140463407047,11.682254651932,0.428501178902239,30
"14460","GO","Senador Canedo",118451,33324.44,52010,"Goiânia",5,"Centro-oeste",1,"522045",5,183,48,135,84,99,0,0,0,0,0,183,48,135,84,99,50,10.4140463407047,11.682254651932,0.385054059527448,31
"14461","GO","Serranópolis",8642,48460.12,52013,"Sudoeste de Goiás",5,"Centro-oeste",0,"522050",2,7,2,5,4,3,0,0,0,0,0,7,2,5,4,3,1,10.7884964706365,9.06438931649188,0.343219742282385,29
"14462","GO","Serranópolis",8642,48460.12,52013,"Sudoeste de Goiás",5,"Centro-oeste",0,"522050",3,10,2,8,3,7,0,0,0,0,0,10,2,8,3,7,5,10.7884964706365,9.06438931649188,0.419251776251633,31
"14463","GO","Serranópolis",8642,48460.12,52013,"Sudoeste de Goiás",5,"Centro-oeste",0,"522050",4,7,4,3,4,3,0,0,0,0,0,7,4,3,4,3,3,10.7884964706365,9.06438931649188,0.430561976944957,30
"14464","GO","Serranópolis",8642,48460.12,52013,"Sudoeste de Goiás",5,"Centro-oeste",0,"522050",5,3,0,3,1,2,0,0,0,0,0,3,0,3,1,2,4,10.7884964706365,9.06438931649188,0.39072394079794,31
"14465","GO","Silvânia",20816,35836.95,52016,"Pires do Rio",5,"Centro-oeste",0,"522060",2,18,2,16,6,12,0,0,0,0,0,18,2,16,6,12,16,10.4867347630212,9.94347720075229,0.289778122692673,29
"14466","GO","Silvânia",20816,35836.95,52016,"Pires do Rio",5,"Centro-oeste",0,"522060",3,14,1,13,6,8,0,0,0,0,0,14,1,13,6,8,15,10.4867347630212,9.94347720075229,0.360464121474596,31
"14467","GO","Silvânia",20816,35836.95,52016,"Pires do Rio",5,"Centro-oeste",0,"522060",4,15,6,9,4,11,0,0,0,0,0,15,6,9,4,11,10,10.4867347630212,9.94347720075229,0.404176415579035,30
"14468","GO","Silvânia",20816,35836.95,52016,"Pires do Rio",5,"Centro-oeste",0,"522060",5,19,2,17,12,7,0,0,0,0,0,19,2,17,12,7,8,10.4867347630212,9.94347720075229,0.393054827691736,31
"14469","GO","Taquaral de Goiás",3521,18072.33,52007,"Anápolis",5,"Centro-oeste",0,"522100",2,7,1,6,1,6,0,0,0,0,0,7,1,6,1,6,4,9.80213731827329,8.16650031915505,0.312560079241157,29
"14470","GO","Taquaral de Goiás",3521,18072.33,52007,"Anápolis",5,"Centro-oeste",0,"522100",3,1,0,1,0,1,0,0,0,0,0,1,0,1,0,1,3,9.80213731827329,8.16650031915505,0.385829531986263,31
"14471","GO","Taquaral de Goiás",3521,18072.33,52007,"Anápolis",5,"Centro-oeste",0,"522100",4,3,1,2,0,3,0,0,0,0,0,3,1,2,0,3,2,9.80213731827329,8.16650031915505,0.435985459697485,30
"14472","GO","Taquaral de Goiás",3521,18072.33,52007,"Anápolis",5,"Centro-oeste",0,"522100",5,5,0,5,4,1,0,0,0,0,0,5,0,5,4,1,5,9.80213731827329,8.16650031915505,0.396733447427787,31
"14473","GO","Terezópolis de Goiás",8186,25325.44,52010,"Goiânia",5,"Centro-oeste",0,"522119",2,5,3,2,2,3,1,1,0,0,1,6,4,2,2,4,3,10.1395647031022,9.01018065705235,0.294237082110088,29
"14474","GO","Terezópolis de Goiás",8186,25325.44,52010,"Goiânia",5,"Centro-oeste",0,"522119",3,4,1,3,3,1,0,0,0,0,0,4,1,3,3,1,6,10.1395647031022,9.01018065705235,0.382440804604447,31
"14475","GO","Terezópolis de Goiás",8186,25325.44,52010,"Goiânia",5,"Centro-oeste",0,"522119",4,5,0,5,1,4,0,0,0,0,0,5,0,5,1,4,3,10.1395647031022,9.01018065705235,0.409752067126507,30
"14476","GO","Terezópolis de Goiás",8186,25325.44,52010,"Goiânia",5,"Centro-oeste",0,"522119",5,7,1,6,1,6,0,0,0,0,0,7,1,6,1,6,3,10.1395647031022,9.01018065705235,0.370026434262166,31
"14477","GO","Trindade",129823,17166.28,52010,"Goiânia",5,"Centro-oeste",1,"522140",2,155,22,133,54,101,1,0,1,0,1,156,22,134,54,102,70,9.7507022734582,11.7739272632405,0.291960784457097,29
"14478","GO","Trindade",129823,17166.28,52010,"Goiânia",5,"Centro-oeste",1,"522140",3,169,30,139,68,101,4,0,4,1,3,173,30,143,69,104,67,9.7507022734582,11.7739272632405,0.384260720494856,31
"14479","GO","Trindade",129823,17166.28,52010,"Goiânia",5,"Centro-oeste",1,"522140",4,144,41,103,60,84,2,2,0,1,1,146,43,103,61,85,63,9.7507022734582,11.7739272632405,0.41972946127743,30
"14480","GO","Trindade",129823,17166.28,52010,"Goiânia",5,"Centro-oeste",1,"522140",5,155,31,124,58,97,1,0,1,0,1,156,31,125,58,98,72,9.7507022734582,11.7739272632405,0.372163458325515,31
"14481","GO","Turvânia",4564,18363.8,52009,"Anicuns",5,"Centro-oeste",0,"522150",2,10,0,10,5,5,0,0,0,0,0,10,0,10,5,5,1,9.81813661443636,8.42595471098197,0.320195923335703,29
"14482","GO","Turvânia",4564,18363.8,52009,"Anicuns",5,"Centro-oeste",0,"522150",3,3,1,2,1,2,0,0,0,0,0,3,1,2,1,2,6,9.81813661443636,8.42595471098197,0.405129963134731,31
"14483","GO","Turvânia",4564,18363.8,52009,"Anicuns",5,"Centro-oeste",0,"522150",4,3,0,3,2,1,0,0,0,0,0,3,0,3,2,1,3,9.81813661443636,8.42595471098197,0.394679165310279,30
"14484","GO","Turvânia",4564,18363.8,52009,"Anicuns",5,"Centro-oeste",0,"522150",5,3,0,3,1,2,0,0,0,0,0,3,0,3,1,2,7,9.81813661443636,8.42595471098197,0.341792922322722,31
"14485","GO","Uruaçu",40840,21020.02,52004,"Porangatu",5,"Centro-oeste",1,"522160",2,38,5,33,12,26,0,0,0,0,0,38,5,33,12,26,24,9.95323059590527,10.6174172722786,0.285125145395092,29
"14486","GO","Uruaçu",40840,21020.02,52004,"Porangatu",5,"Centro-oeste",1,"522160",3,36,6,30,17,19,0,0,0,0,0,36,6,30,17,19,24,9.95323059590527,10.6174172722786,0.371470355443313,31
"14487","GO","Uruaçu",40840,21020.02,52004,"Porangatu",5,"Centro-oeste",1,"522160",4,35,5,30,19,16,0,0,0,0,0,35,5,30,19,16,22,9.95323059590527,10.6174172722786,0.401159647258657,30
"14488","GO","Uruaçu",40840,21020.02,52004,"Porangatu",5,"Centro-oeste",1,"522160",5,57,10,47,25,32,0,0,0,0,0,57,10,47,25,32,25,9.95323059590527,10.6174172722786,0.376760295438104,31
"14489","GO","Uruana",13818,15276.64,52006,"Ceres",5,"Centro-oeste",0,"522170",2,15,4,11,7,8,0,0,0,0,0,15,4,11,7,8,5,9.63408014325204,9.53372736904874,0.306219985782848,29
"14490","GO","Uruana",13818,15276.64,52006,"Ceres",5,"Centro-oeste",0,"522170",3,12,2,10,4,8,1,0,1,0,1,13,2,11,4,9,10,9.63408014325204,9.53372736904874,0.376020857643414,31
"14491","GO","Uruana",13818,15276.64,52006,"Ceres",5,"Centro-oeste",0,"522170",4,6,1,5,1,5,0,0,0,0,0,6,1,5,1,5,9,9.63408014325204,9.53372736904874,0.402539305455969,30
"14492","GO","Uruana",13818,15276.64,52006,"Ceres",5,"Centro-oeste",0,"522170",5,15,3,12,7,8,1,0,1,0,1,16,3,13,7,9,7,9.63408014325204,9.53372736904874,0.383370186106781,31
"14493","GO","Valparaíso de Goiás",172135,15538.72,52012,"Entorno de Brasília",5,"Centro-oeste",1,"522185",2,163,26,137,47,116,5,2,3,1,4,168,28,140,48,120,34,9.65109025244683,12.0560343316564,0.287949284108365,29
"14494","GO","Valparaíso de Goiás",172135,15538.72,52012,"Entorno de Brasília",5,"Centro-oeste",1,"522185",3,201,34,167,72,129,1,0,1,0,1,202,34,168,72,130,52,9.65109025244683,12.0560343316564,0.393800023351577,31
"14495","GO","Valparaíso de Goiás",172135,15538.72,52012,"Entorno de Brasília",5,"Centro-oeste",1,"522185",4,191,42,149,73,118,0,0,0,0,0,191,42,149,73,118,47,9.65109025244683,12.0560343316564,0.437591641014171,30
"14496","GO","Valparaíso de Goiás",172135,15538.72,52012,"Entorno de Brasília",5,"Centro-oeste",1,"522185",5,189,46,143,67,122,1,0,1,1,0,190,46,144,68,122,61,9.65109025244683,12.0560343316564,0.392627146705482,31
"14497","GO","Vianópolis",13977,32025.46,52016,"Pires do Rio",5,"Centro-oeste",0,"522200",2,13,3,10,10,3,0,0,0,0,0,13,3,10,10,3,6,10.3742864904401,9.54516840048491,0.272381340059316,29
"14498","GO","Vianópolis",13977,32025.46,52016,"Pires do Rio",5,"Centro-oeste",0,"522200",3,12,4,8,7,5,0,0,0,0,0,12,4,8,7,5,10,10.3742864904401,9.54516840048491,0.353872054062677,31
"14499","GO","Vianópolis",13977,32025.46,52016,"Pires do Rio",5,"Centro-oeste",0,"522200",4,14,3,11,9,5,1,0,1,1,0,15,3,12,10,5,9,10.3742864904401,9.54516840048491,0.379295294940568,30
"14500","GO","Vianópolis",13977,32025.46,52016,"Pires do Rio",5,"Centro-oeste",0,"522200",5,24,4,20,8,16,0,0,0,0,0,24,4,20,8,16,16,10.3742864904401,9.54516840048491,0.348019363429049,31
"14501","GO","Vicentinópolis",8873,37435.76,52015,"Meia Ponte",5,"Centro-oeste",0,"522205",2,12,3,9,6,6,0,0,0,0,0,12,3,9,6,6,6,10.5303816763153,9.09076823683534,0.338511194547914,29
"14502","GO","Vicentinópolis",8873,37435.76,52015,"Meia Ponte",5,"Centro-oeste",0,"522205",3,13,2,11,9,4,0,0,0,0,0,13,2,11,9,4,5,10.5303816763153,9.09076823683534,0.395609669986302,31
"14503","GO","Vicentinópolis",8873,37435.76,52015,"Meia Ponte",5,"Centro-oeste",0,"522205",4,10,1,9,3,7,0,0,0,0,0,10,1,9,3,7,3,10.5303816763153,9.09076823683534,0.430499997567807,30
"14504","GO","Vicentinópolis",8873,37435.76,52015,"Meia Ponte",5,"Centro-oeste",0,"522205",5,6,1,5,4,2,0,0,0,0,0,6,1,5,4,2,5,10.5303816763153,9.09076823683534,0.390936846823065,31
"14505","GO","Vila Propício",5882,28444.32,52012,"Entorno de Brasília",5,"Centro-oeste",0,"522230",2,6,2,4,3,3,0,0,0,0,0,6,2,4,3,3,1,10.2557037711159,8.67965211911394,0.320072538506705,29
"14506","GO","Vila Propício",5882,28444.32,52012,"Entorno de Brasília",5,"Centro-oeste",0,"522230",3,3,0,3,0,3,0,0,0,0,0,3,0,3,0,3,4,10.2557037711159,8.67965211911394,0.4001303997523,31
"14507","GO","Vila Propício",5882,28444.32,52012,"Entorno de Brasília",5,"Centro-oeste",0,"522230",4,2,0,2,1,1,0,0,0,0,0,2,0,2,1,1,1,10.2557037711159,8.67965211911394,0.423823478433543,30
"14508","GO","Vila Propício",5882,28444.32,52012,"Entorno de Brasília",5,"Centro-oeste",0,"522230",5,8,0,8,2,6,0,0,0,0,0,8,0,8,2,6,3,10.2557037711159,8.67965211911394,0.475003659567671,31
"14509","DF","Brasília",3055149,85661.39,53001,"Brasília",5,"Centro-oeste",1,"530010",2,2974,471,2503,891,2083,14,2,12,4,10,2988,473,2515,895,2093,963,11.3581574779814,14.9323389219026,0.294817727136172,29
"14510","DF","Brasília",3055149,85661.39,53001,"Brasília",5,"Centro-oeste",1,"530010",3,2786,418,2368,798,1988,31,2,29,9,22,2817,420,2397,807,2010,1143,11.3581574779814,14.9323389219026,0.416972754788925,31
"14511","DF","Brasília",3055149,85661.39,53001,"Brasília",5,"Centro-oeste",1,"530010",4,2703,425,2278,832,1871,26,5,21,10,16,2729,430,2299,842,1887,998,11.3581574779814,14.9323389219026,0.478917371834666,30
"14512","DF","Brasília",3055149,85661.39,53001,"Brasília",5,"Centro-oeste",1,"530010",5,3083,510,2573,920,2163,28,5,23,12,16,3111,515,2596,932,2179,1156,11.3581574779814,14.9323389219026,0.434567470846964,31
